Day,Market Participant,Tape A Shares,Tape B Shares,Tape C Shares,Total Shares,Tape A Notional,Tape B Notional,Tape C Notional,Total Notional,Tape A Trade Count,Tape B Trade Count,Tape C Trade Count,Total Trade Count
2021-01-29,NYSE American (A),14600154,66009023,11169454,91778631,576693324.481000,968026183.358600,555755532.601000,2100475040.440600,197971,196790,146998,541759
2021-01-29,NASDAQ BX (B),43325377,28364080,51768038,123457495,1994519858.739900,2137496343.761800,2605958327.576701,6737974530.078401,561234,133173,547474,1241881
2021-01-29,NYSE National (C),74812246,42281223,47769285,164862754,2004060684.357500,1479565045.449900,1575503390.767000,5059129120.574400,650137,191790,419125,1261052
2021-01-29,FINRA / Nasdaq TRF Chicago (DB),15228523,5087381,24252411,44568315,589128008.895200,176981797.914400,1116420712.137000,1882530518.946600,87014,16950,115906,219870
2021-01-29,FINRA / NYSE TRF (DN),438830332,268980638,876674493,1584485463,12910346942.756803,6389836934.868300,19804728450.983392,39104912328.608495,4243721,649541,3347258,8240520
2021-01-29,FINRA / Nasdaq TRF Carteret (DQ),2041236962,959723215,2795794131,5796754308,81653579937.504005,46648325502.911175,95835566200.188175,224137471640.603355,10509947,2476258,9944077,22930282
2021-01-29,MIAX Pearl (H),16139291,10078166,15585483,41802940,618063627.309500,632458382.980600,946334213.021600,2196856223.311700,184525,48327,160109,392961
2021-01-29,EDGA Equities (J),86224607,51032999,74336538,211594144,4065230274.280000,2904242287.790200,3739587074.797200,10709059636.867400,1064137,321717,860670,2246524
2021-01-29,EDGX Equities (K),503027673,243308858,609816130,1356152661,15934935180.534711,11678985228.621006,18403107974.367196,46017028383.522913,3820616,1002478,3313057,8136151
2021-01-29,LTSE (L),1879,0,8593,10472,2516577.630000,0.000000,1888327.880000,4404905.510000,27,0,67,94
2021-01-29,NYSE Chicago (M),14545923,15879484,8764502,39189909,916334688.042400,1359710461.524200,1761485915.992500,4037531065.559100,16933,3492,14613,35038
2021-01-29,NYSE (N),1553044329,70706060,101301905,1725052294,73073539669.980900,4454476640.106100,5163934425.529801,82691950735.616801,5509887,246831,667802,6424520
2021-01-29,NYSE Arca (P),449565640,478124561,702003909,1629694110,17888078162.459997,30830852090.566506,26024158028.009421,74743088281.035924,4065965,1764469,4231773,10062207
2021-01-29,NASDAQ (Q),754137037,328511445,1893120586,2975769068,33910298028.363088,23096802725.826114,96110008749.054243,153117109503.243445,8109535,1722122,12160349,21992006
2021-01-29,Members Exchange (U),54197792,20823571,62909040,137930403,1040729150.240000,698300413.582700,1143012341.197700,2882041905.020400,514403,71926,471420,1057749
2021-01-29,Investors Exchange (V),182623869,31083897,144718657,358426423,10897486633.784302,2436573083.884201,10717295505.512800,24051355223.181303,1843555,173314,1446466,3463335
2021-01-29,NASDAQ PSX (X),40639075,38421640,43196772,122257487,1206861503.055000,2548935993.583100,2397391463.314301,6153188959.952401,297699,180600,358059,836358
2021-01-29,BYX Equities (Y),96337747,65226825,101018222,262582794,3273241051.896401,3979488828.329500,3398552802.370900,10651282682.596801,1003273,310545,838383,2152201
2021-01-29,BZX Equities (Z),264854328,214662266,308050104,787566698,11534332515.491904,15028080761.762502,17339892220.494400,43902305497.748806,2713994,1122964,2786490,6623448
2021-01-28,NYSE American (A),16026080,76788054,10989761,103803895,628809894.715000,894264231.704900,583153313.510300,2106227439.930200,203735,244875,146966,595576
2021-01-28,NASDAQ BX (B),52984725,27206081,64146142,144336948,2277968745.464200,1671115553.508600,2568641965.740300,6517726264.713100,664564,132354,571028,1367946
2021-01-28,NYSE National (C),70021107,42668757,59398885,172088749,1943217876.962600,1255956907.326000,1446321358.021300,4645496142.309900,639900,188894,436930,1265724
2021-01-28,FINRA / Nasdaq TRF Chicago (DB),12770464,6605354,23480018,42855836,418111675.545900,101545279.500700,731945605.392300,1251602560.438900,65384,14758,86108,166250
2021-01-28,FINRA / NYSE TRF (DN),406909450,343381976,1021426837,1771718263,11508625813.217298,5014367099.118600,15643309593.183495,32166302505.519393,2314253,596953,2651736,5562942
2021-01-28,FINRA / Nasdaq TRF Carteret (DQ),2239880607,1081087344,3494068358,6815036309,82214845297.978714,38744543303.755810,92625148733.666692,213584537335.401216,10805515,2473247,9976157,23254919
2021-01-28,MIAX Pearl (H),17126405,8516526,14194563,39837494,630517848.872800,455926878.279600,943337463.377400,2029782190.529800,191997,41236,147307,380540
2021-01-28,EDGA Equities (J),99817319,46752836,101740902,248311057,4455197685.716600,2308865804.776099,3801451860.690503,10565515351.183202,1269489,301392,939231,2510112
2021-01-28,EDGX Equities (K),508971772,287058473,787341433,1583371678,15073169493.615596,10033963739.039393,16931221662.038484,42038354894.693473,3619953,1001842,3327775,7949570
2021-01-28,LTSE (L),391,100,17043,17534,656592.500000,2231.000000,283268.310000,942091.810000,18,1,35,54
2021-01-28,NYSE Chicago (M),25001931,11880071,6266688,43148690,1629190481.702600,1497784545.030399,884796283.041500,4011771309.774499,17651,3336,14338,35325
2021-01-28,NYSE (N),1345205728,72134082,119372705,1536712515,59616358743.268905,3829117986.161098,4833904863.806701,68279381593.236704,5673064,234254,716225,6623543
2021-01-28,NYSE Arca (P),616300591,519620092,1217303593,2353224276,21377615054.751303,27292139459.244169,28213040064.443893,76882794578.439365,4778784,1771364,5012934,11563082
2021-01-28,NASDAQ (Q),873406855,312628397,2274674877,3460710129,36103953790.129407,17552309845.638600,89324391127.390125,142980654763.158132,8463751,1572818,12451746,22488315
2021-01-28,Members Exchange (U),50653189,19147820,72624817,142425826,971474333.065000,644240330.419000,949638929.148100,2565353592.632100,453582,69415,382551,905548
2021-01-28,Investors Exchange (V),195984685,30174078,161583106,387741869,11564214611.272704,2061951774.586000,11550945777.449394,25177112163.308098,1914625,177927,1486489,3579041
2021-01-28,NASDAQ PSX (X),43236013,34607432,44235816,122079261,1257864657.084100,1834466121.138300,2324648587.795400,5416979366.017800,312727,136583,323620,772930
2021-01-28,BYX Equities (Y),105780002,55689692,100451915,261921609,3508502781.392100,3245142266.443801,3454984674.769399,10208629722.605300,1143951,280705,882209,2306865
2021-01-28,BZX Equities (Z),312701866,217163656,385955812,915821334,12339404012.729000,12469143989.168802,16733749332.851108,41542297334.748910,3053468,1059356,3028456,7141280
2021-01-27,NYSE American (A),21748220,65062072,16285064,103095356,865698020.085600,1152381964.252400,763856052.213200,2781936036.551200,242394,204631,181294,628319
2021-01-27,NASDAQ BX (B),72139676,31049373,85266059,188455108,3035649928.039900,2233682650.583100,3261575347.437000,8530907926.060000,818225,157527,663554,1639306
2021-01-27,NYSE National (C),85531265,38265834,67392721,191189820,2469565511.515500,1379292254.182700,1935376414.821400,5784234180.519600,740402,183654,503216,1427272
2021-01-27,FINRA / Nasdaq TRF Chicago (DB),18694519,4241063,26750892,49686474,791748043.948800,133660045.783600,886033539.707600,1811441629.440000,103233,15616,107431,226280
2021-01-27,FINRA / NYSE TRF (DN),746389152,241445873,1518321256,2506156281,20413387540.270606,5852902422.728400,21175134374.676004,47441424337.675010,4870401,643059,3642874,9156334
2021-01-27,FINRA / Nasdaq TRF Carteret (DQ),3119748324,874648029,3963736616,7958132969,112231596250.689515,44739937564.339025,113877878074.151171,270849411889.179711,14982604,2508307,11828184,29319095
2021-01-27,MIAX Pearl (H),11376225,10208854,11201393,32786472,550331020.179800,635420873.696400,936353119.044100,2122105012.920300,147050,48433,121381,316864
2021-01-27,EDGA Equities (J),125615820,53421995,114491249,293529064,5571975308.123200,2999704766.213200,4821690689.352902,13393370763.689302,1417922,351816,1055919,2825657
2021-01-27,EDGX Equities (K),815373303,239812801,957089624,2012275728,24547315847.423087,11946575664.300111,24406418539.885202,60900310051.608400,5684151,1024485,4301996,11010632
2021-01-27,LTSE (L),1089,100,5665,6854,689087.640000,2228.000000,1266372.720000,1957688.360000,71,1,17,89
2021-01-27,NYSE Chicago (M),14314584,10520732,9515863,34351179,1199220110.147800,1321642119.507000,1587706618.602200,4108568848.257000,17379,2918,14101,34398
2021-01-27,NYSE (N),1742547411,75853752,179670315,1998071478,74432503200.186820,4423313436.051699,6043800755.152998,84899617391.391517,7033491,269905,920150,8223546
2021-01-27,NYSE Arca (P),933334612,522574521,1378977766,2834886899,30188861656.922602,30746462499.029788,35277092822.573895,96212416978.526285,6815604,2032322,5811321,14659247
2021-01-27,NASDAQ (Q),1289460197,339005935,2371468757,3999934889,51328513320.739910,22820274147.057577,109127081195.612371,183275868663.409858,11552480,1866176,14682414,28101070
2021-01-27,Members Exchange (U),34012372,19808614,41866959,95687945,705710620.533200,652453438.463900,650379615.692100,2008543674.689200,308887,71656,267302,647845
2021-01-27,Investors Exchange (V),283952019,31825505,198009709,513787233,15506633329.573898,2610433922.868301,13905635626.594802,32022702879.037001,2552423,190027,1840522,4582972
2021-01-27,NASDAQ PSX (X),65678767,38737590,65394637,169810994,1916936769.756400,2446708885.070300,2865502264.176899,7229147919.003599,501823,169945,424663,1096431
2021-01-27,BYX Equities (Y),137639829,62475504,170476734,370592067,4274493032.180500,4053330375.082999,3986595843.489500,12314419250.752999,1350408,320326,998275,2669009
2021-01-27,BZX Equities (Z),458972110,224751154,445273940,1128997204,17986155008.635794,16298452978.213012,21353601309.779305,55638209296.628111,4321209,1254173,3902470,9477852
2021-01-26,NYSE American (A),14671756,37427426,10246932,62346114,560134659.042600,512944380.165400,475667117.664100,1548746156.872100,176686,128014,125486,430186
2021-01-26,NASDAQ BX (B),41935837,14925836,36123282,92984955,1885022038.606800,903336096.106800,1894660550.911301,4683018685.624901,491708,75356,437942,1005006
2021-01-26,NYSE National (C),64856364,21449396,39632151,125937911,1594263553.873600,765275763.271200,1146367553.815700,3505906870.960500,504806,108533,345998,959337
2021-01-26,FINRA / Nasdaq TRF Chicago (DB),16340709,3332906,24602753,44276368,560147459.514400,87712552.987400,908671030.923500,1556531043.425300,77199,10799,108374,196372
2021-01-26,FINRA / NYSE TRF (DN),526492021,180421220,932649435,1639562676,15546983918.125104,3680987238.184401,22277810603.978593,41505781760.288098,2410209,450309,2966018,5826536
2021-01-26,FINRA / Nasdaq TRF Carteret (DQ),2100950357,674001082,2627823421,5402774860,77370041259.671404,29112959480.509598,89924492411.097702,196407493151.278704,8957690,1698622,9100528,19756840
2021-01-26,MIAX Pearl (H),10657573,5433670,9707426,25798669,409065147.198400,292623266.537400,632511649.709400,1334200063.445200,118864,27023,101622,247509
2021-01-26,EDGA Equities (J),81870137,25882703,58409797,166162637,3589390466.860100,1425223262.528000,3150593046.298000,8165206775.686100,909205,179622,728986,1817813
2021-01-26,EDGX Equities (K),472585544,127345398,550861510,1150792452,15086411359.190601,5178141276.623600,17367529511.540994,37632082147.355195,3087590,512780,3013135,6613505
2021-01-26,LTSE (L),2170,0,950,3120,1005553.400000,0.000000,20780.230000,1026333.630000,31,0,16,47
2021-01-26,NYSE Chicago (M),10629503,10611902,9674974,30916379,901652806.956000,1534567513.790000,1692497942.845500,4128718263.591500,15012,2131,14240,31383
2021-01-26,NYSE (N),1045549388,43596529,122565637,1211711554,47069910187.978400,2197848497.719400,3900385655.367700,53168144341.065500,4048689,135625,617330,4801644
2021-01-26,NYSE Arca (P),484814904,265590372,560421442,1310826718,16525512543.861396,15701863186.592399,21970683459.011592,54198059189.465387,3334456,997332,3602821,7934609
2021-01-26,NASDAQ (Q),674951571,171507646,1336538767,2182997984,27970465768.830691,10257280061.666598,67238850436.182798,105466596266.680087,6057437,877854,9209367,16144658
2021-01-26,Members Exchange (U),39789106,10876567,46309356,96975029,726019391.810100,368477269.485900,616434929.124700,1710931590.420700,311119,42795,285682,639596
2021-01-26,Investors Exchange (V),164415121,17891588,126360297,308667006,9392367821.953301,1099218178.465100,9246708093.285600,19738294093.704001,1569239,116264,1248913,2934416
2021-01-26,NASDAQ PSX (X),36392671,18804749,33196719,88394139,1046815401.281600,1204600311.672100,1711716394.904600,3963132107.858300,239248,81825,251381,572454
2021-01-26,BYX Equities (Y),93351275,33864506,82761753,209977534,2783323218.771299,1847896885.394500,2533945011.859000,7165165116.024799,849954,165924,693539,1709417
2021-01-26,BZX Equities (Z),257248060,111244866,241716895,610209821,10013643687.141903,6916590723.147501,11858829854.907401,28789064265.196805,2307366,582255,2172339,5061960
2021-01-25,NYSE American (A),16447707,58478824,10781287,85707818,610984737.463900,746725270.949000,573546023.277100,1931256031.690000,205465,170349,137543,513357
2021-01-25,NASDAQ BX (B),45834315,29072989,48967099,123874403,2255613167.794200,1722978455.927100,2340380349.183001,6318971972.904301,561720,124724,481313,1167757
2021-01-25,NYSE National (C),60612377,30823433,40157010,131592820,1635306227.215500,1080880867.424400,1299743105.073100,4015930199.713000,532294,148417,348281,1028992
2021-01-25,FINRA / Nasdaq TRF Chicago (DB),17783178,4039055,24662907,46485140,686375016.800600,110765041.029000,1179202567.143700,1976342624.973300,93207,13115,114221,220543
2021-01-25,FINRA / NYSE TRF (DN),577914149,255308186,914649902,1747872237,16243769562.418604,4700898592.969698,23745606367.019493,44690274522.407795,2644994,535692,2958026,6138712
2021-01-25,FINRA / Nasdaq TRF Carteret (DQ),2463045549,874080760,2752034494,6089160803,91414268106.378697,36115141462.559197,104580554054.359647,232109963623.297541,10514890,2090558,9944641,22550089
2021-01-25,MIAX Pearl (H),11607220,7395022,10776333,29778575,472986597.394000,466270492.923600,788653740.758400,1727910831.076000,130321,36246,111201,277768
2021-01-25,EDGA Equities (J),85744747,39728021,60418185,185890953,4130249759.556400,2128018060.143900,3735507062.946200,9993774882.646500,1009916,250511,779908,2040335
2021-01-25,EDGX Equities (K),586505293,189911725,573489338,1349906356,18079874889.550599,8131071032.878703,21162693723.086193,47373639645.515495,3854462,735784,3265015,7855261
2021-01-25,LTSE (L),179,0,3240,3419,83038.280000,0.000000,77421.960000,160460.240000,7,0,20,27
2021-01-25,NYSE Chicago (M),19564909,7016422,6293732,32875063,737177515.329600,929758506.110000,1184505005.619499,2851441027.059099,13499,2383,12462,28344
2021-01-25,NYSE (N),1192878885,58410617,103657187,1354946689,56204928118.548696,3477826016.210499,4822333780.597400,64505087915.356595,5025978,187600,651157,5864735
2021-01-25,NYSE Arca (P),505971836,372950733,578666807,1457589376,18104111757.893211,22359812975.933400,23375479106.795818,63839403840.622429,3909881,1383477,3873730,9167088
2021-01-25,NASDAQ (Q),769427624,236403935,1522856317,2528687876,32589215657.275084,15040695929.349299,81777457889.176646,129407369475.801029,7330256,1286218,10637405,19253879
2021-01-25,Members Exchange (U),42734210,16899233,47855597,107489040,782020556.434600,496776189.513000,742594867.883900,2021391613.831500,352114,57868,333006,742988
2021-01-25,Investors Exchange (V),176823692,21452929,132168475,330445096,10775878684.954498,1312804784.279900,10523086237.384401,22611769706.618799,1623707,131423,1255415,3010545
2021-01-25,NASDAQ PSX (X),42160192,29465876,39586549,111212617,1367621801.450900,1769530704.578300,2510920128.639800,5648072634.669000,325634,124335,315331,765300
2021-01-25,BYX Equities (Y),93829131,47604140,66434578,207867849,3358506746.901400,2990337862.495900,2982071034.840500,9330915644.237800,986866,232744,698624,1918234
2021-01-25,BZX Equities (Z),291954891,156899222,260260187,709114300,12011318875.136805,10461876492.475696,14762608341.214895,37235803708.827396,2809940,831755,2481392,6123087
2021-01-22,NYSE American (A),12258147,48727182,8284833,69270162,457631622.416800,532295225.223500,398802346.110500,1388729193.750800,167732,131608,105244,404584
2021-01-22,NASDAQ BX (B),36510883,18248491,38784254,93543628,1514045110.200900,1064951635.665301,1450852498.867800,4029849244.734001,422079,83224,351859,857162
2021-01-22,NYSE National (C),49664129,24327059,32553729,106544917,1398856025.755700,793011715.276400,942741032.520200,3134608773.552300,468674,107492,296836,873002
2021-01-22,FINRA / Nasdaq TRF Chicago (DB),13106446,4135523,22220409,39462378,500212383.299200,108937887.445400,681203350.743800,1290353621.488400,69664,11538,91614,172816
2021-01-22,FINRA / NYSE TRF (DN),441724498,223748572,830615497,1496088567,13595770771.455897,4113590366.859899,18332500582.131994,36041861720.447790,1881117,448649,2266058,4595824
2021-01-22,FINRA / Nasdaq TRF Carteret (DQ),1695858879,735176216,2271124002,4702159097,67482475877.153099,33008858122.025207,74932411642.988412,175423745642.166718,7661749,1800669,7550299,17012717
2021-01-22,MIAX Pearl (H),10179626,6052316,10084209,26316151,402994184.759400,294889019.521900,544416707.783700,1242299912.065000,112274,26955,93619,232848
2021-01-22,EDGA Equities (J),64303290,28549941,50391691,143244922,3189817864.862700,1479390888.775200,2684488787.584000,7353697541.221900,798477,179098,609307,1586882
2021-01-22,EDGX Equities (K),384271168,155931349,478611317,1018813834,12700096532.951800,5387760464.083299,14310032033.458499,32397889030.493598,2534023,534896,2445261,5514180
2021-01-22,LTSE (L),433,0,4592,5025,358133.480000,0.000000,119859.180000,477992.660000,8,0,31,39
2021-01-22,NYSE Chicago (M),13438817,10284174,9184445,32907436,1086234592.563200,1205268807.980000,1206872183.565000,3498375584.108200,10334,2364,11153,23851
2021-01-22,NYSE (N),1045235122,42468569,77311271,1165014962,49385977327.976302,2131852533.276600,3525235054.901400,55043064916.154302,3540346,128710,473324,4142380
2021-01-22,NYSE Arca (P),329074624,316095658,472218700,1117388982,12444492204.709105,17325967471.045496,16043426641.369486,45813886317.124087,2588477,991770,2836543,6416790
2021-01-22,NASDAQ (Q),535265813,173235696,1226288609,1934790118,23470971519.257094,9512071379.300398,61572378661.785383,94555421560.342875,5021184,814989,7593509,13429682
2021-01-22,Members Exchange (U),30046652,15649358,48524945,94220955,652519122.360300,385250617.180000,702717068.454100,1740486807.994400,267581,47516,294835,609932
2021-01-22,Investors Exchange (V),130194893,19985203,99948962,250129058,7574330052.051401,1051935082.464200,7661486015.874298,16287751150.389899,1301970,127472,993770,2423212
2021-01-22,NASDAQ PSX (X),29601157,21223112,26074681,76898950,821470646.469200,1219002371.985500,1413537705.557200,3454010724.011900,199385,87892,199726,487003
2021-01-22,BYX Equities (Y),76950712,40397072,61003439,178351223,2625919037.283600,2079629192.532700,2229071905.357900,6934620135.174200,785599,187754,581791,1555144
2021-01-22,BZX Equities (Z),213205016,112651162,209530408,535386586,8866886928.871703,6728121643.148600,10922095202.533301,26517103774.553604,2018830,551323,1846738,4416891
2021-01-21,NYSE American (A),9895689,40199989,8030339,58126017,376237827.281200,451136590.993400,411483921.481300,1238858339.755900,130704,128218,106748,365670
2021-01-21,NASDAQ BX (B),30057367,18046850,35056630,83160847,1350443807.654700,1119045218.413200,1782757379.471000,4252246405.538900,364844,87335,375522,827701
2021-01-21,NYSE National (C),43902194,22571523,40985111,107458828,1336885015.868500,824427591.931300,1000846244.191000,3162158851.990800,424131,104507,306012,834650
2021-01-21,FINRA / Nasdaq TRF Chicago (DB),11199477,4492944,25271836,40964257,453796988.144000,111448957.037300,828313820.641300,1393559765.822600,56393,14073,102178,172644
2021-01-21,FINRA / NYSE TRF (DN),368148180,211439140,1112363463,1691950783,11790574785.396197,4301842100.110102,22148421474.663396,38240838360.169695,1586617,473080,2632713,4692410
2021-01-21,FINRA / Nasdaq TRF Carteret (DQ),1574114261,691998322,2807273874,5073386457,66871685875.572573,32691435142.341106,89637625849.671382,189200746867.585061,7068690,1781911,8485427,17336028
2021-01-21,MIAX Pearl (H),10536730,4799975,12634466,27971171,401253678.513400,252506786.653100,695810759.310200,1349571224.476700,115002,27006,107226,249234
2021-01-21,EDGA Equities (J),60781564,28494209,56404647,145680420,3134717182.273500,1469136892.093400,3071670512.542799,7675524586.909699,769880,185613,667317,1622810
2021-01-21,EDGX Equities (K),318316735,138276331,583915925,1040508991,11022217902.481396,5354186440.894397,16453212348.621102,32829616691.996895,2186646,526040,2821420,5534106
2021-01-21,LTSE (L),340,1,562,903,204812.920000,57.210000,25836.050000,230706.180000,6,1,8,15
2021-01-21,NYSE Chicago (M),12087767,7292466,7237897,26618130,1122255161.491900,1128270025.900000,1685631324.767000,3936156512.158900,12584,2306,12051,26941
2021-01-21,NYSE (N),890178516,35426865,83784084,1009389465,43659568877.322593,2014493802.702200,3417518105.575000,49091580785.599793,3253293,116644,487256,3857193
2021-01-21,NYSE Arca (P),254573274,291076723,577653184,1123303181,11074044297.546701,16240043974.805800,18342038567.370192,45656126839.722693,2201265,1027112,3097453,6325830
2021-01-21,NASDAQ (Q),467387796,158829452,1408235440,2034452688,21402632977.733506,9551358644.413099,66746635724.654291,97700627346.800896,4645196,825071,8347404,13817671
2021-01-21,Members Exchange (U),29789659,13398046,43851039,87038744,657512378.992700,378999571.019200,664018521.522900,1700530471.534800,276781,42809,284763,604353
2021-01-21,Investors Exchange (V),131769415,19639345,106433886,257842646,7933555576.838302,1114045749.266500,8809480010.405200,17857081336.510002,1328758,112763,1050215,2491736
2021-01-21,NASDAQ PSX (X),27329635,17280800,26665065,71275500,819086222.002700,1003294664.295000,1562597140.434100,3384978026.731800,182717,70897,214472,468086
2021-01-21,BYX Equities (Y),71245220,37531562,93766213,202542995,2675528313.112900,1960610544.185200,2566802321.983500,7202941179.281600,761303,173143,661450,1595896
2021-01-21,BZX Equities (Z),190446572,107219685,229078046,526744303,8314635482.533799,6678411681.239099,11928788049.955802,26921835213.728700,1857377,573382,2022316,4453075
2021-01-20,NYSE American (A),10780597,68513178,8422046,87715821,442220671.725600,652611348.781800,461110598.563300,1555942619.070700,138312,184659,108937,431908
2021-01-20,NASDAQ BX (B),30766170,19467453,34806853,85040476,1474650451.398900,1139851311.873301,1881830651.590999,4496332414.863200,414280,96826,409754,920860
2021-01-20,NYSE National (C),43482141,27688900,38252574,109423615,1351412148.304500,1007190253.681000,1106453803.039800,3465056205.025300,427399,129113,332546,889058
2021-01-20,FINRA / Nasdaq TRF Chicago (DB),11735780,5369433,24581172,41686385,497527481.977200,117149724.996500,979110263.418800,1593787470.392500,61068,16175,113193,190436
2021-01-20,FINRA / NYSE TRF (DN),363357264,335607031,953974420,1652938715,11577343586.918402,5730907637.336201,23389730491.772998,40697981716.027601,1545366,592965,2673954,4812285
2021-01-20,FINRA / Nasdaq TRF Carteret (DQ),1546933891,923214348,2634491284,5104639523,66371005157.536677,33526570246.648496,94690286352.237773,194587861756.422946,7071713,2315142,9008637,18395492
2021-01-20,MIAX Pearl (H),10894716,6420551,11885581,29200848,433470373.295200,292817065.676300,724847456.256000,1451134895.227500,120575,28959,111066,260600
2021-01-20,EDGA Equities (J),59720142,32065362,54197438,145982942,3259948383.840900,1615974143.351300,3192025133.671400,8067947660.863600,763049,204709,687678,1655436
2021-01-20,EDGX Equities (K),323899541,213834896,551342364,1089076801,11574967117.109800,6221697090.327002,18366655593.202696,36163319800.639498,2211980,691052,2917575,5820607
2021-01-20,LTSE (L),29,0,4554,4583,29526.610000,0.000000,195661.040000,225187.650000,2,0,25,27
2021-01-20,NYSE Chicago (M),13029903,13853565,8995192,35878660,889091696.197800,2176388331.579999,1524075070.552900,4589555098.330699,11317,1699,12229,25245
2021-01-20,NYSE (N),992167326,47774398,92092098,1132033822,51411419268.258706,2402673832.500000,4359343734.497400,58173436835.256106,3534288,153708,568523,4256519
2021-01-20,NYSE Arca (P),256206833,388253514,546247238,1190707585,12109527635.110100,18555179032.668705,20493116863.683117,51157823531.461922,2301539,1199406,3348403,6849348
2021-01-20,NASDAQ (Q),462549221,206266253,1374122335,2042937809,23323373255.919006,10421300096.961598,78185627184.775470,111930300537.656074,4838233,979730,8658137,14476100
2021-01-20,Members Exchange (U),29363141,19762044,43598131,92723316,645990251.358300,429965938.162300,679858288.000100,1755814477.520700,273794,56400,314412,644606
2021-01-20,Investors Exchange (V),127972287,21034258,111872325,260878870,8013231349.224000,1198797459.251000,9072418048.455500,18284446856.930500,1259922,134895,1076927,2471744
2021-01-20,NASDAQ PSX (X),26069311,22760967,28102972,76933250,842984678.865000,1376683410.896100,1801210215.818500,4020878305.579600,202394,96762,226254,525410
2021-01-20,BYX Equities (Y),67916774,47629702,74416248,189962724,2694345539.561000,2238639365.822199,2913195016.612801,7846179921.996000,754862,216566,683447,1654875
2021-01-20,BZX Equities (Z),189345230,130162552,229587935,549095717,8752688798.653602,7766748441.285801,12974604931.938404,29494042171.877807,1900765,656264,2040151,4597180
2021-01-19,NYSE American (A),11710286,71353943,8733675,91797904,484634724.490800,628013309.486500,486231467.376400,1598879501.353700,164654,182253,129566,476473
2021-01-19,NASDAQ BX (B),32869863,18879332,30991738,82740933,1485330136.185600,1046993154.398200,1735094009.505400,4267417300.089200,428414,88679,403244,920337
2021-01-19,NYSE National (C),49607795,26803329,35684282,112095406,1375172750.051300,861111168.208800,1149465561.395400,3385749479.655500,495436,120096,353766,969298
2021-01-19,FINRA / Nasdaq TRF Chicago (DB),12857525,7787023,22172204,42816752,479114778.084700,111655455.142400,775924466.916200,1366694700.143300,65798,19088,104144,189030
2021-01-19,FINRA / NYSE TRF (DN),408132239,379709933,887863334,1675705506,12801157640.778206,5002716287.382001,20642536710.054500,38446410638.214707,1733391,626368,2583332,4943091
2021-01-19,FINRA / Nasdaq TRF Carteret (DQ),1709031390,1153453434,2422967307,5285452131,71012231050.522291,36591692450.021104,89354532479.558389,196958455980.101784,7537124,2372417,8499467,18409008
2021-01-19,MIAX Pearl (H),11332704,5724215,11965584,29022503,435052225.966500,287647396.601600,627027736.406100,1349727358.974200,124896,29572,112684,267152
2021-01-19,EDGA Equities (J),57359993,31297244,50100741,138757978,3073056777.466500,1354824941.786500,3132622529.292900,7560504248.545900,771340,172886,682772,1626998
2021-01-19,EDGX Equities (K),355783167,233929488,486107808,1075820463,11913611169.595499,6170055791.303499,16232928346.157394,34316595307.056392,2426431,682858,2693688,5802977
2021-01-19,LTSE (L),1,0,1700,1701,1028.820000,0.000000,58064.000000,59092.820000,1,0,16,17
2021-01-19,NYSE Chicago (M),13936212,9719452,7586181,31241845,914598117.011800,1360225960.022400,1940010902.896600,4214834979.930800,12690,2461,12607,27758
2021-01-19,NYSE (N),1070008685,49287076,83509187,1202804948,52815601360.575600,2303779032.289800,3718187355.244398,58837567748.109798,3733266,139476,534831,4407573
2021-01-19,NYSE Arca (P),295614576,432280077,513790569,1241685222,12176151641.721092,19190122965.719395,19510899004.106101,50877173611.546588,2572145,1219834,3257309,7049288
2021-01-19,NASDAQ (Q),498095743,201809756,1292130215,1992035714,23270946702.569400,9713087931.773203,70113664523.563469,103097699157.906072,5099413,894165,8439298,14432876
2021-01-19,Members Exchange (U),33954514,21171843,34187518,89313875,706422207.256400,421012657.349100,679211376.573300,1806646241.178800,301570,62527,285741,649838
2021-01-19,Investors Exchange (V),136601075,23047405,108352818,268001298,8225210069.245500,1150820853.019700,8212059517.248899,17588090439.514099,1335510,128566,1078814,2542890
2021-01-19,NASDAQ PSX (X),26702970,20701058,25067553,72471581,863919450.559000,1137045531.447900,1470882788.677800,3471847770.684700,201992,83853,219498,505343
2021-01-19,BYX Equities (Y),75964320,47548087,66228435,189740842,2754987846.987000,2137640546.084100,2595589686.882400,7488218079.953500,828282,211243,656738,1696263
2021-01-19,BZX Equities (Z),214880348,133618142,210426533,558925023,9125257817.173101,7234057953.364397,11310790156.210199,27670105926.747697,2116342,620549,1994733,4731624
2021-01-15,NYSE American (A),12963665,53446506,9051861,75462032,517726275.264100,671100274.673800,458418434.488700,1647244984.426600,170489,162503,119002,451994
2021-01-15,NASDAQ BX (B),34983577,23126872,30934783,89045232,1523927704.077900,1525562184.980899,1715207825.296000,4764697714.354799,417333,108086,374499,899918
2021-01-15,NYSE National (C),51597687,29322966,28306980,109227633,1349930990.094600,1047511154.999800,1001054813.253400,3398496958.347800,453833,128707,273633,856173
2021-01-15,FINRA / Nasdaq TRF Chicago (DB),14299784,5377693,20990493,40667970,500455751.233800,141554326.412600,916039290.964400,1558049368.610800,68488,15333,96007,179828
2021-01-15,FINRA / NYSE TRF (DN),428154673,288067893,918179448,1634402014,13050632456.144203,7364400049.119099,22597878566.738000,43012911072.001302,1750614,537893,2566554,4855061
2021-01-15,FINRA / Nasdaq TRF Carteret (DQ),1743940122,899518722,2420338617,5063797461,69558454799.376599,52229031460.628744,88435091572.137923,210222577832.143266,7771802,2087727,8288909,18148438
2021-01-15,MIAX Pearl (H),11626087,6603448,11923564,30153099,466656939.380200,375181967.324300,694491247.559000,1536330154.263500,130408,31077,111250,272735
2021-01-15,EDGA Equities (J),63839915,29971534,49993570,143805019,3213648256.992800,1735327063.636500,2997179454.688701,7946154775.318001,781259,189912,633206,1604377
2021-01-15,EDGX Equities (K),385897246,184730573,502921112,1073548931,12797509318.815197,7556549269.689296,17545799030.556897,37899857619.061390,2683403,686286,2768147,6137836
2021-01-15,LTSE (L),241,700,1219,2160,138980.660000,10743.000000,75870.380000,225594.040000,6,5,14,25
2021-01-15,NYSE Chicago (M),22229348,31633933,17450346,71313627,1756458304.405200,3544808284.625000,3860419233.259601,9161685822.289801,10347,3430,10267,24044
2021-01-15,NYSE (N),1234203844,54170724,85794148,1374168716,63083717546.302311,2946721340.399100,4188759969.729501,70219198856.430912,3917848,161001,552390,4631239
2021-01-15,NYSE Arca (P),308733598,409312532,514274203,1232320333,12577750741.184803,22497520455.961300,18840914515.838790,53916185712.984893,2678488,1308578,3147328,7134394
2021-01-15,NASDAQ (Q),531064097,215642489,1376157300,2122863886,23926695275.560596,13470345245.181997,77316094519.451460,114713135040.194053,5243363,1051532,8307337,14602232
2021-01-15,Members Exchange (U),36638499,20178258,37231126,94047883,770357963.389700,525229881.383500,755738387.908100,2051326232.681300,314374,52577,288326,655277
2021-01-15,Investors Exchange (V),139397647,22075696,108003353,269476696,8649125398.879603,1467023803.770900,8340959848.337502,18457109050.988005,1485589,126188,1144937,2756714
2021-01-15,NASDAQ PSX (X),31551256,24002671,28015334,83569261,945823403.075400,1644476354.542700,1831954588.280900,4422254345.899000,229587,106291,242518,578396
2021-01-15,BYX Equities (Y),83828919,49442450,69653759,202925128,3000616277.653200,3148596743.239200,2635388541.782400,8784601562.674800,869542,246517,673246,1789305
2021-01-15,BZX Equities (Z),234873205,151662182,229140000,615675387,9869825233.264302,10310775465.587702,12918627921.979400,33099228620.831404,2256781,766553,2073340,5096674
2021-01-14,NYSE American (A),12438286,56297906,8950886,77687078,499922508.152500,578511706.887900,478225468.339800,1556659683.380200,152436,152652,112128,417216
2021-01-14,NASDAQ BX (B),35189915,18468184,39926612,93584711,1542874863.820400,1183017484.095900,1781867095.263300,4507759443.179600,392005,88866,357846,838717
2021-01-14,NYSE National (C),47627653,26209837,31211777,105049267,1274431264.675400,935743693.521600,1028567376.651600,3238742334.848600,411891,114561,268546,794998
2021-01-14,FINRA / Nasdaq TRF Chicago (DB),14349419,5558075,22233097,42140591,629941439.444100,110573378.968500,955550801.911700,1696065620.324300,76040,14606,103334,193980
2021-01-14,FINRA / NYSE TRF (DN),411095661,342092215,958603792,1711791668,14217670226.181297,5316600219.322899,22857899667.847889,42392170113.352085,1799212,522878,2670700,4992790
2021-01-14,FINRA / Nasdaq TRF Carteret (DQ),1769612007,1043910255,2615091186,5428613448,78258744158.147409,43178035454.667809,95665600959.878990,217102380572.694208,7857238,2057163,8714950,18629351
2021-01-14,MIAX Pearl (H),9623664,6197303,11469878,27290845,410750331.609400,289603186.369900,622945208.496500,1323298726.475800,106825,31175,96193,234193
2021-01-14,EDGA Equities (J),75521290,42411701,60330069,178263060,3676519341.355201,2125393294.778300,3405121504.324200,9207034140.457701,886525,254473,714590,1855588
2021-01-14,EDGX Equities (K),400609638,201367015,540042389,1142019042,14291997960.674801,6492060801.343405,18046839991.075821,38830898753.094027,2735286,648877,2895673,6279836
2021-01-14,LTSE (L),325,0,2653,2978,293218.560000,0.000000,50114.550000,343333.110000,8,0,18,26
2021-01-14,NYSE Chicago (M),13108963,18510914,9151548,40771425,861635093.284500,2264632310.944400,1425774140.173800,4552041544.402700,10924,3482,10529,24935
2021-01-14,NYSE (N),1042167648,51430316,91033807,1184631771,51213130078.851802,2601473017.675200,3997470616.231598,57812073712.758600,3829158,143007,567649,4539814
2021-01-14,NYSE Arca (P),331803041,383533489,540819000,1256155530,14480817228.945002,18190067250.152001,20305310385.896810,52976194864.993813,2948237,1208412,3468612,7625261
2021-01-14,NASDAQ (Q),517933685,205421038,1313783419,2037138142,24036869932.675600,11174567699.189201,67607292439.120961,102818730070.985762,5006109,953265,8303299,14262673
2021-01-14,Members Exchange (U),32632948,16713581,37014963,86361492,654272754.877700,494227486.730400,707481305.849900,1855981547.458000,259602,47200,261111,567913
2021-01-14,Investors Exchange (V),140295442,21127721,120916456,282339619,8930324759.002200,1189605963.524900,9001953081.288998,19121883803.816098,1396313,125806,1121880,2643999
2021-01-14,NASDAQ PSX (X),30344339,22949991,29411587,82705917,933054533.145800,1427145653.357000,1691924824.373200,4052125010.876000,214546,97377,244401,556324
2021-01-14,BYX Equities (Y),75498138,45423324,64263780,185185242,2673209209.202200,2388893284.814501,2549639501.501200,7611741995.517901,761241,199053,636687,1596981
2021-01-14,BZX Equities (Z),238628855,136677993,239846721,615153569,10696253413.177400,8322425648.469200,12647776514.584103,31666455576.230703,2217502,642927,2109639,4970068
2021-01-13,NYSE American (A),12200110,59256769,11658347,83115226,490162643.270200,520788081.855100,443258527.869100,1454209252.994400,152913,166765,119922,439600
2021-01-13,NASDAQ BX (B),32536466,20637371,33178462,86352299,1555355553.551100,1097843174.382100,1794426848.106200,4447625576.039400,402420,85048,374007,861475
2021-01-13,NYSE National (C),47672394,22062934,28513624,98248952,1258317188.458000,864843820.184800,955158686.626900,3078319695.269700,418230,102741,268538,789509
2021-01-13,FINRA / Nasdaq TRF Chicago (DB),12189208,5824040,25069763,43083011,542782825.275800,96982126.346300,902022115.181400,1541787066.803500,67433,13529,101946,182908
2021-01-13,FINRA / NYSE TRF (DN),358709376,339635549,1042200458,1740545383,12958308837.528303,3942789981.829800,21449389522.298592,38350488341.656695,1533616,458064,2545044,4536724
2021-01-13,FINRA / Nasdaq TRF Carteret (DQ),1560828857,897880850,2732689141,5191398848,70156624301.911185,31445072390.341011,86620542000.051274,188222238692.303470,7023972,1861496,8281542,17167010
2021-01-13,MIAX Pearl (H),9414704,5387352,13424653,28226709,390348401.616400,239386553.233600,576198101.745700,1205933056.595700,105701,28566,106822,241089
2021-01-13,EDGA Equities (J),70677579,35389384,65475855,171542818,3494461082.163500,1810126972.438000,3316633129.616299,8621221184.217799,869473,213896,729016,1812385
2021-01-13,EDGX Equities (K),338568034,185297988,580633116,1104499138,12522965028.642498,5782377197.126600,17977544615.427003,36282886841.196101,2377029,566399,2850519,5793947
2021-01-13,LTSE (L),2152,0,682,2834,214070.960000,0.000000,13778.040000,227849.000000,8,0,4,12
2021-01-13,NYSE Chicago (M),11099472,13272275,8168585,32540332,808407504.764100,1965289061.483498,1019056138.307900,3792752704.555498,12069,6062,10011,28142
2021-01-13,NYSE (N),944670855,50598218,99669173,1094938246,45983109815.322290,2255145789.344800,3734136881.421500,51972392486.088590,3670120,140476,584300,4394896
2021-01-13,NYSE Arca (P),278994383,357247037,585930306,1222171726,12428249451.101405,16489118719.378888,19709834632.467611,48627202802.947904,2462459,1109205,3324244,6895908
2021-01-13,NASDAQ (Q),460629192,187016497,1361328284,2008973973,21859869765.736505,9842780437.771801,64883315287.251490,96585965490.759796,4539360,816431,7985366,13341157
2021-01-13,Members Exchange (U),26976108,15206365,36524528,78707001,632063773.277700,358845383.864000,620834421.222400,1611743578.364100,239288,40076,239741,519105
2021-01-13,Investors Exchange (V),127576751,17655255,109265226,254497232,8079807051.840901,1039604083.850700,7736259025.112300,16855670160.803901,1267969,106573,1032187,2406729
2021-01-13,NASDAQ PSX (X),28178710,19372488,28881237,76432435,898611111.915000,1108466665.941800,1563499116.094000,3570576893.950800,205195,77527,231948,514670
2021-01-13,BYX Equities (Y),70979325,43619764,88558966,203158055,2771973130.139400,2254041832.705300,2702866498.571000,7728881461.415700,772191,190812,663015,1626018
2021-01-13,BZX Equities (Z),210615888,123583913,253640398,587840199,9420460506.782797,7488613411.097300,12245326519.471801,29154400437.351898,2121023,584433,2189672,4895128
2021-01-12,NYSE American (A),12736629,72005689,10983265,95725583,510631279.250800,542662837.498400,449131005.816300,1502425122.565500,164531,159023,113530,437084
2021-01-12,NASDAQ BX (B),33407788,24741277,31713263,89862328,1568255933.292000,1390709373.554800,1879436041.981800,4838401348.828600,418514,96710,359240,874464
2021-01-12,NYSE National (C),48812912,27975422,27657877,104446211,1297175271.618100,1053822654.550000,924988630.168500,3275986556.336600,457828,125266,260727,843821
2021-01-12,FINRA / Nasdaq TRF Chicago (DB),11954368,10006662,24308523,46269553,507696163.802500,133253898.623800,1011737478.670400,1652687541.096700,67372,23224,95160,185756
2021-01-12,FINRA / NYSE TRF (DN),379848749,481372068,1115425900,1976646717,13322232938.403102,5040232083.381398,23832016275.726894,42194481297.511394,1611704,559469,2479925,4651098
2021-01-12,FINRA / Nasdaq TRF Carteret (DQ),1672311181,1274197165,2802115441,5748623787,73118203746.398505,44435942225.265601,92712292807.460531,210266438779.124637,7515593,2220088,8256830,17992511
2021-01-12,MIAX Pearl (H),10575864,4932715,16253738,31762317,421614865.253700,239446097.526400,690934141.502800,1351995104.282900,119305,26900,117104,263309
2021-01-12,EDGA Equities (J),74596991,50589763,60948379,186135133,3721937261.867800,2177056472.020100,3318423249.724000,9217416983.611900,942600,261899,699872,1904371
2021-01-12,EDGX Equities (K),368242285,253729615,583862592,1205834492,13432367807.224298,6737493959.284003,18718363368.620606,38888225135.128907,2566382,684309,2815684,6066375
2021-01-12,LTSE (L),1,100,312,413,1980.160000,2243.000000,11537.040000,15760.200000,1,1,2,4
2021-01-12,NYSE Chicago (M),10617908,9752110,6546667,26916685,887431936.664000,1200925419.790000,808241100.323500,2896598456.777500,12980,4136,11775,28891
2021-01-12,NYSE (N),1055691099,56687708,104774596,1217153403,51448445662.715702,2647394804.014500,4050230500.570501,58146070967.300703,3940291,150380,585050,4675721
2021-01-12,NYSE Arca (P),309500461,456844666,618004631,1384349758,13801821989.201995,18178218078.622301,20853036983.991993,52833077051.816289,2722573,1216825,3359618,7299016
2021-01-12,NASDAQ (Q),511844496,238042066,1344887330,2094773892,23283574355.923700,11272151665.402902,67208316309.258879,101764042330.585481,4931973,979064,7982063,13893100
2021-01-12,Members Exchange (U),27611397,21679550,33512120,82803067,619697264.456200,477554514.921600,604441949.361100,1701693728.738900,242868,52599,230216,525683
2021-01-12,Investors Exchange (V),131776320,23959007,104646101,260381428,8292960562.926200,1269398669.189000,8368686739.828499,17931045971.943699,1280527,120456,1000048,2401031
2021-01-12,NASDAQ PSX (X),30989246,23490280,31226623,85706149,973114630.575000,1207189091.160800,1753958395.614500,3934262117.350300,226753,92199,234318,553270
2021-01-12,BYX Equities (Y),76049925,58602131,90285594,224937650,2953163067.124700,2592153829.645301,2732232725.846799,8277549622.616800,829624,221545,641216,1692385
2021-01-12,BZX Equities (Z),228386965,148117531,256918878,633423374,9978322495.440397,8106213714.135799,12309548953.869301,30394085163.445497,2256980,669315,2119083,5045378
2021-01-11,NYSE American (A),10099560,75126479,9278036,94504075,403807379.738600,500312924.486900,474038176.102900,1378158480.328400,127064,171042,101758,399864
2021-01-11,NASDAQ BX (B),30190650,21719672,36620531,88530853,1378728899.107200,1167834432.770000,1732516639.886100,4279079971.763300,368965,91085,344968,805018
2021-01-11,NYSE National (C),45470880,23259834,27381194,96111908,1196894206.778600,870192761.500400,915771623.566900,2982858591.845900,395371,109947,259009,764327
2021-01-11,FINRA / Nasdaq TRF Chicago (DB),9000606,6382805,17679696,33063107,433560015.231200,110070099.867600,1015828048.628300,1559458163.727100,57811,16338,100058,174207
2021-01-11,FINRA / NYSE TRF (DN),331259007,493529727,1111482338,1936271072,12572176543.288204,4674827861.769596,23004504898.092099,40251509303.149899,1596342,558328,2611914,4766584
2021-01-11,FINRA / Nasdaq TRF Carteret (DQ),1509246426,1089143001,2670311965,5268701392,69071633994.983179,29269566454.280410,91314545273.123627,189655745722.387216,7021546,2147282,8368385,17537213
2021-01-11,MIAX Pearl (H),4171876,2880314,8401413,15453603,247617952.413500,162607300.531300,656552631.387500,1066777884.332300,50461,13211,64717,128389
2021-01-11,EDGA Equities (J),62272792,41535723,51475628,155284143,3052109921.678800,1765133040.381600,3029074472.583401,7846317434.643801,790107,233918,649951,1673976
2021-01-11,EDGX Equities (K),320223000,227687306,556642500,1104552806,12333220385.043895,5940253780.555798,18278525948.958800,36552000114.558493,2327988,648875,2782109,5758972
2021-01-11,LTSE (L),0,200,2396,2596,0.000000,4470.000000,31870.290000,36340.290000,0,2,16,18
2021-01-11,NYSE Chicago (M),9101455,9003463,7601485,25706403,646887392.039000,759082156.250000,1336683503.816100,2742653052.105100,11005,2687,10361,24053
2021-01-11,NYSE (N),961717844,50442201,88948043,1101108088,45727189094.539807,2229630932.633400,3960528159.502200,51917348186.675407,3495568,153330,545822,4194720
2021-01-11,NYSE Arca (P),275825655,483919133,599762883,1359507671,12541056223.436896,17830752536.661610,20342148408.995590,50713957169.094096,2463553,1262413,3241024,6966990
2021-01-11,NASDAQ (Q),459478577,243656270,1315357939,2018492786,21354796741.654292,10558895798.682002,69007348848.685847,100921041389.022141,4531355,949952,7914586,13395893
2021-01-11,Members Exchange (U),25047423,20528153,35393197,80968773,547968814.925800,475858104.651000,639404525.170400,1663231444.747200,215712,51710,230951,498373
2021-01-11,Investors Exchange (V),118977251,19404426,94285887,232667564,7546591574.133200,1223759332.162600,7978133607.717201,16748484514.013001,1202242,122221,969108,2293571
2021-01-11,NASDAQ PSX (X),25832929,18769066,28276759,72878754,810888176.297800,1025447562.011800,1872319770.801400,3708655509.111000,184036,82077,227956,494069
2021-01-11,BYX Equities (Y),68120860,41754854,58594784,168470498,2545990202.080600,2118532854.397600,2498637063.977200,7163160120.455400,724975,184108,585641,1494724
2021-01-11,BZX Equities (Z),199398858,143237324,242980680,585616862,8741347438.271100,7915479284.468201,12326289812.282897,28983116535.022198,1992287,667256,2022119,4681662
2021-01-08,NYSE American (A),10766273,45376714,10554922,66697909,438107458.297300,605008454.858300,527318383.250600,1570434296.406200,154445,143877,134153,432475
2021-01-08,NASDAQ BX (B),33848577,39096848,37911481,110856906,1538810150.860000,1740419595.182700,2120487906.805600,5399717652.848300,412810,125768,431193,969771
2021-01-08,NYSE National (C),50496684,32252872,31591183,114340739,1331067251.481100,1174267022.941700,1003045849.505200,3508380123.928000,463032,133252,312088,908372
2021-01-08,FINRA / Nasdaq TRF Chicago (DB),10279180,7411187,20771835,38462202,521199716.755100,133836237.916700,1170893415.635700,1825929370.307500,61786,15942,104401,182129
2021-01-08,FINRA / NYSE TRF (DN),363093811,294665677,1072229006,1729988494,13277420672.278198,5887979541.347800,27407772724.251321,46573172937.877319,1576036,494129,2652120,4722285
2021-01-08,FINRA / Nasdaq TRF Carteret (DQ),1574445718,903249078,2756611732,5234306528,69568674167.072286,37473688211.900198,98563197367.839179,205605559746.811663,7292738,2036107,9087264,18416109
2021-01-08,MIAX Pearl (H),5239345,4116303,7499453,16855101,311122885.244300,258438217.018100,753037829.629000,1322598931.891400,65957,19384,69064,154405
2021-01-08,EDGA Equities (J),69998587,46914422,64909986,181822995,3378517653.952000,2376375320.058000,3562114781.820500,9317007755.830500,898097,296772,789125,1983994
2021-01-08,EDGX Equities (K),352346420,193475059,586190550,1132012029,13482449939.978902,8752063908.677200,21182302665.976404,43416816514.632506,2657773,719655,3112651,6490079
2021-01-08,LTSE (L),139,0,524,663,276943.000000,0.000000,3305.080000,280248.080000,11,0,4,15
2021-01-08,NYSE Chicago (M),10670332,12821209,6340215,29831756,934877198.897000,1459800788.932900,983408161.820700,3378086149.650600,11750,3637,12180,27567
2021-01-08,NYSE (N),1040887958,60607437,101289564,1202784959,53097054987.866993,3127274491.770100,4931519251.073099,61155848730.710192,4042616,174787,638240,4855643
2021-01-08,NYSE Arca (P),279718354,392474642,622453598,1294646594,13154634683.356595,22416395814.196303,26084430108.349590,61655460605.902488,2720868,1369996,3849972,7940836
2021-01-08,NASDAQ (Q),493204545,248215624,1452295831,2193716000,23199103410.946209,14855717251.910601,78684004238.034098,116738824900.890908,5003191,1172122,9058003,15233316
2021-01-08,Members Exchange (U),29140687,20438207,34173420,83752314,625301564.884600,566171213.115500,726926362.767900,1918399140.768000,250080,50659,248600,549339
2021-01-08,Investors Exchange (V),128550304,22600805,111899653,263050762,8213319381.814101,1442782662.207600,8956969699.205398,18613071743.227099,1318602,136159,1124956,2579717
2021-01-08,NASDAQ PSX (X),30100607,27193024,30991108,88284739,920834514.557500,1560373713.410601,2258838031.376499,4740046259.344600,215388,111024,269794,596206
2021-01-08,BYX Equities (Y),76088560,55651224,66300815,198040599,2729263568.861000,3139592653.254001,3043430160.755400,8912286382.870401,807705,249896,693054,1750655
2021-01-08,BZX Equities (Z),214170644,167125066,275380972,656676682,9555703525.544001,10868344335.158694,14604645704.057499,35028693564.760194,2222532,812159,2343757,5378448
2021-01-07,NYSE American (A),12270480,39019781,11390832,62681093,543199023.895000,554470425.354900,547252823.060100,1644922272.310000,167827,122163,123366,413356
2021-01-07,NASDAQ BX (B),38221197,25125530,32649074,95995801,1766715738.166000,1329621945.940800,2024243746.792700,5120581430.899500,470344,101701,397364,969409
2021-01-07,NYSE National (C),52227698,25010336,30165003,107403037,1439211368.726800,958184368.998200,1011210342.817700,3408606080.542700,488380,114511,298888,901779
2021-01-07,FINRA / Nasdaq TRF Chicago (DB),10496750,3581325,20008142,34086217,526302123.473900,114196969.433800,862326302.493400,1502825395.401100,62004,11698,96271,169973
2021-01-07,FINRA / NYSE TRF (DN),370514813,238857723,976233454,1585605990,13568837280.926703,5792105843.124997,22694877218.610899,42055820342.662599,1560204,427032,2364766,4352002
2021-01-07,FINRA / Nasdaq TRF Carteret (DQ),1726416750,753191759,2682973337,5162581846,78226919798.554641,35017458039.808517,91538295052.915913,204782672891.279071,7695043,1813045,8320197,17828285
2021-01-07,MIAX Pearl (H),5704495,4139789,8018168,17862452,323548854.289600,232098069.735000,677728001.023500,1233374925.048100,70058,18807,67594,156459
2021-01-07,EDGA Equities (J),73318607,37549818,61656201,172524626,3664731984.126000,1914561914.658600,3444478624.615300,9023772523.399900,953430,236887,746309,1936626
2021-01-07,EDGX Equities (K),370167818,164006264,535495533,1069669615,14213583914.334495,6968724730.233901,18034376256.855698,39216684901.424094,2698444,569765,2778561,6046770
2021-01-07,LTSE (L),0,0,1073,1073,0.000000,0.000000,11018.050000,11018.050000,0,0,9,9
2021-01-07,NYSE Chicago (M),13082407,12561943,7393980,33038330,974978144.432500,1158511184.545000,1157954396.434000,3291443725.411500,11287,3533,11351,26171
2021-01-07,NYSE (N),1104440697,47851836,84425458,1236717991,55819124268.518802,2625654248.282600,4191529869.181998,62636308385.983400,4116766,148543,577177,4842486
2021-01-07,NYSE Arca (P),298944694,338943443,555454339,1193342476,13693923825.241798,19242216787.395502,23175124100.574915,56111264713.212215,2744361,1157549,3436828,7338738
2021-01-07,NASDAQ (Q),512983030,187420319,1329980358,2030383707,23862167054.587206,12030334373.013296,73936484249.926804,109828985677.527306,5173690,912577,8280071,14366338
2021-01-07,Members Exchange (U),36249466,19046090,48264659,103560215,984217996.318000,473535289.326300,1202409871.320000,2660163156.964300,354674,58878,401951,815503
2021-01-07,Investors Exchange (V),143043453,21356132,110705542,275105127,9017002473.417302,1425178080.808800,8473585991.232704,18915766545.458806,1471436,123081,1089226,2683743
2021-01-07,NASDAQ PSX (X),31666194,21681474,29976923,83324591,965025927.115000,1258894584.366800,1789345005.091700,4013265516.573500,226022,95452,231445,552919
2021-01-07,BYX Equities (Y),80112797,45374508,65568697,191056002,2987376408.001700,2572273384.831302,2845338389.212000,8404988182.045002,870125,204572,682932,1757629
2021-01-07,BZX Equities (Z),219299002,128016753,251120459,598436214,9838166283.482300,8943534299.006802,13106459518.286803,31888160100.775905,2256400,658913,2131162,5046475
2021-01-06,NYSE American (A),15371000,60941320,14068508,90380828,614576866.998000,748390544.345800,645121706.372100,2008089117.715900,186140,162595,129557,478292
2021-01-06,NASDAQ BX (B),40861802,35039960,36112089,112013851,1788765869.705800,2356047124.504600,2242210098.543100,6387023092.753500,482949,165476,435196,1083621
2021-01-06,NYSE National (C),63039012,38584987,34034330,135658329,1594612438.229900,1410564814.014800,1120708746.460400,4125885998.705100,542713,167216,317968,1027897
2021-01-06,FINRA / Nasdaq TRF Chicago (DB),11476538,5937076,26206460,43620074,534001483.031000,167585173.924400,941075413.408600,1642662070.364000,59082,13330,89614,162026
2021-01-06,FINRA / NYSE TRF (DN),399190813,349466852,1063904191,1812561856,14518074554.094302,7005320177.439700,23967805031.046600,45491199762.580602,1647947,527417,2377238,4552602
2021-01-06,FINRA / Nasdaq TRF Carteret (DQ),1937973080,1054607261,2902668574,5895248915,85874113895.821388,48822621624.787499,100897655080.094912,235594390600.703799,8180049,2281360,8736492,19197901
2021-01-06,MIAX Pearl (H),7446393,7158923,10338271,24943587,373470661.971100,426408775.223200,675838380.944900,1475717818.139200,86729,28895,81048,196672
2021-01-06,EDGA Equities (J),90152278,63769987,72028540,225950805,4082830871.604400,3390948843.229801,3956077832.254700,11429857547.088901,1113389,389301,844097,2346787
2021-01-06,EDGX Equities (K),424055761,260956471,617042302,1302054534,15306352302.223901,11506072692.316901,20789698238.694603,47602123233.235405,3068472,920282,3075120,7063874
2021-01-06,LTSE (L),4,1,1723,1728,3219.920000,346.610000,30280.560000,33847.090000,1,1,5,7
2021-01-06,NYSE Chicago (M),14223783,12265171,5854755,32343709,903374688.548000,914175239.580000,1108145902.870400,2925695830.998400,11592,4146,10780,26518
2021-01-06,NYSE (N),1400448871,80880313,108446712,1589775896,63434784971.333202,4707728167.202900,5477515562.185801,73620028700.721903,5205280,254907,698327,6158514
2021-01-06,NYSE Arca (P),355808004,505418794,652724761,1513951559,15533427213.075900,28337789695.687009,26426724340.169394,70297941248.932303,3166707,1665829,3940657,8773193
2021-01-06,NASDAQ (Q),639190158,319666443,1549158445,2508015046,29024889418.785600,20242001044.456199,85486229081.393704,134753119544.635503,6509032,1529873,9858487,17897392
2021-01-06,Members Exchange (U),42021851,25275862,59676164,126973877,1116966917.655400,791430045.923000,1265525583.757100,3173922547.335500,410889,88640,440076,939605
2021-01-06,Investors Exchange (V),176351941,30947051,122803081,330102073,10610137092.013400,2071330614.343800,9809964894.209099,22491432600.566299,1748742,164953,1250132,3163827
2021-01-06,NASDAQ PSX (X),42142346,36263362,37297620,115703328,1241073040.474000,1973362445.436400,2167912942.858900,5382348428.769300,295929,149360,293995,739284
2021-01-06,BYX Equities (Y),107155322,76296198,77379567,260831087,3655738492.619901,4374233687.018299,3371463258.870901,11401435438.509101,1078133,343122,755190,2176445
2021-01-06,BZX Equities (Z),297209881,215158118,300136700,812504699,12475262805.127699,15362241909.457098,15752978714.127893,43590483428.712690,3103127,1099263,2686648,6889038
2021-01-05,NYSE American (A),11502660,79826787,11214151,102543598,414110114.417200,589483875.306900,418034532.759600,1421628522.483700,157042,189511,108390,454943
2021-01-05,NASDAQ BX (B),32555725,29055217,27971864,89582806,1320361640.589600,1592149285.373900,1565256195.286400,4477767121.249900,403442,135747,342820,882009
2021-01-05,NYSE National (C),51559339,28280014,27608083,107447436,1166495881.550400,1034861674.962900,801191766.864000,3002549323.377300,456564,132559,277473,866596
2021-01-05,FINRA / Nasdaq TRF Chicago (DB),9101757,14530776,27079479,50712012,395700799.275900,119701788.744700,673730573.655500,1189133161.676100,46240,17546,72788,136574
2021-01-05,FINRA / NYSE TRF (DN),333570224,443518181,1110492368,1887580773,12285958371.414695,4713332731.042800,18096187994.612186,35095479097.069681,1351629,513616,1949247,3814492
2021-01-05,FINRA / Nasdaq TRF Carteret (DQ),1511987358,1095300794,2671964520,5279252672,65340471364.594225,36711832479.303282,70761237624.238128,172813541468.135635,6606275,2235480,7225920,16067675
2021-01-05,MIAX Pearl (H),3821638,5175147,9553895,18550680,229698855.712400,177178299.230900,403054498.733500,809931653.676800,45619,17313,59674,122606
2021-01-05,EDGA Equities (J),70339848,47651580,57236528,175227956,3297108228.099200,2085779029.293200,2839980845.342600,8222868102.735000,910827,275731,685028,1871586
2021-01-05,EDGX Equities (K),328139244,247402883,536088916,1111631043,11506969762.828301,6771817675.037898,13696838367.622495,31975625805.488694,2345392,702122,2411201,5458715
2021-01-05,LTSE (L),0,100,1,101,0.000000,2228.000000,99.010000,2327.010000,0,1,1,2
2021-01-05,NYSE Chicago (M),12957523,10359052,3592099,26908674,942777419.969100,928729800.660000,667276409.529500,2538783630.158600,9876,3898,6416,20190
2021-01-05,NYSE (N),994960648,83448614,112531264,1190940526,45777789748.589699,3038117477.979700,3455290573.363200,52271197799.932599,3694978,202534,543646,4441158
2021-01-05,NYSE Arca (P),269344279,475551333,613548832,1358444444,11528080206.178697,19824112575.832899,16961739630.419605,48313932412.431201,2434294,1263299,3059211,6756804
2021-01-05,NASDAQ (Q),477462042,276294608,1271248091,2025004741,20832104831.147392,11786398684.658303,55487398744.044609,88105902259.850304,4797009,1055704,7270729,13123442
2021-01-05,Members Exchange (U),33724457,19242051,50307665,103274173,865814737.308700,448439254.169200,848442270.940800,2162696262.418700,332910,68415,355870,757195
2021-01-05,Investors Exchange (V),129989257,27898788,93888381,251776426,7397464420.960199,1367970882.690600,6406140251.421299,15171575555.072098,1300997,153129,931776,2385902
2021-01-05,NASDAQ PSX (X),29847239,23316194,24412046,77575479,749768695.378800,1150292848.502100,1362797730.273600,3262859274.154500,200694,100013,191173,491880
2021-01-05,BYX Equities (Y),75811063,62168693,69183306,207163062,2486023318.698800,2765277882.680300,2206131333.890600,7457432535.269700,789066,255301,614646,1659013
2021-01-05,BZX Equities (Z),214347294,180441836,253939423,648728553,8410524770.966800,8770718939.576502,9625933551.793901,26807177262.337203,2154840,769091,1877073,4801004
2021-01-04,NYSE American (A),11256613,55427968,11517459,78202040,460416346.010500,791368537.495300,534487312.313900,1786272195.819700,175514,172534,139415,487463
2021-01-04,NASDAQ BX (B),32741429,25238400,40428110,98407939,1513468112.747200,1832813680.978500,1949354416.109100,5295636209.834800,446145,131898,406416,984459
2021-01-04,NYSE National (C),53165818,34137358,35579078,122882254,1296725881.301300,1177459050.424800,1054365691.449800,3528550623.175900,494227,154761,334886,983874
2021-01-04,FINRA / Nasdaq TRF Chicago (DB),12080627,12124688,23330128,47535443,538245494.040100,203291514.379200,1050940117.058900,1792477125.478200,69651,20354,103247,193252
2021-01-04,FINRA / NYSE TRF (DN),356170522,298239356,929675387,1584085265,12784118507.490700,6268787720.369900,23157854918.916990,42210761146.777590,1762862,539591,2400446,4702899
2021-01-04,FINRA / Nasdaq TRF Carteret (DQ),1609978767,938479008,2449224770,4997682545,72875417215.068030,46599762165.128017,94105055488.665934,213580234868.861981,7824515,2283270,8448173,18555958
2021-01-04,MIAX Pearl (H),2910695,4852134,4780090,12542919,174548603.033700,282387702.037700,369525175.803900,826461480.875300,43141,18334,47261,108736
2021-01-04,EDGA Equities (J),81044413,62475167,67501806,211021386,3655058531.987200,3333547044.674302,3640825817.354800,10629431394.016302,1002278,393237,832366,2227881
2021-01-04,EDGX Equities (K),355483878,191479489,493124342,1040087709,13020246154.769396,9976436354.807898,17159674903.133502,40156357412.710796,2817664,781776,2851124,6450564
2021-01-04,LTSE (L),1,300,1017,1318,1016.540000,6668.000000,8373.500000,16058.040000,1,3,8,12
2021-01-04,NYSE Chicago (M),9347082,7012405,5629878,21989365,826612566.494000,943680245.254999,1111111441.185800,2881404252.934799,9209,4752,8753,22714
2021-01-04,NYSE (N),1157625211,92635170,97491047,1347751428,55793265350.490713,4597824098.549099,4939698121.094399,65330787570.134211,4521527,238676,639692,5399895
2021-01-04,NYSE Arca (P),294179520,481162845,591741451,1367083816,12980315456.869994,26701525584.061104,22986245564.209200,62668086605.140298,2872979,1567590,3699266,8139835
2021-01-04,NASDAQ (Q),521409397,272673097,1354661095,2148743589,23708364936.666314,17797237982.299198,74621917247.645853,116127520166.611365,5592778,1359632,8894695,15847105
2021-01-04,Members Exchange (U),35917850,20584953,54966760,111469563,989487339.882400,642577652.244900,1171320888.137000,2803385880.264300,385520,72879,420537,878936
2021-01-04,Investors Exchange (V),136332474,26465687,107119032,269917193,8384936272.409601,1728553232.448500,8255428167.102504,18368917671.960605,1402014,152122,1072825,2626961
2021-01-04,NASDAQ PSX (X),33723045,30430243,28486661,92639949,900049644.047900,1863550849.068899,1658863427.249000,4422463920.365799,239950,128400,256612,624962
2021-01-04,BYX Equities (Y),78127678,61425189,82941531,222494398,2850656528.996000,3819554963.968800,2807765331.297400,9477976824.262200,858112,276852,726481,1861445
2021-01-04,BZX Equities (Z),233514418,201929888,257976337,693420643,9725720525.911197,13325124082.030499,13694393955.368599,36745238563.310295,2524165,968611,2383588,5876364
