Day,Market Participant,Tape A Shares,Tape B Shares,Tape C Shares,Total Shares,Tape A Notional,Tape B Notional,Tape C Notional,Total Notional,Tape A Trade Count,Tape B Trade Count,Tape C Trade Count,Total Trade Count
2013-12-31,NYSE MKT (A),0,13523034,4515410,18038444,0.000000,91821778.322000,74767813.075000,166589591.397000,0,24701,17490,42191
2013-12-31,NASDAQ BX (B),66669506,30193881,42725279,139588666,2278451083.384902,1718250887.995303,1648166727.278598,5644868698.658803,546632,119843,334605,1001080
2013-12-31,NSX (C),10573358,7862582,11699865,30135805,281464297.135400,239212644.865000,218103354.194900,738780296.195300,38290,17544,31537,87371
2013-12-31,NYSE (DN),100747311,40391073,70942300,212080684,3152395421.698099,1972821041.650899,2257268485.516500,7382484948.865498,460850,128636,273695,863181
2013-12-31,NASDAQ (DQ),710378546,299867908,498889129,1509135583,21629497939.409281,15737089212.805761,13269427757.273723,50636014909.488765,2863123,700458,1590100,5153681
2013-12-31,EDGA (J),53760086,29358231,32775908,115894225,1558560498.729699,1592989425.782903,925145313.840603,4076695238.353205,418123,127854,231478,777455
2013-12-31,EDGX (K),181531784,66332755,135773807,383638346,6145921715.675720,3378442662.470597,3856275203.822253,13380639581.968570,1024242,219209,648694,1892145
2013-12-31,CHX (M),5903388,5024772,3075584,14003744,236112730.412500,536419064.190000,176595509.432000,949127304.034500,329,1431,510,2270
2013-12-31,NYSE (N),568391403,0,0,568391403,21112730682.741547,0.000000,0.000000,21112730682.741547,1455520,0,0,1455520
2013-12-31,NYSE Arca (P),150623413,160612395,92883824,404119632,5994020873.469405,10326395867.517108,3532982258.600207,19853398999.586720,1183194,414526,625631,2223351
2013-12-31,NASDAQ (Q),252407463,91418770,370318698,714144931,9493799220.048937,6558233763.167092,13491006029.775921,29543039012.991950,1813321,320501,1739200,3873022
2013-12-31,CBSX (W),9292596,4462759,6924727,20680082,249405305.390000,295133949.210000,148107452.530000,692646707.130000,73097,14536,48878,136511
2013-12-31,NASDAQ PSX (X),6056151,7696509,5074702,18827362,175314487.048200,543649222.393400,164242952.790000,883206662.231600,39399,23492,27761,90652
2013-12-31,BATS BYX (Y),46252196,24605868,25921348,96779412,1482104529.412701,1341850355.904602,868920758.633198,3692875643.950501,389027,99130,198546,686703
2013-12-31,BATS BZX (Z),150947266,85365991,101504844,337818101,4817550622.400242,5989516269.917708,3126931582.864838,13933998475.182788,1115041,316716,664205,2095962
2013-12-30,NYSE MKT (A),0,12270918,4542888,16813806,0.000000,70232607.583200,73303949.836000,143536557.419200,0,22228,17465,39693
2013-12-30,NASDAQ BX (B),67295485,23422932,40369498,131087915,2144394828.763992,1142789872.292698,1474077301.367673,4761262002.424363,539463,100462,304912,944837
2013-12-30,NSX (C),12304424,7141055,11451484,30896963,320438810.713000,162878734.758200,211108354.912000,694425900.383200,46330,16240,33474,96044
2013-12-30,NYSE (DN),103712299,34658161,73194517,211564977,3204231384.447411,1550377797.375301,2344724485.490092,7099333667.312804,470632,104030,276174,850836
2013-12-30,NASDAQ (DQ),771588502,255510660,491810573,1518909735,23176769486.577686,13172912567.417872,13267785989.251901,49617468043.247459,3065097,616634,1635113,5316844
2013-12-30,EDGA (J),54192822,24160617,31995259,110348698,1558144031.884101,1170436703.217300,949102452.715602,3677683187.817003,421925,105854,229292,757071
2013-12-30,EDGX (K),183403247,51313623,131580824,366297694,6208827011.114269,2445656870.359405,4028475558.594917,12682959440.068591,1001218,164266,596845,1762329
2013-12-30,CHX (M),19486683,14347826,7682993,41517502,855633973.059800,1076639875.543600,505968731.608100,2438242580.211500,371,985,394,1750
2013-12-30,NYSE (N),462241518,0,0,462241518,16349010920.571620,0.000000,0.000000,16349010920.571620,1436556,0,0,1436556
2013-12-30,NYSE Arca (P),154954586,138114017,100580178,393648781,6093422124.025386,7769244885.249597,3899727447.566468,17762394456.841451,1172994,371135,613002,2157131
2013-12-30,NASDAQ (Q),258724729,71766920,323828967,654320616,9877520752.958764,4871637285.311318,11761660111.042042,26510818149.312124,1935013,276688,1750760,3962461
2013-12-30,CBSX (W),10387352,6620927,6632591,23640870,287338300.080000,459360870.370000,166926548.300000,913625718.750000,81105,11092,48364,140561
2013-12-30,NASDAQ PSX (X),6017304,4721173,4556888,15295365,177111895.343400,301649808.065800,183699277.320100,662460980.729300,36887,16274,26174,79335
2013-12-30,BATS BYX (Y),46016905,19209388,25523629,90749922,1404860619.089100,955198040.310601,835818956.140502,3195877615.540203,380606,82980,188297,651883
2013-12-30,BATS BZX (Z),144136036,65934062,96496765,306566863,4642224954.360107,4210712683.767604,3167472239.044163,12020409877.171874,1071542,257581,636572,1965695
2013-12-27,NYSE MKT (A),0,12031015,4552812,16583827,0.000000,62048638.000700,77159793.832000,139208431.832700,0,20477,17018,37495
2013-12-27,NASDAQ BX (B),61367373,24512697,34037525,119917595,1947267189.651807,1348993574.997999,1388164040.957801,4684424805.607607,510911,101843,273290,886044
2013-12-27,NSX (C),7927602,5665856,7091949,20685407,238537272.892500,159074676.495300,121832185.633800,519444135.021600,37312,14518,24513,76343
2013-12-27,NYSE (DN),88163996,28900358,69970836,187035190,2866490718.188706,1386036483.043797,2146265238.766098,6398792439.998601,423286,92109,247125,762520
2013-12-27,NASDAQ (DQ),647228979,239739187,454531643,1341499809,19768191404.286874,11575112463.430810,12356951820.595340,43700255688.313024,2562138,528383,1410024,4500545
2013-12-27,EDGA (J),49812833,24624800,29836554,104274187,1446690752.250599,1190118980.192300,830479705.824801,3467289438.267700,392719,103528,207584,703831
2013-12-27,EDGX (K),179591101,54744362,141166424,375501887,6197004455.781079,2467642010.466002,4077832892.476384,12742479358.723465,959831,165308,558045,1683184
2013-12-27,CHX (M),4584204,7301665,3524353,15410222,216834991.663500,734868141.241500,308553772.373000,1260256905.278000,236,748,500,1484
2013-12-27,NYSE (N),423713717,0,0,423713717,15073509078.776314,0.000000,0.000000,15073509078.776314,1367804,0,0,1367804
2013-12-27,NYSE Arca (P),151670063,133550291,90089963,375310317,5884863234.569479,8036868341.477505,3823029523.928080,17744761099.975064,1174851,365640,578296,2118787
2013-12-27,NASDAQ (Q),239258276,74198788,295915184,609372248,9102296796.658518,5091532967.572290,10832748951.632998,25026578715.863806,1805531,274394,1641732,3721657
2013-12-27,CBSX (W),8868680,6935121,6480697,22284498,241483530.070000,458286736.170000,193364895.050000,893135161.290000,70379,10653,39062,120094
2013-12-27,NASDAQ PSX (X),6144755,5769012,5113325,17027092,182024207.919800,369340089.083600,180052137.515000,731416434.518400,33889,18647,27627,80163
2013-12-27,BATS BYX (Y),41469210,19838291,24751835,86059336,1256559676.017199,992622362.517000,849795824.086901,3098977862.621100,346407,84469,181730,612606
2013-12-27,BATS BZX (Z),143783688,73040109,95640933,312464730,4543755808.073404,4788670597.594802,3203740576.255012,12536166981.923218,1058910,268932,597765,1925607
2013-12-26,NYSE MKT (A),0,10621147,4962911,15584058,0.000000,66136472.245200,69333062.184000,135469534.429200,0,20352,16066,36418
2013-12-26,NASDAQ BX (B),57785165,20806268,32648241,111239674,1949618331.959198,1112325439.936699,1223908332.066800,4285852103.962697,481339,90930,258108,830377
2013-12-26,NSX (C),8155337,6889785,6563262,21608384,261876235.284400,198065777.260600,113961319.191700,573903331.736700,35512,14610,23070,73192
2013-12-26,NYSE (DN),85920327,27319175,60868185,174107687,3018922347.079811,1305009946.912298,1976998348.871591,6300930642.863700,408303,88173,218288,714764
2013-12-26,NASDAQ (DQ),624203968,231425896,423488083,1279117947,20030047059.052112,11635337706.752101,11948113603.975178,43613498369.779391,2562478,531433,1417660,4511571
2013-12-26,EDGA (J),45639475,22734496,27624354,95998325,1350604125.993203,1237116333.225600,728880169.523200,3316600628.742003,367400,96583,201671,665654
2013-12-26,EDGX (K),173058185,54051134,131346211,358455530,6524899751.756934,2454127320.585996,3988198063.090009,12967225135.432939,936013,161075,545639,1642727
2013-12-26,CHX (M),4017069,6535099,2565648,13117816,178754153.906000,738354695.350000,404895699.880000,1322004549.136000,289,1187,311,1787
2013-12-26,NYSE (N),420512392,0,0,420512392,15444817472.797434,0.000000,0.000000,15444817472.797434,1365274,0,0,1365274
2013-12-26,NYSE Arca (P),145437414,111148789,82335263,338921466,5999406265.860061,7294969480.257517,3332838027.142709,16627213773.260287,1138725,336551,572513,2047789
2013-12-26,NASDAQ (Q),232111301,66499837,289731200,588342338,9123739050.173898,4616096729.415116,10772186049.777985,24512021829.366999,1809875,255958,1618411,3684244
2013-12-26,CBSX (W),8242704,6706810,5322602,20272116,245780452.430000,466812125.420000,134288590.218500,846881168.068500,67315,10470,37551,115336
2013-12-26,NASDAQ PSX (X),4875240,6128064,4139232,15142536,152485475.615000,387594163.905000,149814659.730000,689894299.250000,30724,19405,25015,75144
2013-12-26,BATS BYX (Y),37938381,16698240,22112183,76748804,1245005737.986498,893268267.315097,768058669.387400,2906332674.688995,324764,74320,164397,563481
2013-12-26,BATS BZX (Z),134774312,65634714,87982686,288391712,4486264896.373001,4519562161.127506,2743358886.032019,11749185943.532526,1008222,248387,603789,1860398
2013-12-24,NYSE MKT (A),0,7257982,3403656,10661638,0.000000,35939915.173600,60453571.863000,96393487.036600,0,12584,13018,25602
2013-12-24,NASDAQ BX (B),33644400,12827005,21225211,67696616,1172726354.589998,653149316.089601,832469939.424400,2658345610.103999,280432,57973,160887,499292
2013-12-24,NSX (C),4756537,3226158,4338936,12321631,143897821.343000,80743547.728900,88974546.658600,313615915.730500,22896,8791,15440,47127
2013-12-24,NYSE (DN),56695140,16590555,40997453,114283148,1861248414.814894,811067230.422902,1494748139.571312,4167063784.809108,257329,60298,148091,465718
2013-12-24,NASDAQ (DQ),433816135,159810405,288665088,882291628,13289575857.591348,8469874409.897631,8784025061.805676,30543475329.294655,1630371,364915,910712,2905998
2013-12-24,EDGA (J),30323844,15502410,19859133,65685387,857217301.489600,797984148.361300,551607868.085599,2206809317.936499,234578,68685,132247,435510
2013-12-24,EDGX (K),108027319,30719531,90494563,229241413,3906095691.495494,1254865343.856802,3050873621.399191,8211834656.751487,568465,96471,383535,1048471
2013-12-24,CHX (M),2261512,4060710,1470082,7792304,82044136.860000,407783973.919600,111274695.445000,601102806.224600,188,1099,210,1497
2013-12-24,NYSE (N),272197263,0,0,272197263,9786707133.044774,0.000000,0.000000,9786707133.044774,881552,0,0,881552
2013-12-24,NYSE Arca (P),96736244,93495666,60708931,250940841,3802188655.295009,5838160595.553022,2688365992.453313,12328715243.301344,712940,255168,388071,1356179
2013-12-24,NASDAQ (Q),150397516,47164475,198908263,396470254,5582147069.766488,3194296545.088395,7523164184.154890,16299607799.009773,1068366,179997,1012673,2261036
2013-12-24,CBSX (W),5251942,1833461,3369529,10454932,157993484.660000,144445139.470000,84101906.810000,386540530.940000,42953,6848,25850,75651
2013-12-24,NASDAQ PSX (X),4113732,3934339,3358239,11406310,141360348.250000,238684260.197000,135002473.460000,515047081.907000,24778,13729,18868,57375
2013-12-24,BATS BYX (Y),24426751,11611059,14512339,50550149,765845768.185999,657950621.616400,507434354.401902,1931230744.204301,202911,53183,105187,361281
2013-12-24,BATS BZX (Z),88464232,47541469,57159275,193164976,2754659579.436811,3216187199.137095,1915665393.986299,7886512172.560205,642026,181708,368466,1192200
2013-12-23,NYSE MKT (A),0,11356699,5768499,17125198,0.000000,66883467.775500,99648521.157000,166531988.932500,0,24412,20042,44454
2013-12-23,NASDAQ BX (B),81354052,27414231,49093750,157862033,2769294392.444997,1390156515.137600,1967142622.338120,6126593529.920717,657710,115764,367484,1140958
2013-12-23,NSX (C),9846457,6682380,7953819,24482656,291176910.042200,242909730.535800,185725024.844999,719811665.422999,48184,18399,31106,97689
2013-12-23,NYSE (DN),126936597,34221617,92494896,253653110,4183756352.505487,1708337807.538703,3430333490.085704,9322427650.129894,606018,116646,354982,1077646
2013-12-23,NASDAQ (DQ),913537825,305423830,635127819,1854089474,28676709375.610059,15211293631.108114,19914116322.840546,63802119329.558719,3583082,672694,1965407,6221183
2013-12-23,EDGA (J),63582859,30597213,40654338,134834410,1960196283.574003,1524873650.540102,1197743491.396990,4682813425.511095,507506,129048,280931,917485
2013-12-23,EDGX (K),233332948,66925488,187444045,487702481,8262987005.593836,3236587268.018595,6588193483.725491,18087767757.337922,1284520,205062,822733,2312315
2013-12-23,CHX (M),15423761,10205092,3206249,28835102,724739875.135400,822397588.676400,210706994.155500,1757844457.967300,362,1598,373,2333
2013-12-23,NYSE (N),611174988,0,0,611174988,22706778669.056092,0.000000,0.000000,22706778669.056092,1847128,0,0,1847128
2013-12-23,NYSE Arca (P),200304491,178459006,136057383,514820880,7954741619.542049,11887224495.913859,5814443055.988131,25656409171.444039,1512079,468333,844631,2825043
2013-12-23,NASDAQ (Q),329978775,93029775,441022405,864030955,12878297608.040334,6556342685.308785,17086755488.246178,36521395781.595297,2450049,340453,2182840,4973342
2013-12-23,CBSX (W),10890045,5524008,7489544,23903597,313114341.260000,428605085.970000,190560217.249000,932279644.479000,87944,12991,54209,155144
2013-12-23,NASDAQ PSX (X),8021324,7566961,7029895,22618180,249806996.010000,463528610.274000,247995236.370000,961330842.654000,49169,22690,39434,111293
2013-12-23,BATS BYX (Y),56728738,23110214,33872081,113711033,1800404566.468503,1293002828.351300,1106460623.767192,4199868018.586995,481552,101674,248223,831449
2013-12-23,BATS BZX (Z),193062655,92906441,134862555,420831651,6265236418.803501,6427783496.468404,4345321889.109493,17038341804.381398,1412943,337123,848478,2598544
2013-12-20,NYSE MKT (A),0,57875415,6182524,64057939,0.000000,317198309.767800,93089329.187000,410287638.954800,0,29267,21668,50935
2013-12-20,NASDAQ BX (B),117576671,41622837,71120641,230320149,4080089434.344997,2212650495.403499,2655180547.525909,8947920477.274405,843043,158298,472505,1473846
2013-12-20,NSX (C),14556154,8397914,12297884,35251952,438465145.884000,390518706.511300,279888262.049800,1108872114.445100,67202,21102,43782,132086
2013-12-20,NYSE (DN),159795099,43383663,105217440,308396202,5335422893.604191,2390195395.749501,3225662305.442499,10951280594.796191,762646,144482,426916,1334044
2013-12-20,NASDAQ (DQ),1313126356,431159445,1290521102,3034806903,42790235634.084629,28952479873.234969,39166285944.729758,110909001452.049356,4337292,792211,2408680,7538183
2013-12-20,EDGA (J),93918814,45108932,57588424,196616170,2811432263.879020,2387238371.866595,1668866436.476415,6867537072.222030,677555,169263,372574,1219392
2013-12-20,EDGX (K),272862311,88382702,228193792,589438805,9876812052.945179,5321070994.518703,7016893031.730158,22214776079.194040,1501748,267098,983297,2752143
2013-12-20,CHX (M),14420729,15849711,7391658,37662098,510507037.584000,1231700117.212800,364404557.365600,2106611712.162400,411,2468,883,3762
2013-12-20,NYSE (N),1968170877,0,0,1968170877,76910671012.486835,0.000000,0.000000,76910671012.486835,2335128,0,0,2335128
2013-12-20,NYSE Arca (P),287233608,262876641,193105453,743215702,11294336182.116672,19018082056.220847,7311048199.501912,37623466437.839431,1958204,591455,1098765,3648424
2013-12-20,NASDAQ (Q),473532023,140461748,1274839164,1888832935,18439164467.456359,10843231268.573185,45000004887.161548,74282400623.191092,3257773,479488,2910454,6647715
2013-12-20,CBSX (W),14378482,7103766,8045840,29528088,427988196.110000,619119532.880000,218034772.180000,1265142501.170000,105130,17609,56480,179219
2013-12-20,NASDAQ PSX (X),14997005,10284458,10343103,35624566,459883909.180900,640592176.055000,324307831.395000,1424783916.630900,76804,32728,51740,161272
2013-12-20,BATS BYX (Y),78597500,30372414,44730254,153700168,2622608820.485011,1777883916.365998,1595063961.063590,5995556697.914599,587379,124365,301296,1013040
2013-12-20,BATS BZX (Z),277412790,131499841,197605313,606517944,9096621503.084934,9139794839.806424,6063314382.848908,24299730725.740266,1837147,456784,1148716,3442647
2013-12-19,NYSE MKT (A),0,9832578,7192365,17024943,0.000000,63357162.022900,112408686.082000,175765848.104900,0,21264,21800,43064
2013-12-19,NASDAQ BX (B),98860470,36785041,57676060,193321571,3552838115.789991,1858680945.501801,2166153921.548912,7577672982.840704,781597,141923,422773,1346293
2013-12-19,NSX (C),12366589,7199076,8456599,28022264,402401947.047400,249777836.875300,225329591.221600,877509375.144300,64807,18095,35705,118607
2013-12-19,NYSE (DN),158574109,40357462,91022161,289953732,5479657671.189172,2069956965.173907,3092780266.988629,10642394903.351708,748827,135786,377374,1261987
2013-12-19,NASDAQ (DQ),1129812776,339366050,643486937,2112665763,35716251238.006423,19402217856.899147,19397850382.625086,74516319477.530656,4090142,734365,2006098,6830605
2013-12-19,EDGA (J),85274338,46098732,44505007,175878077,2629209868.290997,2296276985.285894,1309159048.024005,6234645901.600896,653365,178049,308964,1140378
2013-12-19,EDGX (K),263479065,83442300,169720700,516642065,9372056976.023965,4629342452.524290,6169532099.296829,20170931527.845084,1468394,267160,810928,2546482
2013-12-19,CHX (M),6733528,13377530,3637323,23748381,272459287.752500,1195387702.203000,219099570.592500,1686946560.548000,393,4060,898,5351
2013-12-19,NYSE (N),700715264,0,0,700715264,26180619859.256061,0.000000,0.000000,26180619859.256061,2015183,0,0,2015183
2013-12-19,NYSE Arca (P),266052000,227808447,145966889,639827336,10499805510.646569,14516764395.227638,6216938041.652400,31233507947.526607,2009863,575727,926001,3511591
2013-12-19,NASDAQ (Q),429357000,129567775,442209346,1001134121,16632681155.923427,9215499100.243679,17219973232.297377,43068153488.464483,3094125,461711,2300036,5855872
2013-12-19,CBSX (W),12706344,5729750,7650184,26086278,357588309.880000,490481050.560000,224867821.390000,1072937181.830000,91056,13752,47477,152285
2013-12-19,NASDAQ PSX (X),12380727,10623077,9241354,32245158,406592102.680000,642913696.748600,348749976.630000,1398255776.058600,78266,31353,46047,155666
2013-12-19,BATS BYX (Y),66586621,28930827,34737544,130254992,2229076393.432808,1584126236.886597,1193064840.189297,5006267470.508702,541499,111443,254504,907446
2013-12-19,BATS BZX (Z),255682393,127769348,148849041,532300782,8405783675.250706,8566188949.105309,4962444592.067900,21934417216.423915,1802051,447050,939250,3188351
2013-12-18,NYSE MKT (A),0,11233841,7317289,18551130,0.000000,85579810.820300,115916837.725000,201496648.545300,0,25257,22309,47566
2013-12-18,NASDAQ BX (B),127500534,52795328,68461378,248757240,4643764628.841024,2799284924.427196,2798223179.611899,10241272732.880119,964566,194980,474494,1634040
2013-12-18,NSX (C),17696208,9598643,10439441,37734292,517537730.798300,405683581.822100,281640168.897399,1204861481.517799,74185,24086,41045,139316
2013-12-18,NYSE (DN),171091541,51969734,99321969,322383244,5865357903.233429,2997198301.852195,3713024834.430952,12575581039.516576,774718,166433,384548,1325699
2013-12-18,NASDAQ (DQ),1308996365,432796128,742051670,2483844163,42170559596.172953,25902097577.478292,23858192241.616450,91930849415.267695,4503903,814813,2175568,7494284
2013-12-18,EDGA (J),112186831,60996787,57026513,230210131,3446633005.428193,3173242164.653995,1824893668.629505,8444768838.711693,801947,234615,369905,1406467
2013-12-18,EDGX (K),323406655,121513579,201515468,646435702,11275461363.899940,6958012486.536976,7322532540.329361,25556006390.766277,1723016,371760,960996,3055772
2013-12-18,CHX (M),5772584,17489929,7514390,30776903,222812921.551000,1909947062.890001,378761136.968200,2511521121.409201,412,8134,738,9284
2013-12-18,NYSE (N),883657098,0,0,883657098,33325859054.317001,0.000000,0.000000,33325859054.317001,2608605,0,0,2608605
2013-12-18,NYSE Arca (P),332324209,351328755,188529623,872182587,12717590559.714397,23921860185.544624,8398497004.838027,45037947750.097048,2329449,871127,1142038,4342614
2013-12-18,NASDAQ (Q),607764228,228743329,567198257,1403705814,23524301733.789385,17523951740.452403,22234297633.558827,63282551107.800615,4641932,787462,3096758,8526152
2013-12-18,CBSX (W),13887491,5419036,7887600,27194127,402639039.610000,463891988.240000,193674485.300000,1060205513.150000,101842,18322,53588,173752
2013-12-18,NASDAQ PSX (X),15287876,17659044,10956070,43902990,499710588.485000,1213102746.859999,452607297.000800,2165420632.345799,95409,52901,55766,204076
2013-12-18,BATS BYX (Y),82851204,39227985,41826877,163906066,2764108409.193009,2242538246.745490,1476982834.482104,6483629490.420603,650765,156164,294900,1101829
2013-12-18,BATS BZX (Z),342745053,212176467,192406994,747328514,11056365071.162570,14260999098.884760,6744869646.216384,32062233816.263714,2323411,708817,1137364,4169592
2013-12-17,NYSE MKT (A),0,10638664,7560293,18198957,0.000000,98564808.227000,137822164.197000,236386972.424000,0,23885,25946,49831
2013-12-17,NASDAQ BX (B),88300336,28613765,56497096,173411197,3117917455.185995,1383876828.796600,1959066815.431201,6460861099.413796,682886,119590,375914,1178390
2013-12-17,NSX (C),11441459,7134746,8823493,27399698,338738465.654700,300859086.332900,217466156.649700,857063708.637300,52973,15264,33273,101510
2013-12-17,NYSE (DN),136876644,30461962,86671719,254010325,4747454156.644019,1554756153.011294,2902404425.272596,9204614734.927909,669408,100174,338445,1108027
2013-12-17,NASDAQ (DQ),1115251144,279023684,686348737,2080623565,36797101955.336995,14532402856.117300,19181828029.323202,70511332840.777497,3842363,562385,1942951,6347699
2013-12-17,EDGA (J),76967067,34633517,46470926,158071510,2448073530.108803,1669921321.025999,1306994962.973289,5424989814.108091,592701,135781,305126,1033608
2013-12-17,EDGX (K),211050434,58104872,152175547,421330853,7728237197.629705,3177067148.563804,5065709197.241274,15971013543.434783,1211314,189864,717782,2118960
2013-12-17,CHX (M),7231020,23087397,5035979,35354396,325266662.225500,1238302904.080000,188108436.020000,1751678002.325500,580,2364,899,3843
2013-12-17,NYSE (N),667686303,0,0,667686303,25434690039.565198,0.000000,0.000000,25434690039.565198,1985200,0,0,1985200
2013-12-17,NYSE Arca (P),233970042,180681438,160331253,574982733,9461630530.403372,11404132843.974608,5763895051.204371,26629658425.582351,1767566,468185,940485,3176236
2013-12-17,NASDAQ (Q),407157493,102133331,454181851,963472675,16175278847.721050,6983344308.672082,16340362645.537574,39498985801.930706,3068720,387008,2445295,5901023
2013-12-17,CBSX (W),12926460,4125022,8583895,25635377,364323026.980000,231681416.350000,184863414.050000,780867857.380000,87828,11877,47611,147316
2013-12-17,NASDAQ PSX (X),9424713,7954024,8255824,25634561,291915794.150000,470966577.931000,272319555.405000,1035201927.486000,59557,23806,38717,122080
2013-12-17,BATS BYX (Y),61780726,22244730,35548060,119573516,2052103181.820898,1220752704.119401,1093447597.234097,4366303483.174396,508474,96232,244587,849293
2013-12-17,BATS BZX (Z),232789791,101034109,149195112,483019012,7738586534.473307,6364189345.841897,4412850265.425208,18515626145.740412,1645561,366263,886977,2898801
2013-12-16,NYSE MKT (A),0,10546694,6584539,17131233,0.000000,73844458.896500,119600227.521500,193444686.418000,0,23718,25141,48859
2013-12-16,NASDAQ BX (B),85759935,29290036,55787087,170837058,3159221768.174987,1414314366.667503,1890618303.178598,6464154438.021088,686304,117116,372682,1176102
2013-12-16,NSX (C),12647491,15104486,10266332,38018309,419760069.253000,437610521.925600,240094564.532099,1097465155.710699,70022,18145,46717,134884
2013-12-16,NYSE (DN),135471752,32011010,94080312,261563074,4852410555.136210,1649589995.651803,3041802776.698212,9543803327.486225,682281,111237,359142,1152660
2013-12-16,NASDAQ (DQ),1037215171,292279406,696011693,2025506270,35070393796.044897,14049096460.463822,19438717163.564398,68558207420.073117,3750876,605462,1985840,6342178
2013-12-16,EDGA (J),72783227,33656141,48104896,154544264,2277680496.295799,1647421775.514506,1217966398.266999,5143068670.077304,558358,131367,297150,986875
2013-12-16,EDGX (K),222708779,62949896,163449566,449108241,8160287204.793734,3307755693.597999,5253405964.292935,16721448862.684668,1295106,197687,764339,2257132
2013-12-16,CHX (M),9671896,15288340,3688607,28648843,518854211.640000,1022390950.885000,130339070.487500,1671584233.012500,412,2896,561,3869
2013-12-16,NYSE (N),681153285,0,0,681153285,25740619040.729219,0.000000,0.000000,25740619040.729219,1985526,0,0,1985526
2013-12-16,NYSE Arca (P),240565621,195310322,177985448,613861391,9654538444.287962,12279524891.845810,6023708726.422575,27957772062.556347,1782596,493225,939063,3214884
2013-12-16,NASDAQ (Q),405127666,108700815,476653286,990481767,16468699169.765989,7543962595.837000,17259235598.820018,41271897364.423007,3112565,388031,2453848,5954444
2013-12-16,CBSX (W),11203534,7985805,7980673,27170012,339922427.330000,446468989.360000,173564462.110000,959955878.800000,88937,12700,50350,151987
2013-12-16,NASDAQ PSX (X),9644511,7735187,15088394,32468092,301104897.865000,464459505.746800,336912125.310001,1102476528.921801,66404,23002,45437,134843
2013-12-16,BATS BYX (Y),59054098,23482407,37591120,120127625,1950413892.739002,1271658219.377502,1094354985.420699,4316427097.537203,490878,94830,240408,826116
2013-12-16,BATS BZX (Z),227515250,108354780,152722650,488592680,7689512014.462355,6737678536.181179,4497079128.494073,18924269679.137607,1641904,357315,891239,2890458
2013-12-13,NYSE MKT (A),0,14709412,5314111,20023523,0.000000,178322701.645700,106314262.223000,284636963.868700,0,24783,21036,45819
2013-12-13,NASDAQ BX (B),84016640,28543772,45256940,157817352,3145685237.780009,1473585518.204201,1981529728.371509,6600800484.355719,680956,112359,350796,1144111
2013-12-13,NSX (C),11105367,14239039,9871065,35215471,350038595.085000,442328523.513800,221144247.812200,1013511366.411000,53962,13069,33428,100459
2013-12-13,NYSE (DN),126581207,31760617,82582455,240924279,4392771525.301409,1655602964.743900,3045852206.619414,9094226696.664723,627750,103654,328187,1059591
2013-12-13,NASDAQ (DQ),982021908,271819626,564909090,1818750624,31405016554.117259,14477297341.385644,18370481984.658270,64252795880.161173,3535303,547645,1794819,5877767
2013-12-13,EDGA (J),72596597,35648830,37889132,146134559,2222536060.092001,1817071050.769501,1161720078.642501,5201327189.504003,550161,138109,269102,957372
2013-12-13,EDGX (K),203925835,59285377,144541076,407752288,7468166582.536995,3357869654.713003,5079315615.882612,15905351853.132610,1208958,185320,701931,2096209
2013-12-13,CHX (M),10063273,13078361,7554752,30696386,416580766.365300,1056815146.383700,432942099.602000,1906338012.351000,699,2703,498,3900
2013-12-13,NYSE (N),638705570,0,0,638705570,22721368890.903776,0.000000,0.000000,22721368890.903776,1898555,0,0,1898555
2013-12-13,NYSE Arca (P),251084144,177881720,137675423,566641287,9485772275.202963,11688938672.355492,5940144958.484116,27114855906.042571,1721303,448410,879002,3048715
2013-12-13,NASDAQ (Q),390193928,106919215,407100992,904214135,15266671338.830058,7947772895.309887,16437823457.869302,39652267692.009247,2923045,382713,2229596,5535354
2013-12-13,CBSX (W),9915763,3847293,5679560,19442616,290086846.600000,217707625.930000,148538253.840000,656332726.370000,77906,10187,42461,130554
2013-12-13,NASDAQ PSX (X),9907007,7046011,6951438,23904456,292075942.055000,484687290.289000,283573157.185000,1060336389.529000,57178,24616,36669,118463
2013-12-13,BATS BYX (Y),57206405,25210675,30830434,113247514,1858442709.044002,1295044707.045903,1104175078.040907,4257662494.130812,460144,97354,225722,783220
2013-12-13,BATS BZX (Z),229986392,112077875,130839275,472903542,7519839927.948224,7239304776.232550,4808893459.865160,19568038164.045934,1596402,382258,839897,2818557
2013-12-12,NYSE MKT (A),0,15145141,5803603,20948744,0.000000,83234446.964000,102304076.652000,185538523.616000,0,20813,19943,40756
2013-12-12,NASDAQ BX (B),88343948,32485998,50641864,171471810,3105094500.799991,1696783313.987397,1897962046.940899,6699839861.728287,706162,132083,376068,1214313
2013-12-12,NSX (C),13033597,10000146,12550891,35584634,410117697.080000,429121864.351900,272585892.046200,1111825453.478100,67473,19102,45436,132011
2013-12-12,NYSE (DN),139541420,38433254,97252358,275227032,4699193796.179214,2087378635.960803,3232967012.410617,10019539444.550634,712973,125115,390488,1228576
2013-12-12,NASDAQ (DQ),1066784510,314885932,677191538,2058861980,33344050186.642757,14976816577.093125,20321602544.540259,68642469308.276141,3830265,666275,2029695,6526235
2013-12-12,EDGA (J),78139855,38801259,45085670,162026784,2353112083.114598,1732681229.604804,1310910608.756995,5396703921.476397,601651,152187,310130,1063968
2013-12-12,EDGX (K),229154322,70022155,162780331,461956808,7957502047.751250,3502343725.236198,5364600366.360040,16824446139.347488,1345536,220748,792293,2358577
2013-12-12,CHX (M),8859463,6632848,5714899,21207210,330869746.641600,565962139.330000,313423261.499400,1210255147.471000,409,2827,367,3603
2013-12-12,NYSE (N),753198442,0,0,753198442,27146361995.156598,0.000000,0.000000,27146361995.156598,2087819,0,0,2087819
2013-12-12,NYSE Arca (P),267386329,202651714,163521247,633559290,10002334447.510067,12931413026.084951,6541441504.926343,29475188978.521361,1900812,515458,982853,3399123
2013-12-12,NASDAQ (Q),431803192,130102781,472759240,1034665213,16583987214.749926,9870463568.619395,17933759068.307241,44388209851.676562,3239440,452625,2533647,6225712
2013-12-12,CBSX (W),10393619,5324567,6852077,22570263,301257460.730000,288745253.980000,167839592.620000,757842307.330000,80317,13208,48001,141526
2013-12-12,NASDAQ PSX (X),10697289,9870757,8168427,28736473,342612999.995000,693859914.736000,341874993.253600,1378347907.984600,64113,30405,40016,134534
2013-12-12,BATS BYX (Y),61384090,28506343,34061452,123951885,1997979432.404000,1521345107.584703,1156433126.220503,4675757666.209206,504322,119508,243328,867158
2013-12-12,BATS BZX (Z),252823983,129583151,153074572,535481706,8075137110.916180,8648796521.257817,4888911832.451049,21612845464.625046,1761476,463070,935528,3160074
2013-12-11,NYSE MKT (A),0,10089009,5637003,15726012,0.000000,66265835.685500,85226465.358000,151492301.043500,0,22166,19624,41790
2013-12-11,NASDAQ BX (B),93692122,36172652,55823416,185688190,3484211871.359892,1910216641.349300,2141740682.889295,7536169195.598487,737885,146782,410834,1295501
2013-12-11,NSX (C),15685510,9500130,14098607,39284247,458097308.990000,324811629.227700,269030223.783599,1051939162.001299,68046,20992,46322,135360
2013-12-11,NYSE (DN),146451856,40041531,97901825,284395212,5028651772.549410,2164110808.862202,3304341700.405597,10497104281.817209,682690,139168,370801,1192659
2013-12-11,NASDAQ (DQ),1085071632,322824061,668535791,2076431484,35653536279.766379,18335324845.363884,20286754284.660488,74275615409.790751,3898778,687026,2006677,6592481
2013-12-11,EDGA (J),83933060,42391069,46578986,172903115,2599613168.728801,2118482706.237199,1329439768.590896,6047535643.556896,634977,168742,318087,1121806
2013-12-11,EDGX (K),243445849,77790727,172660606,493897182,8894922267.545885,4108388259.989685,5666877328.407342,18670187855.942912,1387790,258629,799238,2445657
2013-12-11,CHX (M),11426628,9224233,8915878,29566739,452737288.085900,709375114.743000,502600487.142600,1664712889.971500,409,2631,486,3526
2013-12-11,NYSE (N),741203167,0,0,741203167,27173392546.943412,0.000000,0.000000,27173392546.943412,2157122,0,0,2157122
2013-12-11,NYSE Arca (P),264124147,244341403,167298878,675764428,10346254956.313264,15189041320.779057,6748818512.797341,32284114789.889662,1846637,564869,959550,3371056
2013-12-11,NASDAQ (Q),456811765,147641260,488525519,1092978544,18265580333.356137,11082754120.221347,18514912733.242403,47863247186.819887,3465412,511038,2574512,6550962
2013-12-11,CBSX (W),11757643,4167701,6799145,22724489,350186092.430000,271749968.600000,160865436.800000,782801497.830000,91545,14617,48031,154193
2013-12-11,NASDAQ PSX (X),9940251,10472093,8103485,28515829,293345409.270000,675021519.225000,297147201.890000,1265514130.385000,60371,32780,39613,132764
2013-12-11,BATS BYX (Y),63571676,29781933,35418437,128772046,2122960252.624999,1681740081.031198,1178168609.325103,4982868942.981300,515900,129801,251928,897629
2013-12-11,BATS BZX (Z),269310255,142651041,155730335,567691631,9109933828.860071,9593958016.374183,5168794322.818563,23872686168.052817,1882437,499376,967525,3349338
2013-12-10,NYSE MKT (A),0,11229711,5137925,16367636,0.000000,73149749.163300,91408466.454000,164558215.617300,0,24764,19266,44030
2013-12-10,NASDAQ BX (B),81652995,25914550,49209466,156777011,2985466177.814985,1316027592.665399,1817517944.719013,6119011715.199397,666700,107756,376157,1150613
2013-12-10,NSX (C),12142369,9426474,13634275,35203118,360806096.939700,547561610.645500,285772712.094600,1194140419.679800,53747,17427,42541,113715
2013-12-10,NYSE (DN),134307351,31639897,93068441,259015689,4521602169.739410,1509021981.823905,3345760929.467912,9376385081.031227,623068,104767,365218,1093053
2013-12-10,NASDAQ (DQ),1019067441,272134547,692317386,1983519374,33618483786.568944,12638903082.801832,21131009288.553926,67388396157.924702,3688527,584896,1992650,6266073
2013-12-10,EDGA (J),71867846,29993097,40352617,142213560,2145370777.401207,1379264814.401696,1152588627.168408,4677224218.971311,549385,124229,282022,955636
2013-12-10,EDGX (K),214369159,63625046,165786748,443780953,7828775601.284386,3078360986.726588,5675307069.003032,16582443657.014006,1250933,203851,793947,2248731
2013-12-10,CHX (M),8798122,13203786,6156700,28158608,392906175.173800,850599829.310000,266876031.600400,1510382036.084200,508,2376,588,3472
2013-12-10,NYSE (N),632675542,0,0,632675542,23625530447.742553,0.000000,0.000000,23625530447.742553,2044939,0,0,2044939
2013-12-10,NYSE Arca (P),236752882,169419439,155295989,561468310,9661508782.142560,10462159087.451378,6250526360.392012,26374194229.985950,1780411,457028,944558,3181997
2013-12-10,NASDAQ (Q),406191370,105034739,452248573,963474682,16394332970.656157,7616612958.348181,17122007184.795417,41132953113.799755,3088333,379491,2564770,6032594
2013-12-10,CBSX (W),11257465,2739163,6457357,20453985,340576867.810000,171114015.660000,157484818.320000,669175701.790000,87883,10372,48461,146716
2013-12-10,NASDAQ PSX (X),9839188,8361215,8645681,26846084,282597604.900000,500818850.565000,278961444.160000,1062377899.625000,53143,25337,40533,119013
2013-12-10,BATS BYX (Y),57497457,20915342,33703183,112115982,1942758670.109500,1043159380.716199,1100008549.698203,4085926600.523902,474651,95712,249834,820197
2013-12-10,BATS BZX (Z),221717571,105533574,145374395,472625540,7507338206.734976,6488861858.657406,4805037965.507965,18801238030.900347,1575029,377837,916052,2868918
2013-12-09,NYSE MKT (A),0,12206779,6034742,18241521,0.000000,70986427.178200,112399153.015000,183385580.193200,0,24988,22404,47392
2013-12-09,NASDAQ BX (B),81830565,24259556,47019181,153109302,3050602153.905003,1256933111.737001,1977595937.906297,6285131203.548301,657326,101712,365553,1124591
2013-12-09,NSX (C),11893957,10784762,9907215,32585934,346734474.523500,485716932.684400,222447006.365900,1054898413.573800,54023,21296,36710,112029
2013-12-09,NYSE (DN),136245723,32982570,82420456,251648749,4487188823.434270,1698087394.396805,2809745029.232068,8995021247.063143,632783,104449,338576,1075808
2013-12-09,NASDAQ (DQ),1017973045,259810936,626842688,1904626669,32680085973.471809,13171918613.346116,19231159624.245624,65083164211.063549,3711566,571491,1908295,6191352
2013-12-09,EDGA (J),73948133,28768965,39583133,142300231,2214279861.632910,1366269514.163499,1146330794.843799,4726880170.640208,558112,114903,280547,953562
2013-12-09,EDGX (K),211381717,61292130,153763547,426437394,7705985318.720419,3046433352.464506,5312336593.195945,16064755264.380870,1258372,191166,767896,2217434
2013-12-09,CHX (M),8301781,5435686,4097875,17835342,352368078.184900,364515856.070000,357840526.103400,1074724460.358300,271,1562,482,2315
2013-12-09,NYSE (N),695770660,0,0,695770660,25902410845.438771,0.000000,0.000000,25902410845.438771,1955243,0,0,1955243
2013-12-09,NYSE Arca (P),233775832,160475565,144047848,538299245,9409399025.725052,9161520099.271174,5824037092.449134,24394956217.445360,1618554,424693,885904,2929151
2013-12-09,NASDAQ (Q),373777698,89627078,434352972,897757748,15183330406.481512,6498574408.876904,16528939854.956355,38210844670.314771,2854265,341172,2193649,5389086
2013-12-09,CBSX (W),11335602,3081823,6277395,20694820,322106194.350000,154631537.910000,155057062.545400,631794794.805400,86238,9581,45457,141276
2013-12-09,NASDAQ PSX (X),8991192,6639000,7477336,23107528,272116989.805000,413966334.135000,257721898.648000,943805222.588000,52423,20956,36098,109477
2013-12-09,BATS BYX (Y),59212574,19479983,31113262,109805819,2089100329.917993,1015038592.729701,1073551518.899202,4177690441.546896,480316,84790,228101,793207
2013-12-09,BATS BZX (Z),205609193,87304782,126690857,419604832,6853648118.259990,5491754705.226489,4193249842.274041,16538652665.760520,1493257,336489,832609,2662355
2013-12-06,NYSE MKT (A),0,8368074,5418845,13786919,0.000000,54975750.088800,105655990.171000,160631740.259800,0,19561,18153,37714
2013-12-06,NASDAQ BX (B),79575701,28231114,45683301,153490116,2761481965.615002,1547733059.792801,1687111064.919297,5996326090.327100,542317,103338,292827,938482
2013-12-06,NSX (C),13550783,7332738,11011008,31894529,358805103.217600,424837982.905100,205337118.048200,988980204.170900,51697,15734,32917,100348
2013-12-06,NYSE (DN),141382497,37063944,89054506,267500947,4626669827.888173,1981658591.110596,2952665197.796587,9560993616.795356,611767,112750,328889,1053406
2013-12-06,NASDAQ (DQ),1015264484,263096746,631332120,1909693350,31812566683.189062,14875991827.347999,19027862827.565116,65716421338.102177,3234125,513303,1706091,5453519
2013-12-06,EDGA (J),72472815,34880542,38961011,146314368,2208556397.152702,1786854235.672102,1145540234.627900,5140950867.452704,479494,122546,238206,840246
2013-12-06,EDGX (K),223645884,71224641,157173327,452043852,7794266364.817208,3954554230.711203,5215541736.401285,16964362331.929696,1114426,203162,649388,1966976
2013-12-06,CHX (M),8641482,9367609,5191412,23200503,381977528.240400,1157354577.044899,415328674.341700,1954660779.626999,302,3580,440,4322
2013-12-06,NYSE (N),671100961,0,0,671100961,25006346804.111214,0.000000,0.000000,25006346804.111214,1716354,0,0,1716354
2013-12-06,NYSE Arca (P),235227054,207448348,142557836,585233238,8971450589.605005,14116962680.307309,5874271230.383019,28962684500.295333,1371175,472121,773237,2616533
2013-12-06,NASDAQ (Q),390680505,119103873,430564816,940349194,15224640496.679973,9180001463.698308,16717915673.887771,41122557634.266052,2399774,382824,1785838,4568436
2013-12-06,CBSX (W),12548236,4840308,7165572,24554116,349486455.880000,311797059.730000,174142610.800000,835426126.410000,90428,10154,47892,148474
2013-12-06,NASDAQ PSX (X),10542413,10218160,6874889,27635462,276015603.075000,666790411.435000,253732170.945000,1196538185.455000,52053,29051,31911,113015
2013-12-06,BATS BYX (Y),57552906,23629119,31429564,112611589,1934803926.191009,1376929328.932800,1078178263.181007,4389911518.304816,383193,93998,189193,666384
2013-12-06,BATS BZX (Z),219097335,112169793,126728444,457995572,6993055576.529991,7885627943.538508,4236936183.448306,19115619703.516805,1375198,359748,706243,2441189
2013-12-05,NYSE MKT (A),0,9533843,6410024,15943867,0.000000,90794367.205500,119791905.945000,210586273.150500,0,20107,21810,41917
2013-12-05,NASDAQ BX (B),85181431,28194974,47568692,160945097,2889959594.745505,1446600985.353798,1902302184.124297,6238862764.223600,576119,105271,301342,982732
2013-12-05,NSX (C),16740011,7845707,13340369,37926087,423519369.440000,278495099.272400,268797949.370600,970812418.083000,59407,16752,37602,113761
2013-12-05,NYSE (DN),149757312,33825242,93314838,276897392,4655308823.345370,1886256731.616396,3258456913.453859,9800022468.415625,619981,102147,339890,1062018
2013-12-05,NASDAQ (DQ),1061749164,280500052,662985184,2005234400,32957523360.770528,13951052603.378945,20184375314.606993,67092951278.756466,3265129,483403,1775441,5523973
2013-12-05,EDGA (J),78876213,34400381,44445095,157721689,2320680348.669999,1624595595.297199,1319326657.623001,5264602601.590199,512963,120275,261331,894569
2013-12-05,EDGX (K),260138117,72008739,178994949,511141805,8920949630.317981,3883962646.249292,6044465270.244665,18849377546.811938,1336323,209433,771920,2317676
2013-12-05,CHX (M),16301767,7040108,5962942,29304817,521043700.444800,695700584.150000,333040661.495400,1549784946.090200,305,2637,571,3513
2013-12-05,NYSE (N),699954552,0,0,699954552,25625500837.798915,0.000000,0.000000,25625500837.798915,1744536,0,0,1744536
2013-12-05,NYSE Arca (P),249523672,202755022,165981480,618260174,9313416153.159991,12888658088.401621,6618313636.933815,28820387878.495427,1453199,441053,864538,2758790
2013-12-05,NASDAQ (Q),403584073,113195275,462247580,979026928,15667292938.030669,8517369332.373504,17866032614.039588,42050694884.443761,2456044,367479,1870871,4694394
2013-12-05,CBSX (W),15484184,4300824,8244528,28029536,407082223.910000,257747777.030000,184292560.850500,849122561.790500,102871,10548,55641,169060
2013-12-05,NASDAQ PSX (X),12300202,8934955,9417995,30653152,301596489.815000,602932592.285000,330186272.635000,1234715354.735000,57668,25949,38943,122560
2013-12-05,BATS BYX (Y),56858078,26156778,34410376,117425232,1837443061.141004,1474048639.443999,1153852383.196399,4465344083.781402,372988,99650,194250,666888
2013-12-05,BATS BZX (Z),236416455,113987035,150411622,500815112,7301605424.579998,7639964554.105906,5197223363.212194,20138793341.898098,1440646,360059,805617,2606322
2013-12-04,NYSE MKT (A),0,8626549,5681366,14307915,0.000000,51654420.885300,94057028.219100,145711449.104400,0,19116,19977,39093
2013-12-04,NASDAQ BX (B),94773451,33277105,49163729,177214285,3354600820.900006,1752607203.743601,1910452948.484903,7017660973.128510,652232,126306,316908,1095446
2013-12-04,NSX (C),16612491,6888982,12799051,36300524,461051947.900000,332569727.605900,253162193.981100,1046783869.487000,63486,14744,36169,114399
2013-12-04,NYSE (DN),149480131,37092651,89318905,275891687,4862545806.622586,2013243401.667000,2997901521.266918,9873690729.556504,665606,110250,347390,1123246
2013-12-04,NASDAQ (DQ),1127532461,318458624,660931528,2106922613,36096882572.822127,15316435435.998204,19806431756.626171,71219749765.446502,3638333,542748,1805263,5986344
2013-12-04,EDGA (J),81354145,39631182,42605925,163591252,2421961202.292499,1916356327.643500,1195585229.473398,5533902759.409397,545758,140657,252371,938786
2013-12-04,EDGX (K),254577838,82628961,175822765,513029564,8814528498.935017,4518218758.149597,5780112895.707521,19112860152.792135,1273393,237807,730597,2241797
2013-12-04,CHX (M),8018928,12114170,3749517,23882615,321282338.659500,1079731527.969800,462976555.943500,1863990422.572800,303,3728,569,4600
2013-12-04,NYSE (N),756250041,0,0,756250041,27492795638.980592,0.000000,0.000000,27492795638.980592,1956093,0,0,1956093
2013-12-04,NYSE Arca (P),285130164,237686564,165356886,688173614,10256495713.705005,15385661580.895951,6429953461.106885,32072110755.707841,1626430,537154,870702,3034286
2013-12-04,NASDAQ (Q),469776451,134021561,477311911,1081109923,18008522506.551489,9572500712.316011,17757885012.087662,45338908230.955162,2759979,413981,1938802,5112762
2013-12-04,CBSX (W),14045877,3982950,7926336,25955163,397584194.630000,255897495.905200,187059561.652000,840541252.187200,102213,11361,52269,165843
2013-12-04,NASDAQ PSX (X),13418589,12067909,9079846,34566344,343252129.350000,755336475.880000,302612860.390000,1401201465.620000,64766,33951,37855,136572
2013-12-04,BATS BYX (Y),63276369,29985284,33624920,126886573,2056429321.585002,1698422317.283796,1192389865.395002,4947241504.263800,427158,118031,205584,750773
2013-12-04,BATS BZX (Z),279487455,141492751,156603876,577584082,8754025024.647503,9130928250.452005,5077287997.866081,22962241272.965589,1689517,440462,825849,2955828
2013-12-03,NYSE MKT (A),0,12344700,6972721,19317421,0.000000,105162206.838900,120426161.793000,225588368.631900,0,20519,22860,43379
2013-12-03,NASDAQ BX (B),86254141,31723621,47140757,165118519,3000119760.530001,1642157945.935700,1917818884.375295,6560096590.840996,595720,121981,314287,1031988
2013-12-03,NSX (C),15609972,8670820,13920852,38201644,454933861.719000,418392342.694300,277860797.637800,1151187002.051100,63966,15966,40672,120604
2013-12-03,NYSE (DN),148689841,41424552,87086963,277201356,4743658823.317128,2151533974.134996,3233609627.580822,10128802425.032946,641360,113423,333381,1088164
2013-12-03,NASDAQ (DQ),1113094505,326136569,687752510,2126983584,37017023411.333785,18050317951.891591,22294599326.261154,77361940689.486530,3548517,532513,1813340,5894370
2013-12-03,EDGA (J),77057546,38124405,40498100,155680051,2279825730.340004,1874544535.294601,1211179953.481197,5365550219.115802,503112,137277,247361,887750
2013-12-03,EDGX (K),249577410,68991480,170760683,489329573,8820566680.291701,3784462458.892694,5836098802.868611,18441127942.053006,1244474,202236,703325,2150035
2013-12-03,CHX (M),11372841,7799797,4159703,23332341,443090128.612200,510786837.760000,773230902.442500,1727107868.814700,290,2363,414,3067
2013-12-03,NYSE (N),769964178,0,0,769964178,27524898452.611265,0.000000,0.000000,27524898452.611265,1786411,0,0,1786411
2013-12-03,NYSE Arca (P),257163469,214168941,153960029,625292439,9714248547.711151,14339978942.340673,6543754450.032888,30597981940.084712,1521956,471816,850683,2844455
2013-12-03,NASDAQ (Q),420796040,116351866,476976641,1014124547,16110333853.618001,8121281332.993921,17394914745.900229,41626529932.512151,2540936,370086,1875935,4786957
2013-12-03,CBSX (W),13866038,5367048,8110387,27343473,388386385.550000,307961802.230000,172221401.246300,868569589.026300,95884,9564,51871,157319
2013-12-03,NASDAQ PSX (X),11338504,10458234,7931975,29728713,325444677.925000,599302595.490000,256521760.610000,1181269034.025000,59347,29087,34780,123214
2013-12-03,BATS BYX (Y),59721999,25015544,30975247,115712790,1988738575.141002,1427189353.604199,1129276549.459704,4545204478.204905,397748,103450,192901,694099
2013-12-03,BATS BZX (Z),247879257,121611725,141816681,511307663,7865685167.694992,7829367550.612089,4708912863.488498,20403965581.795579,1517071,381765,773879,2672715
2013-12-02,NYSE MKT (A),0,10820656,5130995,15951651,0.000000,64432307.583500,102222505.078000,166654812.661500,0,22709,20586,43295
2013-12-02,NASDAQ BX (B),85335317,32083535,45666927,163085779,2928515047.745001,1626051808.185500,1795245430.363000,6349812286.293501,580176,118155,303065,1001396
2013-12-02,NSX (C),16488040,6781047,13042209,36311296,499889573.420000,262177275.193800,251776506.373999,1013843354.987799,69008,16011,39986,125005
2013-12-02,NYSE (DN),146497397,40456291,90196331,277150019,4718029418.364319,2067200678.984601,3336434057.004885,10121664154.353805,651618,120311,353531,1125460
2013-12-02,NASDAQ (DQ),966267601,321566741,586415732,1874250074,30649546214.373721,17932127193.861134,18530983479.232526,67112656887.467381,3225505,588809,1734664,5548978
2013-12-02,EDGA (J),74958135,37100511,39487440,151546086,2288468175.051998,1937445157.289696,1233272301.626301,5459185633.967995,503224,128260,253983,885467
2013-12-02,EDGX (K),219124838,70332472,156056009,445513319,7399023282.946795,3849886265.725996,5266897943.367991,16515807492.040782,1103999,208820,644990,1957809
2013-12-02,CHX (M),9426797,11897850,5447232,26771879,277729736.627000,1155084391.420000,283837417.331500,1716651545.378500,199,2184,411,2794
2013-12-02,NYSE (N),667387840,0,0,667387840,24443852574.333024,0.000000,0.000000,24443852574.333024,1668259,0,0,1668259
2013-12-02,NYSE Arca (P),228411893,225313509,138761300,592486702,8359297166.410825,13270579066.589709,5975160934.011419,27605037167.011953,1346061,479559,786357,2611977
2013-12-02,NASDAQ (Q),359720368,109739306,420920807,890380481,13806724521.187884,7825119919.423002,15866944913.197864,37498789353.808750,2237737,361147,1799116,4398000
2013-12-02,CBSX (W),14979360,4320798,8853614,28153772,397538000.630000,280296784.600000,243992681.317900,921827466.547900,101984,10056,54721,166761
2013-12-02,NASDAQ PSX (X),9934683,8981212,7321361,26237256,280762244.390000,532704845.745000,272487808.801900,1085954898.936900,54373,27021,34151,115545
2013-12-02,BATS BYX (Y),58464344,25320146,30294225,114078715,1939347995.849004,1392895972.926201,1073443231.156905,4405687199.932110,396410,98430,197791,692631
2013-12-02,BATS BZX (Z),241623060,117745371,135506013,494874444,7857919328.975986,7662065766.381698,4482730672.053885,20002715767.411569,1536982,375269,787808,2700059
2013-11-29,NYSE MKT (A),0,7191826,2539260,9731086,0.000000,40214647.000600,46490298.117000,86704945.117600,0,12670,7784,20454
2013-11-29,NASDAQ BX (B),41343575,16054253,23710523,81108351,1437340584.030000,880109796.400000,891415905.556100,3208866285.986100,285071,56168,141984,483223
2013-11-29,NSX (C),5901428,3210423,5282196,14394047,162600959.385000,181380817.181900,116852681.973500,460834458.540400,24682,6764,17026,48472
2013-11-29,NYSE (DN),56687338,20290444,40352057,117329839,1752647199.265097,1030711762.248099,1568485966.357400,4351844927.870596,255057,60552,148184,463793
2013-11-29,NASDAQ (DQ),439231439,153605109,281594650,874431198,12889894366.312382,7417205105.269994,9288972312.489581,29596071784.071957,1298685,277729,736174,2312588
2013-11-29,EDGA (J),34986690,16722160,18652931,70361781,1006404680.465001,893373171.238600,555978130.431801,2455755982.135402,222958,60785,110194,393937
2013-11-29,EDGX (K),103748377,36346696,78771773,218866846,3289998056.194995,1928062614.650198,2832963268.477508,8051023939.322701,471200,102832,298039,872071
2013-11-29,CHX (M),1370879,4750510,1451865,7573254,78628744.964400,552205648.282000,65004849.279600,695839242.526000,214,939,222,1375
2013-11-29,NYSE (N),474170188,0,0,474170188,17497118233.724592,0.000000,0.000000,17497118233.724592,909461,0,0,909461
2013-11-29,NYSE Arca (P),123246432,126196409,69928900,319371741,4464816700.400092,8004048517.962310,3211039495.008000,15679904713.370402,717723,246762,386347,1350832
2013-11-29,NASDAQ (Q),165702165,57382612,249384355,472469132,6137923108.305006,4281583064.141898,10598497989.183141,21018004161.630045,1022960,184696,851342,2058998
2013-11-29,CBSX (W),5078910,1992289,3074608,10145807,135861833.760000,117776470.510000,70228068.260000,323866372.530000,36051,4235,20091,60377
2013-11-29,NASDAQ PSX (X),4947591,4213127,3686858,12847576,140496194.915000,267517699.205000,134496920.940000,542510815.060000,25557,12978,17001,55536
2013-11-29,BATS BYX (Y),28863066,12445894,13734364,55043324,930567186.649000,739334347.285000,497144386.512500,2167045920.446500,199457,48719,87827,336003
2013-11-29,BATS BZX (Z),113244388,60208202,61759103,235211693,3616138392.060005,3908324031.317399,2264908271.661393,9789370695.038797,704641,182713,347839,1235193
2013-11-27,NYSE MKT (A),0,8131133,5870437,14001570,0.000000,50865209.796200,109953589.504000,160818799.300200,0,18076,18588,36664
2013-11-27,NASDAQ BX (B),73347737,22153178,41490776,136991691,2434545091.899998,1148076142.509701,1564013999.945597,5146635234.355296,493622,86610,260834,841066
2013-11-27,NSX (C),10039941,4806605,8434102,23280648,261259334.515000,172814005.946100,161588165.122600,595661505.583700,38952,12567,27361,78880
2013-11-27,NYSE (DN),116974900,27815832,82652967,227443699,3689477703.930267,1400809905.167101,2733292370.101449,7823579979.198817,515384,85501,297786,898671
2013-11-27,NASDAQ (DQ),842159119,217840149,528298692,1588297960,26178999970.227042,10626459267.890230,15508680407.256080,52314139645.373352,2772038,428552,1476019,4676609
2013-11-27,EDGA (J),64969379,24617203,34200730,123787312,1926335354.939998,1246249660.018600,996353238.405999,4168938253.364597,427854,96796,211559,736209
2013-11-27,EDGX (K),193228795,57827403,140129785,391185983,6551221731.248206,2986025582.716000,4510134000.015719,14047381313.979925,941004,165317,564667,1670988
2013-11-27,CHX (M),11589526,7808471,5628662,25026659,434974777.174000,671370871.533700,217869620.629000,1324215269.336700,234,1359,312,1905
2013-11-27,NYSE (N),532245255,0,0,532245255,19035291704.270869,0.000000,0.000000,19035291704.270869,1397237,0,0,1397237
2013-11-27,NYSE Arca (P),202760479,138390527,124253546,465404552,7413748470.001788,8298971966.917417,5044668885.363424,20757389322.282629,1190158,332331,695297,2217786
2013-11-27,NASDAQ (Q),302505754,85885473,350181161,738572388,11253918952.784978,6036190038.444500,12644498244.177378,29934607235.406856,1823886,280294,1497602,3601782
2013-11-27,CBSX (W),10202485,4334242,5831327,20368054,276932161.120000,249852334.530000,150503077.130000,677287572.780000,70059,7366,39971,117396
2013-11-27,NASDAQ PSX (X),8097704,6627881,7086912,21812497,232967073.940000,399409590.260000,221251609.795000,853628273.995000,43872,19515,30064,93451
2013-11-27,BATS BYX (Y),47986996,17656194,25113536,90756726,1543976904.723001,953418126.986600,850886266.982001,3348281298.691602,327747,73165,160310,561222
2013-11-27,BATS BZX (Z),198208976,84724405,119123706,402057087,6220458521.650001,5288850887.143191,3776309877.303499,15285619286.096691,1214230,264972,655392,2134594
2013-11-26,NYSE MKT (A),0,11608184,6481332,18089516,0.000000,77797457.879100,108820708.574000,186618166.453100,0,21541,24574,46115
2013-11-26,NASDAQ BX (B),84577678,26742592,46077606,157397876,2817894458.329999,1386239308.051199,1734156830.801901,5938290597.183099,552690,97423,297384,947497
2013-11-26,NSX (C),12943648,6471440,10030931,29446019,360529203.560000,276226696.680400,218760473.027400,855516373.267800,50718,13951,34904,99573
2013-11-26,NYSE (DN),145584218,31549587,94471740,271605545,4642384631.903187,1580094433.467902,3243796863.825023,9466275929.196112,623655,96834,359285,1079774
2013-11-26,NASDAQ (DQ),1128587156,263070150,716669466,2108326772,37272876193.671513,13527110728.428931,22010350190.787962,72810337112.888406,3209000,451723,1776107,5436830
2013-11-26,EDGA (J),77068022,29532545,40320211,146920778,2260127045.139999,1495331967.001801,1179184548.272999,4934643560.414799,493636,107775,249887,851298
2013-11-26,EDGX (K),221297431,57975836,167207535,446480802,7840294828.380995,2902072342.237700,5478946065.450869,16221313236.069564,1073987,163606,685244,1922837
2013-11-26,CHX (M),13611684,6340916,6272883,26225483,503921597.374000,431178295.790000,679980285.800000,1615080178.964000,462,1407,472,2341
2013-11-26,NYSE (N),827841873,0,0,827841873,30849442126.478354,0.000000,0.000000,30849442126.478354,1638970,0,0,1638970
2013-11-26,NYSE Arca (P),241693520,152575655,154494408,548763583,9152733157.961886,9599510604.525689,6199068355.242384,24951312117.729959,1401110,344945,837782,2583837
2013-11-26,NASDAQ (Q),366342213,93139996,482381180,941863389,13646162262.864984,6713773702.119000,17988335245.192976,38348271210.176960,2155658,289356,1810893,4255907
2013-11-26,CBSX (W),15578109,2534276,7968522,26080907,393849938.750000,125568242.660000,185659056.502400,705077237.912400,96857,8338,52948,158143
2013-11-26,NASDAQ PSX (X),9687176,7828741,7981067,25496984,272054621.185000,447564062.675000,259021953.455000,978640637.315000,50919,21574,36358,108851
2013-11-26,BATS BYX (Y),56679303,20665695,29547845,106892843,1824157483.534999,1146600360.665799,1024546381.934202,3995304226.135000,376656,79895,187825,644376
2013-11-26,BATS BZX (Z),228786858,89893285,139005683,457685826,7310378966.466798,5748448446.664397,4464946839.113691,17523774252.244886,1373641,276292,781234,2431167
2013-11-25,NYSE MKT (A),0,12424356,7046973,19471329,0.000000,84770428.189700,103248501.748000,188018929.937700,0,22134,22007,44141
2013-11-25,NASDAQ BX (B),76035759,25667646,44596936,146300341,2538850500.335000,1335812883.742500,1634778905.461899,5509442289.539399,504207,95258,270782,870247
2013-11-25,NSX (C),12306762,5201116,11114790,28622668,359347129.165000,158107197.877600,222235265.242300,739689592.284900,49946,13660,34803,98409
2013-11-25,NYSE (DN),142002936,34627752,98139420,274770108,4721126756.049985,1687209865.484602,3044150068.976390,9452486690.510977,619899,106128,350192,1076219
2013-11-25,NASDAQ (DQ),1020695393,271338145,664574852,1956608390,35087115631.369077,13144667260.309309,18356819784.905327,66588602676.583713,3177072,505402,1762168,5444642
2013-11-25,EDGA (J),74807807,29546485,43796628,148150920,2296068944.555897,1429944288.852199,1261493788.531500,4987507021.939596,485202,110668,257100,852970
2013-11-25,EDGX (K),205349984,56911995,161329192,423591171,7199280970.833994,2582559854.508899,5013305121.071715,14795145946.414608,991076,159241,653944,1804261
2013-11-25,CHX (M),9242405,4573755,4094083,17910243,504974081.590400,387607395.218800,244509069.801600,1137090546.610800,332,1897,407,2636
2013-11-25,NYSE (N),625734020,0,0,625734020,23429183091.101519,0.000000,0.000000,23429183091.101519,1552105,0,0,1552105
2013-11-25,NYSE Arca (P),224397073,175903132,154162732,554462937,8609737078.443520,10562626273.179118,5588300435.515006,24760663787.137644,1318427,382462,820516,2521405
2013-11-25,NASDAQ (Q),340408722,96876958,427989609,865275289,12836548747.122996,6363794525.796320,14717998601.987764,33918341874.907080,2057028,315050,1769916,4141994
2013-11-25,CBSX (W),13368687,4441808,8905296,26715791,347423590.450000,217793951.590000,177600938.313900,742818480.353900,89222,8601,51868,149691
2013-11-25,NASDAQ PSX (X),8737291,8223332,8879669,25840292,264700244.765000,442631334.175000,261937027.645000,969268606.585000,47592,22224,32884,102700
2013-11-25,BATS BYX (Y),53767534,22093763,30011499,105872796,1762650286.699999,1187386023.938201,966329029.746301,3916365340.384501,365322,85665,182442,633429
2013-11-25,BATS BZX (Z),206317728,91471133,132814833,430603694,6711797974.860007,5770929743.598713,4059467493.090991,16542195211.549711,1271461,288683,720699,2280843
2013-11-22,NYSE MKT (A),0,8940515,6165834,15106349,0.000000,68043534.020900,111025116.777000,179068650.797900,0,19042,23351,42393
2013-11-22,NASDAQ BX (B),72779817,23345024,46657315,142782156,2540069750.905002,1268391166.606800,1641786113.999098,5450247031.510900,513834,91841,303394,909069
2013-11-22,NSX (C),12520924,5730682,10261052,28512658,364421297.729500,232845040.141000,212634277.298896,809900615.169396,50676,12233,34600,97509
2013-11-22,NYSE (DN),141077463,32886203,92039733,266003399,4777386524.521885,1672845334.958000,2921125277.518310,9371357136.998195,617941,96110,344266,1058317
2013-11-22,NASDAQ (DQ),1092266018,252089627,635462555,1979818200,38184737480.357267,12687249827.111937,19644781823.858007,70516769131.327211,3172625,467173,1767751,5407549
2013-11-22,EDGA (J),70291567,27680328,41684195,139656090,2140248150.331001,1390866551.698701,1254029802.809096,4785144504.838798,464510,99092,258620,822222
2013-11-22,EDGX (K),211343672,55494417,151472826,418310915,7878985958.629105,2786643124.715897,5019366370.852492,15684995454.197494,1059090,162134,645715,1866939
2013-11-22,CHX (M),9889754,12300069,3575193,25765016,471927901.467800,950519454.969900,223883134.915000,1646330491.352700,397,1939,538,2874
2013-11-22,NYSE (N),607203303,0,0,607203303,22036403762.645856,0.000000,0.000000,22036403762.645856,1576462,0,0,1576462
2013-11-22,NYSE Arca (P),224161650,160065104,148468938,532695692,8423225454.837609,10708037070.169390,5904672151.306314,25035934676.313313,1301429,361196,828927,2491552
2013-11-22,NASDAQ (Q),354276655,89054213,422703848,866034716,13682633972.482811,6220500029.262993,15400943614.209665,35304077615.955469,2162012,299876,1803213,4265101
2013-11-22,CBSX (W),12247651,5512238,7614125,25374014,340716993.180000,309153836.530000,182477647.430000,832348477.140000,86331,8289,48166,142786
2013-11-22,NASDAQ PSX (X),9178579,7588095,8235369,25002043,271647348.935000,440205877.010000,268664888.515000,980518114.460000,48450,21849,34326,104625
2013-11-22,BATS BYX (Y),52434053,20108656,29750676,102293385,1732148243.891999,1134990367.390400,1048467336.860099,3915605948.142498,358525,80261,193343,632129
2013-11-22,BATS BZX (Z),206437372,85625745,128884667,420947784,6848532391.684994,5496502588.094607,4105224074.010891,16450259053.790492,1284928,280546,724178,2289652
2013-11-21,NYSE MKT (A),0,10226751,5400042,15626793,0.000000,67861886.457800,97392771.013000,165254657.470800,0,21501,19259,40760
2013-11-21,NASDAQ BX (B),75868818,27338517,42204585,145411920,2576410616.916999,1395179947.857600,1649348578.567101,5620939143.341700,507818,103307,281181,892306
2013-11-21,NSX (C),15143653,9501467,10249508,34894628,434679637.989100,581058540.832100,205210654.691700,1220948833.512900,57514,18064,33143,108721
2013-11-21,NYSE (DN),149572260,38968034,89814643,278354937,4977947476.434369,1875805360.246406,2908122494.933191,9761875331.613966,645405,111155,343042,1099602
2013-11-21,NASDAQ (DQ),1106546039,302407637,607397414,2016351090,37002639312.279722,14243699295.896616,18544349998.153598,69790688606.329936,3255159,518152,1714080,5487391
2013-11-21,EDGA (J),76845190,35710192,41162340,153717722,2241451996.140203,1650084534.419600,1186713097.544299,5078249628.104102,498945,125839,259648,884432
2013-11-21,EDGX (K),219052901,67104090,149053753,435210744,7459333510.312504,3180281202.425002,5032287352.798902,15671902065.536408,1048826,197686,635004,1881516
2013-11-21,CHX (M),13767518,8514756,4473600,26755874,411539038.720000,567838596.190000,219669111.555000,1199046746.465000,287,2448,391,3126
2013-11-21,NYSE (N),668878467,0,0,668878467,23864471176.094153,0.000000,0.000000,23864471176.094153,1683506,0,0,1683506
2013-11-21,NYSE Arca (P),255512548,202433516,153219560,611165624,9572900451.103103,13285717502.781119,5859924451.514010,28718542405.398232,1476942,447684,831840,2756466
2013-11-21,NASDAQ (Q),375452689,112054912,419478517,906986118,13968787992.864211,7628856952.656085,14830893751.379549,36428538696.899845,2226751,362076,1754209,4343036
2013-11-21,CBSX (W),14269251,8341338,8201835,30812424,375923257.220000,494214486.350000,216165770.830000,1086303514.400000,99058,9956,52577,161591
2013-11-21,NASDAQ PSX (X),9737041,9531289,7854656,27122986,271139519.880000,536398017.640000,266008674.445000,1073546211.965000,49704,28918,34410,113032
2013-11-21,BATS BYX (Y),55131882,25017270,28798474,108947626,1829955390.340002,1328748338.846800,993104121.920602,4151807851.107404,372010,96559,185641,654210
2013-11-21,BATS BZX (Z),224927350,110967607,132201954,468096911,7186724861.381090,6823789026.359690,4203933407.053802,18214447294.794582,1359799,355341,717946,2433086
2013-11-20,NYSE MKT (A),0,11429583,5446159,16875742,0.000000,63558191.730900,91806833.164000,155365024.894900,0,22722,23227,45949
2013-11-20,NASDAQ BX (B),71138214,29328280,40869079,141335573,2476168825.720000,1547554982.926002,1453803241.219499,5477527049.865501,493760,119713,267486,880959
2013-11-20,NSX (C),13903987,7527720,10385886,31817593,382183579.648000,342227759.692100,197677100.432000,922088439.772100,54175,16925,33415,104515
2013-11-20,NYSE (DN),139635297,42531239,89966504,272133040,4616754547.602405,2133084170.689206,2825881791.580006,9575720509.871617,599479,120468,328471,1048418
2013-11-20,NASDAQ (DQ),973916298,321317312,609928872,1905162482,31339620246.769178,15267139184.517816,17266692944.721154,63873452376.008148,3103262,562814,1688085,5354161
2013-11-20,EDGA (J),72304277,41617052,41607253,155528582,2124640070.879901,1971413196.099002,1194997473.113801,5291050740.092704,475403,148555,250115,874073
2013-11-20,EDGX (K),226049135,87873192,158149797,472072124,7629002071.166397,4420136157.967688,5229080714.683512,17278218943.817597,1090332,252675,657416,2000423
2013-11-20,CHX (M),11940742,9961524,5003476,26905742,437777500.930700,681885266.687200,257765879.668200,1377428647.286100,308,4377,459,5144
2013-11-20,NYSE (N),622138618,0,0,622138618,22580120919.952594,0.000000,0.000000,22580120919.952594,1766454,0,0,1766454
2013-11-20,NYSE Arca (P),261126638,243480389,157774894,662381921,9557613165.905021,15555481126.746884,6045432569.646209,31158526862.298114,1500911,567781,859632,2928324
2013-11-20,NASDAQ (Q),402369542,154335368,416770053,973474963,14971633233.627016,10882363901.406721,14514246292.039584,40368243427.073321,2437830,511393,1830080,4779303
2013-11-20,CBSX (W),11621281,3535228,7103950,22260459,328542020.050000,219332619.628900,175011852.120000,722886491.798900,82830,9588,46982,139400
2013-11-20,NASDAQ PSX (X),10883365,12755601,9489823,33128789,323621886.915000,816477998.645000,311011520.195000,1451111405.755000,52149,40769,37025,129943
2013-11-20,BATS BYX (Y),54297344,29470535,30140874,113908753,1738701150.322302,1635125202.728899,975868669.316301,4349695022.367502,370335,119560,189438,679333
2013-11-20,BATS BZX (Z),237778620,158718555,141957283,538454458,7470376118.410008,10501802552.697680,4320299422.074910,22292478093.182598,1472459,509300,765969,2747728
2013-11-19,NYSE MKT (A),0,9236257,7619794,16856051,0.000000,66795047.200300,126162721.804000,192957769.004300,0,22184,25722,47906
2013-11-19,NASDAQ BX (B),73887536,26086473,39705626,139679635,2524394731.865002,1481198130.801600,1593828864.740199,5599421727.406801,499767,107108,274684,881559
2013-11-19,NSX (C),13904707,6155235,9237982,29297924,394167896.646600,232902012.863200,190302020.095700,817371929.605500,53460,14974,32209,100643
2013-11-19,NYSE (DN),144316687,37498125,91520017,273334829,4764366330.658794,1854324469.271099,2901022455.359911,9519713255.289804,617524,103799,335130,1056453
2013-11-19,NASDAQ (DQ),1054880741,260028032,641283958,1956192731,34022862295.342477,12766824713.541361,18386957750.339626,65176644759.223464,3233494,483101,1726226,5442821
2013-11-19,EDGA (J),78418109,32291730,40915845,151625684,2357405219.127999,1678316802.094399,1280389146.347502,5316111167.569900,514942,128875,262870,906687
2013-11-19,EDGX (K),227670991,68752525,157830121,454253637,7798588178.241996,3375091890.610896,5234181970.064697,16407862038.917589,1081106,197254,668509,1946869
2013-11-19,CHX (M),13026545,7810164,4918524,25755233,511456939.182400,513816626.810400,306643239.888800,1331916805.881600,1064,2285,384,3733
2013-11-19,NYSE (N),645708006,0,0,645708006,22937538327.907729,0.000000,0.000000,22937538327.907729,1766037,0,0,1766037
2013-11-19,NYSE Arca (P),259438759,185131464,158061964,602632187,9679301549.496001,11655663030.170403,5898167466.362995,27233132046.029399,1488130,461378,874359,2823867
2013-11-19,NASDAQ (Q),406965123,114266720,422276528,943508371,15361136263.006024,8224478445.683494,14691338396.771855,38276953105.461373,2444262,387034,1868923,4700219
2013-11-19,CBSX (W),13059313,2273073,7863964,23196350,359793205.800000,127066222.110000,185373622.298000,672233050.208000,92886,8595,52476,153957
2013-11-19,NASDAQ PSX (X),11205119,9607257,7860587,28672963,306936657.920000,623637382.015000,255916098.922600,1186490138.857600,50958,29928,33401,114287
2013-11-19,BATS BYX (Y),56349539,24475787,28343800,109169126,1811532408.853004,1381454924.329401,983199686.558505,4176187019.740910,378475,101575,187499,667549
2013-11-19,BATS BZX (Z),226056825,106180749,137528148,469765722,7249728037.154993,6979649459.335895,4204388129.215998,18433765625.706886,1377291,359718,751943,2488952
2013-11-18,NYSE MKT (A),0,9440991,7229089,16670080,0.000000,63602796.481700,119740553.113000,183343349.594700,0,20840,24379,45219
2013-11-18,NASDAQ BX (B),75522431,31879593,42733085,150135109,2539031128.014998,1647492953.703600,1619500600.107602,5806024681.826200,498671,122095,280451,901217
2013-11-18,NSX (C),14402072,6728210,10761836,31892118,377399369.065000,335201832.835600,235812650.710900,948413852.611500,48920,15532,35743,100195
2013-11-18,NYSE (DN),148304266,42046553,100077082,290427901,4923260702.658182,2092478293.003195,3257119461.444317,10272858457.105694,619928,126784,368929,1115641
2013-11-18,NASDAQ (DQ),1013279032,316381491,649005588,1978666111,32844369331.782802,15933846678.865689,19722475714.209299,68500691724.857790,3242848,557405,1808218,5608471
2013-11-18,EDGA (J),75218022,35328569,42568408,153114999,2282533327.826104,1657542184.757101,1291285270.191602,5231360782.774807,491489,130525,264844,886858
2013-11-18,EDGX (K),236277956,72908283,173544153,482730392,8055036166.674302,3467856466.624392,5956729505.389560,17479622138.688254,1082958,218760,692993,1994711
2013-11-18,CHX (M),8296351,9395228,5745237,23436816,342173347.006000,695661240.720000,236712577.826000,1274547165.552000,490,2022,422,2934
2013-11-18,NYSE (N),655588102,0,0,655588102,24046235999.893493,0.000000,0.000000,24046235999.893493,1708664,0,0,1708664
2013-11-18,NYSE Arca (P),245359271,227132755,159923866,632415892,9303465076.374486,13926049339.478407,6619062291.434641,29848576707.287534,1405141,482176,865592,2752909
2013-11-18,NASDAQ (Q),395058329,116662480,450550114,962270923,15071216673.012848,8128661116.041403,16578732402.135369,39778610191.189620,2362422,387594,1883065,4633081
2013-11-18,CBSX (W),13356859,4367130,8638684,26362673,370498107.180000,203784156.850000,222589159.239000,796871423.269000,91858,8881,55774,156513
2013-11-18,NASDAQ PSX (X),10730859,9618329,8932517,29281705,317307093.230000,588766225.640000,331768825.560000,1237842144.430000,50958,30299,36282,117539
2013-11-18,BATS BYX (Y),57162392,26339338,30713024,114214754,1888607969.442004,1358119433.505203,1081251428.425205,4327978831.372412,379759,106461,192459,678679
2013-11-18,BATS BZX (Z),224073886,107720486,142195085,473989457,7410887567.720007,7018083626.225007,4553365086.663191,18982336280.608205,1382396,351966,780729,2515091
2013-11-15,NYSE MKT (A),0,9719418,6768908,16488326,0.000000,77088967.377700,118247396.027000,195336363.404700,0,19377,23845,43222
2013-11-15,NASDAQ BX (B),71321299,31639923,41904799,144866021,2443612090.974999,1576263101.210399,1632941999.466195,5652817191.651593,481213,110542,274070,865825
2013-11-15,NSX (C),13120685,6721290,10381677,30223652,393772892.219600,305566301.522100,208063854.848800,907403048.590500,51121,14152,36038,101311
2013-11-15,NYSE (DN),142849634,37650504,98788999,279289137,4929615399.435554,1834403043.736002,2929216228.648066,9693234671.819622,605283,115702,352475,1073460
2013-11-15,NASDAQ (DQ),1009954643,318751100,672298134,2001003877,33357040722.042242,16575191542.824312,19165626138.243323,69097858403.109877,3129685,534323,1776232,5440240
2013-11-15,EDGA (J),71605396,36111657,43176589,150893642,2205887934.461502,1673767608.277902,1217321939.662003,5096977482.401407,468932,128533,248529,845994
2013-11-15,EDGX (K),216248042,67846402,170471927,454566371,7721090245.530290,3305971200.016705,5511360651.402405,16538422096.949400,1042572,179464,683589,1905625
2013-11-15,CHX (M),13583473,13388609,4480457,31452539,544276398.432700,774354185.134500,342440212.680800,1661070796.248000,508,1848,382,2738
2013-11-15,NYSE (N),796303576,0,0,796303576,31514005987.454916,0.000000,0.000000,31514005987.454916,1614495,0,0,1614495
2013-11-15,NYSE Arca (P),249343698,209823426,160959192,620126316,9519869052.440008,12744129151.750189,6119649631.967919,28383647836.158116,1365207,425476,839871,2630554
2013-11-15,NASDAQ (Q),376977143,106180072,514939349,998096564,14384709871.320256,7202104856.696509,19235116169.762723,40821930897.779488,2181744,322800,1814316,4318860
2013-11-15,CBSX (W),13225441,5180457,7859778,26265676,373390186.740000,238740807.210000,187892828.903200,800023822.853200,89848,9150,51966,150964
2013-11-15,NASDAQ PSX (X),9816920,9721746,8745366,28284032,305157683.510000,540836400.865000,262126076.565000,1108120160.940000,48837,25994,33286,108117
2013-11-15,BATS BYX (Y),53834752,23217707,31562228,108614687,1824232489.199002,1178040677.655099,1091480983.602001,4093754150.456102,363138,90253,192671,646062
2013-11-15,BATS BZX (Z),222385620,101964596,135120921,459471137,7414094152.312806,6464528275.039085,4221269512.185392,18099891939.537283,1332904,316060,718981,2367945
2013-11-14,NYSE MKT (A),0,9395641,6793607,16189248,0.000000,58721938.431500,133223934.931000,191945873.362500,0,21009,24046,45055
2013-11-14,NASDAQ BX (B),72354165,30128711,44091059,146573935,2414848812.920000,1522665738.538597,1623055282.222200,5560569833.680797,480537,117698,276515,874750
2013-11-14,NSX (C),15110078,7097893,11761207,33969178,429014859.887000,316084654.101100,262634635.189198,1007734149.177298,61850,15742,37899,115491
2013-11-14,NYSE (DN),147052907,40446470,106620008,294119385,4899283364.631966,2096077671.922795,3527126919.879654,10522487956.434415,614540,119985,367616,1102141
2013-11-14,NASDAQ (DQ),996835044,291540816,710215793,1998591653,32067599401.613597,14725763705.044967,21186396098.861192,67979759205.519756,3061845,535776,1834299,5431920
2013-11-14,EDGA (J),73324255,35465965,45454089,154244309,2166459509.900001,1692562943.804799,1314207039.008992,5173229492.713792,475944,133328,271265,880537
2013-11-14,EDGX (K),223345990,73038430,177215742,473600162,7666072394.314103,3667876329.988598,6022075784.752406,17356024509.055107,1100711,213261,726338,2040310
2013-11-14,CHX (M),9525782,10486213,4502711,24514706,400982528.099800,858705935.107000,211177584.246400,1470866047.453200,500,2733,377,3610
2013-11-14,NYSE (N),633085550,0,0,633085550,22850380645.838483,0.000000,0.000000,22850380645.838483,1719693,0,0,1719693
2013-11-14,NYSE Arca (P),257660431,212329921,186264646,656254998,9555995988.543728,12859903300.520924,7359207085.155005,29775106374.219657,1449536,475611,934382,2859529
2013-11-14,NASDAQ (Q),394153474,119956374,471291386,985401234,14869409929.023249,8278446851.341510,16936568534.809995,40084425315.174754,2332406,390541,1962012,4684959
2013-11-14,CBSX (W),12726878,4136670,7303089,24166637,362018235.240000,257247745.790000,184916227.680000,804182208.710000,88903,10519,50531,149953
2013-11-14,NASDAQ PSX (X),10289676,10426400,9031394,29747470,310837690.475000,639744600.465000,333003444.050000,1283585734.990000,49528,31389,35057,115974
2013-11-14,BATS BYX (Y),57785439,26156041,33249715,117191195,1948382031.723996,1451998483.348901,1184891429.895701,4585271944.968598,389679,109191,204371,703241
2013-11-14,BATS BZX (Z),238846084,112670930,153529148,505046162,7639794458.359907,7498413121.731582,5130837690.086379,20269045270.177868,1442204,375535,822378,2640117
2013-11-13,NYSE MKT (A),0,9634474,5967001,15601475,0.000000,56037019.452300,107688118.802000,163725138.254300,0,20276,22030,42306
2013-11-13,NASDAQ BX (B),77673092,27981016,46357213,152011321,2667375392.289998,1549760593.371400,1811424827.277295,6028560812.938693,521494,106820,298119,926433
2013-11-13,NSX (C),16072883,6242086,9696699,32011668,450010219.206900,217618221.663900,237137523.922800,904765964.793600,57820,12716,33784,104320
2013-11-13,NYSE (DN),150096257,35052636,91016772,276165665,4940521845.579813,1863669233.045095,3009652907.746725,9813843986.371633,640881,98736,339077,1078694
2013-11-13,NASDAQ (DQ),1103159940,268462978,635909358,2007532276,33958044703.507393,14119067693.585221,18410402456.386058,66487514853.478672,3278774,460857,1758192,5497823
2013-11-13,EDGA (J),76242399,31530794,42609147,150382340,2214261798.619599,1558598033.997297,1258012320.121393,5030872152.738289,494583,113774,266695,875052
2013-11-13,EDGX (K),238603884,71253722,167125195,476982801,8482975331.554415,3584900726.975900,5853150559.020982,17921026617.551297,1196567,200280,741613,2138460
2013-11-13,CHX (M),8346560,8846668,4466160,21659388,332422990.038900,684756697.260000,311996000.413800,1329175687.712700,429,1876,609,2914
2013-11-13,NYSE (N),696539339,0,0,696539339,25084983215.572545,0.000000,0.000000,25084983215.572545,1770415,0,0,1770415
2013-11-13,NYSE Arca (P),256423419,188319953,168383359,613126731,9723084520.776213,12055320587.824893,6639714452.714611,28418119561.315717,1475262,427143,893548,2795953
2013-11-13,NASDAQ (Q),429059681,113581388,463064525,1005705594,16398639451.284875,8101103007.490299,16958314807.603394,41458057266.378568,2523662,354199,1973670,4851531
2013-11-13,CBSX (W),12853502,4950396,7030653,24834551,355491602.640000,315882507.710000,161480014.190000,832854124.540000,92302,11569,48928,152799
2013-11-13,NASDAQ PSX (X),10206809,10696379,9788596,30691784,320129526.475000,590037611.255000,374839468.185000,1285006605.915000,52252,29149,38457,119858
2013-11-13,BATS BYX (Y),57388821,24564501,31935533,113888855,1891840627.970601,1416384328.579898,1125580184.010998,4433805140.561497,390466,96474,204026,690966
2013-11-13,BATS BZX (Z),238277851,104273311,146719491,489270653,7846252639.469901,7048755265.748299,4762652256.218094,19657660161.436294,1467156,341249,805798,2614203
2013-11-12,NYSE MKT (A),0,9105837,6268548,15374385,0.000000,60835755.298000,113176895.547000,174012650.845000,0,20806,24949,45755
2013-11-12,NASDAQ BX (B),75159947,27691328,43043988,145895263,2643344477.949998,1483829578.168600,1527449020.927598,5654623077.046196,518923,114179,289128,922230
2013-11-12,NSX (C),15238499,6481971,10576416,32296886,419025411.118400,219972432.356500,224737446.973000,863735290.447900,57831,14242,34709,106782
2013-11-12,NYSE (DN),142524843,36604363,96139443,275268649,4583942567.537019,1874344095.097801,2867950322.398203,9326236985.033023,613122,108663,335728,1057513
2013-11-12,NASDAQ (DQ),1059715169,289261468,624709765,1973686402,35288961481.861778,13241678015.007782,17692980847.641599,66223620344.511159,3179341,482057,1696676,5358074
2013-11-12,EDGA (J),74363758,31229170,43067981,148660909,2198568718.775000,1506990255.466699,1200329452.885797,4905888427.127496,503335,121755,268753,893843
2013-11-12,EDGX (K),224959698,61915069,160883574,447758341,7950781571.750895,2973119420.806899,5170034481.742118,16093935474.299912,1159538,185010,717583,2062131
2013-11-12,CHX (M),7739681,11627580,3630064,22997325,303659229.724600,909338571.823600,182021830.824600,1395019632.372800,725,2093,503,3321
2013-11-12,NYSE (N),653214892,0,0,653214892,24374096515.170919,0.000000,0.000000,24374096515.170919,1776715,0,0,1776715
2013-11-12,NYSE Arca (P),248273663,181913788,161361388,591548839,9454929442.335987,10698966032.447493,5882285232.421962,26036180707.205442,1464179,417360,888266,2769805
2013-11-12,NASDAQ (Q),408663938,110313111,440053933,959030982,15828228995.720588,7455425955.799282,14793854221.976418,38077509173.496288,2529531,365951,1927983,4823465
2013-11-12,CBSX (W),11753737,3359692,7045539,22158968,326050431.060000,208546659.830000,165704609.810000,700301700.700000,87354,7669,50972,145995
2013-11-12,NASDAQ PSX (X),9843551,9624904,8747755,28216210,300437763.680000,521514524.225000,288787652.005000,1110739939.910000,51699,29394,37152,118245
2013-11-12,BATS BYX (Y),56758315,24506757,31495761,112760833,1906357485.612999,1370700793.108702,1054185509.111500,4331243787.833201,395438,103935,204151,703524
2013-11-12,BATS BZX (Z),233297802,105819087,141306913,480423802,7537598212.435479,6588529742.676096,4231124074.892305,18357252030.003880,1466340,349622,784374,2600336
2013-11-11,NYSE MKT (A),0,8018300,5572740,13591040,0.000000,50235228.366900,95451601.299000,145686829.665900,0,17033,18985,36018
2013-11-11,NASDAQ BX (B),67116513,20196815,41206502,128519830,2341859663.960003,1032513565.355501,1642183131.966303,5016556361.281807,457816,86018,260939,804773
2013-11-11,NSX (C),12843753,4821931,8896529,26562213,330366152.670000,186412429.410800,219992453.779500,736771035.860300,46580,11481,30673,88734
2013-11-11,NYSE (DN),117362915,26613733,90871814,234848462,3792377846.722305,1311341596.354901,2857201164.070987,7960920607.148193,522064,79974,312144,914182
2013-11-11,NASDAQ (DQ),785796288,204071035,545844175,1535711498,24545323934.887590,10232912784.054930,16729595717.646990,51507832436.589510,2694233,380974,1538610,4613817
2013-11-11,EDGA (J),60520303,22826553,39438267,122785123,1764065162.644999,1058180809.546000,1171255499.317900,3993501471.508899,410231,87531,235818,733580
2013-11-11,EDGX (K),186480560,44444803,147218109,378143472,6648798622.020387,2191646599.841102,5118962620.201802,13959407842.063291,976561,137097,645518,1759176
2013-11-11,CHX (M),6299143,7229409,4771492,18300044,331923746.866500,538687813.017200,242952721.625100,1113564281.508800,254,1773,427,2454
2013-11-11,NYSE (N),537585256,0,0,537585256,19506237454.352772,0.000000,0.000000,19506237454.352772,1504295,0,0,1504295
2013-11-11,NYSE Arca (P),198229842,146043490,142579485,486852817,7559322645.598986,8447225717.408393,5751605169.209454,21758153532.216833,1178106,327331,759142,2264579
2013-11-11,NASDAQ (Q),312644510,71526567,398787288,782958365,11917675747.595028,4805145081.136695,14470466205.274956,31193287034.006679,1960162,252412,1719935,3932509
2013-11-11,CBSX (W),10975046,4576186,6978878,22530110,300153371.500000,310162561.780000,158310321.020000,768626254.300000,81844,7536,49859,139239
2013-11-11,NASDAQ PSX (X),8092078,6777104,8225253,23094435,270257885.380000,391840285.550000,361192557.570000,1023290728.500000,44153,21730,31861,97744
2013-11-11,BATS BYX (Y),47346646,17786799,28411489,93544934,1560202818.494999,974449679.254499,1057589285.753001,3592241783.502499,329957,76401,174044,580402
2013-11-11,BATS BZX (Z),186881062,69823220,128226847,384931129,5885752021.332484,4449000964.763699,4236356251.513502,14571109237.609685,1171017,240432,695075,2106524
2013-11-08,NYSE MKT (A),0,9036623,6009204,15045827,0.000000,62801100.660100,117005769.893000,179806870.553100,0,19916,24960,44876
2013-11-08,NASDAQ BX (B),90366644,35023720,49432418,174822782,3054342651.759202,1862796907.730100,1859403712.415701,6776543271.905003,596172,129522,321303,1046997
2013-11-08,NSX (C),17511643,6860812,11117177,35489632,430955638.020700,303205687.603700,271655737.685299,1005817063.309699,61939,16965,38645,117549
2013-11-08,NYSE (DN),154347081,43933107,96078860,294359048,4983463782.032813,2472306969.029800,3185461051.615778,10641231802.678391,671788,127876,367930,1167594
2013-11-08,NASDAQ (DQ),1206399289,337984705,688144563,2232528557,38652819445.700436,17885565481.754009,20422521212.131747,76960906139.586192,3725914,555503,1946322,6227739
2013-11-08,EDGA (J),88236590,42926536,46847755,178010881,2528435111.310003,2135846155.895700,1329013160.844102,5993294428.049805,578578,153101,290990,1022669
2013-11-08,EDGX (K),272398137,85761352,182402085,540561574,9264956913.269112,4902626268.666698,6220145972.509457,20387729154.445267,1382454,258654,840554,2481662
2013-11-08,CHX (M),9273537,23131708,4734081,37139326,391537168.620700,1331494371.470000,367278838.925400,2090310379.016100,282,4684,428,5394
2013-11-08,NYSE (N),823423777,0,0,823423777,28796743608.250580,0.000000,0.000000,28796743608.250580,2117407,0,0,2117407
2013-11-08,NYSE Arca (P),306547257,269849201,185911845,762308303,11030698330.480813,16889011060.875239,7390230417.962776,35309939809.318828,1747027,595820,1020306,3363153
2013-11-08,NASDAQ (Q),487857906,159576817,496023100,1143457823,18078155240.477833,11813855646.202387,18292032923.631643,48184043810.311863,2955726,502145,2189208,5647079
2013-11-08,CBSX (W),13923486,3848374,9241488,27013348,372823265.460000,218734300.690000,211666839.028100,803224405.178100,103661,9280,64370,177311
2013-11-08,NASDAQ PSX (X),12955649,13298677,9571931,35826257,385928932.555000,835668212.325000,368864458.770000,1590461603.650000,63238,40250,41845,145333
2013-11-08,BATS BYX (Y),68859308,33645677,35277311,137782296,2196565614.904502,1963851730.729999,1202487036.858495,5362904382.492996,469405,130386,227568,827359
2013-11-08,BATS BZX (Z),294498648,151187627,162717736,608404011,9177543701.711876,10403338860.795912,5315722734.682691,24896605297.190479,1774785,474490,916845,3166120
2013-11-07,NYSE MKT (A),0,11138595,6778122,17916717,0.000000,77190115.138000,109927675.067000,187117790.205000,0,23094,23947,47041
2013-11-07,NASDAQ BX (B),97357588,35869285,54269761,187496634,3346193014.801997,1860763055.942901,2191243156.852808,7398199227.597706,671013,141275,356438,1168726
2013-11-07,NSX (C),19428910,7776852,14062322,41268084,483674693.747900,297278162.452100,298973475.008000,1079926331.208000,65854,17689,44270,127813
2013-11-07,NYSE (DN),161026961,45263898,105903377,312194236,5180488848.749821,2432305731.739804,3488182894.047880,11100977474.537505,696405,123310,379763,1199478
2013-11-07,NASDAQ (DQ),1261872492,341039917,804474175,2407386584,40247204147.556981,18043414932.145469,24446547843.590643,82737166923.293093,4046431,596620,2234651,6877702
2013-11-07,EDGA (J),95794423,46492725,52983498,195270646,2812723210.583901,2237570209.089902,1548085753.581801,6598379173.255604,636183,169607,323716,1129506
2013-11-07,EDGX (K),302880875,91517829,218234450,612633154,10557538438.120199,5008940986.662897,7255536326.984558,22822015751.767654,1564437,280967,960765,2806169
2013-11-07,CHX (M),17166965,13554773,6279641,37001379,541151228.785000,1339149751.906300,196296434.580100,2076597415.271400,1213,4113,773,6099
2013-11-07,NYSE (N),909579958,0,0,909579958,32271617320.544777,0.000000,0.000000,32271617320.544777,2409362,0,0,2409362
2013-11-07,NYSE Arca (P),337824943,274702148,217893306,830420397,12560157688.947898,17782253480.743475,8528369851.930960,38870781021.622333,1952118,620541,1147713,3720372
2013-11-07,NASDAQ (Q),536531466,169719059,574856648,1281107173,20042493306.119345,12470616602.977393,21005206832.869414,53518316741.966152,3252363,532370,2479340,6264073
2013-11-07,CBSX (W),14347043,3250433,9136469,26733945,414631108.070000,177140152.170000,218840466.040000,810611726.280000,105317,11140,61559,178016
2013-11-07,NASDAQ PSX (X),13256200,14580115,11763789,39600104,382538492.050000,975077593.460000,437982698.135000,1795598783.645000,67350,43798,47709,158857
2013-11-07,BATS BYX (Y),74447713,33624458,39792936,147865107,2448862680.671401,1837548967.022100,1454822964.197500,5741234611.891001,521611,136713,258633,916957
2013-11-07,BATS BZX (Z),318282500,166209599,191412649,675904748,10089308104.257498,11795713909.821012,6277981763.224196,28163003777.302706,1927784,523657,1033399,3484840
2013-11-06,NYSE MKT (A),0,9697348,7695651,17392999,0.000000,82741142.751900,127494598.943000,210235741.694900,0,20451,25274,45725
2013-11-06,NASDAQ BX (B),78433389,25308154,48546867,152288410,2713361065.129996,1250072362.520799,1758231427.114596,5721664854.765391,536261,94608,302790,933659
2013-11-06,NSX (C),16570232,6179721,13647903,36397856,406450737.434500,217437747.895600,257779634.051300,881668119.381400,58321,14504,41872,114697
2013-11-06,NYSE (DN),123709410,32200535,91240232,247150177,4048921554.626504,1594883986.082699,3053554299.771798,8697359840.481001,549902,92366,334589,976857
2013-11-06,NASDAQ (DQ),1087977841,279647657,734573338,2102198836,34325399144.985506,13787793371.315182,21979144923.532968,70092337439.833656,3527894,459172,2072385,6059451
2013-11-06,EDGA (J),77305289,30910784,45135290,153351363,2252479681.601700,1382873660.008401,1265582092.487801,4900935434.097902,502951,106532,272090,881573
2013-11-06,EDGX (K),238069302,59514744,193126289,490710335,8161919020.149186,2802157986.761903,6298416016.692491,17262493023.603580,1197500,171672,829991,2199163
2013-11-06,CHX (M),9083327,12253221,5292911,26629459,391360130.568200,829002047.145000,266800745.522000,1487162923.235200,264,1812,462,2538
2013-11-06,NYSE (N),704852432,0,0,704852432,25196569651.634027,0.000000,0.000000,25196569651.634027,1893244,0,0,1893244
2013-11-06,NYSE Arca (P),262769123,172618192,187076862,622464177,9757655483.773821,10594446380.880772,7216755064.974599,27568856929.629192,1521567,391632,997031,2910230
2013-11-06,NASDAQ (Q),416511644,101924045,482895192,1001330881,15749429188.132036,7131132388.588211,17321863215.353141,40202424792.073388,2545239,330149,2095339,4970727
2013-11-06,CBSX (W),12317902,5300356,8258519,25876777,340388186.700000,315464753.870000,174108653.080000,829961593.650000,90271,8055,53866,152192
2013-11-06,NASDAQ PSX (X),11243888,8286616,9919756,29450260,335547892.125000,501318622.155000,323751869.420000,1160618383.700000,55806,26468,37678,119952
2013-11-06,BATS BYX (Y),59933898,23175763,34854842,117964503,1971850978.678002,1235608557.992399,1179314960.893600,4386774497.564001,417528,94835,221373,733736
2013-11-06,BATS BZX (Z),255482541,97776940,163245502,516504983,8009499702.479989,6154052002.307595,5165284637.598100,19328836342.385684,1548155,318521,884478,2751154
2013-11-05,NYSE MKT (A),0,8677951,7496258,16174209,0.000000,53840929.768900,139221743.217000,193062672.985900,0,19552,27106,46658
2013-11-05,NASDAQ BX (B),79000789,25432274,46066596,150499659,2693900166.764998,1280735244.308398,1805122672.354097,5779758083.427493,541650,102422,297811,941883
2013-11-05,NSX (C),16300654,5846278,13535107,35682039,410501180.223200,194193751.136700,241823393.255900,846518324.615800,60105,13651,40476,114232
2013-11-05,NYSE (DN),120915273,26010345,79767562,226693180,3772719817.231805,1329216223.407200,2769084667.010386,7871020707.649391,513979,78065,273772,865816
2013-11-05,NASDAQ (DQ),1161165949,248864779,715961394,2125992122,35409980650.933769,12103793121.406791,21697789219.739254,69211562992.079814,3546859,464726,1940818,5952403
2013-11-05,EDGA (J),81528382,31103622,44635587,157267591,2396857008.420004,1482523810.943101,1306944180.338198,5186324999.701303,535390,116723,278350,930463
2013-11-05,EDGX (K),242088168,56809049,179290725,478187942,8104187987.679409,2828647281.554696,5955691427.569378,16888526696.803483,1198961,167929,751087,2117977
2013-11-05,CHX (M),11675925,8358009,6091711,26125645,559796832.336000,491409744.505000,608073445.948700,1659280022.789700,519,2181,504,3204
2013-11-05,NYSE (N),742019503,0,0,742019503,26079883944.231869,0.000000,0.000000,26079883944.231869,1992066,0,0,1992066
2013-11-05,NYSE Arca (P),269441236,183362204,173149772,625953212,9585785453.449432,11187594023.048715,6584406732.469302,27357786208.967449,1536730,415702,950174,2902606
2013-11-05,NASDAQ (Q),447367954,115290358,470434635,1033092947,16550472292.387527,7939649328.453321,16687676666.746470,41177798287.587318,2688401,358945,2042805,5090151
2013-11-05,CBSX (W),13124719,6818949,7602486,27546154,397420820.010000,370650454.785000,180230151.250000,948301426.045000,101479,7893,52304,161676
2013-11-05,NASDAQ PSX (X),12209956,9468084,8478341,30156381,328823972.200000,568751198.760000,265430229.810000,1163005400.770000,55744,30552,36605,122901
2013-11-05,BATS BYX (Y),60914974,22285102,33064366,116264442,1959815501.528000,1218228182.815199,1151851089.646198,4329894773.989397,425571,95543,216283,737397
2013-11-05,BATS BZX (Z),259270566,107104538,151815963,518191067,7972468622.530106,6659273263.954299,4741625564.988716,19373367451.473121,1565317,341508,830273,2737098
2013-11-04,NYSE MKT (A),0,9412830,6649001,16061831,0.000000,60405631.454300,109422383.836000,169828015.290300,0,18619,22605,41224
2013-11-04,NASDAQ BX (B),78708904,22447367,43285433,144441704,2481929734.224997,1127080647.777099,1434063201.536495,5043073583.538591,534493,88967,286348,909808
2013-11-04,NSX (C),16636116,5646804,12342523,34625443,430544965.030000,188641052.589299,246609215.286401,865795232.905700,60429,14899,35784,111112
2013-11-04,NYSE (DN),114163491,23990762,87367585,225521838,3556134482.364287,1146991747.710602,2550351057.304991,7253477287.379880,505831,66841,272138,844810
2013-11-04,NASDAQ (DQ),1081592261,248510897,682292942,2012396100,33967145029.365856,14340794344.433711,18992867768.145496,67300807141.945063,3573968,435993,1910773,5920734
2013-11-04,EDGA (J),74311451,26146786,42229426,142687663,2041638817.649602,1289310182.464300,1069143201.425002,4400092201.538904,486482,96739,250792,834013
2013-11-04,EDGX (K),219917351,52946761,164980060,437844172,7759430023.979992,2593324246.571003,5266671846.245301,15619426116.796296,1148045,156744,712878,2017667
2013-11-04,CHX (M),10631263,5460279,4907702,20999244,421742336.158700,408448345.047400,499574650.632800,1329765331.838900,1058,1231,315,2604
2013-11-04,NYSE (N),660974197,0,0,660974197,23189378313.280905,0.000000,0.000000,23189378313.280905,1770545,0,0,1770545
2013-11-04,NYSE Arca (P),237855636,163202336,152420572,553478544,8406616621.298912,10216317829.807587,5514310176.488083,24137244627.594582,1359125,359362,826977,2545464
2013-11-04,NASDAQ (Q),385028998,88242143,442294999,915566140,14256517326.299990,5980582978.337894,14526037949.290374,34763138253.928258,2331741,284075,1859934,4475750
2013-11-04,CBSX (W),13928335,5845050,7879293,27652678,387637103.580000,276637438.840000,177856220.339200,842130762.759200,104342,7572,55455,167369
2013-11-04,NASDAQ PSX (X),11592723,7220296,8838352,27651371,306161705.965000,476377285.305000,276913683.890000,1059452675.160000,54336,25343,43005,122684
2013-11-04,BATS BYX (Y),58516890,19032064,31570058,109119012,1839549862.267999,1044272814.053300,1029881775.860198,3913704452.181497,406117,80137,202506,688760
2013-11-04,BATS BZX (Z),232105039,79176188,133017453,444298680,7266384994.089987,5065240111.571901,3923628898.558301,16255254004.220189,1433448,270081,762314,2465843
2013-11-01,NYSE MKT (A),0,11104964,6467850,17572814,0.000000,72442284.708100,103456607.688000,175898892.396100,0,22101,22438,44539
2013-11-01,NASDAQ BX (B),93349009,33913720,49940233,177202962,3050794205.845000,1856133066.632899,1918320861.548105,6825248134.026004,638551,135489,346317,1120357
2013-11-01,NSX (C),15208791,7439537,10022285,32670613,410173227.495000,349036655.942300,244741597.655600,1003951481.092900,60285,16823,37320,114428
2013-11-01,NYSE (DN),133202943,35476483,103178814,271858240,4307557341.321492,1996993833.332801,3093438212.446591,9397989387.100884,573302,102719,333782,1009803
2013-11-01,NASDAQ (DQ),1156430424,399218009,688214316,2243862749,36201188818.759088,27329918760.548626,21164276417.811954,84695383997.119668,3746083,611850,2013539,6371472
2013-11-01,EDGA (J),87474918,42012700,46934480,176422098,2487387529.305000,2336394384.782601,1261301550.353109,6085083464.440710,569580,158092,292321,1019993
2013-11-01,EDGX (K),253392642,76563337,161683114,491639093,8662774347.649798,4573711857.556997,5680401570.031214,18916887775.238009,1331005,243391,791969,2366365
2013-11-01,CHX (M),8045852,10331983,4444567,22822402,330582467.920400,872894705.269000,235136371.739200,1438613544.928600,394,3022,373,3789
2013-11-01,NYSE (N),809671249,0,0,809671249,28550328387.273222,0.000000,0.000000,28550328387.273222,2077726,0,0,2077726
2013-11-01,NYSE Arca (P),283465172,248301359,158311716,690078247,10150125009.934978,17028340792.385530,6377763890.719887,33556229693.040395,1616886,534561,941557,3093004
2013-11-01,NASDAQ (Q),469681734,156813367,509680673,1136175774,17490007666.056031,11894309890.439388,18168081338.416318,47552398894.911737,2850634,498048,2156188,5504870
2013-11-01,CBSX (W),12162267,7162067,9155278,28479612,328952670.760000,519622670.540000,231035509.580000,1079610850.880000,93376,10900,58073,162349
2013-11-01,NASDAQ PSX (X),15987179,14589214,10981203,41557596,444708972.240000,895204796.900000,358789339.365000,1698703108.505000,71559,46198,56213,173970
2013-11-01,BATS BYX (Y),71767698,29821568,35372916,136962182,2261023979.338002,1732346306.892599,1159386656.332804,5152756942.563405,495005,124307,233122,852434
2013-11-01,BATS BZX (Z),293775580,145042511,157572072,596390163,9152020474.510018,10420253400.446695,5183459939.824915,24755733814.781628,1778936,473757,893909,3146602
2013-10-31,NYSE MKT (A),0,12007868,6633857,18641725,0.000000,84901972.576500,123032859.491000,207934832.067500,0,21543,27238,48781
2013-10-31,NASDAQ BX (B),95733969,35708220,49456044,180898233,3238404339.152004,1880511130.930502,1794952657.385197,6913868127.467703,640379,141308,335256,1116943
2013-10-31,NSX (C),14970348,5712092,9811843,30494283,404218269.259400,259408778.466900,252493485.670699,916120533.396999,57583,14990,35831,108404
2013-10-31,NYSE (DN),128127003,33600794,101245641,262973438,4201002698.831835,1949001472.321398,3333415928.102308,9483420099.255541,568506,98001,328262,994769
2013-10-31,NASDAQ (DQ),1187464140,333189825,826705922,2347359887,38363198772.379627,18293735358.988768,25030384084.117703,81687318215.486098,3828915,536215,2222067,6587197
2013-10-31,EDGA (J),89365526,40731193,50828464,180925183,2534105709.634999,2034622658.161301,1408206214.121401,5976934581.917701,585279,148574,315915,1049768
2013-10-31,EDGX (K),252432306,79958471,195015238,527406015,8828552376.369190,4429481735.989404,6734782151.943165,19992816264.301759,1312183,231158,877750,2421091
2013-10-31,CHX (M),17317411,6233261,6979773,30530445,611634150.323400,619832517.520000,524121624.395000,1755588292.238400,877,2739,582,4198
2013-10-31,NYSE (N),908431084,0,0,908431084,33132601157.276761,0.000000,0.000000,33132601157.276761,2108811,0,0,2108811
2013-10-31,NYSE Arca (P),290024228,232120455,205854826,727999509,10429554849.521669,15328247723.579495,7878719513.095138,33636522086.196302,1663886,518429,1085001,3267316
2013-10-31,NASDAQ (Q),477851980,148851996,605487662,1232191638,17437168162.465008,10920719362.706101,21587548315.223550,49945435840.394659,2849168,457870,2363189,5670227
2013-10-31,CBSX (W),13818737,3351827,8645702,25816266,384744287.150000,158428946.500000,211495593.720000,754668827.370000,101124,10769,62839,174732
2013-10-31,NASDAQ PSX (X),15375681,16827305,12354525,44557511,401570355.235000,1035001273.880000,386687267.180000,1823258896.295000,73131,49626,57606,180363
2013-10-31,BATS BYX (Y),70760069,29465205,39506752,139732026,2287687834.346001,1677362476.439499,1337377077.244999,5302427388.030499,485468,121238,254035,860741
2013-10-31,BATS BZX (Z),298812876,131989280,177162837,607964993,9098346108.635275,8908008758.585412,5547198604.093794,23553553471.314481,1751426,418782,980664,3150872
2013-10-30,NYSE MKT (A),0,9312295,5896286,15208581,0.000000,67130221.526300,97305764.864000,164435986.390300,0,22461,21822,44283
2013-10-30,NASDAQ BX (B),68829998,24236389,36839364,129905751,2337500063.594998,1256820242.357600,1456025808.754400,5050346114.706998,465780,99436,245143,810359
2013-10-30,NSX (C),14120216,5760578,9335554,29216348,401168904.590000,225910084.165500,242457309.411800,869536298.167300,55961,14634,36219,106814
2013-10-30,NYSE (DN),120855258,34782183,80879845,236517286,3979734187.406629,1879257264.260800,2972297504.497998,8831288956.165427,527690,93446,288660,909796
2013-10-30,NASDAQ (DQ),1164537785,303662126,672560796,2140760707,37766171178.322637,16992490651.176550,22398186702.344797,77156848531.843984,3684967,547106,1977612,6209685
2013-10-30,EDGA (J),90500351,41335060,48510309,180345720,2735420810.177998,1989671678.881799,1513054987.961304,6238147477.021101,603794,153038,313315,1070147
2013-10-30,EDGX (K),247220812,75409145,187157129,509787086,8907821570.883698,4019847818.104688,6852782409.281927,19780451798.270313,1305409,229543,855660,2390612
2013-10-30,CHX (M),13526113,7233881,15618489,36378483,527419781.698900,568663953.520000,576977276.591500,1673061011.810400,539,3656,681,4876
2013-10-30,NYSE (N),696809613,0,0,696809613,24748850273.527625,0.000000,0.000000,24748850273.527625,2011866,0,0,2011866
2013-10-30,NYSE Arca (P),293615136,206779483,179757423,680152042,10724745677.133392,13943365315.969180,7822928744.889344,32491039737.991916,1677047,517901,1005014,3199962
2013-10-30,NASDAQ (Q),473368429,158922158,488042852,1120333439,17880054686.539981,11797210121.196900,18314384074.380444,47991648882.117325,2890721,514301,2203186,5608208
2013-10-30,CBSX (W),11526212,3342729,6660342,21529283,315593132.270000,159690331.440000,155025918.750000,630309382.460000,86234,9653,48453,144340
2013-10-30,NASDAQ PSX (X),14342378,16913173,10547224,41802775,362894528.380000,1064169325.988000,336969656.805000,1764033511.173000,62942,51617,50300,164859
2013-10-30,BATS BYX (Y),70094136,31968004,36133685,138195825,2290154091.102002,1911736279.161902,1332157654.666001,5534048024.929905,487792,141154,237948,866894
2013-10-30,BATS BZX (Z),270163686,133494565,152251289,555909540,8333022021.395007,9221091331.891993,5054332675.508518,22608446028.795518,1636719,442410,866413,2945542
2013-10-29,NYSE MKT (A),0,9022052,6748055,15770107,0.000000,59434672.213400,118309448.283000,177744120.496400,0,21113,24478,45591
2013-10-29,NASDAQ BX (B),80378383,24397753,42996937,147773073,2632255075.745001,1249354284.164000,1719314229.291698,5600923589.200699,517985,100753,274094,892832
2013-10-29,NSX (C),12936151,4700694,7529008,25165853,365185734.310000,160686980.772700,255174797.281101,781047512.363801,49224,11917,30295,91436
2013-10-29,NYSE (DN),124453073,25753977,87497330,237704380,4116650101.684199,1266256648.524698,3374364242.618396,8757270992.827293,516965,77562,279941,874468
2013-10-29,NASDAQ (DQ),1133863621,247536155,682227190,2063626966,37497349354.501561,12697432841.828975,23391931014.323917,73586713210.654453,3604917,464437,1903331,5972685
2013-10-29,EDGA (J),77484653,30166888,47522746,155174287,2191178744.750002,1397844725.315400,1412048676.339899,5001072146.405301,491799,110568,264805,867172
2013-10-29,EDGX (K),241365966,59466429,159897997,460730392,8997247917.450002,2942739336.559399,6670248738.949696,18610235992.959097,1243352,169865,754440,2167657
2013-10-29,CHX (M),9216583,4769885,17999641,31986109,343802967.945300,434343104.930000,662302548.839300,1440448621.714600,422,1763,617,2802
2013-10-29,NYSE (N),682608240,0,0,682608240,24570682606.782292,0.000000,0.000000,24570682606.782292,1811421,0,0,1811421
2013-10-29,NYSE Arca (P),253247703,152711876,159446342,565405921,9433835509.555008,9874023004.256373,7607336670.027208,26915195183.838589,1441715,363101,878232,2683048
2013-10-29,NASDAQ (Q),413292752,101998113,470713437,986004302,15859741173.664983,7426321874.919992,18326350302.741505,41612413351.326480,2482189,343673,1972786,4798648
2013-10-29,CBSX (W),11729539,2635368,7365397,21730304,309244864.590000,105015738.040000,160722056.590000,574982659.220000,86152,8689,50755,145596
2013-10-29,NASDAQ PSX (X),12424947,10710234,11425557,34560738,355295707.675000,689407182.825000,341779902.325000,1386482792.825000,56548,36305,49202,142055
2013-10-29,BATS BYX (Y),59863943,20744756,33153978,113762677,1994299731.966000,1112597275.388999,1325102934.550200,4431999941.905199,409073,88867,203213,701153
2013-10-29,BATS BZX (Z),247077482,87641106,163829051,498547639,7813471528.339596,5640857500.120290,5429080359.537091,18883409387.996977,1451522,294563,862565,2608650
2013-10-28,NYSE MKT (A),0,8170363,4657247,12827610,0.000000,54903045.917000,84902234.004000,139805279.921000,0,15890,16935,32825
2013-10-28,NASDAQ BX (B),77360580,26358428,43665977,147384985,2656767723.875002,1295542928.604600,1642509083.749999,5594819736.229601,522002,102792,275151,899945
2013-10-28,NSX (C),13171702,4552394,8348419,26072515,338210622.855000,145307233.818900,212037196.959700,695555053.633600,48591,11931,29674,90196
2013-10-28,NYSE (DN),118077195,27141426,69290422,214509043,3842297357.184071,1377009362.985199,2529104296.648512,7748411016.817782,507515,78826,253722,840063
2013-10-28,NASDAQ (DQ),1138187435,279235054,734619583,2152042072,37243135617.297392,13943277354.801533,22398970972.140024,73585383944.238949,3352646,493588,1766426,5612660
2013-10-28,EDGA (J),72104515,32268558,42033626,146406699,2104875947.789999,1549954788.842400,1230576938.390298,4885407675.022697,480925,114852,246549,842326
2013-10-28,EDGX (K),218374251,58358787,150308674,427041712,7700609257.504809,2962662769.187400,6059994617.624303,16723266644.316512,1138701,173495,687881,2000077
2013-10-28,CHX (M),7266437,4284905,8234683,19786025,293341113.777800,409800876.890000,510335842.705000,1213477833.372800,316,1521,401,2238
2013-10-28,NYSE (N),731811146,0,0,731811146,27256906002.323005,0.000000,0.000000,27256906002.323005,1752805,0,0,1752805
2013-10-28,NYSE Arca (P),234069435,165319752,146147951,545537138,8609401777.390012,10696075696.115815,6805225688.150894,26110703161.656721,1376650,386714,795941,2559305
2013-10-28,NASDAQ (Q),403084495,105129017,527687573,1035901085,15232741269.155018,7336997340.357707,18424708907.012636,40994447516.525361,2443306,337573,1868610,4649489
2013-10-28,CBSX (W),10693213,2869758,6665183,20228154,274709375.660000,139656076.530000,136220623.780000,550586075.970000,80345,9071,43029,132445
2013-10-28,NASDAQ PSX (X),11671621,11536759,10474970,33683350,356252685.270000,725997809.735000,311179704.815200,1393430199.820200,56646,35896,46314,138856
2013-10-28,BATS BYX (Y),59018852,23431313,30296257,112746422,1949843198.745999,1236750304.462300,1048944939.199001,4235538442.407300,414103,95946,191774,701823
2013-10-28,BATS BZX (Z),212670836,89016016,137895159,439582011,6701983632.989989,5598396814.353592,4347966532.010700,16648346979.354281,1302213,292298,743804,2338315
2013-10-25,NYSE MKT (A),0,9437611,9672250,19109861,0.000000,90865444.984700,140981665.388000,231847110.372700,0,19241,28853,48094
2013-10-25,NASDAQ BX (B),72878455,24573381,50125072,147576908,2416603573.050000,1207844545.392700,1767406455.211192,5391854573.653892,489223,95046,303477,887746
2013-10-25,NSX (C),13119985,3960312,10587123,27667420,358863786.442700,172716768.098300,245624492.602900,777205047.143900,48731,11341,33263,93335
2013-10-25,NYSE (DN),113476632,25194573,94721881,233393086,3836143054.454493,1363068397.529201,2823806532.125888,8023017984.109582,478146,73322,295293,846761
2013-10-25,NASDAQ (DQ),1099426864,225532006,909578927,2234537797,35929047829.040689,11423260539.793366,23776358125.719984,71128666494.554039,3353246,436371,1993242,5782859
2013-10-25,EDGA (J),73211822,31365084,52005839,156582745,2122843818.607797,1454731002.116902,1390730352.035498,4968305172.760197,471701,108851,288681,869233
2013-10-25,EDGX (K),207766541,51857134,173399488,433023163,7485163380.846992,2597979955.191102,6073460243.907598,16156603579.945692,1085727,154961,732219,1972907
2013-10-25,CHX (M),9637237,12330819,4846294,26814350,375412088.337200,681733403.343200,264094612.700200,1321240104.380600,343,1870,501,2714
2013-10-25,NYSE (N),686922429,0,0,686922429,26691495192.839041,0.000000,0.000000,26691495192.839041,1748646,0,0,1748646
2013-10-25,NYSE Arca (P),229753400,168755944,180456774,578966118,8694097129.850037,11101226282.229889,7316225385.943442,27111548798.023368,1365763,364536,909642,2639941
2013-10-25,NASDAQ (Q),389263441,101977195,511891803,1003132439,14918005268.851980,7401509985.053403,18650226491.538589,40969741745.443972,2365630,333134,1986709,4685473
2013-10-25,CBSX (W),10053132,4601228,9576718,24231078,269514215.690000,237870256.180000,164793999.840000,672178471.710000,73498,8045,42890,124433
2013-10-25,NASDAQ PSX (X),12231849,10916337,14054152,37202338,354517340.910000,699146625.130000,387023582.625000,1440687548.665000,60146,34153,58951,153250
2013-10-25,BATS BYX (Y),57618031,20933664,35464216,114015911,1861628282.249003,1173770910.546700,1202375443.509401,4237774636.305104,388445,91420,216206,696071
2013-10-25,BATS BZX (Z),210760758,86330211,171379798,468470767,6625176210.865002,5540869184.321910,5259466750.610703,17425512145.797615,1258150,280896,830394,2369440
2013-10-24,NYSE MKT (A),0,10286582,8020705,18307287,0.000000,94262448.587200,110094979.822000,204357428.409200,0,20676,25462,46138
2013-10-24,NASDAQ BX (B),81907487,27425532,45913925,155246944,2645156848.190001,1262480817.484001,1747501915.397403,5655139581.071405,536172,105434,288977,930583
2013-10-24,NSX (C),13323232,4995894,9933958,28253084,386729335.694600,181973943.015000,248508190.732299,817211469.441899,51505,12591,34499,98595
2013-10-24,NYSE (DN),132977535,27856086,82043554,242877175,4498580778.115008,1374211977.682602,2875099971.738983,8747892727.536593,547884,84382,284556,916822
2013-10-24,NASDAQ (DQ),1316758524,238548617,785729471,2341036612,41795359928.886698,10460729457.855547,24638929583.451472,76895018970.193717,3786983,490820,2034151,6311954
2013-10-24,EDGA (J),80621999,30386615,46697498,157706112,2272394791.090001,1397937940.071799,1279950825.643600,4950283556.805400,513970,120166,269896,904032
2013-10-24,EDGX (K),248617078,59194757,178991513,486803348,8400375447.447317,2789738195.291385,6227258595.999128,17417372238.737830,1220361,178197,760120,2158678
2013-10-24,CHX (M),16080310,12692777,6306275,35079362,435975842.448200,878794601.190000,230746595.348600,1545517038.986800,553,1912,603,3068
2013-10-24,NYSE (N),715927062,0,0,715927062,25727020745.584304,0.000000,0.000000,25727020745.584304,1894370,0,0,1894370
2013-10-24,NYSE Arca (P),271737467,180847674,175560103,628145244,9705044973.321201,10313249476.989613,6844969935.310173,26863264385.620987,1515458,399959,911198,2826615
2013-10-24,NASDAQ (Q),442974213,110101954,500410368,1053486535,16117395524.266976,7321733627.696502,17614151914.916765,41053281066.880243,2612742,363377,2052762,5028881
2013-10-24,CBSX (W),11377689,5604525,7179887,24162101,303878006.490000,252726209.360000,163777967.240000,720382183.090000,85762,10664,48508,144934
2013-10-24,NASDAQ PSX (X),15381441,11913261,12839379,40134081,423476555.065000,722742855.760000,339298987.475600,1485518398.300600,69970,38128,57853,165951
2013-10-24,BATS BYX (Y),65092324,22983543,32680172,120756039,2060348698.782000,1218460427.719700,1146895622.924997,4425704749.426697,441788,100027,205040,746855
2013-10-24,BATS BZX (Z),261142659,94213109,163886594,519242362,7922726368.596316,5798594269.662309,4931438429.549879,18652759067.808504,1531946,311950,859077,2702973
2013-10-23,NYSE MKT (A),0,10391088,7088585,17479673,0.000000,70878382.476900,103887010.672000,174765393.148900,0,22516,23370,45886
2013-10-23,NASDAQ BX (B),84517118,30941761,46589894,162048773,2643216943.354998,1520951433.730001,1725762193.649200,5889930570.734199,553467,128282,290975,972724
2013-10-23,NSX (C),16370534,5652934,10599785,32623253,424038045.732700,210422987.969500,261098056.016000,895559089.718200,55222,13581,36959,105762
2013-10-23,NYSE (DN),135207736,34343010,79667308,249218054,4523899483.145191,1680059073.262297,2983473360.664695,9187431917.072183,572024,99378,289083,960485
2013-10-23,NASDAQ (DQ),1280339008,325667335,708421551,2314427894,39833665621.412280,14868380243.379405,22970116730.781135,77672162595.572820,3884431,561694,1992419,6438544
2013-10-23,EDGA (J),85623876,39551191,46366268,171541335,2438430184.401802,1871121432.406801,1437360546.921499,5746912163.730102,542841,148820,282909,974570
2013-10-23,EDGX (K),251885301,73061022,163266258,488212581,8784787957.772900,3714286050.614206,6126064236.554609,18625138244.941715,1253364,211438,754206,2219008
2013-10-23,CHX (M),10477387,13864900,7228703,31570990,408162419.640300,950362178.435000,417616968.599000,1776141566.674300,334,2356,561,3251
2013-10-23,NYSE (N),708509380,0,0,708509380,25109229663.753989,0.000000,0.000000,25109229663.753989,1907458,0,0,1907458
2013-10-23,NYSE Arca (P),286164472,221730343,168604891,676499706,10483774434.708196,13727640486.968527,7072539549.723397,31283954471.400120,1590979,477030,917457,2985466
2013-10-23,NASDAQ (Q),478339368,139519206,465717201,1083575775,17887403389.941065,9432134959.650987,17419686517.299094,44739224866.891146,2800646,440866,2041898,5283410
2013-10-23,CBSX (W),12956375,3474221,6692751,23123347,413248272.520000,180060918.800000,181780321.630000,775089512.950000,93678,11052,45274,150004
2013-10-23,NASDAQ PSX (X),16241824,14327267,13103755,43672846,438225109.270000,937186526.320000,417562271.405000,1792973906.995000,78510,46029,65058,189597
2013-10-23,BATS BYX (Y),68904187,26955165,33982343,129841695,2127464874.640500,1383061744.054100,1193047209.691798,4703573828.386398,461943,117080,214953,793976
2013-10-23,BATS BZX (Z),280826662,121854048,160761898,563442608,8493216321.279966,7734159409.391625,5090818420.124693,21318194150.796284,1610559,390800,852882,2854241
2013-10-22,NYSE MKT (A),0,11585907,7360663,18946570,0.000000,73070580.926400,127829275.139000,200899856.065400,0,24653,28116,52769
2013-10-22,NASDAQ BX (B),84110805,36412342,43891794,164414941,2708770151.565000,1843165236.783699,2142395902.165499,6694331290.514198,542524,142830,282896,968250
2013-10-22,NSX (C),17442695,7329264,9688668,34460627,438153601.875000,298502197.628700,295981166.114699,1032636965.618399,57415,18007,34543,109965
2013-10-22,NYSE (DN),136210268,40266060,89318117,265794445,4488317850.253769,2020326280.444897,3884454308.940894,10393098439.639560,578022,114687,296027,988736
2013-10-22,NASDAQ (DQ),1324079291,364249978,693064060,2381393329,41002486014.637094,17272941489.433833,26880563070.628680,85155990574.699607,3971915,652012,1972815,6596742
2013-10-22,EDGA (J),86638960,47088703,42961126,176688789,2407509841.240000,2349096466.326703,1501903444.221599,6258509751.788302,535119,170109,257659,962887
2013-10-22,EDGX (K),267511256,84111956,165165439,516788651,9335132703.960081,4242331379.171698,7391815273.022518,20969279356.154297,1310942,244476,760228,2315646
2013-10-22,CHX (M),10765661,7075873,4046012,21887546,400560931.997300,554560777.664000,247698767.245700,1202820476.907000,517,3734,563,4814
2013-10-22,NYSE (N),753051272,0,0,753051272,27154885794.523882,0.000000,0.000000,27154885794.523882,1944830,0,0,1944830
2013-10-22,NYSE Arca (P),303912375,236428511,160808685,701149571,10811245079.693515,15253507573.356803,8001250807.966094,34066003461.016412,1620222,527197,867779,3015198
2013-10-22,NASDAQ (Q),482508080,165681166,464374399,1112563645,18006157459.728939,11507994317.308001,19947681183.477763,49461832960.514703,2783497,538291,2026658,5348446
2013-10-22,CBSX (W),12091675,5527420,5985494,23604589,388966883.160000,330307043.950000,171565014.880000,890838941.990000,88269,13809,40858,142936
2013-10-22,NASDAQ PSX (X),15078750,16086500,10923786,42089036,369310957.030000,1044259839.025000,342228645.100000,1755799441.155000,63725,51017,46359,161101
2013-10-22,BATS BYX (Y),68064238,33397572,35182975,136644785,2146568345.822002,1824616927.828498,1500082121.816101,5471267395.466601,454728,136750,220142,811620
2013-10-22,BATS BZX (Z),293007211,144200999,159217808,596426018,8925621332.939994,8996807772.929891,5808357824.609413,23730786930.479298,1659197,451963,841495,2952655
2013-10-21,NYSE MKT (A),0,10287223,7153769,17440992,0.000000,58974275.220100,120829670.117000,179803945.337100,0,19595,27781,47376
2013-10-21,NASDAQ BX (B),71483811,27156934,39136233,137776978,2232945190.255002,1259393172.327600,1563908221.818000,5056246584.400602,461381,110177,250027,821585
2013-10-21,NSX (C),13171250,5901134,9732631,28805015,347627694.115000,209144214.738100,263252470.886200,820024379.739300,45268,14457,32448,92173
2013-10-21,NYSE (DN),112446932,28598320,77770564,218815816,3692024830.741914,1402243507.315502,2763324998.226987,7857593336.284403,509316,87172,270385,866873
2013-10-21,NASDAQ (DQ),1040802045,310196290,665755622,2016753957,32193006863.856507,16807235581.118231,21550912441.965330,70551154886.940068,3375546,514142,1893069,5782757
2013-10-21,EDGA (J),69719842,32280527,40401985,142402354,2018683661.095900,1566213291.024899,1263114496.126300,4848011448.247099,452391,123254,246160,821805
2013-10-21,EDGX (K),210806878,59498394,160884027,431189299,7372160845.037804,2673526312.052809,6285971872.108317,16331659029.198930,1066975,172279,696866,1936120
2013-10-21,CHX (M),11827766,9820022,3038362,24686150,436742647.822000,549504907.435000,174977156.901200,1161224712.158200,641,1847,387,2875
2013-10-21,NYSE (N),678308878,0,0,678308878,23995914344.370090,0.000000,0.000000,23995914344.370090,1636320,0,0,1636320
2013-10-21,NYSE Arca (P),225187869,159977973,148523379,533689221,8210257333.031532,10212224121.895097,6918048165.927827,25340529620.854456,1280778,377824,789979,2448581
2013-10-21,NASDAQ (Q),346932303,102532369,424292174,873756846,13229317255.851998,7009981722.432091,16805738788.769332,37045037767.053421,2102612,338071,1753281,4193964
2013-10-21,CBSX (W),10810943,5227857,5868039,21906839,344400020.530000,252736562.660000,144906986.370000,742043569.560000,79160,11720,37452,128332
2013-10-21,NASDAQ PSX (X),9940466,10203303,10846798,30990567,269942082.120000,611233053.465000,287106105.700000,1168281241.285000,52344,33395,43291,129030
2013-10-21,BATS BYX (Y),54986622,22358046,29884678,107229346,1742522492.073001,1198209432.292301,1123544786.676101,4064276711.041403,371227,96655,183583,651465
2013-10-21,BATS BZX (Z),204487211,91355587,139773302,435616100,6554388114.465008,5576051532.608016,4625185971.845701,16755625618.918725,1260574,299914,740800,2301288
2013-10-18,NYSE MKT (A),0,11977082,6447950,18425032,0.000000,80302760.958800,118087419.872000,198390180.830800,0,21460,21572,43032
2013-10-18,NASDAQ BX (B),78799618,31424418,38671755,148895791,2562300588.190000,1683352437.398200,1939890385.865004,6185543411.453204,505496,123104,255877,884477
2013-10-18,NSX (C),15071453,5533763,10828195,31433411,471749051.805000,211994766.685400,279615645.484600,963359463.975000,58401,14302,34746,107449
2013-10-18,NYSE (DN),123331023,34451600,76514882,234297505,4271220139.940690,1780446609.989507,3056678103.328910,9108344853.259107,536396,95883,286102,918381
2013-10-18,NASDAQ (DQ),1222526915,314359557,697043851,2233930323,38745799215.281440,16405413612.529627,24053389644.709756,79204602472.520823,3696864,597594,1923993,6218451
2013-10-18,EDGA (J),78734484,37866720,39788617,156389821,2426783422.945001,2036174142.863801,1384087162.947299,5847044728.756101,512531,145935,251860,910326
2013-10-18,EDGX (K),250836951,73504964,168552852,492894767,9104316604.810105,3669153933.544398,6923609612.965005,19697080151.319508,1248194,209485,732110,2189789
2013-10-18,CHX (M),14304653,10599995,6269688,31174336,610078808.202400,792120055.377200,486006420.957100,1888205284.536700,360,2117,470,2947
2013-10-18,NYSE (N),892067872,0,0,892067872,34433920549.651209,0.000000,0.000000,34433920549.651209,1841141,0,0,1841141
2013-10-18,NYSE Arca (P),266942691,212056952,152714179,631713822,10188187246.181378,14647699285.506569,7957704059.763791,32793590591.451738,1504895,467190,825825,2797910
2013-10-18,NASDAQ (Q),412594637,140649629,551730398,1104974664,16015329674.000146,10603040083.475589,23341329103.765157,49959698861.240892,2486944,433368,1957873,4878185
2013-10-18,CBSX (W),12327440,3941739,5348418,21617597,405469958.020000,240789962.630000,171636857.800000,817896778.450000,94106,15117,41434,150657
2013-10-18,NASDAQ PSX (X),12325865,12933536,9387487,34646888,337563754.690000,851938299.625000,303138373.010000,1492640427.325000,60972,37416,44919,143307
2013-10-18,BATS BYX (Y),63378897,28688212,31585965,123653074,2060415731.149999,1639118580.796100,1332928395.460004,5032462707.406103,424029,122981,203820,750830
2013-10-18,BATS BZX (Z),235002530,115054808,148780619,498837957,7861342810.799398,7626234749.627303,5812879443.519508,21300457003.946209,1445308,375645,818757,2639710
2013-10-17,NYSE MKT (A),0,12750561,7208978,19959539,0.000000,108222893.457300,131440901.038000,239663794.495300,0,24793,25074,49867
2013-10-17,NASDAQ BX (B),79061852,36599717,42119326,157780895,2574599453.385995,1855175061.268200,1515195102.953100,5944969617.607295,514740,139408,269277,923425
2013-10-17,NSX (C),17556113,7185249,11166505,35907867,467361723.065100,277382938.367400,251141882.386000,995886543.818500,60241,18074,34630,112945
2013-10-17,NYSE (DN),117689579,38552596,80317682,236559857,4232634834.295267,1900532758.378209,2600954239.151031,8734121831.824507,521582,108346,272279,902207
2013-10-17,NASDAQ (DQ),1136256445,369880327,718413137,2224549909,37815435832.159954,19176852878.403805,20102943036.599702,77095231747.163461,3689549,684762,1904100,6278411
2013-10-17,EDGA (J),76571208,41386254,42981634,160939096,2242939460.953900,2089475531.194598,1207600230.879102,5540015223.027600,495965,154666,254078,904709
2013-10-17,EDGX (K),254143020,92480245,180783329,527406594,9076027853.149205,4489136713.217199,5876342631.558698,19441507197.925102,1258097,259959,739567,2257623
2013-10-17,CHX (M),9085635,13293796,6604928,28984359,463016477.875600,976067554.781200,468611527.587500,1907695560.244300,348,3055,534,3937
2013-10-17,NYSE (N),760504912,0,0,760504912,27240155717.606018,0.000000,0.000000,27240155717.606018,1860819,0,0,1860819
2013-10-17,NYSE Arca (P),263553119,244479753,172475524,680508396,10057079721.611883,15491566460.820397,6789907681.030502,32338553863.462782,1472815,521085,838220,2832120
2013-10-17,NASDAQ (Q),412187926,146545074,498599724,1057332724,16179180898.775456,10144994619.149707,17323153864.063006,43647329381.988169,2518438,472540,1888094,4879072
2013-10-17,CBSX (W),13139947,3294039,6735731,23169717,425690619.820000,180146377.970000,177801411.120000,783638408.910000,102889,16519,48368,167776
2013-10-17,NASDAQ PSX (X),11895115,14967584,11454831,38317530,327819261.080000,959349389.315000,339312340.850000,1626480991.245000,63736,43901,49678,157315
2013-10-17,BATS BYX (Y),64218494,30633283,34437010,129288787,2124093407.649997,1682180605.383803,1194009507.914997,5000283520.948797,429464,131301,214035,774800
2013-10-17,BATS BZX (Z),242062140,131384815,163291044,536737999,7813799815.633002,8258000486.173900,4950239747.174402,21022040048.981304,1489144,430347,822553,2742044
2013-10-16,NYSE MKT (A),0,9375565,6467688,15843253,0.000000,65063727.216900,119842413.637000,184906140.853900,0,20207,25512,45719
2013-10-16,NASDAQ BX (B),82945279,36357098,40895965,160198342,2664368033.534997,1940116617.407298,1594652944.355700,6199137595.297995,531296,145217,257291,933804
2013-10-16,NSX (C),17041369,7084541,11743291,35869201,447098458.938000,293753278.870000,261419059.326999,1002270797.134999,59527,17022,35507,112056
2013-10-16,NYSE (DN),127040303,39577132,78574532,245191967,3999521137.039086,2014493802.463603,2658206699.477789,8672221638.980478,529134,110212,261213,900559
2013-10-16,NASDAQ (DQ),1176944471,355252558,636352526,2168549555,35746090251.905555,18713513769.911137,19867115409.187250,74326719431.003942,3592077,645778,1754784,5992639
2013-10-16,EDGA (J),84161860,45810115,39251945,169223920,2354881011.164997,2224312538.206500,1181299749.565798,5760493298.937295,521619,165538,232612,919769
2013-10-16,EDGX (K),259329757,90548756,168129722,518008235,8795054457.537095,4533438369.917997,5847747337.187379,19176240164.642471,1271727,254981,715639,2242347
2013-10-16,CHX (M),10841128,15443535,2868780,29153443,439579121.902000,1452876297.058300,139076456.330400,2031531875.290700,1255,2449,610,4314
2013-10-16,NYSE (N),752582316,0,0,752582316,25928083870.443190,0.000000,0.000000,25928083870.443190,1851411,0,0,1851411
2013-10-16,NYSE Arca (P),283560075,248938201,144936838,677435114,9909427951.154388,16530999580.394487,5868212598.044708,32308640129.593583,1528917,535169,785515,2849601
2013-10-16,NASDAQ (Q),433829623,163493214,426657645,1023980482,15973211145.080989,11148844334.821896,15536236533.069846,42658292012.972731,2544196,522522,1774406,4841124
2013-10-16,CBSX (W),12157398,3846704,6874763,22878865,303731052.870000,157231565.210000,153300010.450000,614262628.530000,91095,9416,47903,148414
2013-10-16,NASDAQ PSX (X),13185589,16077747,10253004,39516340,322776426.155000,1051830670.856000,355533747.105000,1730140844.116000,63781,45831,48069,157681
2013-10-16,BATS BYX (Y),65757318,33316622,32284887,131358827,2088458549.189997,1740801092.615598,1163572956.425400,4992832598.230995,429804,139991,201912,771707
2013-10-16,BATS BZX (Z),255456103,149142396,145391023,549989522,7792223018.085007,9500405047.561411,4863341132.183004,22155969197.829422,1505987,472741,781781,2760509
2013-10-15,NYSE MKT (A),0,8888376,6563545,15451921,0.000000,67414518.932400,134604262.029000,202018780.961400,0,18993,27905,46898
2013-10-15,NASDAQ BX (B),84972326,38954008,40832274,164758608,2542237353.724999,2022098631.673200,1510094289.980000,6074430275.378199,542718,170909,269413,983040
2013-10-15,NSX (C),14827319,6168934,14038820,35035073,383671998.755000,282563889.942300,246439501.495000,912675390.192300,51697,16428,33530,101655
2013-10-15,NYSE (DN),112438774,34525824,77508164,224472762,3558151957.672083,1815835257.940700,2623185349.537597,7997172565.150380,487392,100094,245640,833126
2013-10-15,NASDAQ (DQ),1045007030,297619362,588155261,1930781653,31153460796.151286,15461837832.343019,17966658656.356338,64581957284.850643,3332485,607078,1667700,5607263
2013-10-15,EDGA (J),79255309,45189529,40486193,164931031,2142015550.979601,2167982488.833300,1220619010.345299,5530617050.158200,501249,179574,247682,928505
2013-10-15,EDGX (K),249094010,87976643,175627636,512698289,8033862064.436190,4632454954.259897,6023770482.833584,18690087501.529671,1235534,282076,746737,2264347
2013-10-15,CHX (M),10300237,11622678,4233349,26156264,435705214.338900,926058178.050000,223263865.940800,1585027258.329700,332,3715,486,4533
2013-10-15,NYSE (N),690390085,0,0,690390085,23995921519.169979,0.000000,0.000000,23995921519.169979,1863078,0,0,1863078
2013-10-15,NYSE Arca (P),273044151,250712719,155055594,678812464,9505075415.889767,16343592520.929435,6308477234.184504,32157145171.003706,1514640,591486,826363,2932489
2013-10-15,NASDAQ (Q),432661780,168279448,450422076,1051363304,15718450647.829378,11980625002.356269,16194930669.670453,43894006319.856100,2643647,556398,1986871,5186916
2013-10-15,CBSX (W),11054863,3327092,5868352,20250307,277331571.440000,175677944.840000,123548669.566900,576558185.846900,80796,10993,41938,133727
2013-10-15,NASDAQ PSX (X),13430515,15735704,9840586,39006805,315077417.540000,1074648847.805000,342601587.435000,1732327852.780000,63030,48501,47167,158698
2013-10-15,BATS BYX (Y),68265350,32197819,32306284,132769453,2039321163.788998,1654845088.469002,1171735371.982805,4865901624.240805,448456,142743,211318,802517
2013-10-15,BATS BZX (Z),244537450,144372746,146523011,535433207,7183966784.105021,9310441814.431578,4603788412.734096,21098197011.270695,1446857,485139,772983,2704979
2013-10-14,NYSE MKT (A),0,7778553,5371891,13150444,0.000000,48894568.546700,111497647.160000,160392215.706700,0,14878,21606,36484
2013-10-14,NASDAQ BX (B),69299416,31316080,35964123,136579619,2187688017.353101,1621362122.466200,1353586637.557596,5162636777.376897,458905,125107,228757,812769
2013-10-14,NSX (C),12971242,5578720,9118970,27668932,349015543.471600,230200496.783900,210507837.865500,789723878.121000,46170,14424,29291,89885
2013-10-14,NYSE (DN),87858315,30849297,61041463,179749075,2701418253.210287,1548745643.139098,2144050582.192598,6394214478.541983,375176,84404,212682,672262
2013-10-14,NASDAQ (DQ),775402274,252943088,515777748,1544123110,23158003229.566862,12397399233.296065,15300756686.985191,50856159149.848118,2609978,496555,1459806,4566339
2013-10-14,EDGA (J),68741323,39105607,37889333,145736263,1886440457.723000,1799474683.506900,1098032622.754499,4783947763.984399,430264,146502,230616,807382
2013-10-14,EDGX (K),190574086,74420787,143032953,408027826,6459615060.916011,3693232086.853801,5135616570.242803,15288463718.012615,1007310,224092,650614,1882016
2013-10-14,CHX (M),5305817,12256769,2551001,20113587,242026844.496800,1433897526.411200,117610911.409600,1793535282.317600,350,2465,385,3200
2013-10-14,NYSE (N),574976045,0,0,574976045,20411077509.632900,0.000000,0.000000,20411077509.632900,1527289,0,0,1527289
2013-10-14,NYSE Arca (P),194315718,205362335,129635104,529313157,6906191028.750999,13080905179.843206,5084598970.179711,25071695178.773916,1149826,470977,708753,2329556
2013-10-14,NASDAQ (Q),334035698,128445591,379527542,842008831,11989885722.129037,8578992372.408792,13447157249.500247,34016035344.038076,2034746,424924,1648913,4108583
2013-10-14,CBSX (W),9840754,2885171,5606942,18332867,250354089.680000,127822261.490000,126718196.173500,504894547.343500,70822,9270,41040,121132
2013-10-14,NASDAQ PSX (X),10155782,12102203,8244532,30502517,262437477.085000,804170828.096000,266415790.325000,1333024095.506000,52579,38952,41797,133328
2013-10-14,BATS BYX (Y),56948254,28189094,28977118,114114466,1793287270.847500,1503315372.712001,1045224081.685003,4341826725.244504,385391,117591,189116,692098
2013-10-14,BATS BZX (Z),192331768,110571348,122405759,425308875,5828240120.395004,6713464664.983897,3860728178.735097,16402432964.113998,1163592,365034,672742,2201368
2013-10-11,NYSE MKT (A),0,7811366,7008315,14819681,0.000000,55983206.842500,122597090.015000,178580296.857500,0,16277,28136,44413
2013-10-11,NASDAQ BX (B),75580506,38851442,40663809,155095757,2338036082.434998,2047353074.848098,1343328063.990301,5728717221.273397,492540,153301,268761,914602
2013-10-11,NSX (C),11299218,5986623,8978976,26264817,320560297.010100,240690068.237300,167100844.097400,728351209.344800,44971,15839,28433,89243
2013-10-11,NYSE (DN),103067152,33691102,80202671,216960925,3323185486.161494,1678777091.901697,2452175769.955297,7454138348.018488,458000,96323,249634,803957
2013-10-11,NASDAQ (DQ),940600676,292678723,632521863,1865801262,29083015785.544260,14329555334.102221,17025470258.249813,60438041377.896294,3127960,571105,1666754,5365819
2013-10-11,EDGA (J),72755065,38617905,43454396,154827366,2061191453.290303,1906802048.154897,1105578676.951600,5073572178.396800,464765,150465,256542,871772
2013-10-11,EDGX (K),214270365,76959551,168822230,460052146,7440982608.839312,3834729104.119407,5322948561.205283,16598660274.164002,1139199,235448,731945,2106592
2013-10-11,CHX (M),9787187,9058871,3863874,22709932,352051527.002400,778458710.540000,172528515.082500,1303038752.624900,291,3656,397,4344
2013-10-11,NYSE (N),634890982,0,0,634890982,22499271941.077345,0.000000,0.000000,22499271941.077345,1713401,0,0,1713401
2013-10-11,NYSE Arca (P),232432251,201278169,153310472,587020892,8342427310.907105,12967290842.888184,5739443704.410008,27049161858.205297,1351289,487945,813101,2652335
2013-10-11,NASDAQ (Q),349940497,131642299,421386605,902969401,12967053720.684198,9066677326.670606,14212615071.951434,36246346119.306238,2181883,440275,1815646,4437804
2013-10-11,CBSX (W),9910019,2406201,5422293,17738513,245320038.730000,124751119.300000,108854598.331100,478925756.361100,75561,8282,38870,122713
2013-10-11,NASDAQ PSX (X),10711388,13555954,9480897,33748239,284950722.775000,932193147.820000,284093656.390000,1501237526.985000,56134,40859,49700,146693
2013-10-11,BATS BYX (Y),58255652,28542909,30528050,117326611,1819186555.732999,1523765809.008000,984710344.904198,4327662709.645197,398552,120835,199776,719163
2013-10-11,BATS BZX (Z),221376835,116833618,145188123,483398576,6828704024.811985,7225492930.647004,4289939900.159296,18344136855.618285,1356738,400896,774828,2532462
2013-10-10,NYSE MKT (A),0,8248735,7891773,16140508,0.000000,54756431.344800,139936812.952000,194693244.296800,0,17597,31559,49156
2013-10-10,NASDAQ BX (B),88352286,46286307,45704896,180343489,2687115710.954998,2490659798.630200,1703780011.100003,6881555520.685201,562366,178744,289909,1031019
2013-10-10,NSX (C),14799633,8372900,10981761,34154294,414671846.140000,472486756.071700,239673906.333099,1126832508.544799,53593,18440,31868,103901
2013-10-10,NYSE (DN),120702887,42240951,82015314,244959152,3740236313.543803,2171024067.940799,2835574254.791574,8746834636.276176,517503,118993,285879,922375
2013-10-10,NASDAQ (DQ),1079362724,382008152,673481960,2134852836,31802546023.971903,21737955512.862783,20013788393.479343,73554289930.314029,3381339,644126,1821175,5846640
2013-10-10,EDGA (J),81531194,47705831,44138836,173375861,2210548481.025003,2344948698.396001,1246392178.477796,5801889357.898800,500720,173038,258185,931943
2013-10-10,EDGX (K),252824533,99922553,180886768,533633854,8724471810.121402,5238749966.347308,6095418001.001387,20058639777.470097,1323061,303859,795707,2422627
2013-10-10,CHX (M),14158724,15789525,5267948,35216197,535602708.945200,1445893565.999200,188792793.505000,2170289068.449400,398,3451,561,4410
2013-10-10,NYSE (N),738057934,0,0,738057934,26312946694.978281,0.000000,0.000000,26312946694.978281,1930207,0,0,1930207
2013-10-10,NYSE Arca (P),263508454,296960350,171580405,732049209,9179633716.382815,19387473522.110229,6603135286.537351,35170242525.030395,1490589,627816,888756,3007161
2013-10-10,NASDAQ (Q),398410793,185277562,458834387,1042522742,14705735045.393030,13171259006.634194,16552001016.362928,44428995068.390152,2455111,584372,1963183,5002666
2013-10-10,CBSX (W),10245736,4039181,5807154,20092071,268214970.620000,230130353.464000,139431369.330900,637776693.414900,76793,11649,42712,131154
2013-10-10,NASDAQ PSX (X),13128242,17342529,12207312,42678083,335448197.550000,1214557662.645000,378620352.830000,1928626213.025000,64589,52286,54240,171115
2013-10-10,BATS BYX (Y),67206114,36014976,35058155,138279245,2036503745.146004,2071022191.369995,1176014179.870799,5283540116.386798,452856,153026,224314,830196
2013-10-10,BATS BZX (Z),248720293,160774979,169861825,579357097,7641600822.829710,10072446232.333387,5198141680.347799,22912188735.510896,1500639,506526,872734,2879899
2013-10-09,NYSE MKT (A),0,8781736,7653036,16434772,0.000000,59543643.568700,119449735.404000,178993378.972700,0,18814,29358,48172
2013-10-09,NASDAQ BX (B),95793914,48463656,55804356,200061926,2920691218.215001,2407315701.497900,2133333079.077005,7461339998.789906,618528,202138,364679,1185345
2013-10-09,NSX (C),16091822,8100368,13059933,37252123,413988529.870000,322247346.618700,286552791.586200,1022788668.074900,60901,20645,39160,120706
2013-10-09,NYSE (DN),135884880,40694029,90072051,266650960,4009894066.557688,2109903374.212598,3214714371.516008,9334511812.286294,540052,107368,316200,963620
2013-10-09,NASDAQ (DQ),1107248997,392870290,767263680,2267382967,32793926337.025467,18926249027.065568,23642027603.191271,75362202967.282306,3598125,640579,2107624,6346328
2013-10-09,EDGA (J),89111875,53640740,54977404,197730019,2382690590.198500,2448594397.229199,1673200263.204399,6504485250.632098,553965,192458,331310,1077733
2013-10-09,EDGX (K),261446431,105881234,207508415,574836080,8766913942.499619,5431036721.420906,6913165695.639017,21111116359.559542,1413116,328081,958933,2700130
2013-10-09,CHX (M),13561722,9586368,5113761,28261851,383785589.558700,753568828.230000,190535031.103900,1327889448.892600,379,4134,638,5151
2013-10-09,NYSE (N),732379987,0,0,732379987,25148254742.120704,0.000000,0.000000,25148254742.120704,2086045,0,0,2086045
2013-10-09,NYSE Arca (P),286142389,284949850,217064532,788156771,9903388025.020219,18227927694.336813,8189961675.792782,36321277395.149814,1665847,652262,1115340,3433449
2013-10-09,NASDAQ (Q),467588582,205665837,565119805,1238374224,16573331867.033036,13675776714.541811,19905441095.494040,50154549677.068887,2894497,666323,2527550,6088370
2013-10-09,CBSX (W),9621094,5244040,6644168,21509302,245710859.720000,304895669.320000,150702458.450000,701308987.490000,76027,10283,47957,134267
2013-10-09,NASDAQ PSX (X),15594743,19841324,14723268,50159335,385502886.625000,1289683961.155000,496408371.055000,2171595218.835000,75867,60347,69845,206059
2013-10-09,BATS BYX (Y),70875573,37522575,39775301,148173449,2097037295.649000,1829173532.022400,1391877367.369401,5318088195.040801,483655,157094,257981,898730
2013-10-09,BATS BZX (Z),283175862,174765874,198725753,656667489,8356473826.599996,10883134824.988577,6086518028.663843,25326126680.252416,1719671,571958,1072741,3364370
2013-10-08,NYSE MKT (A),0,11039849,6650270,17690119,0.000000,64683437.766800,101208655.278000,165892093.044800,0,19974,22560,42534
2013-10-08,NASDAQ BX (B),88615078,42826025,50450966,181892069,2844935579.370001,2212096064.130100,1937564019.077602,6994595662.577703,576717,172056,319033,1067806
2013-10-08,NSX (C),18350004,8768384,16182906,43301294,440349457.180000,305356008.001300,364778600.139400,1110484065.320700,63136,20081,45255,128472
2013-10-08,NYSE (DN),128181278,43495637,86235329,257912244,3859851516.646622,2096044904.654194,3074261063.290878,9030157484.591694,538829,111724,303670,954223
2013-10-08,NASDAQ (DQ),1170919249,377390251,742525466,2290834966,33329702732.159241,19474724983.858247,21997723998.626624,74802151714.644112,3709691,690299,2089669,6489659
2013-10-08,EDGA (J),84762494,52074559,48354326,185191379,2274073820.541403,2464768747.208099,1423516176.742601,6162358744.492103,530171,197332,284165,1011668
2013-10-08,EDGX (K),275024807,108319051,215097386,598441244,8816197319.085113,5487553171.274397,7159670960.814796,21463421451.174306,1407844,332078,953660,2693582
2013-10-08,CHX (M),11014350,11222636,5194676,27431662,446489987.593400,517519385.608600,167468402.900000,1131477776.102000,338,2784,613,3735
2013-10-08,NYSE (N),732976119,0,0,732976119,25171392841.651169,0.000000,0.000000,25171392841.651169,1997645,0,0,1997645
2013-10-08,NYSE Arca (P),286187034,272322321,189499175,748008530,9924768497.273213,17976512728.703608,7583895761.889754,35485176987.866575,1628476,649599,1009165,3287240
2013-10-08,NASDAQ (Q),427321130,185689916,502297861,1115308907,15465633159.779584,12771146464.837809,17920252978.501735,46157032603.119128,2655464,614738,2219459,5489661
2013-10-08,CBSX (W),10622699,3808858,6499739,20931296,329042851.000000,166848488.450000,178051167.470000,673942506.920000,83882,13100,49287,146269
2013-10-08,NASDAQ PSX (X),15264187,20570895,13376822,49211904,378896465.800000,1308983163.785000,420640092.315000,2108519721.900000,73321,62266,61359,196946
2013-10-08,BATS BYX (Y),69144930,41192092,35914081,146251103,2105678711.728805,2166861074.620000,1264513955.574003,5537053741.922808,463501,168406,232433,864340
2013-10-08,BATS BZX (Z),253043801,169459402,170119055,592622258,7757110767.090013,10798442612.673398,5271674774.189804,23827228153.953215,1575173,561525,948145,3084843
2013-10-07,NYSE MKT (A),0,10017526,5652397,15669923,0.000000,58040325.870400,95365116.623000,153405442.493400,0,19586,21323,40909
2013-10-07,NASDAQ BX (B),69061323,28511696,35116657,132689676,2189610434.734602,1433444953.773600,1285776876.796300,4908832265.304502,446783,115560,231596,793939
2013-10-07,NSX (C),13600986,7019164,11216276,31836426,326285016.901000,212988203.390100,251525533.840000,790798754.131100,45319,14960,32590,92869
2013-10-07,NYSE (DN),92091920,29795034,63724377,185611331,2825902732.910303,1399130925.692500,2273141827.624885,6498175486.227688,417951,79639,222579,720169
2013-10-07,NASDAQ (DQ),908522529,258441295,534500235,1701464059,28060230580.100548,11570897602.404587,15976068225.553914,55607196408.059049,2813523,492042,1501183,4806748
2013-10-07,EDGA (J),63487205,34164713,34048961,131700879,1743712884.810000,1585041204.438599,1034750284.058399,4363504373.306998,408041,130961,209204,748206
2013-10-07,EDGX (K),189549006,79482441,145570399,414601846,6367923422.651000,3580304569.071088,5174405178.837615,15122633170.559703,1005470,234767,647734,1887971
2013-10-07,CHX (M),8157561,9025724,4763806,21947091,322923644.515000,488977810.450000,198902932.396500,1010804387.361500,380,1980,422,2782
2013-10-07,NYSE (N),594549057,0,0,594549057,20826780300.312824,0.000000,0.000000,20826780300.312824,1546522,0,0,1546522
2013-10-07,NYSE Arca (P),198798769,185787614,121170729,505757112,7159036370.455490,11418464982.307085,4958631838.039285,23536133190.801860,1173722,421628,660203,2255553
2013-10-07,NASDAQ (Q),300299466,116208256,363718604,780226326,11298389632.595413,7845075147.673701,13634015675.830222,32777480456.099336,1917475,398133,1560549,3876157
2013-10-07,CBSX (W),9664757,5869303,5381884,20915944,296319902.880000,224643885.870000,148112623.320000,669076412.070000,72206,9695,39877,121778
2013-10-07,NASDAQ PSX (X),10198987,11268916,7546118,29014021,254539707.695000,697920089.640000,218955968.570000,1171415765.905000,50440,37338,38855,126633
2013-10-07,BATS BYX (Y),52261540,24226884,25706294,102194718,1618251975.353002,1237591252.725500,845764227.344402,3701607455.422904,355997,96089,170061,622147
2013-10-07,BATS BZX (Z),170020637,102459267,119208613,391688517,5241077507.413997,6163959841.155591,3647557682.336210,15052595030.905798,1069743,352284,647034,2069061
2013-10-04,NYSE MKT (A),0,9162104,5894827,15056931,0.000000,54265916.601700,122714508.029000,176980424.630700,0,18486,22553,41039
2013-10-04,NASDAQ BX (B),70349119,24811003,36359621,131519743,2312295179.304996,1244061345.682000,1425933150.071701,4982289675.058697,462257,100821,237837,800915
2013-10-04,NSX (C),14709754,4921987,12924723,32556464,396476011.395000,182041487.314400,288850752.129500,867368250.838900,52850,12264,35292,100406
2013-10-04,NYSE (DN),103627218,27473299,67515868,198616385,3232219468.350206,1304104428.641300,2308723960.138396,6845047857.129902,454301,76111,249202,779614
2013-10-04,NASDAQ (DQ),1047183075,240518507,592420437,1880122019,32429155697.337308,11591535119.257015,17715359029.872175,61736049846.466498,3023063,441022,1652144,5116229
2013-10-04,EDGA (J),66205564,29818441,34492758,130516763,1811501223.529301,1533167451.258401,1012177136.272403,4356845811.060105,422363,114039,207892,744294
2013-10-04,EDGX (K),208561836,68097007,149540439,426199282,6955643135.227006,3592756296.060902,5354412875.253326,15902812306.541234,1075835,207805,670525,1954165
2013-10-04,CHX (M),11735733,7919296,4028827,23683856,517545498.142500,547847025.382400,252174091.620000,1317566615.144900,247,1326,401,1974
2013-10-04,NYSE (N),597180083,0,0,597180083,20708969664.370745,0.000000,0.000000,20708969664.370745,1553373,0,0,1553373
2013-10-04,NYSE Arca (P),208388328,170231411,129031992,507651731,7313021434.669295,10817499090.394207,5196177309.863001,23326697834.926503,1195042,415085,698103,2308230
2013-10-04,NASDAQ (Q),322722302,112917057,359714763,795354122,11720120481.860002,7820240202.015017,13336331348.654936,32876692032.529955,2013473,373683,1619338,4006494
2013-10-04,CBSX (W),10136139,3197640,5031301,18365080,332151952.310000,134224356.000000,130110107.061200,596486415.371200,78729,9598,38297,126624
2013-10-04,NASDAQ PSX (X),10693582,10274958,7968575,28937115,272257731.425000,668375535.990000,260732718.850000,1201365986.265000,53959,35309,41595,130863
2013-10-04,BATS BYX (Y),50732464,21789986,25761098,98283548,1557776742.234000,1169320157.916699,848344560.548599,3575441460.699298,345068,87103,165299,597470
2013-10-04,BATS BZX (Z),181889002,96719913,119684668,398293583,5573582546.142792,5930650139.026898,3919598743.360099,15423831428.529789,1122110,324361,667502,2113973
2013-10-03,NYSE MKT (A),0,9075802,6767063,15842865,0.000000,52599976.100600,122297587.142000,174897563.242600,0,18141,28128,46269
2013-10-03,NASDAQ BX (B),81920892,38945248,43138576,164004716,2695036117.529997,2082736243.516904,1715581230.003497,6493353591.050398,521114,157572,279433,958119
2013-10-03,NSX (C),16582856,7533807,13552044,37668707,472596660.650000,334915336.566600,321000254.331400,1128512251.548000,61602,18265,40091,119958
2013-10-03,NYSE (DN),116473467,37068649,76887595,230429711,3719605039.636899,1888362464.172294,2758884277.968721,8366851781.777914,509613,93290,270658,873561
2013-10-03,NASDAQ (DQ),1059992239,347410911,705731804,2113134954,32709850405.446807,19093200245.336303,22552147698.165722,74355198348.948832,3339329,594451,1786009,5719789
2013-10-03,EDGA (J),81205469,49486105,41610679,172302253,2260082966.252500,2655931982.513004,1297092716.261399,6213107665.026903,511506,185960,252980,950446
2013-10-03,EDGX (K),246245262,96859849,185736046,528841157,8104501268.402384,5474606753.045090,6343772575.307005,19922880596.754479,1252862,284750,809855,2347467
2013-10-03,CHX (M),8809963,7688120,3159468,19657551,388479703.490000,559999691.960000,139694336.262000,1088173731.712000,313,3035,406,3754
2013-10-03,NYSE (N),703398409,0,0,703398409,24723304832.297587,0.000000,0.000000,24723304832.297587,1890211,0,0,1890211
2013-10-03,NYSE Arca (P),254213982,246300502,160486165,661000649,8963760746.154994,17351312078.114620,6535899231.374488,32850972055.644102,1487923,581938,863612,2933473
2013-10-03,NASDAQ (Q),396493945,174554478,450022883,1021071306,14746237306.215984,13117590066.700636,16804419611.051092,44668246983.967712,2503638,580178,1970394,5054210
2013-10-03,CBSX (W),9694868,3014417,5381915,18091200,301814752.830000,152323676.060000,163828802.632000,617967231.522000,75647,12240,38835,126722
2013-10-03,NASDAQ PSX (X),14462612,18140879,11643074,44246565,360209715.450000,1193966052.340000,362233551.670000,1916409319.460000,67492,53744,56500,177736
2013-10-03,BATS BYX (Y),62655748,33813826,30888084,127357658,1940084513.900999,1960540403.518199,1098022946.643002,4998647864.062200,415201,139964,199720,754885
2013-10-03,BATS BZX (Z),230798619,157279789,150286168,538364576,7153797318.410004,10055759187.681104,4813843453.205081,22023399959.296189,1429192,517101,834436,2780729
2013-10-02,NYSE MKT (A),0,9969382,6197323,16166705,0.000000,68046977.276100,111640375.209000,179687352.485100,0,20451,24274,44725
2013-10-02,NASDAQ BX (B),81228255,30852167,42561866,154642288,2511750799.205001,1578733720.171001,1561403301.549306,5651887820.925308,511585,117840,269939,899364
2013-10-02,NSX (C),15148590,5618429,15704252,36471271,393998256.350000,224376965.125200,299692004.197899,918067225.673099,55190,15678,40719,111587
2013-10-02,NYSE (DN),107500148,28993016,72899813,209392977,3475098368.507002,1434542620.367499,2573684639.878485,7483325628.752986,497480,83666,269703,850849
2013-10-02,NASDAQ (DQ),1078983215,271382530,701069975,2051435720,32878232096.179754,15407666261.816618,20398209941.098105,68684108299.094477,3335194,501597,1728386,5565177
2013-10-02,EDGA (J),72644327,35511145,38535366,146690838,1957450939.147399,1827241225.114501,1078852822.371298,4863544986.633198,464876,135843,226444,827163
2013-10-02,EDGX (K),240310892,78022754,179866142,498199788,7935647668.878304,4064754655.037790,5673964276.392582,17674366600.308676,1261158,234922,738679,2234759
2013-10-02,CHX (M),10821797,4676715,5569379,21067891,376723536.298300,424585200.900000,316906876.141800,1118215613.340100,347,2301,373,3021
2013-10-02,NYSE (N),691199741,0,0,691199741,23772380680.460861,0.000000,0.000000,23772380680.460861,1747069,0,0,1747069
2013-10-02,NYSE Arca (P),245628860,199879546,147331030,592839436,8378717828.841498,12207095836.593304,5661385294.954574,26247198960.389376,1389898,463819,779091,2632808
2013-10-02,NASDAQ (Q),370657193,122360681,401850073,894867947,13459440429.281450,8437825700.109112,14428469292.484928,36325735421.875490,2287795,413940,1725638,4427373
2013-10-02,CBSX (W),10013040,4076177,5235317,19324534,312245742.100000,196120845.380000,153396493.580000,661763081.060000,79858,11506,40268,131632
2013-10-02,NASDAQ PSX (X),13641413,12771265,9887101,36299779,337345185.040000,828009730.885000,280744700.495000,1446099616.420000,64858,40790,47224,152872
2013-10-02,BATS BYX (Y),58950634,25216742,30048551,114215927,1843044641.210999,1311268986.177902,999169877.462403,4153483504.851304,405008,103866,188896,697770
2013-10-02,BATS BZX (Z),212725421,109445585,140152321,462323327,6470396384.395005,6589652269.492492,4265071154.809192,17325119808.696689,1324799,365052,784991,2474842
2013-10-01,NYSE MKT (A),0,9373355,6328114,15701469,0.000000,66250287.081300,119197454.269000,185447741.350300,0,19830,23744,43574
2013-10-01,NASDAQ BX (B),80620398,36259385,42403708,159283491,2634088667.968396,1895201372.705601,1549984246.094099,6079274286.768096,539841,139178,280682,959701
2013-10-01,NSX (C),15510312,5976336,14740610,36227258,386417808.950000,273602721.475600,302134182.367000,962154712.792600,52700,15191,40045,107936
2013-10-01,NYSE (DN),110751485,36107490,80837309,227696284,3483763913.042828,1945131559.475506,2778301082.253700,8207196554.772034,504234,113402,272578,890214
2013-10-01,NASDAQ (DQ),1088437980,411358629,712889869,2212686478,32180880933.680917,25316024289.124378,21256933076.806711,78753838299.612006,3313888,624597,1834996,5773481
2013-10-01,EDGA (J),75443734,48042212,41414782,164900728,2032502062.671803,2725376961.598003,1209217468.259600,5967096492.529406,486217,182110,247783,916110
2013-10-01,EDGX (K),217365637,86019937,163775504,467161078,7041258627.520490,4941305902.455999,5613404693.709921,17595969223.686410,1126289,271165,701032,2098486
2013-10-01,CHX (M),11033835,7980209,6386819,25400863,420510455.406000,883365370.203400,342060617.980000,1645936443.589400,350,3278,438,4066
2013-10-01,NYSE (N),717023624,0,0,717023624,25049719516.795268,0.000000,0.000000,25049719516.795268,1857525,0,0,1857525
2013-10-01,NYSE Arca (P),240159258,258346385,147051932,645557575,8197753886.055885,17081104700.029854,5712881174.187197,30991739760.272936,1386521,587664,805547,2779732
2013-10-01,NASDAQ (Q),376885850,161672855,442209837,980768542,13385128400.669610,12885555199.994306,15743082840.230539,42013766440.894455,2349975,549619,1874856,4774450
2013-10-01,CBSX (W),9951464,14016158,6337300,30304922,323628950.440000,959103746.050000,189861070.498900,1472593766.988900,78202,12652,42199,133053
2013-10-01,NASDAQ PSX (X),12735427,16084692,9853267,38673386,315557586.785000,1195575111.044600,292010493.015000,1803143190.844600,62529,52427,47503,162459
2013-10-01,BATS BYX (Y),60825838,30797019,29612072,121234929,1898898243.580002,1684977793.181698,1016139318.411302,4600015355.173002,420741,124914,193976,739631
2013-10-01,BATS BZX (Z),223501349,137328289,140387808,501217446,6625278282.885007,9090905982.497192,4463236488.178196,20179420753.560395,1400037,457379,813977,2671393
2013-09-30,NYSE MKT (A),0,12492284,5515577,18007861,0.000000,87920646.507900,96373740.802000,184294387.309900,0,17959,21107,39066
2013-09-30,NASDAQ BX (B),79114500,36630840,43678782,159424122,2489555778.199998,1967721390.113801,1502483015.360297,5959760183.674096,519178,144462,283375,947015
2013-09-30,NSX (C),14385215,6515423,13844331,34744969,367344405.183000,243857915.728400,256853603.280100,868055924.191500,49132,14501,37100,100733
2013-09-30,NYSE (DN),111706707,34719335,71476141,217902183,3297731245.409733,1808374676.810698,2292946755.981699,7399052678.202130,510037,99403,267802,877242
2013-09-30,NASDAQ (DQ),1012916505,324053925,680044434,2017014864,29682244136.991048,17057223680.332046,18903269383.545938,65642737200.869032,3115481,598028,1709513,5423022
2013-09-30,EDGA (J),77585161,48282403,42750193,168617757,2104953031.708903,2611492955.526896,1152418799.888298,5868864787.124097,498644,169643,254968,923255
2013-09-30,EDGX (K),213948984,85899433,167637402,467485819,6936788102.202997,4615569748.518499,4963910121.181583,16516267971.903079,1127861,262815,705715,2096391
2013-09-30,CHX (M),8839231,7628155,3176777,19644163,414186230.267000,818696725.816000,119715893.925200,1352598850.008200,342,2529,513,3384
2013-09-30,NYSE (N),878284063,0,0,878284063,31056522153.753832,0.000000,0.000000,31056522153.753832,1785762,0,0,1785762
2013-09-30,NYSE Arca (P),229692320,253526982,138474163,621693465,7897768036.250330,16279731663.897274,4941524012.552789,29119023712.700393,1331060,579735,756361,2667156
2013-09-30,NASDAQ (Q),373020780,171051027,536607810,1080679617,13206305155.877480,12203199828.602187,17979538374.482707,43389043358.962374,2292646,554342,1832919,4679907
2013-09-30,CBSX (W),9917206,4538914,5710781,20166901,310796637.710000,293238533.890000,161691640.250000,765726811.850000,76172,10920,39912,127004
2013-09-30,NASDAQ PSX (X),15427520,15877819,9944459,41249798,359234937.900000,1146337167.935001,293687753.060000,1799259858.895001,64821,47258,49613,161692
2013-09-30,BATS BYX (Y),61120610,32231314,31322162,124674086,1855130187.060000,1832173422.761198,945431835.660501,4632735445.481699,419479,127859,201949,749287
2013-09-30,BATS BZX (Z),224441029,134263160,146312445,505016634,6824321944.461780,8745263109.289605,4460932196.518087,20030517250.269472,1432012,439915,840598,2712525
2013-09-27,NYSE MKT (A),0,9424953,5328894,14753847,0.000000,57784141.822300,95780028.180000,153564170.002300,0,17741,18325,36066
2013-09-27,NASDAQ BX (B),66671695,29082602,34451871,130206168,2020246798.989999,1407486246.527199,1188742774.481002,4616475819.998200,434796,107799,227307,769902
2013-09-27,NSX (C),14906768,4992216,16473212,36372196,384178233.070000,194637222.284100,269571951.212700,848387406.566800,50263,12258,37055,99576
2013-09-27,NYSE (DN),98697400,19601402,71200869,189499671,2876301378.092101,1002967923.888001,2094087964.956289,5973357266.936391,442995,71080,242521,756596
2013-09-27,NASDAQ (DQ),989127769,282127557,642992227,1914247553,27919381943.232391,13378364845.626458,16204731740.065763,57502478528.924612,2907806,493555,1596597,4997958
2013-09-27,EDGA (J),73231798,33656332,42079545,148967675,1958738760.648800,1703017660.280500,1097711739.339000,4759468160.268300,463737,123520,238076,825333
2013-09-27,EDGX (K),208893460,70871638,166570938,446336036,6446389412.215506,3427783406.337000,4378475860.618810,14252648679.171316,1005922,214280,616567,1836769
2013-09-27,CHX (M),8938441,10137841,6389357,25465639,283985368.138400,641153058.570000,528105679.960300,1453244106.668700,288,1575,399,2262
2013-09-27,NYSE (N),647723178,0,0,647723178,20783745761.565258,0.000000,0.000000,20783745761.565258,1531107,0,0,1531107
2013-09-27,NYSE Arca (P),247315303,189103544,140322082,576740929,7659839443.853301,12009632394.787885,4899151869.725397,24568623708.366583,1239761,430200,700560,2370521
2013-09-27,NASDAQ (Q),348929160,118597979,399404021,866931160,11974304695.710566,7882488602.082694,13140527679.372661,32997320977.165921,2053319,390860,1590907,4035086
2013-09-27,CBSX (W),9597282,3033983,5556386,18187651,296497870.430000,195801939.770000,151498790.760000,643798600.960000,73209,9934,38810,121953
2013-09-27,NASDAQ PSX (X),13259641,11420858,9101415,33781914,299011787.660000,710941740.495000,261873202.615000,1271826730.770000,57856,34974,41798,134628
2013-09-27,BATS BYX (Y),58863356,25123654,27938536,111925546,1856087752.083401,1268412805.353001,913103104.331401,4037603661.767803,389823,97967,177741,665531
2013-09-27,BATS BZX (Z),197266087,99611983,133143132,430021202,5865284413.850010,6015492631.531786,4190841747.494497,16071618792.876293,1200590,330629,737630,2268849
2013-09-26,NYSE MKT (A),0,9799270,6911259,16710529,0.000000,60145579.361400,124481795.790000,184627375.151400,0,23146,26248,49394
2013-09-26,NASDAQ BX (B),71731268,28003198,41461694,141196160,2183752600.705002,1486541143.917802,1405896732.369102,5076190476.991906,459593,114622,257882,832097
2013-09-26,NSX (C),16242204,4585529,19466810,40294543,406729246.640000,144997273.903200,320489578.840799,872216099.383999,57711,12145,43337,113193
2013-09-26,NYSE (DN),93629098,18760345,82918828,195308271,2948753878.643701,982825808.024300,2540578633.172219,6472158319.840220,417970,65370,264064,747404
2013-09-26,NASDAQ (DQ),982341036,240981757,705007196,1928329989,29033406621.546659,11158390880.050701,18423546618.529891,58615344120.127251,2950803,464640,1707536,5122979
2013-09-26,EDGA (J),91071701,36196279,55598997,182866977,2753097994.778397,1803637129.587002,1466485438.181002,6023220562.546401,588195,135162,306759,1030116
2013-09-26,EDGX (K),210806381,65087254,188863244,464756879,6706963405.307819,3009799799.003594,4960310952.183899,14677074156.495312,1045553,200680,674955,1921188
2013-09-26,CHX (M),11274530,7362427,6905892,25542849,358534996.489400,494398582.640000,295583531.726000,1148517110.855400,314,1789,394,2497
2013-09-26,NYSE (N),602694906,0,0,602694906,20044676908.719698,0.000000,0.000000,20044676908.719698,1587638,0,0,1587638
2013-09-26,NYSE Arca (P),219317146,160948520,144538719,524804385,7093677102.581814,9734439520.709797,4753669541.326202,21581786164.617813,1215151,399884,721193,2336228
2013-09-26,NASDAQ (Q),327069489,106481737,419347349,852898575,11551519769.264029,6934634671.113714,13782241206.550769,32268395646.928512,1998318,366744,1705995,4071057
2013-09-26,CBSX (W),9382141,2756281,5920729,18059151,300425585.880000,132693841.550000,162122044.950000,595241472.380000,69903,10265,39409,119577
2013-09-26,NASDAQ PSX (X),10711251,10719786,10564577,31995614,276606840.560000,690648191.415000,242631692.041200,1209886724.016200,55327,35128,44496,134951
2013-09-26,BATS BYX (Y),3149581,721673,1536708,5407962,116025603.930000,39263849.500000,40118041.474600,195407494.904600,22665,3059,7776,33500
2013-09-26,BATS BZX (Z),168810823,85605734,130378284,384794841,5135532987.400015,5323360314.578593,3790563938.941210,14249457240.919818,1035000,282433,691473,2008906
2013-09-25,NYSE MKT (A),0,9900312,7388171,17288483,0.000000,78592372.622200,127585375.055000,206177747.677200,0,20022,28406,48428
2013-09-25,NASDAQ BX (B),72919815,30861301,39763029,143544145,2377274228.814701,1623584595.788399,1402892111.124700,5403750935.727800,489880,125797,254179,869856
2013-09-25,NSX (C),16769624,5778132,14656639,37204395,446893228.200000,238067546.329899,336556677.146199,1021517451.676098,60821,16154,41419,118394
2013-09-25,NYSE (DN),85044475,15394069,82036971,182475515,2841293011.845996,928055340.238901,2496939203.335012,6266287555.419909,440685,65330,263298,769313
2013-09-25,NASDAQ (DQ),1065010924,267772700,687718527,2020502151,32504909748.853626,13375099065.761974,18923962968.127719,64803971782.743319,3368041,542306,1822385,5732732
2013-09-25,EDGA (J),82056992,39724485,45277852,167059329,2397474473.458296,2199745880.719599,1305830332.320102,5903050686.497997,548914,156160,270623,975697
2013-09-25,EDGX (K),237514442,75607282,171237146,484358870,7842685134.196886,3815370591.164805,5208222438.828606,16866278164.190297,1217705,236506,719079,2173290
2013-09-25,CHX (M),11417169,10721591,5132056,27270816,461334016.993000,698470660.030000,409883127.594600,1569687804.617600,390,2621,340,3351
2013-09-25,NYSE (N),641275639,0,0,641275639,22442950301.122970,0.000000,0.000000,22442950301.122970,1753904,0,0,1753904
2013-09-25,NYSE Arca (P),238931371,219536279,149269764,607737414,8112170201.874216,15014205933.319488,5585221790.650620,28711597925.844324,1371997,514154,786467,2672618
2013-09-25,NASDAQ (Q),388444454,135195960,418768169,942408583,13960049904.674107,9301565741.890395,14281970247.588216,37543585894.152718,2398878,474177,1797715,4670770
2013-09-25,CBSX (W),13357760,3715433,7218511,24291704,395746387.973400,212216628.610000,203229727.600000,811192744.183400,99380,10205,50487,160072
2013-09-25,NASDAQ PSX (X),13201974,13622356,10448055,37272385,338128681.155000,870964803.995000,293535876.360000,1502629361.510000,66521,43196,49892,159609
2013-09-25,BATS BYX (Y),61458431,25506777,30198038,117163246,1947773594.112996,1374173982.710501,984846441.981600,4306794018.805097,426778,109627,195693,732098
2013-09-25,BATS BZX (Z),222712689,112424625,153591026,488728340,6707482647.434996,7107184908.500203,4505995594.609302,18320663150.544501,1377276,396752,818225,2592253
2013-09-24,NYSE MKT (A),0,11015726,5923452,16939178,0.000000,82888211.168100,100532408.157000,183420619.325100,0,20277,23461,43738
2013-09-24,NASDAQ BX (B),81040676,30076187,39907413,151024276,2594077270.140703,1519120950.610500,1443079654.243701,5556277874.994904,530677,115652,256376,902705
2013-09-24,NSX (C),17711558,6423388,13799889,37934835,475425524.250000,301633214.145600,319430982.527801,1096489720.923401,64593,17255,38643,120491
2013-09-24,NYSE (DN),91926308,16079982,75150669,183156959,3072751846.475987,961990079.477500,2567076025.214096,6601817951.167583,485760,65589,268414,819763
2013-09-24,NASDAQ (DQ),1162428128,337705825,694832965,2194966918,35578785634.051879,17915312684.927719,20079487785.369980,73573586104.349578,3532396,544929,1844858,5922183
2013-09-24,EDGA (J),86760634,37808997,45860808,170430439,2488891124.409903,1981113437.932099,1261152222.834698,5731156785.176700,564309,136091,272258,972658
2013-09-24,EDGX (K),222705903,74720544,168001249,465427696,7434930510.152103,3609765681.317301,5274931356.584296,16319627548.053700,1167976,218285,699144,2085405
2013-09-24,CHX (M),14543961,12492561,6857252,33893774,533767642.947100,934138966.304000,299727105.299500,1767633714.550600,953,2101,536,3590
2013-09-24,NYSE (N),673766592,0,0,673766592,23574647454.049635,0.000000,0.000000,23574647454.049635,1741214,0,0,1741214
2013-09-24,NYSE Arca (P),237951565,187799208,144699309,570450082,8090849559.272779,11378365208.177363,5526597445.433192,24995812212.883334,1374147,449209,774183,2597539
2013-09-24,NASDAQ (Q),378486762,120128766,422431301,921046829,13617190534.940977,7778630664.166994,14901170806.726882,36296992005.834853,2328257,407036,1784686,4519979
2013-09-24,CBSX (W),13270254,6055671,7745748,27071673,406219723.040000,298055410.180000,234619940.170000,938895073.390000,101808,11474,51661,164943
2013-09-24,NASDAQ PSX (X),13049750,12878080,8987194,34915024,332683167.995000,784184494.895000,268182695.975000,1385050358.865000,67423,36858,45811,150092
2013-09-24,BATS BYX (Y),64194897,24704569,30673100,119572566,2060595710.356001,1276404103.302501,1019922932.211000,4356922745.869502,443641,96839,200538,741018
2013-09-24,BATS BZX (Z),224850367,101253568,150314983,476418918,6764111856.659989,6108293705.937089,4550854373.749605,17423259936.346683,1390810,338465,818851,2548126
2013-09-23,NYSE MKT (A),0,10662312,4756788,15419100,0.000000,61010165.454700,65793828.109000,126803993.563700,0,23159,17428,40587
2013-09-23,NASDAQ BX (B),76418700,35587045,40330427,152336172,2330228922.350001,1803553112.438099,1538029577.185498,5671811611.973598,486931,131599,248746,867276
2013-09-23,NSX (C),16082626,6608818,12521566,35213010,418922435.730000,297541624.304700,360153194.620902,1076617254.655602,56791,17291,37433,111515
2013-09-23,NYSE (DN),84024972,17651689,72303106,173979767,2678359137.344606,970485717.644300,2946649755.315278,6595494610.304184,441672,76468,270424,788564
2013-09-23,NASDAQ (DQ),1047672942,345149619,637008378,2029830939,33085460351.115509,18511323829.942561,20473465115.167533,72070249296.225603,3399481,599318,1851804,5850603
2013-09-23,EDGA (J),78891712,41401509,42452124,162745345,2222966973.597599,2090811081.032897,1335609608.068499,5649387662.698995,505691,158028,247100,910819
2013-09-23,EDGX (K),217232412,76053891,154191755,447478058,7189042451.557793,3723142122.926694,5677626017.970626,16589810592.455113,1129647,242909,694672,2067228
2013-09-23,CHX (M),9752616,8645753,3787239,22185608,340033525.210000,566352248.241400,200282325.420000,1106668098.871400,883,1575,520,2978
2013-09-23,NYSE (N),690086059,0,0,690086059,24262947600.073014,0.000000,0.000000,24262947600.073014,1748899,0,0,1748899
2013-09-23,NYSE Arca (P),232741110,215421447,141305586,589468143,7900249934.995373,13343586191.584489,6834711820.695217,28078547947.275079,1334575,510603,773576,2618754
2013-09-23,NASDAQ (Q),371366478,130782431,426968922,929117831,13245519554.022013,8401514055.850272,17125189498.097425,38772223107.969710,2279831,456711,1877467,4614009
2013-09-23,CBSX (W),14339773,8576477,6985449,29901699,420954418.230000,446935025.980000,201869051.450000,1069758495.660000,100399,11988,50104,162491
2013-09-23,NASDAQ PSX (X),12987492,14344486,9349022,36681000,329850412.015000,868218838.037200,275418761.385000,1473488011.437200,64491,43761,45187,153439
2013-09-23,BATS BYX (Y),60708615,28883219,31014729,120606563,1872083768.183998,1492687215.268399,1083968565.625101,4448739549.077498,415516,114260,198696,728472
2013-09-23,BATS BZX (Z),215982826,112269111,147342852,475594789,6475380721.735802,6719067059.876002,4848498983.146611,18042946764.758415,1317513,378241,817595,2513349
2013-09-20,NYSE MKT (A),0,123912759,6245023,130157782,0.000000,481134426.675200,109615481.468000,590749908.143200,0,29388,23583,52971
2013-09-20,NASDAQ BX (B),90822392,40065436,49017415,179905243,2731033147.555004,2064884683.898200,1751537152.159998,6547454983.613202,578364,151360,301984,1031708
2013-09-20,NSX (C),18153100,8701207,15355751,42210058,462589943.445000,372948241.872600,381778966.753400,1217317152.071000,65805,21782,44707,132294
2013-09-20,NYSE (DN),103461489,21592198,64531327,189585014,3348842854.549702,1230555964.222101,2329318842.227260,6908717660.999063,548934,92739,277360,919033
2013-09-20,NASDAQ (DQ),1393602499,373940704,983743216,2751286419,45244386182.595832,17563130057.507347,34726845506.136312,97534361746.239491,3581080,670929,1923555,6175564
2013-09-20,EDGA (J),97435359,51336424,47265435,196037218,2707756659.130401,2428816354.922901,1392714802.603598,6529287816.656900,629283,183313,286538,1099134
2013-09-20,EDGX (K),251779078,94337956,172568469,518685503,8451830191.948702,4478226241.140497,5878038915.671706,18808095348.760905,1277416,288173,732535,2298124
2013-09-20,CHX (M),9652121,9086018,5498391,24236530,409450372.421400,873484453.390000,320244475.147600,1603179300.959000,842,2463,547,3852
2013-09-20,NYSE (N),2060980174,0,0,2060980174,74229181983.163596,0.000000,0.000000,74229181983.163596,1995317,0,0,1995317
2013-09-20,NYSE Arca (P),274058739,274840808,164368919,713268466,9259930455.411695,17653581795.941933,7139737702.821968,34053249954.175596,1494511,573193,852446,2920150
2013-09-20,NASDAQ (Q),418761064,160141693,994802793,1573705550,14692534549.461861,10677151118.879396,37391965169.860952,62761650838.202209,2479083,521154,1970224,4970461
2013-09-20,CBSX (W),15270748,3570494,7491684,26332926,446393585.500000,169000877.782300,196553273.630000,811947736.912300,111490,10917,51786,174193
2013-09-20,NASDAQ PSX (X),18381992,17034040,9992522,45408554,438578105.115000,1000883991.095000,319181522.630000,1758643618.840000,81047,50296,50772,182115
2013-09-20,BATS BYX (Y),73776105,29919608,35375490,139071203,2299251207.703003,1555554588.628402,1192557676.439601,5047363472.771006,497693,120742,226579,845014
2013-09-20,BATS BZX (Z),262120497,141769368,157506398,561396263,7868824521.401998,8366750103.511992,5183537346.681474,21419111971.595464,1568476,457655,891890,2918021
2013-09-19,NYSE MKT (A),0,11405195,5447779,16852974,0.000000,65232851.430700,93667760.713000,158900612.143700,0,25695,21814,47509
2013-09-19,NASDAQ BX (B),89893663,39959733,40793149,170646545,2797551897.160001,1979752705.339902,1527543759.138396,6304848361.638299,590275,145480,272179,1007934
2013-09-19,NSX (C),22758927,7924811,16099739,46783477,627160975.005000,343567562.347200,349373340.177700,1320101877.529900,83972,20981,40945,145898
2013-09-19,NYSE (DN),107663310,24253246,62605088,194521644,3519392246.224467,1247120251.878800,2144028111.987800,6910540610.091067,552940,90139,261120,904199
2013-09-19,NASDAQ (DQ),1327812938,422094748,702581901,2452489587,39453222435.543774,24214415503.232605,20692641221.407156,84360279160.183535,4045286,699986,1851247,6596519
2013-09-19,EDGA (J),98816009,50772908,44639008,194227925,2830261993.944998,2446291415.960402,1326185126.609398,6602738536.514798,648272,182916,266661,1097849
2013-09-19,EDGX (K),263723305,89412345,160582223,513717873,8712214273.128009,4553210672.986798,5234805038.820295,18500229984.935102,1309070,277371,659917,2246358
2013-09-19,CHX (M),11026224,12692792,3144076,26863092,389211388.277700,1092215862.318800,182271124.807000,1663698375.403500,1224,3658,473,5355
2013-09-19,NYSE (N),738344856,0,0,738344856,25533875335.027965,0.000000,0.000000,25533875335.027965,1876140,0,0,1876140
2013-09-19,NYSE Arca (P),275778554,278176544,140321788,694276886,9150666362.812487,16437656731.609193,5756739320.393013,31345062414.814693,1523587,584980,733921,2842488
2013-09-19,NASDAQ (Q),435614168,160207015,406902353,1002723536,15398853194.474770,10116835470.500504,15200482433.742199,40716171098.717473,2598462,501483,1735880,4835825
2013-09-19,CBSX (W),15022599,6780140,6495782,28298521,431880065.010000,423298212.750000,159464928.100000,1014643205.860000,111579,13253,49383,174215
2013-09-19,NASDAQ PSX (X),17420837,16120313,10551349,44092499,429208810.765000,980117982.129100,339440772.645000,1748767565.539100,84472,46600,50214,181286
2013-09-19,BATS BYX (Y),71680021,31881120,31298872,134860013,2319162397.081004,1585773952.785600,1035102306.711001,4940038656.577605,493594,119980,197210,810784
2013-09-19,BATS BZX (Z),266699374,143497161,145928519,556125054,7988895748.769989,8435515211.108069,4587907354.286793,21012318314.164851,1593556,451197,795985,2840738
2013-09-18,NYSE MKT (A),0,13421177,6229701,19650878,0.000000,75076687.554799,108669781.778000,183746469.332799,0,32357,24857,57214
2013-09-18,NASDAQ BX (B),101958432,51716528,45285186,198960146,3363799456.116103,2499249355.742698,1813125977.994502,7676174789.853303,669408,188879,304644,1162931
2013-09-18,NSX (C),24248037,11396100,15429166,51073303,617464109.186400,398682877.915100,397054718.631100,1413201705.732600,79347,30595,40862,150804
2013-09-18,NYSE (DN),118368662,27989088,66816471,213174221,3836548713.708948,1585586662.482801,2450286164.154080,7872421540.345829,596272,107564,292428,996264
2013-09-18,NASDAQ (DQ),1328953353,506245881,671931325,2507130559,40034153390.610344,27896535089.962534,20956515037.163932,88887203517.736810,4085816,872876,1848016,6806708
2013-09-18,EDGA (J),107061084,60108290,46951448,214120822,3025108962.034701,3118200640.622200,1475965969.361501,7619275572.018402,686463,232266,283755,1202484
2013-09-18,EDGX (K),293909088,125572405,169151982,588633475,9451258102.495457,6255122121.461694,5700146613.250213,21406526837.207364,1394407,374190,727370,2495967
2013-09-18,CHX (M),7066027,16352230,3076103,26494360,266605546.053200,1820424675.173600,148027497.170000,2235057718.396800,1065,7488,679,9232
2013-09-18,NYSE (N),819749218,0,0,819749218,27909437888.350012,0.000000,0.000000,27909437888.350012,2161421,0,0,2161421
2013-09-18,NYSE Arca (P),302490813,371347759,146702229,820540801,10108644910.687679,23065721713.911321,5955753482.223108,39130120106.822108,1692024,784510,807417,3283951
2013-09-18,NASDAQ (Q),475995415,226818305,434730386,1137544106,16623249009.115952,14604142802.904353,16281484878.059856,47508876690.080161,2831050,713613,1940187,5484850
2013-09-18,CBSX (W),13662933,5924008,7084165,26671106,397310769.090000,307913692.139300,180884919.440000,886109380.669300,102075,16405,51520,170000
2013-09-18,NASDAQ PSX (X),19716817,29883518,12315317,61915652,504488729.885000,1746504442.204200,394028266.438000,2645021438.527200,96409,77983,60496,234888
2013-09-18,BATS BYX (Y),82350312,41651240,35077124,159078676,2598131963.041005,2189308035.114500,1208347024.537999,5995787022.693504,562576,167124,231922,961622
2013-09-18,BATS BZX (Z),305873846,198877333,168846975,673598154,9120081782.874968,11917066156.675053,5372594220.463780,26409742160.013801,1851586,645034,932696,3429316
2013-09-17,NYSE MKT (A),0,10094898,5534000,15628898,0.000000,59245046.916000,104795144.332000,164040191.248000,0,19562,20650,40212
2013-09-17,NASDAQ BX (B),69689337,29124583,36944063,135757983,2230316540.074999,1451367592.103699,1357151295.334100,5038835427.512798,467837,101835,240185,809857
2013-09-17,NSX (C),15223047,5010720,11799054,32032821,434316952.495000,176348152.456500,290154046.369100,900819151.320600,57522,14244,32667,104433
2013-09-17,NYSE (DN),81290624,13549508,56869652,151709784,2720620989.373691,738380786.214701,2092100831.344580,5551102606.932972,428161,59344,231821,719326
2013-09-17,NASDAQ (DQ),989542823,281160030,581038689,1851741542,29987428183.170847,13755691164.135489,18007500351.912335,61750619699.218671,3143525,507205,1596203,5246933
2013-09-17,EDGA (J),70552446,34181574,34828156,139562176,1990241284.137702,1640723427.007200,1031711534.754701,4662676245.899603,460964,117324,211408,789696
2013-09-17,EDGX (K),188825198,61181370,135389180,385395748,6429001514.350010,2822439738.375799,4635236616.051428,13886677868.777237,967566,177002,584732,1729300
2013-09-17,CHX (M),10186275,9035256,4616141,23837672,488558306.596200,741184869.680000,231519319.785000,1461262496.061200,1918,1923,546,4387
2013-09-17,NYSE (N),577093745,0,0,577093745,20541202628.557234,0.000000,0.000000,20541202628.557234,1513652,0,0,1513652
2013-09-17,NYSE Arca (P),203606740,181098428,123939956,508645124,6984114750.662709,10010685329.929993,5063976753.329005,22058776833.921707,1193049,376848,676256,2246153
2013-09-17,NASDAQ (Q),306379749,96352047,350858588,753590384,10929680886.352484,6226059499.056614,12943858810.118945,30099599195.528043,1887448,320086,1504073,3711607
2013-09-17,CBSX (W),12926494,4061697,6966757,23954948,379106037.630000,224551510.000000,172963304.168600,776620851.798600,100117,8709,51550,160376
2013-09-17,NASDAQ PSX (X),11428262,10130607,8759392,30318261,306825278.200000,650147342.412400,263827642.005000,1220800262.617400,60376,30813,40727,131916
2013-09-17,BATS BYX (Y),54903033,20670069,26962469,102535571,1787942495.393997,1002445691.945999,954688710.640402,3745076897.980398,380388,77713,174057,632158
2013-09-17,BATS BZX (Z),186198066,84495711,128628801,399322578,5779260298.720008,4973765761.726604,4088888062.639695,14841914123.086307,1168741,274883,710576,2154200
2013-09-16,NYSE MKT (A),0,11040479,5665940,16706419,0.000000,62972173.296800,106334825.141000,169306998.437800,0,21672,21372,43044
2013-09-16,NASDAQ BX (B),74811042,35700414,38709587,149221043,2306643587.035000,1790862749.763601,1515656006.319198,5613162343.117799,497234,129985,250184,877403
2013-09-16,NSX (C),15936745,6727214,10342366,33006325,424236482.133900,275297806.706200,304491301.876800,1004025590.716900,54783,16887,33131,104801
2013-09-16,NYSE (DN),88161800,17954315,55890573,162006688,3015021915.091400,959255055.107100,2284945388.460750,6259222358.659250,476418,76152,243661,796231
2013-09-16,NASDAQ (DQ),1044858675,364584234,581391479,1990834388,31281122958.790656,19705709088.096152,18229374077.284151,69216206124.170959,3296477,615146,1635667,5547290
2013-09-16,EDGA (J),82587993,40581681,38713850,161883524,2331825815.405002,2067389186.631598,1179395190.747100,5578610192.783700,528771,149530,230884,909185
2013-09-16,EDGX (K),216814487,78200730,138773239,433788456,7306839175.869697,3724845691.649497,4975751314.085602,16007436181.604796,1127614,233401,619404,1980419
2013-09-16,CHX (M),5871992,9575983,4988287,20436262,236434550.989800,679217577.194000,315068614.525600,1230720742.709400,1185,2986,482,4653
2013-09-16,NYSE (N),654667029,0,0,654667029,22836505971.466466,0.000000,0.000000,22836505971.466466,1684516,0,0,1684516
2013-09-16,NYSE Arca (P),235026943,226236240,124627328,585890511,7902684203.141211,14059172831.534476,5427618092.637590,27389475127.313277,1350373,490310,709479,2550162
2013-09-16,NASDAQ (Q),358614025,130879666,366536621,856030312,12785418653.543362,8539980961.098405,14168166079.527179,35493565694.168946,2205554,431144,1624658,4261356
2013-09-16,CBSX (W),13049850,6303223,6369671,25722744,371814297.210000,310970216.350000,164513344.960000,847297858.520000,97388,10378,45879,153645
2013-09-16,NASDAQ PSX (X),13598175,14971129,10107703,38677007,356115527.970000,906483395.879000,311124746.610000,1573723670.459000,69705,40438,47950,158093
2013-09-16,BATS BYX (Y),60438726,25310716,28187352,113936794,1902886441.402001,1219024925.037999,999978617.141504,4121889983.581504,410246,95881,180990,687117
2013-09-16,BATS BZX (Z),215834911,116154060,132727113,464716084,6597695780.637402,6831843633.245708,4338403342.860911,17767942756.744021,1336042,371926,747775,2455743
2013-09-13,NYSE MKT (A),0,7936071,4908327,12844398,0.000000,47589155.295600,89712642.126000,137301797.421600,0,16865,18740,35605
2013-09-13,NASDAQ BX (B),66529493,26942130,37210170,130681793,1947325606.630902,1310540341.742799,1219516792.734004,4477382741.107705,429798,96746,226092,752636
2013-09-13,NSX (C),13782973,4340860,9995437,28119270,354360118.287600,148722770.161200,225846712.326000,728929600.774800,49739,12112,29153,91004
2013-09-13,NYSE (DN),71758287,14473271,51693080,137924638,2311837037.120895,681039610.494601,1786949324.453280,4779825972.068776,390609,61654,220256,672519
2013-09-13,NASDAQ (DQ),993789981,289308853,590703946,1873802780,28654307945.209687,12978123082.621631,16221585102.017247,57854016129.848565,2960939,534233,1563089,5058261
2013-09-13,EDGA (J),69233834,30372160,36709714,136315708,1868304639.465498,1429657696.931299,1030951187.387000,4328913523.783797,449472,112893,217417,779782
2013-09-13,EDGX (K),186690684,58356090,129087159,374133933,6107175610.469685,2719212355.263006,4120536241.140618,12946924206.873309,961722,176473,556068,1694263
2013-09-13,CHX (M),8608105,8194587,5278861,22081553,329910296.499000,651508765.530000,222223667.265000,1203642729.294000,982,2180,531,3693
2013-09-13,NYSE (N),569193021,0,0,569193021,19241393003.095503,0.000000,0.000000,19241393003.095503,1462620,0,0,1462620
2013-09-13,NYSE Arca (P),208070735,169194058,118787844,496052637,6721440449.039899,9603098227.345117,4727002863.455500,21051541539.840516,1158921,373296,651089,2183306
2013-09-13,NASDAQ (Q),301151113,100069194,319578096,720798403,10344881440.015963,6521629241.950702,11607334465.749937,28473845147.716602,1845884,339484,1411040,3596408
2013-09-13,CBSX (W),7363710,5581301,4740840,17685851,196655772.690000,237761099.690000,113642567.320000,548059439.700000,56437,4393,27230,88060
2013-09-13,NASDAQ PSX (X),11630306,10653548,8450121,30733975,267214990.445000,622575395.557600,234850448.760000,1124640834.762600,55876,30599,38563,125038
2013-09-13,BATS BYX (Y),50241684,19598901,25211931,95052516,1528033762.188001,931158784.071000,832729782.094302,3291922328.353303,338185,74509,156692,569386
2013-09-13,BATS BZX (Z),183236135,93240336,118191565,394668036,5460827649.510506,5362309766.417596,3647788640.569989,14470926056.498091,1127179,292103,671236,2090518
2013-09-12,NYSE MKT (A),0,10068692,5533810,15602502,0.000000,59192792.174200,100318784.288000,159511576.462200,0,19161,19872,39033
2013-09-12,NASDAQ BX (B),72838055,30788607,36439479,140066141,2177178236.684901,1542398278.054300,1381724222.289599,5101300737.028800,474523,115971,236316,826810
2013-09-12,NSX (C),17506513,5888419,11110845,34505777,474465900.364000,186676083.625600,255036517.210500,916178501.200100,59862,15903,32114,107879
2013-09-12,NYSE (DN),77870791,15588529,54319115,147778435,2502309635.840911,801333836.279500,1957702003.564690,5261345475.685101,427458,64178,230456,722092
2013-09-12,NASDAQ (DQ),1078687549,341101916,673445905,2093235370,31950603701.348971,15513814932.434747,18853750690.614991,66318169324.398709,3328408,599415,1711248,5639071
2013-09-12,EDGA (J),79935194,37985720,38106216,156027130,2100030291.836102,1813426148.819300,1083989661.437499,4997446102.092901,500801,140739,224319,865859
2013-09-12,EDGX (K),222811073,71214741,147411722,441437536,7500610750.938202,3153508298.214998,4943163136.704680,15597282185.857880,1116131,210307,638904,1965342
2013-09-12,CHX (M),10319006,11214804,6899905,28433715,346612859.471000,788441927.238500,260117819.645000,1395172606.354500,1147,2466,463,4076
2013-09-12,NYSE (N),642280941,0,0,642280941,22375713958.591860,0.000000,0.000000,22375713958.591860,1615167,0,0,1615167
2013-09-12,NYSE Arca (P),252534042,208815658,140944951,602294651,8486060011.741600,11521350095.293681,5398229424.216225,25405639531.251506,1402875,444891,747084,2594850
2013-09-12,NASDAQ (Q),348173984,114616693,364349968,827140645,11940063558.067828,7138430634.994606,12805762540.937541,31884256733.999975,2071400,386579,1591323,4049302
2013-09-12,CBSX (W),15704088,3275780,6995584,25975452,375306454.411000,186851265.840000,172767916.160600,734925636.411600,101019,10370,48529,159918
2013-09-12,NASDAQ PSX (X),14365661,12204048,10250380,36820089,339333468.380000,725642307.735000,270136903.825000,1335112679.940000,66853,35885,42939,145677
2013-09-12,BATS BYX (Y),60391473,23884556,27533496,111809525,1818125980.341904,1120743032.473501,947538294.770001,3886407307.585406,400596,87016,175584,663196
2013-09-12,BATS BZX (Z),213466312,111628960,131207290,456302562,6290882718.479984,6138679644.515513,3964650806.842892,16394213169.838389,1279053,347863,733471,2360387
2013-09-11,NYSE MKT (A),0,9214756,5690864,14905620,0.000000,64905997.931000,103900815.879000,168806813.810000,0,18137,20456,38593
2013-09-11,NASDAQ BX (B),75766045,29234908,39589089,144590042,2248592289.133001,1482222712.935500,1693437528.294198,5424252530.362699,485462,107082,257507,850051
2013-09-11,NSX (C),16954250,5566017,13446466,35966733,476810055.536300,198405543.085400,374281003.116900,1049496601.738600,63914,14786,38569,117269
2013-09-11,NYSE (DN),84109491,15632089,57932179,157673759,2652933438.745276,836548386.461402,2578967091.970914,6068448917.177592,436351,67574,244501,748426
2013-09-11,NASDAQ (DQ),1104701678,318095523,670278482,2093075683,31937518995.462936,14843649245.874999,22194707588.521665,68975875829.859600,3427236,548783,1802538,5778557
2013-09-11,EDGA (J),79632485,36411171,40869626,156913282,2171246670.684801,1718860057.594802,1408458600.239801,5298565328.519404,511497,130357,241159,883013
2013-09-11,EDGX (K),217506145,67842848,152757331,438106324,7130195500.230699,3212195215.535406,5750853368.623914,16093244084.390019,1090586,201206,648570,1940362
2013-09-11,CHX (M),10729593,8481699,6130763,25342055,388304085.940300,668183644.790100,275470728.938600,1331958459.669000,920,2159,349,3428
2013-09-11,NYSE (N),656919906,0,0,656919906,22965611141.484202,0.000000,0.000000,22965611141.484202,1616034,0,0,1616034
2013-09-11,NYSE Arca (P),250638469,182496149,146739399,579874017,8504338500.565030,10933114715.208608,7180288380.832708,26617741596.606346,1408433,419393,783218,2611044
2013-09-11,NASDAQ (Q),341147243,114884000,398469115,854500358,11920558258.076054,8129307877.640106,16046272773.874877,36096138909.591037,2072522,376131,1664210,4112863
2013-09-11,CBSX (W),13482715,4328933,7133828,24945476,346478832.600000,179577732.011900,182588188.817800,708644753.429700,94185,9580,49349,153114
2013-09-11,NASDAQ PSX (X),14136758,12543716,11118814,37799288,346804968.160000,777813457.744200,315750979.348000,1440369405.252200,67519,35168,49008,151695
2013-09-11,BATS BYX (Y),58549168,23158841,30212744,111920753,1807078128.952997,1106061529.506500,1113482925.706897,4026622584.166394,392199,81597,189661,663457
2013-09-11,BATS BZX (Z),212181243,99658740,143066662,454906645,6596676650.245002,5972251810.603491,4908222599.893403,17477151060.741896,1332394,315735,803041,2451170
2013-09-10,NYSE MKT (A),0,11614717,6427256,18041973,0.000000,61844057.171100,121361071.878000,183205129.049100,0,19828,25025,44853
2013-09-10,NASDAQ BX (B),81702031,36243622,41253558,159199211,2448632943.790501,1829579040.007798,1747944713.255203,6026156697.053502,524446,132005,276802,933253
2013-09-10,NSX (C),18990520,6660311,15854718,41505549,489960734.698600,241675021.092100,369422837.648400,1101058593.439100,64621,17127,39990,121738
2013-09-10,NYSE (DN),98600634,18215042,64239048,181054724,3029663683.066692,1009757217.565901,2996163337.485104,7035584238.117697,489796,77868,278262,845926
2013-09-10,NASDAQ (DQ),1377407197,362386352,721042502,2460836051,39800176425.138431,15529568477.888317,23954763564.330088,79284508467.356836,3659852,653060,1937194,6250106
2013-09-10,EDGA (J),91026542,44959459,44341319,180327320,2503970905.854995,2337324660.430500,1434340721.961400,6275636288.246895,577237,158790,267117,1003144
2013-09-10,EDGX (K),253145421,83465997,165316583,501928001,8100720081.862980,3837724998.590506,6086154890.595771,18024599971.049257,1219940,241156,706454,2167550
2013-09-10,CHX (M),6620763,9697610,8945297,25263670,241313979.141100,619104143.585000,286149497.763800,1146567620.489900,1207,3017,563,4787
2013-09-10,NYSE (N),773036599,0,0,773036599,25384891317.126914,0.000000,0.000000,25384891317.126914,1793914,0,0,1793914
2013-09-10,NYSE Arca (P),283512653,243571115,154201988,681285756,9445413764.236211,13536163813.192613,6935428101.952191,29917005679.381015,1548013,527516,845215,2920744
2013-09-10,NASDAQ (Q),378089401,142466165,419617051,940172617,13096999380.072977,9372033011.264598,15832604158.323049,38301636549.660624,2255743,457691,1776555,4489989
2013-09-10,CBSX (W),15703494,7660955,9275942,32640391,385817245.306300,311995925.652000,234243570.133700,932056741.092000,106797,12441,54662,173900
2013-09-10,NASDAQ PSX (X),17654210,17323943,11779642,46757795,418711521.270000,960538399.385000,323211914.070000,1702461834.725000,78093,44227,51257,173577
2013-09-10,BATS BYX (Y),66741551,28872234,31205300,126819085,1992984756.384999,1371198251.188901,1141398513.235100,4505581520.809000,443743,102566,205303,751612
2013-09-10,BATS BZX (Z),230069286,121805256,149762216,501636758,6888094091.540008,6988550318.596308,5054889426.925110,18931533837.061426,1410900,393257,839888,2644045
2013-09-09,NYSE MKT (A),0,8498300,7684848,16183148,0.000000,51991925.847900,137420222.092000,189412147.939900,0,17784,28699,46483
2013-09-09,NASDAQ BX (B),72246985,36515261,40003340,148765586,2089504414.675002,1761079737.928999,1384499276.006795,5235083428.610796,473380,126305,256283,855968
2013-09-09,NSX (C),16670515,6551208,14498317,37720040,407061328.362200,214158328.677100,318856312.157600,940075969.196900,55529,15214,36322,107065
2013-09-09,NYSE (DN),84289300,16668869,59889720,160847889,2637217562.188069,856858406.404899,2059792786.624011,5553868755.216979,442199,71377,249766,763342
2013-09-09,NASDAQ (DQ),1141481030,356354459,645119564,2142955053,32809522980.802531,14748184820.077845,18563336547.664097,66121044348.544473,3298064,631254,1709781,5639099
2013-09-09,EDGA (J),79339240,38662211,41237565,159239016,2210883407.476500,1765684474.806199,1212436387.707598,5189004269.990297,522015,137998,242471,902484
2013-09-09,EDGX (K),220271478,76949453,157819292,455040223,6831970921.475287,3532718726.994702,4987606981.427623,15352296629.897612,1091235,214900,638572,1944707
2013-09-09,CHX (M),7464906,6352285,4050227,17867418,262232014.437400,448428136.555000,240500494.885500,951160645.877900,862,2020,436,3318
2013-09-09,NYSE (N),638742711,0,0,638742711,21525618177.101538,0.000000,0.000000,21525618177.101538,1619882,0,0,1619882
2013-09-09,NYSE Arca (P),241181705,215882864,142894491,599959060,7942654708.679004,12355847579.502801,5410533217.481394,25709035505.663199,1402819,473131,749472,2625422
2013-09-09,NASDAQ (Q),324275514,122655226,366504467,813435207,11096093396.140196,8042974672.571693,12847037118.629452,31986105187.341341,2009973,403712,1590030,4003715
2013-09-09,CBSX (W),13166656,11016629,8773161,32956446,356869582.110000,417155917.568300,188973758.273000,962999257.951300,95758,11230,51983,158971
2013-09-09,NASDAQ PSX (X),13726540,12804107,12053654,38584301,333466078.460000,726390831.140000,313343945.130000,1373200854.730000,65146,36701,45256,147103
2013-09-09,BATS BYX (Y),57438761,26597038,29303430,113339229,1725247049.863001,1232309758.663402,964806616.630401,3922363425.156804,391392,91803,183440,666635
2013-09-09,BATS BZX (Z),194733893,108682110,136782169,440198172,5709228016.550695,6066802086.659604,4258147708.386605,16034177811.596904,1243411,342564,760637,2346612
2013-09-06,NYSE MKT (A),0,8036080,5156574,13192654,0.000000,48107528.347400,90956390.910000,139063919.257400,0,17562,20303,37865
2013-09-06,NASDAQ BX (B),77181613,38676964,44040442,159899019,2330527211.705598,2180680002.850998,1589982820.640999,6101190035.197595,511672,148829,271826,932327
2013-09-06,NSX (C),14920775,7179728,12819996,34920499,396119686.409700,323719846.339200,358107215.768100,1077946748.517000,52961,17078,34579,104618
2013-09-06,NYSE (DN),87625114,18826923,43890873,150342910,2651432192.724403,1135034826.039002,1709975734.819400,5496442753.582805,464985,77196,237529,779710
2013-09-06,NASDAQ (DQ),1059815937,309053697,658871258,2027740892,31064474907.501728,15938185380.118950,18970475194.772172,65973135482.392850,3192312,600817,1725697,5518826
2013-09-06,EDGA (J),77553741,42143123,41301656,160998520,2154982588.005497,2144804905.888400,1220745910.441399,5520533404.335296,513309,162483,245377,921169
2013-09-06,EDGX (K),218301621,82624589,155543850,456470060,7041696275.024311,4163514795.262207,5086991800.231392,16292202870.517910,1118662,244167,674038,2036867
2013-09-06,CHX (M),5165039,9155567,4089031,18409637,209346158.141100,798403707.086000,164896059.840000,1172645925.067100,1094,4935,517,6546
2013-09-06,NYSE (N),671665374,0,0,671665374,23138443182.412063,0.000000,0.000000,23138443182.412063,1879176,0,0,1879176
2013-09-06,NYSE Arca (P),257738637,245191536,146252865,649183038,8663483884.700378,16034072589.268453,6053866392.255290,30751422866.224121,1504571,583543,788874,2876988
2013-09-06,NASDAQ (Q),355538041,159413412,406762758,921714211,12223981616.932008,11749064318.576186,14434402466.979145,38407448402.487339,2211114,532695,1777326,4521135
2013-09-06,CBSX (W),11550787,10278120,7543631,29372538,302799413.289700,358449663.723400,173081555.019300,834330632.032400,82139,12156,46993,141288
2013-09-06,NASDAQ PSX (X),16152569,18364962,17134001,51651532,379855753.725000,1254274947.640000,464076851.945000,2098207553.310000,75768,54425,60240,190433
2013-09-06,BATS BYX (Y),59884122,29694852,31207813,120786787,1802075724.894999,1471911596.853601,1067846215.246101,4341833536.994701,399959,110058,195627,705644
2013-09-06,BATS BZX (Z),213754247,133959991,147510683,495224921,6477295048.560011,8342091342.454227,4668319061.239513,19487705452.253751,1375009,436715,821538,2633262
2013-09-05,NYSE MKT (A),0,8447573,6203568,14651141,0.000000,56896868.319700,113761442.839000,170658311.158700,0,19924,22090,42014
2013-09-05,NASDAQ BX (B),71823510,28971424,35315148,136110082,2039556999.799997,1353764642.209999,1136801620.334199,4530123262.344195,441681,106259,217789,765729
2013-09-05,NSX (C),16410543,5756983,11999207,34166733,410282507.377400,227395119.442900,262872974.252000,900550601.072300,54923,14870,30704,100497
2013-09-05,NYSE (DN),86906953,14506288,39290077,140703318,2606165083.638302,762499364.873000,1311355922.350503,4680020370.861805,452454,61492,219953,733899
2013-09-05,NASDAQ (DQ),1036995676,264508737,603657988,1905162401,29467148770.480832,11852397810.402298,15662939632.202407,56982486213.085537,3079766,514415,1596840,5191021
2013-09-05,EDGA (J),73714135,33315286,37961842,144991263,2000522628.462197,1487732719.048702,982515128.090502,4470770475.601401,468736,121550,221310,811596
2013-09-05,EDGX (K),210988640,59234348,144460987,414683975,6658133003.969989,2712462047.862797,4390827992.235997,13761423044.068783,1028602,179133,601684,1809419
2013-09-05,CHX (M),9483616,9405543,5787588,24676747,200638802.105400,496471428.620000,276211804.310000,973322035.035400,1038,2146,460,3644
2013-09-05,NYSE (N),630017616,0,0,630017616,20643115723.292569,0.000000,0.000000,20643115723.292569,1585623,0,0,1585623
2013-09-05,NYSE Arca (P),234330679,184485397,135152498,553968574,7789531163.230181,10155152513.268960,4588320463.420106,22533004139.919247,1323941,416833,707577,2448351
2013-09-05,NASDAQ (Q),315949440,103294913,347882031,767126384,10553214944.857007,6438876750.350999,11541710123.126993,28533801818.334999,1901012,351292,1483521,3735825
2013-09-05,CBSX (W),13490350,6628074,7352683,27471107,352324374.648400,291506184.211700,158234001.434500,802064560.294600,92623,9325,48938,150886
2013-09-05,NASDAQ PSX (X),13672661,10768948,13203764,37645373,311107785.710000,614396410.725000,294710019.075000,1220214215.510000,62631,30969,44047,137647
2013-09-05,BATS BYX (Y),59005092,21769985,29770979,110546056,1781097611.278000,976790893.109200,943799142.499099,3701687646.886299,397471,82206,193732,673409
2013-09-05,BATS BZX (Z),188831706,87653880,133818147,410303733,5576344952.492806,4904398792.716892,3731876456.659115,14212620201.868813,1179120,294743,702838,2176701
2013-09-04,NYSE MKT (A),0,11725983,6646746,18372729,0.000000,68516576.092700,109639289.704000,178155865.796700,0,18874,23460,42334
2013-09-04,NASDAQ BX (B),78362560,31764457,42775286,152902303,2235599845.014998,1521547639.375799,1634839180.028200,5391986664.418997,492368,117308,267038,876714
2013-09-04,NSX (C),15564431,5168109,12189915,32922455,375365141.800000,215126152.833500,293729388.917800,884220683.551300,51921,13746,34745,100412
2013-09-04,NYSE (DN),89984969,17572782,50662826,158220577,2750379462.058196,937011209.330599,1826961715.100987,5514352386.489782,469639,70948,253119,793706
2013-09-04,NASDAQ (DQ),1201343259,302639079,725835238,2229817576,33207374502.068237,12971748274.643305,20778830430.874050,66957953207.585592,3336813,550166,1801431,5688410
2013-09-04,EDGA (J),83328900,38470665,45361596,167161161,2240831908.687002,1700906138.676698,1318491762.636401,5260229810.000101,528671,139891,270588,939150
2013-09-04,EDGX (K),224331912,65984266,160276131,450592309,7193831790.390208,3087303643.717693,5315212374.483503,15596347808.591404,1145104,191246,694229,2030579
2013-09-04,CHX (M),9844767,5589532,4186457,19620756,348079967.008800,349748928.559000,176039033.386000,873867928.953800,1017,2907,606,4530
2013-09-04,NYSE (N),728133034,0,0,728133034,23516940970.238515,0.000000,0.000000,23516940970.238515,1714259,0,0,1714259
2013-09-04,NYSE Arca (P),255148613,192048312,156468789,603665714,8357528680.348201,11254626047.790690,5952435914.607484,25564590642.746375,1452968,431729,820482,2705179
2013-09-04,NASDAQ (Q),334727058,115506823,444555377,894789258,11620520405.623617,7627927721.463611,15054707602.724164,34303155729.811392,2056306,398125,1735956,4190387
2013-09-04,CBSX (W),12920917,13215604,7142298,33278819,326483485.640000,414456278.260500,181209045.159000,922148809.059500,88274,10048,47767,146089
2013-09-04,NASDAQ PSX (X),14511819,12628888,14455671,41596378,342196611.415000,814055109.635000,394248029.040000,1550499750.090000,69399,38142,56993,164534
2013-09-04,BATS BYX (Y),64614893,25594541,34265282,124474716,1932501922.968999,1127310888.949800,1157706722.088004,4217519534.006803,440554,93695,225012,759261
2013-09-04,BATS BZX (Z),199786885,101001726,151887301,452675912,6057493885.269989,5680490876.739493,4705046817.900990,16443031579.910472,1268500,331869,803923,2404292
2013-09-03,NYSE MKT (A),0,8526799,5735516,14262315,0.000000,49083680.296100,108712539.206000,157796219.502100,0,17559,24075,41634
2013-09-03,NASDAQ BX (B),101823919,39787478,42022913,183634310,2604836219.430000,2187084456.200900,1499036170.805900,6290956846.436800,577561,151805,276570,1005936
2013-09-03,NSX (C),17615462,6363459,10145324,34124245,400509581.421800,326009442.385400,317883929.955500,1044402953.762700,57562,18233,31525,107320
2013-09-03,NYSE (DN),100173653,19313564,47239882,166727099,2684123558.171201,1117417833.223699,1790440615.838199,5591982007.233099,519662,83452,264735,867849
2013-09-03,NASDAQ (DQ),1285717658,433472643,566009715,2285200016,31103781723.372350,24968705362.672666,18092027355.674195,74164514441.719211,3492611,668248,1686977,5847836
2013-09-03,EDGA (J),96508561,49603226,40947909,187059696,2375510402.844401,2358078014.142106,1299418674.788101,6033007091.774608,559603,176840,255286,991729
2013-09-03,EDGX (K),252051920,86502181,142509885,481063986,7645454080.674705,4532651038.343395,5209186516.647911,17387291635.666011,1232195,271635,693064,2196894
2013-09-03,CHX (M),8950561,9413720,6207485,24571766,206233323.741000,638573119.814700,213150048.145000,1057956491.700700,1246,4248,424,5918
2013-09-03,NYSE (N),787116088,0,0,787116088,26006557222.546805,0.000000,0.000000,26006557222.546805,1983076,0,0,1983076
2013-09-03,NYSE Arca (P),325584817,271211605,135917321,732713743,9670187638.915410,17624032372.509897,5575392623.839978,32869612635.265285,1695029,615587,758555,3069171
2013-09-03,NASDAQ (Q),384609489,171125339,429087138,984821966,12274683748.501474,11983249599.969617,15304159532.562329,39562092881.033420,2246937,564996,1869191,4681124
2013-09-03,CBSX (W),15680849,13299928,7331210,36311987,344748024.017200,977466835.110000,174251664.298800,1496466523.426000,93993,12495,50409,156897
2013-09-03,NASDAQ PSX (X),20241084,19771954,12140372,52153410,417411867.545000,1321721175.605000,353444144.645000,2092577187.795000,82767,56974,54089,193830
2013-09-03,BATS BYX (Y),79068679,32644585,33871930,145585194,2154122725.666005,1630838768.201898,1194055670.693401,4979017164.561304,497281,128793,233466,859540
2013-09-03,BATS BZX (Z),256902547,149534001,150608000,557044548,7272516870.036311,8615319023.236100,4846479778.367887,20734315671.640298,1532332,495416,888096,2915844
2013-08-30,NYSE MKT (A),0,9159602,4439373,13598975,0.000000,63316186.937500,88559875.878000,151876062.815500,0,17586,19979,37565
2013-08-30,NASDAQ BX (B),70132316,36296288,32271908,138700512,2173146142.732401,1905690955.528598,1327250270.154901,5406087368.415900,461817,143657,211537,817011
2013-08-30,NSX (C),9467495,5027045,7369230,21863770,234912374.750300,219214226.528600,189780995.572999,643907596.851899,35760,16296,22085,74141
2013-08-30,NYSE (DN),60810499,17288753,30940279,109039531,1811532591.856913,922534760.646399,994384356.048908,3728451708.552220,367349,72462,183348,623159
2013-08-30,NASDAQ (DQ),794695932,306095415,468256703,1569048050,22763938264.391507,16507480168.507350,14714683110.488747,53986101543.387604,2564323,554924,1254646,4373893
2013-08-30,EDGA (J),70978139,40718529,33297038,144993706,1950695679.703898,2014080172.021497,1020695996.377698,4985471848.103093,454912,157121,198840,810873
2013-08-30,EDGX (K),180404780,79630409,110677891,370713080,5525677604.813097,3822340621.091411,3668715271.109592,13016733497.014100,910575,239959,509252,1659786
2013-08-30,CHX (M),6985999,16549724,2386893,25922616,238056286.071800,828796940.307600,134515395.082200,1201368621.461600,967,2419,374,3760
2013-08-30,NYSE (N),768165043,0,0,768165043,26463076132.136292,0.000000,0.000000,26463076132.136292,1630194,0,0,1630194
2013-08-30,NYSE Arca (P),202958233,236529182,105911046,545398461,6685875979.632218,14013487733.357061,4281313349.174180,24980677062.163459,1208294,528727,614601,2351622
2013-08-30,NASDAQ (Q),314995077,158749021,383245539,856989637,10912808235.039732,10957556648.256714,13489361849.735198,35359726733.031644,1981943,513186,1441426,3936555
2013-08-30,CBSX (W),9493718,5560343,4739477,19793538,257550357.970000,247852920.755500,118285538.410000,623688817.135500,70273,11036,33784,115093
2013-08-30,NASDAQ PSX (X),13356057,15147913,9547607,38051577,331329458.600000,961346096.760000,279156778.520000,1571832333.880000,64373,45627,40996,150996
2013-08-30,BATS BYX (Y),55978905,27742417,25488462,109209784,1664089119.882000,1367666827.943800,863183270.118501,3894939217.944301,382528,106116,169842,658486
2013-08-30,BATS BZX (Z),176568693,128670347,108811073,414050113,5318930864.000007,7407295124.250208,3570783035.725910,16297009023.976125,1139878,423809,645734,2209421
2013-08-29,NYSE MKT (A),0,10491387,5581057,16072444,0.000000,56216699.469700,110225158.158000,166441857.627700,0,23358,23864,47222
2013-08-29,NASDAQ BX (B),62677727,33593471,33890395,130161593,1839933680.966801,1681679088.304202,1211893879.475300,4733506648.746303,426811,136424,218337,781572
2013-08-29,NSX (C),10676188,5018707,8997265,24692160,289377715.630000,183449778.487800,213919421.163900,686746915.281700,43049,15810,26998,85857
2013-08-29,NYSE (DN),63808531,15440960,34806677,114056168,1941672603.393615,780609160.687498,1088166462.288103,3810448226.369216,367629,65618,184139,617386
2013-08-29,NASDAQ (DQ),833789930,297053151,515454534,1646297615,24545053466.233496,15538874353.724162,15763300943.517224,55847228763.474882,2689310,541325,1414062,4644697
2013-08-29,EDGA (J),64416729,35809839,33609234,133835802,1790497844.156002,1664742066.903202,1022434505.234899,4477674416.294103,427391,140084,198941,766416
2013-08-29,EDGX (K),183850794,77111585,120855695,381818074,5560319148.681994,3408862256.578297,3956407537.660784,12925588942.921075,908554,225109,514837,1648500
2013-08-29,CHX (M),10756828,6240945,5547617,22545390,465068299.031600,617919607.222000,240962290.321600,1323950196.575200,1171,3095,561,4827
2013-08-29,NYSE (N),547228488,0,0,547228488,18077807533.056711,0.000000,0.000000,18077807533.056711,1512326,0,0,1512326
2013-08-29,NYSE Arca (P),203174889,198476342,113347824,514999055,6622626591.293612,10877708802.384213,4429693670.874611,21930029064.552436,1183960,468519,617196,2269675
2013-08-29,NASDAQ (Q),303674857,135873678,319493961,759042496,10335417691.240986,8722736762.261019,11123343682.410470,30181498135.912475,1905216,460197,1422830,3788243
2013-08-29,CBSX (W),10130242,2378427,5805095,18313764,274576289.470000,129882704.050000,136457091.410000,540916084.930000,74349,10176,40009,124534
2013-08-29,NASDAQ PSX (X),13616651,15050373,10597860,39264884,334120754.235000,842010341.935000,303000312.645000,1479131408.815000,70445,43844,47940,162229
2013-08-29,BATS BYX (Y),49215701,24686017,24045784,97947502,1402475912.084798,1166164021.278402,821882314.463601,3390522247.826801,336927,99983,152082,588992
2013-08-29,BATS BZX (Z),172512437,112797746,113764690,399074873,5042070593.598605,6027633768.390595,3631528359.367096,14701232721.356296,1111464,383818,645502,2140784
2013-08-28,NYSE MKT (A),0,9393636,5698844,15092480,0.000000,53788224.894400,105671728.333000,159459953.227400,0,20775,22844,43619
2013-08-28,NASDAQ BX (B),65324174,36841262,33710331,135875767,1989668175.605001,1799809570.773599,1380113447.549600,5169591193.928200,438534,140475,222699,801708
2013-08-28,NSX (C),10841100,6081496,8309647,25232243,314913428.317200,236047130.015900,230149078.550201,781109636.883301,46932,16744,26894,90570
2013-08-28,NYSE (DN),70690695,18578987,33611436,122881118,2236617290.861200,886227649.672497,1066167050.328996,4189011990.862693,407314,77726,186629,671669
2013-08-28,NASDAQ (DQ),924949405,352778175,529267527,1806995107,28100894221.537753,16066465770.004513,16466474999.653875,60633834991.196141,3083372,611160,1454258,5148790
2013-08-28,EDGA (J),72073613,44845291,33262653,150181557,2061701878.448599,2034432513.692999,1093117995.473501,5189252387.615099,471324,159572,207620,838516
2013-08-28,EDGX (K),199077289,79883814,123379185,402340288,6292149889.986191,3531553068.577001,4234941554.148224,14058644512.711416,1000110,233578,567737,1801425
2013-08-28,CHX (M),12475533,6025870,3586295,22087698,467332479.231400,342106798.065100,137083977.096600,946523254.393100,1417,2971,377,4765
2013-08-28,NYSE (N),598782613,0,0,598782613,20555887309.500446,0.000000,0.000000,20555887309.500446,1577711,0,0,1577711
2013-08-28,NYSE Arca (P),216429493,215383305,114955638,546768436,7193680595.262916,11873586498.402763,4311681657.050102,23378948750.715781,1291951,502874,650090,2444915
2013-08-28,NASDAQ (Q),344928788,146709648,327445711,819084147,12053860234.482383,9053320035.676090,11063709381.459051,32170889651.617524,2129875,486893,1475660,4092428
2013-08-28,CBSX (W),10442331,4597494,6491224,21531049,298505434.200000,247912857.550000,144596578.900000,691014870.650000,79618,10394,43755,133767
2013-08-28,NASDAQ PSX (X),14039940,17440283,10205964,41686187,345128432.565000,969275333.705000,280397826.770000,1594801593.040000,68152,48702,45621,162475
2013-08-28,BATS BYX (Y),53634931,28735151,24253173,106623255,1546064247.811999,1347252465.830998,812819433.688400,3706136147.331397,362906,112169,161326,636401
2013-08-28,BATS BZX (Z),190800792,133297281,116971968,441070041,5696569673.368900,6789255002.167810,3579485881.452496,16065310556.989206,1213985,440094,680654,2334733
2013-08-27,NYSE MKT (A),0,11388962,6688479,18077441,0.000000,68501696.502700,109158574.829000,177660271.331700,0,25818,23885,49703
2013-08-27,NASDAQ BX (B),79145909,45783867,40867905,165797681,2317377896.340499,2319939356.774900,1594271209.100399,6231588462.215798,515027,171668,261554,948249
2013-08-27,NSX (C),15985575,7336350,11156407,34478332,421738346.805200,314051534.324300,326736396.299601,1062526277.429101,59062,21247,34231,114540
2013-08-27,NYSE (DN),81114979,23353815,40887868,145356662,2432244893.052408,1168271728.506304,1337104188.437303,4937620809.996015,447793,94384,211540,753717
2013-08-27,NASDAQ (DQ),1049387877,452531877,606580411,2108500165,29663891914.100579,21158927427.305797,19667467384.918743,70490286726.325119,3358885,762596,1726348,5847829
2013-08-27,EDGA (J),83725603,55477511,41801806,181004920,2341312155.472599,2533738073.985003,1383399570.566898,6258449800.024500,540424,187896,249844,978164
2013-08-27,EDGX (K),248222835,110715868,157236091,516174794,7511528176.145308,5000050913.002799,5431803216.840070,17943382305.988177,1185233,306903,687587,2179723
2013-08-27,CHX (M),8209466,6432264,3923379,18565109,349307429.327800,606214574.650000,151538537.408000,1107060541.385800,1315,3363,542,5220
2013-08-27,NYSE (N),683172583,0,0,683172583,22016151339.494834,0.000000,0.000000,22016151339.494834,1815682,0,0,1815682
2013-08-27,NYSE Arca (P),274290759,283659531,146035316,703985606,8770100158.232036,16219458537.504855,5979296872.501417,30968855568.238308,1549605,636480,816354,3002439
2013-08-27,NASDAQ (Q),388592775,192108819,390791097,971492691,13265616641.721993,13025295417.834418,13950011826.388795,40240923885.945206,2381276,629497,1766961,4777734
2013-08-27,CBSX (W),11706409,4787614,6393033,22887056,318362113.660000,218284110.620000,172037052.310000,708683276.590000,86608,13145,44288,144041
2013-08-27,NASDAQ PSX (X),18838109,21769237,13417437,54024783,458063446.100000,1309469173.845400,384969764.085000,2152502384.030400,87907,61078,59169,208154
2013-08-27,BATS BYX (Y),61055951,33840103,28745781,123641835,1712488469.453001,1656410306.645502,982590485.346803,4351489261.445306,393504,128173,180478,702155
2013-08-27,BATS BZX (Z),219591746,163299267,146156560,529047573,6556548896.688694,9094099648.204701,4774763046.185006,20425411591.078401,1403915,524552,827708,2756175
2013-08-26,NYSE MKT (A),0,9772932,5528524,15301456,0.000000,59992280.108200,98862768.294000,158855048.402200,0,20361,22659,43020
2013-08-26,NASDAQ BX (B),59666184,29609090,32864423,122139697,1842125873.824998,1509283741.741899,1483294687.203996,4834704302.770893,403061,110048,217928,731037
2013-08-26,NSX (C),11100045,4822741,9196900,25119686,278640297.651000,191146321.054300,255403331.647400,725189950.352700,39420,13211,28384,81015
2013-08-26,NYSE (DN),59680729,13165216,33439838,106285783,1905620857.809900,659537641.027999,1227248775.300894,3792407274.138793,350512,57832,179775,588119
2013-08-26,NASDAQ (DQ),792915881,287198884,541731600,1621846365,23459708802.417797,12891729841.563296,19123207117.814196,55474645761.795289,2625767,521068,1521775,4668610
2013-08-26,EDGA (J),62557805,34262998,32753137,129573940,1865360319.977498,1595977322.811201,1215413361.161501,4676751003.950200,418157,121642,199936,739735
2013-08-26,EDGX (K),181427403,66963303,131029485,379420191,5674026965.817699,2918936838.804601,4901837678.377018,13494801482.999318,883007,189978,557128,1630113
2013-08-26,CHX (M),4471239,5758038,4965645,15194922,216091333.429100,367412399.821500,188304535.595000,771808268.845600,1193,2096,449,3738
2013-08-26,NYSE (N),546184013,0,0,546184013,18742248044.195293,0.000000,0.000000,18742248044.195293,1443489,0,0,1443489
2013-08-26,NYSE Arca (P),196002301,164346703,121011379,481360383,6615003298.742886,9851507773.284534,5300734597.479604,21767245669.507024,1169158,387032,671367,2227557
2013-08-26,NASDAQ (Q),290582601,109078764,336054886,735716251,10384072407.418960,7050475607.220392,13499216993.759809,30933765008.399161,1827297,372960,1444511,3644768
2013-08-26,CBSX (W),9928077,3785641,4932235,18645953,276527240.010000,238285283.960000,128886457.570000,643698981.540000,74846,9246,36459,120551
2013-08-26,NASDAQ PSX (X),12274854,12742071,10352156,35369081,324614220.795000,778195470.000000,317286487.325000,1420096178.120000,64464,37271,46221,147956
2013-08-26,BATS BYX (Y),44276777,21771111,23728271,89776159,1317273756.619000,1055196283.857299,897514518.459202,3269984558.935501,289321,83500,148127,520948
2013-08-26,BATS BZX (Z),160733811,91617155,117585727,369936693,5028966292.415002,5299559922.562101,4107725969.111502,14436252184.088605,1062568,312262,675833,2050663
2013-08-23,NYSE MKT (A),0,9067275,7665344,16732619,0.000000,46717851.789600,169164962.755000,215882814.544600,0,20394,27369,47763
2013-08-23,NASDAQ BX (B),60756290,28739039,36314023,125809352,1822009440.035003,1464390675.927799,1303571807.407802,4589971923.370604,404671,113923,233288,751882
2013-08-23,NSX (C),10274564,5045841,9596238,24916643,260191891.044000,221745051.386700,243624257.119301,725561199.550001,37994,13164,24754,75912
2013-08-23,NYSE (DN),63991123,14733072,37684618,116408813,1920786897.237107,755096956.403000,1215508319.187904,3891392172.828011,355756,64002,192943,612701
2013-08-23,NASDAQ (DQ),870489398,277904891,565363641,1713757930,26509443919.945018,14306573065.934891,17401142220.022709,58217159205.902618,2697591,514831,1570652,4783074
2013-08-23,EDGA (J),66585894,35314074,36961402,138861370,1911893305.554299,1700626056.070502,1201264568.230301,4813783929.855102,445003,132847,219512,797362
2013-08-23,EDGX (K),185167408,65927234,135361903,386456545,5814523998.415193,3061318007.138500,4558602397.891389,13434444403.445082,932474,196187,577434,1706095
2013-08-23,CHX (M),7384815,6105665,4375725,17866205,293907640.570000,409341771.170000,203491488.085000,906740899.825000,1572,3322,519,5413
2013-08-23,NYSE (N),571789201,0,0,571789201,19415188211.412061,0.000000,0.000000,19415188211.412061,1486444,0,0,1486444
2013-08-23,NYSE Arca (P),203567856,177926034,141750050,523243940,6727019088.879799,10356506793.658206,5403499964.763407,22487025847.301412,1184556,410218,709604,2304378
2013-08-23,NASDAQ (Q),302613169,112818901,357629296,773061366,10646789863.695009,7690847431.866688,12547942220.948165,30885579516.509862,1898731,373058,1477858,3749647
2013-08-23,CBSX (W),11061016,2746219,5521733,19328968,309437494.630000,140509833.450000,136626446.880000,586573774.960000,81599,9837,38506,129942
2013-08-23,NASDAQ PSX (X),11521307,12428738,11011780,34961825,282799069.250000,744839879.838000,328153944.760000,1355792893.848000,59398,36365,47524,143287
2013-08-23,BATS BYX (Y),47397635,22236925,25098974,94733534,1381693752.715000,1071902865.186598,824484946.367400,3278081564.268998,307200,83985,151441,542626
2013-08-23,BATS BZX (Z),170227860,100768540,125992363,396988763,5146234093.350007,6058271799.057097,3940027059.982897,15144532952.390001,1105231,334428,706747,2146406
2013-08-22,NYSE MKT (A),0,8561934,2431698,10993632,0.000000,46266782.422000,47041580.510000,93308362.932000,0,18442,9824,28266
2013-08-22,NASDAQ BX (B),66161542,32708243,29638295,128508080,1991527923.095402,1782047784.134900,1223602657.870600,4997178365.100902,434159,123060,180118,737337
2013-08-22,NSX (C),12076124,5361657,5132192,22569973,327320189.097000,265431022.654500,145529672.931400,738280884.682900,45965,14372,15356,75693
2013-08-22,NYSE (DN),46039136,10542793,18355621,74937550,1411055407.495900,583921065.142499,602858655.273399,2597835127.911798,243951,38838,91724,374513
2013-08-22,NASDAQ (DQ),863465125,296876932,323269419,1483611476,26904937664.467937,13899711741.804208,10125804080.663210,50930453486.935355,2339558,479536,872005,3691099
2013-08-22,EDGA (J),68545144,35288708,23641717,127475569,2056276862.045099,1768094090.088799,823706496.156499,4648077448.290397,450588,127391,145814,723793
2013-08-22,EDGX (K),188881895,69257004,85694674,343833573,6114722532.783310,3396425005.274297,3105147644.541405,12616295182.599012,928261,211836,374990,1515087
2013-08-22,CHX (M),15007381,7005363,3009474,25022218,638207766.644100,459343472.728400,145289085.498400,1242840324.870900,947,2614,342,3903
2013-08-22,NYSE (N),573354257,0,0,573354257,19328790396.767243,0.000000,0.000000,19328790396.767243,1551980,0,0,1551980
2013-08-22,NYSE Arca (P),190604191,174175478,54692899,419472568,6273049149.226699,10220420003.357995,2492186774.520592,18985655927.105286,1052597,377251,285966,1715814
2013-08-22,NASDAQ (Q),281191672,113998870,271543230,666733772,9774735609.323582,7553159312.759598,9566062580.340038,26893957502.423218,1697086,353088,1063292,3113466
2013-08-22,CBSX (W),7099327,2646512,2763908,12509747,207944051.330000,122947807.880000,85251892.000000,416143751.210000,51837,7561,18914,78312
2013-08-22,NASDAQ PSX (X),10646871,12811036,6266458,29724365,260768041.280000,755246067.295000,170007159.390000,1186021267.965000,50598,34956,30139,115693
2013-08-22,BATS BYX (Y),47452382,23192956,18486128,89131466,1434968424.104001,1178361752.615400,652804346.797302,3266134523.516703,310415,86182,114247,510844
2013-08-22,BATS BZX (Z),167527980,108200382,83516424,359244786,5131217143.345003,6123986328.022006,2733413514.056707,13988616985.423716,1084591,351390,474912,1910893
2013-08-21,NYSE MKT (A),0,9158770,4536231,13695001,0.000000,50754849.755100,88427998.483000,139182848.238100,0,20726,20065,40791
2013-08-21,NASDAQ BX (B),71603499,41393426,35824794,148821719,2247750292.290003,2235749846.615602,1362011006.264799,5845511145.170404,469924,162926,238725,871575
2013-08-21,NSX (C),14173656,7488945,9208340,30870941,372615003.512000,329608652.656000,245634312.124600,947857968.292600,51178,19337,26321,96836
2013-08-21,NYSE (DN),74184203,18978909,35662442,128825554,2368058513.529505,1037032062.251598,1162692135.124701,4567782710.905804,417692,74640,193491,685823
2013-08-21,NASDAQ (DQ),901706436,410011321,507866111,1819583868,27193478148.506940,20567793479.636525,16013437794.263768,63774709422.407233,2986933,663432,1452571,5102936
2013-08-21,EDGA (J),75563402,53816536,35208359,164588297,2235151520.508498,2579715589.688199,1184653203.970096,5999520314.166793,504477,186766,219009,910252
2013-08-21,EDGX (K),219899498,98737215,138240491,456877204,7087338821.934707,4920106635.525193,4590373867.615666,16597819325.075566,1100957,299144,603888,2003989
2013-08-21,CHX (M),10846637,7806126,10813697,29466460,449429528.443700,571927761.720000,132680864.294400,1154038154.458100,1252,4811,418,6481
2013-08-21,NYSE (N),657457295,0,0,657457295,22423706109.665711,0.000000,0.000000,22423706109.665711,1868278,0,0,1868278
2013-08-21,NYSE Arca (P),261843409,262580811,133103889,657528109,8944427896.388513,15290077267.305056,5343207804.082661,29577712967.776230,1511105,586946,742125,2840176
2013-08-21,NASDAQ (Q),358999346,168775947,359142539,886917832,12903623761.958995,11095276723.367993,12744255843.961224,36743156329.288212,2243497,518381,1572303,4334181
2013-08-21,CBSX (W),11150210,3755962,5362962,20269134,312422822.040000,225738910.950000,133283472.118000,671445205.108000,78463,13033,37021,128517
2013-08-21,NASDAQ PSX (X),14444547,20858702,10607173,45910422,345603472.800000,1235619237.680000,300615675.590200,1881838386.070200,65716,54611,46057,166384
2013-08-21,BATS BYX (Y),55247789,32369817,25194829,112812435,1659244478.840001,1572388256.870398,847106787.463299,4078739523.173698,361119,123254,161786,646159
2013-08-21,BATS BZX (Z),206300439,158150963,128328933,492780335,6314367321.400005,9429664246.923891,4075021523.247203,19819053091.571099,1321995,501849,735397,2559241
2013-08-20,NYSE MKT (A),0,8707460,4068072,12775532,0.000000,52329654.038200,73894974.523000,126224628.561200,0,19780,16540,36320
2013-08-20,NASDAQ BX (B),63767011,32585229,30717413,127069653,1999328570.452198,1663352390.336301,1342078353.565798,5004759314.354297,433638,119942,210419,763999
2013-08-20,NSX (C),13734408,5376039,7219990,26330437,343333855.869400,224153042.712400,198196872.911300,765683771.493100,49832,13135,22979,85946
2013-08-20,NYSE (DN),83234979,15401486,34268402,132904867,2685871930.321989,807626015.049597,1261480527.893905,4754978473.265491,471376,63368,186476,721220
2013-08-20,NASDAQ (DQ),1047102991,356735662,501981636,1905820289,29879905939.517216,15285256086.613564,15880473374.057465,61045635400.188245,3111222,563830,1411507,5086559
2013-08-20,EDGA (J),75704591,42018526,32808725,150531842,2230914061.028901,1890247989.556297,1088539433.084800,5209701483.669998,506050,137364,206889,850303
2013-08-20,EDGX (K),209033273,73887373,114110832,397031478,6494849914.402307,3437176199.659708,4144209419.968199,14076235534.030214,1019992,211179,530447,1761618
2013-08-20,CHX (M),7761033,5980701,3639926,17381660,308503810.156500,443177237.565000,180962059.415200,932643107.136700,823,2151,273,3247
2013-08-20,NYSE (N),633852277,0,0,633852277,20828373966.414447,0.000000,0.000000,20828373966.414447,1651555,0,0,1651555
2013-08-20,NYSE Arca (P),251879430,194793171,117900863,564573464,8236816286.587486,10784773291.532611,4890724614.057116,23912314192.177213,1432437,436976,670628,2540041
2013-08-20,NASDAQ (Q),327183842,120729141,310924670,758837653,11184381612.793360,7531148777.205600,10658055607.263932,29373585997.262892,1953221,373014,1340215,3666450
2013-08-20,CBSX (W),11682316,4347212,4997325,21026853,316690223.570000,206089906.670000,130553004.850000,653333135.090000,84094,10479,37380,131953
2013-08-20,NASDAQ PSX (X),12566216,14048958,8235056,34850230,288922660.180000,773787932.385000,222078273.110000,1284788865.675000,57025,34981,36103,128109
2013-08-20,BATS BYX (Y),52363264,26740108,21778986,100882358,1527444592.821001,1276470805.273300,769388296.185202,3573303694.279503,341673,98519,141121,581313
2013-08-20,BATS BZX (Z),204633795,113217908,116050129,433901832,6155324667.269999,6450855544.463892,3632276018.672890,16238456230.406781,1287828,369962,662193,2319983
2013-08-19,NYSE MKT (A),0,10015103,5462107,15477210,0.000000,64495306.941400,91309673.943000,155804980.884400,0,20529,18893,39422
2013-08-19,NASDAQ BX (B),66966311,31402689,35976524,134345524,2108199725.265000,1656548332.920401,1388776008.663000,5153524066.848401,450973,126573,238533,816079
2013-08-19,NSX (C),14791082,5897327,10080034,30768443,352476297.125100,192548819.763800,253175722.169600,798200839.058500,52421,15492,28876,96789
2013-08-19,NYSE (DN),71539059,16597116,37119793,125255968,2149510942.581708,781628184.189700,1359001693.732305,4290140820.503713,408727,67103,195604,671434
2013-08-19,NASDAQ (DQ),970654376,333536930,532052847,1836244153,27158041535.601450,15688134090.539128,16602230967.893558,59448406594.034136,3141416,588225,1516910,5246551
2013-08-19,EDGA (J),75744363,37629210,37232722,150606295,2255927515.374401,1809047214.047297,1244727739.898103,5309702469.319801,507399,143223,228613,879235
2013-08-19,EDGX (K),222451040,69169568,133059213,424679821,7055600622.850702,3082359399.197095,4689043775.295684,14827003797.343481,1103180,205367,585357,1893904
2013-08-19,CHX (M),9065889,5341003,4989574,19396466,379923212.282300,401883825.274800,276470551.008000,1058277588.565100,1257,2532,361,4150
2013-08-19,NYSE (N),640282218,0,0,640282218,20550500273.571132,0.000000,0.000000,20550500273.571132,1657978,0,0,1657978
2013-08-19,NYSE Arca (P),242492930,195207170,128783472,566483572,7896713748.830283,10703076348.527401,5311601481.464278,23911391578.821962,1405231,443479,699560,2548270
2013-08-19,NASDAQ (Q),325346799,115491730,342488001,783326530,11233070110.040517,7259098165.637579,12871494284.445106,31363662560.123202,1990051,372985,1469885,3832921
2013-08-19,CBSX (W),12414653,3425122,6232022,22071797,336121920.940000,173873163.840000,146370914.430000,656365999.210000,92198,9741,41143,143082
2013-08-19,NASDAQ PSX (X),13472315,14519953,9715068,37707336,316530634.855000,840543189.980000,274129510.180000,1431203335.015000,64703,38897,44315,147915
2013-08-19,BATS BYX (Y),51946566,26917932,25369043,104233541,1506181453.585001,1247621148.489998,894206030.174500,3648008632.249499,336059,99799,157747,593605
2013-08-19,BATS BZX (Z),196606561,108806768,125301447,430714776,5850587830.162609,6065528795.206299,4051227099.138709,15967343724.507617,1262102,358289,710882,2331273
2013-08-16,NYSE MKT (A),0,11885355,4767593,16652948,0.000000,70295625.385100,80156652.461000,150452277.846100,0,21184,16942,38126
2013-08-16,NASDAQ BX (B),69879826,36361152,36049150,142290128,2235755556.449397,2006859850.616900,1489239935.508000,5731855342.574297,475854,142010,240533,858397
2013-08-16,NSX (C),14460743,8189559,8616154,31266456,361877334.163400,271679868.875800,213325379.546100,846882582.585300,52010,18700,25458,96168
2013-08-16,NYSE (DN),75680350,16601906,34149035,126431291,2369649401.374596,876519172.975100,1048039801.380596,4294208375.730292,439792,70636,191305,701733
2013-08-16,NASDAQ (DQ),993811491,383720598,538930220,1916462309,28666351128.069075,18338087512.426830,15617371520.562248,62621810161.058153,3094787,635822,1433968,5164577
2013-08-16,EDGA (J),75732694,43157336,35766930,154656960,2220918091.419999,2084354115.380501,1154771616.393902,5460043823.194402,506167,154599,222003,882769
2013-08-16,EDGX (K),224729164,90908942,134791849,450429955,7093836135.103872,4105578154.931102,4267083212.350506,15466497502.385480,1121173,258909,594053,1974135
2013-08-16,CHX (M),11486699,9976245,3189781,24652725,436201851.889800,751854654.806500,321293806.400000,1509350313.096300,2291,3505,473,6269
2013-08-16,NYSE (N),835279440,0,0,835279440,29566094955.928290,0.000000,0.000000,29566094955.928290,1765501,0,0,1765501
2013-08-16,NYSE Arca (P),269814800,240772497,136517034,647104331,9004251191.695407,14064272820.220314,5418728916.159058,28487252928.074779,1558886,521442,754006,2834334
2013-08-16,NASDAQ (Q),347840157,155578285,419605743,923024185,12007497885.405874,9867935667.272191,14974138966.183769,36849572518.861834,2130683,459067,1564275,4154025
2013-08-16,CBSX (W),12451084,4145841,5997593,22594518,337045056.605000,215358427.240000,138092802.670000,690496286.515000,91384,12784,40472,144640
2013-08-16,NASDAQ PSX (X),14843701,17256053,11078422,43178176,357419129.215000,1024619899.117500,292484383.630000,1674523411.962500,71092,47695,49753,168540
2013-08-16,BATS BYX (Y),54571660,28525691,25087229,108184580,1590149820.401001,1414929575.907702,796236911.840802,3801316308.149505,353992,107434,159722,621148
2013-08-16,BATS BZX (Z),211511698,130326622,126247180,468085500,6438212929.379483,7671511005.020897,3908168478.498098,18017892412.898478,1346609,409524,716420,2472553
2013-08-15,NYSE MKT (A),0,12597393,6189677,18787070,0.000000,63728776.611500,100124007.744000,163852784.355500,0,24229,15447,39676
2013-08-15,NASDAQ BX (B),77825023,41473646,42196274,161494943,2513894479.370002,2269892664.126400,1612377051.533995,6396164195.030397,518771,154089,270355,943215
2013-08-15,NSX (C),15643869,8085342,10739271,34468482,397303988.460000,287002078.883100,306502372.306900,990808439.650000,54845,20161,30036,105042
2013-08-15,NYSE (DN),81658408,20930164,42390911,144979483,2509133613.738422,1030345732.199997,1450516760.620297,4989996106.558716,467455,81281,220455,769191
2013-08-15,NASDAQ (DQ),1141026164,469487568,649436950,2259950682,32826001320.379916,21945923330.903932,20710244041.807080,75482168693.090928,3476845,749036,1786498,6012379
2013-08-15,EDGA (J),86485064,52764137,46501763,185750964,2483751095.035000,2385036137.621902,1480495609.114202,6349282841.771104,572574,187805,274799,1035178
2013-08-15,EDGX (K),267266392,112154821,158527313,537948526,8327648236.021399,4894373597.412800,5433460970.960331,18655482804.394530,1285417,306549,700341,2292307
2013-08-15,CHX (M),11203787,12653631,4519815,28377233,376730708.915000,873225249.294000,380492710.977000,1630448669.186000,1532,5283,412,7227
2013-08-15,NYSE (N),721160481,0,0,721160481,23694136540.202237,0.000000,0.000000,23694136540.202237,1967699,0,0,1967699
2013-08-15,NYSE Arca (P),311079407,292936409,171305528,775321344,10293439218.312007,17515093442.564290,6912078328.987124,34720610989.863421,1765974,615273,890413,3271660
2013-08-15,NASDAQ (Q),396846174,184070295,406874391,987790860,13721295328.218999,11874927938.239291,14952102448.847234,40548325715.305524,2380864,540535,1770635,4692034
2013-08-15,CBSX (W),14859721,5486722,6812582,27159025,386310769.340000,279768301.190000,167242705.798000,833321776.328000,105507,13905,46086,165498
2013-08-15,NASDAQ PSX (X),16967348,20815741,14797797,52580886,389544346.585000,1148694348.301000,390222736.005000,1928461430.891000,75290,51883,56707,183880
2013-08-15,BATS BYX (Y),59667031,33574367,30232152,123473550,1770640097.356999,1554487036.951300,1057474923.926300,4382602058.234599,381874,124385,188052,694311
2013-08-15,BATS BZX (Z),239612121,157179312,152585279,549376712,7174605155.284987,9094937971.220802,4817421753.837613,21086964880.343402,1505589,494398,853212,2853199
2013-08-14,NYSE MKT (A),0,9805362,5737238,15542600,0.000000,53768108.752400,98927052.798000,152695161.550400,0,20447,21441,41888
2013-08-14,NASDAQ BX (B),64880670,27151718,36489877,128522265,2106439382.209999,1436153939.067601,1678462692.629703,5221056013.907303,435299,104501,239855,779655
2013-08-14,NSX (C),12989494,5474911,9968423,28432828,321345224.645000,176547017.428100,293669153.096600,791561395.169700,45392,14106,26960,86458
2013-08-14,NYSE (DN),80983371,14114923,40564137,135662431,2524907662.512818,736525560.370202,1387511073.464310,4648944296.347330,440101,62529,216635,719265
2013-08-14,NASDAQ (DQ),956938842,315429391,614127495,1886495728,27439475697.623825,13365770736.650221,20647802601.619289,61453049035.893335,2927149,516041,1590106,5033296
2013-08-14,EDGA (J),76173223,34947766,40222381,151343370,2191712623.360001,1585457131.205801,1406266977.965900,5183436732.531702,503306,126201,242241,871748
2013-08-14,EDGX (K),221145694,69528237,153505285,444179216,6874820819.906302,2926697154.467105,5652170666.137906,15453688640.511313,1049734,198255,631799,1879788
2013-08-14,CHX (M),6786157,10401629,6082767,23270553,298536990.489000,685443413.121600,306504279.145000,1290484682.755600,1083,2321,348,3752
2013-08-14,NYSE (N),621902929,0,0,621902929,20561266267.552407,0.000000,0.000000,20561266267.552407,1647543,0,0,1647543
2013-08-14,NYSE Arca (P),260649235,185786166,161429772,607865173,8470173686.799585,10056508627.488903,7017254236.697992,25543936550.986480,1459543,402843,824082,2686468
2013-08-14,NASDAQ (Q),324567283,113885786,377868615,816321684,11330988867.353598,7274581012.887793,14264400203.659695,32869970083.901086,1949679,351933,1610926,3912538
2013-08-14,CBSX (W),13456198,2696853,7136751,23289802,363564295.760000,154460909.140000,157892375.006200,675917579.906200,96157,9649,46635,152441
2013-08-14,NASDAQ PSX (X),14733016,12269442,11656832,38659290,349152691.955000,691701750.921000,319044867.555000,1359899310.431000,67065,36066,47661,150792
2013-08-14,BATS BYX (Y),51739952,20661456,26191403,98592811,1516448995.939001,963537546.574800,932116206.028203,3412102748.542004,336181,77531,162469,576181
2013-08-14,BATS BZX (Z),196890188,101720001,131404148,430014337,5928892897.980210,5787747900.682197,4373648486.769196,16090289285.431603,1240950,328500,732101,2301551
2013-08-13,NYSE MKT (A),0,10160639,6258597,16419236,0.000000,48598305.508700,102601164.608000,151199470.116700,0,19773,22269,42042
2013-08-13,NASDAQ BX (B),63855785,28150722,37349036,129355543,2054085567.180002,1450644000.516001,1627662782.700001,5132392350.396004,433796,109447,242386,785629
2013-08-13,NSX (C),14108399,5833575,12264000,32205974,369781051.878800,197489855.126201,337262959.100700,904533866.105701,54390,15017,31376,100783
2013-08-13,NYSE (DN),83368184,13164664,38239539,134772387,2512082049.061511,702314441.189999,1539222789.433498,4753619279.685008,434750,58927,203334,697011
2013-08-13,NASDAQ (DQ),1047546573,301370690,642928541,1991845804,29731603236.811522,12054180300.466092,21104491855.306211,62890275392.583825,3158065,508482,1653297,5319844
2013-08-13,EDGA (J),78213684,35305186,40248281,153767151,2288842116.843802,1637397950.815599,1490421631.287901,5416661698.947302,524398,130879,245857,901134
2013-08-13,EDGX (K),224545965,71783232,157034521,453363718,6976382774.202604,3146739222.212492,5644359788.974604,15767481785.389700,1072012,194530,623892,1890434
2013-08-13,CHX (M),9519504,6113392,5236880,20869776,404025206.689600,446538056.874000,223625779.895000,1074189043.458600,1279,1825,376,3480
2013-08-13,NYSE (N),618617331,0,0,618617331,20619236939.248906,0.000000,0.000000,20619236939.248906,1675260,0,0,1675260
2013-08-13,NYSE Arca (P),273261015,183047689,156750541,613059245,8831782925.277429,10324493062.857591,7357072158.037913,26513348146.172933,1513009,412365,800011,2725385
2013-08-13,NASDAQ (Q),341078232,115153522,375486415,831718169,11806219538.956093,7209599465.743797,14353345119.311881,33369164124.011771,2052881,344991,1569740,3967612
2013-08-13,CBSX (W),14680123,4106799,8527566,27314488,397827250.840000,184160511.050000,164809538.177900,746797300.067900,105535,10685,46679,162899
2013-08-13,NASDAQ PSX (X),15407435,12948176,11194248,39549859,362001626.955000,771339342.860000,313433890.670000,1446774860.485000,71451,36844,49490,157785
2013-08-13,BATS BYX (Y),50666849,22809791,24810001,98286641,1503560584.445602,1050066785.366200,984184108.388801,3537811478.200603,336124,82380,156092,574596
2013-08-13,BATS BZX (Z),201224060,104361715,129347469,434933244,6115491082.920005,5898864750.538908,4413477255.206237,16427833088.665150,1274555,334471,728337,2337363
2013-08-12,NYSE MKT (A),0,11309737,5235151,16544888,0.000000,52086300.077900,89369402.753000,141455702.830900,0,21130,20680,41810
2013-08-12,NASDAQ BX (B),63015018,26051896,34424731,123491645,1916892219.810001,1331207748.453599,1267917812.577398,4516017780.840998,423657,104820,231391,759868
2013-08-12,NSX (C),11885765,5897165,8890779,26673709,328624021.527000,145368287.498200,212194368.724400,686186677.749600,47637,13949,27402,88988
2013-08-12,NYSE (DN),75125937,14712094,34878559,124716590,2324947211.443115,670165842.370498,1120419949.697109,4115533003.510722,405183,65081,187057,657321
2013-08-12,NASDAQ (DQ),927901681,283237031,535379008,1746517720,28038841613.517755,11212018675.999258,15330706216.845804,54581566506.362817,2959947,504594,1474697,4939238
2013-08-12,EDGA (J),72005894,33089066,37909589,143004549,2139967328.435898,1463836584.054202,1187072898.851099,4790876811.341199,493835,128224,237639,859698
2013-08-12,EDGX (K),201999243,70625188,141150767,413775198,6519288128.952406,2766920535.926998,4533786520.467986,13819995185.347390,1012269,190704,572628,1775601
2013-08-12,CHX (M),6317178,4129882,5005769,15452829,282602994.098500,302150659.171600,610789038.253000,1195542691.523100,1131,1908,320,3359
2013-08-12,NYSE (N),583562897,0,0,583562897,19964869612.816914,0.000000,0.000000,19964869612.816914,1595312,0,0,1595312
2013-08-12,NYSE Arca (P),247689810,171389773,131951418,551031001,8496185804.211988,8972848487.986206,4666551270.690733,22135585562.888927,1440424,386472,710344,2537240
2013-08-12,NASDAQ (Q),319300074,101990934,335276253,756567261,11379235617.550176,6174530106.572604,11084105189.207005,28637870913.329785,1969254,316914,1457969,3744137
2013-08-12,CBSX (W),12461407,2691681,5628560,20781648,328124435.460000,140466061.350000,119375507.456800,587966004.266800,93007,9435,39872,142314
2013-08-12,NASDAQ PSX (X),13997161,11701045,9709241,35407447,314551375.195000,651731764.405000,229838843.975000,1196121983.575000,63399,31994,44287,139680
2013-08-12,BATS BYX (Y),50374917,20906447,23345235,94626599,1485888638.180998,897221578.409701,754193896.723601,3137304113.314300,324920,81081,146871,552872
2013-08-12,BATS BZX (Z),190524909,89714941,114419151,394659001,5852595795.537795,4901874431.820201,3358449301.042000,14112919528.399996,1231055,295847,659871,2186773
2013-08-09,NYSE MKT (A),0,10196296,5169572,15365868,0.000000,54363622.289600,83169910.313000,137533532.602600,0,21219,19577,40796
2013-08-09,NASDAQ BX (B),61723441,27308720,35219216,124251377,1857953570.102201,1529439499.179400,1232385696.503898,4619778765.785499,413307,109282,220725,743314
2013-08-09,NSX (C),13227259,4726974,9870655,27824888,318633306.287300,143374585.141300,225237831.656600,687245723.085200,45557,12392,26681,84630
2013-08-09,NYSE (DN),79355748,13521843,38703704,131581295,2412630789.503614,741647773.342299,1130632894.961893,4284911457.807806,440008,58375,202869,701252
2013-08-09,NASDAQ (DQ),1010522070,267795930,590850984,1869168984,29855751571.543966,11105486396.162741,15753719281.246969,56714957248.953676,3148451,490972,1617433,5256856
2013-08-09,EDGA (J),79455718,32252127,38243169,149951014,2310417239.721599,1567412658.781401,1205175746.163298,5083005644.666298,538935,127559,238156,904650
2013-08-09,EDGX (K),226748583,70582423,147745836,445076842,7099874318.234993,3116991142.734601,4704572183.029202,14921437643.998796,1107133,199693,620901,1927727
2013-08-09,CHX (M),8833944,6315776,4257497,19407217,320454600.685900,546796093.185600,224801300.564800,1092051994.436300,1194,1659,421,3274
2013-08-09,NYSE (N),637150455,0,0,637150455,21156525841.870671,0.000000,0.000000,21156525841.870671,1717382,0,0,1717382
2013-08-09,NYSE Arca (P),262080936,173384754,145780392,581246082,8408028018.295285,10014585255.989208,5350203341.777115,23772816616.061608,1505839,390063,783634,2679536
2013-08-09,NASDAQ (Q),351537314,110327508,365016684,826881506,12122767890.962786,7143523236.480090,11947933533.593715,31214224661.036591,2163950,347517,1568573,4080040
2013-08-09,CBSX (W),15181071,2617670,8537625,26336366,391577217.940000,134760995.930000,162632358.786800,688970572.656800,107881,10757,50897,169535
2013-08-09,NASDAQ PSX (X),14575878,12862959,9981206,37420043,321917010.122200,713349031.425000,253683566.525000,1288949608.072200,61063,34431,42729,138223
2013-08-09,BATS BYX (Y),51780453,22119905,25457675,99358033,1487180706.173899,1069362289.024301,798816643.207801,3355359638.406001,340729,87648,160444,588821
2013-08-09,BATS BZX (Z),196576629,95980194,122571258,415128081,5865091654.912194,5804243417.159804,3645072745.663995,15314407817.735993,1258039,316880,708325,2283244
2013-08-08,NYSE MKT (A),0,9619864,5699325,15319189,0.000000,51000896.277100,92848670.849000,143849567.126100,0,20818,19664,40482
2013-08-08,NASDAQ BX (B),65463557,30186854,36632558,132282969,2024382245.244999,1547573274.010700,1464506739.140101,5036462258.395800,432594,117667,244146,794407
2013-08-08,NSX (C),13747545,6392824,10392777,30533146,359992744.133800,215265787.888800,258350470.122200,833609002.144800,49172,15270,30401,94843
2013-08-08,NYSE (DN),93344325,14716256,47525866,155586447,2825570326.299993,692274672.081600,1442051710.275113,4959896708.656706,516294,63278,243647,823219
2013-08-08,NASDAQ (DQ),1126716093,322316549,639604184,2088636826,33559791634.836356,14931350969.505641,18357895445.487590,66849038049.829587,3330690,529943,1758268,5618901
2013-08-08,EDGA (J),86746917,38790275,43439798,168976990,2580038630.648198,1724336488.742597,1412971930.504600,5717347049.895395,594956,145133,274227,1014316
2013-08-08,EDGX (K),241509187,70321726,170396208,482227121,7781447126.791482,2984968416.551298,5673121025.420504,16439536568.763284,1207734,194073,703431,2105238
2013-08-08,CHX (M),6756344,5635206,4451836,16843386,269163131.947000,386589820.816700,234781681.807800,890534634.571500,1430,2266,398,4094
2013-08-08,NYSE (N),689410320,0,0,689410320,23244627938.276104,0.000000,0.000000,23244627938.276104,1810523,0,0,1810523
2013-08-08,NYSE Arca (P),282216169,217182181,167686232,667084582,9297863696.859687,11423082466.626790,6049560554.105458,26770506717.591935,1602370,427398,888222,2917990
2013-08-08,NASDAQ (Q),376928186,119341174,396678145,892947505,13269609935.783353,7358715927.408981,13717004163.502866,34345330026.695200,2305620,365670,1743956,4415246
2013-08-08,CBSX (W),17460212,9683037,8862206,36005455,496753607.200000,790169084.410000,202998447.269800,1489921138.879800,127105,11470,58191,196766
2013-08-08,NASDAQ PSX (X),15460496,14089975,11580766,41131237,361796515.535000,753588284.670000,294628395.085000,1410013195.290000,66410,37758,48789,152957
2013-08-08,BATS BYX (Y),54629980,25466212,27803679,107899871,1580552369.885002,1171141178.245400,887877780.200001,3639571328.330403,357025,94231,174057,625313
2013-08-08,BATS BZX (Z),212523953,105789961,133063310,451377224,6469195395.453606,5790133815.856511,4132920477.382603,16392249688.692720,1357890,336897,758721,2453508
2013-08-07,NYSE MKT (A),0,10348616,5873857,16222473,0.000000,53007200.591900,97895248.327000,150902448.918900,0,21318,21177,42495
2013-08-07,NASDAQ BX (B),62400624,28275768,36614628,127291020,2066049200.160001,1537133646.596501,1367741468.691402,4970924315.447904,418777,111648,240293,770718
2013-08-07,NSX (C),12145970,5692083,10740532,28578585,332141017.975300,180540445.711500,278296855.036800,790978318.723600,47486,12557,29783,89826
2013-08-07,NYSE (DN),86524111,14747217,45852870,147124198,2737620722.212020,705047495.728001,1400039609.399103,4842707827.339124,488476,65858,259529,813863
2013-08-07,NASDAQ (DQ),1005994249,296283215,621701178,1923978642,30379488629.996088,12151735818.062076,17647628362.634779,60178852810.692943,3212126,502174,1746450,5460750
2013-08-07,EDGA (J),90322904,37422704,47788803,175534411,2854017723.945002,1757897843.210100,1483570156.037801,6095485723.192903,607213,139118,299145,1045476
2013-08-07,EDGX (K),230851748,67355043,165201510,463408301,7666391377.420703,2832041124.244295,5314232076.079771,15812664577.744769,1165513,185086,693567,2044166
2013-08-07,CHX (M),12393347,5965652,3878726,22237725,392944467.315000,396124148.485000,464926112.636500,1253994728.436500,1190,1563,405,3158
2013-08-07,NYSE (N),628879177,0,0,628879177,21898247339.854855,0.000000,0.000000,21898247339.854855,1737324,0,0,1737324
2013-08-07,NYSE Arca (P),267842940,168350967,168774096,604968003,9505564077.708285,9414863091.719393,6048153634.230904,24968580803.658582,1573871,384956,937965,2896792
2013-08-07,NASDAQ (Q),362678504,106127773,395735675,864541952,13655997722.579974,6693650629.006278,14051231684.057498,34400880035.643750,2271576,332655,1779038,4383269
2013-08-07,CBSX (W),16207258,3248257,8989195,28444710,446095436.650000,150275229.030000,193008394.920000,789379060.600000,119643,10642,56602,186887
2013-08-07,NASDAQ PSX (X),14969169,12504635,11594807,39068611,368356527.695000,708367757.636000,311082617.615000,1387806902.946000,66965,33889,46542,147396
2013-08-07,BATS BYX (Y),51344838,23673744,27702279,102720861,1603582831.840997,1176584530.802201,869576526.625500,3649743889.268698,344312,91103,181864,617279
2013-08-07,BATS BZX (Z),192909047,96034179,133981662,422924888,6279175676.579999,5432149643.791592,4268098726.178205,15979424046.549796,1278342,314152,791332,2383826
2013-08-06,NYSE MKT (A),0,12604341,4341115,16945456,0.000000,61005840.739800,77102431.287000,138108272.026800,0,24442,16499,40941
2013-08-06,NASDAQ BX (B),63124156,28548636,33718956,125391748,2040870469.620003,1478801069.674901,1287011343.920702,4806682883.215606,414975,110271,224999,750245
2013-08-06,NSX (C),13998838,6474063,10893557,31366458,371010586.435000,196409679.782600,253333079.063300,820753345.280900,50576,15592,27822,93990
2013-08-06,NYSE (DN),85644889,13996470,39056919,138698278,2751550964.747102,662404046.326499,1213285881.782003,4627240892.855604,470847,60594,205832,737273
2013-08-06,NASDAQ (DQ),1071773813,331549353,591675615,1994998781,33573265479.840929,13984206730.682061,18198185591.770264,65755657802.293254,3447960,541240,1657722,5646922
2013-08-06,EDGA (J),86576648,38332088,41303454,166212190,2710302506.899103,1725605595.293901,1305889671.759097,5741797773.952101,587342,143883,259540,990765
2013-08-06,EDGX (K),234581775,69608462,164170763,468361000,7886457729.837300,2737828903.623496,5387071703.047598,16011358336.508394,1164449,181723,665078,2011250
2013-08-06,CHX (M),8241186,4473800,6402106,19117092,364728072.414500,362518687.910000,372165357.110000,1099412117.434500,2112,2208,469,4789
2013-08-06,NYSE (N),656872932,0,0,656872932,22975359429.389322,0.000000,0.000000,22975359429.389322,1803152,0,0,1803152
2013-08-06,NYSE Arca (P),283055281,180537976,163790566,627383823,9802858062.389415,9682862961.591695,6155818484.658780,25641539508.639890,1633536,398451,902708,2934695
2013-08-06,NASDAQ (Q),398049025,114454714,357603781,870107520,15284021864.480965,7158377281.701797,12863467605.939360,35305866752.122122,2455512,365013,1646335,4466860
2013-08-06,CBSX (W),18840968,4779271,8964125,32584364,520501077.810000,296341757.656500,206991103.697600,1023833939.164100,137196,11346,57984,206526
2013-08-06,NASDAQ PSX (X),17353741,11890096,10201774,39445611,384893589.425000,662694854.130000,283826721.545000,1331415165.100000,70529,35222,44955,150706
2013-08-06,BATS BYX (Y),49918217,21006187,24184304,95108708,1531720707.234000,972903143.401800,834556703.139699,3339180553.775499,325107,80051,155115,560273
2013-08-06,BATS BZX (Z),150564863,70106266,91787823,312458952,4650587752.445005,3839504015.780495,2995000791.726302,11485092559.951802,942765,218531,551563,1712859
2013-08-05,NYSE MKT (A),0,8820591,5594464,14415055,0.000000,45174240.704700,98852603.344000,144026844.048700,0,17759,20358,38117
2013-08-05,NASDAQ BX (B),54158777,18643916,33986993,106789686,1775975813.644999,966071754.408300,1221146806.685798,3963194374.739097,373840,77232,228594,679666
2013-08-05,NSX (C),9199786,4031539,10330698,23562023,228432454.000000,103036025.898500,232472101.858200,563940581.756700,32298,8467,23687,64452
2013-08-05,NYSE (DN),69773036,10664366,37458472,117895874,2286887649.760610,589595260.149500,1217663120.374199,4094146030.284309,388692,49560,200841,639093
2013-08-05,NASDAQ (DQ),871413228,235803455,568294914,1675511597,26253712746.929195,9413087540.781813,16727548195.398526,52394348483.109534,2796729,408155,1573594,4778478
2013-08-05,EDGA (J),70606715,29266262,39128848,139001825,2243545643.760998,1334262927.491900,1210758684.332901,4788567255.585799,487548,104989,252773,845310
2013-08-05,EDGX (K),197686618,52063574,166413681,416163873,6814524471.999289,1975297029.482302,5551796369.686815,14341617871.168406,1012039,136463,643392,1791894
2013-08-05,CHX (M),8758912,4712142,4912537,18383591,261459094.314400,328070435.110000,303766976.171000,893296505.595400,1755,1316,576,3647
2013-08-05,NYSE (N),532984219,0,0,532984219,18351768845.637612,0.000000,0.000000,18351768845.637612,1495145,0,0,1495145
2013-08-05,NYSE Arca (P),220248322,126659845,137850224,484758391,7778727153.983501,7060288158.938583,5193184181.922010,20032199494.844094,1307013,297589,773985,2378587
2013-08-05,NASDAQ (Q),267787707,73421324,311834003,653043034,10237757982.397317,4689715094.215198,11131163737.696123,26058636814.308638,1718176,239215,1447393,3404784
2013-08-05,CBSX (W),15343770,2532598,9763129,27639497,399769199.150001,128455384.460000,178332657.872000,706557241.482001,112221,9438,54034,175693
2013-08-05,NASDAQ PSX (X),11883344,8204637,9486668,29574649,286523985.270000,463911022.779600,259936289.950000,1010371297.999600,57834,24057,43367,125258
2013-08-05,BATS BYX (Y),41029615,16049868,23080909,80160392,1289836984.656000,712873988.583300,734366235.149000,2737077208.388300,277324,59690,148811,485825
2013-08-05,BATS BZX (Z),158912824,67232398,114359224,340504446,5136290834.400405,3750797791.699203,3586820021.286496,12473908647.386104,1040761,221112,679099,1940972
2013-08-02,NYSE MKT (A),0,8551181,7572175,16123356,0.000000,46591605.452900,140140635.008000,186732240.460900,0,18549,23427,41976
2013-08-02,NASDAQ BX (B),62226800,26990479,37047635,126264914,2087785438.300001,1465491964.260599,1423934323.888302,4977211726.448902,429907,102983,234127,767017
2013-08-02,NSX (C),10494808,5202950,9916815,25614573,274495493.000000,157692670.451600,209304702.714200,641492866.165800,36115,11976,23501,71592
2013-08-02,NYSE (DN),91640784,12236390,44947301,148824475,3030174897.547896,662957604.820999,1383947546.375411,5077080048.744306,484939,58619,229083,772641
2013-08-02,NASDAQ (DQ),1066530575,276759310,639212218,1982502103,34502607884.411044,12048030985.743570,18514232371.353877,65064871241.508491,3364774,494834,1707069,5566677
2013-08-02,EDGA (J),85559263,38107404,44584618,168251285,2728659599.265801,1823225944.982399,1422495874.760699,5974381419.008899,578220,132523,267348,978091
2013-08-02,EDGX (K),236447244,69915273,175102536,481465053,8234400269.864619,3105720652.594502,5527000016.165688,16867120938.624809,1185623,185065,684346,2055034
2013-08-02,CHX (M),9525868,11208001,4582884,25316753,383876475.677000,743363301.508000,197139967.054500,1324379744.239500,2422,2668,892,5982
2013-08-02,NYSE (N),681528300,0,0,681528300,24971941677.756989,0.000000,0.000000,24971941677.756989,1758405,0,0,1758405
2013-08-02,NYSE Arca (P),276071761,181405050,168009349,625486160,10095659978.258805,11404319272.641694,6201361169.412616,27701340420.313115,1590624,381647,861466,2833737
2013-08-02,NASDAQ (Q),361216690,106322669,378961469,846500828,13690127371.810133,7012002822.446884,13431695416.066994,34133825610.324011,2207294,334794,1641994,4184082
2013-08-02,CBSX (W),14355140,2904901,7758414,25018455,408441860.180000,143392393.940000,176411982.180000,728246236.300000,107495,10732,49015,167242
2013-08-02,NASDAQ PSX (X),15365368,11760704,14669665,41795737,358753233.470000,695509144.930000,353269879.530000,1407532257.930000,67289,33460,49348,150097
2013-08-02,BATS BYX (Y),48562664,21325020,25033341,94921025,1545617673.431199,1050607363.471300,897254681.351001,3493479718.253500,327186,79167,162114,568467
2013-08-02,BATS BZX (Z),196086328,95851062,132508279,424445669,6361145390.153593,5680049807.414094,4029676459.714589,16070871657.282276,1263994,306257,735001,2305252
2013-08-01,NYSE MKT (A),0,9168352,7019663,16188015,0.000000,52099899.379600,153513271.103000,205613170.482600,0,20048,24659,44707
2013-08-01,NASDAQ BX (B),79281824,35135163,40343300,154760287,2849840030.815001,1868342232.205600,1452820778.685299,6171003041.705900,553498,135660,282508,971666
2013-08-01,NSX (C),15450487,7080540,9985839,32516866,431736895.820600,208579592.268300,247720878.956200,888037367.045100,51798,15460,28248,95506
2013-08-01,NYSE (DN),114889156,19465249,57967828,192322233,3964139467.804174,1113186622.583901,1892188577.010989,6969514667.399064,634861,86316,315425,1036602
2013-08-01,NASDAQ (DQ),1294005990,436923949,705615085,2436545024,41580196671.256494,22675598542.114874,20517679025.489593,84773474238.860961,3982497,631992,1975839,6590328
2013-08-01,EDGA (J),103638679,51473977,48909857,204022513,3401200982.245199,2537560181.283897,1502374214.272401,7441135377.801497,698747,178308,317964,1195019
2013-08-01,EDGX (K),296129938,88209120,194064767,578403825,10472836292.380101,4195515753.275511,6148338411.332698,20816690456.988310,1456573,226556,798275,2481404
2013-08-01,CHX (M),10061128,7170263,6490941,23722332,378040907.139800,609605023.520000,277027475.242000,1264673405.901800,2400,3257,1028,6685
2013-08-01,NYSE (N),798379047,0,0,798379047,29196830007.997827,0.000000,0.000000,29196830007.997827,2157882,0,0,2157882
2013-08-01,NYSE Arca (P),320914998,242429770,175257144,738601912,12325817641.614402,15166260955.818100,6490477499.978220,33982556097.410722,1866138,507557,973583,3347278
2013-08-01,NASDAQ (Q),427713335,145935904,422057494,995706733,16553590665.820033,10450275324.397107,15009910623.632770,42013776613.849910,2631481,446081,1918079,4995641
2013-08-01,CBSX (W),18004671,12640766,9477366,40122803,541987621.480000,849304767.660000,234041780.740000,1625334169.880000,130380,13470,61587,205437
2013-08-01,NASDAQ PSX (X),17844725,16610357,13015680,47470762,459561817.240000,1056677816.880000,353506833.615000,1869746467.735000,86666,44949,60467,192082
2013-08-01,BATS BYX (Y),58636392,28669552,28765482,116071426,1972989216.696002,1466576173.575800,962628233.173599,4402193623.445401,404193,106215,194202,704610
2013-08-01,BATS BZX (Z),246104329,131526573,145461141,523092043,8110381331.999993,8019040283.604800,4486999736.147200,20616421351.751993,1568477,398775,868750,2836002
2013-07-31,NYSE MKT (A),0,12727577,6794857,19522434,0.000000,73705725.707800,126584856.386000,200290582.093800,0,23100,26303,49403
2013-07-31,NASDAQ BX (B),83746202,37170187,42358988,163275377,2899156613.796998,1960527630.881399,1590144997.500600,6449829242.178997,567251,142119,283158,992528
2013-07-31,NSX (C),13583475,7261358,10088573,30933406,377186202.025000,231578024.438000,269800019.661200,878564246.124200,46971,15744,26027,88742
2013-07-31,NYSE (DN),108540991,18504633,55728143,182773767,3697977580.719617,978826605.745399,1768707761.197403,6445511947.662419,580848,79800,277646,938294
2013-07-31,NASDAQ (DQ),1187119789,371934742,694371878,2253426409,38801859711.795068,17558272497.451233,20695200754.545737,77055332963.792038,3742551,603525,1858724,6204800
2013-07-31,EDGA (J),112164759,50691047,53192818,216048624,3562621784.254001,2425112687.538300,1645189923.565699,7632924395.358000,738420,181666,335553,1255639
2013-07-31,EDGX (K),291061260,99063840,194273909,584399009,10428559967.761494,4412692769.882697,6043049556.172670,20884302293.816861,1454764,252646,783009,2490419
2013-07-31,CHX (M),12135145,7205606,6000179,25340930,501570633.303000,685653464.183500,308059362.429900,1495283459.916400,3049,4799,1031,8879
2013-07-31,NYSE (N),904229899,0,0,904229899,32752826496.193639,0.000000,0.000000,32752826496.193639,2198351,0,0,2198351
2013-07-31,NYSE Arca (P),338476916,249037917,191035390,778550223,12763804838.858157,15167056549.525789,6836201893.844103,34767063282.228049,1960189,552856,1003712,3516757
2013-07-31,NASDAQ (Q),441819201,174995195,473130362,1089944758,16902661344.929513,12282012275.291101,16364401963.760317,45549075583.980931,2664873,518885,1929797,5113555
2013-07-31,CBSX (W),16919270,6073072,8201763,31194105,506844548.910000,314253765.060000,219304886.450000,1040403200.420000,120286,14913,55664,190863
2013-07-31,NASDAQ PSX (X),22591671,21017107,18323309,61932087,527886087.005000,1258874830.890000,498333170.965001,2285094088.860001,97104,56697,70794,224595
2013-07-31,BATS BYX (Y),62779685,32573979,28120044,123473708,2070290657.682999,1672445427.004001,990423905.210003,4733159989.897003,409442,124121,185976,719539
2013-07-31,BATS BZX (Z),255191479,142258907,161780189,559230575,8092031993.114989,8680646573.661807,4858399261.837715,21631077828.614511,1633001,451501,938226,3022728
2013-07-30,NYSE MKT (A),0,8200549,6655559,14856108,0.000000,48522629.628800,125392030.644000,173914660.272800,0,18378,27065,45443
2013-07-30,NASDAQ BX (B),67835609,25032526,36097566,128965701,2233456252.919999,1208379672.002300,1435269347.907299,4877105272.829598,456010,93274,244132,793416
2013-07-30,NSX (C),12550526,5194202,10066047,27810775,340734799.599100,158747405.118900,267666303.316500,767148508.034500,45161,10738,26068,81967
2013-07-30,NYSE (DN),96799006,11863387,52342739,161005132,3069214183.051893,625090666.438600,1606567642.793305,5300872492.283798,507188,55038,242988,805214
2013-07-30,NASDAQ (DQ),1124064298,260653152,667106146,2051823596,34184858720.218946,11133658969.916631,20870623129.347398,66189140819.482975,3511994,465026,1815810,5792830
2013-07-30,EDGA (J),97655282,37638928,48162833,183457043,3007437036.268498,1592622082.635800,1549111462.401597,6149170581.305895,641308,123504,312111,1076923
2013-07-30,EDGX (K),246293594,62312380,183978359,492584333,8189798591.931814,2702691713.459300,6105661212.482105,16998151517.873219,1208398,162576,739220,2110194
2013-07-30,CHX (M),11360769,4201954,5241319,20804042,465197344.720300,380601604.726000,207630870.923600,1053429820.369900,3221,1604,1022,5847
2013-07-30,NYSE (N),677568059,0,0,677568059,24104393870.508816,0.000000,0.000000,24104393870.508816,1776416,0,0,1776416
2013-07-30,NYSE Arca (P),306717947,159783264,164460892,630962103,10885500355.819812,8810227494.503311,6206053454.756297,25901781305.079420,1696383,366068,893548,2955999
2013-07-30,NASDAQ (Q),376573159,106247899,398079297,880900355,13568506359.593392,7773852142.632497,14414202379.533302,35756560881.759191,2212332,338357,1691600,4242289
2013-07-30,CBSX (W),13458183,3767129,8431069,25656381,397485677.601100,206575804.450000,221499762.464400,825561244.515500,95460,8958,54043,158461
2013-07-30,NASDAQ PSX (X),18138313,10461486,14935153,43534952,427751009.080000,648558888.710000,441467492.095000,1517777389.885000,77669,32443,60586,170698
2013-07-30,BATS BYX (Y),51306821,23176513,25405726,99889060,1640112310.392998,1045336453.855899,876903899.038397,3562352663.287294,341859,82681,167535,592075
2013-07-30,BATS BZX (Z),220678597,91104083,143874097,455656777,6811702805.664489,5274724696.950502,4520150855.778913,16606578358.393904,1377445,292194,836797,2506436
2013-07-29,NYSE MKT (A),0,8556571,6618570,15175141,0.000000,50120445.326200,130118197.180500,180238642.506700,0,16780,24400,41180
2013-07-29,NASDAQ BX (B),57814483,26014481,30277832,114106796,1847025199.586200,1267424918.948700,1186346249.625200,4300796368.160100,389877,101880,205716,697473
2013-07-29,NSX (C),9944733,5779359,7663480,23387572,264288116.046700,198055874.099700,208339129.045100,670683119.191500,36678,11697,21975,70350
2013-07-29,NYSE (DN),76192438,11986835,42087323,130266596,2420658760.071614,643170223.620100,1302277928.650994,4366106912.342708,408068,54799,217423,680290
2013-07-29,NASDAQ (DQ),985893879,285346539,629565386,1900805804,29507207188.166705,12787283573.448383,18079114777.801283,60373605539.416371,2839473,461542,1486158,4787173
2013-07-29,EDGA (J),82184001,37202114,40625230,160011345,2431439904.059996,1608092997.599101,1265607967.300999,5305140868.960096,530235,127054,260654,917943
2013-07-29,EDGX (K),201889681,61971191,153504761,417365633,6898019382.558096,2729106961.971595,4973948398.130088,14601074742.659779,1019201,172782,620768,1812751
2013-07-29,CHX (M),10815500,2574233,4987516,18377249,401355487.147800,207589107.160000,201269988.446700,810214582.754500,1474,1468,726,3668
2013-07-29,NYSE (N),579166523,0,0,579166523,20466592665.288157,0.000000,0.000000,20466592665.288157,1572446,0,0,1572446
2013-07-29,NYSE Arca (P),258318882,156332548,139826371,554477801,9052918482.822504,8798380510.877697,5309871170.502220,23161170164.202421,1440011,358959,783190,2582160
2013-07-29,NASDAQ (Q),316011732,105601993,326786176,748399901,11418649763.235713,7488257858.384979,11359464282.702513,30266371904.323205,1887810,333514,1458025,3679349
2013-07-29,CBSX (W),12689607,4147362,6329085,23166054,377592615.070000,210474686.745500,150582807.747600,738650109.563100,92078,7895,41664,141637
2013-07-29,NASDAQ PSX (X),16459964,12056831,10802621,39319416,380041784.385000,696080632.905000,275210138.690000,1351332555.980000,66609,35164,47159,148932
2013-07-29,BATS BYX (Y),46619521,21649289,23208886,91477696,1419436338.585000,970878002.818200,795493175.656400,3185807517.059600,306835,82094,150479,539408
2013-07-29,BATS BZX (Z),187025492,85203707,124025481,396254680,5621815200.350002,4956549036.774398,3803981298.645786,14382345535.770186,1147541,276844,719270,2143655
2013-07-26,NYSE MKT (A),0,7178593,5775795,12954388,0.000000,42165357.964700,102196094.838000,144361452.802700,0,17180,21229,38409
2013-07-26,NASDAQ BX (B),58318268,25907288,36665910,120891466,1831038959.272100,1418066070.925801,1378043138.765300,4627148168.963201,397788,100316,238666,736770
2013-07-26,NSX (C),9548478,5750259,9167865,24466602,259459422.895000,192426128.077000,229522856.307300,681408407.279300,36435,13206,24821,74462
2013-07-26,NYSE (DN),74433086,13336857,48716293,136486236,2569536726.786405,723364171.963602,1522547192.507995,4815448091.258002,414774,58529,244843,718146
2013-07-26,NASDAQ (DQ),925522075,283212986,734359259,1943094320,29553244673.792562,13060379405.178915,20684940625.946776,63298564704.918253,2804166,490750,1690325,4985241
2013-07-26,EDGA (J),76422766,36915753,47203223,160541742,2333314372.214000,1721162662.465501,1499051122.048300,5553528156.727801,521638,134139,294260,950037
2013-07-26,EDGX (K),202590974,62400533,159794739,424786246,6869603994.512502,3036340873.241910,5496647239.687702,15402592107.442114,1033858,174112,672842,1880812
2013-07-26,CHX (M),10397102,6888125,4669410,21954637,371677264.707000,455441006.928400,279584130.786800,1106702402.422200,1722,1940,828,4490
2013-07-26,NYSE (N),597117324,0,0,597117324,21634381718.367812,0.000000,0.000000,21634381718.367812,1615715,0,0,1615715
2013-07-26,NYSE Arca (P),235575981,164251808,163772126,563599915,8574451287.901307,9935876707.216383,6486685763.047989,24997013758.165679,1411136,385566,895758,2692460
2013-07-26,NASDAQ (Q),321493984,119917219,405088708,846499911,11816981851.369946,8596415803.276304,14547177729.143333,34960575383.789583,1969027,377366,1700147,4046540
2013-07-26,CBSX (W),11650318,2953719,7128810,21732847,354601066.320000,141306606.130000,196199811.500000,692107483.950000,86939,9096,45519,141554
2013-07-26,NASDAQ PSX (X),14555434,13885699,12244180,40685313,353480046.610000,837912193.910000,340201419.385000,1531593659.905000,66370,40891,52099,159360
2013-07-26,BATS BYX (Y),44991082,21721805,25992379,92705266,1393090693.519999,1073937783.668200,871018028.213000,3338046505.401199,305638,83703,167795,557136
2013-07-26,BATS BZX (Z),182206329,94523700,136023294,412753323,5675330442.164994,5742500161.991000,4383577770.762406,15801408374.918400,1159596,311382,781629,2252607
2013-07-25,NYSE MKT (A),0,9071140,7425453,16496593,0.000000,52213662.755000,125750896.948000,177964559.703000,0,20308,24535,44843
2013-07-25,NASDAQ BX (B),65665203,26994481,43891195,136550879,2197317498.655000,1505207566.825299,1622276733.997598,5324801799.477897,452683,105492,284797,842972
2013-07-25,NSX (C),12081581,5323359,12961979,30366919,314554883.985000,153931137.046700,354903886.728700,823389907.760400,45877,12652,31493,90022
2013-07-25,NYSE (DN),89411822,12872365,52150905,154435092,3103162414.972515,688931652.619299,1792145183.365308,5584239250.957122,495285,56053,263740,815078
2013-07-25,NASDAQ (DQ),1136425298,346216190,857735255,2340376743,35807741989.215934,16473693203.598767,25136657463.663914,77418092656.478615,3395833,504918,1981430,5882181
2013-07-25,EDGA (J),93320712,41163456,61131526,195615694,2863714337.522301,1957910270.529701,1851961915.771897,6673586523.823899,633286,139833,370786,1143905
2013-07-25,EDGX (K),251342523,71734332,189859072,512935927,8927289481.303900,3266000853.562600,6367262876.765582,18560553211.632082,1301545,189475,790378,2281398
2013-07-25,CHX (M),8584116,8751531,6766554,24102201,351607163.369000,585555492.090400,321423160.749000,1258585816.208400,2481,2167,1031,5679
2013-07-25,NYSE (N),680610886,0,0,680610886,24347249850.015480,0.000000,0.000000,24347249850.015480,1939946,0,0,1939946
2013-07-25,NYSE Arca (P),296109717,183877271,242158655,722145643,10678067280.531902,11610074071.340785,9118806293.802458,31406947645.675145,1728188,427245,1156851,3312284
2013-07-25,NASDAQ (Q),387898036,124428405,513948483,1026274924,14248824967.375533,8612424062.190402,18118142992.513653,40979392022.079588,2328822,403939,2066282,4799043
2013-07-25,CBSX (W),13549469,5287694,7461494,26298657,408107149.730000,266494306.580000,182056774.260000,856658230.570000,100203,9434,48810,158447
2013-07-25,NASDAQ PSX (X),15827910,14649896,17035898,47513704,401047917.250000,906209600.580000,458823478.795000,1766080996.625000,76941,43003,65471,185415
2013-07-25,BATS BYX (Y),50312409,23103027,31600144,105015580,1653295460.944001,1215474193.768600,1039645322.081601,3908414976.794202,338264,90693,196493,625450
2013-07-25,BATS BZX (Z),230459429,104730245,163362488,498552162,7396057266.784985,6277937267.076491,5322676964.206394,18996671498.067870,1488377,329192,934673,2752242
2013-07-24,NYSE MKT (A),0,11153007,6576623,17729630,0.000000,61126179.699700,110799772.395000,171925952.094700,0,24160,22503,46663
2013-07-24,NASDAQ BX (B),69597971,31776961,39335671,140710603,2226704949.270000,1689783282.572401,1429705033.268800,5346193265.111201,469374,125993,255403,850770
2013-07-24,NSX (C),14058077,7374036,8628377,30060490,358270077.266600,226825006.607500,245193713.572900,830288797.447000,49084,16663,24031,89778
2013-07-24,NYSE (DN),94567314,17627332,49685675,161880321,3120637146.773995,920041799.563997,1591380065.004608,5632059011.342600,503546,75534,245982,825062
2013-07-24,NASDAQ (DQ),1143286767,362736148,681910670,2187933585,34099960765.542416,15300590910.335407,21043299075.875032,70443850751.752855,3413634,578309,1799230,5791173
2013-07-24,EDGA (J),96539557,44889010,51793090,193221657,2849429416.964999,2096288942.667901,1611997539.128002,6557715898.760902,629699,163971,316524,1110194
2013-07-24,EDGX (K),263004936,86752727,167514596,517272259,8712337060.995958,3714734606.064788,5870429783.709180,18297501450.769926,1237474,221889,694168,2153531
2013-07-24,CHX (M),12033348,6503361,6609172,25145881,363024904.465700,441006459.300000,383156856.445000,1187188220.210700,2481,2658,1239,6378
2013-07-24,NYSE (N),678512901,0,0,678512901,23421839571.222111,0.000000,0.000000,23421839571.222111,1868103,0,0,1868103
2013-07-24,NYSE Arca (P),298384818,224497247,210891771,733773836,10395887199.429003,12964769424.485390,8065157253.416509,31425813877.330902,1690864,497413,1007195,3195472
2013-07-24,NASDAQ (Q),377994808,145381341,439424570,962800719,13477918839.249872,9819752966.340291,15908798203.905575,39206470009.495738,2243071,444779,1843608,4531458
2013-07-24,CBSX (W),13470625,5944404,9938937,29353966,384870425.120000,554978763.270000,246103994.200000,1185953182.590000,93367,8133,54123,155623
2013-07-24,NASDAQ PSX (X),16253012,17766109,12718450,46737571,411447522.190000,1049372326.015000,312823270.995000,1773643119.200000,78288,49677,53966,181931
2013-07-24,BATS BYX (Y),51823033,23082292,25882487,100787812,1617435481.943999,1145772382.067300,828617142.285999,3591825006.297298,344639,89051,168025,601715
2013-07-24,BATS BZX (Z),223543570,121874216,148690766,494108552,6808398160.114993,7013074285.021305,4792919980.813286,18614392425.949584,1387225,380539,833178,2600942
2013-07-23,NYSE MKT (A),0,11139893,5465809,16605702,0.000000,60435360.977200,86340314.484000,146775675.461200,0,22624,17349,39973
2013-07-23,NASDAQ BX (B),66476098,29653291,35766144,131895533,1983225120.258003,1482787296.351201,1291213710.671699,4757226127.280903,436146,108341,232240,776727
2013-07-23,NSX (C),12792875,6050239,7858868,26701982,298372403.581300,160549056.558800,197872223.487300,656793683.627400,41347,13852,25305,80504
2013-07-23,NYSE (DN),89217058,14457578,45819419,149494055,2877992977.107797,729903967.682300,1475086123.285495,5082983068.075592,462966,61526,226210,750702
2013-07-23,NASDAQ (DQ),1101510022,326639402,629139945,2057289369,31781018672.872276,14211274411.238316,18655022723.794350,64647315807.904942,3167861,521204,1656139,5345204
2013-07-23,EDGA (J),91813782,39738458,43805878,175358118,2662562532.513005,1691565836.936301,1494104151.235399,5848232520.684705,601223,133660,274757,1009640
2013-07-23,EDGX (K),237361962,69096015,147802012,454259989,7418719386.982007,2869504280.103697,5239166839.388694,15527390506.474398,1077198,181588,622714,1881500
2013-07-23,CHX (M),4729184,10031098,3543690,18303972,216065417.121000,626792707.492800,197366949.482600,1040225074.096400,1910,1808,1649,5367
2013-07-23,NYSE (N),623461783,0,0,623461783,21129424255.480990,0.000000,0.000000,21129424255.480990,1638572,0,0,1638572
2013-07-23,NYSE Arca (P),260081343,194652583,149532037,604265963,9109433678.602316,10002826262.429920,6308688681.782507,25420948622.814743,1466595,402563,823034,2692192
2013-07-23,NASDAQ (Q),347227986,114708744,380681608,842618338,12206839750.094973,7607152938.591493,13270160327.155814,33084153015.842280,2008810,358572,1634538,4001920
2013-07-23,CBSX (W),14018050,5177486,7047611,26243147,390691284.700000,255812455.280000,193566024.614600,840069764.594600,97764,10244,48243,156251
2013-07-23,NASDAQ PSX (X),14294807,13684164,10441310,38420281,341194831.240000,765346359.955000,270399414.790000,1376940605.985000,69911,38767,49865,158543
2013-07-23,BATS BYX (Y),50532609,21004469,25031660,96568738,1516974431.250998,972890659.483901,825191365.972699,3315056456.707598,327661,79561,159452,566674
2013-07-23,BATS BZX (Z),200145054,96631772,129102035,425878861,5899360848.975006,5165661541.660703,4104711328.547500,15169733719.183209,1212128,299487,747081,2258696
2013-07-22,NYSE MKT (A),0,11295547,6140446,17435993,0.000000,53877406.691700,101250895.351000,155128302.042700,0,23639,18269,41908
2013-07-22,NASDAQ BX (B),61797414,26726878,34085433,122609725,1891719656.202199,1291868124.872899,1198836845.223300,4382424626.298398,405101,99359,215324,719784
2013-07-22,NSX (C),10812957,6728466,8180357,25721780,256422982.362200,178853089.479700,170864765.170600,606140837.012500,35279,14514,21551,71344
2013-07-22,NYSE (DN),73380056,14830102,39310207,127520365,2392153118.645193,736113031.510902,1232672637.228306,4360938787.384401,402783,68080,203904,674767
2013-07-22,NASDAQ (DQ),967458698,318660426,567932329,1854051453,28005666486.896995,13471921941.159644,15996447226.578224,57474035654.634863,2900127,539218,1537612,4976957
2013-07-22,EDGA (J),87807938,36801120,42566964,167176022,2560524336.035002,1641717565.933303,1298893193.525598,5501135095.493903,574509,136552,263489,974550
2013-07-22,EDGX (K),193580377,69022387,133031914,395634678,6476567225.499400,2715273941.901310,4547106552.666694,13738947720.067404,927178,180761,549804,1657743
2013-07-22,CHX (M),7591955,13118002,5589449,26299406,358637918.814300,653390064.175000,274571012.580000,1286598995.569300,1814,2300,1271,5385
2013-07-22,NYSE (N),583787057,0,0,583787057,21014402853.638965,0.000000,0.000000,21014402853.638965,1520679,0,0,1520679
2013-07-22,NYSE Arca (P),228266981,191398268,135922630,555587879,8124267364.963602,10589803067.176082,5226131768.794886,23940202200.934570,1335174,407673,753916,2496763
2013-07-22,NASDAQ (Q),307605568,108948155,378179013,794732736,11122462521.377988,6931283717.672911,13942666051.595966,31996412290.646865,1824065,342313,1519002,3685380
2013-07-22,CBSX (W),13374437,3679063,6395036,23448536,386970671.580000,173628502.622000,167242302.620000,727841476.822000,92787,9855,43246,145888
2013-07-22,NASDAQ PSX (X),12903618,13734398,9036191,35674207,336872594.950000,841740661.050000,252157250.570000,1430770506.570000,68092,40483,45538,154113
2013-07-22,BATS BYX (Y),45475031,19691955,21279721,86446707,1398669734.212999,903401330.246000,683852503.315900,2985923567.774899,294609,74037,135170,503816
2013-07-22,BATS BZX (Z),185999866,92088499,119905188,397993553,5813237121.316007,5104055442.033495,3719939942.894012,14637232506.243514,1164626,303016,680782,2148424
2013-07-19,NYSE MKT (A),0,8211307,6882114,15093421,0.000000,63369437.733800,118581135.257000,181950572.990800,0,17255,18109,35364
2013-07-19,NASDAQ BX (B),71389034,27224128,40887475,139500637,2069263324.140001,1399551526.926600,1721124436.733598,5189939287.800199,442771,97849,254439,795059
2013-07-19,NSX (C),11614271,4798894,8710357,25123522,284294237.634300,152893420.342400,257751503.719500,694939161.696200,38471,11795,23662,73928
2013-07-19,NYSE (DN),93691091,12575546,49835403,156102040,2815216900.435696,649546280.761799,1741670082.705700,5206433263.903195,490066,55856,253730,799652
2013-07-19,NASDAQ (DQ),1035436758,288439134,637189170,1961065062,29909543286.719094,13522516722.576690,20930430037.551499,64362490046.847283,3061596,463795,1653795,5179186
2013-07-19,EDGA (J),95319285,34465785,50613602,180398672,2741624316.879998,1661057429.332301,1658242379.735194,6060924125.947493,595668,122166,292230,1010064
2013-07-19,EDGX (K),226088044,67719244,142756144,436563432,7403508203.345000,3124597331.105501,5437087049.120091,15965192583.570592,1009971,172674,595534,1778179
2013-07-19,CHX (M),7696741,16008574,9964445,33669760,271799378.501800,1438510639.070000,355923749.130000,2066233766.701800,1769,2287,1641,5697
2013-07-19,NYSE (N),871815091,0,0,871815091,32284915768.100820,0.000000,0.000000,32284915768.100820,1612572,0,0,1612572
2013-07-19,NYSE Arca (P),261617542,182295041,162783720,606696303,9101845034.848817,11197038865.489102,7300408819.292299,27599292719.630218,1374356,388657,824392,2587405
2013-07-19,NASDAQ (Q),343379041,113649632,487637102,944665775,12534804813.284998,7667006124.231195,18910328904.561951,39112139842.078144,1962116,335339,1637295,3934750
2013-07-19,CBSX (W),14735935,3081628,7078355,24895918,392938004.070000,169305280.610000,205820338.097800,768063622.777800,95818,9616,46206,151640
2013-07-19,NASDAQ PSX (X),18673098,13707932,12552510,44933540,424563902.485000,833906283.825000,362482027.635000,1620952213.945000,74768,39730,54697,169195
2013-07-19,BATS BYX (Y),55525892,19520967,26695685,101742544,1583665802.416999,982770046.923100,965584866.401298,3532020715.741397,326624,71627,163722,561973
2013-07-19,BATS BZX (Z),218042837,90044828,140802169,448889834,6777211129.487796,5396581417.455804,4977751569.682900,17151544116.626500,1272302,284109,771464,2327875
2013-07-18,NYSE MKT (A),0,8387884,7487229,15875113,0.000000,51359917.751600,101841661.239000,153201578.990600,0,18273,19222,37495
2013-07-18,NASDAQ BX (B),74082396,27539767,40444661,142066824,2260514782.830003,1470997050.881698,1413509283.491299,5145021117.203000,469104,106359,256721,832184
2013-07-18,NSX (C),14372015,6136332,9289768,29798115,371907753.609600,202457108.049300,209339654.901400,783704516.560300,45964,14726,26199,86889
2013-07-18,NYSE (DN),102114908,14620801,52466474,169202183,3243735001.154008,840360436.949200,1820772077.570294,5904867515.673502,509745,60035,255110,824890
2013-07-18,NASDAQ (DQ),1241263536,321948716,657942970,2221155222,35087353670.136201,15630184677.509228,19762208699.527518,70479747047.172947,3423071,524368,1723600,5671039
2013-07-18,EDGA (J),104640720,40583685,49320925,194545330,3070494530.244997,1942440758.165700,1580361963.104500,6593297251.515197,649840,143515,303720,1097075
2013-07-18,EDGX (K),258703280,72576014,148686651,479965945,8380924178.952025,3324127916.113998,5206463015.365093,16911515110.431116,1143630,185303,638505,1967438
2013-07-18,CHX (M),8625413,9195403,8491644,26312460,348275991.840000,574207477.210000,565192659.622800,1487676128.672800,2301,2624,1864,6789
2013-07-18,NYSE (N),668368004,0,0,668368004,22992893861.713778,0.000000,0.000000,22992893861.713778,1701640,0,0,1701640
2013-07-18,NYSE Arca (P),283210298,187639259,162862505,633712062,10028312973.826465,10823011455.980387,6545247647.884384,27396572077.691236,1504479,409050,851056,2764585
2013-07-18,NASDAQ (Q),387469763,120877201,396236597,904583561,14011474662.345896,8193055180.336594,14343883692.335506,36548413535.017996,2170380,373814,1683357,4227551
2013-07-18,CBSX (W),16039342,5600890,6990779,28631011,413623362.680000,311934643.910000,177050040.970000,902608047.560000,97304,10403,43956,151663
2013-07-18,NASDAQ PSX (X),18314020,15095121,12088374,45497515,461495577.690000,964182171.695000,339494870.440000,1765172619.825000,84693,45027,58361,188081
2013-07-18,BATS BYX (Y),55157246,20880940,25486066,101524252,1644568369.989000,1051715433.591201,819629740.334699,3515913543.914900,345770,78208,165421,589399
2013-07-18,BATS BZX (Z),231514821,100441520,143160821,475117162,7307490542.639983,6043012959.213798,4497253890.287415,17847757392.141196,1383873,320753,806166,2510792
2013-07-17,NYSE MKT (A),0,8379774,7072762,15452536,0.000000,50220167.130200,109052389.389000,159272556.519200,0,20517,20158,40675
2013-07-17,NASDAQ BX (B),68463809,29057947,34129531,131651287,2057328529.325000,1396348901.277001,1283699960.246898,4737377390.848899,438718,108110,225452,772280
2013-07-17,NSX (C),12576051,5667238,7268585,25511874,313336123.670000,168781824.094500,177309918.321000,659427866.085500,40023,13727,21218,74968
2013-07-17,NYSE (DN),93427788,14544929,45761133,153733850,3035007479.404504,748110900.411099,1453158639.511414,5236277019.327017,472862,61679,232015,766556
2013-07-17,NASDAQ (DQ),1053447299,303550052,593084832,1950082183,31228931399.114011,13622068272.662093,16940995559.239048,61791995231.015152,3121849,498570,1546600,5167019
2013-07-17,EDGA (J),94903032,38932699,47263811,181099542,2796837178.673902,1826295878.098400,1440055028.981199,6063188085.753501,600816,144760,292618,1038194
2013-07-17,EDGX (K),224671591,76497415,132655525,433824531,7588309055.782403,3506736198.168909,4407355867.943978,15502401121.895290,1051275,203369,579548,1834192
2013-07-17,CHX (M),9279941,11664076,7191465,28135482,323215046.778500,897081704.566000,281821385.920000,1502118137.264500,2161,3816,1394,7371
2013-07-17,NYSE (N),676842366,0,0,676842366,23478659662.953685,0.000000,0.000000,23478659662.953685,1672360,0,0,1672360
2013-07-17,NYSE Arca (P),271214382,204323429,146262718,621800529,9688677045.737795,10817700864.813286,5373105276.366096,25879483186.917177,1468720,434760,779654,2683134
2013-07-17,NASDAQ (Q),364768451,136226869,371976477,872971797,13176000657.801903,8702965030.147702,12810387548.400886,34689353236.350491,2083092,419964,1606047,4109103
2013-07-17,CBSX (W),14367559,5544311,6181804,26093674,392627521.300000,258081068.770000,163786243.810000,814494833.880000,96295,9462,41522,147279
2013-07-17,NASDAQ PSX (X),15098849,12984356,11000770,39083975,335473156.140000,692515539.216200,277573076.255000,1305561771.611200,69286,34586,46639,150511
2013-07-17,BATS BYX (Y),50468248,22322589,23313327,96104164,1525254533.273002,1020627594.386800,732555046.937799,3278437174.597601,318159,81196,147521,546876
2013-07-17,BATS BZX (Z),220030777,108228465,131971448,460230690,6792058823.504997,6225965473.829599,4060636708.234797,17078661005.569393,1309114,353852,750526,2413492
2013-07-16,NYSE MKT (A),0,9444091,7256172,16700263,0.000000,62787556.073300,111211970.268000,173999526.341300,0,19304,21540,40844
2013-07-16,NASDAQ BX (B),68338043,25886877,36820656,131045576,2074389062.492900,1285916033.282900,1335291876.000700,4695596971.776500,449960,97305,240571,787836
2013-07-16,NSX (C),14047423,5158877,8427039,27633339,343863210.782800,171293657.312900,192577710.211000,707734578.306700,42847,11652,23436,77935
2013-07-16,NYSE (DN),88328784,13183497,46150488,147662769,2896372383.570514,706362709.509901,1440937010.144800,5043672103.225215,464561,57304,227674,749539
2013-07-16,NASDAQ (DQ),1077028618,299511367,602124387,1978664372,32569362218.275197,14627272061.617034,18286741146.063665,65483375425.955896,3116579,481908,1618946,5217433
2013-07-16,EDGA (J),89083099,35857053,47121726,172061878,2658251143.805099,1595684421.492200,1420255647.914503,5674191213.211802,576675,125724,282624,985023
2013-07-16,EDGX (K),234405339,72664992,137299100,444369431,7768218443.243799,3181370136.272497,4723248881.022390,15672837460.538686,1126516,181832,602234,1910582
2013-07-16,CHX (M),9384881,6358691,8744503,24488075,433801768.342700,519084223.190000,302577006.957200,1255462998.489900,1872,2475,1656,6003
2013-07-16,NYSE (N),617075958,0,0,617075958,20897116770.872563,0.000000,0.000000,20897116770.872563,1629521,0,0,1629521
2013-07-16,NYSE Arca (P),246085650,179049797,141633331,566768778,8634244111.892226,9506591116.606597,5407517585.350612,23548352813.849435,1419769,391489,761092,2572350
2013-07-16,NASDAQ (Q),347168563,118837852,382465212,848471627,12314241184.522425,7715502366.224706,13097862803.986211,33127606354.733342,2037151,370492,1606843,4014486
2013-07-16,CBSX (W),14842327,5185655,6771845,26799827,449106342.330000,301168162.270000,186991582.380000,937266086.980000,100374,8655,43359,152388
2013-07-16,NASDAQ PSX (X),14173208,13148193,11166068,38487469,319173026.860000,734022196.055000,265044006.960000,1318239229.875000,66770,32521,45583,144874
2013-07-16,BATS BYX (Y),50295583,21418143,25776856,97490582,1489883126.906001,996735107.749000,765513614.888001,3252131849.543002,329534,78980,159749,568263
2013-07-16,BATS BZX (Z),212024182,100739752,129241089,442005023,6627741351.349301,5636952445.171100,4064521134.731411,16329214931.251812,1316336,316320,731291,2363947
2013-07-15,NYSE MKT (A),0,8707457,6174573,14882030,0.000000,49025324.707600,87434739.874000,136460064.581600,0,17781,20954,38735
2013-07-15,NASDAQ BX (B),56351317,24844596,32376177,113572090,1769984585.154998,1306507177.224300,1150066664.568199,4226558426.947497,380328,93884,208912,683124
2013-07-15,NSX (C),9991135,5136000,7346201,22473336,270247518.087600,147928420.813600,158702837.516700,576878776.417900,35185,11842,21626,68653
2013-07-15,NYSE (DN),77724655,12023959,43094743,132843357,2573706116.413089,638814695.002699,1385173276.145401,4597694087.561189,428317,54474,219255,702046
2013-07-15,NASDAQ (DQ),897060044,288231177,557926562,1743217783,29478768318.892946,12284274957.801552,15689248681.156640,57452291957.851138,2860197,468563,1533458,4862218
2013-07-15,EDGA (J),78022427,33673909,41092604,152788940,2412434179.406800,1541896183.458101,1258748273.917100,5213078636.782001,522227,115727,256936,894890
2013-07-15,EDGX (K),193800850,61623171,128256073,383680094,6856233451.054904,2738815013.233599,4104027048.886307,13699075513.174810,950309,155742,558328,1664379
2013-07-15,CHX (M),5868611,5226212,6571713,17666536,312733343.033000,437679142.113600,332052405.495000,1082464890.641600,1757,1848,1888,5493
2013-07-15,NYSE (N),567650073,0,0,567650073,20391373690.276508,0.000000,0.000000,20391373690.276508,1478982,0,0,1478982
2013-07-15,NYSE Arca (P),208213180,181473642,125462183,515149005,7797955355.378978,10082885563.588293,4658858204.417788,22539699123.385059,1230489,342916,692612,2266017
2013-07-15,NASDAQ (Q),286266585,102295484,347106574,735668643,10803662665.058103,6750122404.188799,11988329471.288525,29542114540.535427,1726994,309480,1491310,3527784
2013-07-15,CBSX (W),12403823,5895441,7297232,25596496,385434079.120000,386357494.460000,168848609.520000,940640183.100000,86631,8903,39864,135398
2013-07-15,NASDAQ PSX (X),11244499,10846570,8000654,30091723,285089217.165000,658893246.920000,223983051.090000,1167965515.175000,58729,25613,40393,124735
2013-07-15,BATS BYX (Y),42555604,19559858,22376887,84492349,1310914675.000999,916580586.938700,706232428.197001,2933727690.136700,282472,68822,139653,490947
2013-07-15,BATS BZX (Z),176486233,86740064,116353601,379579898,5936243605.495005,5076578957.673798,3716999481.011489,14729822044.180292,1134656,270128,682279,2087063
2013-07-12,NYSE MKT (A),0,10230083,6536757,16766840,0.000000,55838566.370300,109487173.563000,165325739.933300,0,19256,19084,38340
2013-07-12,NASDAQ BX (B),66096932,27491591,39258166,132846689,2034612741.899999,1397973066.147500,1544595920.402702,4977181728.450201,426391,102588,253157,782136
2013-07-12,NSX (C),12636270,5593140,7608502,25837912,312244234.090000,158353294.633800,180417170.950100,651014699.673900,36995,12191,21668,70854
2013-07-12,NYSE (DN),79569891,13763838,43405938,136739667,2571214567.820101,736341420.836000,1416100876.778395,4723656865.434496,416193,59167,215546,690906
2013-07-12,NASDAQ (DQ),1029272027,309364982,584388762,1923025771,30995164655.315200,14554944513.443715,18419797244.914278,63969906413.673193,2918281,489387,1519164,4926832
2013-07-12,EDGA (J),91236952,35705288,47685838,174628078,2793702555.494998,1589708150.477001,1600671507.430599,5984082213.402598,580940,128315,287855,997110
2013-07-12,EDGX (K),226165255,68367502,137627977,432160734,7888326447.089100,3068480685.614400,4861919494.265807,15818726626.969307,1055831,184026,599417,1839274
2013-07-12,CHX (M),7982888,8196933,2856492,19036313,337506158.837500,611644859.700000,127947430.157800,1077098448.695300,1710,2266,1763,5739
2013-07-12,NYSE (N),681038705,0,0,681038705,24163683840.738490,0.000000,0.000000,24163683840.738490,1664524,0,0,1664524
2013-07-12,NYSE Arca (P),244009254,191552458,136396731,571958443,9027962557.777418,11184458596.455578,6054383302.426114,26266804456.659110,1341293,398150,737076,2476519
2013-07-12,NASDAQ (Q),327497165,122624236,443005329,893126730,12098513240.044321,8492704642.309110,16516525496.044075,37107743378.397506,1893561,377866,1557136,3828563
2013-07-12,CBSX (W),12984238,4399836,7425011,24809085,398975811.130000,210530165.080000,186750484.110000,796256460.320000,86104,9320,45443,140867
2013-07-12,NASDAQ PSX (X),15672932,12877032,10141647,38691611,334593094.500000,758377258.490000,304447457.880000,1397417810.870000,66215,30647,50657,147519
2013-07-12,BATS BYX (Y),46627465,21208928,25109958,92946351,1463743400.026998,1004547245.325800,858500485.729101,3326791131.081899,304807,77316,155570,537693
2013-07-12,BATS BZX (Z),199186003,103403129,125110829,427699961,6337395221.620010,6124153694.063396,4392956442.373597,16854505358.057003,1198410,324957,717376,2240743
2013-07-11,NYSE MKT (A),0,11915184,7555535,19470719,0.000000,62822584.055300,111600401.707000,174422985.762300,0,22585,23858,46443
2013-07-11,NASDAQ BX (B),75438058,38745181,43626471,157809710,2194945590.590002,2014955478.570301,1625714374.570904,5835615443.731207,495006,149107,278665,922778
2013-07-11,NSX (C),15551128,8134774,9096607,32782509,349439060.253900,229651159.141800,198179451.838800,777269671.234500,46171,16988,23423,86582
2013-07-11,NYSE (DN),95062693,19389577,45645400,160097670,2983516557.724894,926800310.139200,1412248812.600510,5322565680.464604,508148,85139,242246,835533
2013-07-11,NASDAQ (DQ),1149949015,436955448,648405736,2235310199,33383362092.291255,20092299392.606246,19443993011.925063,72919654496.822564,3441492,703945,1732340,5877777
2013-07-11,EDGA (J),103012589,51490576,51458294,205961459,2960924446.194995,2290719260.748198,1586463432.566004,6838107139.509197,661631,179545,319322,1160498
2013-07-11,EDGX (K),254990498,100335746,153846738,509172982,8448853465.725504,4375127299.871095,5315551886.158185,18139532651.754784,1232194,255031,681304,2168529
2013-07-11,CHX (M),9000594,6469523,3033292,18503409,322693304.469800,585060916.792800,114355645.237000,1022109866.499600,2224,3024,1986,7234
2013-07-11,NYSE (N),742029851,0,0,742029851,25472671645.597422,0.000000,0.000000,25472671645.597422,1903843,0,0,1903843
2013-07-11,NYSE Arca (P),289669803,280751279,156465642,726886724,9854624183.095007,15298828985.173406,6400546391.521112,31553999559.789525,1614137,556914,862290,3033341
2013-07-11,NASDAQ (Q),392443010,180070119,431643432,1004156561,14040277720.565067,12199157661.885877,15719491627.879875,41958927010.330819,2312445,523952,1782393,4618790
2013-07-11,CBSX (W),14203207,8956010,8457788,31617005,413912634.310000,472708811.920000,238499090.360000,1125120536.590000,99645,13644,49832,163121
2013-07-11,NASDAQ PSX (X),16347377,19565216,13715673,49628266,381035443.840000,1086070686.540000,403913705.355000,1871019835.735000,82730,46563,65715,195008
2013-07-11,BATS BYX (Y),55564682,31416128,27776816,114757626,1595644475.207001,1451240434.947700,933267514.196099,3980152424.350800,359390,105530,171575,636495
2013-07-11,BATS BZX (Z),233908611,145904434,144235572,524048617,7331785747.096298,8178973247.033297,4872728262.814690,20383487256.944285,1452019,437010,836325,2725354
2013-07-10,NYSE MKT (A),0,9670692,6185875,15856567,0.000000,55479637.576700,88137145.342000,143616782.918700,0,20153,19389,39542
2013-07-10,NASDAQ BX (B),66392097,31637634,38098945,136128676,2059857247.729999,1556826230.428000,1271123838.864698,4887807317.022697,458564,123546,253343,835453
2013-07-10,NSX (C),12563551,6924462,7639463,27127476,319446093.474500,252798783.664300,186132396.166100,758377273.304900,41005,14926,23029,78960
2013-07-10,NYSE (DN),75769509,16575904,41691844,134037257,2572814706.329388,888885014.340199,1258774724.360489,4720474445.030076,412681,70101,210422,693204
2013-07-10,NASDAQ (DQ),956618638,338837814,564929282,1860385734,28621670183.538814,15818899833.298095,15176806699.181067,59617376716.017976,2947025,539028,1492636,4978689
2013-07-10,EDGA (J),88371727,45514973,48558695,182445395,2645197251.168396,2015501484.155100,1350864141.235597,6011562876.559093,599158,169999,294383,1063540
2013-07-10,EDGX (K),226623968,97526227,140303597,464453792,7647635663.514194,4161633626.467601,4518946034.176512,16328215324.158307,1152554,245819,614968,2013341
2013-07-10,CHX (M),14572974,13821479,3601187,31995640,404995665.223200,1109343131.690000,144226187.943000,1658564984.856200,1936,4176,2188,8300
2013-07-10,NYSE (N),670574160,0,0,670574160,23147355979.027084,0.000000,0.000000,23147355979.027084,1896592,0,0,1896592
2013-07-10,NYSE Arca (P),250740395,215049245,137697542,603487182,8911058577.411500,12289405713.091393,5352354939.143006,26552819229.645899,1484424,488822,753740,2726986
2013-07-10,NASDAQ (Q),359486272,175648538,388939033,924073843,13033541342.424193,11830036677.008024,12694101771.533033,37557679790.965250,2192835,529389,1687794,4410018
2013-07-10,CBSX (W),13790880,4513711,8132172,26436763,404326347.060000,212814644.740000,197958626.247600,815099618.047600,99520,11229,52886,163635
2013-07-10,NASDAQ PSX (X),14424176,16595987,11839822,42859985,341437098.910000,834540844.360000,315445005.360000,1491422948.630000,71527,39230,56506,167263
2013-07-10,BATS BYX (Y),50808048,27566336,26317625,104692009,1512731007.755001,1256309307.305200,771796978.669999,3540837293.730200,334874,96038,163429,594341
2013-07-10,BATS BZX (Z),205814908,142812125,140361433,488988466,6673777750.045492,8281622907.901684,4348739299.452710,19304139957.399886,1311404,424509,773575,2509488
2013-07-09,NYSE MKT (A),0,8130737,6524002,14654739,0.000000,50884227.918300,86093426.596000,136977654.514300,0,17250,18921,36171
2013-07-09,NASDAQ BX (B),71784246,29775691,39245634,140805571,2101633754.532002,1546510173.314200,1473550973.519298,5121694901.365500,459329,112857,254466,826652
2013-07-09,NSX (C),12367305,5546735,8752759,26666799,309647077.447200,179647401.054100,196081916.043100,685376394.544400,39949,12960,21708,74617
2013-07-09,NYSE (DN),94385569,16958934,45419439,156763942,2969505207.889592,806880978.068698,1435683220.157996,5212069406.116286,470353,68943,235817,775113
2013-07-09,NASDAQ (DQ),1073848251,360548079,606298860,2040695190,32626771702.430468,16599657746.523679,17716608460.693905,66943037909.648052,3278432,558982,1655513,5492927
2013-07-09,EDGA (J),94725478,43255210,45967493,183948181,2774175145.171901,1933475651.655299,1357109697.402701,6064760494.229901,613177,144516,282781,1040474
2013-07-09,EDGX (K),231318077,84324088,149318960,464961125,8005816752.107768,3964741804.549602,4988308724.145890,16958867280.803260,1177947,220229,646778,2044954
2013-07-09,CHX (M),5598650,6929571,5789238,18317459,241393581.247000,504407360.540000,231774790.067000,977575731.854000,1611,2736,1990,6337
2013-07-09,NYSE (N),692121706,0,0,692121706,24755373685.545143,0.000000,0.000000,24755373685.545143,1828699,0,0,1828699
2013-07-09,NYSE Arca (P),242717413,196354010,137847705,576919128,8731668131.157100,11177635965.287316,5511057350.558204,25420361447.002620,1429317,433312,743260,2605889
2013-07-09,NASDAQ (Q),346369836,153450543,403483795,903304174,12745645692.863802,10596916435.579996,13867096002.113850,37209658130.557648,2119734,454743,1687867,4262344
2013-07-09,CBSX (W),14511601,5294863,7826385,27632849,411528662.210000,333985583.880000,214306481.000000,959820727.090000,101370,11712,51883,164965
2013-07-09,NASDAQ PSX (X),14851472,16001058,12437692,43290222,356442724.935000,868808659.070000,293377967.295000,1518629351.300000,78238,36804,59055,174097
2013-07-09,BATS BYX (Y),51325682,22857849,26913714,101097245,1491507815.747001,1095489318.289400,776655738.742000,3363652872.778401,335519,82171,163596,581286
2013-07-09,BATS BZX (Z),209633588,123642220,138067494,471343302,6734421090.071902,7350809416.452003,4245725463.421807,18330955969.945712,1317826,366342,757756,2441924
2013-07-08,NYSE MKT (A),0,9574722,5539812,15114534,0.000000,52684996.802800,72619943.995000,125304940.797800,0,18854,16506,35360
2013-07-08,NASDAQ BX (B),73253870,29384487,37544018,140182375,2135330050.429998,1472385259.909100,1228952338.572700,4836667648.911798,466400,119002,249849,835251
2013-07-08,NSX (C),11174753,6054342,8133411,25362506,258333457.887500,180186553.536500,154585763.536800,593105774.960800,36293,14474,20239,71006
2013-07-08,NYSE (DN),88963990,16791796,40784120,146539906,2509941902.662392,774130458.678401,1257819427.384298,4541891788.725091,454137,69611,209564,733312
2013-07-08,NASDAQ (DQ),1235970610,362402755,557631339,2156004704,31593658917.868716,15284811447.874125,15775002873.882360,62653473239.625201,2986305,576796,1499008,5062109
2013-07-08,EDGA (J),101306854,46236184,43168347,190711385,2796766010.952497,1854162671.679701,1308082800.437701,5959011483.069899,618829,153851,273084,1045764
2013-07-08,EDGX (K),223054320,88309254,136097233,447460807,7434285456.901788,3804496635.705201,4430149058.290806,15668931150.897795,1114110,228479,600546,1943135
2013-07-08,CHX (M),5632097,6588977,4522136,16743210,258145660.040800,541611023.936000,152500238.104400,952256922.081200,1068,2507,2111,5686
2013-07-08,NYSE (N),906710823,0,0,906710823,25928389984.350691,0.000000,0.000000,25928389984.350691,1757238,0,0,1757238
2013-07-08,NYSE Arca (P),243758231,203766092,127872055,575396378,7815045003.711288,11530163290.495209,4772115550.236203,24117323844.442700,1354635,450464,695018,2500117
2013-07-08,NASDAQ (Q),336808350,143969998,395946182,876724530,11114589344.801017,9655103185.907711,12943452188.087401,33713144718.796129,1924199,455357,1555503,3935059
2013-07-08,CBSX (W),15390115,4987296,5655794,26033205,389841825.530000,211848377.790000,147061487.762700,748751691.082700,85337,9229,39119,133685
2013-07-08,NASDAQ PSX (X),14620373,15375849,11665939,41662161,331707305.000000,784171379.885000,283704659.625000,1399583344.510000,71402,38577,52945,162924
2013-07-08,BATS BYX (Y),52794378,25037446,23921361,101753185,1397205200.806000,1026814253.580700,665772205.916001,3089791660.302701,327246,85949,152041,565236
2013-07-08,BATS BZX (Z),210360478,122785831,123621046,456767355,6172429961.979986,7079883812.905594,3798765562.867995,17051079337.753575,1260636,379525,714657,2354818
2013-07-05,NYSE MKT (A),0,8461389,4069335,12530724,0.000000,57467490.075200,58421217.054000,115888707.129200,0,18547,13104,31651
2013-07-05,NASDAQ BX (B),58986872,32057012,31597407,122641291,1666778782.500003,1568159298.183900,1035459138.436300,4270397219.120203,396087,123891,203435,723413
2013-07-05,NSX (C),11502929,5874411,7128524,24505864,247031095.075000,198030307.395700,161076227.088900,606137629.559600,33944,14328,18769,67041
2013-07-05,NYSE (DN),66259069,15129017,34543966,115932052,1862849152.207896,765140894.553000,927518973.989506,3555509020.750402,367069,65752,165905,598726
2013-07-05,NASDAQ (DQ),778780457,327733593,435075063,1541589113,20586146545.405244,15509173851.057833,11334046670.263733,47429367066.726810,2523316,553543,1221611,4298470
2013-07-05,EDGA (J),81267722,43777719,37755277,162800718,2236044790.155198,1939520933.010298,1009915794.009899,5185481517.175395,529574,166795,225339,921708
2013-07-05,EDGX (K),213767728,89253561,122648697,425669986,6482305817.064212,4088609516.597592,3827924891.857019,14398840225.518823,1034737,238232,533224,1806193
2013-07-05,CHX (M),4259600,8260716,1745173,14265489,154760757.292500,665714979.570000,38792859.070000,859268595.932500,1171,3707,1444,6322
2013-07-05,NYSE (N),625377846,0,0,625377846,20250290688.966642,0.000000,0.000000,20250290688.966642,1671592,0,0,1671592
2013-07-05,NYSE Arca (P),217905398,222535304,105262121,545702823,6899172368.493999,12557334683.458208,4041876956.394195,23498384008.346402,1263831,497588,587282,2348701
2013-07-05,NASDAQ (Q),322549749,162874547,330710757,816135053,10407782064.298974,10891981032.950494,10511837779.925371,31811600877.174839,1917883,520131,1405368,3843382
2013-07-05,CBSX (W),11321512,6501472,5700517,23523501,300771868.190000,284077133.580000,142685319.930000,727534321.700000,82082,11242,35858,129182
2013-07-05,NASDAQ PSX (X),11585270,15814738,8942941,36342949,261181753.270000,784759199.565000,222888429.269000,1268829382.104000,59148,37998,40586,137732
2013-07-05,BATS BYX (Y),43878592,25673321,20441726,89993639,1167653529.191001,1199938325.352400,547235976.950000,2914827831.493401,283261,94005,123493,500759
2013-07-05,BATS BZX (Z),187065261,133368203,109066124,429499588,5391305869.922109,7561858187.573306,3281284344.196805,16234448401.692220,1186553,419514,629516,2235583
2013-07-03,NYSE MKT (A),0,5859844,3493825,9353669,0.000000,39816060.731800,41647520.901000,81463581.632800,0,12776,10327,23103
2013-07-03,NASDAQ BX (B),41791600,18959437,23695426,84446463,1229433303.639998,909739712.533700,756977151.875999,2896150168.049697,280780,75177,148862,504819
2013-07-03,NSX (C),6846414,3609713,5201459,15657586,161567703.010000,123141087.572200,108856027.024400,393564817.606600,22330,8813,13325,44468
2013-07-03,NYSE (DN),49033891,8633731,23963975,81631597,1605520123.940301,443062671.227200,681693841.324099,2730276636.491600,267495,38155,116631,422281
2013-07-03,NASDAQ (DQ),615442412,194979977,340786890,1151209279,17724337118.471851,8954847767.878845,9164139260.818533,35843324147.169229,1781668,335036,876128,2992832
2013-07-03,EDGA (J),57279885,29347300,28180006,114807191,1557590342.215799,1296248040.310402,788582310.946500,3642420693.472701,373896,110489,164688,649073
2013-07-03,EDGX (K),141216240,61785942,85489564,288491746,4452745585.924896,2744035280.108097,2682229686.112895,9879010552.145888,718590,162542,359939,1241071
2013-07-03,CHX (M),2908335,3998772,1121104,8028211,131752714.889200,285264252.660000,42180587.970000,459197555.519200,701,1994,812,3507
2013-07-03,NYSE (N),482035813,0,0,482035813,15081403569.916967,0.000000,0.000000,15081403569.916967,1185892,0,0,1185892
2013-07-03,NYSE Arca (P),158423589,151482319,79313720,389219628,5143633141.092798,8421313725.680297,2822695625.088098,16387642491.861193,930967,336911,433017,1700895
2013-07-03,NASDAQ (Q),230945314,103253214,242299267,576497795,7528163008.408604,6528535532.180500,7513255918.335312,21569954458.924416,1356942,329681,971672,2658295
2013-07-03,CBSX (W),6529445,2452568,3483044,12465057,182542748.390000,133886003.720000,86177537.780000,402606289.890000,43389,8026,17436,68851
2013-07-03,NASDAQ PSX (X),8253017,9518500,6551141,24322658,206934765.135000,422296858.940000,160278613.410000,789510237.485000,46174,24225,31284,101683
2013-07-03,BATS BYX (Y),33275351,15835715,15475430,64586496,912570573.085000,746599843.795400,423185482.195000,2082355899.075400,215064,61820,94339,371223
2013-07-03,BATS BZX (Z),132084673,81522940,77155223,290762836,3857721584.539700,4432140540.839698,2422564960.723104,10712427086.102502,830963,254489,439909,1525361
2013-07-02,NYSE MKT (A),0,10288182,6709436,16997618,0.000000,62653492.041200,78108518.545000,140762010.586200,0,22462,17665,40127
2013-07-02,NASDAQ BX (B),74320357,34622119,41831126,150773602,2264679259.889297,1732184949.614500,1344401619.252395,5341265828.756192,508373,131237,268361,907971
2013-07-02,NSX (C),12076108,6158084,9777285,28011477,306914840.695600,193993594.541000,195980802.614600,696889237.851200,40243,16315,22802,79360
2013-07-02,NYSE (DN),90668597,16369864,48527691,155566152,2845697283.393396,800478058.770699,1343620627.738008,4989795969.902103,509893,69630,247157,826680
2013-07-02,NASDAQ (DQ),1068543271,385609831,632136203,2086289305,32732482751.464698,19464246478.581654,17184457185.002181,69381186415.048533,3263923,575600,1610790,5450313
2013-07-02,EDGA (J),104001266,47574190,52729042,204304498,3106816626.289000,2197287286.583200,1437293549.155999,6741397462.028199,709260,175470,313327,1198057
2013-07-02,EDGX (K),268978186,95186648,162335799,526500633,8811095423.903992,4258283233.992300,5177559219.828738,18246937877.725030,1363062,250903,688589,2302554
2013-07-02,CHX (M),9404870,8360932,3471580,21237382,285146452.306400,630340278.667000,131655695.202000,1047142426.175400,297,2815,1490,4602
2013-07-02,NYSE (N),716703442,0,0,716703442,24429222264.727387,0.000000,0.000000,24429222264.727387,1990615,0,0,1990615
2013-07-02,NYSE Arca (P),268687277,239809683,143468447,651965407,9031066733.264189,13414979747.137604,5231595002.415996,27677641482.817789,1609265,514492,791059,2914816
2013-07-02,NASDAQ (Q),392862611,169758285,416820016,979440912,13670430359.345485,11820120902.610825,13389499212.665577,38880050474.621887,2382652,524959,1788637,4696248
2013-07-02,CBSX (W),13331841,4056120,9112988,26500949,387349686.470000,197744930.350000,181189989.670000,766284606.490000,95715,12440,45334,153489
2013-07-02,NASDAQ PSX (X),15369355,15719034,12157299,43245688,387537646.415000,791915638.075000,287461339.165000,1466914623.655000,82567,38305,56914,177786
2013-07-02,BATS BYX (Y),56433860,27913992,29359191,113707043,1636183231.709998,1371153004.853698,755885820.482201,3763222057.045897,382447,100423,177359,660229
2013-07-02,BATS BZX (Z),228001123,131101346,140013388,499115857,7027896112.990588,7581719889.520293,4214832259.552404,18824448262.063285,1454821,409296,791008,2655125
2013-07-01,NYSE MKT (A),0,10209558,5746302,15955860,0.000000,55091127.299300,81512343.937000,136603471.236300,0,20043,21969,42012
2013-07-01,NASDAQ BX (B),72322029,36307549,40221706,148851284,2266421774.619899,1913608370.362399,1505017138.236493,5685047283.218791,501879,146708,274792,923379
2013-07-01,NSX (C),10894406,5488449,7837825,24220680,279793940.846800,172784601.475100,166378116.150600,618956658.472500,37093,13223,20502,70818
2013-07-01,NYSE (DN),86830460,17819665,46715308,151365433,2795049356.723314,996753526.066299,1466181046.803409,5257983929.593022,493023,84046,241843,818912
2013-07-01,NASDAQ (DQ),975454440,457707897,560969440,1994131777,29624569899.423380,22892417307.986257,16687176377.281526,69204163584.691163,3190564,652132,1627875,5470571
2013-07-01,EDGA (J),94605171,52116090,47056522,193777783,2826279587.835804,2481998814.519897,1418853834.840500,6727132237.196201,644420,188669,301265,1134354
2013-07-01,EDGX (K),236373693,103287538,148978619,488639850,8013219517.628709,5086367387.626369,4952209369.555208,18051796274.810286,1266186,294704,696861,2257751
2013-07-01,CHX (M),6867616,6378843,3554368,16800827,267102278.927000,639383833.550000,255303345.194300,1161789457.671300,306,5235,1502,7043
2013-07-01,NYSE (N),713853217,0,0,713853217,24844055585.606495,0.000000,0.000000,24844055585.606495,1970990,0,0,1970990
2013-07-01,NYSE Arca (P),251325933,245506542,138864290,635696765,8823483338.333393,14768618245.682735,5440847747.808477,29032949331.824605,1549214,568119,814661,2931994
2013-07-01,NASDAQ (Q),359618603,177144834,413685064,950448501,12898935163.994736,12227178364.906400,14001393494.100798,39127507023.001934,2253775,574835,1817502,4646112
2013-07-01,CBSX (W),13735253,13059013,8206808,35001074,411496152.300000,931823302.444700,204851749.120000,1548171203.864700,96675,13221,48212,158108
2013-07-01,NASDAQ PSX (X),14521870,17648888,11140256,43311014,376347012.415000,930940787.185000,280308674.510000,1587596474.110000,81948,42475,55386,179809
2013-07-01,BATS BYX (Y),56888270,28335520,27641786,112865576,1741151704.937000,1444107055.362900,806081769.587899,3991340529.887799,396885,107370,184018,688273
2013-07-01,BATS BZX (Z),212032193,136836107,126660364,475528664,6795602560.627572,8330648684.948128,4135357134.975462,19261608380.551162,1390058,454170,769094,2613322
2013-06-28,NYSE MKT (A),0,75495537,6714415,82209952,0.000000,250734794.717600,93330396.960000,344065191.677600,0,33465,27049,60514
2013-06-28,NASDAQ BX (B),89076474,46266977,56244027,191587478,2578053195.205000,2323812891.627303,1624268826.723902,6526134913.556205,597268,172880,367901,1138049
2013-06-28,NSX (C),7912538,5363342,7164181,20440061,205788740.882400,145819683.543400,154204058.350500,505812482.776300,27852,13426,21154,62432
2013-06-28,NYSE (DN),84498293,20011753,48255410,152765456,2696428273.354700,1003720941.005399,1276398364.262209,4976547578.622308,473808,89214,261657,824679
2013-06-28,NASDAQ (DQ),1574886816,470209727,1713916676,3759013219,46353985585.498318,20589601714.921167,38431128657.525337,105374715957.944822,3284858,699432,1704873,5689163
2013-06-28,EDGA (J),117876145,60618544,62969878,241464567,3357215555.131699,2714490930.798099,1600722307.791803,7672428793.721601,776407,226510,379637,1382554
2013-06-28,EDGX (K),265155469,118483422,163928696,547567587,8846775409.872383,5427557978.497061,4873694899.538298,19148028287.907742,1385101,338751,746353,2470205
2013-06-28,CHX (M),9450295,8579010,4425558,22454863,372649018.354000,919884071.052800,116573449.374500,1409106538.781300,317,6210,1891,8418
2013-06-28,NYSE (N),1754919010,0,0,1754919010,57833331202.658698,0.000000,0.000000,57833331202.658698,2312075,0,0,2312075
2013-06-28,NYSE Arca (P),304322784,342175382,170865047,817363213,10356938138.384701,19210560368.327362,5967079738.078604,35534578244.790667,1750090,720374,904775,3375239
2013-06-28,NASDAQ (Q),410388668,211840626,1169957384,1792186678,13994865738.175986,12796125473.817279,27695916105.919161,54486907317.912426,2435622,684889,2106920,5227431
2013-06-28,CBSX (W),14210365,16021506,9539023,39770894,405307703.810000,478121386.170000,224047654.740000,1107476744.720000,99201,16941,52241,168383
2013-06-28,NASDAQ PSX (X),16300339,19365133,13730255,49395727,411101512.135000,923972827.792400,348548449.085000,1683622789.012400,89592,52841,72361,214794
2013-06-28,BATS BYX (Y),71054026,37335735,39800608,148190369,2110913865.534997,1730217327.725601,1037643421.830501,4878774615.091099,481233,141111,254721,877065
2013-06-28,BATS BZX (Z),257747181,171959393,162472974,592179548,7987650375.477291,10033948868.540214,4760562690.558300,22782161934.575805,1633044,565099,943045,3141188
2013-06-27,NYSE MKT (A),0,11916318,7800779,19717097,0.000000,65203807.554100,130075967.837000,195279775.391100,0,23591,24557,48148
2013-06-27,NASDAQ BX (B),73661582,37754779,42331075,153747436,2184041610.435802,1886544316.087899,1383535452.486702,5454121379.010403,484184,141270,276561,902015
2013-06-27,NSX (C),8299647,5509373,5454642,19263662,202678868.353400,143712904.753500,125737431.551800,472129204.658700,24894,11216,15720,51830
2013-06-27,NYSE (DN),89677645,19079266,50887664,159644575,2851669259.724796,877776691.917701,1387536569.453193,5116982521.095690,516974,84285,271265,872524
2013-06-27,NASDAQ (DQ),1074889735,401494920,618231687,2094616342,30603186134.033785,17124259113.518945,16283350508.346397,64010795755.899127,3226749,682251,1607694,5516694
2013-06-27,EDGA (J),103954095,56074899,51770311,211799305,2967797851.878800,2263878891.980701,1451330366.663801,6683007110.523302,686148,189583,317462,1193193
2013-06-27,EDGX (K),267497366,105602945,148144863,521245174,8811885497.004406,5121373473.517407,4654613404.474183,18587872374.995996,1320847,296964,682856,2300667
2013-06-27,CHX (M),61887102,9020602,5178268,76085972,2125466336.369800,783486768.260000,195071212.443200,3104024317.073000,269,4868,1256,6393
2013-06-27,NYSE (N),737773218,0,0,737773218,24429571535.714667,0.000000,0.000000,24429571535.714667,1927373,0,0,1927373
2013-06-27,NYSE Arca (P),281206898,284495344,145274850,710977092,9289361963.676610,15383582356.015729,4968980544.428312,29641924864.120651,1599653,608574,781899,2990126
2013-06-27,NASDAQ (Q),358767675,181611803,430907718,971287196,12236447656.862994,12156651670.548407,13003989862.744864,37397089190.156265,2150068,575968,1718514,4444550
2013-06-27,CBSX (W),15448419,4171887,6400337,26020643,387603649.150000,227841920.660000,160822105.830000,776267675.640000,96231,13554,44443,154228
2013-06-27,NASDAQ PSX (X),14069515,16323756,10694879,41088150,344785656.065000,803744177.740000,283136447.420000,1431666281.225000,75799,40279,56879,172957
2013-06-27,BATS BYX (Y),61074091,29829826,29630438,120534355,1794832243.088999,1395921770.436301,836120338.312100,4026874351.837400,396492,109394,185761,691647
2013-06-27,BATS BZX (Z),224902307,144500616,137581100,506984023,6966367896.256803,8146345609.195101,4220282435.541491,19332995940.993395,1458398,477384,818293,2754075
2013-06-26,NYSE MKT (A),0,10732370,6399406,17131776,0.000000,70225516.488000,115600100.546000,185825617.034000,0,24089,23685,47774
2013-06-26,NASDAQ BX (B),77581232,41382224,43588519,162551975,2169056871.820002,2160141008.914698,1397917523.934606,5727115404.669306,495137,154260,282568,931965
2013-06-26,NSX (C),8933677,5173755,6391079,20498511,208519826.700400,161803149.877000,135874809.485200,506197786.062600,27726,11639,15837,55202
2013-06-26,NYSE (DN),94955811,19384630,48405926,162746367,2827285465.236294,985800220.015698,1366795744.749708,5179881430.001700,505513,82287,253346,841146
2013-06-26,NASDAQ (DQ),1190906896,417066766,607284994,2215258656,31661017040.640905,18105093697.931211,16403145079.963554,66169255818.535670,3317155,710885,1630880,5658920
2013-06-26,EDGA (J),105582231,52281748,48492820,206356799,2874300397.727701,2291870586.836103,1378163360.012599,6544334344.576403,683104,200000,303070,1186174
2013-06-26,EDGX (K),262918125,122983741,152380900,538282766,8376722163.738608,5817497741.029572,4868649796.487896,19062869701.256076,1342914,332032,703204,2378150
2013-06-26,CHX (M),20217227,22264300,3256556,45738083,701863634.668000,1401019994.653200,135565291.286000,2238448920.607200,228,4597,1591,6416
2013-06-26,NYSE (N),774175026,0,0,774175026,24960751159.310496,0.000000,0.000000,24960751159.310496,1975864,0,0,1975864
2013-06-26,NYSE Arca (P),284926164,277933939,148438179,711298282,9200850526.648314,15062498839.323214,5222327078.688611,29485676444.660139,1614603,612228,802333,3029164
2013-06-26,NASDAQ (Q),392621692,191881700,414547107,999050499,13182916585.804693,11943947026.670699,13464840530.034869,38591704142.510261,2298046,609935,1696123,4604104
2013-06-26,CBSX (W),14455687,4862108,7099831,26417626,393427547.730000,260695604.900000,175216590.565000,829339743.195000,97282,15772,46369,159423
2013-06-26,NASDAQ PSX (X),16261914,21310809,11383888,48956611,364434654.305000,1044495766.325000,313430328.000000,1722360748.630000,86576,50701,60326,197603
2013-06-26,BATS BYX (Y),68696364,31974443,34073942,134744749,2080174545.546996,1480739924.182399,983606825.953000,4544521295.682395,455238,122772,214789,792799
2013-06-26,BATS BZX (Z),254500321,163931098,140030470,558461889,7618761418.370095,9128265072.020794,4381297287.147094,21128323777.537983,1592631,529430,833263,2955324
2013-06-25,NYSE MKT (A),0,12037125,5437152,17474277,0.000000,77685217.630000,81385429.101000,159070646.731000,0,24708,19806,44514
2013-06-25,NASDAQ BX (B),78988021,37954450,41599388,158541859,2346818244.945900,2025412466.330598,1388782492.546102,5761013203.822600,522758,146272,279796,948826
2013-06-25,NSX (C),9080860,5727322,5649982,20458164,218527153.224500,198712454.024800,131513156.453300,548752763.702600,29641,12756,15150,57547
2013-06-25,NYSE (DN),100642231,20298980,48735806,169677017,3023447354.603403,992055323.856199,1376802892.679616,5392305571.139218,557578,84908,257673,900159
2013-06-25,NASDAQ (DQ),1216838575,431253587,578904818,2226996980,34441163293.141693,20721886766.679213,15200970486.330300,70364020546.151206,3525668,682256,1616030,5823954
2013-06-25,EDGA (J),116858883,53339437,51895448,222093768,3279659945.520502,2399726381.863600,1485484222.479700,7164870549.863802,771022,215039,325703,1311764
2013-06-25,EDGX (K),286586899,108049768,148449067,543085734,9261372324.831009,5097619641.218115,4775001800.200209,19133993766.249333,1499210,308255,709212,2516677
2013-06-25,CHX (M),64731166,12410376,5774754,82916296,1890850558.920800,839250307.992400,209833999.763800,2939934866.677000,377,3090,1465,4932
2013-06-25,NYSE (N),810069232,0,0,810069232,26527014711.973762,0.000000,0.000000,26527014711.973762,2114544,0,0,2114544
2013-06-25,NYSE Arca (P),286613107,272176276,142688600,701477983,9292572093.596095,15556619650.228360,5129638634.578804,29978830378.403259,1645762,628538,793496,3067796
2013-06-25,NASDAQ (Q),415106057,195286212,426703964,1037096233,14176678884.405796,12782475895.602377,13737571246.720778,40696726026.728951,2483398,652181,1747907,4883486
2013-06-25,CBSX (W),13478436,6420807,6481901,26381144,373042515.120000,338700344.350000,162669809.840000,874412669.310000,96857,14438,44364,155659
2013-06-25,NASDAQ PSX (X),17186854,17157861,12354640,46699355,405471500.795000,944604567.255000,348453258.640000,1698529326.690000,90810,45553,62410,198773
2013-06-25,BATS BYX (Y),69126121,31784869,33742487,134653477,1968458939.317601,1623693301.384599,932992461.472001,4525144702.174201,445853,128936,200623,775412
2013-06-25,BATS BZX (Z),276346897,155901301,149181000,581429198,8225927128.434317,8859813394.848012,4591062277.504494,21676802800.786823,1717388,532562,879148,3129098
2013-06-24,NYSE MKT (A),0,12237292,7231972,19469264,0.000000,80230987.864100,101766919.888000,181997907.752100,0,27828,25563,53391
2013-06-24,NASDAQ BX (B),95335220,53761672,53973087,203069979,2768482999.469398,2815009365.099701,1793589346.409696,7377081710.978795,646445,222498,353969,1222912
2013-06-24,NSX (C),11869088,7238335,7160424,26267847,272836487.130800,254250984.895900,180448412.819600,707535884.846300,38095,17562,20465,76122
2013-06-24,NYSE (DN),126405024,30782747,49886188,207073959,3805164812.990518,1621654924.272099,1420495635.497018,6847315372.759635,670692,123813,273752,1068257
2013-06-24,NASDAQ (DQ),1505854955,551060154,694347175,2751262284,41550838262.849024,25986717760.041769,19351267420.650275,86888823443.541068,4376652,1025698,1909499,7311849
2013-06-24,EDGA (J),148618568,76518586,66360066,291497220,4066121270.826601,3394465529.331299,1922537277.491603,9383124077.649503,980962,327181,410747,1718890
2013-06-24,EDGX (K),372581235,163071718,188898546,724551499,11646485183.167309,7781047572.057702,6025586476.305400,25453119231.530411,1958436,471127,890481,3320044
2013-06-24,CHX (M),105789626,23056312,7276041,136121979,3089449509.505001,1160689569.592000,388040834.183500,4638179913.280501,503,5374,2810,8687
2013-06-24,NYSE (N),968433533,0,0,968433533,30778679021.641417,0.000000,0.000000,30778679021.641417,2757367,0,0,2757367
2013-06-24,NYSE Arca (P),374246341,393239748,181988249,949474338,12181336702.091897,23091401640.413333,6702733997.143206,41975472339.648436,2147853,932665,1001771,4082289
2013-06-24,NASDAQ (Q),548585959,295731195,520380770,1364697924,18070105304.276383,19084772017.584565,15852068331.202111,53006945653.063059,3260484,977617,2208604,6446705
2013-06-24,CBSX (W),14980868,5488794,6849646,27319308,369254366.510000,338799997.620000,163813077.960000,871867442.090000,95193,21428,44488,161109
2013-06-24,NASDAQ PSX (X),24631141,27553913,18027830,70212884,547277809.260000,1530541399.305000,459430817.330000,2537250025.895000,111263,68720,78597,258580
2013-06-24,BATS BYX (Y),80395985,45824081,36830022,163050088,2229479977.703703,2192931602.338000,1013141145.588599,5435552725.630302,516689,192488,225667,934844
2013-06-24,BATS BZX (Z),357044428,230205863,192212191,779462482,10659484266.593673,13426361971.767171,5878662866.074810,29964509104.435654,2246028,779765,1120942,4146735
2013-06-21,NYSE MKT (A),0,124747385,6585659,131333044,0.000000,479220584.277300,105120830.563000,584341414.840300,0,29863,26005,55868
2013-06-21,NASDAQ BX (B),113190219,56661562,63798877,233650658,3467903296.965001,3052122427.886102,2152437510.527502,8672463235.378605,758500,235923,413143,1407566
2013-06-21,NSX (C),12388260,6705440,9976676,29070376,302352046.143100,260587829.369800,215298972.609200,778238848.122100,40470,17141,24143,81754
2013-06-21,NYSE (DN),110473356,28386338,51466695,190326389,3452641136.933447,1644464987.988205,1532876947.948609,6629983072.870261,596669,110874,274459,982002
2013-06-21,NASDAQ (DQ),1604084602,625076993,911011314,3140172909,45162910522.245517,29926576455.874224,24551281016.929472,99640767995.049213,4101351,968388,1925409,6995148
2013-06-21,EDGA (J),155210547,86211923,75244919,316667389,4389538216.514302,3731070707.695203,2176766214.960501,10297375139.170006,987426,316881,448550,1752857
2013-06-21,EDGX (K),362299899,161790604,199977810,724068313,11847277487.711029,7920916373.191195,5952546588.667806,25720740449.570030,1886513,470117,876122,3232752
2013-06-21,CHX (M),41177280,17511145,5041389,63729814,1170088358.027300,1672780331.992600,183114375.050800,3025983065.070700,407,5770,2631,8808
2013-06-21,NYSE (N),2009462801,0,0,2009462801,68497876518.051236,0.000000,0.000000,68497876518.051236,2822968,0,0,2822968
2013-06-21,NYSE Arca (P),379840250,402664409,200103901,982608560,12746656017.371829,24105786027.734878,7163022936.696997,44015464981.803704,2148107,935597,1026212,4109916
2013-06-21,NASDAQ (Q),537553973,297148123,1118608455,1953310551,18087622057.073297,19986840128.390570,34191363399.282957,72265825584.746824,3149213,1004427,2389929,6543569
2013-06-21,CBSX (W),16890389,5677468,10582854,33150711,473020646.430000,317701423.200000,228384306.762000,1019106376.392000,118529,19310,59232,197071
2013-06-21,NASDAQ PSX (X),26384114,29530193,21268097,77182404,578285045.905000,1798947968.299999,578056192.365000,2955289206.569999,119594,75190,89462,284246
2013-06-21,BATS BYX (Y),83438008,50695140,40393112,174526260,2295730454.669999,2639257430.761596,1160538762.348100,6095526647.779695,518986,193504,238542,951032
2013-06-21,BATS BZX (Z),345943145,245603164,208863826,800410135,10577792748.951369,14356524090.490514,6270814144.088696,31205130983.530579,2168658,814173,1126588,4109419
2013-06-20,NYSE MKT (A),0,15145139,7651755,22796894,0.000000,107733373.360200,134915488.011000,242648861.371200,0,32014,29655,61669
2013-06-20,NASDAQ BX (B),113244319,65916777,60806177,239967273,3383344638.044999,3505354711.028005,2111575341.452800,9000274690.525804,757721,260140,398189,1416050
2013-06-20,NSX (C),16979730,9034816,7936251,33950797,371038000.505900,329448029.161600,177424605.581900,877910635.249400,47801,19358,21057,88216
2013-06-20,NYSE (DN),113047319,40772318,50455933,204275570,3307307787.327448,2364711835.323599,1530283848.855209,7202303471.506256,597474,155873,263674,1017021
2013-06-20,NASDAQ (DQ),1476118469,729197239,661936137,2867251845,40056655772.231621,38192160298.614816,18049244030.713634,96298060101.560071,4433714,1237700,1860864,7532278
2013-06-20,EDGA (J),153315567,95844685,65167572,314327824,4188753977.609496,4117401342.409399,1860022289.425996,10166177609.444891,978519,357805,395443,1731767
2013-06-20,EDGX (K),409860194,210600467,190922811,811383472,12749556119.514873,9956542630.448814,6123355357.984088,28829454107.947775,1992303,579824,890340,3462467
2013-06-20,CHX (M),33438017,20113544,3639850,57191411,1085680632.685300,2084309181.842800,197991255.013000,3367981069.541100,554,7584,2801,10939
2013-06-20,NYSE (N),1066891543,0,0,1066891543,34576069955.729314,0.000000,0.000000,34576069955.729314,2848886,0,0,2848886
2013-06-20,NYSE Arca (P),400417096,505599612,191890615,1097907323,13013270612.633458,29623091236.439655,7256808848.333908,49893170697.407021,2237105,1100232,1013585,4350922
2013-06-20,NASDAQ (Q),581764387,379705552,531445764,1492915703,19369336958.324624,25340174727.579891,17141271670.372829,61850783356.277344,3346172,1166249,2251770,6764191
2013-06-20,CBSX (W),17861228,8099216,7851960,33812404,487427632.380000,456607152.670000,206371780.400000,1150406565.450000,122057,22970,51173,196200
2013-06-20,NASDAQ PSX (X),32363114,41177020,26597598,100137732,712299294.130000,2250371078.441801,743638617.585000,3706308990.156801,134672,90296,96333,321301
2013-06-20,BATS BYX (Y),83304634,56307427,37069486,176681547,2238205406.115002,2894141952.882898,1076665138.376400,6209012497.374300,534251,222531,227468,984250
2013-06-20,BATS BZX (Z),379079173,297015086,198756143,874850402,11426099488.549982,17069979472.565027,6199829028.801708,34695907989.916717,2341670,927950,1120747,4390367
2013-06-19,NYSE MKT (A),0,7708127,5785102,13493229,0.000000,56769308.998400,87627362.751000,144396671.749400,0,20918,20276,41194
2013-06-19,NASDAQ BX (B),90226252,43900324,47892915,182019491,2675637605.452201,2463088165.221898,1781135936.969702,6919861707.643801,605512,179422,335076,1120010
2013-06-19,NSX (C),12640893,7186258,8738838,28565989,292067855.607500,253767179.766500,188897921.571200,734732956.945200,33716,15769,19792,69277
2013-06-19,NYSE (DN),92107681,22748573,44791151,159647405,2882124050.922232,1378561988.937898,1362128075.354007,5622814115.214137,479558,88624,240476,808658
2013-06-19,NASDAQ (DQ),1035360260,436125315,571490355,2042975930,28708809082.848730,24414101795.125900,16240290774.330316,69363201652.304946,2968418,717147,1527108,5212673
2013-06-19,EDGA (J),115982369,59694617,51846386,227523372,3222736211.082498,2785918193.197497,1507757758.260597,7516412162.540592,734707,237333,321060,1293100
2013-06-19,EDGX (K),280608162,121349146,161308583,563265891,8901497857.725800,5847764786.980674,5085523027.259013,19834785671.965487,1371984,331690,731174,2434848
2013-06-19,CHX (M),36504183,19630769,4528701,60663653,1085882532.415000,1844860499.659999,162325253.447500,3093068285.522499,316,5588,2205,8109
2013-06-19,NYSE (N),760160857,0,0,760160857,25529830161.862004,0.000000,0.000000,25529830161.862004,2190410,0,0,2190410
2013-06-19,NYSE Arca (P),313763207,309108828,165355445,788227480,9966696350.329415,18719964845.589072,5854492570.057718,34541153765.976205,1660693,713607,866372,3240672
2013-06-19,NASDAQ (Q),431108425,238075851,430716660,1099900936,14552919061.397903,16207703345.528773,13676124436.173999,44436746843.100675,2465368,761585,1882601,5109554
2013-06-19,CBSX (W),13029699,3623311,6623626,23276636,384795228.730000,231938622.680000,165658998.100000,782392849.510000,87334,15812,40694,143840
2013-06-19,NASDAQ PSX (X),24962878,26296423,18951210,70210511,550939914.650000,1529628483.505000,528806927.375000,2609375325.530000,100246,59952,76021,236219
2013-06-19,BATS BYX (Y),66475436,36984077,29353292,132812805,1845016820.098601,2026347203.285499,849333617.308499,4720697640.692599,419948,147655,188882,756485
2013-06-19,BATS BZX (Z),280455081,187578143,154407278,622440502,8368318523.369501,11175525786.157107,4874061817.818205,24417906127.344813,1674932,584196,913760,3172888
2013-06-18,NYSE MKT (A),0,8191728,7473357,15665085,0.000000,52977966.386700,104322459.982000,157300426.368700,0,20222,21592,41814
2013-06-18,NASDAQ BX (B),72428018,27605852,43207231,143241101,2139927943.050002,1399643559.692901,1372668616.401602,4912240119.144505,484360,110484,295493,890337
2013-06-18,NSX (C),10053625,4655443,8655403,23364471,209666256.945700,151428280.711400,146697322.254000,507791859.911100,27136,9971,20822,57929
2013-06-18,NYSE (DN),83270015,16355431,41081251,140706697,2481736298.441091,851775488.749200,1237906909.062100,4571418696.252391,439213,70901,215579,725693
2013-06-18,NASDAQ (DQ),1027109501,330162654,672197354,2029469509,28920116651.295675,17223707006.108139,16292951141.202972,62436774798.606786,2869424,561599,1497060,4928083
2013-06-18,EDGA (J),101140014,41904459,50637955,193682428,2668215865.546804,1741452542.041901,1323602439.648494,5733270847.237199,630789,149109,300006,1079904
2013-06-18,EDGX (K),247172162,80259450,152422061,479853673,7621779920.580508,3704170257.536897,4443900029.604808,15769850207.722213,1171881,224358,657862,2054101
2013-06-18,CHX (M),61788151,11114699,6159226,79062076,1891268396.573000,739898234.527500,158633457.410000,2789800088.510500,734,1706,2039,4479
2013-06-18,NYSE (N),646029207,0,0,646029207,21321115732.064256,0.000000,0.000000,21321115732.064256,1702191,0,0,1702191
2013-06-18,NYSE Arca (P),245464088,187872233,135249455,568585776,7880630732.360907,11135348624.917690,4584962961.573199,23600942318.851796,1354755,424774,708905,2488434
2013-06-18,NASDAQ (Q),315576459,123972005,370941230,810489694,10536510663.642509,8191599069.321993,11087934824.101285,29816044557.065787,1831207,407605,1568554,3807366
2013-06-18,CBSX (W),15469579,4735767,6623656,26829002,357415442.330000,232241010.130000,161133950.100000,750790402.560000,91544,11360,43224,146128
2013-06-18,NASDAQ PSX (X),21991639,15180008,17491015,54662662,428743430.365000,950829527.740000,428941630.584700,1808514588.689700,77506,37435,64923,179864
2013-06-18,BATS BYX (Y),53975591,22861118,27405151,104241860,1554567597.232001,1215136730.671800,785356629.070300,3555060956.974101,355811,91721,177918,625450
2013-06-18,BATS BZX (Z),219980386,102186412,136146242,458313040,6424801543.521530,5746785630.475804,4095174817.113098,16266761991.110432,1301100,337728,784780,2423608
2013-06-17,NYSE MKT (A),0,8576677,5313236,13889913,0.000000,58681729.947100,84773716.565000,143455446.512100,0,21741,19787,41528
2013-06-17,NASDAQ BX (B),69633782,31701897,39544986,140880665,2154352754.960002,1671766735.089601,1487307096.134298,5313426586.183901,469418,125757,272301,867476
2013-06-17,NSX (C),8506651,4354268,7537418,20398337,208369551.005500,140609980.322100,167524325.222200,516503856.549800,25701,9670,19379,54750
2013-06-17,NYSE (DN),80266787,17569272,37634660,135470719,2505090879.944811,927410783.245200,1208504315.964200,4641005979.154211,422059,72655,215271,709985
2013-06-17,NASDAQ (DQ),999527560,314959070,571604043,1886090673,29537635763.473625,15088740527.175358,15624764058.555928,60251140349.204911,2985944,564631,1555267,5105842
2013-06-17,EDGA (J),100778451,46644724,48167109,195590284,2855443068.213201,1998482498.781802,1396760694.174901,6250686261.169904,660686,169229,308629,1138544
2013-06-17,EDGX (K),265620686,88733715,157301391,511655792,8844808069.391789,4411413306.312376,4998683400.462303,18254904776.166468,1360713,245917,705447,2312077
2013-06-17,CHX (M),30610841,9696365,2914749,43221955,900957777.143300,778758112.724800,66788714.545000,1746504604.413100,269,3016,2142,5427
2013-06-17,NYSE (N),679142610,0,0,679142610,23518981666.219787,0.000000,0.000000,23518981666.219787,1906488,0,0,1906488
2013-06-17,NYSE Arca (P),257849845,206341021,138411185,602602051,8820136552.947322,12648350706.264427,5102511699.036526,26570998958.248275,1514241,476509,773369,2764119
2013-06-17,NASDAQ (Q),339343856,148238714,383224793,870807363,12270393250.876886,10275011959.237738,12709192009.126970,35254597219.241594,2110181,491956,1685029,4287166
2013-06-17,CBSX (W),14506112,4412261,7137412,26055785,398669685.810000,293958532.679600,195812156.850000,888440375.339600,97735,13659,48449,159843
2013-06-17,NASDAQ PSX (X),18158484,18102167,18042935,54303586,424969719.270000,1162369169.379200,508776094.765001,2096114983.414201,77185,41177,64563,182925
2013-06-17,BATS BYX (Y),52635263,26473278,26150532,105259073,1529026497.088000,1486607712.325700,772601586.807999,3788235796.221699,345404,105654,169060,620118
2013-06-17,BATS BZX (Z),221838979,122748734,139170486,483758199,7207596916.385002,7169005741.008207,4478293446.123940,18854896103.517149,1429650,401114,844026,2674790
2013-06-14,NYSE MKT (A),0,7348084,5108477,12456561,0.000000,50259754.432100,68764660.050000,119024414.482100,0,17988,19551,37539
2013-06-14,NASDAQ BX (B),62439567,35776802,33071745,131288114,1938165311.657300,1750164614.748999,1155874454.316498,4844204380.722797,430298,139082,224347,793727
2013-06-14,NSX (C),9168110,4474445,6192813,19835368,209201278.206400,136467011.877800,132746562.909000,478414852.993200,27637,9981,16765,54383
2013-06-14,NYSE (DN),74630128,17781625,36273145,128684898,2488681727.676602,916902387.154201,1161028407.426798,4566612522.257601,431648,71647,184787,688082
2013-06-14,NASDAQ (DQ),920259554,357216730,518264242,1795740526,26809059001.693297,17509014478.302111,13718210017.294933,58036283497.290341,2684190,588906,1303748,4576844
2013-06-14,EDGA (J),96303003,53116942,44860449,194280394,2678993937.182105,2169663370.503299,1251282472.756999,6099939780.442403,640859,186121,277173,1104153
2013-06-14,EDGX (K),226095129,93181660,143646970,462923759,7409112010.692915,4395772093.186498,4302738889.795611,16107622993.675024,1203072,260756,648165,2111993
2013-06-14,CHX (M),41818626,9661254,3090156,54570036,1188118899.373100,832781310.650000,140820412.735600,2161720622.758700,231,3084,1807,5122
2013-06-14,NYSE (N),633867749,0,0,633867749,21359460858.224572,0.000000,0.000000,21359460858.224572,1818134,0,0,1818134
2013-06-14,NYSE Arca (P),254632632,210574020,133971999,599178651,8541583281.202891,12134976101.164915,4816763329.524182,25493322711.891988,1474058,497845,704131,2676034
2013-06-14,NASDAQ (Q),323170698,169544745,356152265,848867708,11230560779.020021,11687092789.420715,11181721465.258220,34099375033.698956,1974172,548190,1491891,4014253
2013-06-14,CBSX (W),10905705,5126578,4669669,20701952,296286798.300000,286825238.910000,130413298.440000,713525335.650000,74862,15089,32577,122528
2013-06-14,NASDAQ PSX (X),19129300,18898100,15985652,54013052,424714808.980000,1035669815.015000,388945836.665000,1849330460.660000,74955,42178,52177,169310
2013-06-14,BATS BYX (Y),47966343,30054323,23544474,101565140,1417974637.190999,1450338074.572700,658702872.607000,3527015584.370699,323349,117606,145204,586159
2013-06-14,BATS BZX (Z),219046170,135881193,133559032,488486395,6933580603.551812,7568605940.000605,4081790796.880899,18583977340.433316,1419338,430245,763173,2612756
2013-06-13,NYSE MKT (A),0,8114397,5542613,13657010,0.000000,60959963.198900,78944842.574000,139904805.772900,0,19046,19386,38432
2013-06-13,NASDAQ BX (B),70395191,39337963,37988606,147721760,2140002061.820000,2068005332.596901,1399932790.724702,5607940185.141603,475392,149310,251325,876027
2013-06-13,NSX (C),9315287,5030291,6546138,20891716,229956859.386000,240017000.809300,143217947.577300,613191807.772600,27748,10965,16824,55537
2013-06-13,NYSE (DN),89061510,20087813,42027604,151176927,2823541437.316597,1109273972.097598,1246242857.613700,5179058267.027895,480863,78343,206711,765917
2013-06-13,NASDAQ (DQ),1083767125,414470500,575476686,2073714311,30812822708.863392,20878841444.357609,15468869464.844966,67160533618.065967,3069866,650868,1454629,5175363
2013-06-13,EDGA (J),109056286,57423662,52425381,218905329,3142676465.835001,2463106476.994298,1476073119.086496,7081856061.915795,723786,193305,304052,1221143
2013-06-13,EDGX (K),260315935,108082700,153069752,521468387,8541732959.937908,5338223271.475494,4776204385.626897,18656160617.040299,1328425,288847,677451,2294723
2013-06-13,CHX (M),47059434,14368770,2866779,64294983,1275916783.671600,902715632.920000,96324691.023000,2274957107.614600,280,3394,1808,5482
2013-06-13,NYSE (N),755895385,0,0,755895385,24886884970.762649,0.000000,0.000000,24886884970.762649,1990021,0,0,1990021
2013-06-13,NYSE Arca (P),284330805,264484470,141452889,690268164,9342507653.073985,15459939914.966099,5252843477.722118,30055291045.762202,1587260,559158,764422,2910840
2013-06-13,NASDAQ (Q),361871975,182857074,375658876,920387925,12546364541.445961,12411549674.578826,11877027899.571487,36834942115.596274,2152898,565642,1606720,4325260
2013-06-13,CBSX (W),13112642,5499134,6220700,24832476,372726527.350000,320404213.166800,176687336.490000,869818077.006800,89717,15032,37971,142720
2013-06-13,NASDAQ PSX (X),22136318,22088876,17068473,61293667,496737643.345000,1293489139.325000,431675049.670000,2221901832.340000,84972,48074,59147,192193
2013-06-13,BATS BYX (Y),56475565,33388192,26466138,116329895,1684512520.115000,1795693572.115099,794800694.119999,4275006786.350098,376072,130861,168147,675080
2013-06-13,BATS BZX (Z),262677535,160935662,142528801,566141998,8034501489.061713,9280766451.470918,4517396261.870489,21832664202.403120,1582044,483923,834169,2900136
2013-06-12,NYSE MKT (A),0,8515654,8338410,16854064,0.000000,53191433.657300,109429658.450000,162621092.107300,0,20638,23843,44481
2013-06-12,NASDAQ BX (B),72692136,39479276,39535534,151706946,2198234633.260002,1973160120.701199,1407135512.016702,5578530265.977903,473021,159663,259537,892221
2013-06-12,NSX (C),10476875,6184061,8047066,24708002,272609038.966400,304606661.551700,156403520.545600,733619221.063700,32364,13409,18941,64714
2013-06-12,NYSE (DN),78398525,20598205,38229040,137225770,2495758411.628904,1133970766.252297,1241663815.877101,4871392993.758302,429453,80297,195364,705114
2013-06-12,NASDAQ (DQ),964104849,438730084,585878270,1988713203,27682925691.412689,22159203939.069414,16664833746.341300,66506963376.823403,2902959,694852,1470300,5068111
2013-06-12,EDGA (J),103605276,65815366,51860689,221281331,2919147313.788002,2640671555.174403,1480950446.060302,7040769315.022707,682558,216158,307389,1206105
2013-06-12,EDGX (K),279943652,118377247,169499622,567820521,8969498757.633745,5587532989.598995,5218113955.971419,19775145703.204159,1361841,313676,733404,2408921
2013-06-12,CHX (M),32169499,7675864,5367170,45212533,898996501.237300,663996465.996500,217231434.034500,1780224401.268300,280,3478,2054,5812
2013-06-12,NYSE (N),691940832,0,0,691940832,22701079245.047225,0.000000,0.000000,22701079245.047225,1986471,0,0,1986471
2013-06-12,NYSE Arca (P),282633726,251672222,141976709,676282657,9481742276.023444,15392417735.233896,5456943316.058580,30331103327.315920,1606434,568746,783474,2958654
2013-06-12,NASDAQ (Q),361443492,195619338,379175115,936237945,12430860768.255609,13355629122.639999,12211344628.491447,37997834519.387055,2152729,627043,1687624,4467396
2013-06-12,CBSX (W),12656248,10617797,6566386,29840431,342445257.800000,520035705.620000,169466462.875000,1031947426.295000,83729,17122,39898,140749
2013-06-12,NASDAQ PSX (X),23353290,23586296,20985505,67925091,532457526.180000,1353345533.541200,567773872.125000,2453576931.846200,87966,59371,65070,212407
2013-06-12,BATS BYX (Y),55988352,37042621,26393438,119424411,1580805361.834000,2085270681.661199,763046398.224500,4429122441.719699,361513,153287,166920,681720
2013-06-12,BATS BZX (Z),250186340,173107173,148717767,572011280,7815985789.739998,9960804578.893677,4770722086.319690,22547512454.953365,1562465,531429,868826,2962720
2013-06-11,NYSE MKT (A),0,8185738,5918395,14104133,0.000000,55096870.780500,77629613.679000,132726484.459500,0,20243,21362,41605
2013-06-11,NASDAQ BX (B),73607587,40866210,37915043,152388840,2150699725.720004,2028178422.529102,1401423161.511397,5580301309.760503,479044,158483,257232,894759
2013-06-11,NSX (C),9631439,6060579,8061108,23753126,225515161.680500,227284724.848100,140672856.801900,593472743.330500,27186,11571,17712,56469
2013-06-11,NYSE (DN),88466993,20703210,38691722,147861925,2598024703.539197,1222102110.776601,1220672549.052197,5040799363.367995,441867,82683,204923,729473
2013-06-11,NASDAQ (DQ),1110616223,413732285,544121553,2068470061,31666819471.896713,19897086550.039075,15300854449.354028,66864760471.289816,2897283,672475,1467148,5036906
2013-06-11,EDGA (J),107274487,61960098,49783436,219018021,2962216971.218398,2514636678.576900,1391907436.879700,6868761086.674998,687496,201056,304705,1193257
2013-06-11,EDGX (K),277558070,122119630,165035493,564713193,8889873520.498319,5669395439.506904,5259629843.408999,19818898803.414222,1375080,316054,731086,2422220
2013-06-11,CHX (M),43953903,8148748,2850688,54953339,1096326825.535000,664248825.971000,102216610.713200,1862792262.219200,405,3217,2036,5658
2013-06-11,NYSE (N),689181363,0,0,689181363,22762875859.689808,0.000000,0.000000,22762875859.689808,1949288,0,0,1949288
2013-06-11,NYSE Arca (P),299050057,275442047,141587882,716079986,9410898295.265140,15974444616.962853,5291912706.720924,30677255618.948917,1622415,599643,798888,3020946
2013-06-11,NASDAQ (Q),377293623,192983056,378337097,948613776,12722016362.240670,12853803274.305009,12307523704.895557,37883343341.441236,2205919,605229,1676848,4487996
2013-06-11,CBSX (W),12656757,7008415,4906956,24572128,338358667.890000,384050018.210000,137559179.822900,859967865.922900,81030,16891,35910,133831
2013-06-11,NASDAQ PSX (X),23828029,24437175,16575640,64840844,514845948.610000,1302439345.250000,456158173.010000,2273443466.870000,88657,50260,60830,199747
2013-06-11,BATS BYX (Y),63002223,36764525,27175364,126942112,1735032542.509000,2051196573.425600,813452781.149800,4599681897.084400,397707,141259,177631,716597
2013-06-11,BATS BZX (Z),260202489,172419567,140018183,572640239,7712638815.607191,9771762369.960525,4474507418.500921,21958908604.068637,1520271,502654,821754,2844679
2013-06-10,NYSE MKT (A),0,7931682,7608400,15540082,0.000000,50599270.690900,112926624.402000,163525895.092900,0,18999,25795,44794
2013-06-10,NASDAQ BX (B),68318757,30898126,40240905,139457788,2057878875.707904,1406405746.830700,1342806191.889201,4807090814.427805,442616,116773,258391,817780
2013-06-10,NSX (C),9685837,4458439,9077544,23221820,235528831.085800,190095900.444300,169971674.095800,595596405.625900,30790,9475,20939,61204
2013-06-10,NYSE (DN),74048660,16069455,35731497,125849612,2383954865.705717,866592295.612599,1203000949.406197,4453548110.724513,397546,64416,197150,659112
2013-06-10,NASDAQ (DQ),1007669588,326034736,562168153,1895872477,31254033860.335103,16028053431.318188,16254345968.700766,63536433260.354057,2635581,537150,1396881,4569612
2013-06-10,EDGA (J),95696248,53493963,52405704,201595915,2760490186.598100,2083949117.784500,1392101712.332501,6236541016.715101,637567,164792,305185,1107544
2013-06-10,EDGX (K),246882492,89620127,160209438,496712057,7988628446.374793,4341020273.864302,5180925019.547280,17510573739.786375,1226656,247780,694381,2168817
2013-06-10,CHX (M),20444035,5434450,3378155,29256640,774545369.461600,355273192.300000,181334337.620000,1311152899.381600,315,1731,2057,4103
2013-06-10,NYSE (N),595341427,0,0,595341427,20111671662.525500,0.000000,0.000000,20111671662.525500,1684655,0,0,1684655
2013-06-10,NYSE Arca (P),246116791,212347910,134163227,592627928,8359436682.812485,11617298297.831694,5379549968.743006,25356284949.387185,1455789,459595,728711,2644095
2013-06-10,NASDAQ (Q),316112209,136072120,368916668,821100997,11133084499.388210,9025923544.356501,12113644424.909304,32272652468.654015,1931394,452211,1607673,3991278
2013-06-10,CBSX (W),13811646,4748268,6060648,24620562,351952147.000000,239857059.250000,151124272.052500,742933478.302500,90968,13968,40574,145510
2013-06-10,NASDAQ PSX (X),20116297,17159814,15546619,52822730,443522850.420000,883937909.545000,369819483.370000,1697280243.335000,76708,39903,56018,172629
2013-06-10,BATS BYX (Y),54948881,27134712,27827513,109911106,1622693295.662601,1435133600.760200,791497179.042300,3849324075.465101,364022,110483,178270,652775
2013-06-10,BATS BZX (Z),210119571,123514449,133775680,467409700,6785500477.352986,7037128753.356583,4271285624.356185,18093914855.065754,1324737,381997,772621,2479355
2013-06-07,NYSE MKT (A),0,7688469,6624732,14313201,0.000000,51273964.680900,98575900.629000,149849865.309900,0,18508,20729,39237
2013-06-07,NASDAQ BX (B),74476703,36430695,43290706,154198104,2306251719.084997,1691011381.191302,1647488457.005401,5644751557.281700,489279,126031,278096,893406
2013-06-07,NSX (C),11309773,6042109,7904663,25256545,321108116.866200,277811689.521700,177262524.158400,776182330.546300,35167,11342,19993,66502
2013-06-07,NYSE (DN),81646042,23006188,40288661,144940891,2673099227.245106,1267860887.179203,1352502039.274494,5293462153.698803,432474,91684,200682,724840
2013-06-07,NASDAQ (DQ),1075404125,480166935,563150984,2118722044,32643491799.930709,21716481233.798478,16649476626.754494,71009449660.483681,2945371,654610,1480344,5080325
2013-06-07,EDGA (J),104369970,62658251,53825428,220853649,3089548931.007693,2628213776.045400,1572810439.040198,7290573146.093291,685733,205341,314915,1205989
2013-06-07,EDGX (K),281180034,123776081,156369031,561325146,9227134921.092507,5870254050.883607,5420998789.872102,20518387761.848216,1344170,310624,702484,2357278
2013-06-07,CHX (M),17601342,9422099,3848966,30872407,610906564.084100,939902716.570000,178921359.975000,1729730640.629100,298,3497,1728,5523
2013-06-07,NYSE (N),729436987,0,0,729436987,26395721435.946280,0.000000,0.000000,26395721435.946280,1914058,0,0,1914058
2013-06-07,NYSE Arca (P),284844101,273421819,142396919,700662839,10216623493.213793,16797541590.985489,6148221871.343099,33162386955.542381,1615530,563993,759651,2939174
2013-06-07,NASDAQ (Q),363893469,189378234,428289050,981560753,13182583886.467820,13395253432.347091,15466802171.431911,42044639490.246822,2200173,594268,1710182,4504623
2013-06-07,CBSX (W),13247435,6657257,8801928,28706620,384779788.420000,284024016.535100,226571914.423500,895375719.378600,88921,15467,48340,152728
2013-06-07,NASDAQ PSX (X),25753220,24654331,17263888,67671439,675956590.295000,1503593007.510000,458714234.270000,2638263832.075000,91241,52142,61824,205207
2013-06-07,BATS BYX (Y),58965253,33125901,28556276,120647430,1830543341.930000,1804362044.683202,925380815.879900,4560286202.493102,388511,122517,181199,692227
2013-06-07,BATS BZX (Z),255346629,164209248,146597452,566153329,8827163418.549207,9693570114.059894,5080572633.364602,23601306165.973703,1573188,489847,837630,2900665
2013-06-06,NYSE MKT (A),0,8256073,7072350,15328423,0.000000,58702404.558300,111612655.058000,170315059.616300,0,18960,26905,45865
2013-06-06,NASDAQ BX (B),83663316,44134344,47538194,175335854,2679423724.659999,2069274565.460600,1701261450.534503,6449959740.655102,558748,157012,302216,1017976
2013-06-06,NSX (C),12027932,6744496,6892411,25664839,328973235.273500,296502018.308800,200141940.009100,825617193.591400,37241,13385,20583,71209
2013-06-06,NYSE (DN),78643677,23421846,41709595,143775118,2565087155.890999,1340540048.509801,1370596057.386496,5276223261.787296,447215,88326,212547,748088
2013-06-06,NASDAQ (DQ),1078740933,492801451,614677438,2186219822,31645113927.182219,24817411945.881081,17355021878.998224,73817547752.061524,3097236,708175,1525784,5331195
2013-06-06,EDGA (J),108377202,67803643,56613271,232794116,3118586221.563700,2762470830.677999,1708432807.772900,7589489860.014599,705575,234509,337720,1277804
2013-06-06,EDGX (K),287410666,136694445,174306317,598411428,9472370139.221119,6427905343.768897,5687761619.687408,21588037102.677424,1442880,349146,772253,2564279
2013-06-06,CHX (M),12675159,7813443,4439875,24928477,504057633.565100,606743979.122000,132462029.710000,1243263642.397100,281,3296,2349,5926
2013-06-06,NYSE (N),799617281,0,0,799617281,28387227931.868349,0.000000,0.000000,28387227931.868349,2124105,0,0,2124105
2013-06-06,NYSE Arca (P),292687615,290812224,150539958,734039797,9942107323.285717,17739234545.171435,5679650470.284215,33360992338.741367,1694780,651053,789533,3135366
2013-06-06,NASDAQ (Q),430636211,222010167,466763401,1119409779,15361312850.799700,15259553288.369612,15501240482.690749,46122106621.860061,2630902,725885,1894487,5251274
2013-06-06,CBSX (W),12437791,6497179,8557899,27492869,367564684.790000,371329314.830000,200550493.757200,939444493.377200,91164,16851,45127,153142
2013-06-06,NASDAQ PSX (X),21662191,24838857,21074104,67575152,516703575.185000,1444166864.052000,529311824.800000,2490182264.037000,92625,59959,67836,220420
2013-06-06,BATS BYX (Y),62748040,42025831,31349336,136123207,1953697410.539001,2306743531.409498,966819979.097000,5227260921.045499,419140,155429,195846,770415
2013-06-06,BATS BZX (Z),275256108,202537134,171380352,649173594,9014835261.495418,11561488859.946495,5356288227.600482,25932612349.042395,1754420,607811,942240,3304471
2013-06-05,NYSE MKT (A),0,8778486,8074831,16853317,0.000000,67610295.123800,135347868.627000,202958163.750800,0,21875,31932,53807
2013-06-05,NASDAQ BX (B),86202971,41001064,45624039,172828074,2790257410.856997,1889999238.566300,1628326953.578196,6308583603.001493,553994,147212,293159,994365
2013-06-05,NSX (C),12628375,7561521,8648501,28838397,325219868.086500,337206917.239100,205075160.389700,867501945.715300,37094,14097,21584,72775
2013-06-05,NYSE (DN),85744229,27198057,43163845,156106131,2806149039.194412,1486015171.909096,1315180441.758106,5607344652.861614,468561,91804,213673,774038
2013-06-05,NASDAQ (DQ),1114203081,449968974,617249162,2181421217,32979639196.343508,24031267105.191834,17394018448.785638,74404924750.320980,3352590,757919,1588823,5699332
2013-06-05,EDGA (J),117098892,73893519,57447315,248439726,3272008868.683402,3006070080.570301,1623276509.947895,7901355459.201598,748146,233098,339362,1320606
2013-06-05,EDGX (K),300375994,127170846,180292481,607839321,9811886571.139708,5997761088.995705,5572342441.663000,21381990101.798413,1480078,337271,779707,2597056
2013-06-05,CHX (M),12114907,5326651,3414078,20855636,427359889.954400,432808153.706000,212087393.628000,1072255437.288400,359,2528,2403,5290
2013-06-05,NYSE (N),740897250,0,0,740897250,25077855436.202785,0.000000,0.000000,25077855436.202785,2180816,0,0,2180816
2013-06-05,NYSE Arca (P),337758028,294180982,159345730,791284740,11371584328.714816,18538503457.611823,5749224652.841616,35659312439.168255,1904770,681334,839057,3425161
2013-06-05,NASDAQ (Q),442955447,222415704,458250562,1123621713,15550133896.303328,14975364115.675099,14381477693.221727,44906975705.200154,2652364,728397,1940214,5320975
2013-06-05,CBSX (W),14125268,4893105,8395618,27413991,403387419.790000,298063620.400000,223349324.940000,924800365.130000,94698,16044,46396,157138
2013-06-05,NASDAQ PSX (X),22687592,24323294,19965195,66976081,540179346.264900,1401554963.515000,542563045.170000,2484297354.949900,92063,57641,69687,219391
2013-06-05,BATS BYX (Y),65558570,37719934,31417884,134696388,1949369173.845001,2297601758.948101,952814854.905400,5199785787.698502,425179,146755,197018,768952
2013-06-05,BATS BZX (Z),282459906,209923445,173275389,665658740,8977937919.255822,12428944442.729592,5348759170.276303,26755641532.261717,1755217,630510,945394,3331121
2013-06-04,NYSE MKT (A),0,9244964,8080529,17325493,0.000000,81683118.905200,134740305.573000,216423424.478200,0,23135,28090,51225
2013-06-04,NASDAQ BX (B),79492217,34767173,44815960,159075350,2545856448.721799,1716432477.225900,1510988558.542302,5773277484.490001,523046,129523,283770,936339
2013-06-04,NSX (C),11419439,5334938,7347669,24102046,336433100.701300,226016716.380400,188075032.082600,750524849.164300,40375,12149,20689,73213
2013-06-04,NYSE (DN),81829473,20598254,42961221,145388948,2639573357.704010,1224947940.405603,1339973723.418016,5204495021.527629,445984,82716,225922,754622
2013-06-04,NASDAQ (DQ),1133855023,383458772,666251845,2183565640,34445217286.370654,20426209841.122946,18146161856.869205,73017588984.362805,3264459,640711,1636226,5541396
2013-06-04,EDGA (J),110073813,62196522,60802939,233073274,3155377027.440999,2771486770.349598,1646584427.966503,7573448225.757100,707707,208236,345812,1261755
2013-06-04,EDGX (K),300866604,110091782,173947226,584905612,10072327131.808420,5428631622.586897,5496669419.161791,20997628173.557108,1540967,300718,779560,2621245
2013-06-04,CHX (M),15458208,5238337,3970108,24666653,613687110.896800,388151237.539200,205756106.314700,1207594454.750700,445,2858,2795,6098
2013-06-04,NYSE (N),786982500,0,0,786982500,26369726427.534683,0.000000,0.000000,26369726427.534683,2128181,0,0,2128181
2013-06-04,NYSE Arca (P),327634809,238039202,155661026,721335037,11230777424.508764,14956964957.220289,5478447267.460524,31666189649.189577,1862809,570538,825808,3259155
2013-06-04,NASDAQ (Q),426037223,186853670,473798345,1086689238,15299692348.716398,12397828303.228311,14730374541.226182,42427895193.170891,2561182,621573,1870213,5052968
2013-06-04,CBSX (W),12646866,6425330,7648486,26720682,371793312.170000,363260423.869400,218087732.320000,953141468.359400,88650,16652,43272,148574
2013-06-04,NASDAQ PSX (X),22672328,22136299,20410838,65219465,558532725.875000,1340978829.410000,543200556.735000,2442712112.020000,90542,53488,73903,217933
2013-06-04,BATS BYX (Y),63156074,31071778,32593440,126821292,1944159788.359999,1796298012.094601,926966772.099999,4667424572.554599,419142,122432,205157,746731
2013-06-04,BATS BZX (Z),282851403,165388741,173939987,622180131,9034470028.955400,9918595645.432598,5226377928.915402,24179443603.303400,1746926,520753,961894,3229573
2013-06-03,NYSE MKT (A),0,12198148,8866203,21064351,0.000000,90276887.153100,134317120.843000,224594007.996100,0,26216,34094,60310
2013-06-03,NASDAQ BX (B),90207940,45704187,49111941,185024068,2905842944.929998,2111524551.558601,1750374632.637197,6767742129.125796,592019,159017,323337,1074373
2013-06-03,NSX (C),13636317,6819200,8245717,28701234,369258346.820200,294137108.638400,207281535.654200,870676991.112800,42853,15060,22879,80792
2013-06-03,NYSE (DN),90695441,28814892,45281980,164792313,2885651552.534087,1538777855.779595,1474988969.490103,5899418377.803785,505796,105768,250363,861927
2013-06-03,NASDAQ (DQ),1167201769,561302412,707988369,2436492550,33801193524.252681,28538825191.413200,19360148234.153259,81700166949.819140,3509548,820546,1837604,6167698
2013-06-03,EDGA (J),118684843,77105849,62264571,258055263,3296914171.017996,3419648352.470200,1731922328.979600,8448484852.467796,773329,263020,376862,1413211
2013-06-03,EDGX (K),301451940,138021394,192326242,631799576,9776760187.651405,6708947130.508508,6070292648.103251,22555999966.263164,1571488,373421,857212,2802121
2013-06-03,CHX (M),10943856,7308688,6876697,25129241,380166257.414200,505061088.854400,262527100.158300,1147754446.426900,351,2628,2678,5657
2013-06-03,NYSE (N),879974783,0,0,879974783,29878750146.774686,0.000000,0.000000,29878750146.774686,2520240,0,0,2520240
2013-06-03,NYSE Arca (P),370607295,368939696,177780864,917327855,12669480488.880300,22366825336.343962,6422784099.703405,41459089924.927667,2163232,781148,968268,3912648
2013-06-03,NASDAQ (Q),490315576,254828701,545028322,1290172599,17512972881.745740,16160730972.169108,16918066400.812657,50591770254.727505,2983902,790682,2213632,5988216
2013-06-03,CBSX (W),12951099,9174585,8429635,30555319,370053244.440000,558550082.220000,211345243.649300,1139948570.309300,94191,19321,48163,161675
2013-06-03,NASDAQ PSX (X),22386910,26988519,18519688,67895117,534549791.565000,1557084155.180000,479634497.985000,2571268444.730000,92435,61757,68510,222702
2013-06-03,BATS BYX (Y),67476008,37979833,34659792,140115633,2048228284.237998,2062745380.120299,994087375.516501,5105061039.874798,449606,146725,220553,816884
2013-06-03,BATS BZX (Z),316324801,219979161,189475436,725779398,10004546237.621599,12531248454.169600,5806357824.483991,28342152516.275190,1995075,660506,1081575,3737156
2013-05-31,NYSE MKT (A),0,19281611,7394217,26675828,0.000000,197417441.920400,119359873.226000,316777315.146400,0,24941,23794,48735
2013-05-31,NASDAQ BX (B),88726530,41777630,43930677,174434837,2773026765.359997,2029884802.446199,1598978934.974297,6401890502.780493,555870,140390,277433,973693
2013-05-31,NSX (C),11935289,5357855,7523326,24816470,296768893.140700,250839811.949900,156438335.379600,704047040.470200,33540,11297,18081,62918
2013-05-31,NYSE (DN),94491629,25571240,40987311,161050180,2961175533.181507,1324187255.335201,1319251310.486100,5604614099.002808,517996,98144,226251,842391
2013-05-31,NASDAQ (DQ),1230087516,429915186,711332324,2371335026,36504610476.805240,20880372448.923633,20255940262.190275,77640923187.919148,3224199,704259,1510907,5439365
2013-05-31,EDGA (J),109243203,65425478,50783655,225452336,3050179433.143395,3084818728.608800,1391149360.565605,7526147522.317800,677777,207599,299114,1184490
2013-05-31,EDGX (K),264081335,107428919,161638856,533149110,8813735288.098409,5277315872.342297,5070977014.369716,19162028174.810422,1284047,292722,690523,2267292
2013-05-31,CHX (M),14138242,7750364,6029125,27917731,492724308.944600,770938504.342500,212076339.904600,1475739153.191700,448,2445,1960,4853
2013-05-31,NYSE (N),1135265907,0,0,1135265907,40159934458.841388,0.000000,0.000000,40159934458.841388,2131174,0,0,2131174
2013-05-31,NYSE Arca (P),322855318,304089878,147658259,774603455,10850437514.279098,19515146285.685257,5647680448.565162,36013264248.529517,1754919,661703,769138,3185760
2013-05-31,NASDAQ (Q),430777376,227190385,576937447,1234905208,15415577191.438322,14751030663.835692,18862888825.121400,49029496680.395414,2517107,693187,1795868,5006162
2013-05-31,CBSX (W),15173582,5910202,8260923,29344707,435754038.290000,326017346.980000,234490197.510000,996261582.780000,98835,16087,45072,159994
2013-05-31,NASDAQ PSX (X),26138593,21664733,15743574,63546900,766366197.555000,1322023638.689000,457022692.975000,2545412529.219000,135680,47987,61370,245037
2013-05-31,BATS BYX (Y),69012832,32498363,31015977,132527172,2053630742.965000,1788837070.829699,905992375.167000,4748460188.961699,442681,124782,192808,760271
2013-05-31,BATS BZX (Z),277241527,183661893,160216556,621119976,8893746199.932262,11002153140.075886,5092724120.800972,24988623460.809120,1680230,536621,879942,3096793
2013-05-30,NYSE MKT (A),0,9294130,6897510,16191640,0.000000,61136342.375100,110176025.305000,171312367.680100,0,21810,23736,45546
2013-05-30,NASDAQ BX (B),80511604,33609673,42866971,156988248,2501199588.035002,1509306765.057900,1554083193.779295,5564589546.872197,512100,108363,268928,889391
2013-05-30,NSX (C),11559161,4813301,8165092,24537554,274725755.413200,153703536.777400,163391561.005200,591820853.195800,31452,11129,18466,61047
2013-05-30,NYSE (DN),86673644,17683339,44250246,148607229,2872210041.786704,923040758.403000,1339857746.532602,5135108546.722306,484558,71537,225677,781772
2013-05-30,NASDAQ (DQ),1132125771,373613403,672712754,2178451928,32965150263.848683,16288303253.994912,17777863615.522008,67031317133.365603,3225822,565769,1562286,5353877
2013-05-30,EDGA (J),97200771,56248623,48670681,202120075,2720143216.788200,2439005883.304802,1266183332.948000,6425332433.041002,609600,175903,274023,1059526
2013-05-30,EDGX (K),262219285,87135317,176146988,525501590,8807006049.192713,3906858913.109093,5440692385.835099,18154557348.136905,1258764,230481,688779,2178024
2013-05-30,CHX (M),20952785,7694777,7412607,36060169,1073654661.577500,563078428.400000,357204619.855000,1993937709.832500,470,1549,2019,4038
2013-05-30,NYSE (N),710541536,0,0,710541536,24639757583.272426,0.000000,0.000000,24639757583.272426,1838056,0,0,1838056
2013-05-30,NYSE Arca (P),328826637,247989843,155457266,732273746,10707379004.612692,12562537776.365497,5271767166.868924,28541683947.847113,1665123,490766,737723,2893612
2013-05-30,NASDAQ (Q),402545722,166860659,414512888,983919269,13876822447.979064,9792022929.331890,13133317153.585858,36802162530.896812,2282050,508298,1625376,4415724
2013-05-30,CBSX (W),11883003,6108848,7013613,25005464,352227237.670000,316337787.330000,203013391.823600,871578416.823600,78315,15553,37427,131295
2013-05-30,NASDAQ PSX (X),30375468,17405240,15570821,63351529,873038104.450000,955972553.703100,377597786.732600,2206608444.885700,138054,39083,55682,232819
2013-05-30,BATS BYX (Y),58826278,28241842,31001774,118069894,1703423985.170000,1495254990.378900,837794233.407798,4036473208.956698,371932,103890,178806,654628
2013-05-30,BATS BZX (Z),268804195,143878435,162902618,575585248,8297518210.509398,7928811609.467403,4780936544.502517,21007266364.479318,1583691,428822,836238,2848751
2013-05-29,NYSE MKT (A),0,9260755,7799091,17059846,0.000000,69920460.024200,105548911.400000,175469371.424200,0,21724,21719,43443
2013-05-29,NASDAQ BX (B),79772878,36435243,44599108,160807229,2506431102.391503,1716407482.764098,1448391315.129501,5671229900.285102,508283,121895,255767,885945
2013-05-29,NSX (C),11461096,5446202,6836170,23743468,293019676.968900,260247769.356100,165428501.972500,718695948.297500,35326,10907,17318,63551
2013-05-29,NYSE (DN),93933204,22125953,43833571,159892728,3073211001.162928,1411220916.881903,1459417290.341005,5943849208.385836,531135,85538,236045,852718
2013-05-29,NASDAQ (DQ),1161961911,374111778,672742022,2208815711,34224024469.432118,18350418550.829353,17684574581.812876,70259017602.074347,3368592,647753,1548170,5564515
2013-05-29,EDGA (J),101418574,51505137,52771928,205695639,2932384977.697905,2571924959.119100,1349311828.651100,6853621765.468105,674507,184702,292503,1151712
2013-05-29,EDGX (K),273500485,97325316,168777404,539603205,9138027462.161954,4784332791.002791,5465519417.670005,19387879670.834750,1361388,268014,707095,2336497
2013-05-29,CHX (M),15134103,5585650,4853926,25573679,488578640.846300,440157671.410000,200890532.546000,1129626844.802300,395,1667,2205,4267
2013-05-29,NYSE (N),722890117,0,0,722890117,24869419645.831400,0.000000,0.000000,24869419645.831400,2009541,0,0,2009541
2013-05-29,NYSE Arca (P),330272844,245226570,158520025,734019439,11176575790.552518,15797376104.398510,5560759977.882395,32534711872.833423,1825408,569226,789709,3184343
2013-05-29,NASDAQ (Q),412180852,189359310,401422819,1002962981,14427678203.791035,12483117579.734619,13206240794.119862,40117036577.645516,2436497,595200,1668625,4700322
2013-05-29,CBSX (W),14660053,5783001,8726992,29170046,422424357.910000,286528633.760000,231394567.160000,940347558.830000,94269,16452,44930,155651
2013-05-29,NASDAQ PSX (X),28266134,19764517,17984273,66014924,818942904.490000,1205174301.945000,477711083.615000,2501828290.050000,148096,45304,63963,257363
2013-05-29,BATS BYX (Y),66846827,29985697,32253987,129086511,2021856353.139999,1814951236.879401,921810737.129299,4758618327.148699,447532,119941,193065,760538
2013-05-29,BATS BZX (Z),276031423,171076026,173924717,621032166,8851790160.482603,10932875386.882824,5216177963.236613,25000843510.602040,1715387,518088,889932,3123407
2013-05-28,NYSE MKT (A),0,10003974,7803471,17807445,0.000000,77598683.734200,109466367.984000,187065051.718200,0,21994,24142,46136
2013-05-28,NASDAQ BX (B),74149433,29793931,37944892,141888256,2402569279.146002,1538046762.782499,1451291452.130200,5391907494.058701,463284,106689,239234,809207
2013-05-28,NSX (C),10763709,5226607,9196768,25187084,289453109.998500,235825381.528100,201450693.894600,726729185.421200,35037,10232,22304,67573
2013-05-28,NYSE (DN),86793753,19554142,39234604,145582499,2811747947.800394,1181593272.642900,1300048653.502801,5293389873.946095,471561,71960,217077,760598
2013-05-28,NASDAQ (DQ),1156766108,354715027,637141335,2148622470,36283108698.040680,17863356921.628499,17654327178.870362,71800792798.539541,3244116,573991,1595432,5413539
2013-05-28,EDGA (J),94311096,45493483,48782570,188587149,2736579007.512494,2084515453.014997,1360541234.002097,6181635694.529588,611291,149148,295051,1055490
2013-05-28,EDGX (K),259128591,87842690,176230878,523202159,8809600149.253090,4416780384.734401,5507513901.035433,18733894435.022924,1299427,234816,737843,2272086
2013-05-28,CHX (M),15441779,5058125,7276846,27776750,569100904.170200,398998586.450000,408218511.557000,1376318002.177200,350,1934,2016,4300
2013-05-28,NYSE (N),733990556,0,0,733990556,26544132445.219869,0.000000,0.000000,26544132445.219869,1957980,0,0,1957980
2013-05-28,NYSE Arca (P),301739836,239256124,144395251,685391211,10608712077.211243,15021020551.205567,5258428865.898714,30888161494.315524,1700882,521385,781194,3003461
2013-05-28,NASDAQ (Q),381723011,178813085,435801329,996337425,14032262859.134005,12293206806.019617,14282940282.908109,40608409948.061731,2289002,543106,1769072,4601180
2013-05-28,CBSX (W),12723501,5295748,7442741,25461990,379115409.070000,302428529.270000,182423946.790000,863967885.130000,86445,16348,46246,149039
2013-05-28,NASDAQ PSX (X),23502289,17939509,13518282,54960080,720498244.725000,1211934551.090000,378323931.280000,2310756727.095000,126780,44272,47156,218208
2013-05-28,BATS BYX (Y),59853838,25897516,29869418,115620772,1804745296.364001,1555126253.900900,866899852.707300,4226771402.972201,388767,102153,181929,672849
2013-05-28,BATS BZX (Z),247416175,141555086,154149582,543120843,7940309689.007497,9060626595.184198,4777262574.429095,21778198858.620790,1506863,434866,863440,2805169
2013-05-24,NYSE MKT (A),0,7242151,6261091,13503242,0.000000,48670932.000100,88974077.726000,137645009.726100,0,17315,21848,39163
2013-05-24,NASDAQ BX (B),59367315,27777462,34189633,121334410,1984165080.460801,1250960852.844800,1159175988.188398,4394301921.493999,384105,91105,208981,684191
2013-05-24,NSX (C),7685615,4258973,6696469,18641057,210544938.238200,211829271.351800,143955517.215000,566329726.805000,28329,8036,17873,54238
2013-05-24,NYSE (DN),68637431,15873056,35770768,120281255,2388500357.822213,922257133.034902,1094221283.369999,4404978774.227114,399843,61761,198746,660350
2013-05-24,NASDAQ (DQ),884038495,330455383,511256350,1725750228,29141651433.397476,18327897093.335507,13596524235.843321,61066072762.576304,2590928,482098,1315521,4388547
2013-05-24,EDGA (J),73895681,46288091,40779939,160963711,2205328150.626202,1900939611.556703,1110441649.959594,5216709412.142499,491772,130698,238674,861144
2013-05-24,EDGX (K),204520617,78160580,144430623,427111820,6939278013.682506,3892624110.361100,4417206940.591502,15249109064.635108,1029413,188868,604522,1822803
2013-05-24,CHX (M),17711469,4443980,4672600,26828049,721536423.586600,501369932.390000,171210799.270000,1394117155.246600,251,923,1493,2667
2013-05-24,NYSE (N),590742639,0,0,590742639,21411871262.982899,0.000000,0.000000,21411871262.982899,1620729,0,0,1620729
2013-05-24,NYSE Arca (P),249479557,240399487,127093645,616972689,9125039217.913610,12931938622.318491,4690204258.838820,26747182099.070921,1417277,423753,648585,2489615
2013-05-24,NASDAQ (Q),322731616,158596645,356674818,838003079,11840059471.226110,9765011947.877902,11549272965.599976,33154344384.703988,1925306,432223,1455702,3813231
2013-05-24,CBSX (W),10659881,4385567,6561353,21606801,324277522.270000,217816681.370000,159893866.167600,701988069.807600,73599,12706,42721,129026
2013-05-24,NASDAQ PSX (X),19597522,17324329,13435357,50357208,630501367.315000,1004672954.735000,352541024.200000,1987715346.250000,107985,37134,42982,188101
2013-05-24,BATS BYX (Y),49354953,25652473,25703880,100711306,1578216766.114999,1456138777.530200,775013995.685699,3809369539.330898,329485,92014,155402,576901
2013-05-24,BATS BZX (Z),203704214,134214595,136143154,474061963,6833414003.736504,7537242389.105295,4327166792.986614,18697823185.828413,1251226,359347,731923,2342496
2013-05-23,NYSE MKT (A),0,9156289,7215933,16372222,0.000000,64749686.335900,107012170.073000,171761856.408900,0,21241,23659,44900
2013-05-23,NASDAQ BX (B),84605795,43203469,45057104,172866368,2774266486.470000,2103756215.487898,1687782145.204398,6565804847.162296,548470,147783,276539,972792
2013-05-23,NSX (C),10218104,5913738,7398680,23530522,320616187.655400,306882267.226300,188556835.705500,816055290.587200,40797,9727,22913,73437
2013-05-23,NYSE (DN),92441647,23824053,46028342,162294042,3046437834.190029,1519115694.994204,1537425137.907392,6102978667.091625,543035,90778,261441,895254
2013-05-23,NASDAQ (DQ),1275024969,454149997,627059824,2356234790,39251602243.996187,22473558924.607064,17702385565.179254,79427546733.782505,3301308,714172,1605880,5621360
2013-05-23,EDGA (J),108774343,63641860,54503897,226920100,3264956779.071996,2812205433.853196,1632407797.422500,7709570010.347692,722160,210420,326769,1259349
2013-05-23,EDGX (K),297964923,118223001,174475787,590663711,9769315585.317507,5759678822.002389,5646671337.570535,21175665744.890431,1463187,314965,783316,2561468
2013-05-23,CHX (M),21209177,12038430,4090097,37337704,777025518.790000,851945887.240400,169577853.558800,1798549259.589200,392,2616,2456,5464
2013-05-23,NYSE (N),853143285,0,0,853143285,29112228024.192801,0.000000,0.000000,29112228024.192801,2153856,0,0,2153856
2013-05-23,NYSE Arca (P),363303516,304346560,164409071,832059147,12421847891.340606,18198053452.809620,6179135095.848179,36799036439.998405,2002710,655915,881636,3540261
2013-05-23,NASDAQ (Q),472214265,237418122,456619519,1166251906,16759824469.386811,16369456645.578347,14690893772.998817,47820174887.963975,2761333,716501,1945561,5423395
2013-05-23,CBSX (W),13349975,8013397,7995826,29359198,398049031.860000,463843885.410000,201910876.030000,1063803793.300000,86840,20159,48160,155159
2013-05-23,NASDAQ PSX (X),26799159,23793943,16550176,67143278,813449004.825000,1484762017.882000,505269916.695000,2803480939.402000,146121,57263,58269,261653
2013-05-23,BATS BYX (Y),73557130,37478041,35014618,146049789,2282726588.033300,2095773633.094899,1121987023.194601,5500487244.322800,487066,137397,224620,849083
2013-05-23,BATS BZX (Z),290936590,189359325,176651182,656947097,9311588748.695693,11201076218.965100,5459932274.346494,25972597242.007287,1782256,561091,955544,3298891
2013-05-22,NYSE MKT (A),0,9414845,6925034,16339879,0.000000,62984410.262000,115725278.211400,178709688.473400,0,22784,25758,48542
2013-05-22,NASDAQ BX (B),85437103,50820546,45808164,182065813,2737480973.159999,2450575245.360999,1612922044.126202,6800978262.647200,556543,165889,285904,1008336
2013-05-22,NSX (C),15159140,7625203,10914294,33698637,380380308.125800,313930529.159200,238619391.795000,932930229.080000,46495,12831,27343,86669
2013-05-22,NYSE (DN),99292052,28884104,49471613,177647769,3473305425.276394,2015696495.756209,1743213680.138299,7232215601.170902,563101,108082,267914,939097
2013-05-22,NASDAQ (DQ),1359469708,514162550,746394778,2620027036,40901005127.821434,28159927062.651991,22077877914.948462,91138810105.421887,3838822,806975,1933203,6579000
2013-05-22,EDGA (J),125142563,72422667,64147426,261712656,3587559587.795494,3322937035.983099,1862655359.283205,8773151983.061798,808075,234794,374239,1417108
2013-05-22,EDGX (K),370430136,148986971,225999901,745417008,12124588523.004917,7561429872.344925,7070438831.818019,26756457227.167861,1745671,401905,960595,3108171
2013-05-22,CHX (M),22707814,11714404,5418376,39840594,867370957.778500,1069072379.620000,263013215.840100,2199456553.238600,370,5706,3027,9103
2013-05-22,NYSE (N),854703846,0,0,854703846,30772863752.384453,0.000000,0.000000,30772863752.384453,2395449,0,0,2395449
2013-05-22,NYSE Arca (P),424889731,346933134,210215838,982038703,14778987542.384136,22377100695.807200,7835431074.392711,44991519312.584047,2366286,822205,1090411,4278902
2013-05-22,NASDAQ (Q),536517799,299501409,530647586,1366666794,19321235382.502862,19563644023.344071,17933357635.226416,56818237041.073349,3185236,917106,2292456,6394798
2013-05-22,CBSX (W),14585090,9073336,10103513,33761939,443583923.440000,571537806.200000,291264304.620000,1306386034.260000,97918,23343,58639,179900
2013-05-22,NASDAQ PSX (X),31992017,34212850,20848338,87053205,968968651.825000,2002587678.522399,688698561.790000,3660254892.137399,167501,71983,63464,302948
2013-05-22,BATS BYX (Y),80783253,44741871,39368220,164893344,2465080517.200000,2546081975.730299,1250184347.083798,6261346840.014097,525657,166557,242033,934247
2013-05-22,BATS BZX (Z),341234209,251098859,213714187,806047255,11158740049.893991,15656424006.525582,6943835447.977669,33758999504.397242,2114804,764639,1166103,4045546
2013-05-21,NYSE MKT (A),0,8440574,7081896,15522470,0.000000,54339910.712500,111003876.895000,165343787.607500,0,20499,24138,44637
2013-05-21,NASDAQ BX (B),66143012,25583053,36079104,127805169,2130946492.428402,1233720603.471000,1432545691.242901,4797212787.142303,438180,92026,229686,759892
2013-05-21,NSX (C),13427022,3969283,8356476,25752781,304321344.670100,115396490.682400,178591188.899700,598309024.252200,39322,7963,21895,69180
2013-05-21,NYSE (DN),85885276,16353004,50611922,152850202,2876854218.971191,941510923.309399,1470963481.972993,5289328624.253583,484088,65178,219801,769067
2013-05-21,NASDAQ (DQ),1215553594,301210051,656084243,2172847888,35691542405.808204,14014784257.463538,18512042828.180620,68218369491.452362,3330656,529849,1645335,5505840
2013-05-21,EDGA (J),96169735,36451864,48754297,181375896,2835482758.776398,1708689647.879298,1391669173.877701,5935841580.533397,625530,136129,279730,1041389
2013-05-21,EDGX (K),291808247,74479044,183504939,549792230,9212487481.880793,3530878750.341698,5758190428.548087,18501556660.770578,1342337,215005,729285,2286627
2013-05-21,CHX (M),16009677,7284319,4607040,27901036,710213118.628600,586146091.742600,267367194.100000,1563726404.471200,284,2033,2085,4402
2013-05-21,NYSE (N),687187705,0,0,687187705,23913248560.653354,0.000000,0.000000,23913248560.653354,1713811,0,0,1713811
2013-05-21,NYSE Arca (P),313940775,170016270,154779856,638736901,10487748259.542594,10377543267.807722,5544474772.969390,26409766300.319706,1680853,401286,785769,2867908
2013-05-21,NASDAQ (Q),381950180,128889161,412649802,923489143,13582433857.337345,7935013491.644107,13644559308.549588,35162006657.531040,2222539,401235,1661804,4285578
2013-05-21,CBSX (W),12368450,4406625,6308134,23083209,361473597.300000,261092348.620000,175564508.545000,798130454.465000,81909,11049,41803,134761
2013-05-21,NASDAQ PSX (X),23873194,13487846,13910485,51271525,706163692.745000,819080428.820000,363718475.095000,1888962596.660000,121747,34743,43796,200286
2013-05-21,BATS BYX (Y),62390600,23813447,31450747,117654794,1854019001.817999,1314042797.392900,949269743.288002,4117331542.498901,407578,93104,185378,686060
2013-05-21,BATS BZX (Z),253351366,111917990,163129603,528398959,7992843303.878400,6612332748.383302,4915625064.695992,19520801116.957694,1542683,363552,854484,2760719
2013-05-20,NYSE MKT (A),0,9497901,7086283,16584184,0.000000,69502958.455700,126305856.628000,195808815.083700,0,21643,22736,44379
2013-05-20,NASDAQ BX (B),62083903,25855847,34822422,122762172,1957910143.825001,1226428212.041600,1299246039.451198,4483584395.317799,404408,96381,226844,727633
2013-05-20,NSX (C),11742251,4318130,7334936,23395317,258039395.483700,147890899.040100,161906228.902900,567836523.426700,34106,7387,19148,60641
2013-05-20,NYSE (DN),84497838,18682823,45296282,148476943,2713248840.095889,1003901262.053600,1481792483.481001,5198942585.630490,469350,75414,236994,781758
2013-05-20,NASDAQ (DQ),1117398709,321308109,642743926,2081450744,31668747239.553386,14966430582.156189,18518509896.268611,65153687717.978186,3264708,576351,1734585,5575644
2013-05-20,EDGA (J),91237145,36806310,46178697,174222152,2557892989.754397,1663441516.069199,1396683530.742097,5618018036.565693,584203,135509,283030,1002742
2013-05-20,EDGX (K),264503171,78696129,177481853,520681153,8508609567.579988,3598586061.981297,5654425778.287701,17761621407.848986,1225601,226540,711839,2163980
2013-05-20,CHX (M),12982111,7003414,9406019,29391544,388304770.591500,628854766.227400,934655957.222200,1951815494.041100,317,1956,1682,3955
2013-05-20,NYSE (N),653192696,0,0,653192696,22951464249.215062,0.000000,0.000000,22951464249.215062,1685832,0,0,1685832
2013-05-20,NYSE Arca (P),288613827,179150910,151607543,619372280,9724257541.551611,10294559711.881034,5460752696.796787,25479569950.229432,1573919,416838,797173,2787930
2013-05-20,NASDAQ (Q),366733338,136468876,416353484,919555698,12988947127.422183,8118624489.291504,13833509834.298414,34941081451.012101,2154774,436271,1733392,4324437
2013-05-20,CBSX (W),11576718,4056745,6874293,22507756,338416909.100000,237504446.400000,189000239.510000,764921595.010000,76966,11719,43852,132537
2013-05-20,NASDAQ PSX (X),21349988,14391766,14206550,49948304,650466582.495000,799017378.290000,403657027.080000,1853140987.865000,114999,35834,44315,195148
2013-05-20,BATS BYX (Y),57250707,24286716,28638631,110176054,1658626541.621201,1290870077.976699,844167399.164799,3793664018.762699,372398,99464,179944,651806
2013-05-20,BATS BZX (Z),232585426,112756950,157840222,503182598,7402173540.267597,6643307836.153602,4946142347.528000,18991623723.949199,1437533,375910,848657,2662100
2013-05-17,NYSE MKT (A),0,10914157,6908007,17822164,0.000000,76683474.147700,118219605.292000,194903079.439700,0,21216,18270,39486
2013-05-17,NASDAQ BX (B),66442079,28968599,40766368,136177046,2101841270.329002,1413380702.617799,1545630532.783499,5060852505.730300,433097,95822,254728,783647
2013-05-17,NSX (C),10357161,5344382,6312190,22013733,250101693.062600,235633767.778400,151004810.000200,636740270.841200,32612,10363,18026,61001
2013-05-17,NYSE (DN),86246213,19151997,44499751,149897961,2915732310.283189,1021916033.051697,1461539861.780080,5399188205.114966,476182,74256,228435,778873
2013-05-17,NASDAQ (DQ),1080944946,350047941,625686753,2056679640,32218087134.311522,17959970357.439897,18016560211.654849,68194617703.406268,3107978,575904,1647169,5331051
2013-05-17,EDGA (J),95382012,41921172,50362826,187666010,2767327095.622698,1880648178.098604,1483874198.744698,6131849472.466000,602522,135249,298394,1036165
2013-05-17,EDGX (K),262003069,79013269,170369810,511386148,9243451519.908101,3850860550.438997,5594468486.178228,18688780556.525326,1287378,213252,692356,2192986
2013-05-17,CHX (M),8116624,5274556,4500162,17891342,307816295.136500,447517406.670000,197356079.080300,952689780.886800,223,2448,1714,4385
2013-05-17,NYSE (N),848043173,0,0,848043173,31911654005.037869,0.000000,0.000000,31911654005.037869,1795346,0,0,1795346
2013-05-17,NYSE Arca (P),293511581,194276057,153452562,641240200,10529243166.396496,12482348524.703791,6048600195.866793,29060191886.967080,1626304,428750,806796,2861850
2013-05-17,NASDAQ (Q),363402047,150418146,513701303,1027521496,13280625593.979651,9670656668.797009,17527785905.976394,40479068168.753054,2137415,454093,1730452,4321960
2013-05-17,CBSX (W),13153659,4227137,10278013,27658809,398574475.730000,239894462.446000,329647908.480000,968116846.656000,88511,12063,66036,166610
2013-05-17,NASDAQ PSX (X),14660104,17059904,12273327,43993335,340592357.025000,998817177.778000,355430423.365000,1694839958.168000,56954,36068,38569,131591
2013-05-17,BATS BYX (Y),60451266,25170782,31030304,116652352,1825506641.446800,1391248855.046400,926494957.004800,4143250453.498000,395994,94457,190691,681142
2013-05-17,BATS BZX (Z),246811233,125106966,158830568,530748767,8274614152.958011,7732343487.832397,5283041955.748403,21289999596.538811,1521240,384400,875601,2781241
2013-05-16,NYSE MKT (A),0,8399927,9024769,17424696,0.000000,57162519.947500,151552942.668000,208715462.615500,0,20323,23701,44024
2013-05-16,NASDAQ BX (B),75402153,26322047,45082571,146806771,2352762338.310001,1282211574.019700,1644366467.359002,5279340379.688703,504183,91889,291143,887215
2013-05-16,NSX (C),11077139,4644393,7814324,23535856,256189557.477600,165116540.250600,161054965.596000,582361063.324200,35597,8888,19955,64440
2013-05-16,NYSE (DN),92292259,18600240,55348542,166241041,3071818611.923990,1062035963.999400,1985248377.616889,6119102953.540279,530463,72827,280962,884252
2013-05-16,NASDAQ (DQ),1179773747,327274981,732072336,2239121064,33122201468.215796,16355809621.476564,22765359620.476326,72243370710.168686,3404135,523215,1861016,5788366
2013-05-16,EDGA (J),97830741,39129315,54740551,191700607,2762732597.874204,1765448276.506001,1700997719.205501,6229178593.585706,630388,133830,326639,1090857
2013-05-16,EDGX (K),283468580,77958697,187900603,549327880,8960962137.330691,3761413458.042897,6397055002.162519,19119430597.536107,1390230,229670,768479,2388379
2013-05-16,CHX (M),11207855,8479242,8515876,28202973,423572902.621900,733824523.090000,244309089.979900,1401706515.691800,251,2079,2364,4694
2013-05-16,NYSE (N),684387402,0,0,684387402,23503740654.877311,0.000000,0.000000,23503740654.877311,1844297,0,0,1844297
2013-05-16,NYSE Arca (P),317084137,184124347,185722233,686930717,10640507242.455750,11888527422.648511,7149042733.679376,29678077398.783637,1720544,427353,926788,3074685
2013-05-16,NASDAQ (Q),405095199,138382441,440583180,984060820,14159009233.821724,8930412945.659592,15549159151.197916,38638581330.679232,2321362,434984,1807232,4563578
2013-05-16,CBSX (W),15963564,5532399,7846281,29342244,447460700.020000,328649992.840000,209068963.090000,985179655.950000,101692,11690,49234,162616
2013-05-16,NASDAQ PSX (X),16811458,15700060,14024039,46535557,386085838.625000,971006565.535000,379846701.590000,1736939105.750000,65132,38752,46461,150345
2013-05-16,BATS BYX (Y),62607644,23612018,32817445,119037107,1928926162.251999,1349751212.782399,972858008.474400,4251535383.508798,418186,92162,205495,715843
2013-05-16,BATS BZX (Z),265159491,118514288,180213953,563887732,8419253116.416989,7255298093.752503,5803288223.537091,21477839433.706583,1615736,372619,963190,2951545
2013-05-15,NYSE MKT (A),0,11226748,8746452,19973200,0.000000,70475749.432100,125779193.456500,196254942.888600,0,21934,25077,47011
2013-05-15,NASDAQ BX (B),77533043,28495855,42534398,148563296,2398766413.360003,1432579231.314100,1677942733.611298,5509288378.285401,501760,97301,278678,877739
2013-05-15,NSX (C),12350251,5407748,7568583,25326582,293073927.006300,188324878.856800,164809712.740100,646208518.603200,38744,10532,20924,70200
2013-05-15,NYSE (DN),92315069,19845992,48135277,160296338,3017447246.689892,1011684372.530701,1733971830.261100,5763103449.481693,517025,75395,251550,843970
2013-05-15,NASDAQ (DQ),1240681069,376143010,694726128,2311550207,36040456568.276126,18207348771.129289,21558196864.341891,75806002203.747306,3545618,603469,1751274,5900361
2013-05-15,EDGA (J),102602352,43055065,53273441,198930858,2828338818.643197,1840710596.085800,1558532847.751999,6227582262.480996,655808,139762,309416,1104986
2013-05-15,EDGX (K),291144080,87556900,183612746,562313726,9462584285.309585,3970842855.254198,6350665713.509345,19784092854.073128,1373889,237539,730241,2341669
2013-05-15,CHX (M),11711733,5395126,4831717,21938576,353699646.141100,438610814.610000,239212299.465000,1031522760.216100,388,2386,2022,4796
2013-05-15,NYSE (N),742255830,0,0,742255830,25726130928.064421,0.000000,0.000000,25726130928.064421,1875483,0,0,1875483
2013-05-15,NYSE Arca (P),323474306,218422335,168032893,709929534,10927265244.002786,13216581253.169018,6656912430.665771,30800758927.837575,1740352,450370,849772,3040494
2013-05-15,NASDAQ (Q),404381124,150547599,417681622,972610345,14500499074.792101,9711762335.886177,14864882147.370131,39077143558.048409,2323988,449530,1674972,4448490
2013-05-15,CBSX (W),21980154,5134008,7984111,35098273,760217581.430000,286794357.680000,194613498.950000,1241625438.060000,160878,13193,44886,218957
2013-05-15,NASDAQ PSX (X),17611024,17385083,14870053,49866160,429576878.960300,1086929142.420000,342980513.650000,1859486535.030300,68737,38258,42399,149394
2013-05-15,BATS BYX (Y),65965015,26109986,32782137,124857138,1960702405.160001,1419816609.732100,973017923.308500,4353536938.200601,432886,99279,203863,736028
2013-05-15,BATS BZX (Z),265968230,122709086,159940618,548617934,8349051425.805790,7477742656.686509,5136212574.525029,20963006657.017328,1582806,387874,870338,2841018
2013-05-14,NYSE MKT (A),0,8578637,8160752,16739389,0.000000,58859481.427600,131514335.219000,190373816.646600,0,17588,26840,44428
2013-05-14,NASDAQ BX (B),72353870,23807242,40909375,137070487,2277136415.315001,1275940842.935800,1491915462.475299,5044992720.726100,447534,81533,250222,779289
2013-05-14,NSX (C),10310001,4733478,6885148,21928627,270478023.661800,160074525.601200,158419901.021500,588972450.284500,34718,8022,18892,61632
2013-05-14,NYSE (DN),98996250,18093405,52655999,169745654,3311811011.037299,998623551.284000,1902188813.780792,6212623376.102091,552498,70068,279278,901844
2013-05-14,NASDAQ (DQ),1201469664,340967291,690366447,2232803402,35249262619.923463,17327656003.063159,21367035603.230292,73943954226.216914,3267524,521251,1735574,5524349
2013-05-14,EDGA (J),101060709,37656869,53544492,192262070,2825161983.650899,1657515101.618701,1570889083.438094,6053566168.707694,625639,121738,311970,1059347
2013-05-14,EDGX (K),282925155,69580366,179328375,531833896,9608497063.848246,3284166108.194290,6225882671.667716,19118545843.710252,1347309,192376,736776,2276461
2013-05-14,CHX (M),8960012,7249376,5883622,22093010,365170853.456200,455462135.602500,344685623.885000,1165318612.943700,329,1832,1802,3963
2013-05-14,NYSE (N),700153150,0,0,700153150,24608782242.052087,0.000000,0.000000,24608782242.052087,1722973,0,0,1722973
2013-05-14,NYSE Arca (P),288057501,173756565,158476502,620290568,10004875069.420772,11126403141.484190,6142346304.020822,27273624514.925784,1599774,380283,851992,2832049
2013-05-14,NASDAQ (Q),373575307,119497843,409236397,902309547,13349329362.252329,8024548770.154884,14081163323.387195,35455041455.794408,2066337,368932,1670702,4105971
2013-05-14,CBSX (W),14543351,4648596,5922830,25114777,419157264.260000,264815605.600000,161204481.200000,845177351.060000,85446,10804,37215,133465
2013-05-14,NASDAQ PSX (X),15780910,14111680,14164717,44057307,396888926.190000,905317539.600000,373680971.955000,1675887437.745000,62077,33227,43105,138409
2013-05-14,BATS BYX (Y),60785942,22408703,32238045,115432690,1880774654.180500,1210339986.722700,948758337.930502,4039872978.833702,392736,82170,196162,671068
2013-05-14,BATS BZX (Z),240556110,97059906,163239776,500855792,7580163127.687202,6220240682.427998,5174271866.297097,18974675676.412297,1406687,306554,888980,2602221
2013-05-13,NYSE MKT (A),0,7899538,7647044,15546582,0.000000,59920795.606100,116819772.675900,176740568.282000,0,17812,26114,43926
2013-05-13,NASDAQ BX (B),66769953,20060433,38312812,125143198,2106803671.024999,997225488.501100,1461361481.869299,4565390641.395398,438560,77084,249130,764774
2013-05-13,NSX (C),9281155,4721743,6782766,20785664,219159565.701900,194301731.219700,150455623.138900,563916920.060500,30857,7350,19307,57514
2013-05-13,NYSE (DN),72919497,14361001,39852312,127132810,2283652992.953796,766927450.502200,1325063491.717205,4375643935.173201,399194,57513,211380,668087
2013-05-13,NASDAQ (DQ),981767296,261802027,605166010,1848735333,28906876792.370860,12275452179.625803,17183465097.885810,58365794069.882473,2760395,455065,1554859,4770319
2013-05-13,EDGA (J),85826755,33372070,46397530,165596355,2235263733.343599,1336467936.624801,1326345923.151698,4898077593.120098,536252,100810,275879,912941
2013-05-13,EDGX (K),238362918,56450332,164373441,459186691,7533825971.199107,2585143621.246701,5238342643.551699,15357312235.997507,1124395,160939,656063,1941397
2013-05-13,CHX (M),8453713,3777851,2904016,15135580,328975563.822400,284437342.707800,329207372.410000,942620278.940200,911,1189,1488,3588
2013-05-13,NYSE (N),593725314,0,0,593725314,20417207962.184315,0.000000,0.000000,20417207962.184315,1544316,0,0,1544316
2013-05-13,NYSE Arca (P),246099762,157909658,145590304,549599724,8093978366.806979,8990291521.086393,5341526513.226000,22425796401.119372,1383020,331864,789104,2503988
2013-05-13,NASDAQ (Q),328641482,104544745,367047517,800233744,11363059782.475706,6635825637.669001,12357551361.154765,30356436781.299472,1851531,316438,1543521,3711490
2013-05-13,CBSX (W),12399007,4735760,5685333,22820100,333214100.640000,264939247.420000,144602787.959000,742756136.019000,72662,8795,31556,113013
2013-05-13,NASDAQ PSX (X),13383668,9856903,11407557,34648128,309957199.515000,584115309.660000,301752798.540000,1195825307.715000,53537,24734,37872,116143
2013-05-13,BATS BYX (Y),52202250,18594489,27863857,98660596,1528024761.479999,969464556.827200,828848283.454802,3326337601.762001,342572,72749,174197,589518
2013-05-13,BATS BZX (Z),201322936,81662839,147020529,430006304,6075323597.873396,4942109913.204595,4453756626.763091,15471190137.841082,1213698,263380,822361,2299439
2013-05-10,NYSE MKT (A),0,11789461,6660609,18450070,0.000000,99258288.558100,113165225.229400,212423513.787500,0,20275,21801,42076
2013-05-10,NASDAQ BX (B),69145065,26967864,38586726,134699655,2223013499.664999,1330958346.631400,1384086876.097996,4938058722.394395,459827,97979,246953,804759
2013-05-10,NSX (C),9069363,4172075,6844281,20085719,226268127.583300,149968244.065300,148843346.258600,525079717.907200,32187,7182,19122,58491
2013-05-10,NYSE (DN),80655582,16189480,46102004,142947066,2769675189.544009,892294740.880400,1531007891.193293,5192977821.617702,468805,60679,230799,760283
2013-05-10,NASDAQ (DQ),1043249998,304676121,622342232,1970268351,31975386858.481677,14766738674.680432,17525513690.746778,64267639223.908887,2925563,493086,1599360,5018009
2013-05-10,EDGA (J),90229670,39743486,49030533,179003689,2532181536.131703,1766742193.831002,1405496428.335304,5704420158.298009,587696,127493,295544,1010733
2013-05-10,EDGX (K),253544352,76418867,165798460,495761679,8400404970.229918,3671288262.959492,5548352492.115275,17620045725.304685,1270159,215670,692102,2177931
2013-05-10,CHX (M),12405603,8690005,6104468,27200076,385808094.920000,620717747.622300,312678434.310000,1319204276.852300,240,1874,1391,3505
2013-05-10,NYSE (N),630520557,0,0,630520557,21949311120.839392,0.000000,0.000000,21949311120.839392,1700969,0,0,1700969
2013-05-10,NYSE Arca (P),265940570,191068262,166935841,623944673,9111070290.381997,11135463158.643208,6035384566.981307,26281918016.006512,1513072,424513,823513,2761098
2013-05-10,NASDAQ (Q),339044774,136434226,383673604,859152604,11882381568.759012,8704387590.126497,13022319510.599056,33609088669.484565,1956939,422782,1600903,3980624
2013-05-10,CBSX (W),12629829,4455034,5509045,22593908,372658838.470000,213800700.470000,146977268.160000,733436807.100000,79310,11129,34156,124595
2013-05-10,NASDAQ PSX (X),13217219,14898827,13914446,42030492,337482568.540000,859513843.041200,360948365.450000,1557944777.031200,59615,38139,41403,139157
2013-05-10,BATS BYX (Y),58069938,23573149,28787012,110430099,1741746058.903000,1251194132.271900,843343214.345000,3836283405.519900,380994,90411,180723,652128
2013-05-10,BATS BZX (Z),212069534,104707388,150762021,467538943,6637554771.836599,6188563463.805700,4737891083.516401,17564009319.158700,1306313,330210,816376,2452899
2013-05-09,NYSE MKT (A),0,7655820,6867499,14523319,0.000000,54532671.003700,103408854.607200,157941525.610900,0,19564,24308,43872
2013-05-09,NASDAQ BX (B),78709283,28820148,43964994,151494425,2464204946.444999,1354799306.112500,1785602786.018099,5604607038.575598,524105,96857,293677,914639
2013-05-09,NSX (C),10158186,4096491,7838862,22093539,256785171.772300,161141308.807000,172135154.400200,590061634.979500,36607,7585,22863,67055
2013-05-09,NYSE (DN),90005237,17145665,46772312,153923214,2975921142.064283,971132420.043900,1533731742.033605,5480785304.141788,516750,69119,250514,836383
2013-05-09,NASDAQ (DQ),1208832825,344208034,690357259,2243398118,37244851395.299159,15128847347.656775,20647907169.574602,73021605912.530536,3227335,502070,1725159,5454564
2013-05-09,EDGA (J),103040064,52007720,51711519,206759303,2822003662.455200,1967926906.062599,1497119830.169801,6287050398.687600,644805,140900,313601,1099306
2013-05-09,EDGX (K),278558766,82759938,188583455,549902159,9058092571.155801,3706854727.325195,5998404563.306691,18763351861.787687,1389443,214553,768623,2372619
2013-05-09,CHX (M),10076643,5322271,6470530,21869444,364782213.074000,426570420.220000,240638972.313200,1031991605.607200,538,1371,2021,3930
2013-05-09,NYSE (N),670100470,0,0,670100470,22583975060.820002,0.000000,0.000000,22583975060.820002,1828299,0,0,1828299
2013-05-09,NYSE Arca (P),304901801,185077710,172206414,662185925,10312256560.392482,10688305054.426995,6425066811.532823,27425628426.352300,1712110,415965,914090,3042165
2013-05-09,NASDAQ (Q),407827699,151731625,400971640,960530964,14287867243.854364,9322993689.147790,13570715483.202532,37181576416.204686,2317545,434023,1765360,4516928
2013-05-09,CBSX (W),11807236,3719416,6355009,21881661,349152765.160000,180034750.040000,158323297.746600,687510812.946600,74479,10526,37511,122516
2013-05-09,NASDAQ PSX (X),15767153,14854946,12759360,43381459,413558285.215000,811744912.545000,360603909.205000,1585907106.965000,73542,35589,46670,155801
2013-05-09,BATS BYX (Y),63771279,25143258,32282183,121196720,1839259308.345000,1242309676.374999,920215007.289499,4001783992.009498,422039,94894,208947,725880
2013-05-09,BATS BZX (Z),246735716,116019212,159634667,522389595,7543495726.931797,6092750200.685099,4966040064.779295,18602285992.396191,1496911,337698,888386,2722995
2013-05-08,NYSE MKT (A),0,8358140,7031338,15389478,0.000000,63791162.272400,115016998.131300,178808160.403700,0,21191,25240,46431
2013-05-08,NASDAQ BX (B),82480188,26737163,43754310,152971661,2501302156.511299,1348580871.599699,1421860160.101799,5271743188.212797,549017,93365,289093,931475
2013-05-08,NSX (C),11066107,3429872,7905962,22401941,268032833.686900,126898428.227200,137403758.607000,532335020.521100,38346,7131,23608,69085
2013-05-08,NYSE (DN),96736181,16197156,46200028,159133365,3166697743.941376,952813350.071701,1451578732.804704,5571089826.817781,560666,66967,254470,882103
2013-05-08,NASDAQ (DQ),1189970308,338537990,657550423,2186058721,36156482271.433835,14731994589.379646,18726045215.244496,69614522076.057977,3495588,526548,1708886,5731022
2013-05-08,EDGA (J),101866792,39783897,50725555,192376244,2729681010.836106,1768658602.375898,1419202320.328700,5917541933.540704,635478,125406,309231,1070115
2013-05-08,EDGX (K),296814330,69788989,180083970,546687289,9738052851.041787,3420547427.779995,5814078041.638858,18972678320.460640,1439816,190246,764503,2394565
2013-05-08,CHX (M),7173146,8459565,6763978,22396689,263721636.349600,664368134.075200,1099405761.967200,2027495532.392000,491,1084,2341,3916
2013-05-08,NYSE (N),730018658,0,0,730018658,24938920829.511092,0.000000,0.000000,24938920829.511092,1837900,0,0,1837900
2013-05-08,NYSE Arca (P),298916348,175012473,162015385,635944206,10163293335.878396,10701785625.428430,6041804398.397156,26906883359.703982,1659296,362945,872046,2894287
2013-05-08,NASDAQ (Q),409079338,119385790,398135733,926600861,14348316372.466850,7797118569.131300,13523928445.961484,35669363387.559634,2305989,353236,1708567,4367792
2013-05-08,CBSX (W),11991330,3838524,5872170,21702024,357522554.490000,200463903.130000,156939117.700000,714925575.320000,79928,10820,38538,129286
2013-05-08,NASDAQ PSX (X),16608852,13257467,12193210,42059529,457193431.685000,829394960.690000,349821297.245000,1636409689.620000,79611,36123,46190,161924
2013-05-08,BATS BYX (Y),66936264,22733424,31430398,121100086,2009626614.936098,1201109305.976900,885429902.702300,4096165823.615298,450681,84774,205833,741288
2013-05-08,BATS BZX (Z),240566719,95228614,147726296,483521629,7533392431.318190,5833475136.491593,4681648815.908894,18048516383.718677,1465978,295404,837795,2599177
2013-05-07,NYSE MKT (A),0,7870584,6683678,14554262,0.000000,58430680.002000,96746818.694500,155177498.696500,0,17915,18814,36729
2013-05-07,NASDAQ BX (B),77125889,24281946,41747847,143155682,2324983416.150000,1205715025.233800,1582858542.661497,5113556984.045297,490368,86464,271901,848733
2013-05-07,NSX (C),10469414,3195291,7052894,20717599,257784126.163100,134043060.302300,160108837.423300,551936023.888700,32628,6161,20295,59084
2013-05-07,NYSE (DN),93462049,17941920,48072076,159476045,3028973090.147966,950795770.838601,1598832950.933318,5578601811.919885,529416,70150,267986,867552
2013-05-07,NASDAQ (DQ),1125262897,288513292,635811434,2049587623,33945199724.403184,13833223894.116357,18775129915.777886,66553553534.297427,3268492,517132,1702008,5487632
2013-05-07,EDGA (J),98074962,37481087,48658841,184214890,2626144483.098201,1702866883.992799,1443259910.029997,5772271277.120997,598226,125707,296208,1020141
2013-05-07,EDGX (K),261277117,67213402,166394985,494885504,8636529772.780624,3453466681.575795,5585291951.615489,17675288405.971908,1252244,198040,714401,2164685
2013-05-07,CHX (M),12831746,5909226,4583138,23324110,531503835.175300,401024041.240000,325665704.971000,1258193581.386300,450,1424,2318,4192
2013-05-07,NYSE (N),636583643,0,0,636583643,21629296427.554554,0.000000,0.000000,21629296427.554554,1639389,0,0,1639389
2013-05-07,NYSE Arca (P),291141894,161725088,156829628,609696610,9948085932.412616,9641902775.280886,5989097758.559884,25579086466.253386,1627760,382826,861321,2871907
2013-05-07,NASDAQ (Q),380688764,122787194,391173795,894649753,13498146400.852755,8070496366.172490,13065273751.735740,34633916518.760985,2175419,379669,1713310,4268398
2013-05-07,CBSX (W),13404378,4933522,6446175,24784075,388906920.408000,280993796.626000,169057928.890000,838958645.924000,85848,10134,39850,135832
2013-05-07,NASDAQ PSX (X),15960361,14697329,13284737,43942427,463811657.000000,897253049.680000,384817345.580000,1745882052.260000,81476,38682,49415,169573
2013-05-07,BATS BYX (Y),63591463,23210777,31073297,117875537,1933009336.427001,1173529925.895400,921955788.574301,4028495050.896702,430259,89629,204215,724103
2013-05-07,BATS BZX (Z),232770580,92610919,154388778,479770277,7101983349.608012,5504758505.716101,4715988978.098681,17322730833.422794,1395177,307157,853777,2556111
2013-05-06,NYSE MKT (A),0,7734087,5871111,13605198,0.000000,56514538.261300,96803502.653000,153318040.914300,0,15980,20750,36730
2013-05-06,NASDAQ BX (B),74436774,20734297,36609339,131780410,2119853950.618101,989623039.584000,1223790105.374701,4333267095.576802,469013,75101,237564,781678
2013-05-06,NSX (C),12199000,3118066,5990383,21307449,261349326.996100,110340867.318200,143377286.926600,515067481.240900,34116,6295,19795,60206
2013-05-06,NYSE (DN),79389892,13631907,39473953,132495752,2592475684.310398,713244679.098399,1332717031.932100,4638437395.340897,463446,55938,209416,728800
2013-05-06,NASDAQ (DQ),1030279140,238902508,566182195,1835363843,30067432211.266556,10283652800.649729,17221872309.908109,57572957321.824394,3065388,450741,1517601,5033730
2013-05-06,EDGA (J),91320657,29067673,40758493,161146823,2400484999.856299,1295859497.402199,1241914925.014700,4938259422.273198,554964,99424,249189,903577
2013-05-06,EDGX (K),246804187,56140402,143482841,446427430,7834068758.972401,2588855374.557506,4772940914.716176,15195865048.246083,1149261,154166,613008,1916435
2013-05-06,CHX (M),9418073,4552758,4561226,18532057,453379039.391000,332755293.700400,631191245.079900,1417325578.171300,691,746,1949,3386
2013-05-06,NYSE (N),619507407,0,0,619507407,21209636049.693623,0.000000,0.000000,21209636049.693623,1628322,0,0,1628322
2013-05-06,NYSE Arca (P),261524532,143822255,133367048,538713835,8713782878.297000,8634195606.842098,5367692995.922420,22715671481.061518,1481832,321452,744611,2547895
2013-05-06,NASDAQ (Q),340516185,103835823,344841564,789193572,11997589642.022309,6375194441.206002,12424870610.366715,30797654693.595026,1981693,319766,1518007,3819466
2013-05-06,CBSX (W),14100481,3618152,7091060,24809693,383526639.570000,188765577.860000,197121108.650000,769413326.080000,85762,9692,39026,134480
2013-05-06,NASDAQ PSX (X),13347430,12030312,10815004,36192746,344637683.105000,668076863.860000,292426558.945600,1305141105.910600,57377,27331,38238,122946
2013-05-06,BATS BYX (Y),60281934,18475177,26964131,105721242,1762722341.741999,943586226.552600,748043435.327300,3454352003.621899,401573,73784,177473,652830
2013-05-06,BATS BZX (Z),209614038,80097687,134843059,424554784,6396811792.770505,4479426650.298501,4292464345.575688,15168702788.644694,1263724,258670,750979,2273373
2013-05-03,NYSE MKT (A),0,7996637,7452203,15448840,0.000000,57759846.600500,121111674.887900,178871521.488400,0,19320,23416,42736
2013-05-03,NASDAQ BX (B),80635806,27213891,40570542,148420239,2464699486.089999,1397143452.232001,1455709315.244299,5317552253.566299,530255,97165,267226,894646
2013-05-03,NSX (C),12046508,4173118,8375484,24595110,291327308.854100,214189743.260700,151302565.731400,656819617.846200,38501,6488,21577,66566
2013-05-03,NYSE (DN),106606752,21425494,49769464,177801710,3429657600.574565,1347723766.942699,1529706852.744490,6307088220.261754,594193,84818,279774,958785
2013-05-03,NASDAQ (DQ),1212162041,350272496,649530330,2211964867,36755674989.469750,18055813003.252382,18831273706.817727,73642761699.539859,3579956,592064,1763685,5935705
2013-05-03,EDGA (J),106733072,42048020,49337463,198118555,2966848409.075096,2017567292.048499,1415029513.877395,6399445215.000990,680251,137348,306489,1124088
2013-05-03,EDGX (K),281539422,79015179,167390205,527944806,9378842609.061895,4017451378.550306,5261809203.129182,18658103190.741383,1350910,209359,713710,2273979
2013-05-03,CHX (M),15935748,7415521,4816967,28168236,538477948.624500,645605226.204000,176812592.656000,1360895767.484500,693,2130,1668,4491
2013-05-03,NYSE (N),716369894,0,0,716369894,25010286928.680431,0.000000,0.000000,25010286928.680431,1890601,0,0,1890601
2013-05-03,NYSE Arca (P),317160219,217803084,158316034,693279337,11199393304.928299,14173965448.855434,6001454058.708417,31374812812.492150,1794490,492435,878863,3165788
2013-05-03,NASDAQ (Q),410685585,154595170,408461966,973742721,14831174514.270438,10118645500.969711,13594485384.487941,38544305399.728090,2435037,469097,1779543,4683677
2013-05-03,CBSX (W),13598220,4208711,6145826,23952757,401808631.230000,241486567.110000,150990501.480000,794285699.820000,89519,12292,39884,141695
2013-05-03,NASDAQ PSX (X),16178568,18179754,13753706,48112028,439122379.620000,1100629358.915000,390545869.722500,1930297608.257500,76701,40559,49224,166484
2013-05-03,BATS BYX (Y),67821922,25806162,30981668,124609752,2100407988.330000,1442501158.400001,914953984.992500,4457863131.722501,475543,100834,207461,783838
2013-05-03,BATS BZX (Z),246728930,129589494,151293570,527611994,7747917599.505795,7957167772.537704,4881571743.918977,20586657115.962476,1516835,386465,882342,2785642
2013-05-02,NYSE MKT (A),0,8069698,7718997,15788695,0.000000,54561701.506200,129814346.819800,184376048.326000,0,18676,25005,43681
2013-05-02,NASDAQ BX (B),77379240,23550006,41922290,142851536,2498460773.579497,1116459781.370500,1394594431.750695,5009514986.700692,518483,85224,272762,876469
2013-05-02,NSX (C),9553063,3615250,6914636,20082949,246140105.632300,163111271.327100,157992847.121601,567244224.081001,35279,6548,21881,63708
2013-05-02,NYSE (DN),99674422,17553645,51267762,168495829,3298689476.378196,977477283.897999,1572284959.319983,5848451719.596178,562707,67862,272705,903274
2013-05-02,NASDAQ (DQ),1131049382,289003086,646777250,2066829718,34099765300.018656,13469521281.315145,18427492524.075569,65996779105.409370,3473780,496968,1729869,5700617
2013-05-02,EDGA (J),104821862,39135678,52817198,196774738,2994141356.691601,1622429705.132398,1490116534.890094,6106687596.714093,693804,124166,328503,1146473
2013-05-02,EDGX (K),279531949,70655771,168553329,518741049,9536552710.460284,3103622757.243407,5548148835.066747,18188324302.770438,1413480,191789,716900,2322169
2013-05-02,CHX (M),8535296,4508410,3595689,16639395,306152239.927400,455945097.615000,473429535.751500,1235526873.293900,256,1770,1305,3331
2013-05-02,NYSE (N),676645710,0,0,676645710,22637785806.411939,0.000000,0.000000,22637785806.411939,1904570,0,0,1904570
2013-05-02,NYSE Arca (P),308195525,178475560,165232040,651903125,10425833523.223207,10280696517.991711,5927436961.340593,26633967002.555511,1755232,413884,880181,3049297
2013-05-02,NASDAQ (Q),395870052,137875071,409625453,943370576,14196851530.293591,8272125750.891993,13319973373.708528,35788950654.894112,2379117,432860,1766266,4578243
2013-05-02,CBSX (W),13917133,5468229,7475760,26861122,416951439.450000,311596401.080000,170205175.210000,898753015.740000,89971,10974,42009,142954
2013-05-02,NASDAQ PSX (X),13434377,13191219,12400478,39026074,317450870.035000,703561394.250000,310107072.862000,1331119337.147000,57489,30524,35733,123746
2013-05-02,BATS BYX (Y),64126436,22372761,32773367,119272564,2014164263.180002,1149679793.890000,952618310.638500,4116462367.708502,452652,90762,218084,761498
2013-05-02,BATS BZX (Z),232798193,106241677,151534891,490574761,7287842042.887798,6118099834.652207,4812403160.662702,18218345038.202707,1468349,344050,860421,2672820
2013-05-01,NYSE MKT (A),0,13404316,7773357,21177673,0.000000,110799036.263500,120810498.086900,231609534.350400,0,22866,27145,50011
2013-05-01,NASDAQ BX (B),75820043,30195746,44940912,150956701,2343327057.709997,1603516461.648202,1448566297.036097,5395409816.394296,528198,119375,294968,942541
2013-05-01,NSX (C),9893071,4494331,7704549,22091951,266590529.509300,172126872.826000,156400805.172500,595118207.507800,38064,8504,23351,69919
2013-05-01,NYSE (DN),101221723,21000339,53201631,175423693,3633833953.796695,1282281827.679201,1657148029.745217,6573263811.221113,561202,82935,280520,924657
2013-05-01,NASDAQ (DQ),1127966242,420578739,646578970,2195123951,35115522469.952631,24186288619.440194,18352782078.237236,77654593167.630061,3415151,585997,1732499,5733647
2013-05-01,EDGA (J),109733812,43529189,61932852,215195853,3148783062.137998,2097406483.520600,1685170933.143804,6931360478.802402,735503,154743,365492,1255738
2013-05-01,EDGX (K),267995290,107593196,173301895,548890381,8936736039.469618,5478062218.865298,5307247783.188905,19722046041.523821,1441238,295238,785728,2522204
2013-05-01,CHX (M),12340377,11930310,3373680,27644367,494549711.909000,996788194.446000,124251597.241800,1615589503.596800,319,2386,1694,4399
2013-05-01,NYSE (N),721380181,0,0,721380181,24558809381.231982,0.000000,0.000000,24558809381.231982,2095716,0,0,2095716
2013-05-01,NYSE Arca (P),321340688,253551026,180436911,755328625,11258557066.927575,16335420635.793192,6427757483.003675,34021735185.724442,1946152,555682,998541,3500375
2013-05-01,NASDAQ (Q),439295225,183995127,477727969,1101018321,15638141735.356413,11771629761.698482,14815425991.850372,42225197488.905267,2687657,597626,2097140,5382423
2013-05-01,CBSX (W),13748314,7183694,8031641,28963649,403027522.500000,384428957.701400,207213743.790000,994670223.991400,88340,13577,44074,145991
2013-05-01,NASDAQ PSX (X),19054706,17468821,14777958,51301485,527536444.200000,979202512.680000,376665859.015000,1883404815.895000,98025,45543,56600,200168
2013-05-01,BATS BYX (Y),67358387,31327297,35200121,133885805,2123887307.940001,1731339224.320602,995003121.562398,4850229653.823001,481847,131460,228454,841761
2013-05-01,BATS BZX (Z),249449187,141631234,170447845,561528266,7914242243.729608,8671004040.182801,5052958722.409817,21638205006.322226,1616518,463649,964030,3044197
2013-04-30,NYSE MKT (A),0,11564282,9062053,20626335,0.000000,93555369.617000,135531405.127000,229086774.744000,0,22025,28417,50442
2013-04-30,NASDAQ BX (B),80871571,24288246,46587045,151746862,2551504116.601003,1229006266.736800,1581833072.160395,5362343455.498198,546864,89224,292067,928155
2013-04-30,NSX (C),9057492,4076975,7571629,20706096,240644271.257300,135974120.547200,168034761.459900,544653153.264400,34516,7046,20959,62521
2013-04-30,NYSE (DN),98670206,17624193,49096051,165390450,3130705437.566563,1051099558.124699,1658626548.957003,5840431544.648265,552701,73799,257581,884081
2013-04-30,NASDAQ (DQ),1226029322,316282216,721462268,2263773806,36310752560.023359,16197935937.932004,23701487536.198715,76210176034.154078,3386634,500789,1703358,5590781
2013-04-30,EDGA (J),102502308,41165487,53040000,196707795,2810425185.038295,1838511045.883999,1531968084.719297,6180904315.641591,668853,126378,313874,1109105
2013-04-30,EDGX (K),231484070,63167475,147031289,441682834,8084745370.025699,2987445795.965789,5091075935.765380,16163267101.756868,1283784,184481,673929,2142194
2013-04-30,CHX (M),11103972,6106376,5105460,22315808,345179778.570000,502288205.469000,618039547.175000,1465507531.214000,362,1948,1299,3609
2013-04-30,NYSE (N),886948746,0,0,886948746,30741067942.734076,0.000000,0.000000,30741067942.734076,1941707,0,0,1941707
2013-04-30,NYSE Arca (P),315527130,197246101,181412996,694186227,10818580538.045127,11633900133.990826,6839106495.429383,29291587167.465336,1804448,442835,940105,3187388
2013-04-30,NASDAQ (Q),441694844,154494207,541471495,1137660546,15265000824.962790,9554760740.486201,18638152017.729624,43457913583.178615,2502859,454558,1885920,4843337
2013-04-30,CBSX (W),14123239,4931221,7448667,26503127,424870668.650000,321093684.590000,174199154.335000,920163507.575000,94627,10911,43155,148693
2013-04-30,NASDAQ PSX (X),15706372,10255320,16075772,42037464,398055827.195000,572139399.370000,319174921.795000,1289370148.360000,66837,24419,38650,129906
2013-04-30,BATS BYX (Y),64253573,23753933,32978455,120985961,2086495914.150001,1300730519.268700,1004358906.271299,4391585339.690000,446636,97450,209452,753538
2013-04-30,BATS BZX (Z),247213335,108128353,166425851,521767539,7697492053.184615,6479166496.551705,5451749599.182910,19628408148.919230,1509054,339672,903462,2752188
2013-04-29,NYSE MKT (A),0,7744166,6863941,14608107,0.000000,61322931.318000,112436932.342000,173759863.660000,0,18891,23561,42452
2013-04-29,NASDAQ BX (B),67872177,22419983,39677243,129969403,2065817595.761503,1041451793.717200,1415097557.057099,4522366946.535802,450500,78748,249653,778901
2013-04-29,NSX (C),6570388,2563385,4675083,13808856,184126675.155900,90819663.967000,131056054.991500,406002394.114400,27227,5031,16900,49158
2013-04-29,NYSE (DN),81729652,15043574,47212549,143985775,2754931524.332186,824689022.653301,1655543782.618506,5235164329.603993,468685,65954,232118,766757
2013-04-29,NASDAQ (DQ),997119408,261368806,628792156,1887280370,30094192669.830284,12511523240.893086,20412029543.770180,63017745454.493550,2848540,441840,1528707,4819087
2013-04-29,EDGA (J),82400097,30728660,43349094,156477851,2388165193.185601,1338910836.573499,1349028852.904099,5076104882.663199,557656,113788,268989,940433
2013-04-29,EDGX (K),178395188,49292854,117605648,345293690,6162524439.543892,2417578338.949401,4375944470.304124,12956047248.797417,998965,151449,566191,1716605
2013-04-29,CHX (M),7973465,4816143,5470516,18260124,318656127.226900,473291679.384200,1045370162.148000,1837317968.759100,546,1103,1167,2816
2013-04-29,NYSE (N),598688002,0,0,598688002,21043529152.923683,0.000000,0.000000,21043529152.923683,1624569,0,0,1624569
2013-04-29,NYSE Arca (P),245941879,152962515,136403396,535307790,8508198355.961799,9069332029.593204,5631790911.894001,23209321297.449004,1440764,364239,751615,2556618
2013-04-29,NASDAQ (Q),348679410,117506823,383987979,850174212,12355495781.050680,7393378581.049206,14131897413.410418,33880771775.510304,2046715,372479,1604758,4023952
2013-04-29,CBSX (W),11977417,4681193,6478757,23137367,376149579.740000,320438915.570000,184234610.210000,880823105.520000,83684,10596,39630,133910
2013-04-29,NASDAQ PSX (X),13506462,8296337,11159461,32962260,315271772.950000,476727734.270000,275432969.805000,1067432477.025000,49830,21587,29277,100694
2013-04-29,BATS BYX (Y),51159395,18846166,25646646,95652207,1521253529.432100,979599086.028400,796448304.829999,3297300920.290499,347889,80910,163432,592231
2013-04-29,BATS BZX (Z),199670357,86277861,137610482,423558700,6466463430.983896,5095540535.755003,4693409765.573087,16255413732.311986,1256281,287426,765818,2309525
2013-04-26,NYSE MKT (A),0,8092923,6086198,14179121,0.000000,49031069.582100,101964871.266000,150995940.848100,0,19222,27142,46364
2013-04-26,NASDAQ BX (B),72718619,23458445,41214488,137391552,2118051133.958199,1058403661.240000,1485994352.753498,4662449147.951697,482859,87558,275157,845574
2013-04-26,NSX (C),8445809,3221452,5326465,16993726,219327409.495900,93904390.041100,136802926.302800,450034725.839800,34277,6860,18935,60072
2013-04-26,NYSE (DN),80956269,16618712,46943149,144518130,2576837018.051105,1028170735.382802,1590116785.159411,5195124538.593318,469848,70797,253956,794601
2013-04-26,NASDAQ (DQ),1034613543,259229613,658992755,1952835911,29870435763.553202,12002201451.629228,20567761657.290180,62440398872.472610,2932964,479060,1615201,5027225
2013-04-26,EDGA (J),95357629,38012003,46170066,179539698,2581852453.384203,1574295542.648402,1430706556.221998,5586854552.254603,618222,129394,288703,1036319
2013-04-26,EDGX (K),203995253,64596186,130884422,399475861,6472375701.236008,3082579590.834004,4692384690.073498,14247339982.143510,1107616,203864,649234,1960714
2013-04-26,CHX (M),11884548,6657930,8501175,27043653,382971654.225600,544039599.366000,2252509224.370600,3179520477.962200,581,2054,1576,4211
2013-04-26,NYSE (N),681786357,0,0,681786357,22745870626.064724,0.000000,0.000000,22745870626.064724,1773869,0,0,1773869
2013-04-26,NYSE Arca (P),282389026,174610845,153982416,610982287,9143222973.095416,10371852443.883882,6468618292.256019,25983693709.235317,1598504,424057,871475,2894036
2013-04-26,NASDAQ (Q),402018078,139874246,443584919,985477243,13203886766.866786,7991999651.911001,16910300266.339384,38106186685.117171,2344026,453426,1839482,4636934
2013-04-26,CBSX (W),12576715,3205275,5859383,21641373,362440990.490000,188072217.100000,146785122.890000,697298330.480000,84276,10509,37779,132564
2013-04-26,NASDAQ PSX (X),14501121,9402616,9912422,33816159,362588434.880000,520643611.960000,233735336.960000,1116967383.800000,61287,25677,32049,119013
2013-04-26,BATS BYX (Y),57472476,22968959,30021971,110463406,1642785461.667999,1181466520.454900,870466720.460000,3694718702.582899,392537,92467,200975,685979
2013-04-26,BATS BZX (Z),246874007,113897523,153329088,514100618,7352757093.831990,6559532094.710196,5265657768.450012,19177946956.992198,1490202,375380,887410,2752992
2013-04-25,NYSE MKT (A),0,10205114,8125446,18330560,0.000000,59258427.005800,143485052.198000,202743479.203800,0,23328,31364,54692
2013-04-25,NASDAQ BX (B),87308862,25878505,46090384,159277751,2487840689.444399,1205083864.021100,1511529114.477001,5204453667.942500,553757,93755,295576,943088
2013-04-25,NSX (C),11775706,5041610,7069762,23887078,291331703.716700,160007475.405000,189845861.791601,641185040.913301,42685,9614,24112,76411
2013-04-25,NYSE (DN),106459396,21314234,59610256,187383886,3463892800.660780,1185763174.042200,2005847119.788784,6655503094.491764,594814,91163,294195,980172
2013-04-25,NASDAQ (DQ),1329763352,325655656,784722515,2440141523,39183358185.126436,15540770853.910475,23960010273.556425,78684139312.593336,3568908,564011,1851154,5984073
2013-04-25,EDGA (J),122597946,44727610,56640522,223966078,3450418027.819797,1898208310.510400,1705750973.480102,7054377311.810299,795375,156997,353779,1306151
2013-04-25,EDGX (K),258672309,69210802,153886098,481769209,8600372190.750095,3384351443.608802,5135528594.141287,17120252228.500184,1363707,209335,757300,2330342
2013-04-25,CHX (M),6569540,5765591,4745572,17080703,245162619.551600,453320623.610000,292491006.169900,990974249.331500,431,2211,2007,4649
2013-04-25,NYSE (N),746312183,0,0,746312183,25229263273.462072,0.000000,0.000000,25229263273.462072,2022646,0,0,2022646
2013-04-25,NYSE Arca (P),351196126,206883208,184268012,742347346,11699434857.835320,12905290915.811904,7078470187.592096,31683195961.239320,1911988,481381,981544,3374913
2013-04-25,NASDAQ (Q),498349015,165460431,472923052,1136732498,16828044715.274729,10276319347.638138,16302185396.671550,43406549459.584417,2840631,515775,2079509,5435915
2013-04-25,CBSX (W),15664955,5245144,7307894,28217993,463985072.720000,256117928.120000,185123731.770000,905226732.610000,103218,13358,46257,162833
2013-04-25,NASDAQ PSX (X),16339286,11122461,14123191,41584938,414486229.635000,676747885.780000,361775521.475000,1453009636.890000,72808,29769,41947,144524
2013-04-25,BATS BYX (Y),66841701,24732389,34233794,125807884,1842998032.965800,1270031373.900301,985259521.201001,4098288928.067102,435599,101276,219295,756170
2013-04-25,BATS BZX (Z),291415800,124743645,179084884,595244329,9072740461.651016,7435726212.204793,5922882960.484199,22431349634.340008,1775661,420556,1011603,3207820
2013-04-24,NYSE MKT (A),0,8695433,7366941,16062374,0.000000,56190066.902800,136721682.866000,192911749.768800,0,21741,27488,49229
2013-04-24,NASDAQ BX (B),79959870,24960628,42920783,147841281,2395890712.210002,1076305060.008900,1613472110.404002,5085667882.622904,521138,86172,263385,870695
2013-04-24,NSX (C),11145614,4416281,6194399,21756294,288385508.309300,178783701.407500,187153551.130300,654322760.847100,38529,8180,21171,67880
2013-04-24,NYSE (DN),99487101,18933460,46765278,165185839,3230629752.936256,980299245.416698,1864520547.611170,6075449545.964124,580106,78473,250938,909517
2013-04-24,NASDAQ (DQ),1194626256,329682536,615352240,2139661032,34366743675.032202,15419457053.282124,22638365175.968701,72424565904.283027,3314029,507017,1613506,5434552
2013-04-24,EDGA (J),109472331,41373564,52355298,203201193,3042940903.282101,1655313305.345801,1733160606.395498,6431414815.023400,710594,138885,312204,1161683
2013-04-24,EDGX (K),241647212,61365265,137605083,440617560,8071757975.315902,2953656234.651699,5263186434.598419,16288600644.566020,1292354,183277,655771,2131402
2013-04-24,CHX (M),6935008,13617218,5079847,25632073,272726485.153000,778596322.510000,197299077.336900,1248621884.999900,383,1476,1682,3541
2013-04-24,NYSE (N),706098059,0,0,706098059,23775016493.889110,0.000000,0.000000,23775016493.889110,1925730,0,0,1925730
2013-04-24,NYSE Arca (P),324506371,196796592,172890036,694192999,11134655507.566292,10526648325.489989,7612641911.300233,29273945744.356514,1824288,437193,912109,3173590
2013-04-24,NASDAQ (Q),451411765,146596723,441517039,1039525527,15285582150.388427,8838793357.308502,16197203476.326521,40321578984.023450,2567963,451480,1890077,4909520
2013-04-24,CBSX (W),14445436,4368254,6964801,25778491,439108768.120000,190867270.710000,174302127.440000,804278166.270000,97670,10885,40677,149232
2013-04-24,NASDAQ PSX (X),16150030,10726783,11808817,38685630,420766896.020000,589391233.685000,291978253.015000,1302136382.720000,71135,26506,37721,135362
2013-04-24,BATS BYX (Y),62474651,22238159,33106725,117819535,1804994590.140001,1075548239.439900,1002664172.293999,3883207001.873900,423210,87043,211192,721445
2013-04-24,BATS BZX (Z),280450472,121666689,170702618,572819779,8924053800.131893,6762916069.513087,5769671585.567002,21456641455.211982,1648802,367205,886512,2902519
2013-04-23,NYSE MKT (A),0,8339310,9062523,17401833,0.000000,66977092.720900,160813792.580000,227790885.300900,0,19727,35553,55280
2013-04-23,NASDAQ BX (B),82879793,33892380,41961970,158734143,2427661095.325699,1667774672.756500,1562769072.181403,5658204840.263602,527999,115184,264619,907802
2013-04-23,NSX (C),10270202,3869405,6586927,20726534,306245122.627300,150350289.331800,191608677.165600,648204089.124700,40728,9307,23757,73792
2013-04-23,NYSE (DN),92486624,23609371,45612358,161708353,2980255068.663385,1355966690.740200,1692706717.130790,6028928476.534375,529095,90515,250002,869612
2013-04-23,NASDAQ (DQ),1126623195,356352075,565199783,2048175053,32885984234.591227,17318956015.021520,18986602416.212533,69191542665.825280,3250917,564470,1577714,5393101
2013-04-23,EDGA (J),115169075,54280909,56195801,225645785,3191628802.756907,2425221555.126298,1755358778.658101,7372209136.541306,731858,174720,337259,1243837
2013-04-23,EDGX (K),248430210,87607340,136114490,472152040,8193391931.945109,4610390377.162406,4872670697.777292,17676453006.884807,1335475,257484,665423,2258382
2013-04-23,CHX (M),8963206,6952042,5606888,21522136,458848862.467600,685848418.106200,923757113.889900,2068454394.463700,538,1962,1982,4482
2013-04-23,NYSE (N),684019391,0,0,684019391,22883817564.151792,0.000000,0.000000,22883817564.151792,2012002,0,0,2012002
2013-04-23,NYSE Arca (P),336375811,258673192,167019892,762068895,11312217837.332070,15339756374.028489,7303631845.680534,33955606057.041093,1904645,583734,917047,3405426
2013-04-23,NASDAQ (Q),485046895,215826640,443547073,1144420608,16248144217.752887,13661013404.448408,16454334086.659576,46363491708.860871,2785891,659042,1965339,5410272
2013-04-23,CBSX (W),15143854,5525801,6488883,27158538,433156181.250000,268052070.850000,163815178.180000,865023430.280000,95653,14034,39099,148786
2013-04-23,NASDAQ PSX (X),15609684,14305222,11173402,41088308,401615346.500000,831452185.918000,288258889.280000,1521326421.698000,67762,37861,34148,139771
2013-04-23,BATS BYX (Y),65143633,30952853,32700512,128796998,1816082204.456098,1613903182.270000,971149778.422701,4401135165.148799,426103,118862,207592,752557
2013-04-23,BATS BZX (Z),280253655,156298116,174913613,611465384,8459902293.785817,9611561114.998384,5642437334.401520,23713900743.185721,1661708,480633,911645,3053986
2013-04-22,NYSE MKT (A),0,9080006,7936314,17016320,0.000000,54582242.000200,125437371.079600,180019613.079800,0,19999,30172,50171
2013-04-22,NASDAQ BX (B),71332866,23931677,43025008,138289551,2038766992.444302,1065512875.100000,1447447034.739198,4551726902.283500,449130,82705,264793,796628
2013-04-22,NSX (C),8274983,3238971,5424769,16938723,222770692.018200,134022813.688000,157854810.062500,514648315.768700,34411,6816,20671,61898
2013-04-22,NYSE (DN),81254615,19126825,43583513,143964953,2516229122.762285,1029449032.275699,1511863172.282098,5057541327.320082,457320,82264,231166,770750
2013-04-22,NASDAQ (DQ),921524075,295259754,551746875,1768530704,27163682839.305468,13515069118.733754,17427191265.070729,58105943223.109951,2863762,503071,1506885,4873718
2013-04-22,EDGA (J),96132220,40427808,55438094,191998122,2625400014.968996,1711198137.876401,1560445047.248003,5897043200.093400,611040,140641,313627,1065308
2013-04-22,EDGX (K),198796350,69454926,126283038,394534314,6682392890.319004,3341425719.621203,4292459869.160388,14316278479.100595,1109495,218497,598094,1926086
2013-04-22,CHX (M),10772301,9485040,4826723,25084064,455701412.978300,873263470.896800,314957462.241800,1643922346.116900,330,1382,1844,3556
2013-04-22,NYSE (N),620516658,0,0,620516658,20866718753.054214,0.000000,0.000000,20866718753.054214,1766443,0,0,1766443
2013-04-22,NYSE Arca (P),271232836,205641198,174234225,651108259,9268296619.400128,12233563310.116312,6187285963.041098,27689145892.557538,1591256,470292,851136,2912684
2013-04-22,NASDAQ (Q),392665002,148287826,444745616,985698444,13252542032.394604,8817430513.949600,14724121040.148322,36794093586.492526,2320543,487996,1814513,4623052
2013-04-22,CBSX (W),12303660,4921624,7142948,24368232,367740856.170000,290983707.960000,159273150.040000,817997714.170000,85300,11486,39851,136637
2013-04-22,NASDAQ PSX (X),13024036,9800261,12914541,35738838,307011115.810000,572340273.400000,291084906.600000,1170436295.810000,56789,27200,33200,117189
2013-04-22,BATS BYX (Y),58459494,22106116,29563947,110129557,1557469223.509999,1111743269.024399,799020927.783099,3468233420.317497,386894,91246,178077,656217
2013-04-22,BATS BZX (Z),224216696,118000586,163348413,505565695,6765479188.963704,6778698131.735407,5078435029.043009,18622612349.742120,1366030,384592,838656,2589278
2013-04-19,NYSE MKT (A),0,8890696,6715285,15605981,0.000000,58780341.353500,115575974.859600,174356316.213100,0,20215,22823,43038
2013-04-19,NASDAQ BX (B),79909334,27777538,43522897,151209769,2370254001.110999,1311815895.715800,1604061086.281898,5286130983.108697,504080,98208,273635,875923
2013-04-19,NSX (C),10475729,3620145,5651355,19747229,277028307.759400,149179257.512000,164295582.582900,590503147.854300,39570,7853,21415,68838
2013-04-19,NYSE (DN),92952859,19285644,48387650,160626153,3046058519.774913,1067466001.558599,1946774535.997168,6060299057.330680,516036,81301,254293,851630
2013-04-19,NASDAQ (DQ),1046671537,321652444,549848450,1918172431,30978150977.393741,16131665360.242298,19121940668.887526,66231757006.523565,3027793,519736,1473652,5021181
2013-04-19,EDGA (J),110022284,48840619,54233642,213096545,3068603762.736396,1981388056.693701,1629717650.897399,6679709470.327496,698351,158393,320608,1177352
2013-04-19,EDGX (K),222710756,77412316,129016156,429139228,7733440911.441854,3860642130.736697,4505235945.003097,16099318987.181648,1233749,241033,624242,2099024
2013-04-19,CHX (M),9428197,21461714,6407034,37296945,371488689.627500,1628920029.786500,302785230.865200,2303193950.279200,521,1745,1581,3847
2013-04-19,NYSE (N),914464523,0,0,914464523,32851763058.284435,0.000000,0.000000,32851763058.284435,1982137,0,0,1982137
2013-04-19,NYSE Arca (P),318556103,234719749,172895150,726171002,10803652204.073201,14438680564.484423,7032414089.208629,32274746857.766253,1779128,509701,879250,3168079
2013-04-19,NASDAQ (Q),432201969,169391141,517505485,1119098595,14815665106.334993,9942206809.402985,18532789499.302297,43290661415.040275,2496281,536891,1876165,4909337
2013-04-19,CBSX (W),14694088,4964822,6458138,26117048,401961435.350000,218109986.870000,169862044.100000,789933466.320000,88929,12311,39108,140348
2013-04-19,NASDAQ PSX (X),14792340,12348426,12005840,39146606,344265736.670000,707568301.525000,287878694.715000,1339712732.910000,65867,31057,36215,133139
2013-04-19,BATS BYX (Y),67979750,26928758,32126847,127035355,1944036337.838401,1390007288.818400,1019259930.805798,4353303557.462599,458536,112841,211123,782500
2013-04-19,BATS BZX (Z),257348477,138795814,170473316,566617607,7785868718.157878,8072373318.600405,5658295554.077693,21516537590.835976,1528240,426510,892579,2847329
2013-04-18,NYSE MKT (A),0,8957085,5717818,14674903,0.000000,58998789.403300,81529624.587000,140528413.990300,0,22429,21224,43653
2013-04-18,NASDAQ BX (B),91115881,32850036,45339310,169305227,2619841318.840002,1573128207.857802,1610353990.083700,5803323516.781504,566044,119302,281370,966716
2013-04-18,NSX (C),12799559,4654748,6477047,23931354,325734993.265300,164258427.598800,208359525.162400,698352946.026500,51612,10100,26508,88220
2013-04-18,NYSE (DN),103543788,22936605,47560520,174040913,3070465506.264082,1249743728.253305,1736977897.923896,6057187132.441283,564718,99745,263974,928437
2013-04-18,NASDAQ (DQ),1160386189,410005033,554379994,2124771216,31823468127.298911,19721845648.456397,17943129877.365961,69488443653.121269,3309040,643227,1580317,5532584
2013-04-18,EDGA (J),130414325,59206759,59867697,249488781,3300006178.753197,2388468401.322199,1774284676.077998,7462759256.153394,804798,187308,370138,1362244
2013-04-18,EDGX (K),253612658,97545704,142900690,494059052,8080732666.114191,4604832634.794002,4827983606.766498,17513548907.674691,1363872,308136,698887,2370895
2013-04-18,CHX (M),9319729,13235852,5052120,27607701,228052731.373800,1126126384.099600,184180135.199900,1538359250.673300,640,2883,1898,5421
2013-04-18,NYSE (N),797800296,0,0,797800296,25715039875.944306,0.000000,0.000000,25715039875.944306,2279302,0,0,2279302
2013-04-18,NYSE Arca (P),395291889,265768122,183764865,844824876,12288640714.254649,15318876862.739281,7040490210.107927,34648007787.101857,2115802,645196,976905,3737903
2013-04-18,NASDAQ (Q),532815236,233189429,488268276,1254272941,17300475509.016942,13708892302.228203,16716323737.037447,47725691548.282592,3030354,746651,2158134,5935139
2013-04-18,CBSX (W),15391368,4917533,6332711,26641612,395439542.510000,311574268.730000,173083641.540000,880097452.780000,90552,15970,38910,145432
2013-04-18,NASDAQ PSX (X),18829047,14492349,14046984,47368380,367006172.970000,834722079.780000,292358979.535000,1494087232.285000,67605,36211,36808,140624
2013-04-18,BATS BYX (Y),81334105,36116502,36012902,153463509,2146804784.125001,1851009451.901299,998601733.734199,4996415969.760499,531251,149311,230872,911434
2013-04-18,BATS BZX (Z),310466143,174713403,178896418,664075964,8770790087.991104,9798927822.557608,5674528886.036502,24244246796.585214,1783615,560983,969785,3314383
2013-04-17,NYSE MKT (A),0,11555650,6973693,18529343,0.000000,63148427.107600,100095743.709200,163244170.816800,0,25639,24156,49795
2013-04-17,NASDAQ BX (B),102927320,39665592,48263579,190856491,2918817470.935004,2029030750.653399,1824038986.328205,6771887207.916608,649919,138098,301352,1089369
2013-04-17,NSX (C),14941775,6370175,7330622,28642572,353454174.962300,209678136.960200,214649219.432600,777781531.355100,55805,13438,27865,97108
2013-04-17,NYSE (DN),108929468,25466602,46943748,181339818,3159761966.837298,1404152728.537397,1974450498.561597,6538365193.936292,598548,106811,273319,978678
2013-04-17,NASDAQ (DQ),1239609535,544700631,602731189,2387041355,33565549558.956044,27133468738.761579,20845652415.574359,81544670713.291982,3592551,764115,1676768,6033434
2013-04-17,EDGA (J),149767006,64740237,68254036,282761279,3798027241.894197,2810056403.793598,1974972593.943700,8583056239.631495,923723,221831,418810,1564364
2013-04-17,EDGX (K),285911140,124006736,148469824,558387700,8850758802.157304,6212275143.572016,5112282586.521792,20175316532.251112,1479533,376947,724670,2581150
2013-04-17,CHX (M),13345165,10265287,4837105,28447557,341549416.153000,823442511.227800,232131955.107500,1397123882.488300,640,3793,1863,6296
2013-04-17,NYSE (N),866015559,0,0,866015559,27807729235.745894,0.000000,0.000000,27807729235.745894,2432739,0,0,2432739
2013-04-17,NYSE Arca (P),424861308,336440670,197324183,958626161,13056049798.633120,19457072219.020374,7842267693.850340,40355389711.503834,2265840,771411,1062287,4099538
2013-04-17,NASDAQ (Q),579630244,286449552,522288955,1388368751,18259806572.256399,16887312286.304086,17657449043.609717,52804567902.170202,3254849,871652,2358383,6484884
2013-04-17,CBSX (W),16840652,8128282,6911867,31880801,437873190.840000,399475151.600000,177210977.690000,1014559320.130000,99193,16619,44687,160499
2013-04-17,NASDAQ PSX (X),18830565,20002832,14125185,52958582,399403258.215000,1182224102.485000,299456815.960000,1881084176.660000,71534,45590,38971,156095
2013-04-17,BATS BYX (Y),88960384,47097649,41401626,177459659,2272919020.376002,2263320765.173602,1137891842.784799,5674131628.334403,575430,187643,257683,1020756
2013-04-17,BATS BZX (Z),341395100,217974348,199228399,758597847,9657090699.639589,12635053737.135467,6437050677.209213,28729195113.984269,1939785,662737,1090581,3693103
2013-04-16,NYSE MKT (A),0,12827080,6925807,19752887,0.000000,76726981.941600,104937757.460400,181664739.402000,0,23686,24528,48214
2013-04-16,NASDAQ BX (B),86302931,32802146,39712118,158817195,2533594572.015799,1692476248.328602,1297001573.186101,5523072393.530502,540992,107790,255223,904005
2013-04-16,NSX (C),11267707,4664187,4964284,20896178,288149160.550400,160837671.055100,133835885.291300,582822716.896800,44002,9999,21223,75224
2013-04-16,NYSE (DN),96752674,23332668,41711818,161797160,2944614509.881211,1358470850.953603,1377607239.641117,5680692600.475931,545720,96217,237985,879922
2013-04-16,NASDAQ (DQ),1180683288,395948169,519982941,2096614398,32241033000.493055,19311875268.590143,15199808492.438740,66752716761.521938,3312056,651631,1474694,5438381
2013-04-16,EDGA (J),121945850,46472847,51377380,219796077,3269085380.626702,2195478233.104003,1448460173.030204,6913023786.760909,770675,168799,331648,1271122
2013-04-16,EDGX (K),234256077,83714835,120002534,437973446,7943862840.866968,4256050413.205205,3784789908.245106,15984703162.317279,1279652,259293,605557,2144502
2013-04-16,CHX (M),23835169,9726885,2971802,36533856,496743018.602600,744150813.440000,141064385.364800,1381958217.407400,515,4238,1557,6310
2013-04-16,NYSE (N),743467373,0,0,743467373,24442889079.240297,0.000000,0.000000,24442889079.240297,2007342,0,0,2007342
2013-04-16,NYSE Arca (P),316693840,260339850,141851714,718885404,10640325952.211150,15566613471.256508,5026192920.909508,31233132344.377166,1769851,576368,789264,3135483
2013-04-16,NASDAQ (Q),467205497,202166807,404098405,1073470709,16007596808.341192,12375666604.333002,13519646299.518036,41902909712.192230,2705821,613889,1785684,5105394
2013-04-16,CBSX (W),15658124,4389077,6033063,26080264,423032544.690000,253350741.790000,147256486.760000,823639773.240000,93426,14162,37622,145210
2013-04-16,NASDAQ PSX (X),14151452,14393144,8703445,37248041,300068342.550000,941709228.200000,208962191.250000,1450739762.000000,52956,36690,27095,116741
2013-04-16,BATS BYX (Y),75890347,32033874,31109581,139033802,2039828665.605003,1765313464.547001,830689555.084000,4635831685.236004,500877,136239,213394,850510
2013-04-16,BATS BZX (Z),269354004,146391455,145970786,561716245,8115934525.771491,8835143664.774603,4492429351.735714,21443507542.281808,1592859,456458,827364,2876681
2013-04-15,NYSE MKT (A),0,15879197,5613030,21492227,0.000000,107755592.718300,83032020.158200,190787612.876500,0,32254,19997,52251
2013-04-15,NASDAQ BX (B),111856329,51653764,47457708,210967801,3145158857.619004,2378132210.409699,1641761023.003300,7165052091.032003,678383,164188,288451,1131022
2013-04-15,NSX (C),15986168,7523973,7359437,30869578,388764915.320400,245064490.655300,190358701.495900,824188107.471600,60224,15530,27634,103388
2013-04-15,NYSE (DN),114888780,36753012,44331071,195972863,3258909255.962637,2301220259.904202,1540644910.974404,7100774426.841243,623842,144006,254562,1022410
2013-04-15,NASDAQ (DQ),1371744246,612271651,556712220,2540728117,35707214373.114647,29887564832.983977,16591911761.805943,82186690967.904567,3907872,991039,1605256,6504167
2013-04-15,EDGA (J),158159800,78669808,62002838,298832446,3977713813.111199,3367565435.259298,1745260228.061902,9090539476.432399,953345,248320,394232,1595897
2013-04-15,EDGX (K),313489072,140458031,143676003,597623106,9720579214.802405,6896976758.601598,4311158554.213622,20928714527.617625,1567153,404049,698330,2669532
2013-04-15,CHX (M),25337088,11120431,2868177,39325696,387900263.714300,1043901468.150900,105992715.582400,1537794447.447600,919,7774,1444,10137
2013-04-15,NYSE (N),975717981,0,0,975717981,31739395409.480311,0.000000,0.000000,31739395409.480311,2448753,0,0,2448753
2013-04-15,NYSE Arca (P),452324137,406472332,175473879,1034270348,13588518910.672306,24434725954.670770,6339746834.098822,44362991699.441898,2258116,889738,955967,4103821
2013-04-15,NASDAQ (Q),620588677,331812579,507821145,1460222401,19631243362.735704,20104039788.269818,16401582530.656985,56136865681.662507,3463230,995318,2194023,6652571
2013-04-15,CBSX (W),19167295,8538467,6480061,34185823,477365838.060000,540749152.500000,186314020.970000,1204429011.530000,105926,20701,40388,167015
2013-04-15,NASDAQ PSX (X),21721739,22616001,13014397,57352137,428486072.950000,1252006644.080000,306523375.810000,1987016092.840000,73581,51986,34590,160157
2013-04-15,BATS BYX (Y),97204664,53582258,38087356,188874278,2497341606.705002,2659810275.909902,1161653481.816401,6318805364.431305,601896,202898,244275,1049069
2013-04-15,BATS BZX (Z),363818151,248004570,180546501,792369222,10177932933.484007,14249689615.256284,5667180926.117992,30094803474.858283,2059036,737263,1015077,3811376
2013-04-12,NYSE MKT (A),0,10318225,7734690,18052915,0.000000,64482482.773000,159629945.385400,224112428.158400,0,21540,24206,45746
2013-04-12,NASDAQ BX (B),76023826,37880016,34814729,148718571,2236449703.180600,1638092592.656299,1167494247.079900,5042036542.916799,491502,108223,222764,822489
2013-04-12,NSX (C),10624645,4661131,5388224,20674000,251978481.808300,177199325.947900,121992486.936600,551170294.692800,39536,8914,19316,67766
2013-04-12,NYSE (DN),79172977,24207660,36163418,139544055,2519586191.736194,1335297862.687400,1148459139.716198,5003343194.139792,466502,92165,200688,759355
2013-04-12,NASDAQ (DQ),993316341,420064234,527336831,1940717406,29196633361.622434,20375273103.659891,14525623451.582653,64097529916.864978,2906761,624938,1334825,4866524
2013-04-12,EDGA (J),103611437,59072866,46055690,208739993,2682399573.718002,2515811962.181298,1232684069.087201,6430895604.986501,656876,168707,281454,1107037
2013-04-12,EDGX (K),212421827,77283245,111290299,400995371,6892333055.864905,3812788957.358817,3417151681.289092,14122273694.512814,1108987,234417,522334,1865738
2013-04-12,CHX (M),11269176,12691670,3412471,27373317,362886272.717300,904375336.314000,190167369.453000,1457428978.484300,462,3567,1153,5182
2013-04-12,NYSE (N),700201037,0,0,700201037,23077229903.138306,0.000000,0.000000,23077229903.138306,1668056,0,0,1668056
2013-04-12,NYSE Arca (P),297337511,259511857,132261787,689111155,9670807436.275833,14970534573.898004,5006314875.707095,29647656885.880932,1579254,535776,725260,2840290
2013-04-12,NASDAQ (Q),415688360,185716279,390760994,992165633,13793804197.150386,11315550520.154408,12726923556.991953,37836278274.296747,2387005,566512,1568569,4522086
2013-04-12,CBSX (W),13402539,4890318,5976056,24268913,386115276.990000,264143981.310000,137999789.300000,788259047.600000,85599,14291,35168,135058
2013-04-12,NASDAQ PSX (X),13391844,16385301,10384208,40161353,294089969.335000,973088793.280000,247119526.035000,1514298288.650000,51084,38963,26335,116382
2013-04-12,BATS BYX (Y),61210944,33424211,27204242,121839397,1721927875.235999,1608579536.543999,752935345.322901,4083442757.102899,420977,126777,178456,726210
2013-04-12,BATS BZX (Z),245187528,142394325,135795415,523377268,7306731899.656292,8015855146.127698,4153643521.988391,19476230567.772381,1450277,415685,749438,2615400
2013-04-11,NYSE MKT (A),0,6819259,9010637,15829896,0.000000,44278994.627600,202431961.296000,246710955.923600,0,17282,29727,47009
2013-04-11,NASDAQ BX (B),78925920,29962931,46454148,155342999,2341207571.349399,1353151640.783200,1442216216.763998,5136575428.896597,493520,90429,267564,851513
2013-04-11,NSX (C),13173374,3495452,7294298,23963124,301984973.197300,153135300.640600,191824594.074900,646944867.912800,45442,7659,23788,76889
2013-04-11,NYSE (DN),87714779,18666992,50606364,156988135,2902989050.548500,999057547.469700,1665556924.950291,5567603522.968491,504499,74360,263982,842841
2013-04-11,NASDAQ (DQ),1128484473,334846606,656428436,2119759515,34305071872.514049,15247563564.472082,18841738901.787627,68394374338.773758,3258695,523985,1699768,5482448
2013-04-11,EDGA (J),112424174,49191837,59059556,220675567,3143755960.446595,1930437341.923500,1597344910.013900,6671538212.383995,729594,137763,357133,1224490
2013-04-11,EDGX (K),232800520,65841779,144418810,443061109,8060476293.562509,3275567071.486899,4196277609.474382,15532320974.523790,1247485,191136,645028,2083649
2013-04-11,CHX (M),10176041,11054261,5171201,26401503,429632986.669000,598943968.725000,219311877.316900,1247888832.710900,962,1208,1587,3757
2013-04-11,NYSE (N),642741849,0,0,642741849,22152029328.295918,0.000000,0.000000,22152029328.295918,1733875,0,0,1733875
2013-04-11,NYSE Arca (P),310265349,210317308,172849936,693432593,10401038908.151838,11310787397.102401,5910161566.975809,27621987872.230048,1674617,401614,892049,2968280
2013-04-11,NASDAQ (Q),436193581,142287877,456630280,1035111738,15148472098.427712,9019536847.061702,14343112709.959945,38511121655.449359,2539587,424078,1862568,4826233
2013-04-11,CBSX (W),14025517,5945885,6641136,26612538,400706436.420000,245172012.009600,163857941.220000,809736389.649600,87767,11326,41127,140220
2013-04-11,NASDAQ PSX (X),16468396,13877721,14041619,44387736,397396268.225000,861119803.340000,339936258.805000,1598452330.370000,65425,32372,38424,136221
2013-04-11,BATS BYX (Y),65631665,29131982,35501520,130265167,1882039991.247001,1268599089.845600,969098490.716000,4119737571.808601,437570,97233,222964,757767
2013-04-11,BATS BZX (Z),246594801,123383257,172067518,542045576,7717015644.019195,6627734611.731109,5090560730.978184,19435310986.728488,1473442,318081,902972,2694495
2013-04-10,NYSE MKT (A),0,8694176,9394448,18088624,0.000000,59546226.000800,189344250.896800,248890476.897600,0,20262,28163,48425
2013-04-10,NASDAQ BX (B),87350868,28624733,47417341,163392942,2478122440.310001,1543033086.174999,1523893508.765599,5545049035.250599,541001,94822,278453,914276
2013-04-10,NSX (C),13674803,4084265,8257613,26016681,321301536.320700,155578916.358900,199864973.539500,676745426.219100,48510,9018,26487,84015
2013-04-10,NYSE (DN),91526596,20713056,45787581,158027233,2828504160.215101,1127038154.702400,1449163663.232491,5404705978.149992,523969,79914,251340,855223
2013-04-10,NASDAQ (DQ),1135678103,355014249,643845079,2134537431,32490056779.846617,18559332614.496106,18745634275.030457,69795023669.373180,3361480,570033,1705816,5637329
2013-04-10,EDGA (J),120023643,43495426,60977490,224496559,3156041631.068104,2064311438.891702,1619447625.618805,6839800695.578611,774542,144393,379739,1298674
2013-04-10,EDGX (K),227817267,66430373,138258640,432506280,7600198255.752500,3503086795.038498,4277301700.254899,15380586751.045897,1189828,191854,637882,2019564
2013-04-10,CHX (M),11529786,11017046,4416105,26962937,380604257.240000,1023855503.262000,154573713.842500,1559033474.344500,386,1763,1556,3705
2013-04-10,NYSE (N),700835986,0,0,700835986,22994824951.124352,0.000000,0.000000,22994824951.124352,1782984,0,0,1782984
2013-04-10,NYSE Arca (P),317156172,208815194,161322699,687294065,10153199694.182702,12245774095.729268,5755735431.070923,28154709220.982893,1710473,422068,863183,2995724
2013-04-10,NASDAQ (Q),421160982,157675683,440011629,1018848294,14067905242.356225,10568922032.715283,14109028088.033132,38745855363.104640,2441696,474862,1829711,4746269
2013-04-10,CBSX (W),15651612,5690649,6982048,28324309,429811401.900000,325762980.370000,190068331.270000,945642713.540000,94359,13327,41998,149684
2013-04-10,NASDAQ PSX (X),18734323,13994375,15192763,47921461,462919012.590200,890149517.050000,396627142.900000,1749695672.540200,81152,33302,42842,157296
2013-04-10,BATS BYX (Y),70097874,25841890,33652480,129592244,1981801156.984197,1391181316.744999,945518410.645099,4318500884.374295,473378,103002,222176,798556
2013-04-10,BATS BZX (Z),252264564,118618179,166840539,537723282,7603049448.374821,7465973435.568205,5137905092.335784,20206927976.278810,1514353,353614,901344,2769311
2013-04-09,NYSE MKT (A),0,8790538,7906781,16697319,0.000000,64474455.820700,166145738.279300,230620194.100000,0,23447,26596,50043
2013-04-09,NASDAQ BX (B),82777777,27637518,43730450,154145745,2378822512.932700,1329089365.653801,1355592211.594697,5063504090.181198,537047,95642,271768,904457
2013-04-09,NSX (C),11673419,4541287,7146333,23361039,281611003.562400,169495465.878300,165008984.957800,616115454.398500,42214,9194,23020,74428
2013-04-09,NYSE (DN),80267292,18656690,35822241,134746223,2550899653.700808,982173213.302701,1132893215.098202,4665966082.101711,461824,76022,207726,745572
2013-04-09,NASDAQ (DQ),1042990804,349691442,523809269,1916491515,28975134471.177079,15441969765.617585,14344970333.416476,58762074570.211140,2948742,518483,1404312,4871537
2013-04-09,EDGA (J),104653852,44303209,49292871,198249932,2708396567.638099,1915300076.756001,1320756199.204198,5944452843.598298,665094,143594,301713,1110401
2013-04-09,EDGX (K),211824937,70003119,116066014,397894070,6682822606.626290,3389574632.825095,3538586473.206001,13610983712.657386,1111135,203040,550729,1864904
2013-04-09,CHX (M),10653877,6869226,4153103,21676206,428736531.019000,464129001.988000,191282624.206500,1084148157.213500,459,1060,1428,2947
2013-04-09,NYSE (N),669898235,0,0,669898235,22155659522.740416,0.000000,0.000000,22155659522.740416,1701144,0,0,1701144
2013-04-09,NYSE Arca (P),305335889,199477080,133529671,638342640,9555627525.166351,10865787506.356885,4629572071.487720,25050987103.010956,1680233,435438,734306,2849977
2013-04-09,NASDAQ (Q),396587733,150903190,386877559,934368482,12819631486.857864,9023071805.741010,12461395391.618452,34304098684.217326,2271596,465443,1656223,4393262
2013-04-09,CBSX (W),13014404,5162956,5529026,23706386,343186714.570000,290365682.360000,133496467.707300,767048864.637300,80504,12395,32627,125526
2013-04-09,NASDAQ PSX (X),14354285,14334397,13254046,41942728,334975220.180000,795552359.080000,335349982.000000,1465877561.260000,60933,33401,34278,128612
2013-04-09,BATS BYX (Y),61866987,24320404,29690443,115877834,1747149753.910002,1175727702.609999,856531072.284301,3779408528.804302,417145,98318,193224,708687
2013-04-09,BATS BZX (Z),247573653,120811044,147962173,516346870,7444276909.648212,6728847796.596293,4590605761.763288,18763730468.007793,1479536,347920,802976,2630432
2013-04-08,NYSE MKT (A),0,7448926,8106245,15555171,0.000000,48749189.468300,149954235.663300,198703425.131600,0,17975,25978,43953
2013-04-08,NASDAQ BX (B),71140859,22964572,35578985,129684416,2062230377.434499,1143755199.389800,1166322429.535898,4372308006.360197,477892,79606,231005,788503
2013-04-08,NSX (C),9284966,4073496,5773851,19132313,232686917.216700,140026077.550300,113535884.837300,486248879.604300,34756,7943,19356,62055
2013-04-08,NYSE (DN),74962129,15488061,33948680,124398870,2440806023.508518,814672777.440399,1155564888.195703,4411043689.144620,427744,63397,191991,683132
2013-04-08,NASDAQ (DQ),924270645,312220514,451995554,1688486713,26543608455.311199,14527410816.190684,13004945527.742621,54075964799.244504,2749720,458933,1257818,4466471
2013-04-08,EDGA (J),97646048,43757849,43386705,184790602,2602700532.399200,1760616051.512299,1204096294.107703,5567412878.019202,618193,130286,267047,1015526
2013-04-08,EDGX (K),195080177,60162300,104411778,359654255,6383548965.802585,2908286892.022299,3140951322.565308,12432787180.390192,1070969,174901,502815,1748685
2013-04-08,CHX (M),7686154,5325401,3646838,16658393,297273748.047800,436631385.328000,310552985.930600,1044458119.306400,274,685,1052,2011
2013-04-08,NYSE (N),582776694,0,0,582776694,19533652763.231721,0.000000,0.000000,19533652763.231721,1543133,0,0,1543133
2013-04-08,NYSE Arca (P),267314095,181916654,119157847,568388596,8502553076.715792,9940156917.542403,4112218315.755381,22554928310.013576,1526103,390251,660713,2577067
2013-04-08,NASDAQ (Q),353847217,128618790,344321425,826787432,11553087375.268414,7139967549.017384,11062905373.894486,29755960298.180284,2056021,402518,1451577,3910116
2013-04-08,CBSX (W),13162059,5207283,6587984,24957326,346468195.560000,270565990.597000,154758001.615000,771792187.772000,84737,9330,37798,131865
2013-04-08,NASDAQ PSX (X),14185352,10083272,10201089,34469713,360762058.150000,567101941.460000,238452693.610000,1166316693.220000,65072,26792,31203,123067
2013-04-08,BATS BYX (Y),58820370,22959220,28119078,109898668,1685111214.203201,1077206806.694100,761721165.553399,3524039186.450700,402301,91451,184070,677822
2013-04-08,BATS BZX (Z),217817551,102788756,131112359,451718666,6697437893.175090,5724171952.296114,3920145760.839205,16341755606.310409,1330947,303848,715993,2350788
2013-04-05,NYSE MKT (A),0,8764981,8309269,17074250,0.000000,61981574.310800,160185760.633300,222167334.944100,0,21913,25757,47670
2013-04-05,NASDAQ BX (B),79078611,33289047,39907281,152274939,2307012893.781000,1830719974.292999,1350964506.776402,5488697374.850401,513742,120435,251283,885460
2013-04-05,NSX (C),9083674,5396605,5807285,20287564,263226248.109200,186990544.242900,154249431.075800,604466223.427900,40357,10288,20067,70712
2013-04-05,NYSE (DN),86981433,22979521,41079620,151040574,2791889837.196417,1233302103.886697,1376305367.328813,5401497308.411927,485561,90506,221257,797324
2013-04-05,NASDAQ (DQ),1140979962,395919182,551397696,2088296840,34885484158.903681,19333588920.902986,16371111900.602252,70590184980.408919,3200407,621749,1489571,5311727
2013-04-05,EDGA (J),117774964,55002526,55913847,228691337,3226516530.785000,2522130227.763398,1515631587.443901,7264278345.992299,755357,179567,333937,1268861
2013-04-05,EDGX (K),219628378,87529191,124577953,431735522,7208609622.601611,4562669135.404095,3909623703.442487,15680902461.448193,1221350,254018,600478,2075846
2013-04-05,CHX (M),10413643,8772503,2499443,21685589,360114727.201000,794746521.507500,157802995.938200,1312664244.646700,534,1941,1514,3989
2013-04-05,NYSE (N),725545687,0,0,725545687,23864378215.735623,0.000000,0.000000,23864378215.735623,1865723,0,0,1865723
2013-04-05,NYSE Arca (P),323510107,267058580,154685398,745254085,10610568340.023011,16063523139.224902,5719040662.041896,32393132141.289809,1837635,567574,835363,3240572
2013-04-05,NASDAQ (Q),436081360,194474507,418190908,1048746775,14344954024.087916,12042144102.747003,14030470145.717135,40417568272.552054,2600185,596935,1760131,4957251
2013-04-05,CBSX (W),14598198,7796527,6411895,28806620,394968827.770000,391966417.032500,159468877.520000,946404122.322500,88184,13611,38881,140676
2013-04-05,NASDAQ PSX (X),16346819,18023945,13126509,47497273,377528011.620000,1131573439.440000,318294943.785000,1827396394.845000,65788,41282,35624,142694
2013-04-05,BATS BYX (Y),70950339,32884550,33866961,137701850,2049704324.425002,1707870277.703998,976474888.170800,4734049490.299800,485783,127141,215126,828050
2013-04-05,BATS BZX (Z),264719844,150866529,159248813,574835186,7944183754.027503,8953445494.872901,4979253912.832183,21876883161.732587,1592168,427748,851144,2871060
2013-04-04,NYSE MKT (A),0,8766088,8296746,17062834,0.000000,63841013.365200,158830451.416000,222671464.781200,0,22545,27016,49561
2013-04-04,NASDAQ BX (B),81736614,29749873,37762020,149248507,2436393029.352605,1502914427.184999,1210957849.449002,5150265305.986606,533454,104163,244839,882456
2013-04-04,NSX (C),9349550,4875694,6241513,20466757,253501411.957400,172569717.583900,156644921.731200,582716051.272500,37373,9480,19728,66581
2013-04-04,NYSE (DN),77689905,21621407,35421740,134733052,2537514439.627108,1098384663.261400,1201495113.978907,4837394216.867415,469264,84869,194579,748712
2013-04-04,NASDAQ (DQ),1144847285,386428874,528774793,2060050952,35440777551.614366,18712671584.535816,14803838590.520528,68957287726.670710,3101583,560465,1358262,5020310
2013-04-04,EDGA (J),111368433,49308513,48378297,209055243,2997181251.171203,2184439674.628499,1291830783.497098,6473451709.296800,715703,167479,290337,1173519
2013-04-04,EDGX (K),209272333,80500830,115057498,404830661,7101121737.454191,3963681030.441103,3638090678.403715,14702893446.299009,1184687,230932,556611,1972230
2013-04-04,CHX (M),12773139,7711240,3321789,23806168,476704181.115800,709622474.061900,124625989.006000,1310952644.183700,360,1425,1314,3099
2013-04-04,NYSE (N),646948351,0,0,646948351,21837436443.821158,0.000000,0.000000,21837436443.821158,1774538,0,0,1774538
2013-04-04,NYSE Arca (P),304805579,229775883,138422986,673004448,10042054056.485791,13413901566.867824,4910487783.240502,28366443406.594117,1787113,516427,767312,3070852
2013-04-04,NASDAQ (Q),403318661,168079366,371361063,942759090,13855612745.501596,10405308317.833992,12069172812.358135,36330093875.693723,2480725,541912,1608221,4630858
2013-04-04,CBSX (W),13813959,4536985,4961743,23312687,368938783.320000,248786007.822500,123801527.030000,741526318.172500,85998,11527,33493,131018
2013-04-04,NASDAQ PSX (X),15151965,14650985,12036750,41839700,359088290.995000,881680705.690000,275834795.060000,1516603791.745000,62367,33787,32378,128532
2013-04-04,BATS BYX (Y),68301369,29242540,31381608,128925517,1936395750.487001,1485423526.216799,804492037.623899,4226311314.327699,462552,115045,189580,767177
2013-04-04,BATS BZX (Z),257434839,134991627,146903663,539330129,7929143929.833316,8095500539.157194,4401524948.841104,20426169417.831614,1577583,403494,785055,2766132
2013-04-03,NYSE MKT (A),0,10488719,10778976,21267695,0.000000,75714332.223400,189765994.128000,265480326.351400,0,26002,30441,56443
2013-04-03,NASDAQ BX (B),96962896,35994267,48453362,181410525,2840654588.620000,1928910488.193500,1433227463.890599,6202792540.704099,640727,128317,312857,1081901
2013-04-03,NSX (C),13232943,5674091,8204131,27111165,346924004.625200,213890836.290900,194737888.222100,755552729.138200,51604,10865,27471,89940
2013-04-03,NYSE (DN),98745069,26663744,44092218,169501031,3071614111.325204,1395212298.008100,1409040580.376703,5875866989.710007,574779,102471,244650,921900
2013-04-03,NASDAQ (DQ),1283808133,436776995,631167691,2351752819,37647091150.500811,20138127937.158323,17094693346.444983,74879912434.104117,3907421,666236,1729501,6303158
2013-04-03,EDGA (J),135337993,53199158,62276672,250813823,3692280453.817101,2557875692.280300,1598181227.188397,7848337373.285798,875287,184409,374642,1434338
2013-04-03,EDGX (K),281342980,92982613,143301963,517627556,9477804553.854825,4800418068.179303,4402080325.327100,18680302947.361228,1530607,275108,690731,2496446
2013-04-03,CHX (M),9530210,14761191,3624825,27916226,360613485.088100,795687789.944200,251472023.499800,1407773298.532100,270,1945,1554,3769
2013-04-03,NYSE (N),811551245,0,0,811551245,26960847758.489279,0.000000,0.000000,26960847758.489279,2150639,0,0,2150639
2013-04-03,NYSE Arca (P),380108011,253248610,174605124,807961745,12614393754.151280,14997760826.850614,5759223358.270795,33371377939.272689,2150066,598647,940938,3689651
2013-04-03,NASDAQ (Q),526107905,199031865,464261526,1189401296,18123251203.217692,12376740787.293322,14180799829.158592,44680791819.669606,3183032,626533,1991330,5800895
2013-04-03,CBSX (W),16134997,7930370,6084127,30149494,458243692.640000,345753291.457500,146437969.280000,950434953.377500,100771,15243,39584,155598
2013-04-03,NASDAQ PSX (X),19649552,20973653,16486989,57110194,455287245.490000,1244212208.600000,343870777.090000,2043370231.180000,77914,44327,45482,167723
2013-04-03,BATS BYX (Y),82891825,30373508,37802058,151067391,2336738406.687597,1507577980.215000,983269698.128801,4827586085.031398,561312,112798,243882,917992
2013-04-03,BATS BZX (Z),310289401,154230483,175678077,640197961,9503452683.107707,9323501384.569513,5079586297.392599,23906540365.069819,1859146,458142,947474,3264762
2013-04-02,NYSE MKT (A),0,9897406,8279154,18176560,0.000000,60363471.290500,159135036.758000,219498508.048500,0,19830,25213,45043
2013-04-02,NASDAQ BX (B),80915084,27797162,43646663,152358909,2348980736.327998,1394549553.903400,1387624317.727201,5131154607.958599,533343,95759,269454,898556
2013-04-02,NSX (C),10091738,4806067,6913442,21811247,270382704.199700,172984174.091100,175430732.621400,618797610.912200,40522,8274,22182,70978
2013-04-02,NYSE (DN),84259486,18304841,40976368,143540695,2907078239.812996,944619282.171799,1474876411.721194,5326573933.705989,491302,73744,228794,793840
2013-04-02,NASDAQ (DQ),1111935667,334159350,577472447,2023567464,33466772722.704755,15615490541.780403,17654352363.171925,66736615627.657083,3341728,531107,1571738,5444573
2013-04-02,EDGA (J),113360716,48099884,54312301,215772901,3187995587.509198,2004935601.139301,1597749559.326504,6790680747.975003,746965,137561,343390,1227916
2013-04-02,EDGX (K),209831913,67284717,120272234,397388864,7054254397.560330,3319763205.506801,4021081418.980011,14395099022.047142,1187141,188153,589608,1964902
2013-04-02,CHX (M),14308587,6236799,3325276,23870662,534480808.839100,557646471.760900,152364386.642500,1244491667.242500,432,1307,1363,3102
2013-04-02,NYSE (N),639449115,0,0,639449115,21461636833.468085,0.000000,0.000000,21461636833.468085,1720365,0,0,1720365
2013-04-02,NYSE Arca (P),307382922,209531396,153348579,670262897,10276685830.438288,11531313511.093305,5608505864.046229,27416505205.577822,1744989,413724,832827,2991540
2013-04-02,NASDAQ (Q),389539630,142388078,382251235,914178943,13520527033.807306,8460397539.517189,13039322543.741021,35020247117.065516,2348093,427647,1703380,4479120
2013-04-02,CBSX (W),14272704,8713091,5875322,28861117,402867522.380000,375806601.860000,155847108.020000,934521232.260000,95139,10878,38628,144645
2013-04-02,NASDAQ PSX (X),16154640,13585237,12502286,42242163,376613142.890000,879997933.970000,322180315.060000,1578791391.920000,66937,32159,39194,138290
2013-04-02,BATS BYX (Y),69686516,23396189,32723294,125805999,1974994400.035801,1066296937.987400,906806418.628000,3948097756.651201,474955,85454,214822,775231
2013-04-02,BATS BZX (Z),251932516,117387467,150227013,519546996,7966188957.859701,6688284587.751197,4736982670.935813,19391456216.546711,1552001,320094,844904,2716999
2013-04-01,NYSE MKT (A),0,9673490,7569167,17242657,0.000000,59083139.224600,139556107.545400,198639246.770000,0,19537,23887,43424
2013-04-01,NASDAQ BX (B),69886816,24667532,41081871,135636219,2061082688.566499,1293565528.578500,1334725907.289099,4689374124.434098,472685,84270,263606,820561
2013-04-01,NSX (C),9583468,4941369,7433287,21958124,239095480.433800,182823523.598500,174663640.816300,596582644.848600,36261,9019,23711,68991
2013-04-01,NYSE (DN),72815423,15921617,38150346,126887386,2303905167.661903,853216704.229498,1408458347.259606,4565580219.151007,443186,71528,227963,742677
2013-04-01,NASDAQ (DQ),851598281,333913081,513260162,1698771524,24235899113.154271,16888671974.301492,14390210334.541576,55514781421.997339,2738837,529286,1459632,4727755
2013-04-01,EDGA (J),91882024,37400529,48733681,178016234,2456486689.585401,1780051133.645499,1334344006.694197,5570881829.925097,599923,122015,308702,1030640
2013-04-01,EDGX (K),178183528,60705909,118393921,357283358,5747575810.352001,2841033886.367105,3625488478.099512,12214098174.818618,1011059,164891,574982,1750932
2013-04-01,CHX (M),6131821,3701237,2316135,12149193,258408233.414400,347107759.130000,106911384.749000,712427377.293400,322,1076,1175,2573
2013-04-01,NYSE (N),572993742,0,0,572993742,19028462392.311734,0.000000,0.000000,19028462392.311734,1643676,0,0,1643676
2013-04-01,NYSE Arca (P),252366374,184737235,137867969,574971578,8240260766.811597,12072761392.802593,4868552941.856013,25181575101.470203,1480100,390929,795381,2666410
2013-04-01,NASDAQ (Q),340073958,121144219,381850467,843068644,11545356046.070191,7339393474.363184,11994749968.599738,30879499489.033113,2090702,372679,1688175,4151556
2013-04-01,CBSX (W),11511719,5522551,6139194,23173464,320834768.050000,242432501.936300,177793568.670000,741060838.656300,78202,10497,37578,126277
2013-04-01,NASDAQ PSX (X),12591534,10037889,10667570,33296993,305774867.800000,679687948.395000,265102979.911400,1250565796.106400,54365,23940,33635,111940
2013-04-01,BATS BYX (Y),65002541,20828954,32103403,117934898,1810669065.219999,988670839.706500,857873119.770400,3657213024.696899,455430,77229,212470,745129
2013-04-01,BATS BZX (Z),218555344,96293228,144912220,459760792,6650545202.339794,6215610187.872490,4350835496.574109,17216990886.786393,1331688,277802,808532,2418022
2013-03-28,NYSE MKT (A),0,10428824,8358568,18787392,0.000000,86941427.171400,148878575.632500,235820002.803900,0,21889,25959,47848
2013-03-28,NASDAQ BX (B),81993520,23079471,40826466,145899457,2438549615.588205,1181747873.835000,1364669890.199999,4984967379.623204,526557,79770,266710,873037
2013-03-28,NSX (C),9283371,3337084,6905147,19525602,255684897.078300,135039705.644600,180919241.984600,571643844.707500,36336,7091,21868,65295
2013-03-28,NYSE (DN),81521236,16730721,40170673,138422630,2694586731.772700,897016295.168403,1424522840.810492,5016125867.751595,494406,75688,236211,806305
2013-03-28,NASDAQ (DQ),1028117579,283630682,597058467,1908806728,30714217081.760348,13093920560.825805,17128006548.674983,60936144191.261136,2846916,468749,1445244,4760909
2013-03-28,EDGA (J),102667641,34806825,52275282,189749748,3052099643.339002,1680948227.761701,1449735002.667998,6182782873.768701,678384,117791,319835,1116010
2013-03-28,EDGX (K),193497221,60627395,140400590,394525206,6695413256.042808,2905224259.600607,4269910054.218186,13870547569.861601,1074740,164426,597381,1836547
2013-03-28,CHX (M),7325248,6890143,6356916,20572307,249755889.675500,455993837.517900,263027807.952000,968777535.145400,318,713,1130,2161
2013-03-28,NYSE (N),886806480,0,0,886806480,31842418220.999637,0.000000,0.000000,31842418220.999637,1674907,0,0,1674907
2013-03-28,NYSE Arca (P),268981568,170401048,138302631,577685247,9034395066.711426,10592098052.386001,4934661862.827206,24561154981.924633,1491427,369246,747536,2608209
2013-03-28,NASDAQ (Q),352747201,110768243,438235960,901751404,12275152224.475385,6829279866.290516,14185904951.167187,33290337041.933088,2053998,358284,1509257,3921539
2013-03-28,CBSX (W),11585483,9431934,5458586,26476003,350560674.990000,388451594.610000,134397175.240000,873409444.840000,77042,8662,33957,119661
2013-03-28,NASDAQ PSX (X),14592465,10070441,12486273,37149179,331437966.335000,706161312.370000,273781499.990000,1311380778.695000,53551,24273,32147,109971
2013-03-28,BATS BYX (Y),61827217,18192971,29405823,109426011,1765061781.553998,863547277.695000,766207066.473300,3394816125.722298,413099,64773,185601,663473
2013-03-28,BATS BZX (Z),229211712,94491391,141091626,464794729,7331115664.417194,6091307413.983099,4256876459.824312,17679299538.224605,1377522,268298,747878,2393698
2013-03-27,NYSE MKT (A),0,9072552,8264351,17336903,0.000000,62594923.344900,159993837.830000,222588761.174900,0,19184,24428,43612
2013-03-27,NASDAQ BX (B),74939502,23837794,40061927,138839223,2265996955.422002,1225979718.300700,1331313512.814801,4823290186.537503,504226,83658,258050,845934
2013-03-27,NSX (C),7659313,3866332,6373226,17898871,211897076.836200,140841282.355200,158637769.677000,511376128.868400,31697,7744,19381,58822
2013-03-27,NYSE (DN),81696148,16145168,37262975,135104291,2678240693.032396,906193888.167999,1287544483.090510,4871979064.290905,496221,69341,222813,788375
2013-03-27,NASDAQ (DQ),918891683,282288248,501363890,1702543821,27435456479.201237,13300320328.068476,14403224161.437400,55139000968.707113,2745320,469108,1374271,4588699
2013-03-27,EDGA (J),101855618,36823723,50631562,189310903,2865452778.262298,1726181444.239100,1433653857.113800,6025288079.615198,664380,129874,317293,1111547
2013-03-27,EDGX (K),201715258,71556723,129917841,403189822,6819550509.581719,3464407121.245901,4021318724.779927,14305276355.607547,1113934,190996,561253,1866183
2013-03-27,CHX (M),6245146,4725186,3582429,14552761,225159986.121000,320333826.222800,117426182.240400,662919994.584200,222,905,1186,2313
2013-03-27,NYSE (N),596280610,0,0,596280610,19539030082.170990,0.000000,0.000000,19539030082.170990,1622759,0,0,1622759
2013-03-27,NYSE Arca (P),259470274,155685311,128260939,543416524,8668710434.844411,9213376671.294889,4522030324.439181,22404117430.578481,1489950,379424,697526,2566900
2013-03-27,NASDAQ (Q),354163590,122149882,329063665,805377137,12153984039.116963,7469618439.498419,10590450418.385015,30214052897.000397,2113604,399679,1482648,3995931
2013-03-27,CBSX (W),13673701,2846108,6179198,22699007,378296164.970000,154403525.310000,157924744.120000,690624434.400000,90043,9338,36341,135722
2013-03-27,NASDAQ PSX (X),14882805,12427041,13964246,41274092,311181972.615000,828715498.950000,311018093.490000,1450915565.055000,54360,30790,35556,120706
2013-03-27,BATS BYX (Y),60138815,18274683,28183543,106597041,1672666160.594999,889411100.005400,758065364.802401,3320142625.402800,405700,69908,185122,660730
2013-03-27,BATS BZX (Z),224119629,95004338,139847088,458971055,6877121039.060484,5903855967.727012,4154744852.914702,16935721859.702198,1334123,285531,734378,2354032
2013-03-26,NYSE MKT (A),0,9076600,8095067,17171667,0.000000,74093447.119800,138163342.697000,212256789.816800,0,17115,23070,40185
2013-03-26,NASDAQ BX (B),70963027,25362023,40506924,136831974,2078075882.556901,1163177347.519999,1144220937.361502,4385474167.438402,459524,87074,239547,786145
2013-03-26,NSX (C),9058546,3778827,5962111,18799484,247664704.161700,124050788.993500,135607927.445200,507323420.600400,34598,7393,20348,62339
2013-03-26,NYSE (DN),79118803,16833586,40551849,136504238,2609249635.119307,854751794.655200,1194147262.149902,4658148691.924409,503684,72741,224319,800744
2013-03-26,NASDAQ (DQ),957543495,290233089,525862443,1773639027,29656752952.842781,11870297059.866236,14033727102.053929,55560777114.762946,2938948,458179,1424440,4821567
2013-03-26,EDGA (J),100594493,39503799,53279956,193378248,2829282006.666401,1735007553.611399,1346561123.819201,5910850684.097001,649832,120838,317102,1087772
2013-03-26,EDGX (K),200442503,70677262,133604026,404723791,6973397179.503706,3260290160.284904,3996250301.191114,14229937640.979724,1077350,181928,573153,1832431
2013-03-26,CHX (M),6090243,10334692,5231041,21655976,222234878.932000,667587196.178400,211630832.391000,1101452907.501400,491,1046,1326,2863
2013-03-26,NYSE (N),558327367,0,0,558327367,18683927643.153636,0.000000,0.000000,18683927643.153636,1519768,0,0,1519768
2013-03-26,NYSE Arca (P),248824494,170504074,128329988,547658556,8489913038.044977,10022836900.903091,4090826170.869191,22603576109.817259,1422707,366587,684272,2473566
2013-03-26,NASDAQ (Q),346781523,116899003,319017101,782697627,12062184869.187511,6829257002.671299,9726364766.419350,28617806638.278160,2062082,363802,1434904,3860788
2013-03-26,CBSX (W),12617179,4521312,6286064,23424555,383222443.330000,247358800.590000,184095668.600000,814676912.520000,83251,9544,36032,128827
2013-03-26,NASDAQ PSX (X),14599961,12787643,11627642,39015246,375030239.705000,748473156.325000,239260053.340000,1362763449.370000,60350,27980,31062,119392
2013-03-26,BATS BYX (Y),59008724,18766097,29379547,107154368,1701157204.519999,851017477.771600,735203331.889500,3287378014.181099,401354,70108,188645,660107
2013-03-26,BATS BZX (Z),209991822,97317094,139436501,446745417,6640455344.363791,5609135148.780903,3747753432.096509,15997343925.241203,1262328,269388,719670,2251386
2013-03-25,NYSE MKT (A),0,8358265,8965005,17323270,0.000000,53020039.324700,162921777.971000,215941817.295700,0,18172,25831,44003
2013-03-25,NASDAQ BX (B),77188362,29992511,44288061,151468934,2213673486.078998,1603669293.394599,1299047670.576999,5116390450.050596,491682,108087,273082,872851
2013-03-25,NSX (C),10017004,5216743,6952657,22186404,262360787.441300,188150534.666800,173710761.648300,624222083.756400,38330,9063,23953,71346
2013-03-25,NYSE (DN),84577222,18086007,42126957,144790186,2745318394.460301,1052788660.590801,1381174997.553696,5179282052.604798,515460,77371,243589,836420
2013-03-25,NASDAQ (DQ),1007818573,345168418,601775465,1954762456,30618198446.322026,16869182258.033607,17575743923.761835,65063124628.117468,2953669,528773,1566042,5048484
2013-03-25,EDGA (J),115239026,47225505,58763415,221227946,3128319138.287202,2217613070.014399,1587127649.185100,6933059857.486701,735212,160954,359259,1255425
2013-03-25,EDGX (K),221033163,93295351,152783028,467111542,7445343105.524715,4785301572.844402,4813248250.518094,17043892928.887211,1190215,246132,670625,2106972
2013-03-25,CHX (M),5683632,15049282,3255405,23988319,201274650.284100,1360482791.410000,133951606.300000,1695709047.994100,276,1393,1302,2971
2013-03-25,NYSE (N),655496571,0,0,655496571,22439869698.713626,0.000000,0.000000,22439869698.713626,1738609,0,0,1738609
2013-03-25,NYSE Arca (P),289117056,212989273,154886116,656992445,9823642222.908713,13392158179.298028,5548684779.657701,28764485181.864442,1665010,510365,831696,3007071
2013-03-25,NASDAQ (Q),402451208,152074356,393364351,947889915,14181871724.989983,9127541155.582308,12715543236.743085,36024956117.315376,2429881,471052,1706693,4607626
2013-03-25,CBSX (W),11842402,5158985,5913546,22914933,338165564.640000,261032957.510000,156226904.180000,755425426.330000,76629,10697,36373,123699
2013-03-25,NASDAQ PSX (X),14087209,14718531,11998938,40804678,343996830.620000,940783832.115000,274948299.525000,1559728962.260000,54992,32913,33899,121804
2013-03-25,BATS BYX (Y),60451884,22575405,30292804,113320093,1726095086.929200,1182514534.303900,822624424.780000,3731234046.013100,401300,87843,197782,686925
2013-03-25,BATS BZX (Z),223693232,128613303,153829025,506135560,7311972706.492203,8197685692.861401,4722237077.766894,20231895477.120498,1362492,355385,806201,2524078
2013-03-22,NYSE MKT (A),0,8765183,10272075,19037258,0.000000,59167612.136700,190229016.696000,249396628.832700,0,17618,29331,46949
2013-03-22,NASDAQ BX (B),70603390,21821589,42769651,135194630,2035030488.046398,1114271378.795100,1294948737.530003,4444250604.371501,439259,75911,265685,780855
2013-03-22,NSX (C),9322668,3324672,8173841,20821181,237632810.854800,152262463.589600,155943370.458800,545838644.903200,34286,6229,22371,62886
2013-03-22,NYSE (DN),77928005,14009558,44211006,136148569,2657861531.584593,745600995.845099,1415220329.522398,4818682856.952090,494317,61000,239350,794667
2013-03-22,NASDAQ (DQ),1015921087,253482163,662193476,1931596726,30670319135.383707,11694649297.966753,17632457404.016331,59997425837.366791,2790446,426134,1537647,4754227
2013-03-22,EDGA (J),103863816,38207759,58902540,200974115,2813580276.730404,1728062371.805200,1520831931.214598,6062474579.750202,663648,120963,350092,1134703
2013-03-22,EDGX (K),190054381,65547815,145174295,400776491,6240347868.806898,3142475147.362301,4258460761.535595,13641283777.704794,1006878,171317,601726,1779921
2013-03-22,CHX (M),6923870,9448432,3620594,19992896,234986592.726000,563106442.084500,155403963.419400,953496998.229900,176,693,1714,2583
2013-03-22,NYSE (N),620363764,0,0,620363764,21508956101.124700,0.000000,0.000000,21508956101.124700,1530534,0,0,1530534
2013-03-22,NYSE Arca (P),255655838,174942684,157724577,588323099,8529785642.886692,11476874080.167306,5380902390.371300,25387562113.425298,1434264,361334,802076,2597674
2013-03-22,NASDAQ (Q),328464324,105277940,372169369,805911633,11377478019.794532,6716372724.684397,11562551380.063404,29656402124.542333,1971515,326313,1536875,3834703
2013-03-22,CBSX (W),11693129,2664482,5756354,20113965,327561810.830000,137653694.360000,140470183.030000,605685688.220000,74693,8480,36938,120111
2013-03-22,NASDAQ PSX (X),14108178,10761832,12563382,37433392,326854916.875000,661790039.400000,267277794.425000,1255922750.700000,56685,25431,34087,116203
2013-03-22,BATS BYX (Y),54838751,17891940,28916957,101647648,1484893009.604400,879703059.315400,729479484.895500,3094075553.815300,357007,61881,175169,594057
2013-03-22,BATS BZX (Z),202960672,99339701,156172623,458472996,6381849361.443297,6404660332.884596,4549911451.247080,17336421145.574973,1233644,279525,803410,2316579
2013-03-21,NYSE MKT (A),0,7833955,10352733,18186688,0.000000,50967764.506300,203046696.925200,254014461.431500,0,18001,29345,47346
2013-03-21,NASDAQ BX (B),71897172,27710901,40221109,139829182,2081089358.459999,1460021614.394999,1243252702.570802,4784363675.425800,461497,97023,250646,809166
2013-03-21,NSX (C),12060073,3880478,7418572,23359123,280574069.909100,158742820.135300,157133688.911800,596450578.956200,39976,7313,22776,70065
2013-03-21,NYSE (DN),91994834,17089071,47337486,156421391,3140722671.724387,976087028.649000,1573272540.181003,5690082240.554390,574020,73815,266506,914341
2013-03-21,NASDAQ (DQ),1057280660,313746275,640208891,2011235826,31523240756.021642,14568680538.404606,17393692031.422967,63485613325.849215,3039342,491297,1576910,5107549
2013-03-21,EDGA (J),120331207,45146775,62835565,228313547,3296723803.405600,2115368967.817698,1635813448.237899,7047906219.461197,773330,148545,358089,1279964
2013-03-21,EDGX (K),215937215,81164717,143904239,441006171,6830834785.033796,4053947399.345805,4388587729.942003,15273369914.321604,1136970,218316,623569,1978855
2013-03-21,CHX (M),6795625,7605522,4060765,18461912,212715657.168800,568947661.180000,206545932.244000,988209250.592800,323,1051,1349,2723
2013-03-21,NYSE (N),652170377,0,0,652170377,22052145203.015917,0.000000,0.000000,22052145203.015917,1718392,0,0,1718392
2013-03-21,NYSE Arca (P),299292687,208435430,160139204,667867321,9817558517.435173,12443401659.510377,5636880092.937447,27897840269.882997,1670948,462703,822056,2955707
2013-03-21,NASDAQ (Q),395766716,133911662,377370557,907048935,13529069800.796579,7914515589.469891,12067934268.725258,33511519658.991728,2371517,418999,1586386,4376902
2013-03-21,CBSX (W),11661229,6611643,5679374,23952246,337029138.990000,300146970.490000,143693736.920000,780869846.400000,76005,9860,35271,121136
2013-03-21,NASDAQ PSX (X),14357660,13342537,12482042,40182239,359109637.540000,804154479.220000,260003697.405000,1423267814.165000,61049,32137,35398,128584
2013-03-21,BATS BYX (Y),61424825,20741908,29307329,111474062,1735375567.816499,1124497415.973000,775972024.949999,3635845008.739498,406113,76750,181589,664452
2013-03-21,BATS BZX (Z),245956495,125562424,160135222,531654141,7724009864.301782,7744462510.525580,4690334449.389111,20158806824.216473,1488149,355031,812671,2655851
2013-03-20,NYSE MKT (A),0,6783981,9471007,16254988,0.000000,44886430.112700,169541792.927500,214428223.040200,0,16228,30768,46996
2013-03-20,NASDAQ BX (B),78788179,25652692,38838798,143279669,2300461879.865004,1357768402.905000,1153373741.215501,4811604023.985505,496841,88487,249443,834771
2013-03-20,NSX (C),10096885,3585750,8302377,21985012,286505874.011900,139574571.815100,157040548.739400,583120994.566400,38691,6767,23508,68966
2013-03-20,NYSE (DN),93295401,17702758,41728044,152726203,3091568882.687766,984967523.049502,1366267611.720101,5442804017.457369,551771,78912,239976,870659
2013-03-20,NASDAQ (DQ),1127276487,333642573,587429259,2048348319,32669484608.386444,15597618713.607238,15333166305.800633,63600269627.794315,3148920,476381,1480721,5106022
2013-03-20,EDGA (J),123284142,45567132,58217984,227069258,3375240311.455107,2039829714.751100,1526752163.158298,6941822189.364505,781412,144218,353488,1279118
2013-03-20,EDGX (K),216777230,75961601,148531408,441270239,7151904312.269974,3524234618.054707,4140583049.267989,14816721979.592670,1158260,197087,638803,1994150
2013-03-20,CHX (M),13954589,5781283,4287833,24023705,357446999.268200,480771939.240000,158084819.362000,996303757.870200,238,1369,1297,2904
2013-03-20,NYSE (N),672952046,0,0,672952046,22537080723.730104,0.000000,0.000000,22537080723.730104,1702859,0,0,1702859
2013-03-20,NYSE Arca (P),295754707,193256123,152989345,642000175,9645384880.617212,11666885113.659116,5104335246.660092,26416605240.936420,1636483,436789,784947,2858219
2013-03-20,NASDAQ (Q),395657991,130722037,362335569,888715597,13474207860.156060,7847061440.217597,11323721089.781461,32644990390.155118,2315665,408645,1534838,4259148
2013-03-20,CBSX (W),14990950,4840408,6639938,26471296,395867032.970000,220347690.160000,160912044.880000,777126768.010000,89767,11083,41144,141994
2013-03-20,NASDAQ PSX (X),17307071,12679302,13204231,43190604,429473075.700000,778197679.790000,276000994.605000,1483671750.095000,71095,32030,37936,141061
2013-03-20,BATS BYX (Y),59705368,18914609,28669340,107289317,1638315894.135001,930135758.291300,712572654.292300,3281024306.718601,393238,72157,181923,647318
2013-03-20,BATS BZX (Z),239714049,119015869,146321176,505051094,7446054230.791016,7290001636.422901,4227105101.260314,18963160968.474231,1443847,334369,783509,2561725
2013-03-19,NYSE MKT (A),0,8600114,9236232,17836346,0.000000,58415596.473700,170072228.943500,228487825.417200,0,21139,31696,52835
2013-03-19,NASDAQ BX (B),89396215,39128423,41990679,170515317,2478541975.271000,2040941285.020001,1442616426.123902,5962099686.414903,545526,132526,271685,949737
2013-03-19,NSX (C),12855546,5140527,7919146,25915219,317752457.159800,231086560.528900,164099602.450400,712938620.139100,43380,9769,25352,78501
2013-03-19,NYSE (DN),110446820,25891415,47390030,183728265,3477633707.059903,1431330639.872307,1710821416.758196,6619785763.690406,651277,109104,279314,1039695
2013-03-19,NASDAQ (DQ),1195740827,403669966,590722305,2190133098,34316290973.806938,18475055016.665047,17172971620.066571,69964317610.538556,3488445,633326,1610273,5732044
2013-03-19,EDGA (J),149495344,67642023,66399550,283536917,3972633557.663802,3034311021.835896,1846463697.829302,8853408277.329000,930970,213069,413382,1557421
2013-03-19,EDGX (K),255225784,113264776,155773884,524264444,7977009332.388303,5455618366.685101,4678628010.162179,18111255709.235583,1344075,299406,691726,2335207
2013-03-19,CHX (M),11559252,10259949,3931998,25751199,305148777.460000,796284325.223000,189415477.764400,1290848580.447400,441,1424,1394,3259
2013-03-19,NYSE (N),731685487,0,0,731685487,23731718146.233701,0.000000,0.000000,23731718146.233701,1998481,0,0,1998481
2013-03-19,NYSE Arca (P),359809943,262227960,167072438,789110341,11487955434.796115,15612858901.161277,6249661672.508690,33350476008.466082,1949953,610021,899025,3458999
2013-03-19,NASDAQ (Q),477233222,199262012,389499500,1065994734,15665056829.389516,12169191384.120415,12769643611.709582,40603891825.219513,2740070,611426,1801361,5152857
2013-03-19,CBSX (W),15108957,4287240,6899132,26295329,433778275.970000,218182460.390000,183700678.230000,835661414.590000,96453,14292,42636,153381
2013-03-19,NASDAQ PSX (X),20131200,21820868,15521913,57473981,463517571.650000,1363857473.695000,352824558.725000,2180199604.070000,84700,51049,44389,180138
2013-03-19,BATS BYX (Y),74450819,31746261,30696105,136893185,1983830257.349999,1514186163.035100,869710092.759100,4367726513.144199,486669,114956,199970,801595
2013-03-19,BATS BZX (Z),293546134,180918595,169347348,643812077,8853878427.474802,10945232775.540896,5302695666.879206,25101806869.894904,1742657,521884,920395,3184936
2013-03-18,NYSE MKT (A),0,11488989,9747655,21236644,0.000000,69497913.284500,186200517.915000,255698431.199500,0,24007,32706,56713
2013-03-18,NASDAQ BX (B),75915906,30862376,37756851,144535133,2098776062.704900,1595702762.537500,1273015126.663398,4967493951.905798,482887,101165,250299,834351
2013-03-18,NSX (C),11176651,3921577,7080229,22178457,303764554.773200,171103544.057400,173379940.366200,648248039.196800,42734,8597,23896,75227
2013-03-18,NYSE (DN),89831560,25015997,45881297,160728854,2863813286.010305,1296147287.985898,1607788513.334594,5767749087.330797,566087,102649,265143,933879
2013-03-18,NASDAQ (DQ),959099148,340688628,553712796,1853500572,27442889090.208375,15108833101.379161,17409577921.855557,59961300113.443093,3021690,530966,1501953,5054609
2013-03-18,EDGA (J),122444178,53319380,61851274,237614832,3330366511.677198,2450800481.043402,1760541693.325199,7541708686.045799,798227,167139,375360,1340726
2013-03-18,EDGX (K),209576026,88111576,140229718,437917320,6743032285.886112,4126079164.140194,4631157660.488202,15500269110.514508,1132940,233739,630351,1997030
2013-03-18,CHX (M),8401044,10845922,4340087,23587053,316731865.355800,861347913.250000,287816956.939500,1465896735.545300,217,1128,1308,2653
2013-03-18,NYSE (N),676189725,0,0,676189725,22663432911.208243,0.000000,0.000000,22663432911.208243,1696211,0,0,1696211
2013-03-18,NYSE Arca (P),295010194,217917909,137304164,650232267,9534991036.116300,13304391889.415796,5255673150.202694,28095056075.734790,1646412,474653,746362,2867427
2013-03-18,NASDAQ (Q),384528727,149096026,367356748,900981501,12599674394.793301,9269852222.768805,12360166443.996749,34229693061.558855,2229933,454085,1569029,4253047
2013-03-18,CBSX (W),13644719,3396796,6828610,23870125,382007583.100000,179351273.270000,153370711.410000,714729567.780000,88630,11271,44761,144662
2013-03-18,NASDAQ PSX (X),17370690,16104131,12459203,45934024,409565278.845000,959844362.730000,286595555.735000,1656005197.310000,74390,38390,39531,152311
2013-03-18,BATS BYX (Y),62433851,22231298,27742305,112407454,1690861644.909998,1133631132.544999,749655340.760301,3574148118.215298,418954,79640,183369,681963
2013-03-18,BATS BZX (Z),240288643,136258005,150601596,527148244,7306683895.510507,8028314668.727708,4712826330.788602,20047824895.026817,1469497,392814,813746,2676057
2013-03-15,NYSE MKT (A),0,36516338,9842552,46358890,0.000000,227514925.896400,183970305.994200,411485231.890600,0,28505,28953,57458
2013-03-15,NASDAQ BX (B),96560278,32443195,42455821,171459294,2536054087.027201,1510714822.700300,1439688912.330605,5486457822.058106,542184,91475,263813,897472
2013-03-15,NSX (C),12633024,3993534,8273394,24899952,328014938.671500,187640392.017600,187635474.540900,703290805.230000,50837,7795,27881,86513
2013-03-15,NYSE (DN),112487687,22544831,49029895,184062413,3302195648.357785,1157190531.556400,1744278124.328598,6203664304.242783,654468,86461,282694,1023623
2013-03-15,NASDAQ (DQ),1428363787,350886277,775056380,2554306444,39355751261.669765,15649508268.320777,24138392449.712999,79143651979.703541,3575357,503897,1662018,5741272
2013-03-15,EDGA (J),151967287,46131071,65983014,264081372,3823307225.019406,2179056100.125400,1812323699.996504,7814687025.141310,908896,146520,397041,1452457
2013-03-15,EDGX (K),251544482,70226902,148487004,470258388,7814004918.413299,3495668729.230502,4971683607.981812,16281357255.625613,1255529,199545,645083,2100157
2013-03-15,CHX (M),10346338,11291603,5271695,26909636,333498630.550200,714750126.417600,196442354.465000,1244691111.432800,272,771,1472,2515
2013-03-15,NYSE (N),1825203082,0,0,1825203082,63917573828.613705,0.000000,0.000000,63917573828.613705,1978926,0,0,1978926
2013-03-15,NYSE Arca (P),375339199,215844498,153091272,744274969,11517308379.856011,14919579997.593100,6140096555.716281,32576984933.165392,1892473,411732,814836,3119041
2013-03-15,NASDAQ (Q),448534586,122266832,892871473,1463672891,14238248673.026309,7832674296.307877,28791430891.496342,50862353860.830528,2423177,374545,1748027,4545749
2013-03-15,CBSX (W),18486448,5309160,9265492,33061100,510083934.240000,331014738.570000,212374877.690000,1053473550.500000,113803,11989,50456,176248
2013-03-15,NASDAQ PSX (X),23720468,13044178,14253366,51018012,549776764.750000,824285403.485000,344586472.990000,1718648641.225000,91054,29935,43070,164059
2013-03-15,BATS BYX (Y),77886158,20328661,32866995,131081814,2038056574.381801,1019129007.750000,877391298.783801,3934576880.915602,493560,70168,207649,771377
2013-03-15,BATS BZX (Z),303467127,118887641,166903400,589258168,8807652196.136307,7185970605.505706,5191426277.549088,21185049079.191101,1706969,341769,892699,2941437
2013-03-14,NYSE MKT (A),0,8864854,9237322,18102176,0.000000,75817923.825700,166503824.940700,242321748.766400,0,22512,27255,49767
2013-03-14,NASDAQ BX (B),79199641,27822115,41280424,148302180,2344033980.519596,1405575652.301001,1279625204.873698,5029234837.694295,492949,85497,256466,834912
2013-03-14,NSX (C),12129187,4126399,8372764,24628350,328484519.520200,194914602.329700,185075611.690700,708474733.540600,48528,7834,28515,84877
2013-03-14,NYSE (DN),101932776,20047148,45504291,167484215,3227812299.844004,1062064734.052199,1474153438.494097,5764030472.390300,584378,73878,263995,922251
2013-03-14,NASDAQ (DQ),1175565389,336852174,610679251,2123096814,32661553107.678091,18115786628.930571,16747789657.722989,67525129394.331651,3336816,481967,1594155,5412938
2013-03-14,EDGA (J),125258708,40291217,57594344,223144269,3318769282.899895,1922587484.757201,1532991799.827401,6774348567.484497,800570,125422,347991,1273983
2013-03-14,EDGX (K),215807073,62576548,149105500,427489121,6994832201.395095,2915634127.125598,4402295032.060509,14312761360.581202,1132152,176995,617788,1926935
2013-03-14,CHX (M),9907185,24681053,2250797,36839035,318841494.945000,1496312226.323800,78325876.751000,1893479598.019800,237,1138,1467,2842
2013-03-14,NYSE (N),676492774,0,0,676492774,22754468673.462302,0.000000,0.000000,22754468673.462302,1672086,0,0,1672086
2013-03-14,NYSE Arca (P),320582823,166376703,141056939,628016465,10249880019.481842,10098578605.130485,4775958914.743218,25124417539.355545,1718401,363608,750678,2832687
2013-03-14,NASDAQ (Q),390343919,108693380,377084107,876121406,12774080868.978412,6586442959.192596,11791437673.723462,31151961501.894470,2195161,338077,1562288,4095526
2013-03-14,CBSX (W),14948252,5646565,7938303,28533120,440067499.810000,272163930.530000,185493873.730000,897725304.070000,97902,10424,49005,157331
2013-03-14,NASDAQ PSX (X),20757827,13729862,14198146,48685835,490279635.850000,800733712.900000,310491411.520000,1601504760.270000,85722,29527,43107,158356
2013-03-14,BATS BYX (Y),65408585,19525930,30209692,115144207,1816206096.583100,969798232.012001,797958877.054400,3583963205.649501,433999,64492,189404,687895
2013-03-14,BATS BZX (Z),252222558,110732298,164271013,527225869,7841849527.874724,6359705373.707299,4780269666.972807,18981824568.554830,1539790,318156,863143,2721089
2013-03-13,NYSE MKT (A),0,8668685,8446531,17115216,0.000000,56179694.815700,152681217.700000,208860912.515700,0,19631,27917,47548
2013-03-13,NASDAQ BX (B),72171744,22918450,39633815,134724009,2099023428.129802,1143535165.400000,1185211950.915099,4427770544.444901,479302,81174,248468,808944
2013-03-13,NSX (C),11114858,3377977,7704025,22196860,280790001.027800,163443895.186700,168324874.456800,612558770.671300,43652,7248,26438,77338
2013-03-13,NYSE (DN),91393709,18171406,44096477,153661592,2950356206.174390,920670079.429301,1439934058.781401,5310960344.385092,585612,77802,269055,932469
2013-03-13,NASDAQ (DQ),1029190200,307654396,594824540,1931669136,29714052213.890614,15065772429.022256,16261803002.813661,61041627645.726531,3040275,451266,1480374,4971915
2013-03-13,EDGA (J),112841788,35890226,55494661,204226675,3030531851.030402,1654745175.502800,1411140506.832098,6096417533.365300,743142,120667,331266,1195075
2013-03-13,EDGX (K),200959526,61963121,146645105,409567752,6713814547.491179,2784793438.415401,4358113244.142712,13856721230.049292,1070674,167155,610146,1847975
2013-03-13,CHX (M),9347609,8303832,3994519,21645960,278184611.020400,612486541.050000,528810826.482000,1419481978.552400,268,1299,1114,2681
2013-03-13,NYSE (N),584671481,0,0,584671481,19543464971.053811,0.000000,0.000000,19543464971.053811,1589454,0,0,1589454
2013-03-13,NYSE Arca (P),284464490,168094274,143161950,595720714,9162247829.325175,9593715495.931582,4728343985.867596,23484307311.124353,1577162,358693,759269,2695124
2013-03-13,NASDAQ (Q),356599095,106291166,352639080,815529341,11772577639.835984,6196318941.599499,11245933151.642341,29214829733.077824,2102685,334556,1563310,4000551
2013-03-13,CBSX (W),14963957,6108577,6140117,27212651,424017176.440000,284524201.440000,154042379.140000,862583757.020000,97930,10363,42085,150378
2013-03-13,NASDAQ PSX (X),17760277,12738779,14021721,44520777,430534603.790000,736678077.570000,296151135.720000,1463363817.080000,81487,30360,43161,155008
2013-03-13,BATS BYX (Y),60928165,18533775,30934711,110396651,1753355074.211001,889260614.221000,808067870.863100,3450683559.295101,421641,67868,198641,688150
2013-03-13,BATS BZX (Z),233338539,103183096,152827369,489349004,7260708444.203193,5934147831.746104,4553527482.014707,17748383757.964004,1450161,313279,837327,2600767
2013-03-12,NYSE MKT (A),0,8247610,10515434,18763044,0.000000,59540669.318100,186668099.466700,246208768.784800,0,20847,32044,52891
2013-03-12,NASDAQ BX (B),70049929,25116909,37787652,132954490,2033608200.031999,1244902977.131700,1174976380.088201,4453487557.251900,459726,89276,246043,795045
2013-03-12,NSX (C),10713895,4329772,8668009,23711676,307296653.481500,187463621.164300,188850291.534000,683610566.179800,46458,8360,28863,83681
2013-03-12,NYSE (DN),89918239,17612331,42622662,150153232,2916347371.658193,932708845.521202,1464816717.945002,5313872935.124397,548432,79990,249559,877981
2013-03-12,NASDAQ (DQ),1126726176,307546086,627783238,2062055500,33760702495.190545,14357578241.581308,17006963878.925555,65125244615.697408,3106343,504556,1548826,5159725
2013-03-12,EDGA (J),116656758,39865339,58771865,215293962,3085789317.589205,1816993056.959701,1477226541.090203,6380008915.639109,745795,138711,349735,1234241
2013-03-12,EDGX (K),206737346,63515881,154377400,424630627,6840041218.590799,2838074631.220497,4508049618.854693,14186165468.665989,1097879,173082,637089,1908050
2013-03-12,CHX (M),12427100,6851805,2911510,22190415,438881041.812900,685083548.025000,109344030.165500,1233308620.003400,303,1501,1549,3353
2013-03-12,NYSE (N),622431157,0,0,622431157,20630600186.407793,0.000000,0.000000,20630600186.407793,1644945,0,0,1644945
2013-03-12,NYSE Arca (P),299781866,180471483,149197367,629450716,9719343437.361026,10516595531.543080,5100046054.340795,25335985023.244901,1669667,400476,792397,2862540
2013-03-12,NASDAQ (Q),382968047,115567416,380910818,879446281,12675936727.968016,7194023547.508912,12280045702.358795,32150005977.835723,2222509,362027,1622250,4206786
2013-03-12,CBSX (W),13952566,4220357,6367803,24540726,400029786.070000,203409719.610000,153495853.230000,756935358.910000,92116,12558,40145,144819
2013-03-12,NASDAQ PSX (X),18330836,14556800,15089649,47977285,419256336.865000,815579662.240000,307865648.285000,1542701647.390000,75482,32318,40015,147815
2013-03-12,BATS BYX (Y),59724830,20181285,30527464,110433579,1739066362.745001,950856221.415499,820442486.788600,3510365070.949100,407807,71493,191078,670378
2013-03-12,BATS BZX (Z),244950934,114582283,161010332,520543549,7464303272.255617,6594957709.388105,4719501541.251783,18778762522.895505,1485424,341037,866821,2693282
2013-03-11,NYSE MKT (A),0,9401806,10749555,20151361,0.000000,59655088.167200,169650080.142000,229305168.309200,0,21073,30269,51342
2013-03-11,NASDAQ BX (B),68295459,20655799,39041738,127992996,1935977012.860000,957376635.918800,1154740741.850001,4048094390.628801,442504,73140,240800,756444
2013-03-11,NSX (C),10514018,3548532,8766953,22829503,285820586.718800,154280181.357800,186341214.871100,626441982.947700,45652,7810,27754,81216
2013-03-11,NYSE (DN),85206889,16131037,43215650,144553576,2792043150.096800,823441352.417302,1339159307.225596,4954643809.739698,525771,74759,242914,843444
2013-03-11,NASDAQ (DQ),1079702067,314079813,624258395,2018040275,32253678039.488629,14722874217.598405,16565443548.108281,63541995805.195315,3066238,476970,1582089,5125297
2013-03-11,EDGA (J),114544942,36485031,62900412,213930385,2998755618.400602,1566291158.391502,1435661602.445498,6000708379.237602,739461,119582,350750,1209793
2013-03-11,EDGX (K),197499700,55286136,149144188,401930024,6491911895.414394,2404149870.417100,4118524549.513294,13014586315.344788,1054295,152675,595786,1802756
2013-03-11,CHX (M),10059906,5807006,2080004,17946916,271388700.789900,452040347.571200,85936887.848800,809365936.209900,253,1241,1805,3299
2013-03-11,NYSE (N),598553066,0,0,598553066,19731541346.284403,0.000000,0.000000,19731541346.284403,1556645,0,0,1556645
2013-03-11,NYSE Arca (P),268853044,169821876,134978087,573653007,8856836557.199799,9507658339.544717,4407885389.951689,22772380286.696205,1537600,342905,707655,2588160
2013-03-11,NASDAQ (Q),348919603,94507654,356735520,800162777,11745889547.087281,5530441365.115704,10905812744.426781,28182143656.629766,2080059,304896,1499930,3884885
2013-03-11,CBSX (W),13896325,4218003,7024239,25138567,406013991.240000,202409335.650000,186045334.510000,794468661.400000,96766,9621,47720,154107
2013-03-11,NASDAQ PSX (X),16786433,10374851,15221254,42382538,406485110.030000,574071995.264200,274477644.380000,1255034749.674200,74765,24827,40083,139675
2013-03-11,BATS BYX (Y),58204311,17319249,30717140,106240700,1671070754.683000,788809798.640000,781916884.226900,3241797437.549900,397694,63797,184562,646053
2013-03-11,BATS BZX (Z),228265088,90463496,154260698,472989282,7080902512.025898,5044019674.389896,4238531861.875908,16363454048.291702,1410111,285615,795033,2490759
2013-03-08,NYSE MKT (A),0,10383219,9244734,19627953,0.000000,60707281.749000,159983013.720000,220690295.469000,0,20424,27627,48051
2013-03-08,NASDAQ BX (B),80876152,29171663,39577159,149624974,2348146850.139999,1534447713.961000,1189820730.472502,5072415294.573501,511601,96858,261879,870338
2013-03-08,NSX (C),13550456,5489754,8344633,27384843,357915445.764100,245702801.735000,186299835.939099,789918083.438199,50840,9463,26722,87025
2013-03-08,NYSE (DN),103905037,24003303,44482386,172390726,3459347030.785400,1177039845.903403,1454418937.309302,6090805813.998105,612466,87492,255699,955657
2013-03-08,NASDAQ (DQ),1221624018,423624615,579828123,2225076756,35470768122.761990,20108414453.577076,15644915831.890246,71224098408.229312,3401245,558353,1558164,5517762
2013-03-08,EDGA (J),137306891,48644938,58077162,244028991,3496313983.048004,2201514580.982898,1445494054.978203,7143322619.009105,839781,153083,346362,1339226
2013-03-08,EDGX (K),244920680,80709030,153239028,478868738,7844934286.175567,3625828477.184405,4502416888.089807,15973179651.449779,1273123,201310,650651,2125084
2013-03-08,CHX (M),12436516,10434446,3107273,25978235,406657888.306300,1188829438.897000,399123260.642000,1994610587.845300,470,3295,2042,5807
2013-03-08,NYSE (N),690493675,0,0,690493675,22606948896.700053,0.000000,0.000000,22606948896.700053,1773694,0,0,1773694
2013-03-08,NYSE Arca (P),343884156,224909049,139527497,708320702,10963225318.231956,13675710815.801390,4986870929.176710,29625807063.210056,1795259,467951,752169,3015379
2013-03-08,NASDAQ (Q),425171751,138630817,366530094,930332662,13735459171.249471,8653526925.278684,11634386821.660520,34023372918.188675,2411726,438760,1591574,4442060
2013-03-08,CBSX (W),17301675,5032930,7300811,29635416,507215794.300000,184362370.090000,174206641.610000,865784806.000000,114121,10260,49231,173612
2013-03-08,NASDAQ PSX (X),18525250,15610759,13645014,47781023,419573677.955000,918602566.840000,294429056.630000,1632605301.425000,75509,36494,39525,151528
2013-03-08,BATS BYX (Y),68736372,21613633,30815557,121165562,2003327483.966198,1078437917.600000,830620946.883501,3912386348.449699,454514,74114,195366,723994
2013-03-08,BATS BZX (Z),274273890,136689226,162026351,572989467,8494690247.782177,8173239461.272022,4929554702.528856,21597484411.583055,1655009,407660,865237,2927906
2013-03-07,NYSE MKT (A),0,10483336,7222390,17705726,0.000000,51398272.820800,97575877.154000,148974149.974800,0,21494,22372,43866
2013-03-07,NASDAQ BX (B),85198761,22452073,39483988,147134822,2192336191.900002,1030936427.004700,1187146580.299297,4410419199.203999,514898,76822,257713,849433
2013-03-07,NSX (C),13014942,4838061,8984012,26837015,314698403.653100,144375100.743700,200993065.192500,660066569.589300,44839,8514,27478,80831
2013-03-07,NYSE (DN),101868617,17324664,41158365,160351646,3003765007.807804,785620965.122001,1339976352.071205,5129362325.001010,596304,71239,245628,913171
2013-03-07,NASDAQ (DQ),1199266347,291123902,624815550,2115205799,31746315482.669171,12906943228.571841,17557116408.306903,62210375119.547915,3283653,454204,1573049,5310906
2013-03-07,EDGA (J),123972652,38021618,55211572,217205842,3094505127.202903,1641420611.927100,1441857356.070801,6177783095.200804,768200,125418,335616,1229234
2013-03-07,EDGX (K),223890095,64330197,151358387,439578679,6897671303.919674,2490367693.382797,4504694331.670716,13892733328.973187,1119832,161161,628124,1909117
2013-03-07,CHX (M),11269482,9727263,6380486,27377231,307453780.030500,684016938.035100,236177401.104100,1227648119.169700,288,1250,2062,3600
2013-03-07,NYSE (N),708417980,0,0,708417980,21869253663.317561,0.000000,0.000000,21869253663.317561,1694575,0,0,1694575
2013-03-07,NYSE Arca (P),371921559,164222372,153521667,689665598,10243532880.984704,9445397055.082887,5241800028.033388,24930729964.100979,1748158,364803,815103,2928064
2013-03-07,NASDAQ (Q),429472258,110843740,376454576,916770574,13081509972.013796,6597170270.249892,11681952531.733248,31360632773.996936,2352175,344816,1614496,4311487
2013-03-07,CBSX (W),15115763,4573407,7077236,26766406,420151233.660000,171869841.991000,175818763.340000,767839838.991000,94481,9692,42517,146690
2013-03-07,NASDAQ PSX (X),20933501,12101543,15404883,48439927,464593962.555000,679580793.385000,324808179.905000,1468982935.845000,86341,28391,44378,159110
2013-03-07,BATS BYX (Y),73894373,18902084,31677334,124473791,1890181114.845000,776817520.428000,823554036.206400,3490552671.479400,453138,64408,192360,709906
2013-03-07,BATS BZX (Z),265810290,104327190,162401487,532538967,7662593007.603883,5752985319.343800,4766285484.820809,18181863811.768492,1563157,320249,880535,2763941
2013-03-06,NYSE MKT (A),0,8473607,8963401,17437008,0.000000,56237573.090800,123935287.311000,180172860.401800,0,22255,25866,48121
2013-03-06,NASDAQ BX (B),85978927,25741517,43772324,155492768,2318009959.831799,1213414003.519000,1309361563.848299,4840785527.199098,541536,89601,286153,917290
2013-03-06,NSX (C),15773144,4237345,10259833,30270322,372662454.789300,178240242.183400,245485110.656600,796387807.629300,52864,8727,32006,93597
2013-03-06,NYSE (DN),93629217,16908576,43515213,154053006,2816887858.330913,870531427.619300,1462939927.730194,5150359213.680407,550068,72860,243407,866335
2013-03-06,NASDAQ (DQ),1223561044,307523370,645346049,2176430463,33618828710.076007,13526757229.515738,18381851029.757284,65527436969.349029,3516504,505940,1649510,5671954
2013-03-06,EDGA (J),124688173,40048371,58567121,223303665,3179872187.346798,1796763278.197202,1550136388.724600,6526771854.268600,801581,135709,352212,1289502
2013-03-06,EDGX (K),246138981,65001036,157807469,468947486,7482971369.704199,2802626634.290402,4738642029.574487,15024240033.569088,1273453,178010,679691,2131154
2013-03-06,CHX (M),7639515,10192305,4819762,22651582,263398185.574000,605611739.652500,233264331.810000,1102274257.036500,445,1630,2283,4358
2013-03-06,NYSE (N),683850894,0,0,683850894,21486161512.553510,0.000000,0.000000,21486161512.553510,1789044,0,0,1789044
2013-03-06,NYSE Arca (P),357044621,193275092,162225594,712545307,10332532866.696592,10317232855.963399,5678355423.140990,26328121145.800981,1845794,416436,854619,3116849
2013-03-06,NASDAQ (Q),447117115,127214528,390513563,964845206,13715158101.378849,7727200284.976801,12516301016.034816,33958659402.390466,2507702,398102,1688945,4594749
2013-03-06,CBSX (W),16160812,5417327,7572010,29150149,444730203.570000,225948552.165300,196093726.320000,866772482.055300,102637,10644,48386,161667
2013-03-06,NASDAQ PSX (X),21536791,12842980,16028137,50407908,488909034.405000,743545561.185000,351246534.645000,1583701130.235000,89946,32302,48936,171184
2013-03-06,BATS BYX (Y),72740185,20955659,34127762,127823606,1882912876.596000,913399157.730200,890627643.986800,3686939678.313000,464468,72158,206646,743272
2013-03-06,BATS BZX (Z),281887658,117120998,178947940,577956596,8077754475.415275,6662973369.486702,5207756036.456993,19948483881.358970,1697893,362311,953863,3014067
2013-03-05,NYSE MKT (A),0,8299721,8284524,16584245,0.000000,56401740.527500,106517879.585000,162919620.112500,0,18907,23260,42167
2013-03-05,NASDAQ BX (B),79242911,27854519,45784891,152882321,2230956976.245000,1398261481.503000,1396949719.938602,5026168177.686602,510166,91873,290409,892448
2013-03-05,NSX (C),13373035,4342936,9538645,27254616,355107220.437500,167072331.614800,239498072.224000,761677624.276300,49623,8491,30228,88342
2013-03-05,NYSE (DN),84164378,16706925,48588784,149460087,2762238559.793888,863333954.035100,1749975839.858292,5375548353.687280,513581,71629,272184,857394
2013-03-05,NASDAQ (DQ),1221365644,330097638,689535029,2240998311,35515494100.211120,14986191364.684023,21462645417.458309,71964330882.353452,3439076,544960,1790118,5774154
2013-03-05,EDGA (J),122314332,43652185,64385835,230352352,3174898049.402097,2175484157.966702,1756876084.675401,7107258292.044200,804423,151874,390454,1346751
2013-03-05,EDGX (K),237779469,73815336,167572573,479167378,7701832052.773988,3389958722.532504,5424688418.863883,16516479194.170375,1248228,192324,721766,2162318
2013-03-05,CHX (M),10044909,8750677,5855731,24651317,306318317.162000,557271656.691500,316533444.956700,1180123418.810200,361,1490,2192,4043
2013-03-05,NYSE (N),682997422,0,0,682997422,22804596391.290852,0.000000,0.000000,22804596391.290852,1845603,0,0,1845603
2013-03-05,NYSE Arca (P),342778933,201548439,176041434,720368806,11160491153.501081,12196309019.021104,6732554649.401862,30089354821.924047,1911048,445864,964425,3321337
2013-03-05,NASDAQ (Q),433081989,149534959,434426283,1017043231,14141140297.335524,9692594857.188982,15018449997.194539,38852185151.719045,2522298,455450,1900214,4877962
2013-03-05,CBSX (W),13065257,5658902,6488595,25212754,369484076.260000,245704142.200000,169356339.476000,784544557.936000,87906,10353,41268,139527
2013-03-05,NASDAQ PSX (X),20857094,15135469,19078750,55071313,519524384.995000,873928637.400000,385125490.700000,1778578513.095000,91628,36017,53346,180991
2013-03-05,BATS BYX (Y),69015212,21765595,34981177,125761984,1852037113.274999,1023333018.315000,929329481.274301,3804699612.864300,439486,73323,209013,721822
2013-03-05,BATS BZX (Z),282721345,133651132,193070098,609442575,8755518813.054979,8292835641.505700,5979145716.054291,23027500170.614970,1797804,417269,1065752,3280825
2013-03-04,NYSE MKT (A),0,9018631,8137028,17155659,0.000000,58593739.455000,100446647.053000,159040386.508000,0,19135,22610,41745
2013-03-04,NASDAQ BX (B),78936634,25028102,41048550,145013286,2127468756.781596,1201265464.595001,1286156699.806999,4614890921.183596,512088,86233,260847,859168
2013-03-04,NSX (C),12543547,4297775,8871739,25713061,293195733.409200,196222982.423100,199617378.805700,689036094.638000,45817,7925,28997,82739
2013-03-04,NYSE (DN),96064530,16267296,49013267,161345093,2902738118.162502,799036872.836302,1625887699.643891,5327662690.642695,600122,72808,266934,939864
2013-03-04,NASDAQ (DQ),1044745278,308528258,594718173,1947991709,29100604536.714521,13311289836.834380,17440975994.967508,59852870368.516409,3256177,496974,1591496,5344647
2013-03-04,EDGA (J),112415479,38615348,60736312,211767139,2810214270.200899,1734564558.124902,1576068172.451998,6120847000.777799,739820,128710,362707,1231237
2013-03-04,EDGX (K),229788681,60247812,150762175,440798668,7236265420.640197,2466380787.260499,4996036355.404397,14698682563.305093,1221793,162761,664237,2048791
2013-03-04,CHX (M),8488766,4564351,3512693,16565810,315004101.927600,297025684.939000,238930632.231600,850960419.098200,261,1088,2204,3553
2013-03-04,NYSE (N),693186423,0,0,693186423,22393017252.088747,0.000000,0.000000,22393017252.088747,1803233,0,0,1803233
2013-03-04,NYSE Arca (P),329884647,189454243,163807059,683145949,10395497592.817019,10961376863.605898,5844286821.800601,27201161278.223518,1865456,425067,913278,3203801
2013-03-04,NASDAQ (Q),426182336,132101627,411544450,969828413,13663212725.941210,7985513184.941893,13205756328.552745,34854482239.435848,2487516,399577,1769954,4657047
2013-03-04,CBSX (W),13385994,13973641,6322951,33682586,365819117.820000,645996931.900000,151801607.530000,1163617657.250000,90528,9958,41754,142240
2013-03-04,NASDAQ PSX (X),22264035,14391157,16243844,52899036,537850764.895000,839993266.000000,338493587.760000,1716337618.655000,100511,35616,54256,190383
2013-03-04,BATS BYX (Y),70627114,20823722,34104963,125555799,1896202874.730000,935884462.022600,928371851.818100,3760459188.570700,465346,72596,213467,751409
2013-03-04,BATS BZX (Z),277628747,121191442,181292051,580112240,8379776684.000598,7211525746.267494,5211197415.921023,20802499846.189115,1739500,372272,980919,3092691
2013-03-01,NYSE MKT (A),0,10079513,7463008,17542521,0.000000,57133196.693800,93384200.560000,150517397.253800,0,19541,21523,41064
2013-03-01,NASDAQ BX (B),94246699,32901517,46387735,173535951,2689043633.084996,1793324790.525599,1512362512.786601,5994730936.397196,600391,112605,303441,1016437
2013-03-01,NSX (C),10217478,4087003,7840442,22144923,258729433.513700,227124702.280600,179336543.940000,665190679.734300,37380,7070,21270,65720
2013-03-01,NYSE (DN),96014176,18806613,52298988,167119777,2939679225.786889,1107798775.721301,1617455857.591492,5664933859.099682,624295,79672,313699,1017666
2013-03-01,NASDAQ (DQ),1084496954,390842879,632305466,2107645299,30138903471.379294,21073965956.141057,17255808006.532753,68468677434.053104,3412647,554311,1740629,5707587
2013-03-01,EDGA (J),135144861,49489119,69448681,254082661,3416437478.627204,2364070892.752802,1735482406.557999,7515990777.938005,874796,163431,419324,1457551
2013-03-01,EDGX (K),249874657,78438573,165317540,493630770,8119372935.773821,4115098537.652392,5150242552.034325,17384714025.460538,1380317,230043,753089,2363449
2013-03-01,CHX (M),10576487,8087579,5392196,24056262,260107007.919200,530182461.579100,220353213.590800,1010642683.089100,452,2204,1805,4461
2013-03-01,NYSE (N),743402115,0,0,743402115,24385887580.500704,0.000000,0.000000,24385887580.500704,2068124,0,0,2068124
2013-03-01,NYSE Arca (P),366455647,244768729,181954859,793179235,11837915332.738222,16384825486.377811,6689814243.912485,34912555063.028518,2096125,561362,1041705,3699192
2013-03-01,NASDAQ (Q),480515703,185011924,445174623,1110702250,15782464572.043825,12178664083.175010,14015720334.805982,41976848990.024817,2893120,579097,1983206,5455423
2013-03-01,CBSX (W),14240091,7868550,7492655,29601296,403298707.440000,436677439.580000,174113207.218300,1014089354.238300,98318,11964,46641,156923
2013-03-01,NASDAQ PSX (X),24700210,19302389,18674574,62677173,705272927.740000,1159370148.790000,406614190.345000,2271257266.875000,127259,47654,62896,237809
2013-03-01,BATS BYX (Y),67132055,24557695,34129101,125818851,1785955151.555402,1285644825.554999,882239440.251299,3953839417.361700,436790,88741,208239,733770
2013-03-01,BATS BZX (Z),319271399,171546065,200373023,691190487,9888262473.819196,11539563438.364017,5935241411.628098,27363067323.811311,2000859,529778,1107525,3638162
2013-02-28,NYSE MKT (A),0,10040536,8552535,18593071,0.000000,67178741.023000,104753031.347000,171931772.370000,0,19047,24101,43148
2013-02-28,NASDAQ BX (B),82642304,29910473,44286721,156839498,2363651447.206702,1546364649.939001,1233773636.314298,5143789733.460001,545396,100599,275459,921454
2013-02-28,NSX (C),9467036,3913770,8001317,21382123,225703482.651300,224291580.721300,149531226.205400,599526289.578000,31005,6949,19623,57577
2013-02-28,NYSE (DN),102134295,20669874,54982085,177786254,3267253707.131409,1091164472.725799,1573552062.386889,5931970242.244097,618224,86644,303384,1008252
2013-02-28,NASDAQ (DQ),1194934525,351684718,687230483,2233849726,34804656965.812762,15913291101.359982,17781416985.801024,68499365052.973768,3255737,524434,1635589,5415760
2013-02-28,EDGA (J),122229439,48466566,65438748,236134753,3189772582.155402,2222414403.675400,1533662242.400297,6945849228.231099,792894,149920,377692,1320506
2013-02-28,EDGX (K),201896893,64521431,157642467,424060791,6480869902.359604,2783878767.047200,4331842590.959907,13596591260.366711,1079723,170201,634479,1884403
2013-02-28,CHX (M),14148565,7580331,7842181,29571077,329455888.713400,535761344.308000,265375996.991000,1130593230.012400,233,1477,1747,3457
2013-02-28,NYSE (N),1006967522,0,0,1006967522,34394297201.058144,0.000000,0.000000,34394297201.058144,1982460,0,0,1982460
2013-02-28,NYSE Arca (P),339746364,222799925,190533056,753079345,11006991119.664989,13258400640.766205,6006217458.062598,30271609218.493792,1917444,450995,978655,3347094
2013-02-28,NASDAQ (Q),457760344,150870593,557246025,1165876962,15159917117.358582,9619051148.781598,15962235987.031310,40741204253.171490,2676864,443372,1868709,4988945
2013-02-28,CBSX (W),14113284,6684060,6779812,27577156,421965092.140000,291714385.080000,156676422.500000,870355899.720000,93956,10915,41970,146841
2013-02-28,NASDAQ PSX (X),20262531,15643041,17286629,53192201,562091195.535000,928381321.390000,310166669.610000,1800639186.535000,93628,35463,47714,176805
2013-02-28,BATS BYX (Y),60399373,21176035,30233008,111808416,1639215146.780002,1046662694.390000,740123912.719400,3426001753.889402,388480,74436,177683,640599
2013-02-28,BATS BZX (Z),286388779,137177525,201575363,625141667,8786860350.242007,8506990998.034380,5203755588.450386,22497606936.726773,1761682,387429,1016916,3166027
2013-02-27,NYSE MKT (A),0,8244586,9716604,17961190,0.000000,59580883.900600,122649947.494000,182230831.394600,0,18444,27718,46162
2013-02-27,NASDAQ BX (B),91486365,28812127,45768594,166067086,2616423158.812602,1438752027.395000,1464512274.067801,5519687460.275403,577977,98075,290872,966924
2013-02-27,NSX (C),9811247,4806714,7450136,22068097,242585355.225600,239353129.717100,219102370.765400,701040855.708100,33491,7825,22401,63717
2013-02-27,NYSE (DN),97454774,17825489,44126805,159407068,3051088678.585864,983133305.576601,1480740874.515086,5514962858.677551,567550,75999,249560,893109
2013-02-27,NASDAQ (DQ),1120642457,348179423,588518895,2057340775,31862263854.459580,18073624186.168865,17284215343.656682,67220103384.285127,3160262,515854,1507347,5183463
2013-02-27,EDGA (J),123755958,43617816,58630961,226004735,3250999953.644002,1997665899.756002,1557166904.748699,6805832758.148703,800757,142466,354203,1297426
2013-02-27,EDGX (K),214712703,67348473,147276014,429337190,7053753647.162996,3014498667.823599,4707312882.793098,14775565197.779693,1144311,181843,638105,1964259
2013-02-27,CHX (M),13514618,8770703,2060871,24346192,344690768.238500,646713375.678600,78375801.661200,1069779945.578300,391,1430,1890,3711
2013-02-27,NYSE (N),673251765,0,0,673251765,21747212413.000447,0.000000,0.000000,21747212413.000447,1949502,0,0,1949502
2013-02-27,NYSE Arca (P),349322825,213842391,178152087,741317303,11153698544.493003,12400813035.016018,6695584673.623636,30250096253.132657,1960386,482861,978792,3422039
2013-02-27,NASDAQ (Q),467676700,159759847,413038779,1040475326,15424260161.389666,9643417033.056689,13165814666.035126,38233491860.481481,2739872,489944,1856327,5086143
2013-02-27,CBSX (W),12695941,3322560,5545765,21564266,361032962.140000,152901738.800000,138808378.420000,652743079.360000,82939,9840,37999,130778
2013-02-27,NASDAQ PSX (X),22481352,15909739,16717762,55108853,557130445.425000,993388383.420000,349080683.060000,1899599511.905000,96531,37379,48150,182060
2013-02-27,BATS BYX (Y),62350927,21258215,29893603,113502745,1703215959.350003,1055109651.550000,808073903.025400,3566399513.925403,403771,75700,177914,657385
2013-02-27,BATS BZX (Z),293817798,147307197,190536136,631661131,9174504191.127020,8830063948.906990,5615854724.133606,23620422864.167616,1819825,430428,1000519,3250772
2013-02-26,NYSE MKT (A),0,7582396,10910241,18492637,0.000000,57312021.905800,132380968.696800,189692990.602600,0,19706,27483,47189
2013-02-26,NASDAQ BX (B),101725587,39075140,50725427,191526154,2972248972.729398,1934533957.081400,1550742741.480901,6457525671.291699,655822,138947,326085,1120854
2013-02-26,NSX (C),9810778,5436201,6454335,21701314,248478591.872100,254767997.765900,158356227.144500,661602816.782500,37050,8858,18764,64672
2013-02-26,NYSE (DN),107061412,21906655,51549244,180517311,3413724223.198406,1258458201.665898,1628315022.031486,6300497446.895790,619663,95064,274212,988939
2013-02-26,NASDAQ (DQ),1218464333,439683468,605156666,2263304467,35759174612.192867,21058320326.999317,17223764830.241880,74041259769.434064,3371623,659914,1565586,5597123
2013-02-26,EDGA (J),141569819,66989665,66282986,274842470,3637253368.602899,3102232992.512401,1675583128.580201,8415069489.695501,890920,218123,384695,1493738
2013-02-26,EDGX (K),238361019,92848688,156192253,487401960,7763119726.790184,4230030564.325103,4840104883.885664,16833255175.000951,1316017,255214,702882,2274113
2013-02-26,CHX (M),11048140,8336693,6608561,25993394,272532569.700300,787392836.954000,147045269.367000,1206970676.021300,417,1740,2179,4336
2013-02-26,NYSE (N),772168147,0,0,772168147,25240971974.295069,0.000000,0.000000,25240971974.295069,2269844,0,0,2269844
2013-02-26,NYSE Arca (P),380670584,277803056,180261883,838735523,12105122411.457486,15997888318.666233,6296948753.653792,34399959483.777511,2190978,650298,983802,3825078
2013-02-26,NASDAQ (Q),529691642,223008377,447929340,1200629359,17625931368.963937,13023125322.722505,13939684427.280394,44588741118.966836,3214032,715613,1983787,5913432
2013-02-26,CBSX (W),13521997,4241266,6830567,24593830,397937410.850000,204644641.220000,185346162.130000,787928214.200000,92543,13747,40930,147220
2013-02-26,NASDAQ PSX (X),24765402,22888477,17348736,65002615,577610287.580000,1399818012.730000,370929606.320000,2348357906.630000,97998,54882,49825,202705
2013-02-26,BATS BYX (Y),74005246,29749390,33732899,137487535,2050133563.523400,1583027699.920000,863975177.060800,4497136440.504200,477177,107644,198994,783815
2013-02-26,BATS BZX (Z),356418191,218358730,212830079,787607000,11143127103.585002,13032192155.824026,6064580137.458680,30239899396.867708,2238107,671851,1113770,4023728
2013-02-25,NYSE MKT (A),0,9656844,10842183,20499027,0.000000,64625807.339500,135799142.191000,200424949.530500,0,21049,32757,53806
2013-02-25,NASDAQ BX (B),112441100,39951398,57609295,210001793,3288045088.980001,2243698037.684998,1639247755.630801,7170990882.295800,735151,135953,366386,1237490
2013-02-25,NSX (C),13786187,7086807,8628250,29501244,330796031.925000,357825983.115800,195061133.462500,883683148.503300,46928,10467,24935,82330
2013-02-25,NYSE (DN),105455054,23594044,56532109,185581207,3336640234.283201,1299931261.450100,1587069978.732007,6223641474.465308,650730,97628,292613,1040971
2013-02-25,NASDAQ (DQ),1190215177,437426193,623424463,2251065833,35687876863.005134,24861780548.014708,15955252667.744056,76504910078.763898,3403933,641774,1622780,5668487
2013-02-25,EDGA (J),145461701,63045936,70334696,278842333,3799901876.310500,2978541705.911605,1728302806.426102,8506746388.648207,915113,198269,404191,1517573
2013-02-25,EDGX (K),240689626,93755178,168843786,503288590,7957010629.816411,4544739097.361805,4864533039.778609,17366282766.956825,1291235,247539,716259,2255033
2013-02-25,CHX (M),12775603,8460048,5184209,26419860,552553235.708500,832748142.396800,169755425.788100,1555056803.893400,389,1659,2282,4330
2013-02-25,NYSE (N),818825053,0,0,818825053,27476385007.531323,0.000000,0.000000,27476385007.531323,2304531,0,0,2304531
2013-02-25,NYSE Arca (P),398308685,301122292,199174446,898605423,12722891732.766833,18249139487.643731,6109302832.819586,37081334053.230150,2178420,617160,1011532,3807112
2013-02-25,NASDAQ (Q),524777575,230032662,476165921,1230976158,17840238051.805213,14748710004.540774,14450430215.272431,47039378271.618418,3120969,678367,2014842,5814178
2013-02-25,CBSX (W),14631859,5826224,6377435,26835518,427310161.760000,288725155.540000,161897526.550000,877932843.850000,95526,13164,41193,149883
2013-02-25,NASDAQ PSX (X),23459717,23825265,16769387,64054369,554542344.115000,1573996178.130000,360562094.965000,2489100617.210000,90593,52368,48177,191138
2013-02-25,BATS BYX (Y),75539492,29030405,34800675,139370572,2103660294.147902,1563843634.554000,910106373.410001,4577610302.111903,497041,99358,210865,807264
2013-02-25,BATS BZX (Z),337420323,209514572,201973056,748907951,10510892821.324970,13788169836.597612,5740432626.030618,30039495283.953200,2056937,582467,1061779,3701183
2013-02-22,NYSE MKT (A),0,8659312,9260906,17920218,0.000000,58737022.523300,106025217.098700,164762239.622000,0,18723,23813,42536
2013-02-22,NASDAQ BX (B),88083795,24531246,42610481,155225522,2658270880.439993,1266265985.899999,1288774978.282501,5213311844.622493,585533,88307,289614,963454
2013-02-22,NSX (C),10057165,3743138,6270515,20070818,260508986.289900,146053144.840500,137967740.993500,544529872.123900,37284,6584,20532,64400
2013-02-22,NYSE (DN),101330280,17687349,45706098,164723727,3287352678.097490,913497225.424899,1412237251.605697,5613087155.128086,615388,75302,267725,958415
2013-02-22,NASDAQ (DQ),1119175394,313281638,559562478,1992019510,33220470741.000294,14384606523.248559,14699765838.488426,62304843102.737279,3231549,485513,1515785,5232847
2013-02-22,EDGA (J),119062126,42488135,56305980,217856241,3133440343.649604,1937624082.885903,1374384940.270699,6445449366.806206,740279,131689,332798,1204766
2013-02-22,EDGX (K),202135499,58779054,133103969,394018522,6769072651.941603,2589934987.170798,4243845558.726891,13602853197.839292,1073157,151913,612723,1837793
2013-02-22,CHX (M),10084327,8139328,3964316,22187971,317233891.676900,415559492.797200,368918027.309000,1101711411.783100,275,998,1658,2931
2013-02-22,NYSE (N),682602083,0,0,682602083,22229704083.830465,0.000000,0.000000,22229704083.830465,1733304,0,0,1733304
2013-02-22,NYSE Arca (P),318572586,186230702,152633640,657436928,10140852412.418041,11018931512.498098,5239489770.341704,26399273695.257843,1692361,375611,818992,2886964
2013-02-22,NASDAQ (Q),406840668,119520004,371723264,898083936,13598108309.699858,7322075904.692696,11602265320.510213,32522449534.902767,2364679,355745,1620437,4340861
2013-02-22,CBSX (W),13870255,3196870,6328871,23395996,404883103.030000,170185086.250000,148106247.450000,723174436.730000,93121,9700,40782,143603
2013-02-22,NASDAQ PSX (X),17233901,13372192,12286304,42892397,394095226.565000,901538492.330000,260619931.380000,1556253650.275000,68419,30595,39626,138640
2013-02-22,BATS BYX (Y),61275265,16346619,26510230,104132114,1714820594.575000,850306646.679000,671056944.630000,3236184185.884000,394492,58314,166664,619470
2013-02-22,BATS BZX (Z),270000668,116820080,159642143,546462891,8116156176.468984,6933277928.311306,4533887894.464907,19583321999.245197,1585224,315658,863135,2764017
2013-02-21,NYSE MKT (A),0,9672980,9662532,19335512,0.000000,64184482.269100,115165332.641200,179349814.910300,0,22969,26880,49849
2013-02-21,NASDAQ BX (B),123082659,36518665,60645068,220246392,3402544260.179996,2069596270.726698,1753624394.579000,7225764925.485694,786824,124233,383967,1295024
2013-02-21,NSX (C),12955230,6119784,9175299,28250313,315684735.885800,262792480.731900,211219833.946000,789697050.563700,49971,10575,27877,88423
2013-02-21,NYSE (DN),134662142,23359928,61659559,219681629,4211114730.228710,1320935563.375797,1867179842.544087,7399230136.148594,806517,101261,348139,1255917
2013-02-21,NASDAQ (DQ),1339134125,459484662,711542458,2510161245,38036895503.762596,22053308191.713040,19123822167.779332,79214025863.254968,4075064,694831,1887979,6657874
2013-02-21,EDGA (J),157564829,61189643,76841970,295596442,4054886749.345202,2986512342.558900,1861427723.219099,8902826815.123201,976275,193885,446036,1616196
2013-02-21,EDGX (K),267799237,96648342,183514933,547962512,8529385726.663432,4389475292.073400,5610792254.490598,18529653273.227430,1426325,244098,792797,2463220
2013-02-21,CHX (M),11305137,7820352,4488755,23614244,340058546.776000,576892989.767800,206071242.923400,1123022779.467200,327,1711,2140,4178
2013-02-21,NYSE (N),813926152,0,0,813926152,26582939163.846338,0.000000,0.000000,26582939163.846338,2228865,0,0,2228865
2013-02-21,NYSE Arca (P),415509278,274410871,200794330,890714479,13292499720.724798,16326719634.484701,6716400812.133385,36335620167.342884,2245082,574106,1023587,3842775
2013-02-21,NASDAQ (Q),529124754,197796887,460368955,1187290596,17377577522.677788,12422066339.034110,14407023427.837631,44206667289.549529,3091602,581195,2035234,5708031
2013-02-21,CBSX (W),18337446,6352886,7783740,32474072,518273726.300000,249188792.980000,191233443.630000,958695962.910000,114199,14235,52930,181364
2013-02-21,NASDAQ PSX (X),24267842,19668845,19084854,63021541,545848353.925000,1267620849.940000,389682422.850000,2203151626.715000,95756,43448,53319,192523
2013-02-21,BATS BYX (Y),83286942,28600407,38927669,150815018,2332343703.855001,1468665319.126500,982110843.825199,4783119866.806700,540294,93296,229630,863220
2013-02-21,BATS BZX (Z),344965916,187967374,219957546,752890836,10110188711.555013,11472558139.047396,6017017422.189907,27599764272.792316,2065664,492407,1143262,3701333
2013-02-20,NYSE MKT (A),0,12478508,8884002,21362510,0.000000,82845693.267300,114588539.704000,197434232.971300,0,24376,26113,50489
2013-02-20,NASDAQ BX (B),108922520,34682049,54223273,197827842,3179680065.915002,1910308283.636800,1723978730.404001,6813967079.955803,706061,114251,345448,1165760
2013-02-20,NSX (C),15793982,6819293,9419853,32033128,352859296.255400,312229319.425600,221196869.266700,886285484.947700,51838,11297,26400,89535
2013-02-20,NYSE (DN),124910700,23354974,59752920,208018594,4021258388.066765,1297268160.015499,1843793150.011796,7162319698.094060,766941,99855,334536,1201332
2013-02-20,NASDAQ (DQ),1397433132,414891830,703561312,2515886274,40218982867.415547,19782440178.191249,19835041299.796247,79836464345.403043,3944228,619919,1778095,6342242
2013-02-20,EDGA (J),150364885,54436988,71666456,276468329,3863065919.015799,2602415621.796796,1925289976.659899,8390771517.472494,922934,165443,410534,1498911
2013-02-20,EDGX (K),260270668,83347344,172367035,515985047,8316988270.781884,3652003593.155603,5333183384.116539,17302175248.054026,1322667,209617,728510,2260794
2013-02-20,CHX (M),12641767,11291394,7166990,31100151,508250655.770000,845621742.069500,284763218.953000,1638635616.792500,621,1957,2459,5037
2013-02-20,NYSE (N),816039668,0,0,816039668,26296089641.865030,0.000000,0.000000,26296089641.865030,2054676,0,0,2054676
2013-02-20,NYSE Arca (P),385579121,254986532,187549987,828115640,11794140405.490566,15560143707.626517,6399968664.305288,33754252777.422371,2002906,531101,930286,3464293
2013-02-20,NASDAQ (Q),516247925,184113039,477150541,1177511505,16632233709.165304,11755513421.026107,14798455261.014006,43186202391.205417,2891821,524374,1917961,5334156
2013-02-20,CBSX (W),16264400,6032917,7204079,29501396,483714116.580000,331714221.660000,175122392.440000,990550730.680000,105226,12907,46731,164864
2013-02-20,NASDAQ PSX (X),23942352,18166199,16237168,58345719,504326162.500000,1170181327.201400,400210807.875000,2074718297.576400,89149,38663,47721,175533
2013-02-20,BATS BYX (Y),85274380,26252459,39463181,150990020,2367888594.700002,1374320486.315000,1080007091.118200,4822216172.133202,536684,84545,235443,856672
2013-02-20,BATS BZX (Z),327801174,162019248,201345850,691166272,9547272142.405012,9922704223.340725,5681699884.829481,25151676250.575218,1868234,428983,1004057,3301274
2013-02-19,NYSE MKT (A),0,9356485,10249561,19606046,0.000000,61994218.585100,132180668.009000,194174886.594100,0,19293,25516,44809
2013-02-19,NASDAQ BX (B),96307989,23734846,46581463,166624298,2790608731.644997,1177273771.503000,1420479742.475002,5388362245.622999,603679,81765,319658,1005102
2013-02-19,NSX (C),10730712,4405459,8815069,23951240,270746481.879300,174952128.525400,189148112.405800,634846722.810500,38074,7689,23157,68920
2013-02-19,NYSE (DN),116848083,20109952,55263132,192221167,3875870233.153080,1019918343.386901,1716282446.015092,6612071022.555073,711846,86614,325112,1123572
2013-02-19,NASDAQ (DQ),1338750878,342922076,702479300,2384152254,40346484058.710573,16399353249.457835,19451093753.181546,76196931061.349954,3615260,517171,1735701,5868132
2013-02-19,EDGA (J),120848568,39643068,58580770,219072406,3267024252.710004,1732237746.133500,1576238224.842999,6575500223.686503,742363,119896,350145,1212404
2013-02-19,EDGX (K),229180018,59756716,162677371,451614105,7853641600.640423,2474256021.610602,5336449352.632693,15664346974.883718,1177148,152213,693158,2022519
2013-02-19,CHX (M),14944577,7397194,3160951,25502722,635011889.400000,494440893.970600,191396435.913400,1320849219.284000,419,921,1607,2947
2013-02-19,NYSE (N),734551587,0,0,734551587,25253158817.754660,0.000000,0.000000,25253158817.754660,1784875,0,0,1784875
2013-02-19,NYSE Arca (P),307148374,179576347,156037291,642762012,10135197409.885812,9983314827.124409,5317894896.742725,25436407133.752946,1631592,364907,801989,2798488
2013-02-19,NASDAQ (Q),415992196,115534515,420595292,952122003,14189874692.555540,6983853727.354327,13406804019.696712,34580532439.606579,2346231,330906,1677569,4354706
2013-02-19,CBSX (W),14495027,6709299,5340801,26545127,432051730.290000,278145428.920000,133230842.970000,843428002.180000,98642,10297,38123,147062
2013-02-19,NASDAQ PSX (X),18478032,11834121,14478778,44790931,420573026.215000,663447728.770000,307047526.460000,1391068281.445000,68804,25388,40653,134845
2013-02-19,BATS BYX (Y),68484656,19038814,31093618,118617088,1992346326.049999,889779449.593400,852145324.608001,3734271100.251400,434855,65173,197310,697338
2013-02-19,BATS BZX (Z),262832034,104254078,173055876,540141988,8072208767.649998,5877123495.100807,4946429699.135610,18895761961.886415,1543574,276032,897901,2717507
2013-02-15,NYSE MKT (A),0,10318678,9862603,20181281,0.000000,65129600.612600,140995754.742800,206125355.355400,0,18792,25720,44512
2013-02-15,NASDAQ BX (B),94285183,28799784,49765194,172850161,2811628638.163798,1544285588.299999,1492008438.610998,5847922665.074795,613726,91285,316646,1021657
2013-02-15,NSX (C),12300718,4025211,8302450,24628379,357157553.409200,166180837.843300,184552000.528800,707890391.781300,47336,7277,23407,78020
2013-02-15,NYSE (DN),113268924,19043607,56485270,188797801,3933547862.953691,1044663231.956601,1743490857.784393,6721701952.694685,684786,76265,310457,1071508
2013-02-15,NASDAQ (DQ),1166654565,405439632,631569453,2203663650,36289834070.922322,29171387327.106469,17300489608.575845,82761711006.604636,3516292,482688,1606392,5605372
2013-02-15,EDGA (J),128539923,40181757,63320298,232041978,3698547368.795999,1976579144.405899,1806731773.811099,7481858287.012997,821977,126274,380802,1329053
2013-02-15,EDGX (K),215822388,65290002,155760650,436873040,7635060527.799095,3064075177.506000,4839708536.017408,15538844241.322503,1159225,168037,665807,1993069
2013-02-15,CHX (M),12850275,10910561,5357847,29118683,541610511.586000,733531907.186900,172892978.283600,1448035397.056500,355,2041,1834,4230
2013-02-15,NYSE (N),939503112,0,0,939503112,34730073532.243416,0.000000,0.000000,34730073532.243416,1873972,0,0,1873972
2013-02-15,NYSE Arca (P),339029934,205971453,166012110,711013497,11756606416.666192,12657965641.127287,5898879759.800995,30313451817.594474,1782609,402744,831932,3017285
2013-02-15,NASDAQ (Q),450348133,138951921,496719924,1086019978,15981224442.329458,9346641313.705189,16484047091.047109,41811912847.081756,2576724,400946,1715630,4693300
2013-02-15,CBSX (W),13972368,3666026,6250338,23888732,435122999.470000,209707265.640000,157679665.260000,802509930.370000,98258,10103,40838,149199
2013-02-15,NASDAQ PSX (X),19801985,15531494,14487039,49820518,459492913.275000,898074615.530000,346141114.840000,1703708643.645000,74134,31293,41108,146535
2013-02-15,BATS BYX (Y),66998791,20178841,31627041,118804673,2079741036.604999,1038797177.057301,843484507.088001,3962022720.750301,438869,64825,193369,697063
2013-02-15,BATS BZX (Z),265459865,121858403,169054942,556373210,8552900028.874794,7585526143.246501,4945642422.493007,21084068594.614302,1604929,316643,882342,2803914
2013-02-14,NYSE MKT (A),0,6917064,12583445,19500509,0.000000,48935142.937300,156280424.964000,205215567.901300,0,14615,29201,43816
2013-02-14,NASDAQ BX (B),88877304,21157078,47549611,157583993,2669819018.725000,1083992413.992200,1437166536.742197,5190977969.459397,565178,72901,302976,941055
2013-02-14,NSX (C),11136474,3173549,9611412,23921435,275967224.938000,146809856.470900,191348614.061200,614125695.470100,38940,5788,24639,69367
2013-02-14,NYSE (DN),115975900,15393904,55295779,186665583,3915148369.793105,749955911.021801,1704321618.451902,6369425899.266808,658141,63988,305121,1027250
2013-02-14,NASDAQ (DQ),1414819953,247970423,742034944,2404825320,45709279988.717706,11243454808.421973,20500217996.230334,77452952793.370013,3418906,405457,1668021,5492384
2013-02-14,EDGA (J),116032331,31941701,60939479,208913511,3330959967.293902,1358976653.708600,1570863132.926898,6260799753.929400,732267,99834,361360,1193461
2013-02-14,EDGX (K),202397972,52614222,164516217,419528411,6684955584.771106,2185946689.068301,4654009623.372089,13524911897.211496,997722,122760,650689,1771171
2013-02-14,CHX (M),14524392,10042333,5498426,30065151,491576398.961800,636196216.688200,188608895.519800,1316381511.169800,396,1127,1790,3313
2013-02-14,NYSE (N),671844969,0,0,671844969,22535248924.770159,0.000000,0.000000,22535248924.770159,1698448,0,0,1698448
2013-02-14,NYSE Arca (P),338457576,141384822,175263260,655105658,11243734169.368815,8561869014.018716,5378401228.915908,25184004412.303439,1667787,311183,837283,2816253
2013-02-14,NASDAQ (Q),431375019,102104035,426757817,960236871,14837497934.375760,6609390172.147000,12758980360.736035,34205868467.258795,2388828,299894,1715728,4404450
2013-02-14,CBSX (W),13198750,4633472,7170286,25002508,408915703.910000,183277888.150000,150776931.704200,742970523.764200,92777,8215,42338,143330
2013-02-14,NASDAQ PSX (X),19127433,11247304,14919164,45293901,435478397.520000,654019715.730000,316606409.570000,1406104522.820000,67986,23972,41173,133131
2013-02-14,BATS BYX (Y),67450027,15679417,34012697,117142141,1985321660.225000,721245859.297500,891333005.255000,3597900524.777500,436763,53417,208229,698409
2013-02-14,BATS BZX (Z),256149597,88719999,173381016,518250612,7837091297.269995,5276094903.281606,4789566303.491300,17902752504.042901,1468196,244606,884683,2597485
2013-02-13,NYSE MKT (A),0,7140559,9923803,17064362,0.000000,46174227.500000,133828998.610000,180003226.110000,0,16319,25880,42199
2013-02-13,NASDAQ BX (B),79953888,22305430,47956893,150216211,2376406383.946999,1121375175.279200,1392447202.035901,4890228761.262100,533630,76880,302753,913263
2013-02-13,NSX (C),11266393,3399254,8357135,23022782,283497758.336500,129176232.635600,192776941.206500,605450932.178600,38122,6746,23265,68133
2013-02-13,NYSE (DN),101175391,15645360,54101320,170922071,3249631364.676097,817527585.590102,1635213064.058397,5702372014.324596,586259,65475,280191,931925
2013-02-13,NASDAQ (DQ),1138162478,252302332,668496941,2058961751,34599332152.217467,11752059413.643397,18645750844.647352,64997142410.508216,3146619,413867,1577599,5138085
2013-02-13,EDGA (J),116887973,32283917,62733903,211905793,3148903712.377705,1475608501.678801,1634691833.180302,6259204047.236808,733686,104822,374032,1212540
2013-02-13,EDGX (K),196772754,52906635,159778724,409458113,6340243687.299200,2288597278.161899,4562389888.315849,13191230853.776948,964980,131814,621939,1718733
2013-02-13,CHX (M),9323014,5586438,5011371,19920823,348157515.052700,342712580.166800,396107295.510600,1086977390.730100,348,737,1560,2645
2013-02-13,NYSE (N),657108276,0,0,657108276,22162193819.604263,0.000000,0.000000,22162193819.604263,1641779,0,0,1641779
2013-02-13,NYSE Arca (P),307026042,146522283,174958418,628506743,9891050916.199697,8428519337.420893,6020616615.644799,24340186869.265389,1600339,304196,845278,2749813
2013-02-13,NASDAQ (Q),418503888,107841244,417631071,943976203,14220696567.022988,6821480171.601893,13405981517.330138,34448158255.955019,2300505,308417,1703082,4312004
2013-02-13,CBSX (W),12534521,5627647,6003008,24165176,356938096.850000,228826944.928600,143112089.210000,728877130.988600,82511,7687,38941,129139
2013-02-13,NASDAQ PSX (X),18048656,10726809,14762913,43538378,416591020.045000,639667841.370000,324944331.090000,1381203192.505000,67688,25051,45736,138475
2013-02-13,BATS BYX (Y),65472683,15426961,33552998,114452642,1893693424.514998,763587335.277400,927265926.410000,3584546686.202398,429376,54039,204949,688364
2013-02-13,BATS BZX (Z),254273045,93337173,174994974,522605192,7637549997.787705,5526071570.981400,4988433562.577916,18152055131.347021,1469245,258042,903517,2630804
2013-02-12,NYSE MKT (A),0,8029990,11016631,19046621,0.000000,52390865.954400,137325907.571000,189716773.525400,0,18093,27284,45377
2013-02-12,NASDAQ BX (B),81478768,19974920,46023222,147476910,2422632567.524203,967353261.985100,1454990534.690700,4844976364.200003,515668,67903,284387,867958
2013-02-12,NSX (C),11868224,3389409,8322587,23580220,286233546.190000,131307269.328600,232034193.692200,649575009.210800,36486,5952,21683,64121
2013-02-12,NYSE (DN),104156137,14994178,50121132,169271447,3468607973.037088,722468113.959898,1665679223.849603,5856755310.846589,615044,60056,272688,947788
2013-02-12,NASDAQ (DQ),1205733226,243547357,661152247,2110432830,35719066583.953115,9999796537.106606,18384003235.632020,64102866356.691741,3134049,408745,1515923,5058717
2013-02-12,EDGA (J),115402272,32916882,58243200,206562354,3071692436.117896,1436524123.318300,1556722965.103101,6064939524.539297,702111,102237,336628,1140976
2013-02-12,EDGX (K),198559514,48866846,153224869,400651229,6310077939.792894,2043356363.677004,4749290920.572209,13102725224.042107,941599,121825,608077,1671501
2013-02-12,CHX (M),8539099,6879026,7728930,23147055,295501942.148200,432148709.286000,666362966.501500,1394013617.935700,350,794,1664,2808
2013-02-12,NYSE (N),613750912,0,0,613750912,20439300777.728685,0.000000,0.000000,20439300777.728685,1579153,0,0,1579153
2013-02-12,NYSE Arca (P),307053755,130647638,162010669,599712062,9934550735.258030,7032711848.257105,5721502725.175809,22688765308.690944,1541631,284188,786509,2612328
2013-02-12,NASDAQ (Q),412351296,100587655,418145454,931084405,13813439653.944409,6006835794.309803,13093730996.698211,32914006444.952423,2272091,280985,1592336,4145412
2013-02-12,CBSX (W),13823252,3492634,6544558,23860444,393865045.720000,143179812.800000,151429339.220000,688474197.740000,97394,7570,43847,148811
2013-02-12,NASDAQ PSX (X),20196091,11188686,14397242,45782019,490223833.410000,583862823.940000,325466811.180000,1399553468.530000,68638,22929,42876,134443
2013-02-12,BATS BYX (Y),68386329,14378114,31995878,114760321,2016341177.375003,667565754.538900,914314550.376400,3598221482.290303,439341,51227,198502,689070
2013-02-12,BATS BZX (Z),253942368,90562972,167914122,512419462,7534377137.433008,4991499074.571096,4798154203.847006,17324030415.851110,1442454,241241,862239,2545934
2013-02-11,NYSE MKT (A),0,7152771,9432830,16585601,0.000000,48425908.444500,121049072.317300,169474980.761800,0,15519,24507,40026
2013-02-11,NASDAQ BX (B),65093152,18757555,40422127,124272834,1959454590.387999,924180526.781800,1210195434.649199,4093830551.818998,440974,66991,257287,765252
2013-02-11,NSX (C),8606254,2967620,7213742,18787616,220896907.787500,95288497.152800,206222078.606000,522407483.546300,31245,5677,20387,57309
2013-02-11,NYSE (DN),91022353,12949952,51648584,155620889,2913786351.514395,654091583.266600,1525100541.924994,5092978476.705989,506932,58893,272623,838448
2013-02-11,NASDAQ (DQ),912984936,230616577,559460534,1703062047,28730136922.315650,10288831832.156323,15480327814.501140,54499296568.973113,2622887,380286,1419407,4422580
2013-02-11,EDGA (J),90784365,30645515,55144767,176574647,2428997287.309293,1367794611.134299,1413352711.194798,5210144609.638390,582846,95038,314728,992612
2013-02-11,EDGX (K),161474662,44666010,137004961,343145633,5570038678.992399,1863710518.317395,4513497551.567391,11947246748.877185,819510,113656,550941,1484107
2013-02-11,CHX (M),10147931,3641014,5146545,18935490,392729927.145000,276228300.925400,270633061.122100,939591289.192500,245,839,896,1980
2013-02-11,NYSE (N),496927729,0,0,496927729,17012467700.560687,0.000000,0.000000,17012467700.560687,1440670,0,0,1440670
2013-02-11,NYSE Arca (P),231815309,142522658,136144436,510482403,7841545856.450999,8410367782.683902,4814245530.989789,21066159170.124690,1276355,284171,678936,2239462
2013-02-11,NASDAQ (Q),328668581,94140675,347041478,769850734,11433154071.831414,6017194769.609202,11298383854.866202,28748732696.306818,1887393,280101,1466697,3634191
2013-02-11,CBSX (W),12700482,4658185,6551350,23910017,366772055.160000,177724948.760000,147221874.170000,691718878.090000,94008,8006,45629,147643
2013-02-11,NASDAQ PSX (X),13751768,8389593,13204427,35345788,322979476.990000,473897864.745000,245352242.845000,1042229584.580000,56237,20740,36557,113534
2013-02-11,BATS BYX (Y),51322093,14037878,29829967,95189938,1526366634.094999,668250100.055000,768674647.197000,2963291381.346999,358158,52132,181206,591496
2013-02-11,BATS BZX (Z),209697503,83496710,158232923,451427136,6463591158.056389,4754327493.888907,4435365021.656816,15653283673.602112,1264127,239920,802174,2306221
2013-02-08,NYSE MKT (A),0,6687597,9420084,16107681,0.000000,45115064.524600,123139409.509000,168254474.033600,0,15651,24375,40026
2013-02-08,NASDAQ BX (B),70922304,22248367,43504904,136675575,2098124340.755000,1284709194.520000,1312681047.585002,4695514582.860002,482959,72187,277509,832655
2013-02-08,NSX (C),9076576,3764265,7944612,20785453,261309190.020100,164823667.227300,207969761.214200,634102618.461600,34940,6541,23428,64909
2013-02-08,NYSE (DN),91277561,14756946,53815847,159850354,3030776053.519500,778438288.055899,1790754014.223200,5599968355.798599,535404,63074,276375,874853
2013-02-08,NASDAQ (DQ),1025492141,287314794,681785664,1994592599,32052684191.992848,13435486287.184123,18998117859.599294,64486288338.776265,2810248,403923,1557746,4771917
2013-02-08,EDGA (J),106954313,36232839,60704799,203891951,2760165906.145903,1705650595.052599,1633960157.017802,6099776658.216304,634252,110441,338956,1083649
2013-02-08,EDGX (K),169162873,50379831,157798065,377340769,5790120181.875504,2297461609.461198,5102487696.897681,13190069488.234383,873831,125611,604908,1604350
2013-02-08,CHX (M),6910471,4883224,5374396,17168091,251883195.779700,301861957.517000,411512833.565900,965257986.862600,275,712,1299,2286
2013-02-08,NYSE (N),578048304,0,0,578048304,20157229311.732907,0.000000,0.000000,20157229311.732907,1564783,0,0,1564783
2013-02-08,NYSE Arca (P),265689110,166716840,160687638,593093588,8924114144.722395,9597409288.844787,6131348265.838893,24652871699.406075,1424215,317722,779622,2521559
2013-02-08,NASDAQ (Q),356512571,110603561,409780598,876896730,12539471965.151515,7244560709.950420,13662384295.894028,33446416970.995963,2040330,304474,1628861,3973665
2013-02-08,CBSX (W),12727630,2298624,6895694,21921948,369138052.980000,108211500.036800,155844587.350000,633194140.366800,92437,8294,46563,147294
2013-02-08,NASDAQ PSX (X),13606310,10390289,14094915,38091514,327943235.120000,646239074.915000,292780200.620000,1266962510.655000,58522,22711,39769,121002
2013-02-08,BATS BYX (Y),60166662,15193510,34670486,110030658,1815473302.906000,793613560.650000,1015321619.435001,3624408482.991001,421047,52665,215238,688950
2013-02-08,BATS BZX (Z),227069046,98863166,178498578,504430790,7057139344.559992,6060993216.153604,5304143518.631015,18422276079.344611,1363282,260447,900402,2524131
2013-02-07,NYSE MKT (A),0,7232350,10255289,17487639,0.000000,47985983.159000,140745798.636800,188731781.795800,0,16624,29923,46547
2013-02-07,NASDAQ BX (B),85325222,30408930,52650125,168384277,2538507372.139997,1742465648.803501,1666667454.963001,5947640475.906499,564779,97522,311692,973993
2013-02-07,NSX (C),11654958,4880628,8008867,24544453,312405492.900000,220295392.068600,223340425.446100,756041310.414700,42146,8202,24794,75142
2013-02-07,NYSE (DN),110254549,18548936,61140998,189944483,3593920881.199203,1105071414.897199,2108826534.229904,6807818830.326306,657820,77049,322037,1056906
2013-02-07,NASDAQ (DQ),1182687536,327341984,694227765,2204257285,34499100702.579156,17502773109.283427,21051923455.897648,73053797267.760231,3307227,506116,1674443,5487786
2013-02-07,EDGA (J),124224477,47660135,69252907,241137519,3255961846.430000,2322391861.734302,1973870318.718298,7552224026.882600,767569,149409,400452,1317430
2013-02-07,EDGX (K),211713780,66947969,164768846,443430595,7063456082.897915,3226463555.652801,5595287343.189738,15885206981.740454,1075028,173967,683295,1932290
2013-02-07,CHX (M),12877161,8732997,3281729,24891887,519320099.360300,557264976.000100,451383302.206100,1527968377.566500,379,1318,1247,2944
2013-02-07,NYSE (N),663689169,0,0,663689169,22420522931.083650,0.000000,0.000000,22420522931.083650,1887708,0,0,1887708
2013-02-07,NYSE Arca (P),342219558,205258400,188349954,735827912,11008138553.299601,12472909043.281904,7664224408.751003,31145272005.332508,1783643,433570,935076,3152289
2013-02-07,NASDAQ (Q),465960060,154224325,447794659,1067979044,15986743282.434031,10318226066.649888,15597106204.493487,41902075553.577406,2671835,443647,1932000,5047482
2013-02-07,CBSX (W),15442446,3274496,7350078,26067020,446408788.600000,158639035.550000,180704981.810000,785752805.960000,107219,9819,47724,164762
2013-02-07,NASDAQ PSX (X),19414006,14881241,16009631,50304878,465736838.935000,934628767.230000,355986503.010000,1756352109.175000,77777,33657,47320,158754
2013-02-07,BATS BYX (Y),76466069,21383928,39502993,137352990,2300800043.350002,1185274663.175000,1172130811.730300,4658205518.255302,517345,71355,241227,829927
2013-02-07,BATS BZX (Z),293370027,137337400,203034939,633742366,8905014137.309206,8789326774.335901,6093369752.687299,23787710664.332406,1713998,374811,1028970,3117779
2013-02-06,NYSE MKT (A),0,8999623,11119896,20119519,0.000000,49120187.688000,150077343.065400,199197530.753400,0,17115,27466,44581
2013-02-06,NASDAQ BX (B),85726685,24156024,50652619,160535328,2507086785.490000,1255252032.034999,1613737489.364300,5376076306.889299,566782,83257,316629,966668
2013-02-06,NSX (C),9331924,4736742,7860343,21929009,256586609.762500,181311694.203600,230169023.695600,668067327.661700,37105,8176,23752,69033
2013-02-06,NYSE (DN),108793657,18852684,60686171,188332512,3542635666.543784,933980061.058100,2174079867.868124,6650695595.470008,645987,73875,321309,1041171
2013-02-06,NASDAQ (DQ),1244147871,359818585,756059858,2360026314,37738043275.543177,19275551916.480215,22846666035.515694,79860261227.539086,3363529,451194,1737497,5552220
2013-02-06,EDGA (J),119659369,42076114,66752752,228488235,3102320680.626401,1921219158.329301,1841631039.618198,6865170878.573900,729453,120598,378249,1228300
2013-02-06,EDGX (K),210925825,56000368,165712996,432639189,7058454368.841505,2593548989.205408,5490305201.815898,15142308559.862811,1064156,142056,674678,1880890
2013-02-06,CHX (M),14384554,13851779,5341309,33577642,450788945.113800,803018221.087000,238197944.941400,1492005111.142200,275,1164,1023,2462
2013-02-06,NYSE (N),681285248,0,0,681285248,22953977713.394619,0.000000,0.000000,22953977713.394619,1787299,0,0,1787299
2013-02-06,NYSE Arca (P),325559929,180217433,182338086,688115448,10644809867.653102,10502937064.758796,7005945925.382185,28153692857.794083,1722317,373557,905297,3001171
2013-02-06,NASDAQ (Q),438981123,129434726,452268938,1020684787,15158152892.264224,8603384696.822320,15574723620.845520,39336261209.932064,2512046,355211,1919939,4787196
2013-02-06,CBSX (W),17928977,7370328,8400261,33699566,513306494.720000,240869353.820000,204581467.280000,958757315.820000,113175,9792,51197,174164
2013-02-06,NASDAQ PSX (X),18140844,12126222,14827282,45094348,414888373.200000,716657110.520000,332002575.810000,1463548059.530000,70596,25934,41152,137682
2013-02-06,BATS BYX (Y),77082233,17936394,39451846,134470473,2343751643.815001,900901577.793600,1114274898.818999,4358928120.427600,520966,59106,233690,813762
2013-02-06,BATS BZX (Z),273786234,111154327,194440777,579381338,8418643732.092898,6665353135.291099,5894802315.538324,20978799182.922321,1618390,294578,999161,2912129
2013-02-05,NYSE MKT (A),0,10770439,10113904,20884343,0.000000,57295870.981600,126722695.269300,184018566.250900,0,21021,24798,45819
2013-02-05,NASDAQ BX (B),86465775,25792493,57649754,169908022,2468282589.834996,1358129804.861499,1757355854.655794,5583768249.352289,567189,85934,302194,955317
2013-02-05,NSX (C),11347324,4542763,10571778,26461865,297069716.033700,173261375.573500,249289810.743801,719620902.351001,41331,8266,26649,76246
2013-02-05,NYSE (DN),110956263,18333538,62156225,191446026,3638878421.971804,988059587.738399,1884867269.532998,6511805279.243201,661754,75663,300369,1037786
2013-02-05,NASDAQ (DQ),1168961629,292530632,776467375,2237959636,35350536285.954013,13637850610.388065,20646641147.000987,69635028043.343065,3409678,468521,1690519,5568718
2013-02-05,EDGA (J),106943923,39156345,73699513,219799781,2881024607.049597,1845738774.676101,1949984286.984002,6676747668.709700,682140,119965,351102,1153207
2013-02-05,EDGX (K),217387845,58458999,176938900,452785744,7195375451.851398,2668185923.799003,5362345425.598199,15225906801.248600,1091305,156616,662113,1910034
2013-02-05,CHX (M),8218117,11175470,5994755,25388342,352487215.263000,759439688.728800,170957410.413600,1282884314.405400,268,1377,1048,2693
2013-02-05,NYSE (N),701669125,0,0,701669125,23813826364.439023,0.000000,0.000000,23813826364.439023,1848771,0,0,1848771
2013-02-05,NYSE Arca (P),341040538,197591411,210185622,748817571,11286704445.010373,11633629934.015110,6434564542.085387,29354898921.110870,1826746,386737,895479,3108962
2013-02-05,NASDAQ (Q),468217017,129668647,472735519,1070621183,16176612471.279728,8707150916.709409,14758144526.423496,39641907914.412633,2618651,373855,1856983,4849489
2013-02-05,CBSX (W),16808561,3888258,8256670,28953489,474111796.290000,172880116.310000,181891399.810000,828883312.410000,109372,9696,47656,166724
2013-02-05,NASDAQ PSX (X),17774977,12738439,18566460,49079876,402874897.075000,759352484.570000,355902010.450000,1518129392.095000,72350,28213,44601,145164
2013-02-05,BATS BYX (Y),76597724,19025488,44689359,140312571,2305394625.771999,961286822.955400,1147434091.617499,4414115540.344898,531223,64163,233943,829329
2013-02-05,BATS BZX (Z),286814669,113298957,233526005,633639631,8766026971.559200,7032834319.894890,6149408185.080695,21948269476.534785,1673289,310832,994676,2978797
2013-02-04,NYSE MKT (A),0,8618409,6981481,15599890,0.000000,58156198.454600,87003315.470000,145159513.924600,0,17899,24058,41957
2013-02-04,NASDAQ BX (B),82585141,26217908,49505386,158308435,2464831491.785001,1418290519.545000,1536560798.003807,5419682809.333808,563806,91706,318558,974070
2013-02-04,NSX (C),11069295,5179642,9507280,25756217,281225159.640000,236534474.960700,260469369.786700,778229004.387400,41072,9132,29615,79819
2013-02-04,NYSE (DN),97734991,18192975,49294000,165221966,3298451051.987897,977687973.503602,1596490149.676098,5872629175.167597,613023,77921,292569,983513
2013-02-04,NASDAQ (DQ),1034179730,348694935,653501969,2036376634,30926803064.515484,20010889733.766660,18674061511.868015,69611754310.150159,3246641,516499,1676982,5440122
2013-02-04,EDGA (J),107712362,43008303,59571624,210292289,2841385490.141998,1964597716.332302,1669570967.404699,6475554173.878999,679518,137095,355346,1171959
2013-02-04,EDGX (K),193905250,63854340,160223976,417983566,6303916032.608915,3096984821.124704,4823004011.353696,14223904865.087315,975207,170357,633000,1778564
2013-02-04,CHX (M),9806454,7781722,4230559,21818735,449995838.641600,490222130.321300,143529354.165100,1083747323.128000,291,1155,1597,3043
2013-02-04,NYSE (N),693830798,0,0,693830798,24105488298.164875,0.000000,0.000000,24105488298.164875,1846106,0,0,1846106
2013-02-04,NYSE Arca (P),322407169,214519745,180722073,717648987,10728359411.598011,12852179006.195185,6281883019.974337,29862421437.767533,1743894,433066,909211,3086171
2013-02-04,NASDAQ (Q),455295158,139673483,462171124,1057139765,15828747957.970507,9282930356.480387,14664054647.243001,39775732961.693895,2656875,412275,1918201,4987351
2013-02-04,CBSX (W),15075153,4151174,8194890,27421217,436081896.190000,232109831.160000,175550848.727800,843742576.077800,104178,9709,51530,165417
2013-02-04,NASDAQ PSX (X),16940314,13431420,16529987,46901721,415487881.235000,849546433.120000,386257350.450000,1651291664.805000,72088,31069,49043,152200
2013-02-04,BATS BYX (Y),76882569,19464925,38511451,134858945,2271565275.755002,1018913132.881401,1104228367.921001,4394706776.557404,529131,69215,242671,841017
2013-02-04,BATS BZX (Z),273568043,120292256,190640749,584501048,8377718641.608000,7496347064.580018,5490182625.619989,21364248331.808007,1589671,337743,988955,2916369
2013-02-01,NYSE MKT (A),0,9290629,6601783,15892412,0.000000,66109435.465800,92110675.434000,158220110.899800,0,18467,24819,43286
2013-02-01,NASDAQ BX (B),91825962,29031833,47840564,168698359,2689848285.624997,1573366343.361299,1551844849.351998,5815059478.338294,604132,92586,313865,1010583
2013-02-01,NSX (C),14773383,4876999,11591878,31242260,351280974.147400,206722929.220800,284652954.728600,842656858.096800,46293,8134,30254,84681
2013-02-01,NYSE (DN),123931070,19290302,55915353,199136725,4123195685.945989,1161799718.503899,1874684360.722701,7159679765.172589,728908,82779,322621,1134308
2013-02-01,NASDAQ (DQ),1277119316,345159600,736507325,2358786241,38249997013.645453,16958943861.066012,21492576668.380047,76701517543.091512,3829059,537757,1833945,6200761
2013-02-01,EDGA (J),121253033,42337824,62881572,226472429,3200667117.003900,1996553131.388100,1580709600.449498,6777929848.841498,761109,124457,380128,1265694
2013-02-01,EDGX (K),213816785,63515935,175391912,452724632,7101243595.416100,2941226248.406605,5410078089.833495,15452547933.656200,1068505,170343,681793,1920641
2013-02-01,CHX (M),15786019,14826189,5588784,36200992,1167709592.753400,1006571526.927100,444989683.874700,2619270803.555200,368,2236,1302,3906
2013-02-01,NYSE (N),756713602,0,0,756713602,26109137914.814563,0.000000,0.000000,26109137914.814563,1993416,0,0,1993416
2013-02-01,NYSE Arca (P),347569171,211463463,186708763,745741397,11510113467.694750,13307388180.146928,6776663527.009203,31594165174.850881,1812932,430724,931185,3174841
2013-02-01,NASDAQ (Q),516608886,148045186,484744237,1149398309,17759811976.049439,9953546589.076310,15877017150.450933,43590375715.576682,2909574,422411,2036792,5368777
2013-02-01,CBSX (W),21882573,5698299,9430674,37011546,609209886.200000,223242563.870000,240021645.810000,1072474095.880000,142142,10401,62891,215434
2013-02-01,NASDAQ PSX (X),19831578,14933776,20013435,54778789,481435818.665000,877994625.460000,451355134.355000,1810785578.480000,83030,31929,51088,166047
2013-02-01,BATS BYX (Y),93314242,21258257,41127402,155699901,2778778078.925000,1147905915.535000,1310389024.692401,5237073019.152401,633899,72046,264472,970417
2013-02-01,BATS BZX (Z),290088938,121772158,188350284,600211380,8858608711.782516,7784452619.219281,5604825488.447994,22247886819.449791,1654003,341117,970221,2965341
2013-01-31,NYSE MKT (A),0,10377291,5964672,16341963,0.000000,60750002.780600,86573604.601000,147323607.381600,0,19096,24794,43890
2013-01-31,NASDAQ BX (B),88679671,26011672,49635059,164326402,2588340588.481998,1521955951.002199,1438694543.241101,5548991082.725298,589371,88187,326072,1003630
2013-01-31,NSX (C),10952098,4970287,10081024,26003409,286335593.217100,168397400.242400,237710868.265800,692443861.725300,40807,8669,29526,79002
2013-01-31,NYSE (DN),124377410,18040929,61685505,204103844,4220273700.622966,1002573765.183702,1873210740.925999,7096058206.732667,717694,73122,350139,1140955
2013-01-31,NASDAQ (DQ),1278787498,319814621,799227350,2397829469,37512730399.656504,15540476953.991706,21100991487.737313,74154198841.385523,3577967,510705,1922499,6011171
2013-01-31,EDGA (J),109117772,39293888,60541021,208952681,2874083156.514999,1971303614.901301,1484620496.537501,6330007267.953801,679703,118071,363314,1161088
2013-01-31,EDGX (K),225833363,68623604,210417296,504874263,7108341666.418502,2945866881.747803,5507625806.190187,15561834354.356492,1099449,174758,768036,2042243
2013-01-31,CHX (M),14448616,5297425,8602875,28348916,491050485.507700,439840538.488700,381600814.785400,1312491838.781800,325,1647,1641,3613
2013-01-31,NYSE (N),933190065,0,0,933190065,32876643183.723705,0.000000,0.000000,32876643183.723705,2008948,0,0,2008948
2013-01-31,NYSE Arca (P),344460852,192678821,211278312,748417985,11353025337.294006,11646541925.261302,6409622750.833055,29409190013.388363,1793917,398773,1026033,3218723
2013-01-31,NASDAQ (Q),462785913,122831978,534473305,1120091196,16350416907.925152,7940113886.473702,16480308754.311356,40770839548.710210,2701692,356834,2104352,5162878
2013-01-31,CBSX (W),17231598,4125223,9112539,30469360,514029848.770000,228431511.170000,215346109.410000,957807469.350000,118079,10330,57483,185892
2013-01-31,NASDAQ PSX (X),20952102,13105163,17854064,51911329,467347038.430000,763334906.170000,457619338.360000,1688301282.960000,79415,27666,56944,164025
2013-01-31,BATS BYX (Y),96183112,21121472,48315749,165620333,2835234439.024998,1114151013.186600,1297920104.605197,5247305556.816795,624490,71612,296998,993100
2013-01-31,BATS BZX (Z),287799594,109137620,199482240,596419454,8612340021.580925,6643000964.774592,5391550652.784402,20646891639.139919,1613790,309352,1033370,2956512
2013-01-30,NYSE MKT (A),0,8929480,6217311,15146791,0.000000,55850522.719000,87258968.752000,143109491.471000,0,19452,26178,45630
2013-01-30,NASDAQ BX (B),84976089,28343342,49026699,162346130,2413721680.119993,1651343326.688000,1455916317.003600,5520981323.811593,574093,96769,322950,993812
2013-01-30,NSX (C),11834599,5261990,10795583,27892172,305437409.017700,237098823.210300,294076969.714400,836613201.942400,45003,9522,29925,84450
2013-01-30,NYSE (DN),119358759,18623920,54628515,192611194,3931187013.461197,1108479717.718403,1763378142.586098,6803044873.765698,716204,81174,320382,1117760
2013-01-30,NASDAQ (DQ),1191309145,335374078,702877611,2229560834,35391127934.831283,17521733224.618103,19418412512.354329,72331273671.803715,3494282,544925,1767138,5806345
2013-01-30,EDGA (J),107882780,45756740,61392513,215032033,2791767046.093498,2188667578.268299,1491181416.221496,6471616040.583293,686449,139304,361845,1187598
2013-01-30,EDGX (K),236886647,76042706,204473377,517402730,7086455922.352401,3500965301.733701,5879853730.240277,16467274954.326379,1084364,201391,747125,2032880
2013-01-30,CHX (M),13575068,11255617,5513707,30344392,508688526.053400,839751819.984000,264974937.786500,1613415283.823900,436,1770,1540,3746
2013-01-30,NYSE (N),704621956,0,0,704621956,23625526592.445447,0.000000,0.000000,23625526592.445447,1957334,0,0,1957334
2013-01-30,NYSE Arca (P),344843800,197268757,205403781,747516338,10716449266.579307,11759209324.426596,6904700329.021294,29380358920.027197,1795585,443449,1011556,3250590
2013-01-30,NASDAQ (Q),480799718,133086738,454148117,1068034573,16432851178.351410,8791259953.320671,13855472189.963706,39079583321.635787,2795943,404191,2008239,5208373
2013-01-30,CBSX (W),16040985,4556759,7843981,28441725,464616830.820000,259972310.150000,191618297.370000,916207438.340000,108019,11237,49811,169067
2013-01-30,NASDAQ PSX (X),19042037,13671883,19639837,52353757,441337704.350000,876468096.610000,432434225.560000,1750240026.520000,80344,32142,55236,167722
2013-01-30,BATS BYX (Y),92489118,24159533,48118974,164767625,2653811003.544996,1249771231.928899,1334251253.017000,5237833488.490895,612744,79523,284235,976502
2013-01-30,BATS BZX (Z),304964802,123216855,206481622,634663279,8803670766.160016,7721591101.033888,5368926625.582990,21894188492.776894,1690992,361849,1026631,3079472
2013-01-29,NYSE MKT (A),0,8227799,6040605,14268404,0.000000,60437430.630400,79140013.552000,139577444.182400,0,19938,22792,42730
2013-01-29,NASDAQ BX (B),93570187,28000395,48138564,169709146,2543272959.310003,1456413066.460001,1479014161.589401,5478700187.359405,575945,99604,304447,979996
2013-01-29,NSX (C),13206090,4092841,10365170,27664101,328929700.068800,184979702.324900,229880092.846100,743789495.239800,45803,7981,29769,83553
2013-01-29,NYSE (DN),128287234,20373438,58228460,206889132,4228342217.750613,956151919.494500,1793920035.607778,6978414172.852891,767204,83873,324393,1175470
2013-01-29,NASDAQ (DQ),1350833198,288435972,786152969,2425422139,39968649018.325029,13797629143.131509,22280207950.918069,76046486112.374607,3740112,496941,1750776,5987829
2013-01-29,EDGA (J),110525160,39768227,57641953,207935340,2855218033.278002,1734164450.461900,1437239406.699199,6026621890.439101,674027,122233,330512,1126772
2013-01-29,EDGX (K),241586809,60506720,194496887,496590416,7091159814.695996,2678059980.225101,5893172926.769995,15662392721.691092,1075628,160955,698104,1934687
2013-01-29,CHX (M),14395779,8374627,3585101,26355507,685957447.780200,605389784.648300,110872900.358300,1402220132.786800,328,928,1705,2961
2013-01-29,NYSE (N),719843362,0,0,719843362,23978369415.796715,0.000000,0.000000,23978369415.796715,1902673,0,0,1902673
2013-01-29,NYSE Arca (P),358191373,186354153,192083349,736628875,11050684357.771508,10657844057.319595,6703510935.726210,28412039350.817313,1782507,385104,922606,3090217
2013-01-29,NASDAQ (Q),483486180,113403851,438120285,1035010316,16042717926.255122,7449578177.816903,13976018908.685991,37468315012.758016,2645441,345482,1888722,4879645
2013-01-29,CBSX (W),15866956,4447702,8027038,28341696,454276206.120000,162339120.840000,202570123.460000,819185450.420000,109369,9807,47885,167061
2013-01-29,NASDAQ PSX (X),22330393,11090832,22683130,56104355,484465847.625000,642844386.290000,468773268.945000,1596083502.860000,85787,26082,57865,169734
2013-01-29,BATS BYX (Y),99478225,21827534,46090486,167396245,2759495242.860002,1037226311.085900,1232611056.009201,5029332609.955103,630375,73467,275506,979348
2013-01-29,BATS BZX (Z),303242183,110595494,197202742,611040419,8592238438.053184,6473910890.528499,5365596612.466214,20431745941.047897,1633606,306829,982972,2923407
2013-01-28,NYSE MKT (A),0,8139899,5471876,13611775,0.000000,55143045.476800,80061626.293000,135204671.769800,0,18605,23705,42310
2013-01-28,NASDAQ BX (B),80458407,24406194,46768803,151633404,2282813339.264999,1224972507.375600,1438295882.468502,4946081729.109101,537879,89265,306121,933265
2013-01-28,NSX (C),12097563,4027360,11132807,27257730,297127729.854600,169231305.466100,237617232.373901,703976267.694601,45639,8735,30390,84764
2013-01-28,NYSE (DN),102165326,18550494,53937333,174653153,3390112395.696415,932301469.192099,1982959913.382424,6305373778.270938,632027,79220,306155,1017402
2013-01-28,NASDAQ (DQ),1165829205,330217067,759968092,2256014364,34947843294.630949,18830305350.954220,23216892094.630028,76995040740.215197,3264612,511896,1712338,5488846
2013-01-28,EDGA (J),94122600,36087965,55819689,186030254,2412975451.456602,1621057465.831399,1433612293.955497,5467645211.243498,593123,112869,331685,1037677
2013-01-28,EDGX (K),221029091,59865351,200629415,481523857,6652213340.701190,2618495413.922200,6050879095.467801,15321587850.091191,1055271,160886,711006,1927163
2013-01-28,CHX (M),11642969,18540767,7070950,37254686,582666309.566100,1096840172.707500,268279177.743300,1947785660.016900,361,836,2205,3402
2013-01-28,NYSE (N),646589585,0,0,646589585,21921735874.243521,0.000000,0.000000,21921735874.243521,1720682,0,0,1720682
2013-01-28,NYSE Arca (P),295788959,169236956,174176071,639201986,9508521942.286902,9746167623.155105,6282985863.150880,25537675428.592887,1581700,377142,862630,2821472
2013-01-28,NASDAQ (Q),382741100,101946539,396696636,881384275,13117345390.588118,6635563165.395706,13394736372.966794,33147644928.950618,2257026,320254,1721933,4299213
2013-01-28,CBSX (W),15428355,5681345,8620272,29729972,433972327.020000,234419387.380000,233826598.350000,902218312.750000,105677,9799,49928,165404
2013-01-28,NASDAQ PSX (X),18435469,10590916,16964736,45991121,397291816.010000,553079532.100000,368713832.022200,1319085180.132200,71220,23330,48525,143075
2013-01-28,BATS BYX (Y),81964914,20620991,39752875,142338780,2294991863.513204,911780910.301900,1184843053.620900,4391615827.436004,553183,71228,255423,879834
2013-01-28,BATS BZX (Z),252530743,97964757,182333283,532828783,7476366413.064704,5844033305.073494,5261255083.458086,18581654801.596284,1460628,284036,931517,2676181
2013-01-25,NYSE MKT (A),0,8513385,6215950,14729335,0.000000,61238365.344200,83790326.162000,145028691.506200,0,20755,22126,42881
2013-01-25,NASDAQ BX (B),84781285,29855832,45905876,160542993,2392696090.459101,1399461566.135000,1758410738.292700,5550568394.886801,540756,89619,301935,932310
2013-01-25,NSX (C),11165568,4212826,8115147,23493541,274091045.775500,177541551.597500,259951735.636200,711584333.009200,40852,7949,25605,74406
2013-01-25,NYSE (DN),106354779,16177252,59103086,181635117,3457264450.032113,877968269.897000,2431018540.020095,6766251259.949208,651124,72209,354630,1077963
2013-01-25,NASDAQ (DQ),1162443146,331187512,724822479,2218453137,34560650215.812889,18728594248.641756,26339091055.823433,79628335520.278078,3278211,515602,1757604,5551417
2013-01-25,EDGA (J),98894091,39816729,51928522,190639342,2582374387.226195,1695665318.444401,1519751213.622000,5797790919.292596,616562,114531,325430,1056523
2013-01-25,EDGX (K),220238528,67186980,178716813,466142321,6810891132.665515,2917371574.256901,7120927298.679038,16849190005.601454,1037024,170982,726834,1934840
2013-01-25,CHX (M),19549299,17474976,5196346,42220621,882790034.810000,1862200140.313500,431128725.739000,3176118900.862500,397,1060,1840,3297
2013-01-25,NYSE (N),692422389,0,0,692422389,24177249398.475453,0.000000,0.000000,24177249398.475453,1790799,0,0,1790799
2013-01-25,NYSE Arca (P),300003194,183678667,172558957,656240818,9647071128.352502,10570211599.271296,8390625258.032166,28607907985.655964,1574908,388809,896443,2860160
2013-01-25,NASDAQ (Q),400628930,124587591,425479343,950695864,14072024566.734483,8188207208.317986,17371166801.240998,39631398576.293467,2363761,362934,1895794,4622489
2013-01-25,CBSX (W),14779135,3653563,7920374,26353072,443553742.190000,177632619.280000,224719439.290000,845905800.760000,102800,10065,49658,162523
2013-01-25,NASDAQ PSX (X),18483415,12554512,18133009,49170936,406670366.985000,742243112.335000,467919529.900000,1616833009.220000,74523,26802,51196,152521
2013-01-25,BATS BYX (Y),84095272,21854004,41030861,146980137,2373862318.894001,1022363823.286101,1419549288.965696,4815775431.145798,555599,75866,267646,899111
2013-01-25,BATS BZX (Z),262446065,127812276,181649637,571907978,7921463632.561688,7211786621.698685,6183820758.582592,21317071012.842965,1513446,322544,956110,2792100
2013-01-24,NYSE MKT (A),0,9044000,7182526,16226526,0.000000,58890459.773100,107135681.610000,166026141.383100,0,21727,26346,48073
2013-01-24,NASDAQ BX (B),85994380,28778533,48634901,163407814,2401839284.629300,1682690404.465000,1996216450.058497,6080746139.152797,552836,93757,308559,955152
2013-01-24,NSX (C),13435410,4794419,9303801,27533630,301824660.532200,205022502.343600,291252820.746700,798099983.622500,45073,9427,27425,81925
2013-01-24,NYSE (DN),117418063,20904686,65646499,203969248,3857451539.192710,1222467472.344204,2805019598.902585,7884938610.439499,712039,87103,354116,1153258
2013-01-24,NASDAQ (DQ),1231200696,359668017,730356442,2321225155,35327023730.982525,18476868360.965867,27134180604.170132,80938072696.118524,3573818,548991,1904774,6027583
2013-01-24,EDGA (J),100169346,38758107,57170771,196098224,2528257165.035698,1829076436.931901,1679418236.264901,6036751838.232500,608182,118537,317878,1044597
2013-01-24,EDGX (K),238271834,79564895,192111250,509947979,7023453457.118969,3314983955.563897,7617746615.495153,17956184028.178019,1070074,189949,749519,2009542
2013-01-24,CHX (M),9844055,8631380,4542916,23018351,559803877.555100,637094100.810600,349280273.904100,1546178252.269800,342,1548,1777,3667
2013-01-24,NYSE (N),678557989,0,0,678557989,22517513612.277991,0.000000,0.000000,22517513612.277991,1897392,0,0,1897392
2013-01-24,NYSE Arca (P),356342521,203135598,212999111,772477230,10764331021.206961,11638038017.319329,9786623586.154615,32188992624.680905,1782167,428404,1034974,3245545
2013-01-24,NASDAQ (Q),441058534,139833402,442942359,1023834295,14697472822.909432,8992875874.397124,18948566133.807661,42638914831.114217,2524788,409746,1978533,4913067
2013-01-24,CBSX (W),15799019,4791572,7734926,28325517,472981125.870000,217524928.400000,188314398.340000,878820452.610000,105072,12091,50252,167415
2013-01-24,NASDAQ PSX (X),20372345,15367255,19072683,54812283,457123054.805000,947780319.750000,457298813.165000,1862202187.720000,83785,31570,54007,169362
2013-01-24,BATS BYX (Y),95986359,24099521,47559296,167645176,2640399662.072500,1192185356.754200,1599569861.829999,5432154880.656699,627683,83944,291584,1003211
2013-01-24,BATS BZX (Z),296251318,133563246,213788334,643602898,8668584804.704382,8043711537.452202,7112688852.145509,23824985194.302093,1651038,363765,1050747,3065550
2013-01-23,NYSE MKT (A),0,8292999,6326004,14619003,0.000000,59288075.678300,80203656.657400,139491732.335700,0,20015,23977,43992
2013-01-23,NASDAQ BX (B),85703708,24665445,43152408,153521561,2304809224.545003,1251900507.511900,1590576752.436702,5147286484.493605,528064,77476,260809,866349
2013-01-23,NSX (C),12203999,3965454,7470948,23640401,287700950.502900,142474880.887300,269943024.800800,700118856.191000,39765,7785,21730,69280
2013-01-23,NYSE (DN),111430321,15859750,51056969,178347040,3699189570.000723,856012553.870002,2006262921.715291,6561465045.586016,669107,66800,284548,1020455
2013-01-23,NASDAQ (DQ),1247306999,295486029,620228582,2163021610,36503393126.622684,14658180038.906041,20575620116.168059,71737193281.696784,3437094,459016,1641350,5537460
2013-01-23,EDGA (J),86119729,34222391,43435343,163777463,2188086339.331998,1412814289.615500,1309228778.278000,4910129407.225498,514786,91480,248754,855020
2013-01-23,EDGX (K),223854243,57017760,166786218,447658221,6674457904.453273,2451146735.107501,6643667442.001105,15769272081.561879,985006,141637,631589,1758232
2013-01-23,CHX (M),15774052,5525741,6550314,27850107,1010336899.611400,410273893.142500,450163718.207100,1870774510.961000,362,932,1499,2793
2013-01-23,NYSE (N),638692698,0,0,638692698,21001934838.172054,0.000000,0.000000,21001934838.172054,1703331,0,0,1703331
2013-01-23,NYSE Arca (P),343282328,164323178,184582265,692187771,10800674710.455700,9659218314.652003,8607626651.768981,29067519676.876684,1708569,336932,861260,2906761
2013-01-23,NASDAQ (Q),380268916,94992801,375676398,850938115,12971628098.826060,6192527214.835417,14689363114.522836,33853518428.184313,2199835,285534,1592490,4077859
2013-01-23,CBSX (W),16053262,5831255,7490179,29374696,453025026.780000,277420525.500000,197991033.960000,928436586.240000,106863,9750,46697,163310
2013-01-23,NASDAQ PSX (X),17411180,10971915,16720960,45104055,389743536.810000,660378868.790000,383857795.070000,1433980200.670000,69343,21190,43465,133998
2013-01-23,BATS BYX (Y),97254966,19811326,42678708,159745000,2690247144.429996,926084059.355000,1280022043.149999,4896353246.934995,629091,72640,268704,970435
2013-01-23,BATS BZX (Z),277670400,99449064,178192640,555312104,8177878751.115012,5801405959.714096,5573215322.511004,19552500033.340112,1513354,267630,878498,2659482
2013-01-22,NYSE MKT (A),0,10038476,6681790,16720266,0.000000,68058243.172100,101629623.240000,169687866.412100,0,20654,24657,45311
2013-01-22,NASDAQ BX (B),89622136,24697660,44413520,158733316,2383734690.405001,1241051214.501098,1375329720.425999,5000115625.332098,560816,80625,278375,919816
2013-01-22,NSX (C),13627380,4889718,7929709,26446807,316576528.845200,177256411.379600,188630146.348400,682463086.573200,44036,8781,22718,75535
2013-01-22,NYSE (DN),108570722,18470660,50735003,177776385,3554951331.859107,963732355.557301,1820430271.937285,6339113959.353693,677292,79170,298033,1054495
2013-01-22,NASDAQ (DQ),1182558274,290884122,653043774,2126486170,34157452260.058153,14589581175.293483,17919198649.590786,66666232084.942422,3568900,498619,1707330,5774849
2013-01-22,EDGA (J),86169424,30675155,44930929,161775508,2142193554.813899,1404640716.729101,1162708320.009900,4709542591.552900,512808,89919,254951,857678
2013-01-22,EDGX (K),224553933,58130929,170026199,452711061,6649875012.600599,2493657343.529299,5160008881.638704,14303541237.768602,1003341,153167,628804,1785312
2013-01-22,CHX (M),17033337,7381995,6268032,30683364,789894735.528000,670203371.824500,252782336.536000,1712880443.888500,489,837,1649,2975
2013-01-22,NYSE (N),698987317,0,0,698987317,23655272686.462334,0.000000,0.000000,23655272686.462334,1718951,0,0,1718951
2013-01-22,NYSE Arca (P),359337355,183948257,177115665,720401277,11354856890.287066,10895203427.361121,6292500065.591497,28542560383.239684,1884718,370409,882324,3137451
2013-01-22,NASDAQ (Q),377831562,98550952,392783629,869166143,12762896358.449193,6611466714.464986,12931944995.343443,32306308068.257622,2200525,302872,1591828,4095225
2013-01-22,CBSX (W),16422387,3916730,8129841,28468958,441186224.080000,225508349.480000,189716083.130000,856410656.690000,107192,9294,51428,167914
2013-01-22,NASDAQ PSX (X),15815382,9722579,16184285,41722246,368774252.655000,603851844.440000,370882612.880000,1343508709.975000,70785,22317,45780,138882
2013-01-22,BATS BYX (Y),100239283,20194235,44095270,164528788,2760287788.187202,927531866.492000,1260639032.125400,4948458686.804602,656329,74319,282603,1013251
2013-01-22,BATS BZX (Z),281984002,101429941,178950049,562363992,8214306765.909497,5938035451.176396,5093039162.429417,19245381379.515310,1553892,278113,892146,2724151
2013-01-18,NYSE MKT (A),0,9492834,6678303,16171137,0.000000,64663565.379700,106250055.949000,170913621.328700,0,18279,24456,42735
2013-01-18,NASDAQ BX (B),89854073,29300057,49011389,168165519,2422771182.221800,1607064905.816400,1428103110.219002,5457939198.257202,561449,87986,299958,949393
2013-01-18,NSX (C),12404366,4966374,8428004,25798744,294007358.355900,232720112.612300,193088973.876700,719816444.844900,38560,8179,23451,70190
2013-01-18,NYSE (DN),107925231,20296986,52945894,181168111,3591657455.892778,1030897554.278102,1828803046.121189,6451358056.292069,644637,84111,300574,1029322
2013-01-18,NASDAQ (DQ),1118788914,342823101,618309293,2079921308,31401605984.883127,20461415416.846310,17302918451.432452,69165939853.161889,3153272,494086,1554509,5201867
2013-01-18,EDGA (J),83352900,34816136,45242184,163411220,2050537991.266100,1622917348.736399,1141453106.787099,4814908446.789598,485532,96627,246034,828193
2013-01-18,EDGX (K),224390097,64560915,164250641,453201653,6736835348.585403,3057137236.837300,4759500845.826794,14553473431.249497,964480,157116,595594,1717190
2013-01-18,CHX (M),11131246,10899067,6596228,28626541,436488630.000700,914743192.662200,778477214.556200,2129709037.219100,756,1053,2015,3824
2013-01-18,NYSE (N),1068377958,0,0,1068377958,34824729919.095313,0.000000,0.000000,34824729919.095313,1604653,0,0,1604653
2013-01-18,NYSE Arca (P),336088470,191459749,175572126,703120345,10473421265.058619,11303881219.055993,6185557451.234409,27962859935.349021,1684776,377597,823814,2886187
2013-01-18,NASDAQ (Q),352753076,112948880,513128769,978830725,11740417050.224205,7730060987.586812,16821704294.975153,36292182332.786170,1981770,333782,1549000,3864552
2013-01-18,CBSX (W),15972112,4599632,7147691,27719435,472040013.580000,193794179.400000,173613692.020000,839447885.000000,101798,10148,46841,158787
2013-01-18,NASDAQ PSX (X),17845582,12777356,19074130,49697068,403598966.440000,822274404.790000,392697150.595000,1618570521.825000,73035,25097,50862,148994
2013-01-18,BATS BYX (Y),100029389,22414772,48072118,170516279,2795042051.507698,1122199061.603100,1312223299.970801,5229464413.081599,651467,79544,300137,1031148
2013-01-18,BATS BZX (Z),272907472,119955101,190616031,583478604,8060503456.518874,7239438916.348596,5439147730.829707,20739090103.697177,1463018,311740,891554,2666312
2013-01-17,NYSE MKT (A),0,8238959,6457433,14696392,0.000000,50121901.839700,98445883.679000,148567785.518700,0,18636,23877,42513
2013-01-17,NASDAQ BX (B),87672004,28453078,45648541,161773623,2254515434.161201,1365384736.335000,1297034742.217999,4916934912.714200,529995,88318,274589,892902
2013-01-17,NSX (C),13595723,4746825,7822781,26165329,315013475.302200,190706527.741100,183895894.208400,689615897.251700,40105,8940,22047,71092
2013-01-17,NYSE (DN),114562018,20848812,51308541,186719371,3710131300.255188,1093302422.741501,1696901327.693890,6500335050.690579,664955,82921,297732,1045608
2013-01-17,NASDAQ (DQ),1267117262,359077428,616931368,2243126058,34917136218.728329,18162747453.309485,17259056800.206618,70338940472.244432,3418855,506004,1562445,5487304
2013-01-17,EDGA (J),86278101,38101625,45329775,169709501,2127676528.328301,1650241926.162598,1149727358.204397,4927645812.695296,495179,107227,245225,847631
2013-01-17,EDGX (K),242268835,68888398,168332019,479489252,7042494596.832289,2991874993.323602,4962473559.857298,14996843150.013189,1031991,171492,625287,1828770
2013-01-17,CHX (M),16956899,12035910,7443700,36436509,568916237.378000,945628611.942800,480327440.716700,1994872290.037500,275,1488,2147,3910
2013-01-17,NYSE (N),710016598,0,0,710016598,23183003957.929997,0.000000,0.000000,23183003957.929997,1697045,0,0,1697045
2013-01-17,NYSE Arca (P),377792010,195297976,179733388,752823374,11564253012.524268,12351210867.169420,6162686173.150893,30078150052.844581,1826341,393775,838263,3058379
2013-01-17,NASDAQ (Q),377106493,121346189,388896842,887349524,12609344779.794358,8626724765.475404,12151125474.816860,33387195020.086622,2136580,366426,1578564,4081570
2013-01-17,CBSX (W),14626028,4979179,7899598,27504805,426630172.850000,265710986.600000,188627637.580000,880968797.030000,95404,9200,45538,150142
2013-01-17,NASDAQ PSX (X),17861484,12781363,18765702,49408549,384496239.150000,775284187.520000,384680348.500000,1544460775.170000,71590,26985,49543,148118
2013-01-17,BATS BYX (Y),102397217,24562465,47983149,174942831,2841611961.934999,1167080774.939999,1370999392.117500,5379692128.992498,665087,84425,300511,1050023
2013-01-17,BATS BZX (Z),300258217,123198348,185238238,608694803,8691161605.837586,7597173347.621702,5195043287.260303,21483378240.719591,1605576,329695,897974,2833245
2013-01-16,NYSE MKT (A),0,7410946,6259741,13670687,0.000000,45576857.808700,96438178.214000,142015036.022700,0,15172,22023,37195
2013-01-16,NASDAQ BX (B),76678472,22189761,40544531,139412764,1992777020.696399,1091693675.166401,1299508512.390298,4383979208.253098,485124,70893,258074,814091
2013-01-16,NSX (C),10971641,3868818,6989991,21830450,273814294.981500,146658741.140600,158956265.607200,579429301.729300,36569,7876,20240,64685
2013-01-16,NYSE (DN),98719243,14196078,47946000,160861321,3113677652.377387,731224423.133400,1790670461.273299,5635572536.784086,567352,63554,277874,908780
2013-01-16,NASDAQ (DQ),1071935126,259478807,603629948,1935043881,30449515197.270085,13277128371.127484,18518730684.588865,62245374252.986434,2946765,395728,1496965,4839458
2013-01-16,EDGA (J),76192129,27226154,39053082,142471365,1851683833.815402,1264500938.664700,951072475.673200,4067257248.153302,443509,81302,221028,745839
2013-01-16,EDGX (K),197386763,49724049,163191479,410302291,5838844663.135803,2089289035.638799,5330252557.897704,13258386256.672306,868090,125586,594283,1587959
2013-01-16,CHX (M),13031499,19055472,4871291,36958262,374212041.304800,807560334.032400,259947652.042800,1441720027.380000,341,959,1570,2870
2013-01-16,NYSE (N),599777620,0,0,599777620,19527055541.803561,0.000000,0.000000,19527055541.803561,1521598,0,0,1521598
2013-01-16,NYSE Arca (P),319570156,150307332,168292577,638170065,10025191550.466015,8432132244.941402,6233671037.602716,24690994833.010133,1637148,305918,820217,2763283
2013-01-16,NASDAQ (Q),328942793,92971824,365325693,787240310,10912182012.684355,6686965256.565007,12206418652.946326,29805565922.195688,1896895,295699,1511276,3703870
2013-01-16,CBSX (W),13950008,2899353,7267084,24116445,372360303.600000,147748336.670000,164420499.626800,684529139.896800,89340,7597,45419,142356
2013-01-16,NASDAQ PSX (X),16249407,8873628,15548843,40671878,348708072.550000,640736335.700000,348796801.190000,1338241209.440000,66551,20157,45415,132123
2013-01-16,BATS BYX (Y),91724897,19151185,47628401,158504483,2482032329.037601,923741527.185000,1333556604.143001,4739330460.365602,600464,69454,299331,969249
2013-01-16,BATS BZX (Z),256776758,96143642,180254550,533174950,7345338530.330008,5713020910.992701,5082083650.368505,18140443091.691214,1399107,258354,885807,2543268
2013-01-15,NYSE MKT (A),0,8499012,5267703,13766715,0.000000,58150811.177700,81947939.715000,140098750.892700,0,17712,20906,38618
2013-01-15,NASDAQ BX (B),74367456,23853464,44014586,142235506,1928812739.707999,1150606443.175800,1468812091.373498,4548231274.257297,475697,76316,268679,820692
2013-01-15,NSX (C),11032967,4176316,8901147,24110430,264627675.328600,165354435.656700,263220548.363000,693202659.348300,37508,8470,25751,71729
2013-01-15,NYSE (DN),96161595,15465434,54840185,166467214,3056202561.283599,827570814.247901,2168024277.097299,6051797652.628799,569086,67676,298691,935453
2013-01-15,NASDAQ (DQ),1042295305,262912495,659473586,1964681386,28284787795.078540,12731093187.123330,21487155795.416348,62503036777.618218,2963821,434539,1651233,5049593
2013-01-15,EDGA (J),76121213,32914184,46575994,155611391,1794224900.880000,1429164245.139701,1153847216.872799,4377236362.892500,440788,95662,247846,784296
2013-01-15,EDGX (K),192506025,56085449,181089586,429681060,5544208943.490288,2339112572.560898,6284995264.636877,14168316780.688063,876941,141017,657241,1675199
2013-01-15,CHX (M),14435090,6455740,4662058,25552888,472053550.436600,513573469.996600,172768745.873700,1158395766.306900,538,1147,2259,3944
2013-01-15,NYSE (N),603250611,0,0,603250611,18918736003.905507,0.000000,0.000000,18918736003.905507,1558141,0,0,1558141
2013-01-15,NYSE Arca (P),313645401,169604186,198330396,681579983,9393729894.261105,9878918259.190119,7393844811.220084,26666492964.671308,1669984,345180,944363,2959527
2013-01-15,NASDAQ (Q),343386158,102422448,388569978,834378584,10937608235.449993,6773194078.432589,13652299814.176353,31363102128.058935,1980177,309307,1692403,3981887
2013-01-15,CBSX (W),13701685,3542920,8046596,25291201,355502290.320000,194434459.620000,184602920.470000,734539670.410000,89554,7877,50255,147686
2013-01-15,NASDAQ PSX (X),17079095,11148909,20383316,48611320,358560555.235000,642618988.050000,444334477.000000,1445514020.285000,68458,22736,54279,145473
2013-01-15,BATS BYX (Y),90797507,19478775,48568523,158844805,2449058206.468402,943783322.487600,1437610899.242502,4830452428.198504,606454,72758,312482,991694
2013-01-15,BATS BZX (Z),256359537,106464914,191229010,554053461,7215086249.974099,6341221779.849599,5686439277.694488,19242747307.518186,1405058,282629,948934,2636621
2013-01-14,NYSE MKT (A),0,8135379,5254652,13390031,0.000000,49573316.777200,78931306.492000,128504623.269200,0,17437,23253,40690
2013-01-14,NASDAQ BX (B),73832911,23919766,46944778,144697455,1866590859.534999,1144141759.708800,1480060061.242200,4490792680.485999,469937,75465,283175,828577
2013-01-14,NSX (C),10632723,4107011,8087501,22827235,249291528.319700,167499279.192200,184182179.645600,600972987.157500,37532,8024,24163,69719
2013-01-14,NYSE (DN),85280518,16010764,49334971,150626253,2615094383.787687,785091443.137700,1802187815.133002,5202373642.058389,519261,66587,268185,854033
2013-01-14,NASDAQ (DQ),990265254,251393358,663414095,1905072707,26743638953.467514,11289640133.457189,18189012767.346479,56222291854.271182,2826695,417344,1593047,4837086
2013-01-14,EDGA (J),70445936,28373489,45188764,144008189,1662263757.335699,1269094811.134401,1098954821.380498,4030313389.850598,412248,85376,234777,732401
2013-01-14,EDGX (K),191709091,52992933,188130103,432832127,5329391919.944406,2183174723.836200,5692975810.409919,13205542454.190525,866969,135317,645231,1647517
2013-01-14,CHX (M),6600252,11070836,4364429,22035517,236665118.608100,627656257.174700,144687059.305400,1009008435.088200,252,993,2349,3594
2013-01-14,NYSE (N),590486417,0,0,590486417,19022406648.034420,0.000000,0.000000,19022406648.034420,1555657,0,0,1555657
2013-01-14,NYSE Arca (P),304052554,163107071,188735746,655895371,8836791393.630308,9108727147.632386,6977105731.056280,24922624272.318974,1585602,343110,876376,2805088
2013-01-14,NASDAQ (Q),313222774,97112628,404536008,814871410,10062339706.858905,6869372229.893996,13941659487.724236,30873371424.477137,1834211,315437,1618794,3768442
2013-01-14,CBSX (W),14140931,3669240,8950829,26761000,370784463.260000,142929512.490000,192675729.870000,706389705.620000,97359,8653,53114,159126
2013-01-14,NASDAQ PSX (X),14433488,10119321,17991962,42544771,291165787.925000,654820381.980000,377730222.505000,1323716392.410000,59404,22226,48762,130392
2013-01-14,BATS BYX (Y),84622639,18539184,47406036,150567859,2261621181.708103,902384175.783000,1312992329.186701,4476997686.677804,578879,68759,292307,939945
2013-01-14,BATS BZX (Z),257205382,98949093,201230924,557385399,7154659823.536116,5875052109.697489,5691491979.690903,18721203912.924508,1393790,281835,952928,2628553
2013-01-11,NYSE MKT (A),0,8589811,4859019,13448830,0.000000,56415395.117500,72128542.484000,128543937.601500,0,17009,20189,37198
2013-01-11,NASDAQ BX (B),80675150,24098857,44900934,149674941,2031016755.812800,1155300004.052200,1191728858.218301,4378045618.083301,498184,72404,259698,830286
2013-01-11,NSX (C),12416077,4463794,9659647,26539518,285387234.125400,147371507.554400,166128549.348100,598887291.027900,39070,8685,22969,70724
2013-01-11,NYSE (DN),95850579,16889377,52079717,164819673,3023259416.123391,862202101.518300,1521983103.685000,5407444621.326691,583777,74412,267589,925778
2013-01-11,NASDAQ (DQ),1129435551,288148814,655163572,2072747937,31009521600.305415,15222821016.500306,16896994054.949494,63129336671.755215,2961889,428910,1447554,4838353
2013-01-11,EDGA (J),78709878,31366212,44487544,154563634,1862692186.202597,1395304599.523800,912583554.341201,4170580340.067598,449724,87985,219574,757283
2013-01-11,EDGX (K),216848393,57044955,173719995,447613343,6093411652.052789,2330607230.011500,4527795775.027582,12951814657.091871,921376,139126,589039,1649541
2013-01-11,CHX (M),23162267,7538482,7317277,38018026,586034177.071500,501047143.877800,341119534.591300,1428200855.540600,366,1138,1492,2996
2013-01-11,NYSE (N),632965925,0,0,632965925,20115654462.269193,0.000000,0.000000,20115654462.269193,1612293,0,0,1612293
2013-01-11,NYSE Arca (P),340978973,167158104,171938799,680075876,10014959837.463808,10083109968.502874,5467663516.070515,25565733322.037197,1713580,332575,811028,2857183
2013-01-11,NASDAQ (Q),337829833,95457464,352559911,785847208,10764104719.187430,6469933062.486301,10639014155.612709,27873051937.286440,1949416,298735,1514102,3762253
2013-01-11,CBSX (W),13612342,4623803,7220805,25456950,355226384.490000,254286284.976400,152127620.780000,761640290.246400,89910,8526,45126,143562
2013-01-11,NASDAQ PSX (X),18572142,10118220,18233550,46923912,396128509.495000,603403560.075000,328159604.410000,1327691673.980000,76053,22395,47740,146188
2013-01-11,BATS BYX (Y),96471978,19569578,48664322,164705878,2600767357.674996,898064616.724999,1149849590.513800,4648681564.913795,640205,69702,291899,1001806
2013-01-11,BATS BZX (Z),264522416,97463417,186189592,548175425,7428861912.754904,5753205558.637891,4815854480.840611,17997921952.233406,1427002,270338,881427,2578767
2013-01-10,NYSE MKT (A),0,8062175,5065882,13128057,0.000000,53925914.384100,75582225.861000,129508140.245100,0,18719,20425,39144
2013-01-10,NASDAQ BX (B),104399336,29666199,45115548,179181083,2511102746.084997,1458624723.523501,1489640958.768200,5459368428.376698,598235,90962,281857,971054
2013-01-10,NSX (C),14294478,5305224,9249532,28849234,323330246.326300,222202029.563900,178096833.178800,723629109.069000,44511,10255,26156,80922
2013-01-10,NYSE (DN),124623775,20144647,54184772,198953194,3622016460.391087,1078061865.745205,1847073607.110388,6547151933.246680,725890,93327,302801,1122018
2013-01-10,NASDAQ (DQ),1370086234,319899019,630209551,2320194804,35851664727.868649,17136120795.954288,18790799204.840430,71778584728.663367,3467220,496943,1530908,5495071
2013-01-10,EDGA (J),97738273,35028768,40037250,172804291,2155549257.739400,1575068912.586499,999844240.562902,4730462410.888801,523936,100418,224893,849247
2013-01-10,EDGX (K),274368889,63878301,174491919,512739109,7223512998.924304,2767335355.924599,5604138783.498617,15594987138.347520,1106704,166445,639540,1912689
2013-01-10,CHX (M),13606996,8318246,3314966,25240208,425053430.681500,683221933.367300,211160173.472500,1319435537.521300,500,1158,1615,3273
2013-01-10,NYSE (N),726924466,0,0,726924466,22823307181.329760,0.000000,0.000000,22823307181.329760,1772703,0,0,1772703
2013-01-10,NYSE Arca (P),440297907,188339044,168844349,797481300,11962621197.466930,10746820334.712918,6689608188.493773,29399049720.673621,1949234,392983,840037,3182254
2013-01-10,NASDAQ (Q),421234162,126246190,365861979,913342331,12951390866.568846,8796228456.723399,12466915529.128602,34214534852.420847,2244904,388877,1576616,4210397
2013-01-10,CBSX (W),16536898,3304237,8251743,28092878,425739600.090000,142936767.103200,176538958.871000,745215326.064200,103843,9705,48512,162060
2013-01-10,NASDAQ PSX (X),21772302,11610637,17490073,50873012,454108094.425000,670781253.080000,407828000.615000,1532717348.120000,86114,23314,47379,156807
2013-01-10,BATS BYX (Y),118319437,23251772,52200378,193771587,3009505658.289200,1138589522.097501,1373840626.453200,5521935806.839901,737758,85731,322183,1145672
2013-01-10,BATS BZX (Z),338605954,125286755,187755032,651647741,9043592238.658321,7495923677.696604,5538052590.336818,22077568506.691743,1717993,345384,941363,3004740
2013-01-09,NYSE MKT (A),0,8053654,4514208,12567862,0.000000,53908781.026900,64771222.296000,118680003.322900,0,17184,19539,36723
2013-01-09,NASDAQ BX (B),91034554,23485433,43393007,157912994,2338503338.844700,1120900307.561699,1269469031.048203,4728872677.454602,543409,74971,273593,891973
2013-01-09,NSX (C),14007606,3849901,8210658,26068165,308314828.380100,143203211.741200,170591544.023100,622109584.144400,42915,7992,23046,73953
2013-01-09,NYSE (DN),109728998,15737750,47454518,172921266,3328847477.066007,787143758.781301,1566994661.105591,5682985896.952899,641271,70411,281478,993160
2013-01-09,NASDAQ (DQ),1271962994,269879977,630832931,2172675902,32792967243.241773,12679574408.050661,16213746996.257847,61686288647.550281,3294640,451608,1515354,5261602
2013-01-09,EDGA (J),82347789,28732705,38059734,149140228,1847037329.752901,1283243784.760900,846392037.691999,3976673152.205800,462381,90663,215343,768387
2013-01-09,EDGX (K),251311980,58588154,173315212,483215346,6730986818.444200,2444213843.309102,4889743813.078295,14064944474.831597,1043661,145805,621446,1810912
2013-01-09,CHX (M),10378634,10541715,3178952,24099301,329828530.631200,833925628.769200,127027807.731900,1290781967.132300,298,759,1228,2285
2013-01-09,NYSE (N),671740340,0,0,671740340,20617748476.858080,0.000000,0.000000,20617748476.858080,1710402,0,0,1710402
2013-01-09,NYSE Arca (P),374467407,151687298,181693970,707848675,10971270294.974942,8802985789.299115,5596749554.390003,25371005638.664060,1824101,333344,840564,2998009
2013-01-09,NASDAQ (Q),374601275,100918195,363091687,838611157,11933287862.077184,6797443664.171804,10913746888.393864,29644478414.642852,2112938,322095,1559867,3994900
2013-01-09,CBSX (W),15586099,3670345,7419802,26676246,408015636.460000,166783787.550000,171876692.056400,746676116.066400,101415,9756,47549,158720
2013-01-09,NASDAQ PSX (X),20180996,9411121,17787073,47379190,430784986.875000,489071118.460000,318017943.925000,1237874049.260000,74893,20212,44037,139142
2013-01-09,BATS BYX (Y),107301269,19516012,50098273,176915554,2816676054.997296,923027592.767000,1202901489.139698,4942605136.903994,680806,74416,308323,1063545
2013-01-09,BATS BZX (Z),282568606,91199790,179176495,552944891,7729474372.575198,5332373414.557507,4706456134.082392,17768303921.215097,1536803,266549,914664,2718016
2013-01-08,NYSE MKT (A),0,8834801,4550856,13385657,0.000000,52183130.343500,55016407.806000,107199538.149500,0,18503,18679,37182
2013-01-08,NASDAQ BX (B),89015005,24981159,45177368,159173532,2356749098.002094,1238318241.528199,1459940173.994297,5055007513.524590,554387,81474,292714,928575
2013-01-08,NSX (C),10961331,3965404,6979585,21906320,243958649.573900,126305516.036200,130311292.407900,500575458.018000,36131,7462,19327,62920
2013-01-08,NYSE (DN),115324908,17912052,51054499,184291459,3491438803.252801,908353504.111802,1761663143.365491,6161455450.730094,683722,77510,302350,1063582
2013-01-08,NASDAQ (DQ),1190826711,280453993,610219601,2081500305,31607677593.734555,14403710064.468420,16606161637.133309,62617549295.336284,3321666,442823,1525481,5289970
2013-01-08,EDGA (J),83088334,33783615,39563058,156435007,2024554245.891898,1455775984.692798,913582375.712998,4393912606.297694,486230,93865,231027,811122
2013-01-08,EDGX (K),238858662,65509275,175568353,479936290,6663204772.817596,2759960288.223997,4886597598.869012,14309762659.910605,1077594,163682,645311,1886587
2013-01-08,CHX (M),14917728,6841896,3876005,25635629,454129802.234400,410982002.011400,257862319.281700,1122974123.527500,343,1371,1556,3270
2013-01-08,NYSE (N),693543015,0,0,693543015,22163152154.682731,0.000000,0.000000,22163152154.682731,1731082,0,0,1731082
2013-01-08,NYSE Arca (P),353171103,168295877,168866162,690333142,10598863842.436696,9431847806.634714,5698440125.952200,25729151775.023610,1817903,359484,846358,3023745
2013-01-08,NASDAQ (Q),380072306,107002631,386434875,873509812,12350082164.197637,7357316399.695411,11807240457.382352,31514639021.275400,2170622,339058,1600859,4110539
2013-01-08,CBSX (W),15559574,5714339,7931967,29205880,423294297.160000,231396667.473100,169715735.130000,824406699.763100,105102,9392,50362,164856
2013-01-08,NASDAQ PSX (X),19979491,10737374,16362369,47079234,471302271.940000,600173736.990000,345549012.200000,1417025021.130000,84059,24074,48633,156766
2013-01-08,BATS BYX (Y),108768377,21198509,51271206,181238092,2950544852.374999,1034775210.244100,1287541914.193001,5272861976.812100,718769,79726,329967,1128462
2013-01-08,BATS BZX (Z),288814336,99977876,180282173,569074385,8264533304.923675,5898543508.827710,4788656602.396503,18951733416.147888,1637956,297027,942655,2877638
2013-01-07,NYSE MKT (A),0,9346331,5382205,14728536,0.000000,72082111.747400,69196789.262000,141278901.009400,0,19234,21189,40423
2013-01-07,NASDAQ BX (B),81797998,22191357,43933185,147922540,2125810588.310003,1088558200.594300,1331317902.879997,4545686691.784300,521190,75131,280440,876761
2013-01-07,NSX (C),9883092,3424927,6741001,20049020,247121828.229800,140240977.812800,122328471.660800,509691277.703400,35456,7088,19339,61883
2013-01-07,NYSE (DN),99351691,17222975,50246452,166821118,3136144591.805991,856594762.292002,1672011489.779793,5664750843.877786,606081,75234,288296,969611
2013-01-07,NASDAQ (DQ),1097595581,302180783,604870509,2004646873,29671334648.585420,15648803954.640436,16166633007.191674,61486771610.417530,3199025,462501,1542001,5203527
2013-01-07,EDGA (J),75742227,33612329,41299306,150653862,1811625189.650201,1448983708.991101,931082920.924297,4191691819.565599,444938,106822,232210,783970
2013-01-07,EDGX (K),233478968,56556772,178111428,468147168,6784667737.297684,2336458494.025303,5062707288.038510,14183833519.361497,1065569,149329,644321,1859219
2013-01-07,CHX (M),10182097,9274048,2847224,22303369,319652020.396600,886157696.580000,75853495.532300,1281663212.508900,329,964,1426,2719
2013-01-07,NYSE (N),625695630,0,0,625695630,20052793953.896820,0.000000,0.000000,20052793953.896820,1690614,0,0,1690614
2013-01-07,NYSE Arca (P),333368785,168095951,169037943,670502679,10109376367.638780,9777450578.189531,5934071312.696999,25820898258.525310,1761574,366386,845312,2973272
2013-01-07,NASDAQ (Q),348215760,94905843,361677215,804798818,11452230322.964477,6290850018.206709,11480699298.068924,29223779639.240110,2048738,300693,1542123,3891554
2013-01-07,CBSX (W),16455531,4617932,8226827,29300290,451434699.630000,241130774.080000,172916597.330000,865482071.040000,113116,7956,52679,173751
2013-01-07,NASDAQ PSX (X),18043568,8859751,15061208,41964527,427440676.430000,465424679.440000,320384941.830000,1213250297.700000,78074,19687,48156,145917
2013-01-07,BATS BYX (Y),101458955,19698997,48133530,169291482,2735589343.395003,976847573.877800,1203555428.817801,4915992346.090604,670708,73817,307164,1051689
2013-01-07,BATS BZX (Z),254437873,98606661,171935021,524979555,7394013527.491794,5793847491.934793,4726831808.473604,17914692827.900191,1490163,285406,904471,2680040
2013-01-04,NYSE MKT (A),0,9070569,5239795,14310364,0.000000,72098271.792600,64028013.057000,136126284.849600,0,21203,19427,40630
2013-01-04,NASDAQ BX (B),86518396,25665160,45552330,157735886,2259691135.750000,1234702690.645000,1365918765.505001,4860312591.900001,543224,85137,278593,906954
2013-01-04,NSX (C),10520395,3536017,7434520,21490932,241589733.553800,139727626.919100,134948311.799400,516265672.272300,33888,6668,19630,60186
2013-01-04,NYSE (DN),107102257,18342667,51924182,177369106,3279318953.512790,853173109.577801,1590951072.785793,5723443135.876384,647243,79441,300443,1027127
2013-01-04,NASDAQ (DQ),1119460564,304148993,623828910,2047438467,30216934801.652491,14639460731.235467,16616256102.309490,61472651635.197448,3230418,528787,1566530,5325735
2013-01-04,EDGA (J),84909523,34288044,44111748,163309315,2081524341.714401,1613242738.759301,988197226.006800,4682964306.480502,503524,109941,233531,846996
2013-01-04,EDGX (K),227729890,68829768,170154775,466714433,6467923232.152400,3044593910.521200,5286195125.641591,14798712268.315191,1038815,182986,618999,1840800
2013-01-04,CHX (M),9981254,12186869,3222706,25390829,292524636.484000,1005467554.066800,141061948.707300,1439054139.258100,350,1809,1337,3496
2013-01-04,NYSE (N),651287621,0,0,651287621,20985243766.094339,0.000000,0.000000,20985243766.094339,1733176,0,0,1733176
2013-01-04,NYSE Arca (P),347335721,197798426,171867865,717002012,10518342726.268298,12250858605.179932,6607396592.264210,29376597923.712440,1840651,441475,852467,3134593
2013-01-04,NASDAQ (Q),371707351,124409636,379608685,875725672,12114401068.603021,8532039072.982189,12139569202.110529,32786009343.695739,2184851,387797,1611248,4183896
2013-01-04,CBSX (W),16053748,3516364,8319864,27889976,450341463.460000,156590472.030000,195059342.513200,801991278.003200,108588,9886,53130,171604
2013-01-04,NASDAQ PSX (X),19856824,10956888,16454043,47267755,481141209.405000,623474152.418800,365660693.125000,1470276054.948800,91342,24280,48990,164612
2013-01-04,BATS BYX (Y),102907418,22111869,49168737,174188024,2821243755.221301,1067022734.274300,1221713531.299601,5109980020.795202,697067,85063,316211,1098341
2013-01-04,BATS BZX (Z),269772112,113368251,170933372,554073735,7852146728.240610,7178816878.381908,4980189976.129810,20011153582.752328,1579916,335208,894708,2809832
2013-01-03,NYSE MKT (A),0,10281830,6042540,16324370,0.000000,67807048.612900,84428132.880000,152235181.492900,0,22722,20631,43353
2013-01-03,NASDAQ BX (B),98249281,34338184,51600606,184188071,2513065381.864998,1715358755.159999,1436855385.778495,5665279522.803492,631175,111343,315579,1058097
2013-01-03,NSX (C),11998695,4022405,7714869,23735969,292743183.110600,155192707.912800,137063891.964300,584999782.987700,39813,8242,21041,69096
2013-01-03,NYSE (DN),119723665,21906765,56462253,198092683,3655988139.067686,1114760007.250902,1628752416.013298,6399500562.331886,731091,94076,322792,1147959
2013-01-03,NASDAQ (DQ),1237703728,389253555,621223530,2248180813,34339322917.120653,19706189906.743780,16867374423.074070,70912887246.938503,3595194,606224,1585297,5786715
2013-01-03,EDGA (J),93333441,43832626,44689905,181855972,2307022034.378298,2242609259.627901,1020592798.917301,5570224092.923500,567362,143658,249765,960785
2013-01-03,EDGX (K),271623805,85600601,170765168,527989574,7709145938.150084,3782274061.583001,4929829948.710115,16421249948.443200,1232597,224500,649156,2106253
2013-01-03,CHX (M),11142275,10658225,3076179,24876679,398371946.830300,804529083.471000,130407658.560400,1333308688.861700,375,1636,1456,3467
2013-01-03,NYSE (N),707024164,0,0,707024164,22930988729.273034,0.000000,0.000000,22930988729.273034,1929458,0,0,1929458
2013-01-03,NYSE Arca (P),405711725,242928198,186966017,835605940,12254411876.902246,14761028780.967960,6410853757.637298,33426294415.507504,2133450,512107,926687,3572244
2013-01-03,NASDAQ (Q),423971705,155582529,395092623,974646857,13682004974.729788,10641991820.585985,12205685840.998662,36529682636.314435,2428743,466302,1718887,4613932
2013-01-03,CBSX (W),15134671,4769076,7228527,27132274,421084626.570000,247703638.640000,161360009.920000,830148275.130000,106048,11066,46861,163975
2013-01-03,NASDAQ PSX (X),22577244,15859117,17045266,55481627,539207489.210000,866758888.590000,400220013.465000,1806186391.265000,99200,31149,52546,182895
2013-01-03,BATS BYX (Y),114667796,28948469,49306476,192922741,3145178326.835004,1442251082.536000,1267513435.817503,5854942845.188507,770103,104651,316096,1190850
2013-01-03,BATS BZX (Z),297950136,134096521,171914865,603961522,8621283957.376311,8254892149.404894,4742448261.650200,21618624368.431405,1750197,393840,920380,3064417
2013-01-02,NYSE MKT (A),0,12344455,5633079,17977534,0.000000,92065867.928100,70387784.468700,162453652.396800,0,24592,21448,46040
2013-01-02,NASDAQ BX (B),101684204,45012980,55953135,202650319,2595570478.984400,2357403195.799500,1604989419.753200,6557963094.537100,625385,132825,332556,1090766
2013-01-02,NSX (C),13495940,4991944,8974020,27461904,321572768.438500,229024414.184400,186774634.894900,737371817.517800,42488,10124,26242,78854
2013-01-02,NYSE (DN),124890406,26627746,62779363,214297515,3821807247.820587,1405255798.202102,1850663240.449910,7077726286.472599,775836,122023,363003,1260862
2013-01-02,NASDAQ (DQ),1321476868,527830903,705512557,2554820328,35946315049.585856,27965575998.668006,20007417791.771080,83919308840.024942,3921407,743036,1878357,6542800
2013-01-02,EDGA (J),102629472,57274666,51023904,210928042,2558035391.002998,3005083941.985501,1209324637.619900,6772443970.608399,615069,180274,283863,1079206
2013-01-02,EDGX (K),287851957,111014891,207343078,606209926,8197642402.066206,5321830963.620998,6012739298.373897,19532212664.061101,1295049,286300,793207,2374556
2013-01-02,CHX (M),8110809,7262196,2806657,18179662,321808873.876400,508095090.971200,118389995.311100,948293960.158700,501,1913,1576,3990
2013-01-02,NYSE (N),859175596,0,0,859175596,28058406759.471228,0.000000,0.000000,28058406759.471228,2214205,0,0,2214205
2013-01-02,NYSE Arca (P),452312372,333277741,218290485,1003880598,14153907317.962038,20038167583.976097,8037587136.495112,42229662038.433247,2435167,662264,1089170,4186601
2013-01-02,NASDAQ (Q),437837599,195930976,505736253,1139504828,14529790210.815159,13134258060.969041,16169615061.123776,43833663332.907976,2606546,568244,2106095,5280885
2013-01-02,CBSX (W),17981963,6914296,9422808,34319067,471823751.950000,392155303.310000,204632850.923000,1068611906.183000,116381,13807,59887,190075
2013-01-02,NASDAQ PSX (X),23551409,20248381,20244003,64043793,640606577.520000,1139423690.770000,488006991.820000,2268037260.110000,117029,41842,66309,225180
2013-01-02,BATS BYX (Y),129391125,36155800,63170005,228716930,3527301289.997696,1873859816.844503,1626789166.303997,7027950273.146196,865624,129962,407515,1403101
2013-01-02,BATS BZX (Z),323225702,181154116,211973653,716353471,9642976989.642427,11512879962.295491,6015350561.562878,27171207513.500796,1957576,511684,1156496,3625756
