Day,Market Participant,Tape A Shares,Tape B Shares,Tape C Shares,Total Shares,Tape A Notional,Tape B Notional,Tape C Notional,Total Notional,Tape A Trade Count,Tape B Trade Count,Tape C Trade Count,Total Trade Count
2018-12-31,NYSE American (A),5446922,16623229,2136144,24206295,206002324.155200,206124838.999700,100806681.688200,512933844.843100,50149,40802,20906,111857
2018-12-31,NASDAQ BX (B),75242142,35337447,40462883,151042472,2766566662.077300,2020953624.636100,1834149955.362500,6621670242.075900,743703,182992,409767,1336462
2018-12-31,NYSE National (C),37472438,20175919,16808213,74456570,879150944.761000,693061803.461600,570775966.317000,2142988714.539600,324857,89282,170406,584545
2018-12-31,FINRA / NYSE TRF (DN),223690822,142984062,206261024,572935908,5007570098.675600,6245700331.491802,8468072176.181602,19721342606.349004,484602,251112,478680,1214394
2018-12-31,FINRA / Nasdaq TRF Carteret (DQ),936579275,661943842,602130390,2200653507,29550030788.151394,42443995528.962894,28306045001.072604,100300071318.186892,3433707,1390856,2034933,6859496
2018-12-31,EDGA Equities (J),50546618,34081082,27702424,112330124,1811660697.710100,2021339117.023100,1508582968.860300,5341582783.593500,483700,173328,259750,916778
2018-12-31,EDGX Equities (K),154205119,103395469,113925935,371526523,4441485189.051900,6635474300.171797,5255817579.669401,16332777068.893098,1002007,464624,731650,2198281
2018-12-31,CHX (M),8916482,17262644,7768404,33947530,353850741.987600,1618150573.875000,808710752.392200,2780712068.254800,4342,11359,7696,23397
2018-12-31,NYSE (N),985652800,50973718,35997903,1072624421,35720368066.773798,3606425477.418300,1898188342.752100,41224981886.944198,2744174,176739,204509,3125422
2018-12-31,NYSE Arca (P),172677026,374273004,161914660,708864690,5851732782.052400,21716596497.412096,7843642113.870597,35411971393.335093,1316123,1072724,1169359,3558206
2018-12-31,NASDAQ (Q),375532806,239454016,654595555,1269582377,14311760465.355101,16067979791.575699,32813691324.373993,63193431581.304793,3433951,1097640,3592082,8123673
2018-12-31,IEX (V),83230204,29486581,42203130,154919915,2831738696.481500,1665734531.138501,1917744448.595501,6415217676.215502,624223,135919,330488,1090630
2018-12-31,NASDAQ PSX (X),14183311,25403586,14221832,53808729,497080745.510600,1952971535.094600,994868179.734100,3444920460.339300,119781,106169,115914,341864
2018-12-31,BYX Equities (Y),152742902,91375524,68620593,312739019,3918277353.198100,4094582600.460301,2594809091.383400,10607669045.041801,1260374,426695,639125,2326194
2018-12-31,BZX Equities (Z),185802328,145463939,114573439,445839706,6676331649.806100,9713409313.501300,6323207336.688200,22712948299.995600,1645534,710385,1055514,3411433
2018-12-28,NYSE American (A),6458480,14179499,2227421,22865400,251430668.707000,222474938.589900,123561728.716100,597467336.013000,60939,43128,22371,126438
2018-12-28,NASDAQ BX (B),87779755,42068792,48382316,178230863,3219515500.027300,2356395548.982200,2215945008.401300,7791856057.410800,864765,228212,491899,1584876
2018-12-28,NYSE National (C),45188940,22918671,18485244,86592855,1121800988.808000,819721282.456000,669839652.575900,2611361923.839900,391775,122676,188930,703381
2018-12-28,FINRA / NYSE TRF (DN),248010508,150765672,240423915,639200095,5727138013.436597,7348315837.832694,10212256052.644295,23287709903.913586,514430,264761,526055,1305246
2018-12-28,FINRA / Nasdaq TRF Carteret (DQ),1011866572,697511664,642953909,2352332145,31568374878.522598,42143612072.664207,31012344013.485398,104724330964.672203,3635825,1255339,2166961,7058125
2018-12-28,EDGA Equities (J),60815981,42090597,32752226,135658804,2337570574.974400,2300499838.270100,1888520620.759200,6526591034.003700,578966,210531,311520,1101017
2018-12-28,EDGX Equities (K),161330900,110651436,124959523,396941859,5217264965.895100,7435342196.566502,6032812270.242400,18685419432.704002,1119602,539121,835777,2494500
2018-12-28,CHX (M),12647389,24130905,6900268,43678562,664407831.075000,2262286843.259999,891869157.228500,3818563831.563499,6229,19143,9832,35204
2018-12-28,NYSE (N),897117683,59417758,41205652,997741093,31400159447.539501,4604869426.533799,2318724119.502200,38323752993.575500,3227752,220610,250059,3698421
2018-12-28,NYSE Arca (P),207770132,401640120,179163695,788573947,7195642147.484599,23427737500.216806,9341095132.929402,39964474780.630807,1592615,1275839,1345181,4213635
2018-12-28,NASDAQ (Q),466711590,299346507,601367480,1367425577,18044186838.442702,20439672206.902994,32509570688.484689,70993429733.830385,4181251,1451736,4100636,9733623
2018-12-28,IEX (V),98399727,33108151,45795824,177303702,3287963129.381300,1875617508.710601,2269798072.573500,7433378710.665401,690914,142730,355605,1189249
2018-12-28,NASDAQ PSX (X),18255040,28018664,17084342,63358046,700677279.950800,2068778738.455700,1314843479.485300,4084299497.891800,147512,133661,145328,426501
2018-12-28,BYX Equities (Y),184461860,102958946,77518970,364939776,4624214964.972700,4580960136.733199,3008060463.908600,12213235565.614499,1492964,497213,720292,2710469
2018-12-28,BZX Equities (Z),221628594,179347112,137036380,538012086,8171885859.654604,12094079437.118699,8150544427.508600,28416509724.281903,1973476,950545,1247866,4171887
2018-12-27,NYSE American (A),6657790,12140756,2470389,21268935,243996665.029100,262061845.730300,138917631.011000,644976141.770400,62700,45179,25366,133245
2018-12-27,NASDAQ BX (B),92915052,42772135,50586180,186273367,3332524140.196700,2466999573.173200,2403447343.166500,8202971056.536400,895818,232410,516128,1644356
2018-12-27,NYSE National (C),49964388,24920611,19894378,94779377,1219015807.768100,907331022.839300,741172235.309900,2867519065.917300,436550,123065,204696,764311
2018-12-27,FINRA / NYSE TRF (DN),231557715,146147773,236411304,614116792,5521923363.481498,6778654018.059498,10495431623.348601,22796009004.889597,481056,263430,528455,1272941
2018-12-27,FINRA / Nasdaq TRF Carteret (DQ),1094831233,778455577,704840842,2578127652,35966305113.850501,46868403391.124392,34271216080.870710,117105924585.845603,3868122,1475659,2278343,7622124
2018-12-27,EDGA Equities (J),70634320,44290999,35645346,150570665,2622343952.336500,2719752925.258400,2062976418.936700,7405073296.531600,667724,232125,352779,1252628
2018-12-27,EDGX Equities (K),170132725,132070043,131007318,433210086,5490771027.868602,9087323877.822398,6529719396.007396,21107814301.698396,1239305,651481,910345,2801131
2018-12-27,CHX (M),9989387,27306998,9305697,46602082,315995288.699700,2611405513.255400,746657816.169700,3674058618.124800,7326,20684,10425,38435
2018-12-27,NYSE (N),1079141452,68494165,47708504,1195344121,38870478265.814097,4750444755.069599,2534673462.827600,46155596483.711296,3556009,240535,285446,4081990
2018-12-27,NYSE Arca (P),235141339,486742750,192883432,914767521,8110240240.585503,28901798751.834092,10338476783.681199,47350515776.100794,1814604,1512600,1488346,4815550
2018-12-27,NASDAQ (Q),535221257,347891790,718740533,1601853580,20173078915.074102,24510238140.550789,39826227190.446304,84509544246.071195,4741741,1695437,4753595,11190773
2018-12-27,IEX (V),101249378,36533419,48978409,186761206,3506921622.838800,2184579032.010700,2508525955.945400,8200026610.794900,750328,163517,380378,1294223
2018-12-27,NASDAQ PSX (X),19499969,35652040,19358089,74510098,774615567.500600,2655779586.855200,1571154586.423500,5001549740.779300,159024,157488,163117,479629
2018-12-27,BYX Equities (Y),191189076,109458160,75789480,376436716,4637273268.737500,5031929739.706100,3067977367.193700,12737180375.637300,1577093,542426,745701,2865220
2018-12-27,BZX Equities (Z),250889986,204390394,155492699,610773079,9031047768.635098,14101309018.098701,9023363170.100101,32155719956.833900,2294467,1096466,1444818,4835751
2018-12-26,NYSE American (A),6636942,12896795,2692628,22226365,238867133.128000,220538985.966700,126777515.256500,586183634.351200,59193,40172,25461,124826
2018-12-26,NASDAQ BX (B),93848105,43372228,55454969,192675302,3443185151.353300,2460969039.167500,2662585231.945100,8566739422.465900,892502,244235,554308,1691045
2018-12-26,NYSE National (C),49718058,24612454,23390339,97720851,1232395484.078600,910337842.370500,956599302.580800,3099332629.029900,429569,140908,237774,808251
2018-12-26,FINRA / NYSE TRF (DN),275386903,160336286,237514885,673238074,7046374014.988297,7243763622.076400,11349405264.295387,25639542901.360084,594260,299148,584072,1477480
2018-12-26,FINRA / Nasdaq TRF Carteret (DQ),1147952654,824783709,719792773,2692529136,36441061128.814103,51139809339.519692,35994038193.650891,123574908661.984686,4305758,1641901,2548662,8496321
2018-12-26,EDGA Equities (J),68289295,43577846,37253364,149120505,2472528994.672800,2539210788.978400,2120685951.144100,7132425734.795300,633985,231884,359192,1225061
2018-12-26,EDGX Equities (K),181025921,144180506,141147959,466354386,5963237550.988800,9622822859.610501,7519343986.907696,23105404397.506997,1266473,688301,974038,2928812
2018-12-26,CHX (M),6071552,32224681,11153554,49449787,319131294.619500,3306152768.857401,1574926169.258100,5200210232.735001,8060,24413,11504,43977
2018-12-26,NYSE (N),1066848454,76295704,52044481,1195188639,37715172851.706404,5258630402.108400,2774729847.671199,45748533101.486003,3521922,269193,295208,4086323
2018-12-26,NYSE Arca (P),235637722,523082477,200754822,959475021,8124764300.613598,29841430813.603991,10908501681.517405,48874696795.734994,1785869,1585474,1551993,4923336
2018-12-26,NASDAQ (Q),539917592,410075054,757357029,1707349675,20531736576.217697,26977059324.951900,42280850854.909889,89789646756.079486,4674054,1907434,4858061,11439549
2018-12-26,IEX (V),110524123,36196839,56223265,202944227,3782499792.806201,2241411605.286400,3121340615.475100,9145252013.567701,766072,158649,416192,1340913
2018-12-26,NASDAQ PSX (X),19736007,35646311,21830419,77212737,702291493.839800,2484219569.568100,1642971436.028701,4829482499.436601,151724,163419,168479,483622
2018-12-26,BYX Equities (Y),191530435,112465128,87287848,391283411,4602516609.969899,4977712488.212601,3538544774.877199,13118773873.059699,1527928,571068,823092,2922088
2018-12-26,BZX Equities (Z),256624113,225918997,168998537,651541647,9257815479.913301,15417530143.247908,9653329614.680798,34328675237.842007,2259412,1226290,1506055,4991757
2018-12-24,NYSE American (A),4552307,9426709,1793791,15772807,177238874.277300,161227697.256000,99146104.704000,437612676.237300,41582,29242,17622,88446
2018-12-24,NASDAQ BX (B),58913666,26538372,34632617,120084655,2250303199.829600,1676607181.553100,1746992707.111600,5673903088.494300,559556,145900,347365,1052821
2018-12-24,NYSE National (C),28486561,17683864,12464417,58634842,737940605.031300,597002842.462900,518923190.365500,1853866637.859700,257581,86795,126673,471049
2018-12-24,FINRA / NYSE TRF (DN),163477723,85564373,153727899,402769995,4195787743.625200,3981862973.495298,6842104780.362898,15019755497.483396,377501,199115,381493,958109
2018-12-24,FINRA / Nasdaq TRF Carteret (DQ),677652933,482834857,454344967,1614832757,22178933179.165104,31428793771.325997,23453482568.092397,77061209518.583498,2571917,908491,1581924,5062332
2018-12-24,EDGA Equities (J),40762275,24798617,24113338,89674230,1635033330.909000,1743647777.654401,1386292374.429600,4764973482.993001,384250,140830,229362,754442
2018-12-24,EDGX Equities (K),122953682,99637105,95204839,317795626,4356693273.657700,6852012895.291395,4901306255.239998,16110012424.189093,884368,500092,659806,2044266
2018-12-24,CHX (M),2906931,14230441,7519813,24657185,162014862.208700,1842204285.690000,906707340.771400,2910926488.670100,6440,18160,9740,34340
2018-12-24,NYSE (N),657558606,51093148,38423078,747074832,23839322415.056601,3723836281.355099,1984133324.755500,29547292021.167200,2486107,177590,212064,2875761
2018-12-24,NYSE Arca (P),160498662,341831638,141644443,643974743,5791949490.005701,19777616207.964292,7366941640.078298,32936507338.048291,1241205,1070222,1077326,3388753
2018-12-24,NASDAQ (Q),328731559,255163469,465810516,1049705544,12900379836.001804,17887494425.414003,26496790047.733513,57284664309.149320,2801536,1204524,3184765,7190825
2018-12-24,IEX (V),64010869,20871676,35221323,120103868,2382179080.658700,1266229278.047900,2049429319.275000,5697837677.981600,445986,105308,254001,805295
2018-12-24,NASDAQ PSX (X),13890423,22340244,13380694,49611361,581854152.230200,1769994143.417700,955626074.427400,3307474370.075300,111526,118405,109425,339356
2018-12-24,BYX Equities (Y),116641703,69795731,52071103,238508537,2968713424.659800,3178964641.596100,2192509593.388200,8340187659.644100,973867,357514,500704,1832085
2018-12-24,BZX Equities (Z),172641664,160834012,117093497,450569173,6459892219.652900,10374220955.496700,6056203499.166900,22890316674.316500,1570753,862787,1034021,3467561
2018-12-21,NYSE American (A),9513473,65838319,3712270,79064062,393684383.803900,489137989.366200,196216301.591800,1079038674.761900,89334,51648,37025,178007
2018-12-21,NASDAQ BX (B),129977060,56134109,71740494,257851663,4957462549.849900,3345182734.737300,3492014954.964699,11794660239.551899,1218036,294053,718896,2230985
2018-12-21,NYSE National (C),59171889,31495626,25813551,116481066,1523006478.224500,1209653321.447300,1009372868.775000,3742032668.446800,505952,175087,258162,939201
2018-12-21,FINRA / NYSE TRF (DN),273279143,163456281,258207349,694942773,7592882982.639698,7200622100.028198,12127467585.290199,26920972667.958095,596686,285880,632564,1515130
2018-12-21,FINRA / Nasdaq TRF Carteret (DQ),1846875293,875283403,1203781351,3925940047,63400029007.710296,55971329091.396486,57184032987.646784,176555391086.753566,4984600,1578695,3018759,9582054
2018-12-21,EDGA Equities (J),90475317,58867438,50417903,199760658,3369421906.977400,3580222935.895801,2909951810.655400,9859596653.528601,835325,292564,465209,1593098
2018-12-21,EDGX Equities (K),220305957,176610990,178564876,575481823,7950244758.636698,12052922006.255702,9886312813.816100,29889479578.708500,1634046,843915,1277365,3755326
2018-12-21,CHX (M),10380102,38623628,14852277,63856007,617863777.629700,3662760583.655999,1320029727.095800,5600654088.381499,9451,22777,13118,45346
2018-12-21,NYSE (N),3259532037,95477740,73003691,3428013468,120261435334.724205,6998338222.951904,4347340706.553401,131607114264.229510,4410690,302079,406462,5119231
2018-12-21,NYSE Arca (P),315377297,592770667,274687823,1182835787,12268454184.570897,35936542378.470284,15425796023.042700,63630792586.083881,2460014,1861676,2101651,6423341
2018-12-21,NASDAQ (Q),658865866,425570593,1961289439,3045725898,26724792027.588999,29821449185.374292,98022622829.157701,154568864042.120992,5773668,1926684,6134866,13835218
2018-12-21,IEX (V),158203093,45265498,83115781,286584372,5747093023.449399,2503414234.615100,4282462440.250601,12532969698.315100,1072783,196088,593042,1861913
2018-12-21,NASDAQ PSX (X),26166201,49124539,28387925,103678665,1064007094.600100,4062977735.052800,2314302068.822999,7441286898.475899,209894,219071,228239,657204
2018-12-21,BYX Equities (Y),252987591,138024028,111000212,502011831,6482323919.473500,6493001845.348902,4375824745.860099,17351150510.682501,1988419,697907,1025371,3711697
2018-12-21,BZX Equities (Z),346783568,285187306,233100278,865071152,13852471415.347900,19753752578.810100,14449242358.461503,48055466352.619503,3147682,1484147,2078484,6710313
2018-12-20,NYSE American (A),9629127,15758593,4137589,29525309,395039401.067300,303230045.389700,229879973.995500,928149420.452500,91424,49748,41326,182498
2018-12-20,NASDAQ BX (B),130950144,57033378,72497470,260480992,4991981584.690900,3315438641.174100,3450882540.880799,11758302766.745799,1222180,287010,719836,2229026
2018-12-20,NYSE National (C),61359086,37705407,25309955,124374448,1617973763.954600,1428737784.391100,1003587335.171900,4050298883.517600,518446,188559,255906,962911
2018-12-20,FINRA / NYSE TRF (DN),299741405,165218107,275888100,740847612,8111073961.442700,7621816095.113000,12633471649.317808,28366361705.873508,644007,302275,628387,1574669
2018-12-20,FINRA / Nasdaq TRF Carteret (DQ),1500921968,961908476,944134151,3406964595,51056421771.835697,58862243462.569215,43948564687.914897,153867229922.319809,5363677,1759365,3107727,10230769
2018-12-20,EDGA Equities (J),95508047,58073287,53618110,207199444,3620692009.193800,3489173894.569800,2978708117.823800,10088574021.587400,887016,285879,494823,1667718
2018-12-20,EDGX Equities (K),234468468,183295748,175444402,593208618,8621125176.470200,12685206180.316797,9061623363.378095,30367954720.165092,1734017,868259,1265335,3867611
2018-12-20,CHX (M),20545365,34881228,11029037,66455630,612027660.554800,3613502569.329700,941953199.940000,5167483429.824500,9781,22566,12529,44876
2018-12-20,NYSE (N),1394769206,101418747,75692573,1571880526,52679918890.710700,7724776624.492297,4342673118.482899,64747368633.685896,4623526,322729,433017,5379272
2018-12-20,NYSE Arca (P),326122426,652703768,268192030,1247018224,12518796227.977500,37586764641.602503,14455439669.087897,64561000538.667900,2560668,1905427,2101603,6567698
2018-12-20,NASDAQ (Q),729824201,499368927,925510158,2154703286,29400931862.849100,35147418802.910402,52053329733.390414,116601680399.149916,6449757,2157365,6247706,14854828
2018-12-20,IEX (V),171052812,45530383,85314755,301897950,6345785632.084599,2619016218.066099,4249315334.571001,13214117184.721699,1163183,186510,620756,1970449
2018-12-20,NASDAQ PSX (X),27832478,52802340,27699291,108334109,1107542764.054800,4365367300.593399,2294055187.229701,7766965251.877900,234113,224308,237236,695657
2018-12-20,BYX Equities (Y),254894189,145663622,111072672,511630483,6536071615.945600,6734797443.534402,4391777352.659101,17662646412.139103,2064957,721254,1037996,3824207
2018-12-20,BZX Equities (Z),362168195,296468841,226902839,885539875,14192566603.745304,21090420810.770600,12947932644.872499,48230920059.388403,3261268,1513682,2068548,6843498
2018-12-19,NYSE American (A),8609106,16750385,3610844,28970335,365169305.745200,262377233.697100,180922235.125200,808468774.567500,83428,44667,34355,162450
2018-12-19,NASDAQ BX (B),124237869,51503798,65548814,241290481,4731115001.574800,2992284044.820398,3265225500.670400,10988624547.065598,1172783,266864,646635,2086282
2018-12-19,NYSE National (C),55266618,25787267,23232180,104286065,1470748311.923800,1029054889.968500,985661176.233300,3485464378.125600,476320,142012,235123,853455
2018-12-19,FINRA / NYSE TRF (DN),255171957,143080811,257969570,656222338,7648791410.284502,5875992325.201800,11383984122.968301,24908767858.454603,544472,249561,558154,1352187
2018-12-19,FINRA / Nasdaq TRF Carteret (DQ),1366485844,757430992,795050527,2918967363,47527648484.936801,44212154275.682888,41958211531.442292,133698014292.061981,4437554,1373725,2609248,8420527
2018-12-19,EDGA Equities (J),90636553,54871677,46498764,192006994,3242230940.467300,3314566044.464600,2506496358.767600,9063293343.699500,824577,271329,411190,1507096
2018-12-19,EDGX Equities (K),204677158,173811795,163030855,541519808,7783000987.467299,12010198180.343891,8441807460.862697,28235006628.673887,1531149,830297,1100644,3462090
2018-12-19,CHX (M),10006850,28755526,10454208,49216584,492941521.453000,3021233673.887801,1169170612.592300,4683345807.933101,9128,21654,11403,42185
2018-12-19,NYSE (N),1275124037,84088528,63034797,1422247362,46784786153.374694,5873402403.795399,3728882783.814501,56387071340.984594,4122205,274086,361721,4758012
2018-12-19,NYSE Arca (P),301131309,620236069,231790027,1153157405,11155451414.325197,35624414592.937698,13141368147.115300,59921234154.378195,2204529,1911464,1759525,5875518
2018-12-19,NASDAQ (Q),685456366,442471654,841164908,1969092928,27446496897.253195,30192516481.989910,48475185346.662495,106114198725.905600,5777537,1904387,5396499,13078423
2018-12-19,IEX (V),172013785,40731649,87561421,300306855,6729147089.915701,2314033230.990000,4822167637.566300,13865347958.472001,1223334,198250,650937,2072521
2018-12-19,NASDAQ PSX (X),25935211,52425690,22810669,101171570,1030945380.234800,4000705576.953001,1580084531.247100,6611735488.434901,208688,215424,183334,607446
2018-12-19,BYX Equities (Y),238731612,132609962,98312947,469654521,6251903689.277498,5915498487.203800,4001860044.897500,16169262221.378798,1954641,672802,921924,3549367
2018-12-19,BZX Equities (Z),339350862,289410568,209073954,837835384,13274381001.517599,19885683625.238998,11857910927.604000,45017975554.360597,3027010,1475090,1873318,6375418
2018-12-18,NYSE American (A),7257953,14065645,2722160,24045758,293714305.228800,202704074.332200,137627506.855800,634045886.416800,71623,42210,27985,141818
2018-12-18,NASDAQ BX (B),111943566,40103186,56841998,208888750,4259354706.323000,2083870595.417700,2630197358.773000,8973422660.513700,1070943,184451,574252,1829646
2018-12-18,NYSE National (C),45452686,20100696,19327635,84881017,1216318739.264800,757086880.667300,743179047.353500,2716584667.285600,392507,101657,197265,691429
2018-12-18,FINRA / NYSE TRF (DN),236721239,122294063,229496131,588511433,6928931387.980102,5066452201.850102,9340104012.239497,21335487602.069701,529132,231724,493674,1254530
2018-12-18,FINRA / Nasdaq TRF Carteret (DQ),1301789324,698156555,789683934,2789629813,44932096646.392498,41158061829.317800,36228913251.713890,122319071727.424188,4656583,1447566,2625889,8730038
2018-12-18,EDGA Equities (J),77003450,42448026,39350056,158801532,2729758031.844500,2262020425.980700,1968251831.296100,6960030289.121300,716283,199433,357234,1272950
2018-12-18,EDGX Equities (K),180093700,115046557,145860838,441001095,6674765126.439803,7414217441.843699,6857956267.409302,20946938835.692804,1378157,500094,974782,2853033
2018-12-18,CHX (M),12219390,26728291,9543288,48490969,591117759.888200,2613572107.020000,864765544.058300,4069455410.966500,6402,16902,9328,32632
2018-12-18,NYSE (N),1076510051,55544207,50140602,1182194860,41205500536.080598,3844293518.119400,2433664774.548400,47483458828.748398,3453160,170538,279920,3903618
2018-12-18,NYSE Arca (P),251559375,431477998,206193770,889231143,9610943918.719399,24138711991.793106,10002996349.111600,43752652259.624105,1924063,1287280,1495003,4706346
2018-12-18,NASDAQ (Q),551056817,289907807,728476102,1569440726,22983346606.496302,18667810049.709396,39348600159.587387,80999756815.793085,4899546,1194901,4643687,10738134
2018-12-18,IEX (V),151379386,35562426,78792930,265734742,5894152547.278600,1877045654.318100,3958556412.674099,11729754614.270799,1103816,166960,593258,1864034
2018-12-18,NASDAQ PSX (X),20419363,28791863,16857200,66068426,751656452.891400,2243607734.266300,1266682624.930900,4261946812.088600,163184,113158,137606,413948
2018-12-18,BYX Equities (Y),214493111,110948723,86181089,411622923,5531847342.021600,4688960161.963000,3238001401.577100,13458808905.561700,1762487,510707,813225,3086419
2018-12-18,BZX Equities (Z),281297286,169866235,163808143,614971664,11126380367.490200,11567942091.137294,9192216738.582303,31886539197.209797,2576862,863979,1534005,4974846
2018-12-17,NYSE American (A),7649471,14715947,2971066,25336484,320840550.919700,225778688.549600,152340711.979900,698959951.449200,78939,45202,29963,154104
2018-12-17,NASDAQ BX (B),115587610,42429150,57137001,215153761,4502791594.819100,2562610487.934000,2746958239.668900,9812360322.422000,1106921,202955,568498,1878374
2018-12-17,NYSE National (C),47661589,30104525,21257075,99023189,1291480719.879500,1051905979.490900,820861095.683200,3164247795.053600,418155,115409,209665,743229
2018-12-17,FINRA / NYSE TRF (DN),268276650,129659607,264990030,662926287,7990994885.542501,5554983249.959699,11069004002.973596,24614982138.475796,618766,271699,608426,1498891
2018-12-17,FINRA / Nasdaq TRF Carteret (DQ),1286707772,700132207,783755797,2770595776,46946769381.498896,44030798109.023897,38590514619.250202,129568082109.772995,4664662,1373947,2595503,8634112
2018-12-17,EDGA Equities (J),78710611,42037591,41593415,162341617,2876673870.648100,2429867453.858501,2157264855.234400,7463806179.741001,747676,212846,376631,1337153
2018-12-17,EDGX Equities (K),181907600,123292136,142483079,447682815,7028794412.610901,8262601853.248798,7200653037.909801,22492049303.769500,1421813,572159,1003864,2997836
2018-12-17,CHX (M),9600674,38399819,10724662,58725155,456335223.295500,3589957715.240200,1032451451.706400,5078744390.242100,6627,21088,12387,40102
2018-12-17,NYSE (N),1152498501,58966981,50153549,1261619031,45353739135.499593,4410103478.350499,2787208870.894400,52551051484.744492,3700253,197959,298791,4197003
2018-12-17,NYSE Arca (P),254834814,454692781,205113022,914640617,10149935378.227698,26784210614.824796,11303428789.698596,48237574782.751090,2004162,1429334,1584780,5018276
2018-12-17,NASDAQ (Q),579663666,308460057,765761178,1653884901,24523824484.239805,20927338329.011305,43616616186.328698,89067778999.579808,5242512,1334008,4950401,11526921
2018-12-17,IEX (V),143470838,32666411,72095688,248232937,5791365476.624199,1974223576.657100,3802297405.243100,11567886458.524399,1091450,163309,568799,1823558
2018-12-17,NASDAQ PSX (X),21250970,29505282,18548605,69304857,817205469.682200,2558864577.349001,1332794440.941400,4708864487.972601,179118,122910,151524,453552
2018-12-17,BYX Equities (Y),222634686,115690180,89848059,428172925,5929922640.608700,5439020715.906500,3471199381.403300,14840142737.918500,1820032,558519,858008,3236559
2018-12-17,BZX Equities (Z),290967900,177649434,170976224,639593558,12136237293.094901,12718718378.341497,10349592786.858598,35204548458.294996,2692078,913631,1599903,5205612
2018-12-14,NYSE American (A),6524007,11866468,2382788,20773263,271123184.769500,182067880.602000,125801961.726800,578993027.098300,63128,35008,23599,121735
2018-12-14,NASDAQ BX (B),102319521,33449904,50980779,186750204,4280909075.361400,1753373380.397900,2587071023.497500,8621353479.256800,989560,155648,503408,1648616
2018-12-14,NYSE National (C),39735540,23636130,17474582,80846252,1082804455.629100,771842255.939800,669819311.544300,2524466023.113200,338170,85256,176165,599591
2018-12-14,FINRA / NYSE TRF (DN),236703653,99423177,214363387,550490217,7597234850.756899,4300245687.362904,9192133692.206101,21089614230.325904,519581,208132,494758,1222471
2018-12-14,FINRA / Nasdaq TRF Carteret (DQ),1138243950,479415607,633819567,2251479124,40589215161.977804,28145073632.819091,30966939244.632001,99701228039.428896,3972463,1013387,2178715,7164565
2018-12-14,EDGA Equities (J),68888083,33959840,37637791,140485714,2651021529.053500,1863843120.829700,1914942267.341700,6429806917.224900,648335,164319,324523,1137177
2018-12-14,EDGX Equities (K),162194838,92007480,119007845,373210163,6418620530.450200,6238401066.150799,6466728356.535202,19123749953.136201,1238238,406938,828365,2473541
2018-12-14,CHX (M),11744125,32157676,8382130,52283931,469541149.283300,2858341087.973600,744469274.870200,4072351512.127100,5176,15300,8025,28501
2018-12-14,NYSE (N),983889295,43494567,39539860,1066923722,39211484018.388099,3302122245.540900,2153135350.101500,44666741614.030499,3023785,142209,249702,3415696
2018-12-14,NYSE Arca (P),221666538,348897403,172549958,743113899,8983881846.146900,20828727939.372002,9665359456.521396,39477969242.040298,1699625,1041288,1318191,4059104
2018-12-14,NASDAQ (Q),489991810,237260956,620473874,1347726640,21046442437.443291,16419480574.766903,36593426532.655201,74059349544.865395,4332361,1001428,4076747,9410536
2018-12-14,IEX (V),135891339,24671169,64016607,224579115,5779933897.288002,1441912719.950200,3538291025.337301,10760137642.575503,994142,116881,499996,1611019
2018-12-14,NASDAQ PSX (X),19548108,24274358,15298902,59121368,743084569.216100,2168166613.902300,1221531185.743000,4132782368.861400,152739,89042,123092,364873
2018-12-14,BYX Equities (Y),194366312,91114191,76314832,361795335,5380578515.732100,4015666616.636900,2947428837.987800,12343673970.356800,1593653,423132,713196,2729981
2018-12-14,BZX Equities (Z),252668626,134809374,146090033,533568033,10348252870.029701,9905782126.172802,9379261280.052997,29633296276.255500,2276093,685869,1360425,4322387
2018-12-13,NYSE American (A),5717116,10615417,2246679,18579212,247598488.122000,149349483.033500,116740592.239700,513688563.395200,55290,32399,22889,110578
2018-12-13,NASDAQ BX (B),84107741,30563623,43526534,158197898,3369924193.830300,1488791588.782600,2084379100.590600,6943094883.203500,815088,133171,428587,1376846
2018-12-13,NYSE National (C),38635295,26145004,16358702,81139001,1029861369.094400,785650059.739100,623513804.483100,2439025233.316600,339612,82360,168074,590046
2018-12-13,FINRA / NYSE TRF (DN),230730083,93070770,222482438,546283291,6168177533.036198,4015352823.559097,9568472106.154800,19752002462.750095,497825,183852,494929,1176606
2018-12-13,FINRA / Nasdaq TRF Carteret (DQ),1181413654,451377433,648380234,2281171321,40315853923.683600,26530796908.278193,29072639572.680503,95919290404.642296,3793650,877372,2069105,6740127
2018-12-13,EDGA Equities (J),76225352,34481255,37643014,148349621,3077325264.051200,1827709126.520300,1924333033.639300,6829367424.210800,763950,163199,369765,1296914
2018-12-13,EDGX Equities (K),167424747,82043364,116788838,366256949,5898225728.000201,5399656128.894301,5818990203.580900,17116872060.475402,1223439,364801,799255,2387495
2018-12-13,CHX (M),11836904,22091534,6126664,40055102,607912475.832200,1798371998.985000,639088457.326700,3045372932.143900,4432,10483,7407,22322
2018-12-13,NYSE (N),913305620,44731662,40700516,998737798,35429573795.891796,3003333884.457601,2215564472.057699,40648472152.407096,3075497,138438,242574,3456509
2018-12-13,NYSE Arca (P),230383195,322146643,167470886,720000724,8286356564.949699,18069883338.481095,8468901060.492403,34825140963.923197,1691130,946778,1253839,3891747
2018-12-13,NASDAQ (Q),479440293,214455433,579314378,1273210104,19899955019.686599,13739397691.975497,31600439320.331311,65239792031.993407,4246800,887441,3986570,9120811
2018-12-13,IEX (V),115196489,20629422,56288214,192114125,4415642837.207600,1073971384.872800,2821867808.072600,8311482030.153000,823202,96393,413322,1332917
2018-12-13,NASDAQ PSX (X),17129750,20819797,13718522,51668069,654849362.418000,1634582405.987900,1047905189.858800,3337336958.264700,142745,78501,111676,332922
2018-12-13,BYX Equities (Y),180331547,83818482,71164740,335314769,4798259348.635600,3753794052.481300,2721086423.688100,11273139824.805000,1502833,390845,673489,2567167
2018-12-13,BZX Equities (Z),246466741,136023586,140002932,522493259,9856226578.595602,9292259794.414096,8004412809.918001,27152899182.927699,2268409,665497,1291848,4225754
2018-12-12,NYSE American (A),6366989,11728325,2521191,20616505,258377095.976100,169902328.056600,131878038.128000,560157462.160700,57656,36330,23710,117696
2018-12-12,NASDAQ BX (B),88370525,31895175,44324581,164590281,3473392188.356500,1737873723.293500,2169649243.631900,7380915155.281900,824340,144710,428469,1397519
2018-12-12,NYSE National (C),39729683,23357846,17537982,80625511,1084454315.967200,781502002.755100,671975795.371200,2537932114.093500,330650,81475,169393,581518
2018-12-12,FINRA / NYSE TRF (DN),224305387,102045561,263581425,589932373,6739801490.070001,4106459089.469698,10476486415.085695,21322746994.625394,503001,199168,551328,1253497
2018-12-12,FINRA / Nasdaq TRF Carteret (DQ),1152233559,515684310,734802367,2402720236,42623500009.665288,28474613390.046201,33478217719.547998,104576331119.259487,3811076,949685,2237953,6998714
2018-12-12,EDGA Equities (J),75204073,36545244,40233629,151982946,2934937210.162100,2027094676.004800,2037390650.219600,6999422536.386500,733051,182996,374115,1290162
2018-12-12,EDGX Equities (K),160196273,86333574,134717600,381247447,5828863396.771200,5496106347.834400,6566287950.623497,17891257695.229097,1187393,385305,847935,2420633
2018-12-12,CHX (M),12109776,16828046,7185923,36123745,487437542.121200,1614810621.790000,836364504.304600,2938612668.215800,5163,8908,7092,21163
2018-12-12,NYSE (N),985893537,45337227,40588004,1071818768,38879910894.892299,3216784362.241800,2028086903.980000,44124782161.114099,3017756,140096,248075,3405927
2018-12-12,NYSE Arca (P),220507585,364527124,181335707,766370416,8289148932.520702,19924278109.421697,8998273923.269004,37211700965.211403,1613320,1000683,1278033,3892036
2018-12-12,NASDAQ (Q),481538786,218186849,656141876,1355867511,20141217362.780004,14440791482.592901,36156390580.428593,70738399425.801498,4325049,923087,4150139,9398275
2018-12-12,IEX (V),126876151,25025708,61067794,212969653,5014317415.567900,1330086912.585900,3181046377.932900,9525450706.086700,853577,108928,428112,1390617
2018-12-12,NASDAQ PSX (X),16477565,22097089,15247410,53822064,635569308.885000,1917191604.483800,1237570341.280300,3790331254.649100,136905,86458,115669,339032
2018-12-12,BYX Equities (Y),189069890,90311454,74004808,353386152,5050890667.544401,4088696266.102200,2919638072.357800,12059225006.004401,1532154,439985,698426,2670565
2018-12-12,BZX Equities (Z),250429769,145321118,153798968,549549855,10042565189.459000,10001488981.572501,8772347425.775305,28816401596.806806,2252060,727372,1364223,4343655
2018-12-11,NYSE American (A),6481903,10515298,2700213,19697414,264373761.320600,188685182.123100,145943778.046000,599002721.489700,61556,37267,26276,125099
2018-12-11,NASDAQ BX (B),87912330,34230506,45575751,167718587,3383151468.106200,1857917592.094200,2319951475.336700,7561020535.537100,846614,152725,450959,1450298
2018-12-11,NYSE National (C),40935637,22924966,17132103,80992706,1053665567.363900,777755592.515700,640000784.888400,2471421944.768000,344470,85124,177560,607154
2018-12-11,FINRA / NYSE TRF (DN),228440636,108910552,231953565,569304753,6439692931.758201,4920462250.811702,11137704372.384094,22497859554.953997,485988,206404,530525,1222917
2018-12-11,FINRA / Nasdaq TRF Carteret (DQ),1160726132,551272793,690340950,2402339875,40345170678.800185,31632542379.947204,34030982903.721488,106008695962.468877,3841737,1047089,2211731,7100557
2018-12-11,EDGA Equities (J),77711788,38052706,39328584,155093078,3025416502.508100,2148327250.378500,2028717545.748700,7202461298.635300,759179,190952,364579,1314710
2018-12-11,EDGX Equities (K),165317060,94996752,126082320,386396132,6233161662.407101,6590339576.895004,6800061497.406399,19623562736.708504,1260706,459661,874672,2595039
2018-12-11,CHX (M),9363560,24110648,11189109,44663317,606296783.748900,2101176458.743800,1032776265.457500,3740249507.950200,5958,11393,7508,24859
2018-12-11,NYSE (N),889852634,51460456,42292940,983606030,33851304375.641703,3990639232.129400,2242228563.026600,40084172170.797703,3127679,165715,263221,3556615
2018-12-11,NYSE Arca (P),220884972,373340036,176827800,771052808,8539131442.679101,22531795661.199697,9549856846.382301,40620783950.261099,1690610,1117282,1327990,4135882
2018-12-11,NASDAQ (Q),493596056,242445657,603072830,1339114543,20661151110.236500,16694451677.342196,34052359212.865098,71407962000.443794,4427420,1073024,4280958,9781402
2018-12-11,IEX (V),119452998,31823577,59047577,210324152,4488205460.066400,1772896092.684200,3124232411.766200,9385333964.516800,837346,120837,434557,1392740
2018-12-11,NASDAQ PSX (X),19271442,27914733,16791466,63977641,735435946.893000,2283014904.937300,1412096617.408300,4430547469.238600,161373,106380,137046,404799
2018-12-11,BYX Equities (Y),192082550,100380244,74858896,367321690,4927124237.532400,4684322511.107001,3045140560.504200,12656587309.143601,1545569,472642,703978,2722189
2018-12-11,BZX Equities (Z),251416348,152045481,149622953,553084782,9927326284.010000,11214876008.935599,8927883239.864101,30070085532.809700,2292942,783292,1397962,4474196
2018-12-10,NYSE American (A),7070331,11892760,2861609,21824700,292599904.351500,216368277.148900,145480355.011400,654448536.511800,70541,40129,29983,140653
2018-12-10,NASDAQ BX (B),89419407,37600266,46803484,173823157,3537867815.303200,2159906968.741300,2446904833.295200,8144679617.339700,858676,181210,462776,1502662
2018-12-10,NYSE National (C),42533076,25478727,19831325,87843128,1090586279.595500,910976422.873200,733694287.878200,2735256990.346900,375425,124329,202553,702307
2018-12-10,FINRA / NYSE TRF (DN),239118576,117414169,233025252,589557997,6733771543.040800,5329246576.994401,12163461064.834196,24226479184.869397,528086,241604,561744,1331434
2018-12-10,FINRA / Nasdaq TRF Carteret (DQ),1149138022,555106665,688381103,2392625790,41253871636.996199,32570426771.258494,34906447403.926394,108730745812.181087,4137612,1386931,2387746,7912289
2018-12-10,EDGA Equities (J),76952067,41542948,38523506,157018521,3108157006.885400,2480789243.295601,2232783969.333401,7821730219.514402,765641,217414,390152,1373207
2018-12-10,EDGX Equities (K),171173529,114714660,128392995,414281184,6514451088.828300,8093646132.573198,7285917287.218602,21894014508.620100,1315095,568471,930935,2814501
2018-12-10,CHX (M),8636667,26164956,5743540,40545163,479719216.118100,2473497276.854001,554407881.017600,3507624373.989701,7307,14914,9550,31771
2018-12-10,NYSE (N),1008781642,58495195,46589365,1113866202,38742995523.228000,4727819609.898000,2696619416.959799,46167434550.085799,3486293,205841,293444,3985578
2018-12-10,NYSE Arca (P),229277814,420888929,185255376,835422119,8826943515.387400,25636751741.685398,10681074344.656593,45144769601.729391,1801893,1408726,1456865,4667484
2018-12-10,NASDAQ (Q),524120777,296618567,664413339,1485152683,21695173249.876800,20447876685.327296,38374227989.785106,80517277924.989202,4730791,1377887,4627691,10736369
2018-12-10,IEX (V),127348059,29256909,66273763,222878731,4718446467.298700,1838688406.254400,3463371019.918099,10020505893.471199,894078,132571,473512,1500161
2018-12-10,NASDAQ PSX (X),19351461,29517420,17301443,66170324,768459175.203900,2399927630.244200,1413078662.508000,4581465467.956100,165115,129175,145715,440005
2018-12-10,BYX Equities (Y),200206405,104740748,77728473,382675626,5064972903.778299,4983032604.315601,3225935811.032801,13273941319.126701,1622288,538607,733664,2894559
2018-12-10,BZX Equities (Z),269754101,181889384,159154414,610797899,10806674576.757298,13367542313.963694,9849381729.514803,34023598620.235795,2484193,1000357,1501059,4985609
2018-12-07,NYSE American (A),7248012,11991600,2942205,22181817,308905686.921100,227171653.566200,162725854.007600,698803194.494900,68122,40448,29758,138328
2018-12-07,NASDAQ BX (B),91899916,39693925,50917288,182511129,3748117771.101400,2126533383.303600,2700616025.141500,8575267179.546500,888439,182160,509992,1580591
2018-12-07,NYSE National (C),54925635,66388772,26148624,147463031,1482848097.617100,2321653536.246998,960198014.561900,4764699648.425998,471966,246210,224533,942709
2018-12-07,FINRA / NYSE TRF (DN),229666881,113346403,242404097,585417381,6725070302.154602,5103538289.057504,11724594605.353293,23553203196.565399,519872,235016,609071,1363959
2018-12-07,FINRA / Nasdaq TRF Carteret (DQ),1180086381,535680200,695953515,2411720096,41234547402.377695,33395129761.516601,35775209438.988496,110404886602.882792,3991671,1127398,2436678,7555747
2018-12-07,EDGA Equities (J),81798054,43301263,42314389,167413706,3337662524.132300,2448112398.533000,2397187385.631700,8182962308.297000,797412,214428,405433,1417273
2018-12-07,EDGX Equities (K),168718538,119679869,140473051,428871458,6603535470.878202,8207222328.722398,7994962897.118099,22805720696.718699,1321200,571494,993266,2885960
2018-12-07,CHX (M),9225315,23278005,8237831,40741151,404294594.238300,2332610544.110201,560614700.848100,3297519839.196601,6119,11591,9593,27303
2018-12-07,NYSE (N),1035436988,56918006,48241930,1140596924,40820339599.719100,4655716342.365098,2626989883.629200,48103045825.713398,3551774,198910,307044,4057728
2018-12-07,NYSE Arca (P),231552560,442673069,194196721,868422350,9197572645.581301,26346504446.579479,11508766049.680202,47052843141.840982,1817207,1385462,1529667,4732336
2018-12-07,NASDAQ (Q),530560864,314041654,710087575,1554690093,23179919277.701098,21515663618.212209,42872391940.814596,87567974836.727903,4901086,1377567,4860198,11138851
2018-12-07,IEX (V),128202870,30984905,65038826,224226601,5093652743.950400,1966267854.145400,3655847962.117900,10715768560.213700,902962,136661,484249,1523872
2018-12-07,NASDAQ PSX (X),18559654,32475830,20526528,71562012,781335338.798300,2758235165.992900,1883745316.750600,5423315821.541800,160090,127663,166401,454154
2018-12-07,BYX Equities (Y),200949475,110366001,84265553,395581029,5424710967.430400,5003761391.200999,3391236878.586099,13819709237.217498,1649513,537235,792819,2979567
2018-12-07,BZX Equities (Z),273413449,188252542,172934618,634600609,11417200703.836501,13382151288.356603,10903662499.822902,35703014492.016006,2539067,989191,1588936,5117194
2018-12-06,NYSE American (A),8691545,14882750,3424633,26998928,376605642.781400,292485216.245800,190015638.528300,859106497.555500,85598,49641,35965,171204
2018-12-06,NASDAQ BX (B),112835980,47477118,57941045,218254143,4745656205.042799,2607990962.823800,3072629851.005701,10426277018.872300,1069157,210284,559196,1838637
2018-12-06,NYSE National (C),62267027,82008594,26471255,170746876,1752962989.501000,2885560588.273099,1077178998.967000,5715702576.741099,542676,275969,249326,1067971
2018-12-06,FINRA / NYSE TRF (DN),284333203,128888230,269777544,682998977,8924527934.541300,5920569473.547100,12425253471.447505,27270350879.535905,656827,289782,622846,1569455
2018-12-06,FINRA / Nasdaq TRF Carteret (DQ),1408362167,679138338,813061654,2900562159,52479089730.879088,44276544066.811308,42461864102.248304,139217497899.938700,5204129,1569919,2861911,9635959
2018-12-06,EDGA Equities (J),94447550,52052474,48607865,195107889,3930542452.595400,3040166021.750300,2809792258.099200,9780500732.444900,925812,252479,466607,1644898
2018-12-06,EDGX Equities (K),210277004,137448944,154287025,502012973,8683744705.804598,9957968580.683002,8261087088.502500,26902800374.990100,1669782,664079,1110900,3444761
2018-12-06,CHX (M),10813927,28660618,9100994,48575539,628944855.652400,2946530749.000001,1141600993.527299,4717076598.179700,9613,20752,11687,42052
2018-12-06,NYSE (N),1284767718,70366128,56322659,1411456505,53754962818.696708,5648007408.810800,3238584990.887001,62641555218.394509,4345329,236223,360110,4941662
2018-12-06,NYSE Arca (P),297688279,521460414,223298956,1042447649,12290612208.473301,32417464315.477420,13271167978.891709,57979244502.842430,2315848,1597034,1750452,5663334
2018-12-06,NASDAQ (Q),639166693,364803806,803288042,1807258541,28407808275.424700,25479734820.999290,47919035328.074577,101806578424.498567,5817833,1594421,5592967,13005221
2018-12-06,IEX (V),171968742,38205936,78853409,289028087,6953258503.542199,2370015972.186300,4317917881.328800,13641192357.057299,1198603,172649,571565,1942817
2018-12-06,NASDAQ PSX (X),22259775,37222046,23397379,82879200,929642676.384900,3273355859.483601,1928205805.078400,6131204340.946901,191574,147010,183390,521974
2018-12-06,BYX Equities (Y),244332788,134192860,99430320,477955968,6772488621.147001,6313030242.544201,4136755873.178000,17222274736.869202,1987383,640834,914198,3542415
2018-12-06,BZX Equities (Z),328221151,214464353,190393132,733078636,14170509394.364998,15990960402.977597,11318245337.366399,41479715134.708994,3117532,1128512,1812168,6058212
2018-12-04,NYSE American (A),7032893,13173272,2988368,23194533,334898663.651400,227135876.545200,191801176.404500,753835716.601100,70932,42037,32282,145251
2018-12-04,NASDAQ BX (B),92187619,34883617,51940882,179012118,4049571495.859200,1998633027.440600,2881912028.494699,8930116551.794499,900405,161462,519220,1581087
2018-12-04,NYSE National (C),56297793,64417871,25604229,146319893,1592104615.006100,2154781647.919400,1020300538.060700,4767186800.986200,489596,230882,245511,965989
2018-12-04,FINRA / NYSE TRF (DN),252564257,110347512,259366831,622278600,8411196920.391902,5140163002.747401,12993550395.339708,26544910318.479011,584169,245404,637637,1467210
2018-12-04,FINRA / Nasdaq TRF Carteret (DQ),1239996268,549948878,754540469,2544485615,50460328667.958385,37120780581.048094,40851115803.912695,128432225052.919174,4457622,1211675,2604114,8273411
2018-12-04,EDGA Equities (J),82079287,39045140,44064353,165188780,3807006907.318900,2438665139.279001,2629318609.358900,8874990655.956801,825990,196906,429281,1452177
2018-12-04,EDGX Equities (K),193701371,115181106,145584357,454466834,7972416272.837601,8508546268.371798,8042311761.739602,24523274302.949001,1487594,536732,1045441,3069767
2018-12-04,CHX (M),8285617,18141306,9169637,35596560,453334975.328000,2159246683.340599,712243926.112700,3324825584.781299,6155,14173,9972,30300
2018-12-04,NYSE (N),1132460537,58564893,48753271,1239778701,48636793534.220596,5112101030.228201,3044126441.331900,56793021005.780697,3672520,195778,303563,4171861
2018-12-04,NYSE Arca (P),248965411,418054815,197230075,864250301,10568591705.521302,26662360232.933875,11792076244.832596,49023028183.287773,1991635,1323923,1592614,4908172
2018-12-04,NASDAQ (Q),553555706,299899038,771915876,1625370620,25670729124.988189,23000107476.024209,47953331958.426403,96624168559.438801,5127562,1312948,5092158,11532668
2018-12-04,IEX (V),143896598,28782287,71803289,244482174,6260205571.479100,1800479549.550500,4317086048.678100,12377771169.707700,1030383,134856,535970,1701209
2018-12-04,NASDAQ PSX (X),22143366,30726991,19901098,72771455,942584190.591900,2715138768.658599,1731427401.673899,5389150360.924398,196712,119625,163195,479532
2018-12-04,BYX Equities (Y),203010055,110719879,89417760,403147694,5944240211.489900,5076840288.966702,3879590663.121300,14900671163.577902,1701330,541613,852976,3095919
2018-12-04,BZX Equities (Z),279539377,166021991,163441050,609002418,12405138812.541299,12983693417.112707,9821906951.330702,35210739180.984708,2667675,865402,1560919,5093996
2018-12-03,NYSE American (A),7281100,12916013,3041804,23238917,312976045.087700,224006647.247900,176021358.970300,713004051.305900,69319,41400,32961,143680
2018-12-03,NASDAQ BX (B),89881167,32389588,51831283,174102038,4005751007.316400,1927337909.635600,2873572924.714300,8806661841.666300,861880,149015,515615,1526510
2018-12-03,NYSE National (C),36495194,18347050,15938521,70780765,1072299759.357400,731873605.721900,750029529.609400,2554202894.688700,312489,84414,161246,558149
2018-12-03,FINRA / NYSE TRF (DN),243465652,103635045,268549000,615649697,8191082535.172200,4173279906.160702,12349138234.191610,24713500675.524512,583674,230225,684523,1498422
2018-12-03,FINRA / Nasdaq TRF Carteret (DQ),1247333389,536349532,820097509,2603780430,51475029967.442492,32793601157.849407,44250044742.322191,128518675867.614090,4370132,1090059,2732773,8192964
2018-12-03,EDGA Equities (J),77128371,34598763,39113978,150841112,3476972025.505100,2148700858.814900,2269921164.392100,7895594048.712100,764625,169825,397961,1332411
2018-12-03,EDGX Equities (K),177388368,89879074,147914512,415181954,7322106317.497300,6293814782.736199,8149383835.896997,21765304936.130496,1331506,381839,1010451,2723796
2018-12-03,CHX (M),7857528,22600239,4461199,34918966,355695035.461500,1727156122.570000,706758588.559200,2789609746.590700,4684,8387,8037,21108
2018-12-03,NYSE (N),985496273,43254730,45905462,1074656465,42626895226.807501,3214147604.594400,2656084492.276199,48497127323.678100,3248263,134450,291747,3674460
2018-12-03,NYSE Arca (P),233489882,348776081,196429678,778695641,9932224195.295999,20596386538.736597,11389271814.827596,41917882548.860192,1761792,926035,1490890,4178717
2018-12-03,NASDAQ (Q),487348702,219720689,712542909,1419612300,22811661888.500700,16149158579.661902,44629963802.577104,83590784270.739706,4389191,921304,4742369,10052864
2018-12-03,IEX (V),154359313,29448525,75980950,259788788,6584121260.095101,1802779811.544000,4499251265.279999,12886152336.919100,1095897,140571,576427,1812895
2018-12-03,NASDAQ PSX (X),20588066,24680790,16445479,61714335,842589974.350000,1938605643.157000,1162935974.691600,3944131592.198600,174620,85886,133215,393721
2018-12-03,BYX Equities (Y),194799796,88414971,85583716,368798483,5687978105.763000,4453206776.981900,3589538688.562400,13730723571.307300,1607495,432507,808473,2848475
2018-12-03,BZX Equities (Z),258669423,126735568,159317293,544722284,11672695170.099698,9344070675.891596,9804862913.603597,30821628759.594891,2404484,605078,1499791,4509353
2018-11-30,NYSE American (A),6460373,23779851,2598644,32838868,278932511.485100,219011978.521200,136411067.884000,634355557.890300,60028,41678,26246,127952
2018-11-30,NASDAQ BX (B),87333311,30807153,46727001,164867465,3794856634.296200,1633549107.543900,2448387706.798300,7876793448.638400,834520,135263,474207,1443990
2018-11-30,NYSE National (C),40226775,15722349,18563287,74512411,1137132759.009900,617131179.842600,757836659.769800,2512100598.622300,341295,70284,193794,605373
2018-11-30,FINRA / NYSE TRF (DN),201674149,94520446,192035173,488229768,6450669818.370302,3254267190.178901,9004056694.679197,18708993703.228400,467939,195740,487863,1151542
2018-11-30,FINRA / Nasdaq TRF Carteret (DQ),1322526332,428771138,725109565,2476407035,51914062318.474099,29264969183.307404,40694624535.293007,121873656037.074510,3918900,883742,2238891,7041533
2018-11-30,EDGA Equities (J),77342610,31888948,38210718,147442276,3349603507.911000,1778648997.253600,2100965943.341000,7229218448.505600,746979,149647,367562,1264188
2018-11-30,EDGX Equities (K),150383583,76106270,115226585,341716438,5986589791.752200,4668311024.518099,5793824377.338499,16448725193.608798,1115192,315007,780157,2210356
2018-11-30,CHX (M),9379683,17406215,10526719,37312617,412932391.936200,1776571330.098300,1236511781.940600,3426015503.975100,2360,6806,4983,14149
2018-11-30,NYSE (N),1522753767,34563709,33285121,1590602597,73894919285.466209,2395442175.383199,1719310295.908500,78009671756.757908,2798031,111944,220328,3130303
2018-11-30,NYSE Arca (P),209148389,287867302,170386686,667402377,9105035231.887797,16437189648.597798,9431542297.136193,34973767177.621788,1664609,785280,1339669,3789558
2018-11-30,NASDAQ (Q),456923752,187483008,905743011,1550149771,21180104355.684697,12501671218.468201,55765761287.164522,89447536861.317420,4064703,729946,3974797,8769446
2018-11-30,IEX (V),142729235,23899561,65875001,232503797,6199274192.225600,1376360955.121600,3766447240.458300,11342082387.805500,1003101,113644,496552,1613297
2018-11-30,NASDAQ PSX (X),17535540,18072946,14378709,49987195,709436258.106400,1474188705.293000,1187438365.518600,3371063328.918000,146592,68830,114053,329475
2018-11-30,BYX Equities (Y),192894517,88580806,78527116,360002439,5751519436.582800,4063447105.574900,3180411728.270300,12995378270.428000,1548295,418754,733322,2700371
2018-11-30,BZX Equities (Z),231005073,103021438,130777072,464803583,10206061066.649399,7093962225.900897,7675235212.859798,24975258505.410094,2110780,487306,1228490,3826576
2018-11-29,NYSE American (A),5463352,9158872,2344676,16966900,213960145.326200,144161973.557600,139498672.562800,497620791.446600,51515,34808,24695,111018
2018-11-29,NASDAQ BX (B),76333940,26949897,40896389,144180226,3225893190.146700,1542129291.641400,2229208648.225500,6997231130.013600,751458,129517,425294,1306269
2018-11-29,NYSE National (C),34557225,14408590,16169546,65135361,895684071.011100,520522518.259200,661704935.765200,2077911525.035500,302236,71925,172684,546845
2018-11-29,FINRA / NYSE TRF (DN),201480322,78322536,198863075,478665933,6271435420.614200,3117576378.373900,9882574646.810000,19271586445.798100,468009,173047,491515,1132571
2018-11-29,FINRA / Nasdaq TRF Carteret (DQ),1086774442,377901854,616910848,2081587144,40630640845.105600,22401399162.776503,32415973870.303525,95448013878.185628,3715812,814661,2122220,6652693
2018-11-29,EDGA Equities (J),64735246,30279378,32634996,127649620,2740045302.305600,1729425367.341700,1852394160.767500,6321864830.414800,644241,144209,329291,1117741
2018-11-29,EDGX Equities (K),143629914,71732712,111862778,327225404,5707605389.496499,4616756929.280801,5795001803.273900,16119364122.051200,1097480,322325,770697,2190502
2018-11-29,CHX (M),11006316,17401722,11260856,39668894,710846852.271500,1579327139.525000,1494104807.654000,3784278799.450500,3883,7662,6628,18173
2018-11-29,NYSE (N),800135000,32315804,30562825,863013629,31704383876.295100,2441362927.679600,1811768625.011300,35957515428.986000,2744906,112162,211433,3068501
2018-11-29,NYSE Arca (P),199896715,282406917,158973178,641276810,8117929231.118199,16065606168.642001,8744763055.159301,32928298454.919501,1541543,823342,1245057,3609942
2018-11-29,NASDAQ (Q),431659175,184299535,534695527,1150654237,19602485012.393102,12679862073.331198,32374216705.278398,64656563791.002698,3814383,795250,3823008,8432641
2018-11-29,IEX (V),130787290,22776481,56062141,209625912,5621129761.719700,1405970009.396900,3294812515.569500,10321912286.686100,947852,108871,446476,1503199
2018-11-29,NASDAQ PSX (X),16497136,19863075,13191184,49551395,613748075.452700,1579360457.352300,1058810182.052200,3251918714.857200,137724,72519,113660,323903
2018-11-29,BYX Equities (Y),167159318,77706069,66389698,311255085,4742263811.866300,3703733184.485499,2778694143.339900,11224691139.691699,1397985,392674,647035,2437694
2018-11-29,BZX Equities (Z),229089668,106246940,127380673,462717281,9688989831.279098,7069380427.754999,7644656806.819597,24403027065.853694,2102486,532819,1219435,3854740
2018-11-28,NYSE American (A),5616676,11509124,2323539,19449339,254432251.812300,180219971.261500,133439483.901600,568091706.975400,57641,37276,24596,119513
2018-11-28,NASDAQ BX (B),89063313,33489877,51919242,174472432,4078423163.110000,1957855460.741100,2867323630.516100,8903602254.367200,897679,153799,533712,1585190
2018-11-28,NYSE National (C),38679802,17217777,18278442,74176021,1056131144.551600,578806911.637400,745548087.576900,2380486143.765900,340167,82610,194143,616920
2018-11-28,FINRA / NYSE TRF (DN),229423969,98368858,242493188,570286015,7773454394.641901,4260249606.947199,11961502408.943891,23995206410.532991,488441,198811,549442,1236694
2018-11-28,FINRA / Nasdaq TRF Carteret (DQ),1177376321,521799711,723830161,2423006193,44379595870.408098,32391877939.948400,38279531877.146897,115051005687.503395,4033290,1002371,2487563,7523224
2018-11-28,EDGA Equities (J),63235079,38620880,34424045,136280004,2607543754.439400,2179588371.405400,2062258996.830500,6849391122.675300,608901,174960,324612,1108473
2018-11-28,EDGX Equities (K),158491391,95959953,128202711,382654055,6721088829.953900,6515004541.171502,7005770192.606801,20241863563.732203,1215594,414900,899306,2529800
2018-11-28,CHX (M),8739215,16473005,8381337,33593557,493027850.172700,1768962862.360400,806087756.305000,3068078468.838100,5007,9013,7323,21343
2018-11-28,NYSE (N),929072153,43234103,37655022,1009961278,39870187459.192102,3412234084.302500,2144793546.634200,45427215090.128802,2969232,139996,252186,3361414
2018-11-28,NYSE Arca (P),223776281,372446160,193610710,789833151,9448117006.815596,21508575157.898506,10974436350.103998,41931128514.818100,1702203,1032677,1501208,4236088
2018-11-28,NASDAQ (Q),474354948,240062369,654082076,1368499393,21763917303.458003,16974067725.944500,41337631393.929904,80075616423.332407,4220606,987967,4278280,9486853
2018-11-28,IEX (V),137284756,29440265,70170623,236895644,5966334626.522100,1826913071.091300,4224877965.864199,12018125663.477599,987405,125703,527763,1640871
2018-11-28,NASDAQ PSX (X),18280849,26985781,18009296,63275926,727602733.186100,2303500190.769000,1556923944.891901,4588026868.847001,151406,100231,141412,393049
2018-11-28,BYX Equities (Y),182388282,92978688,77961105,353328075,5439503693.735200,4317326769.222200,3225270553.754400,12982101016.711800,1535983,446223,744898,2727104
2018-11-28,BZX Equities (Z),248765101,139200830,151783129,539749060,10799469676.448301,9692938829.910700,9246335435.226901,29738743941.585902,2305964,677946,1386375,4370285
2018-11-27,NYSE American (A),5200474,9562951,2302914,17066339,201793487.023500,142321655.754400,128775524.223500,472890667.001400,51028,32357,24127,107512
2018-11-27,NASDAQ BX (B),83004263,26757933,45896999,155659195,3752705502.518700,1389460984.123400,2378308979.633500,7520475466.275600,857335,124771,473363,1455469
2018-11-27,NYSE National (C),36774180,13363731,16850601,66988512,994217798.825800,480633509.934000,640080212.380700,2114931521.140500,320271,63646,175037,558954
2018-11-27,FINRA / NYSE TRF (DN),193172508,82644832,213981476,489798816,5721767119.425100,3236677472.219701,9673648273.072405,18632092864.717206,409004,163752,465051,1037807
2018-11-27,FINRA / Nasdaq TRF Carteret (DQ),1024240251,368727249,614986477,2007953977,37782979813.131409,20619880581.100391,29527002619.676315,87929863013.908115,3648823,846150,2132150,6627123
2018-11-27,EDGA Equities (J),55362895,28658237,27926769,111947901,2164447017.334300,1571718270.365700,1551365022.990600,5287530310.690600,530204,134544,271737,936485
2018-11-27,EDGX Equities (K),139508811,68669017,116840557,325018385,5659991563.985301,4156325733.376102,5506277738.775498,15322595036.136901,1106627,302569,784128,2193324
2018-11-27,CHX (M),7236359,14651703,9035184,30923246,411674197.424900,1187562525.467400,898630047.650300,2497866770.542600,3810,7698,6814,18322
2018-11-27,NYSE (N),800375119,30677868,32965625,864018612,32388949552.973400,2187312274.948200,1641224644.312900,36217486472.234500,2722383,107138,224916,3054437
2018-11-27,NYSE Arca (P),191145956,278844924,164741215,634732095,7928098322.581800,15571906374.645505,8356771754.790500,31856776452.017805,1485103,796519,1269704,3551326
2018-11-27,NASDAQ (Q),431123124,189899394,557975796,1178998314,19776461828.549298,12052869416.795396,31550552087.675898,63379883333.020592,3843646,778857,3714525,8337028
2018-11-27,IEX (V),123818160,21967014,60492417,206277591,5369092154.632900,1238090799.267400,3164205183.999699,9771388137.899999,915491,100677,449813,1465981
2018-11-27,NASDAQ PSX (X),16079696,17875213,13800742,47755651,583013856.298000,1267203961.174500,1007505787.058700,2857723604.531200,131464,67278,111062,309804
2018-11-27,BYX Equities (Y),166807444,73204210,70591056,310602710,4804252189.794100,3169757335.872200,2760119902.908300,10734129428.574600,1400541,362012,669669,2432222
2018-11-27,BZX Equities (Z),220536262,99039898,128410853,447987013,9697872227.914000,6541117865.116300,6932166179.223800,23171156272.254100,2081787,505150,1187458,3774395
2018-11-26,NYSE American (A),5143963,11217509,2199651,18561123,221558102.909800,158664265.997100,125678473.619800,505900842.526700,49603,34572,22079,106254
2018-11-26,NASDAQ BX (B),78376681,24074319,41710737,144161737,3646353845.365700,1355155653.544300,2218290118.882500,7219799617.792500,811356,118828,442340,1372524
2018-11-26,NYSE National (C),34105408,13431238,16605101,64141747,922386207.274700,457535230.806000,629468009.381800,2009389447.462500,305048,63072,175191,543311
2018-11-26,FINRA / NYSE TRF (DN),193503462,76233122,214519108,484255692,5711045846.158399,3167202581.910602,10230295443.356596,19108543871.425597,421872,168933,494274,1085079
2018-11-26,FINRA / Nasdaq TRF Carteret (DQ),1073868418,376145007,616089852,2066103277,41994658203.937292,22175688472.839101,30609520160.800512,94779866837.576905,3615508,977664,2148033,6741205
2018-11-26,EDGA Equities (J),53497017,29495957,28322163,111315137,2200519414.405600,1618818548.137800,1684815623.341900,5504153585.885300,526770,147458,280970,955198
2018-11-26,EDGX Equities (K),132409687,66056933,112456600,310923220,5395579793.982402,3975305431.534697,5396144828.268099,14767030053.785198,1081377,295502,767914,2144793
2018-11-26,CHX (M),11574292,19715435,4490829,35780556,445270353.630400,1746721095.615000,679382946.723500,2871374395.968900,4353,7949,7164,19466
2018-11-26,NYSE (N),853753310,29101029,31589793,914444132,35869074008.651300,2040027031.058500,1612248655.638400,39521349695.348200,2667735,106563,209138,2983436
2018-11-26,NYSE Arca (P),180457271,266711047,155984602,603152920,7506210657.071999,14984073873.248500,8213084736.034900,30703369266.355399,1430027,758641,1228008,3416676
2018-11-26,NASDAQ (Q),405718587,173400713,556641563,1135760863,18281280286.787600,11325241913.406400,32500774762.240281,62107296962.434281,3709570,733639,3604962,8048171
2018-11-26,IEX (V),113201661,19589016,56616795,189407472,5016501398.407800,1133211012.999400,3126334474.432700,9276046885.839900,844691,92080,426803,1363574
2018-11-26,NASDAQ PSX (X),14913557,16906955,12546004,44366516,589274080.323700,1200083778.538500,936475918.022300,2725833776.884500,127887,64817,102734,295438
2018-11-26,BYX Equities (Y),164627663,73894759,70886029,309408451,4768353030.845500,3436674955.321100,2848426710.434200,11053454696.600800,1405230,371568,672892,2449690
2018-11-26,BZX Equities (Z),208370595,92743233,116258843,417372671,9138149775.291403,6244993897.370801,6477626897.671800,21860770570.334004,2007802,479575,1118091,3605468
2018-11-23,NYSE American (A),2846488,8011017,1394084,12251589,132393081.550500,88033396.218700,91225779.097500,311652256.866700,27586,19116,13996,60698
2018-11-23,NASDAQ BX (B),34882679,16251238,19858338,70992255,1566724968.532300,660575409.298600,1014343350.520200,3241643728.351100,357845,68295,204997,631137
2018-11-23,NYSE National (C),19038988,10797344,8691746,38528078,500982615.505500,289963730.783700,306014963.381400,1096961309.670600,174455,37077,93852,305384
2018-11-23,FINRA / NYSE TRF (DN),92251207,51501276,106588566,250341049,2517628500.101700,1456145336.188400,4685125295.255198,8658899131.545298,189876,92237,231893,514006
2018-11-23,FINRA / Nasdaq TRF Carteret (DQ),402789764,211598557,238605017,852993338,15082717463.262203,10838208412.868001,12002823476.512301,37923749352.642505,1638264,443230,968935,3050429
2018-11-23,EDGA Equities (J),26242731,16948738,13853013,57044482,1082577605.074700,778036314.935400,783086225.991400,2643700146.001500,258735,74722,138538,471995
2018-11-23,EDGX Equities (K),66166472,45748996,53843184,165758652,2607594056.185900,2173618554.309599,2568136571.554201,7349349182.049700,518677,179711,370444,1068832
2018-11-23,CHX (M),3287880,8192178,2934427,14414485,125592039.915000,764551694.140000,368157119.400000,1258300853.455000,3251,4552,4376,12179
2018-11-23,NYSE (N),440452447,18294788,15231909,473979144,16434846147.079002,1136195459.694700,822072885.206300,18393114491.980002,1438062,62670,105833,1606565
2018-11-23,NYSE Arca (P),101532122,182173790,80660786,364366698,3981599928.066601,8208593779.964001,4166808526.757099,16357002234.787701,771624,450782,637127,1859533
2018-11-23,NASDAQ (Q),217310840,106359982,294993591,618664413,9458523460.296098,6376583438.479497,16215243186.290704,32050350085.066299,1888138,440056,1840578,4168772
2018-11-23,IEX (V),48501574,12433994,21895529,82831097,1997864408.723500,625671362.342700,1236786564.466500,3860322335.532700,358022,53707,172777,584506
2018-11-23,NASDAQ PSX (X),8897168,9465617,7755104,26117889,368802745.802600,666028201.965000,636889668.626100,1671720616.393700,76102,36767,60535,173404
2018-11-23,BYX Equities (Y),76385590,47903452,31982325,156271367,2084431774.468800,1768879640.952800,1208173457.947700,5061484873.369300,649760,214638,308244,1172642
2018-11-23,BZX Equities (Z),111096602,59976432,60671283,231744317,4740168754.860300,3485589542.676500,3394368777.855401,11620127075.392201,1062619,300454,581231,1944304
2018-11-21,NYSE American (A),4837366,10218294,2149740,17205400,214363914.925100,144419712.818000,123946309.940900,482729937.684000,46296,31907,21941,100144
2018-11-21,NASDAQ BX (B),75964240,27253863,39246979,142465082,3397238484.344400,1320249752.738500,2148483560.353500,6865971797.436400,763055,129347,415999,1308401
2018-11-21,NYSE National (C),32894027,14770995,15028142,62693164,956633361.010900,473688861.539500,673159386.404000,2103481608.954400,291127,64519,159315,514961
2018-11-21,FINRA / NYSE TRF (DN),175159536,98915252,179011119,453085907,5471778567.522800,3199309270.935598,8814303525.906395,17485391364.364793,406661,163576,448237,1018474
2018-11-21,FINRA / Nasdaq TRF Carteret (DQ),886089747,412666615,534146918,1832903280,33784530232.037305,22834186639.240590,27688976475.033307,84307693346.311202,3485893,835337,2018243,6339473
2018-11-21,EDGA Equities (J),52199215,28734815,28513150,109447180,2189453428.891000,1482638434.801200,1603644941.287400,5275736804.979600,517368,140075,274708,932151
2018-11-21,EDGX Equities (K),131488427,76069051,103953050,311510528,5150498357.761001,4208094392.793699,5371962414.487201,14730555165.041901,1026550,317337,744428,2088315
2018-11-21,CHX (M),7806255,24776101,9825694,42408050,335245936.497800,2019891577.242000,908124660.158400,3263262173.898200,3731,7255,5756,16742
2018-11-21,NYSE (N),776929747,29933416,29714633,836577796,31616606464.299200,2066735437.511100,1558200185.875700,35241542087.686000,2617959,108594,203225,2929778
2018-11-21,NYSE Arca (P),186337811,294937344,149713220,630988375,7694950189.825599,15179139248.490193,8219227083.007599,31093316521.323391,1462187,773389,1187447,3423023
2018-11-21,NASDAQ (Q),409358140,191921690,526944797,1128224627,18464131752.813894,12122546628.714809,30980007437.773602,61566685819.302305,3679829,783916,3562347,8026092
2018-11-21,IEX (V),110193467,21633114,52687481,184514062,4802768665.324000,1153601720.606000,3066830095.958200,9023200481.888200,794825,94229,399811,1288865
2018-11-21,NASDAQ PSX (X),16042652,18543925,13168189,47754766,611601398.705000,1308373406.932900,1102346915.481600,3022321721.119500,133734,67301,103910,304945
2018-11-21,BYX Equities (Y),150847799,81579210,63802367,296229376,4363147721.366600,3481308441.838500,2612967807.698400,10457423970.903500,1275408,403547,597034,2275989
2018-11-21,BZX Equities (Z),221257097,110238641,119937596,451433334,9341025093.803600,6708050565.907101,6958977727.993999,23008053387.704700,2022511,531450,1130446,3684407
2018-11-20,NYSE American (A),6736030,12596368,3329619,22662017,298545912.244100,209572698.206300,213978304.689500,722096915.139900,65401,39247,33835,138483
2018-11-20,NASDAQ BX (B),101727400,39022588,56634472,197384460,4320279167.320500,1996040314.068500,3264293833.215700,9580613314.604700,988254,176960,580047,1745261
2018-11-20,NYSE National (C),45114845,23847509,22460728,91423082,1293973173.135100,748573456.441500,1098117689.190400,3140664318.767000,406142,97782,236342,740266
2018-11-20,FINRA / NYSE TRF (DN),242413282,130310936,242085008,614809226,7541177587.030998,4997100563.919901,13771901419.755486,26310179570.706385,537569,244475,614957,1397001
2018-11-20,FINRA / Nasdaq TRF Carteret (DQ),1215391284,559511962,777915754,2552819000,46221086805.878594,32331934187.653993,44606263784.219899,123159284777.752486,4472420,1181915,2839874,8494209
2018-11-20,EDGA Equities (J),67466423,40958003,39860598,148285024,2796181300.794300,2280557812.118400,2620626025.395300,7697365138.308000,655384,193682,390887,1239953
2018-11-20,EDGX Equities (K),184594989,115119983,146775109,446490081,7529788327.667402,7381988320.361803,8814495938.975002,23726272587.004207,1503159,495814,1122636,3121609
2018-11-20,CHX (M),25805434,20290720,15712069,61808223,1078896042.302100,2207574843.092700,1349231428.990400,4635702314.385200,8089,13612,12923,34624
2018-11-20,NYSE (N),999647331,50827759,44628939,1095104029,40655779254.667303,4191715602.296400,2813784082.536501,47661278939.500204,3675775,187974,308380,4172129
2018-11-20,NYSE Arca (P),252085593,416456406,214082503,882624502,10552855642.574697,23347419956.209797,14063193527.621794,47963469126.406288,1985678,1239683,1766504,4991865
2018-11-20,NASDAQ (Q),566821042,294481002,739313172,1600615216,24958299089.118005,19668627113.492603,47956815554.388191,92583741756.998799,5135345,1290959,5244726,11671030
2018-11-20,IEX (V),147803697,32199697,76930131,256933525,6315739983.015199,1808348973.593800,4865251178.677201,12989340135.286200,1062422,139045,578451,1779918
2018-11-20,NASDAQ PSX (X),21805240,30691434,22519327,75016001,869694868.247100,2250806786.536200,2061529425.142499,5182031079.925799,179894,116563,177287,473744
2018-11-20,BYX Equities (Y),205614965,107068599,89774048,402457612,5770109172.536600,4552900198.727600,3936058939.405900,14259068310.670100,1691158,506327,843100,3040585
2018-11-20,BZX Equities (Z),287796105,178843613,180232266,646871984,12695436130.780902,11559416688.201805,11772830969.666696,36027683788.649403,2705415,909185,1701670,5316270
2018-11-19,NYSE American (A),5203802,11469351,3207204,19880357,230948085.243600,170209798.551200,187895262.420100,589053146.214900,52134,33782,29579,115495
2018-11-19,NASDAQ BX (B),85868928,30021904,50719160,166609992,3709620708.433700,1524660787.253300,2866273746.834000,8100555242.521000,870046,142113,515012,1527171
2018-11-19,NYSE National (C),38928484,20957700,19749061,79635245,1128607875.108800,638579762.937900,875183066.446700,2642370704.493400,348703,84893,202899,636495
2018-11-19,FINRA / NYSE TRF (DN),207916342,111864486,223844674,543625502,6745481278.633698,3840385041.271899,12752862220.358105,23338728540.263702,494642,219356,575868,1289866
2018-11-19,FINRA / Nasdaq TRF Carteret (DQ),1067557539,429540640,671162139,2168260318,42467782825.023295,24678505690.863097,36616024244.632476,103762312760.518868,3915363,928070,2518243,7361676
2018-11-19,EDGA Equities (J),55308010,32301658,35086241,122695909,2241002631.081000,1780308246.103401,2091019192.418001,6112330069.602402,546323,156534,318626,1021483
2018-11-19,EDGX Equities (K),154524976,88092245,134297376,376914597,6060637081.920200,5191694800.703800,7375444146.159301,18627776028.783301,1194903,370885,930907,2496695
2018-11-19,CHX (M),14986292,24398167,6923828,46308287,824083096.206200,2032507356.998001,825642901.346000,3682233354.550201,5365,9405,7347,22117
2018-11-19,NYSE (N),908974235,35663577,38601222,983239034,37537878192.646103,2714185659.918801,2106368785.090799,42358432637.655703,3174520,132143,266475,3573138
2018-11-19,NYSE Arca (P),217546801,322306589,190727418,730580808,8764110933.621900,18414127961.724587,11609255155.846702,38787494051.193189,1687871,961466,1572218,4221555
2018-11-19,NASDAQ (Q),488646454,229957527,687008401,1405612382,21766962298.398290,16007139683.547012,41555262130.722122,79329364112.667424,4353879,1021370,4591044,9966293
2018-11-19,IEX (V),129062858,24748261,68832080,222643199,5683355898.248100,1433538509.182800,4297850204.920601,11414744612.351501,923956,112439,506220,1542615
2018-11-19,NASDAQ PSX (X),17678642,22468262,17052555,57199459,683309533.938200,1724022893.764200,1431385110.933800,3838717538.636200,147881,83595,141494,372970
2018-11-19,BYX Equities (Y),172762151,85396151,78222470,336380772,4870435527.848200,3706172395.673200,3287312911.423401,11863920834.944801,1436800,430498,708217,2575515
2018-11-19,BZX Equities (Z),241974782,130337190,156005120,528317092,10583606122.834399,8520202723.314800,9847277146.533197,28951085992.682396,2275447,661551,1450661,4387659
2018-11-16,NYSE American (A),5448126,15803580,2468357,23720063,237443839.041200,177248455.719600,140598613.702500,555290908.463300,52944,36005,24827,113776
2018-11-16,NASDAQ BX (B),90089315,36258749,50602749,176950813,3981803787.262100,1865327071.170400,2648385241.246100,8495516099.678600,883825,166578,499976,1550379
2018-11-16,NYSE National (C),40825161,19231857,20131991,80189009,1153381083.894300,677590972.436100,868596808.413800,2699568864.744200,354266,88044,203773,646083
2018-11-16,FINRA / NYSE TRF (DN),206655236,120493558,224042377,551191171,6114431026.303201,3807304315.622599,10709137657.209805,20630872999.135605,442696,193503,509665,1145864
2018-11-16,FINRA / Nasdaq TRF Carteret (DQ),1084390013,566307124,696776127,2347473264,39056003969.338402,34452331699.631908,35879694770.554703,109388030439.525013,3812149,1000090,2417763,7230002
2018-11-16,EDGA Equities (J),62653941,36926396,35917487,135497824,2507980600.817200,2123333044.580600,2051554264.023399,6682867909.421199,583860,164746,321164,1069770
2018-11-16,EDGX Equities (K),156596487,99519770,126903288,383019545,5896122412.514601,5689280348.273901,6677398179.849099,18262800940.637601,1181317,396695,893930,2471942
2018-11-16,CHX (M),4806652,36640464,13425838,54872954,426166672.431000,3388257026.673500,2041503958.385500,5855927657.490000,2660,827,3374,6861
2018-11-16,NYSE (N),1057534775,39060872,40550705,1137146352,45643136001.822001,3067071653.799401,2008396178.859100,50718603834.480502,2946104,134580,260305,3340989
2018-11-16,NYSE Arca (P),221615768,367596241,183776000,772988009,8777292708.662701,20351942510.989111,10300752082.250797,39429987301.902609,1646268,993044,1434393,4073705
2018-11-16,NASDAQ (Q),483859718,251677204,759411650,1494948572,20908722155.643893,17073913061.941209,43862161552.719789,81844796770.304891,4173927,1031199,4253922,9459048
2018-11-16,IEX (V),129115604,29669785,62751061,221536450,5385239093.190400,1738685825.349199,3560789757.613000,10684714676.152599,893264,125848,471187,1490299
2018-11-16,NASDAQ PSX (X),18864357,25427256,16784630,61076243,732332843.913100,2092451542.786000,1199803026.822800,4024587413.521900,158935,92042,134334,385311
2018-11-16,BYX Equities (Y),188763234,95234662,81507224,365505120,5389789873.589601,4293969782.924101,3326582356.369800,13010342012.883502,1521099,452938,743524,2717561
2018-11-16,BZX Equities (Z),245760282,143650252,151935001,541345535,10223552001.318701,9301198386.282397,9086782114.751999,28611532502.353097,2220630,710768,1390550,4321948
2018-11-15,NYSE American (A),5762491,12005579,2833523,20601593,267205001.252000,205893304.527600,166634660.146000,639732965.925600,57774,39209,27769,124752
2018-11-15,NASDAQ BX (B),100942783,41753202,53369967,196065952,4365260394.063600,2180938424.412000,2773429604.450401,9319628422.926001,976514,189474,524020,1690008
2018-11-15,NYSE National (C),45031319,23962047,22184610,91177976,1335958878.303300,737051795.673800,952952059.145600,3025962733.122700,407399,105274,225561,738234
2018-11-15,FINRA / NYSE TRF (DN),226745662,121891754,239559649,588197065,7019011185.342001,4345944835.184402,11201137706.924305,22566093727.450708,484019,213933,526697,1224649
2018-11-15,FINRA / Nasdaq TRF Carteret (DQ),1151167991,505604002,688576325,2345348318,42591783005.966200,29188845856.500398,35225578010.062009,107006206872.528607,4099115,1060051,2430172,7589338
2018-11-15,EDGA Equities (J),67594243,50538098,37524970,155657311,2771882204.810100,2882601325.621101,2193008399.302000,7847491929.733201,636614,224759,349973,1211346
2018-11-15,EDGX Equities (K),180489675,132743011,146570135,459802821,7165049005.869599,8249930891.354498,7512780714.632100,22927760611.856197,1404136,553825,1009375,2967336
2018-11-15,CHX (M),14484094,28110638,11948725,54543457,729602753.880500,2652423717.059200,1347692357.630900,4729718828.570600,7663,14278,12325,34266
2018-11-15,NYSE (N),950840213,51737576,43660391,1046238180,38419564413.873693,3876321104.361599,2333134501.913900,44629020020.149192,3465377,182947,282062,3930386
2018-11-15,NYSE Arca (P),257203236,459925992,229681964,946811192,10664058772.859897,25741926254.045307,12175010365.282400,48580995392.187604,1991915,1304987,1626685,4923587
2018-11-15,NASDAQ (Q),562654266,342204086,708902692,1613761044,24806004474.202191,21710692995.544688,41655043014.468795,88171740484.215674,4989779,1359712,4754048,11103539
2018-11-15,IEX (V),142724101,32548333,68566536,243838970,6110533615.088700,1922747177.738000,3944522589.924001,11977803382.750701,993965,128677,511963,1634605
2018-11-15,NASDAQ PSX (X),21775605,33420898,19054455,74250958,862839283.678600,2443251685.906200,1308941502.326700,4615032471.911500,182538,125681,152712,460931
2018-11-15,BYX Equities (Y),196766068,107841823,86760699,391368590,5541038952.986300,4918407601.662200,3482400890.703199,13941847445.351699,1619928,503516,788758,2912202
2018-11-15,BZX Equities (Z),280787672,188403247,164306754,633497673,11941890384.906501,12319829562.660105,9747150663.805602,34008870611.372208,2662060,920307,1502263,5084630
2018-11-14,NYSE American (A),5797911,13753577,2581233,22132721,249163513.323000,211804653.017400,140256270.835800,601224437.176200,56075,42477,25054,123606
2018-11-14,NASDAQ BX (B),104083609,42234991,54712994,201031594,4537827240.782000,2054571665.475200,2763276236.038300,9355675142.295500,1021788,189559,544655,1756002
2018-11-14,NYSE National (C),45379999,26064475,21144837,92589311,1343164159.356000,797523465.077700,984124863.562400,3124812487.996100,395919,98839,222892,717650
2018-11-14,FINRA / NYSE TRF (DN),251552045,128196135,269291801,649039981,7348810099.346503,4386468086.105701,11305152458.949004,23040430644.401208,488894,219600,544578,1253072
2018-11-14,FINRA / Nasdaq TRF Carteret (DQ),1243691691,577910755,708401429,2530003875,41891286442.745706,30379570036.041302,33624221400.567403,105895077879.354411,4132199,1060505,2446761,7639465
2018-11-14,EDGA Equities (J),65897841,44962386,36166477,147026704,2618848008.709600,2464692975.892901,2012125395.007000,7095666379.609501,610457,200390,325161,1136008
2018-11-14,EDGX Equities (K),180259118,124725847,159619785,464604750,6584065034.405601,7390545163.888098,7230603220.071404,21205213418.365103,1335007,515353,978971,2829331
2018-11-14,CHX (M),12060662,21206651,9659685,42926998,616395143.538000,1501093245.801600,1095747786.165000,3213236175.504600,5861,5587,6064,17512
2018-11-14,NYSE (N),1002871198,46584510,45320857,1094776565,37733767089.287704,3400544560.707900,2575318927.780200,43709630577.775804,3346257,162199,297257,3805713
2018-11-14,NYSE Arca (P),267100754,441433646,227956186,936490586,9825362266.219502,23568733030.251399,10851198727.857093,44245294024.327994,1933115,1252020,1620210,4805345
2018-11-14,NASDAQ (Q),589585109,305644829,691504405,1586734343,24585712073.644395,19754284192.671392,38643414731.621185,82983410997.936972,4977731,1241322,4604129,10823182
2018-11-14,IEX (V),154536469,31895770,68366781,254799020,6205114347.985300,1810413996.308300,3803013519.644699,11818541863.938299,1034745,140095,519284,1694124
2018-11-14,NASDAQ PSX (X),20944964,30060872,18600916,69606752,773677085.595200,2262156146.876700,1501922980.014800,4537756212.486700,169230,106434,151813,427477
2018-11-14,BYX Equities (Y),216849883,112986460,88481151,418317494,5812374495.986100,4748612511.031901,3365854025.490500,13926841032.508501,1700262,511110,780729,2992101
2018-11-14,BZX Equities (Z),288456800,171519496,164407435,624383731,11648944279.970602,11228535140.665100,9460636478.143299,32338115898.779001,2572737,844899,1496545,4914181
2018-11-13,NYSE American (A),6083129,13293623,2247170,21623922,244037980.286800,173080340.813000,118076011.728200,535194332.828000,56482,40343,23757,120582
2018-11-13,NASDAQ BX (B),96688329,36597121,53386395,186671845,4038338474.327700,1708380599.408300,2764787021.161500,8511506094.897500,924689,161558,530582,1616829
2018-11-13,NYSE National (C),43089979,20636047,19559886,83285912,1229294659.645800,664895995.017800,834534644.833500,2728725299.497100,378830,91397,204978,675205
2018-11-13,FINRA / NYSE TRF (DN),214037756,106737140,241761192,562536088,6651906396.706402,3854657665.256600,9941330878.843203,20447894940.806205,448827,180725,518490,1148042
2018-11-13,FINRA / Nasdaq TRF Carteret (DQ),1146949918,444523375,655475682,2246948975,39287299886.857805,23079602877.780909,30346870288.144807,92713773052.783521,3941353,915479,2289148,7145980
2018-11-13,EDGA Equities (J),64156654,41363199,34308139,139827992,2527400760.081700,1999871230.469800,1842235986.123700,6369507976.675200,598272,180016,316526,1094814
2018-11-13,EDGX Equities (K),167236877,105237911,137786702,410261490,6297158054.275801,5941430968.107899,6801622748.659599,19040211771.043299,1294291,451138,961364,2706793
2018-11-13,CHX (M),11059559,20727625,9918582,41705766,573023164.099100,1566510285.763600,1129080935.182400,3268614385.045100,6289,9394,10117,25800
2018-11-13,NYSE (N),951886371,45426594,40462112,1037775077,35505045803.912396,3083761324.405601,2174869776.707600,40763676905.025597,3171792,150974,271865,3594631
2018-11-13,NYSE Arca (P),237803857,375484782,192070337,805358976,9142393785.527899,19738412244.477499,10233850406.827502,39114656436.832900,1794378,1064053,1484016,4342447
2018-11-13,NASDAQ (Q),542339178,276081095,654072550,1472492823,22522263853.163195,17756799191.567396,36058528881.891987,76337591926.622578,4638474,1112181,4403588,10154243
2018-11-13,IEX (V),141711389,27087396,67524702,236323487,5715285166.632300,1427209370.737300,3572872098.639200,10715366636.008800,979488,122203,501483,1603174
2018-11-13,NASDAQ PSX (X),21120504,25515949,17884174,64520627,778776990.643200,1833385468.932800,1278838295.373000,3891000754.949000,170222,93170,148323,411715
2018-11-13,BYX Equities (Y),199280239,94299671,79978612,373558522,5370483803.811100,3993742142.714101,3058807867.013000,12423033813.538201,1586346,445740,730571,2762657
2018-11-13,BZX Equities (Z),269382838,153202712,154803769,577389319,10831919795.603300,9426205898.969700,8930653323.324003,29188779017.897003,2474484,756933,1450430,4681847
2018-11-12,NYSE American (A),5359886,13993337,2796153,22149376,224352775.398600,180601318.797800,170286606.384600,575240700.581000,51966,40475,29172,121613
2018-11-12,NASDAQ BX (B),92942637,27737745,51551292,172231674,4143149862.339100,1524339805.718700,2714798412.806000,8382288080.863800,915882,136995,532613,1585490
2018-11-12,NYSE National (C),39653766,18937286,18482452,77073504,1086316904.666200,611457603.888400,762343185.433500,2460117693.988100,340648,75815,185902,602365
2018-11-12,FINRA / NYSE TRF (DN),200200677,85058570,229080916,514340163,6419914966.405500,3597485799.034201,10785726754.401706,20803127519.841407,464689,175884,574568,1215141
2018-11-12,FINRA / Nasdaq TRF Carteret (DQ),1058871858,371685477,662747468,2093304803,38965151043.489097,21084001674.218700,34438377589.630812,94487530307.338609,3832732,949567,2481881,7264180
2018-11-12,EDGA Equities (J),58030279,30337674,32138385,120506338,2287421085.896400,1668259995.539300,1792215058.499100,5747896139.934800,541635,145745,300239,987619
2018-11-12,EDGX Equities (K),151117507,81599421,131449325,364166253,6076795529.365700,5424677153.617401,7064040012.896496,18565512695.879597,1194275,366753,952392,2513420
2018-11-12,CHX (M),7521118,16116548,8392705,32030371,416027275.104900,1791459922.973000,1180153783.910600,3387640981.988500,4874,9681,8754,23309
2018-11-12,NYSE (N),856025108,33913922,37875493,927814523,35457301817.727997,2612084889.150300,2168444487.089301,40237831193.967598,2923420,125491,255744,3304655
2018-11-12,NYSE Arca (P),206357734,298757954,180279703,685395391,8436341765.377701,17870057162.951791,10583793560.902399,36890192489.231891,1603400,923607,1488625,4015632
2018-11-12,NASDAQ (Q),462878881,190975837,644445232,1298299950,20832858182.189998,14499692095.486705,39203906693.458701,74536456971.135404,4161827,869833,4423808,9455468
2018-11-12,IEX (V),127487266,21292140,66442096,215221502,5220967144.598600,1293788590.830500,3770786284.507901,10285542019.937001,879767,100177,493375,1473319
2018-11-12,NASDAQ PSX (X),18177529,18755729,17907335,54840593,730656949.551400,1521741174.513800,1460467917.539500,3712866041.604700,152613,75382,142435,370430
2018-11-12,BYX Equities (Y),185827515,78909843,78795988,343533346,5327340770.651900,3585125045.489400,3202285611.692402,12114751427.833702,1514220,396748,733560,2644528
2018-11-12,BZX Equities (Z),231120117,112491660,142961348,486573125,10044158955.819805,8169978208.911798,8384331079.022004,26598468243.753607,2181624,593614,1335244,4110482
2018-11-09,NYSE American (A),5594569,16973209,2866156,25433934,230115619.707500,202153585.221600,155538324.589900,587807529.519000,54413,40457,29364,124234
2018-11-09,NASDAQ BX (B),99290638,32210896,53535444,185036978,4150106566.059700,1682879019.467600,2578792027.553600,8411777613.080900,970387,155546,542418,1668351
2018-11-09,NYSE National (C),37696269,21524961,17909637,77130867,1037042632.178000,672094390.915400,705115279.132000,2414252302.225400,335005,78153,185384,598542
2018-11-09,FINRA / NYSE TRF (DN),240277941,91962877,244138175,576378993,6619494678.154498,3635382127.275800,10623925352.146098,20878802157.576396,493003,176798,568827,1238628
2018-11-09,FINRA / Nasdaq TRF Carteret (DQ),1134185890,456238134,735886001,2326310025,39938677986.047987,27438286176.059693,33095769516.075785,100472733678.183465,4074927,946758,2587691,7609376
2018-11-09,EDGA Equities (J),60005564,30909930,32075761,122991255,2200425514.410600,1623087631.097700,1739773847.871300,5563286993.379600,548805,149342,302016,1000163
2018-11-09,EDGX Equities (K),166840548,82219831,129651756,378712135,6363921666.565399,5037521363.712700,6412193699.215400,17813636729.493499,1274751,369291,915409,2559451
2018-11-09,CHX (M),11869997,15358791,8406300,35635088,528168192.956000,1597907386.493800,1116487733.060300,3242563312.510100,4780,7957,8455,21192
2018-11-09,NYSE (N),934372615,34987978,40832722,1010193315,37604233423.630496,2458078909.303500,2162205672.100800,42224518005.034796,2990739,120819,271231,3382789
2018-11-09,NYSE Arca (P),230490595,324278110,186405070,741173775,8695858967.844299,18219052401.989703,9608719943.998799,36523631313.832801,1679197,921891,1466786,4067874
2018-11-09,NASDAQ (Q),501397228,198644858,659856424,1359898510,21697852917.556702,13963959863.301895,37079104818.104921,72740917598.963518,4375955,842565,4318400,9536920
2018-11-09,IEX (V),137974310,25886253,71763936,235624499,5583562632.769000,1488726059.451801,3823062318.895901,10895351011.116702,929037,119058,523083,1571178
2018-11-09,NASDAQ PSX (X),20311640,19330321,16299312,55941273,733884027.807900,1500330699.412700,1282585018.661400,3516799745.882000,158343,73928,128895,361166
2018-11-09,BYX Equities (Y),187438655,87388493,79722427,354549575,5020165296.152200,3794649812.142900,3082651070.496099,11897466178.791199,1491796,422577,748863,2663236
2018-11-09,BZX Equities (Z),261283717,117086466,147406439,525776622,10561215508.747096,8031645552.614200,8439344713.996601,27032205775.357897,2352068,595505,1383695,4331268
2018-11-08,NYSE American (A),4946830,15174033,2779395,22900258,220262030.720000,192479506.613600,161235217.090900,573976754.424500,50429,38182,27943,116554
2018-11-08,NASDAQ BX (B),89703514,25737855,55384791,170826160,4034286428.217500,1428696364.272800,2858235696.462600,8321218488.952900,914766,126285,552082,1593133
2018-11-08,NYSE National (C),35413142,16253011,17780746,69446899,1040210339.947200,511287366.538800,704059056.616000,2255556763.102000,320140,67189,182739,570068
2018-11-08,FINRA / NYSE TRF (DN),211083693,83136210,255408501,549628404,7062779755.051503,3570613737.394098,11468610994.627102,22102004487.072703,477837,163541,614574,1255952
2018-11-08,FINRA / Nasdaq TRF Carteret (DQ),1097172907,376428633,770871087,2244472627,41594703988.805002,21750233779.218303,36237792751.845286,99582730519.868591,3849566,889990,2669544,7409100
2018-11-08,EDGA Equities (J),52939860,27121067,32447200,112508127,2158141178.357300,1397912899.680300,1768355413.671800,5324409491.709400,518284,128563,301326,948173
2018-11-08,EDGX Equities (K),154412302,69468953,135257057,359138312,6442749670.153699,3960187570.144101,6796883340.804800,17199820581.102600,1225546,311692,950359,2487597
2018-11-08,CHX (M),9044390,11012838,6205351,26262579,637893626.039700,1086349364.750000,749119060.471500,2473362051.261200,2980,4985,4188,12153
2018-11-08,NYSE (N),825467597,28194616,36960084,890622297,33391290233.351198,1828177541.853800,1781331076.515800,37000798851.720798,2854608,100777,260242,3215627
2018-11-08,NYSE Arca (P),203122971,267218570,196916689,667258230,8521803967.313298,14931470699.596504,9658484049.551799,33111758716.461601,1595952,756887,1438585,3791424
2018-11-08,NASDAQ (Q),447533140,168268961,645772442,1261574543,20813112742.432599,10994013638.706804,35984653263.261894,67791779644.401297,4049596,701368,4264014,9014978
2018-11-08,IEX (V),124517195,21965383,72972191,219454769,5218858884.513700,1306341259.477800,3747783014.212000,10272983158.203500,854077,101229,515146,1470452
2018-11-08,NASDAQ PSX (X),16562029,16093311,16875432,49530772,639310108.661600,1067966809.535901,1160493126.426000,2867770044.623501,134845,60727,123782,319354
2018-11-08,BYX Equities (Y),162803359,70863000,80726124,314392483,4921425407.875300,3337432528.447900,3141650638.054900,11400508574.378100,1390796,352494,728654,2471944
2018-11-08,BZX Equities (Z),238827664,95021206,148805549,482654419,10416761408.108399,6132499906.845600,8116904939.598898,24666166254.552897,2241040,487551,1380173,4108764
2018-11-07,NYSE American (A),5246579,16086680,2921655,24254914,236824138.261000,173374389.540100,165295570.614300,575494098.415400,52972,41510,28575,123057
2018-11-07,NASDAQ BX (B),97243532,28439249,58854839,184537620,4513905288.538900,1673632663.984300,3110525978.880700,9298063931.403900,1001594,134547,591549,1727690
2018-11-07,NYSE National (C),36839422,17728172,19222052,73789646,1113207809.619400,574172961.676700,767724990.870300,2455105762.166400,343608,69116,198951,611675
2018-11-07,FINRA / NYSE TRF (DN),249681626,92704370,283339245,625725241,8659954694.656602,3837069554.973200,12664938083.085411,25161962332.715213,561731,182941,668548,1413220
2018-11-07,FINRA / Nasdaq TRF Carteret (DQ),1142278813,444922928,820585004,2407786745,48267483324.259100,27525336404.984499,38656476841.304007,114449296570.547606,4250255,925063,2831484,8006802
2018-11-07,EDGA Equities (J),55798179,29935481,33126853,118860513,2325319875.534700,1786774479.382200,1807511748.175600,5919606103.092500,542097,138040,307361,987498
2018-11-07,EDGX Equities (K),165142192,87397022,157843077,410382291,7084054946.106302,5623866889.501699,7804630092.805099,20512551928.413100,1304254,373670,1050370,2728294
2018-11-07,CHX (M),18533194,19266132,10313231,48112557,1079884916.687600,2062783198.602201,1127277377.928200,4269945493.218001,4064,9394,8074,21532
2018-11-07,NYSE (N),886278326,31763439,41772557,959814322,38191918876.155401,2362076174.549400,2111411092.912400,42665406143.617201,3082722,107578,272135,3462435
2018-11-07,NYSE Arca (P),216364773,297005566,207680160,721050499,9413341449.868600,18253161776.041100,10946887122.014803,38613390347.924503,1704325,861474,1541071,4106870
2018-11-07,NASDAQ (Q),468554131,194027447,710447403,1373028981,22246701493.464801,14185536288.516599,41097860794.251701,77530098576.233101,4223607,812112,4559403,9595122
2018-11-07,IEX (V),142001940,24517417,78252722,244772079,6235043486.488000,1512860985.736700,4211430814.138099,11959335286.362799,960438,111495,551060,1622993
2018-11-07,NASDAQ PSX (X),18580600,18176049,17628839,54385488,777127965.205000,1492771442.759400,1437404515.151400,3707303923.115800,157810,68908,142968,369686
2018-11-07,BYX Equities (Y),175254901,77760479,83584232,336599612,5379751070.194100,3924833667.629399,3325691940.136400,12630276677.959899,1500591,391640,780015,2672246
2018-11-07,BZX Equities (Z),251287631,116905285,161843828,530036744,11073819637.431302,8275280034.795704,9225227121.613398,28574326793.840404,2386514,586105,1488310,4460929
2018-11-06,NYSE American (A),4696268,10936537,2244336,17877141,202708972.917500,121385064.880100,105649752.155000,429743789.952600,47591,32750,22595,102936
2018-11-06,NASDAQ BX (B),87954931,20960286,50926397,159841614,3883927918.292300,1035041902.598500,2586118697.608000,7505088518.498800,898343,101799,524733,1524875
2018-11-06,NYSE National (C),37092474,14054337,17143355,68290166,1093999570.663800,436103492.170400,660903268.353100,2191006331.187300,333436,56175,176361,565972
2018-11-06,FINRA / NYSE TRF (DN),208185171,72426721,259622786,540234678,6474973900.417298,2738710120.761700,9676218532.616102,18889902553.795100,449351,148939,553739,1152029
2018-11-06,FINRA / Nasdaq TRF Carteret (DQ),1047766749,334293144,718908033,2100967926,39965402693.681294,18307752314.927901,30209528303.239902,88482683311.849097,3863521,751691,2455633,7070845
2018-11-06,EDGA Equities (J),52061423,22890197,26842512,101794132,2061873178.138300,1199128021.434700,1379031259.357000,4640032458.930000,515121,107055,260137,882313
2018-11-06,EDGX Equities (K),146039238,63855882,139631819,349526939,5848792446.878700,3816050471.468401,5850692678.432301,15515535596.779402,1157107,275467,874892,2307466
2018-11-06,CHX (M),13302646,12340795,6976295,32619736,554902177.485000,1265030089.565000,584835298.864400,2404767565.914400,4377,6123,6493,16993
2018-11-06,NYSE (N),815037693,23086639,32828450,870952782,33292318607.133295,1591575729.913600,1514247724.973900,36398142062.020795,3051881,82780,219856,3354517
2018-11-06,NYSE Arca (P),190816609,214402046,171316773,576535428,7614475280.028101,11872365790.185904,7917149613.398799,27403990683.612804,1465850,620622,1267721,3354193
2018-11-06,NASDAQ (Q),421495238,138058027,587754959,1147308224,19005539967.154707,9455719080.886499,31031991267.077495,59493250315.118701,3780901,601173,3875780,8257854
2018-11-06,IEX (V),121093133,18338399,64664091,204095623,4882469222.318001,1048658388.854100,3125593487.904600,9056721099.076701,806578,84299,459971,1350848
2018-11-06,NASDAQ PSX (X),15898397,13196362,14400920,43495679,592437931.188100,918359516.347100,1013378968.996500,2524176416.531700,134295,50580,117276,302151
2018-11-06,BYX Equities (Y),162559738,57878188,72055555,292493481,4859191181.066400,2511980312.985000,2716382786.835900,10087554280.887300,1398195,295379,686398,2379972
2018-11-06,BZX Equities (Z),219807882,84872691,135612326,440292899,9087371368.031000,5537290707.165501,6779156985.463097,21403819060.659598,2052369,431085,1220803,3704257
2018-11-05,NYSE American (A),4936715,15509634,2458758,22905107,202415017.674500,141609967.043400,147738391.688600,491763376.406500,49312,37898,25074,112284
2018-11-05,NASDAQ BX (B),88420277,25805779,48245297,162471353,3911923609.902900,1310693418.594500,2673542855.981800,7896159884.479200,918429,130123,516989,1565541
2018-11-05,NYSE National (C),37613925,15299709,17110710,70024344,1066410680.778600,508838496.897700,777615717.897800,2352864895.574100,327265,65767,179482,572514
2018-11-05,FINRA / NYSE TRF (DN),202552476,83758780,224520018,510831274,6376498150.846199,2957251284.347100,10300002848.158505,19633752283.351804,450691,171110,555450,1177251
2018-11-05,FINRA / Nasdaq TRF Carteret (DQ),1032654242,402096446,656884631,2091635319,41174243930.807009,21391956966.868593,33419620118.985010,95985821016.660612,3812752,918779,2405163,7136694
2018-11-05,EDGA Equities (J),51075560,25658077,25670254,102403891,1890197690.729100,1402036044.132000,1409802615.146900,4702036350.008000,497591,121891,251753,871235
2018-11-05,EDGX Equities (K),137238580,73707516,125511962,336458058,5627181289.263400,3910661673.135200,6193675048.904302,15731518011.302902,1110462,310266,866919,2287647
2018-11-05,CHX (M),11721747,13003928,6677823,31403498,472295714.877000,1596127267.550000,615761176.153400,2684184158.580400,4711,7503,7243,19457
2018-11-05,NYSE (N),932695083,26010222,31679947,990385252,37969792739.642801,1704258384.548700,1578721172.738200,41252772296.929701,3077950,99761,213545,3391256
2018-11-05,NYSE Arca (P),190623149,268742862,158226478,617592489,7708363771.248400,15071335779.405999,8853273244.108903,31632972794.763302,1490441,708007,1283617,3482065
2018-11-05,NASDAQ (Q),440062936,165847958,609515087,1215425981,19853817242.022704,10648755771.534100,36583369548.206005,67085942561.762809,3975184,727228,3924244,8626656
2018-11-05,IEX (V),112981053,19423579,60992277,193396909,4761025120.342700,1157138310.744700,3634887637.239601,9553051068.327001,821258,95117,471610,1387985
2018-11-05,NASDAQ PSX (X),16777596,15006974,14363221,46147791,643071995.181500,1060902480.870200,1067620550.238700,2771595026.290400,144215,59550,121752,325517
2018-11-05,BYX Equities (Y),166576031,67352576,70397772,304326379,4956222808.905900,2982186627.924300,2913828859.025499,10852238295.855699,1449993,352815,684976,2487784
2018-11-05,BZX Equities (Z),224990429,101754636,134065130,460810195,9526053794.054601,6517758371.867101,7654784049.069901,23698596214.991603,2142061,504503,1275052,3921616
2018-11-02,NYSE American (A),6422353,13320555,3045056,22787964,273414057.310000,213859183.629000,176078355.358600,663351596.297600,60361,42906,30737,134004
2018-11-02,NASDAQ BX (B),110505912,36237738,64183918,210927568,4675651285.189300,1950428756.116500,3540181969.177201,10166262010.483001,1063953,174574,642690,1881217
2018-11-02,NYSE National (C),53376111,27741162,23138313,104255586,1515935935.645800,881749576.628800,1054685990.734800,3452371503.009400,468328,116815,242027,827170
2018-11-02,FINRA / NYSE TRF (DN),226988506,91036342,276983968,595008816,7040108355.757299,4068352146.742601,13556669243.390006,24665129745.889906,477623,182701,640498,1300822
2018-11-02,FINRA / Nasdaq TRF Carteret (DQ),1151837800,433001573,870235764,2455075137,44702575599.976588,26386935531.603198,42127446140.429295,113216957272.009081,4348335,1037402,2984806,8370543
2018-11-02,EDGA Equities (J),62590053,37222166,34079558,133891777,2430660145.777000,2156852584.339901,2000401023.045300,6587913753.162201,567568,165465,308384,1041417
2018-11-02,EDGX Equities (K),171529149,106076678,167933923,445539750,7200590089.199703,7133916634.452298,8990535275.870003,23325041999.522004,1350939,493889,1157346,3002174
2018-11-02,CHX (M),11156562,27483893,17083219,55723674,800080039.252900,2462991184.839100,1297957968.746500,4561029192.838500,6827,14400,10899,32126
2018-11-02,NYSE (N),988820733,43427733,47138474,1079386940,40772473205.007394,3216531032.332601,2425478985.525699,46414483222.865694,3779621,161888,298984,4240493
2018-11-02,NYSE Arca (P),246087038,378163775,234255191,858506004,10735667748.588399,21757897083.687801,12745337058.631598,45238901890.907798,1911672,1114455,1700064,4726191
2018-11-02,NASDAQ (Q),553297138,254181330,780499977,1587978445,25915395494.071704,18569326405.993399,46248039904.824715,90732761804.889818,4977151,1133458,5081575,11192184
2018-11-02,IEX (V),156948774,30881104,82557610,270387488,6351011335.909301,1812676813.456800,4836435919.867401,13000124069.233502,1001872,135731,576146,1713749
2018-11-02,NASDAQ PSX (X),20257907,26118847,21275198,67651952,867860581.948900,2017615745.600100,1871619235.714399,4757095563.263399,172590,103519,168125,444234
2018-11-02,BYX Equities (Y),213040531,94818616,98024754,405883901,6128051589.172400,4414880721.497000,4031050558.532800,14573982869.202200,1695843,476819,864069,3036731
2018-11-02,BZX Equities (Z),288380133,162390235,179236862,630007230,12034859228.229696,10946885379.030395,10270586140.652206,33252330747.912297,2600004,835003,1605605,5040612
2018-11-01,NYSE American (A),6644682,13625410,3139604,23409696,276512955.370700,220126991.248800,174253570.332000,670893516.951500,61046,39249,30997,131292
2018-11-01,NASDAQ BX (B),117478208,38971593,62326974,218776775,5176858914.856500,2122287624.203100,3523705914.948200,10822852454.007800,1128168,172346,640302,1940816
2018-11-01,NYSE National (C),53077497,22738488,22712809,98528794,1478501929.733100,735666388.304500,969481021.750100,3183649339.787700,445868,93662,234946,774476
2018-11-01,FINRA / NYSE TRF (DN),272201532,98473045,264915408,635589985,8234194813.785299,3884293682.899999,12976057933.468697,25094546430.153995,562007,184211,656417,1402635
2018-11-01,FINRA / Nasdaq TRF Carteret (DQ),1375559245,534032476,818572333,2728164054,50399117305.811108,31433457780.257408,40262429566.215308,122095004652.283824,4838293,1000603,2962207,8801103
2018-11-01,EDGA Equities (J),61132902,46998520,28384044,136515466,2135480627.261200,2113438000.994400,1661126068.654700,5910044696.910300,532516,152243,272620,957379
2018-11-01,EDGX Equities (K),188503755,93115739,165528288,447147782,7458076808.139001,5802580496.000796,8529574434.632003,21790231738.771800,1436574,406115,1115728,2958417
2018-11-01,CHX (M),11776063,24724990,9751934,46252987,697226554.858500,2354188319.630000,978309860.886500,4029724735.375000,5282,10695,8278,24255
2018-11-01,NYSE (N),1033479590,39356511,41304967,1114141068,40486191249.657308,2659021709.399200,2232780228.268600,45377993187.325108,4003007,134885,303976,4441868
2018-11-01,NYSE Arca (P),282919736,381373165,213988586,878281487,11036721354.199395,20996933635.161496,12591085601.124701,44624740590.485592,2027740,969867,1660569,4658176
2018-11-01,NASDAQ (Q),585723777,232002968,736826485,1554553230,26076921458.112803,15804751559.766904,43996947452.002013,85878620469.881720,5017276,969361,4941450,10928087
2018-11-01,IEX (V),170302741,34555782,81087533,285946056,7038641554.693700,1982067581.845300,4634526559.113599,13655235695.652599,1085549,141998,579368,1806915
2018-11-01,NASDAQ PSX (X),21867048,24435596,18134155,64436799,822730839.104400,1697182021.936100,1411505335.398700,3931418196.439200,176006,89160,143277,408443
2018-11-01,BYX Equities (Y),240752805,103812429,95223326,439788560,6751903090.337500,4665072063.645700,3895248017.154100,15312223171.137300,1854381,506439,888505,3249325
2018-11-01,BZX Equities (Z),308832100,140461748,166864579,616158427,12496824017.507198,9234117701.053701,9381676302.494902,31112618021.055801,2733926,700300,1560854,4995080
2018-10-31,NYSE American (A),7881546,16290626,3422110,27594282,347494750.838000,232662595.506300,205677334.595000,785834680.939300,76798,40606,34129,151533
2018-10-31,NASDAQ BX (B),129545969,41056005,66590914,237192888,5925486470.885300,2308503358.095600,4018463038.687000,12252452867.667900,1272171,192404,690939,2155514
2018-10-31,NYSE National (C),62755399,27285168,28556102,118596669,1971572156.185400,988056638.400500,1238551974.225700,4198180768.811600,569431,118010,300160,987601
2018-10-31,FINRA / NYSE TRF (DN),268893118,95217022,263709687,627819827,8120223728.891100,4280326927.577000,14544541073.736198,26945091730.204298,563133,185715,622322,1371170
2018-10-31,FINRA / Nasdaq TRF Carteret (DQ),1463036189,490723420,869367818,2823127427,55381455875.040804,31908006251.283886,45946460567.047701,133235922693.372391,5072884,954605,2963557,8991046
2018-10-31,EDGA Equities (J),59565050,33576217,29131630,122272897,2278931239.503800,2337154227.403700,1709192499.463400,6325277966.370900,534776,156667,274982,966425
2018-10-31,EDGX Equities (K),195770536,102456404,163462957,461689897,8052115519.771204,7064696804.359398,8579668500.662507,23696480824.793109,1518581,449117,1123471,3091169
2018-10-31,CHX (M),10731968,16606778,16458522,43797268,682176618.533600,2035104518.490300,1183024741.025100,3900305878.049000,6900,11475,9117,27492
2018-10-31,NYSE (N),1286729334,38110491,46651203,1371491028,53459086943.191400,2982902604.262900,2808825524.409899,59250815071.864199,4113325,140835,319714,4573874
2018-10-31,NYSE Arca (P),273121767,376669023,218506279,868297069,11401730194.411404,23251862453.218799,12641032926.248698,47294625573.878901,2087262,1046925,1685431,4819618
2018-10-31,NASDAQ (Q),609653448,248499763,828425303,1686578514,28467599884.799610,17572952424.116195,51097195900.947077,97137748209.862882,5410667,1030434,5093376,11534477
2018-10-31,IEX (V),168036575,29262695,80702059,278001329,7161995348.157600,1865405244.432800,4994837484.790199,14022238077.380599,1122216,127198,580434,1829848
2018-10-31,NASDAQ PSX (X),23709698,25800035,21256263,70765996,1016842997.477200,1836065505.232300,1831315963.364200,4684224466.073700,206003,97318,167863,471184
2018-10-31,BYX Equities (Y),243097183,106600790,96916818,446614791,7347675477.405800,4739453271.072501,4139055193.706501,16226183942.184802,1989113,513286,938744,3441143
2018-10-31,BZX Equities (Z),330857518,150965236,185730973,667553727,14237766111.335399,10943820008.740900,11072438309.502103,36254024429.578402,3034680,745735,1752812,5533227
2018-10-30,NYSE American (A),7443505,13671497,3276230,24391232,325112142.221000,210840951.620700,246336765.301000,782289859.142700,69094,44796,32869,146759
2018-10-30,NASDAQ BX (B),120797320,41504021,63258268,225559609,5437349428.585900,2469461514.307800,3892744004.807799,11799554947.701499,1156786,203921,650273,2010980
2018-10-30,NYSE National (C),75759042,29632418,33883443,139274903,2309816231.636100,1171980567.266800,1569091550.802800,5050888349.705700,677095,160660,356149,1193904
2018-10-30,FINRA / NYSE TRF (DN),282661889,98001815,228539896,609203600,7775746576.302100,4406446982.585700,13253876607.470196,25436070166.357996,543387,197772,566493,1307652
2018-10-30,FINRA / Nasdaq TRF Carteret (DQ),1448655370,408136141,753143231,2609934742,50382869256.093706,27177878440.330096,40109064438.385804,117669812134.809606,4865842,987511,2771250,8624603
2018-10-30,EDGA Equities (J),59442700,37894369,30190913,127527982,2202680011.265000,2728288267.936099,1863064521.769400,6794032800.970499,510848,187977,274497,973322
2018-10-30,EDGX Equities (K),199352580,123200642,159055252,481608474,7975413257.308102,8792060906.086302,9239459488.329100,26006933651.723504,1533490,591204,1159190,3283884
2018-10-30,CHX (M),20204770,26367060,11713992,58285822,950744673.258300,2794247626.987000,1179170702.448200,4924163002.693500,9045,17154,13309,39508
2018-10-30,NYSE (N),1172564573,45363730,49809273,1267737576,51265250301.046604,3204884883.059000,3431070798.966100,57901205983.071704,4500251,189993,344468,5034712
2018-10-30,NYSE Arca (P),297065552,428057301,217552641,942675494,11779010424.498904,26278502535.375208,14106989077.388798,52164502037.262910,2142242,1372883,1735495,5250620
2018-10-30,NASDAQ (Q),648256050,303040038,749135435,1700431523,29533564601.893199,21263220613.547408,50007832577.486891,100804617792.927498,5669374,1334136,5336779,12340289
2018-10-30,IEX (V),173666955,26290279,78579477,278536711,6958553591.920301,1799923513.859300,5211155525.762200,13969632631.541801,1098980,129313,573895,1802188
2018-10-30,NASDAQ PSX (X),23970416,32131352,24641495,80743263,1002847955.207100,2713341385.095300,2354153540.564900,6070342880.867300,204836,149962,191320,546118
2018-10-30,BYX Equities (Y),250221923,107211315,99035336,456468574,7066062457.045900,5326942182.376600,4340337876.435099,16733342515.857599,1960670,586165,929627,3476462
2018-10-30,BZX Equities (Z),345545619,203310718,197414816,746271153,14560358024.880301,15167289421.274702,11799066702.448206,41526714148.603209,3090795,1111586,1793801,5996182
2018-10-29,NYSE American (A),7087608,14537529,3599270,25224407,337144395.026000,284851409.923300,228686064.159400,850681869.108700,70167,47516,36075,153758
2018-10-29,NASDAQ BX (B),119362804,46676908,63547109,229586821,5373875261.379700,2739382858.261000,4268000374.924999,12381258494.565699,1143196,230888,654271,2028355
2018-10-29,NYSE National (C),70642717,33230458,31729187,135602362,2180506267.482800,1257128139.805800,1528194312.525400,4965828719.814000,630518,163278,338213,1132009
2018-10-29,FINRA / NYSE TRF (DN),252814291,98666655,250570103,602051049,8140676594.853603,4656444181.303300,14272413237.338194,27069534013.495097,541638,202020,656266,1399924
2018-10-29,FINRA / Nasdaq TRF Carteret (DQ),1250250377,447436349,738443624,2436130350,49225831781.872493,30414853739.974709,42267581890.481892,121908267412.329094,4524012,1041351,2817010,8382373
2018-10-29,EDGA Equities (J),54390982,39286853,30228130,123905965,2060294057.465400,2879655278.000601,1867858418.575000,6807807754.041001,478424,190914,271263,940601
2018-10-29,EDGX Equities (K),189845561,126429453,164464582,480739596,7987521376.471598,8709843269.034199,9618945912.050199,26316310557.555996,1451269,599632,1135186,3186087
2018-10-29,CHX (M),15377646,19914939,12959143,48251728,763000516.105700,2878176852.977000,1075749017.154200,4716926386.236900,7238,17868,12558,37664
2018-10-29,NYSE (N),1077956331,50604184,47735948,1176296463,42712085044.095209,3703509303.812800,3285121499.411500,49700715847.319509,4361012,210218,318309,4889539
2018-10-29,NYSE Arca (P),277923631,458097834,214365049,950386514,11845490671.892199,27718072805.319199,13805680277.209403,53369243754.420801,2065473,1449440,1723803,5238716
2018-10-29,NASDAQ (Q),631277016,317157030,768275694,1716709740,29055384073.685504,21125044037.122099,51613574978.352489,101794003089.160092,5425029,1395639,5097226,11917894
2018-10-29,IEX (V),150291368,29733595,73679243,253704206,6741904617.088999,1853051622.126200,5243051859.986998,13838008099.202197,1036649,138523,548903,1724075
2018-10-29,NASDAQ PSX (X),26010330,33548958,23166910,82726198,1077677750.169000,2634977712.689501,2067971751.246800,5780627214.105301,210404,150020,179088,539512
2018-10-29,BYX Equities (Y),241286210,116375306,92859608,450521124,7055714830.397000,5529517707.984200,4227520639.702099,16812753178.083299,1924485,612292,876039,3412816
2018-10-29,BZX Equities (Z),336752988,204463955,196284022,737500965,14426669835.900098,14435151896.620406,12871053876.267201,41732875608.787705,3015155,1091115,1794189,5900459
2018-10-26,NYSE American (A),7792427,14118595,3591242,25502264,349629714.379200,278792937.457900,243566275.660600,871988927.497700,74775,46015,36010,156800
2018-10-26,NASDAQ BX (B),113009644,52192416,61493367,226695427,4961309077.603000,3029988381.793200,4186561569.627001,12177859029.023201,1081426,241749,653093,1976268
2018-10-26,NYSE National (C),73262133,37358398,35477275,146097806,2292581382.573000,1377627496.371400,1711157385.864600,5381366264.809000,657020,183602,372428,1213050
2018-10-26,FINRA / NYSE TRF (DN),250808529,111484193,273886341,636179063,7618772563.142301,5367229031.327800,15393489312.528696,28379490906.998797,507247,227936,651840,1387023
2018-10-26,FINRA / Nasdaq TRF Carteret (DQ),1259499665,509495461,842738024,2611733150,48131878369.089902,33139261792.843116,48870944361.437118,130142084523.370136,4796152,1271090,3129129,9196371
2018-10-26,EDGA Equities (J),54419170,47719920,33893143,136032233,2087030024.374300,3379860959.544600,2267841781.447700,7734732765.366600,492408,228314,299410,1020132
2018-10-26,EDGX Equities (K),192846359,167304791,179865573,540016723,7994279484.305700,11855160338.726806,11138438544.718801,30987878367.751307,1528052,789117,1277614,3594783
2018-10-26,CHX (M),15618179,29397274,13548212,58563665,622615073.074900,3557913108.135000,1253886428.339801,5434414609.549701,9018,23263,15390,47671
2018-10-26,NYSE (N),1127522925,65500350,55192080,1248215355,47232485926.630498,4674017813.337398,4014929637.021498,55921433376.989394,4641447,259379,377555,5278381
2018-10-26,NYSE Arca (P),286848452,556769977,245314427,1088932856,11681417623.514501,34007236338.004394,17142153520.290400,62830807481.809295,2160130,1725079,1979273,5864482
2018-10-26,NASDAQ (Q),648708916,393915877,799668704,1842293497,29850342361.369403,26846626327.647004,57756678572.270937,114453647261.287344,5754845,1732428,5634511,13121784
2018-10-26,IEX (V),155263926,36725639,87412040,279401605,6717758678.807200,2309908482.899100,5852141254.587299,14879808416.293599,1038351,146031,596325,1780707
2018-10-26,NASDAQ PSX (X),27203286,43692189,28426740,99322215,1177756539.142300,3557062993.772599,2820334021.731400,7555153554.646299,215101,200288,222427,637816
2018-10-26,BYX Equities (Y),246265088,134767943,101959391,482992422,7025513079.482700,6426381275.434999,4685548801.270099,18137443156.187798,1953202,688165,960307,3601674
2018-10-26,BZX Equities (Z),345265548,277413063,209067538,831746149,14720085351.005702,20322743821.628299,14012206305.260301,49055035477.894302,3140633,1464449,1914517,6519599
2018-10-25,NYSE American (A),7054052,16548074,3366368,26968494,308235920.512700,245273164.898700,199776655.106400,753285740.517800,65098,42589,31311,138998
2018-10-25,NASDAQ BX (B),111866808,40124411,61452129,213443348,5013661634.460399,2096425593.321000,3818347328.074098,10928434555.855497,1090090,190930,655718,1936738
2018-10-25,NYSE National (C),63442541,26168218,30963037,120573796,2080887838.680100,982640439.050300,1392750107.417500,4456278385.147900,589973,129510,327586,1047069
2018-10-25,FINRA / NYSE TRF (DN),254589886,109810992,257898968,622299846,8333703150.493396,4557415641.080103,13197567351.735588,26088686143.309087,556008,215306,619531,1390845
2018-10-25,FINRA / Nasdaq TRF Carteret (DQ),1330579404,471339049,821078835,2622997288,52182729008.921402,29675290961.125194,43172758127.982714,125030778098.029310,4928481,1072655,2927186,8928322
2018-10-25,EDGA Equities (J),51376302,32712527,29706375,113795204,1934363770.393200,2199393866.960199,1660538200.342800,5794295837.696199,452718,164298,258583,875599
2018-10-25,EDGX Equities (K),185151272,114396766,171689512,471237550,7617184357.489999,7556629378.785501,9583973552.341291,24757787288.616791,1436790,533726,1148151,3118667
2018-10-25,CHX (M),15170608,23617255,13438845,52226708,670624782.036600,2316269166.129999,1481189963.575100,4468083911.741699,8167,12027,11663,31857
2018-10-25,NYSE (N),1074372363,40823084,40889651,1156085098,41879162445.204500,2745843353.544900,2612136744.596200,47237142543.345600,3947689,163389,292271,4403349
2018-10-25,NYSE Arca (P),274024877,395004332,227281304,896310513,11277917105.625999,24038271140.932696,14635954825.595701,49952143072.154396,2036707,1200602,1722577,4959886
2018-10-25,NASDAQ (Q),582623419,266919478,757493281,1607036178,27234850240.388301,18455607023.563703,48814554408.550908,94505011672.502912,5072898,1228591,4909407,11210896
2018-10-25,IEX (V),151710448,25805776,80603479,258119703,6617574624.254100,1550361083.013300,4951701995.282098,13119637702.549498,1045030,117473,572662,1735165
2018-10-25,NASDAQ PSX (X),22932738,27644424,19816000,70393162,910738305.246800,2163789739.020300,1655411851.525799,4729939895.792899,183472,126864,159714,470050
2018-10-25,BYX Equities (Y),231252358,102713015,90935937,424901310,6677108769.185899,4865402621.338601,4029617550.582099,15572128941.106599,1853484,535684,868444,3257612
2018-10-25,BZX Equities (Z),307784269,177062446,181484102,666330817,12873229136.041798,13017040270.391097,11140985764.881000,37031255171.313895,2749199,945101,1645716,5340016
2018-10-24,NYSE American (A),7148280,14874150,3418522,25440952,339447863.675000,239281527.723400,213854164.195500,792583555.593900,69681,47649,34418,151748
2018-10-24,NASDAQ BX (B),113653254,43745563,64830895,222229712,5345419218.585000,2479603726.594700,3731524382.683700,11556547327.863400,1123460,197960,685589,2007009
2018-10-24,NYSE National (C),61257164,31913201,31783127,124953492,2082190396.028500,1176743424.315200,1477769336.063000,4736703156.406700,569817,153151,336413,1059381
2018-10-24,FINRA / NYSE TRF (DN),250294861,115667672,289490710,655453243,8615117267.236301,5236498149.795102,13915092555.900595,27766707972.931998,533547,244022,664737,1442306
2018-10-24,FINRA / Nasdaq TRF Carteret (DQ),1352944633,466108219,848495620,2667548472,53548838498.926068,32040460903.201896,43420622201.716097,129009921603.844061,4853955,1085048,2995795,8934798
2018-10-24,EDGA Equities (J),54669439,38159965,34231156,127060560,2186395036.947800,2757829924.146799,1954044944.867400,6898269905.961999,484534,181244,294910,960688
2018-10-24,EDGX Equities (K),185220209,130328481,186866280,502414970,8019279774.086296,9333123894.560800,9792194946.747796,27144598615.394892,1487492,616639,1234517,3338648
2018-10-24,CHX (M),12943443,20045342,10901029,43889814,652031928.377900,2329601841.805000,1216035672.106700,4197669442.289600,5120,13679,9295,28094
2018-10-24,NYSE (N),1081875789,48448173,42246398,1172570360,45523908118.914896,3404146739.929700,2565366459.543700,51493421318.388296,4464573,186591,289905,4941069
2018-10-24,NYSE Arca (P),278257367,444538030,246585448,969380845,12104471035.438502,27760937648.329303,14650989444.866804,54516398128.634609,2158594,1391078,1848250,5397922
2018-10-24,NASDAQ (Q),595077788,301138667,798393525,1694609980,28938250200.553802,22361201783.811204,48739004973.835588,100038456958.200594,5375073,1386285,5377230,12138588
2018-10-24,IEX (V),160181195,27470048,78196170,265847413,7405122024.244602,1818780073.284300,4876959799.853700,14100861897.382602,1112063,120803,586418,1819284
2018-10-24,NASDAQ PSX (X),23842099,31284814,21949167,77076080,1031987703.803000,2644562347.540601,1912557228.835900,5589107280.179501,195342,144790,184987,525119
2018-10-24,BYX Equities (Y),236464754,115968247,101243720,453676721,7192142283.512600,5725981511.541098,4321788093.386000,17239911888.439698,1979604,588800,957067,3525471
2018-10-24,BZX Equities (Z),324846576,205559584,200937603,731343763,14313107445.807595,15758262090.279501,12964101931.763500,43035471467.850596,2950834,1060866,1835887,5847587
2018-10-23,NYSE American (A),6734795,14539895,3182286,24456976,318323405.611000,260876038.340400,186782949.707700,765982393.659100,64968,47879,30720,143567
2018-10-23,NASDAQ BX (B),110305582,42661534,58319971,211287087,5353776945.964000,2310266295.818800,3384842890.096699,11048886131.879499,1119008,196450,634920,1950378
2018-10-23,NYSE National (C),63267929,27082685,31200442,121551056,2199559271.029700,1009787112.133500,1395187583.529700,4604533966.692900,598181,143300,335519,1077000
2018-10-23,FINRA / NYSE TRF (DN),242712682,119552870,279998670,642264222,8379549099.114798,5016456790.627999,12375915970.600195,25771921860.342992,512628,249130,600666,1362424
2018-10-23,FINRA / Nasdaq TRF Carteret (DQ),1211224883,520139460,783547610,2514911953,48702071507.118206,30211569903.561096,37169490871.429011,116083132282.108313,4706937,1261157,2752610,8720704
2018-10-23,EDGA Equities (J),51342180,39743983,33076218,124162381,2027151749.102600,2764280803.223400,1615548876.156900,6406981428.482900,463335,192010,263338,918683
2018-10-23,EDGX Equities (K),171956490,127582267,189027124,488565881,7533875509.885799,8424050885.516801,8449351285.623001,24407277681.025601,1387347,602633,1074029,3064009
2018-10-23,CHX (M),12891707,21761286,7880255,42533248,679901520.974000,2563649515.860001,727495517.330800,3971046554.164801,6792,16460,9065,32317
2018-10-23,NYSE (N),973791922,47133317,46319703,1067244942,40156978237.912595,3122446078.094299,2556738023.777800,45836162339.784694,3987028,180115,280709,4447852
2018-10-23,NYSE Arca (P),263933866,417988846,223072962,904995674,11363339038.275601,25512295799.402091,12110593350.172495,48986228187.850187,2005168,1332720,1629913,4967801
2018-10-23,NASDAQ (Q),574915266,303993149,731319486,1610227901,27637125500.898203,21635552488.556206,41861686909.733297,91134364899.187706,5407168,1433043,5058370,11898581
2018-10-23,IEX (V),144861556,27173968,72849596,244885120,6793671132.412401,1679475409.645200,4387425991.184500,12860572533.242101,999771,118944,536872,1655587
2018-10-23,NASDAQ PSX (X),23158874,32002539,20836063,75997476,955329726.250400,2429334531.374700,1823834137.362800,5208498394.987900,186904,153570,180618,521092
2018-10-23,BYX Equities (Y),220199225,112304078,89680580,422183883,6775735123.697400,5196055159.284001,3845632960.132200,15817423243.113601,1861668,581294,885379,3328341
2018-10-23,BZX Equities (Z),302417059,196507849,181703321,680628229,13035315846.586102,14063200396.644595,10923332470.180501,38021848713.411198,2738987,1034406,1617828,5391221
2018-10-22,NYSE American (A),4627753,12063939,2538253,19229945,227679423.649100,162150106.847800,143170807.243200,533000337.740100,47735,38678,24555,110968
2018-10-22,NASDAQ BX (B),88635749,28813003,50653049,168101801,4196356013.723900,1531661257.100000,2674089676.185100,8402106947.009000,907800,143199,528772,1579771
2018-10-22,NYSE National (C),45396855,17581818,22917077,85895750,1427430848.452400,658600088.570600,927516047.872700,3013546984.895700,418950,91775,237189,747914
2018-10-22,FINRA / NYSE TRF (DN),186359586,82802177,268069583,537231346,6344098799.992098,3320941155.725999,10567314031.019307,20232353986.737404,409004,177602,575577,1162183
2018-10-22,FINRA / Nasdaq TRF Carteret (DQ),974327872,336038390,700165120,2010531382,40836173748.771106,19329796512.572791,31262609491.308185,91428579752.652082,3673056,851292,2389654,6914002
2018-10-22,EDGA Equities (J),40530408,22542804,22980449,86053661,1602783407.271700,1579340913.900100,1196079164.729700,4378203485.901500,365895,116749,201021,683665
2018-10-22,EDGX Equities (K),125821040,78510192,144200277,348531509,5585645355.693300,4959280854.162304,6163191906.499099,16708118116.354703,1038891,375324,864264,2278479
2018-10-22,CHX (M),10133885,15183174,7874892,33191951,463665898.126200,1679762717.179900,589109391.637000,2732538006.943100,5359,8103,5390,18852
2018-10-22,NYSE (N),749754261,27032949,28919022,805706232,32636053595.197199,2187506321.295500,1599214523.905300,36422774440.397999,2879707,112424,215494,3207625
2018-10-22,NYSE Arca (P),188106405,269386498,174683079,632175982,8196511080.744499,15684225255.288699,8332584774.204603,32213321110.237801,1458068,843292,1232995,3534355
2018-10-22,NASDAQ (Q),408686716,182152747,591907755,1182747218,20472465584.879405,12727014400.056907,33106375922.266314,66305855907.202626,3618972,870717,3789221,8278910
2018-10-22,IEX (V),105643015,16322274,60078882,182044171,4930418464.001000,997429053.625500,3253614161.676400,9181461679.302900,746448,76892,424457,1247797
2018-10-22,NASDAQ PSX (X),16599821,19558173,15281684,51439678,699097202.810100,1785908605.860000,1312323767.951400,3797329576.621500,143385,92257,127994,363636
2018-10-22,BYX Equities (Y),172523307,75448371,75512933,323484611,5445734893.424502,3472442035.964000,2993827500.037101,11912004429.425603,1472864,396930,717950,2587744
2018-10-22,BZX Equities (Z),214125414,113922598,135231487,463279499,9407871183.457699,7847659536.697999,7500940492.733400,24756471212.889098,1992153,608611,1232234,3832998
2018-10-19,NYSE American (A),5274085,14653420,2528160,22455665,245220691.879500,176715562.232400,149808339.429700,571744593.541600,53905,40046,25813,119764
2018-10-19,NASDAQ BX (B),91382373,31325703,55332098,178040174,4444883142.149900,1755003455.454100,3092934126.990501,9292820724.594501,936822,154216,563346,1654384
2018-10-19,NYSE National (C),42140388,19829094,22814181,84783663,1419666279.526600,766764132.397900,1000107002.881400,3186537414.805900,397309,108289,242932,748530
2018-10-19,FINRA / NYSE TRF (DN),186179299,92830801,269450012,548460112,6221872057.829998,3540209474.134101,10935272964.444400,20697354496.408499,391644,179684,579610,1150938
2018-10-19,FINRA / Nasdaq TRF Carteret (DQ),983886244,415024978,741553900,2140465122,41130157034.421708,30361404834.352989,36560179568.214278,108051741436.988975,3653803,824927,2486181,6964911
2018-10-19,EDGA Equities (J),42238106,28953669,26510808,97702583,1816931996.851300,2207729644.974599,1436939450.560400,5461601092.386299,395176,147579,230967,773722
2018-10-19,EDGX Equities (K),137321058,96571122,157866882,391759062,5939321413.710999,6238178508.894302,7791394948.480701,19968894871.086002,1090862,428899,972873,2492634
2018-10-19,CHX (M),15944467,31231049,20246883,67422399,1002303030.304700,3013709462.990000,2089724108.040900,6105736601.335600,5418,10034,7530,22982
2018-10-19,NYSE (N),938579402,33300722,38342194,1010222318,42204723112.528698,2533056142.274301,2287678330.188300,47025457584.991299,2953412,125139,274429,3352980
2018-10-19,NYSE Arca (P),198494941,319311910,192281590,710088441,8664087912.960402,19716257593.266096,10215618736.559297,38595964242.785795,1515516,973318,1416171,3905005
2018-10-19,NASDAQ (Q),424233814,211326645,693056317,1328616776,20820215671.502497,15327270272.410304,40374887254.610093,76522373198.522894,3829097,956902,4183982,8969981
2018-10-19,IEX (V),100181219,20653333,60919836,181754388,4829716922.708600,1230049778.828800,3414812764.483400,9474579466.020800,735847,86715,444794,1267356
2018-10-19,NASDAQ PSX (X),17838473,23720853,18267729,59827055,798277444.762500,2087989251.740900,1531949030.120500,4418215726.623900,150043,103611,149349,403003
2018-10-19,BYX Equities (Y),175231353,86078216,82689747,343999316,5624131989.914600,4123696404.185501,3522139101.286900,13269967495.387001,1504668,446165,777445,2728278
2018-10-19,BZX Equities (Z),235020490,140752572,165939525,541712587,10530442954.131001,10240639325.276001,10482293590.403101,31253375869.810103,2165037,719231,1474133,4358401
2018-10-18,NYSE American (A),4473113,15040499,2399905,21913517,221993077.984000,178483238.561200,160379194.609900,560855511.155100,48173,43586,24971,116730
2018-10-18,NASDAQ BX (B),97874434,36039776,54559304,188473514,4682544191.080900,2026050647.602200,3115951121.915600,9824545960.598700,976408,176840,551207,1704455
2018-10-18,NYSE National (C),44617677,23681078,23416800,91715555,1506221357.234300,888878766.763800,1028014059.286500,3423114183.284600,420072,123099,233807,776978
2018-10-18,FINRA / NYSE TRF (DN),197399717,102481776,277015720,576897213,6867176890.437800,3955326272.345502,11001440203.670696,21823943366.453998,402087,195835,598859,1196781
2018-10-18,FINRA / Nasdaq TRF Carteret (DQ),1048852858,461386935,763147984,2273387777,42779960112.427609,28130434897.913790,35707927053.120488,106618322063.461887,3757632,960485,2472906,7191023
2018-10-18,EDGA Equities (J),48223254,31360953,29493255,109077462,1888468075.294500,1957569055.016199,1613529807.795500,5459566938.106199,429137,150671,254976,834784
2018-10-18,EDGX Equities (K),141531371,119680261,172756590,433968222,6137177468.092704,7686694209.164801,7768639781.309001,21592511458.566506,1132416,525791,995461,2653668
2018-10-18,CHX (M),10372751,19679419,13901611,43953781,638463855.953600,2224189574.647501,1437411883.484000,4300065314.085101,7430,10011,7800,25241
2018-10-18,NYSE (N),827779265,35863954,36801603,900444822,35377700965.935398,2575218702.179399,2266423409.784400,40219343077.899197,3139951,134064,245952,3519967
2018-10-18,NYSE Arca (P),203228338,363902140,212812503,779942981,8735131972.646801,21800576529.286598,10502027254.269603,41037735756.203002,1535865,1109414,1429228,4074507
2018-10-18,NASDAQ (Q),450725051,246590747,653472906,1350788704,22411322430.488298,17821972591.384403,38793333924.192889,79026628946.065590,4062655,1118267,4213500,9394422
2018-10-18,IEX (V),115327231,22087981,62340784,199755996,5401034152.677000,1386076132.043000,3591728602.655000,10378838887.375000,806317,105578,441057,1352952
2018-10-18,NASDAQ PSX (X),17746934,28101699,17628275,63476908,766326050.050000,2577214379.950801,1505242361.853600,4848782791.854401,144699,131896,145329,421924
2018-10-18,BYX Equities (Y),188486141,92006427,86457005,366949573,5876199861.889300,4283963858.265501,3639952504.115399,13800116224.270200,1573926,470152,797388,2841466
2018-10-18,BZX Equities (Z),242666383,176909510,161785050,581360943,10664285751.412900,13601167039.553298,10268390503.548302,34533843294.514500,2210444,949820,1416964,4577228
2018-10-17,NYSE American (A),4708078,11735486,2325387,18768951,221846728.320200,162716245.925000,161051311.500000,545614285.745200,47891,35655,23397,106943
2018-10-17,NASDAQ BX (B),85984582,32219797,50074722,168279101,4056743994.077400,1809969053.222100,2878942686.799300,8745655734.098800,893898,157908,532331,1584137
2018-10-17,NYSE National (C),39339331,21591396,19166139,80096866,1273166925.655900,807139974.950100,893549310.561500,2973856211.167500,354498,98828,196191,649517
2018-10-17,FINRA / NYSE TRF (DN),171695591,88832968,284099355,544627914,6075630475.820498,3555600896.228800,11637687947.835002,21268919319.884300,386280,191057,568404,1145741
2018-10-17,FINRA / Nasdaq TRF Carteret (DQ),953611082,372803799,717505439,2043920320,38967149371.885004,24223086432.829088,33281458539.097501,96471694343.811593,3463621,810977,2269744,6544342
2018-10-17,EDGA Equities (J),40942839,30061043,25030195,96034077,1637798037.963500,1962150037.075700,1305493974.478900,4905442049.518100,370376,138351,206452,715179
2018-10-17,EDGX Equities (K),131934336,92095852,168075545,392105733,5765790913.262898,5933961368.099998,7320592273.521197,19020344554.884093,1084704,423096,898556,2406356
2018-10-17,CHX (M),11888757,17756566,8156143,37801466,551290343.583500,2135542281.440000,848966253.460100,3535798878.483600,5110,5865,6374,17349
2018-10-17,NYSE (N),793843743,33230492,31839301,858913536,34971357494.467903,2854949695.637700,2033546932.215399,39859854122.321002,2817003,121230,220513,3158746
2018-10-17,NYSE Arca (P),188484110,313626792,184186758,686297660,7988080334.649699,18990549641.451493,9550932633.004099,36529562609.105291,1443437,949489,1281960,3674886
2018-10-17,NASDAQ (Q),406467387,200171876,606274920,1212914183,20185092688.050495,14242748929.043805,35893090177.006097,70320931794.100397,3710995,911475,3836815,8459285
2018-10-17,IEX (V),99208422,18023792,53055549,170287763,4642486137.497099,1208091048.536100,3109594028.328900,8960171214.362099,712826,81440,390581,1184847
2018-10-17,NASDAQ PSX (X),16525799,21745150,14458601,52729550,710746170.512500,2100683328.497800,1327255127.516500,4138684626.526800,137853,98608,125657,362118
2018-10-17,BYX Equities (Y),175738256,80832481,76665149,333235886,5507372010.633201,3755588352.207299,3326341416.597000,12589301779.437500,1495967,413987,738304,2648258
2018-10-17,BZX Equities (Z),226722271,139356326,144164834,510243431,9914750963.066499,10210365956.572999,8646895390.446302,28772012310.085800,2085686,730979,1278911,4095576
2018-10-16,NYSE American (A),5236345,13740975,2259407,21236727,246335127.547600,173600735.926200,167162750.665900,587098614.139700,51562,39870,22871,114303
2018-10-16,NASDAQ BX (B),98051286,32320785,54297514,184669585,4695859804.884200,1879139065.272600,3195555174.049900,9770554044.206700,996319,155265,562999,1714583
2018-10-16,NYSE National (C),41806139,22409104,19398231,83613474,1319142151.381100,850428657.607400,900010405.669600,3069581214.658100,360039,89847,197859,647745
2018-10-16,FINRA / NYSE TRF (DN),208706000,91654244,326263923,626624167,7590944874.476500,3555380726.647200,11332819275.237092,22479144876.360792,475145,202652,637414,1315211
2018-10-16,FINRA / Nasdaq TRF Carteret (DQ),1001387252,462108268,793325312,2256820832,42160178786.440311,32030251683.481995,35921161589.727291,110111592059.649597,3912978,921158,2491860,7325996
2018-10-16,EDGA Equities (J),43554005,25645697,27084808,96284510,1740546689.545300,1633827206.102900,1391463880.585700,4765837776.233900,387225,126668,218213,732106
2018-10-16,EDGX Equities (K),138770013,94586898,210375566,443732477,6244563243.107200,5797978305.662300,7635926974.573297,19678468523.342797,1107158,395981,936675,2439814
2018-10-16,CHX (M),11112212,13854797,10401791,35368800,839925116.970000,1763482905.352000,1666757537.131200,4270165559.453200,5157,7506,5843,18506
2018-10-16,NYSE (N),789134456,28188477,32070696,849393629,34471890995.921597,2347454690.660801,1945941421.052300,38765287107.634698,2825631,99252,235568,3160451
2018-10-16,NYSE Arca (P),186016653,294487558,200325351,680829562,8227596620.333199,18490559066.862097,10703377769.805007,37421533457.000303,1416152,863361,1327755,3607268
2018-10-16,NASDAQ (Q),396458269,187290101,660329131,1244077501,20083706684.503392,13474420157.524714,37238924862.002026,70797051704.030132,3535578,811155,3847655,8194388
2018-10-16,IEX (V),110954034,18372713,55540586,184867333,5161851224.560500,1251203463.232100,3308719679.905499,9721774367.698099,765246,84141,408421,1257808
2018-10-16,NASDAQ PSX (X),16506396,20109201,15183746,51799343,714302464.413600,1899878146.930599,1432004479.259200,4046185090.603399,137789,90040,125870,353699
2018-10-16,BYX Equities (Y),188721799,80382071,84604359,353708229,6116435883.194800,3938517453.592699,3542041371.458899,13596994708.246398,1598496,411835,791467,2801798
2018-10-16,BZX Equities (Z),223851895,129848458,148307306,502007659,9811771838.259500,9788880948.147396,8543318534.991100,28143971321.397996,2035788,650348,1286268,3972404
2018-10-15,NYSE American (A),4776972,14495490,2367940,21640402,226641988.859700,174609619.911900,143246792.692800,544498401.464400,47943,42679,23993,114615
2018-10-15,NASDAQ BX (B),89090190,32320960,48261057,169672207,4136378544.465000,1748305965.959200,2777538214.269600,8662222724.693800,921682,162301,516861,1600844
2018-10-15,NYSE National (C),39541207,18855248,19207324,77603779,1259207459.540000,723830658.844800,848778041.187000,2831816159.571800,362274,88035,189215,639524
2018-10-15,FINRA / NYSE TRF (DN),182530366,100341464,241036077,523907907,5960503897.191002,3776159748.342297,10129300401.634794,19865964047.168093,400709,204002,544399,1149110
2018-10-15,FINRA / Nasdaq TRF Carteret (DQ),925182270,374564727,639922927,1939669924,37681428498.240094,23379926185.874595,30608238067.999612,91669592752.114301,3423682,898340,2213638,6535660
2018-10-15,EDGA Equities (J),40141010,27389600,22583445,90114055,1557342115.473000,1720716269.977099,1199054783.041300,4477113168.491399,359391,134333,198412,692136
2018-10-15,EDGX Equities (K),129421806,98914260,143596328,371932394,5361053793.396599,6107714632.873400,6220554820.646897,17689323246.916896,1058100,431129,861881,2351110
2018-10-15,CHX (M),9275528,14169846,11136055,34581429,438413569.154000,1631553372.940000,1828766714.427300,3898733656.521300,5374,8399,6844,20617
2018-10-15,NYSE (N),824078217,27426609,29266911,880771737,34405588867.873197,1800270788.466500,1693666083.690000,37899525740.029697,2789720,112175,218267,3120162
2018-10-15,NYSE Arca (P),183746298,320754227,168707352,673207877,7564838246.254399,18745601672.312791,9149310750.798195,35459750669.365385,1402106,944310,1261265,3607681
2018-10-15,NASDAQ (Q),395416974,206210786,569664781,1171292541,18581750382.647803,14233032196.510296,33121934739.537205,65936717318.695304,3531356,944770,3578809,8054935
2018-10-15,IEX (V),92188593,21081357,46790472,160060422,4238069840.048100,1317875438.570100,2851277633.409401,8407222912.027601,663400,91648,363792,1118840
2018-10-15,NASDAQ PSX (X),17185128,20086924,13955084,51227136,694346337.059500,1467204384.592600,1200982848.572000,3362533570.224100,139237,93344,116922,349503
2018-10-15,BYX Equities (Y),175685386,83146182,75057934,333889502,5356711068.240700,3822108756.143800,3022730336.487900,12201550160.872400,1473557,420659,713507,2607723
2018-10-15,BZX Equities (Z),218905960,149486095,135448759,503840814,9110288895.832203,10577992186.527296,8175414415.058502,27863695497.418001,1995818,764116,1230488,3990422
2018-10-12,NYSE American (A),6001770,18503246,2866673,27371689,293853543.046100,236229302.179500,194404062.596400,724486907.822000,62034,51004,29118,142156
2018-10-12,NASDAQ BX (B),113200777,44495082,64322153,222018012,5130515733.261200,2426088770.610199,3722588115.877302,11279192619.748701,1131368,218016,671716,2021100
2018-10-12,NYSE National (C),47770368,25226962,23318669,96315999,1664514797.112500,982340111.357500,1180632257.828400,3827487166.298400,426584,127093,231160,784837
2018-10-12,FINRA / NYSE TRF (DN),217957173,136411171,260246430,614614774,7396737507.371400,5519845201.762700,12331635300.115904,25248218009.250004,478166,256433,589350,1323949
2018-10-12,FINRA / Nasdaq TRF Carteret (DQ),1070279824,532705995,750860367,2353846186,43525700071.124109,38031697480.358605,39568950471.361713,121126348022.844427,4178749,1253698,2670401,8102848
2018-10-12,EDGA Equities (J),51336027,44690927,29673710,125700664,2012052741.734400,2964370860.404900,1827665902.896400,6804089505.035700,448984,210636,262570,922190
2018-10-12,EDGX Equities (K),165480233,149679894,166159874,481320001,7232537288.753100,10059225819.585598,9479268078.311498,26771031186.650196,1362941,694207,1158865,3216013
2018-10-12,CHX (M),8651557,25892871,11155226,45699654,420221160.470900,2590981977.857501,1138835848.971000,4150038987.299401,7460,13997,11666,33123
2018-10-12,NYSE (N),961135757,49265895,43005914,1053407566,42378107940.982699,3562940732.233100,2998190702.581699,48939239375.797498,3661127,202366,300580,4164073
2018-10-12,NYSE Arca (P),234089390,495970630,208740425,938800445,10495650435.662795,30781543728.868492,12905606499.600207,54182800664.131494,1860392,1544474,1641352,5046218
2018-10-12,NASDAQ (Q),514519281,352823192,742510506,1609852979,25244773537.021699,26367620650.786110,48053539791.143623,99665933978.951432,4760193,1583546,4975897,11319636
2018-10-12,IEX (V),120554139,32118513,68565529,221238181,5609981623.071700,2189737788.029500,4381439933.134500,12181159344.235700,870731,141951,503897,1516579
2018-10-12,NASDAQ PSX (X),23165123,38176589,22015094,83356806,1034581170.963300,3051935519.390202,1998146468.226400,6084663158.579902,194727,176177,184015,554919
2018-10-12,BYX Equities (Y),211301055,121519573,95930727,428751355,6601389881.804299,5994922794.251300,4231632428.180000,16827945104.235599,1799096,635455,908986,3343537
2018-10-12,BZX Equities (Z),278576541,246167426,184847575,709591542,12232395804.028000,18585881352.740904,12790231841.192596,43608508997.961500,2608510,1294217,1714182,5616909
2018-10-11,NYSE American (A),7894805,18980837,3684362,30560004,405082735.251200,312483968.980000,242539325.068000,960106029.299200,79920,61552,38090,179562
2018-10-11,NASDAQ BX (B),133163290,70722403,75606729,279492422,6270452947.437600,4528587422.097599,4854257543.721600,15653297913.256799,1303172,377881,778495,2459548
2018-10-11,NYSE National (C),55814859,37954486,26069136,119838481,1871060757.886600,1546183794.376600,1437556689.850000,4854801242.113200,491565,195422,265543,952530
2018-10-11,FINRA / NYSE TRF (DN),250369863,158532310,288053713,696955886,8354601337.725300,6499369557.133795,15696413632.079997,30550384526.939092,581028,318953,685643,1585624
2018-10-11,FINRA / Nasdaq TRF Carteret (DQ),1223549398,740490612,842415650,2806455660,51192547868.031622,51913697635.094406,47853895912.330679,150960141415.456707,4963140,1754609,3145431,9863180
2018-10-11,EDGA Equities (J),61523426,62886151,38846846,163256423,2599830594.662700,4562849051.036901,2457716507.716100,9620396153.415701,561298,303289,341057,1205644
2018-10-11,EDGX Equities (K),210534904,245063907,204733534,660332345,9252593031.453899,17509091458.881010,12218238191.689099,38979922682.024008,1714848,1145082,1443345,4303275
2018-10-11,CHX (M),16575889,32840243,10706576,60122708,1004843156.244500,3618246150.295000,1306374893.979800,5929464200.519300,13123,18256,15354,46733
2018-10-11,NYSE (N),1168266190,78368258,54340775,1300975223,50744609355.550303,6103665914.044200,3803869445.046698,60652144714.641201,4624302,306324,380853,5311479
2018-10-11,NYSE Arca (P),314504747,807006271,276294806,1397805824,13822253404.283201,49826883102.225801,17659830837.344289,81308967343.853291,2420723,2438131,2132986,6991840
2018-10-11,NASDAQ (Q),675736774,553991554,883361533,2113089861,33196578023.005999,41134059995.386908,59883771955.477709,134214409973.870616,6044579,2405966,6280858,14731403
2018-10-11,IEX (V),155993911,45533125,80252546,281779582,7768987946.062398,3200793467.357000,5837309795.781800,16807091209.201198,1118235,215385,611048,1944668
2018-10-11,NASDAQ PSX (X),30265027,67371299,30857452,128493778,1453591241.510200,6044517154.267500,3051323368.293300,10549431764.071000,241946,309189,255197,806332
2018-10-11,BYX Equities (Y),260332205,176895191,113293767,550521163,8289375400.852099,8871087469.519703,5330606216.476698,22491069086.848500,2222458,919039,1071695,4213192
2018-10-11,BZX Equities (Z),349568947,370610147,226009654,946188748,15280679429.021701,26731454171.404402,14583522851.377897,56595656451.804000,3271876,1945499,2091303,7308678
2018-10-10,NYSE American (A),7372674,19023142,3479144,29874960,335398109.083600,291176287.514000,223467575.659400,850041972.257000,69462,56125,35674,161261
2018-10-10,NASDAQ BX (B),120271481,53430609,69704649,243406739,5962800581.588200,3371992614.368800,4165859208.732799,13500652404.689799,1205426,265494,732856,2203776
2018-10-10,NYSE National (C),49779636,28092407,24878436,102750479,1670567459.258800,1234317498.138700,1241314993.744300,4146199951.141800,428359,141599,247242,817200
2018-10-10,FINRA / NYSE TRF (DN),255922015,127454328,300705955,684082298,8992997920.470402,5327600046.375897,15599378172.478200,29919976139.324499,591242,274417,733291,1598950
2018-10-10,FINRA / Nasdaq TRF Carteret (DQ),1249534742,567361994,903259650,2720156386,53210057052.079585,41865374326.486895,49535111012.493501,144610542391.059981,4542664,1365797,3069872,8978333
2018-10-10,EDGA Equities (J),58382149,48247289,36424825,143054263,2449069711.477000,3436477668.618200,2102312996.032900,7987860376.128100,514938,215642,304960,1035540
2018-10-10,EDGX Equities (K),191488832,153292526,202979423,547760781,8203188235.305296,10864592903.910101,10932136759.819198,29999917899.034595,1486546,682226,1311468,3480240
2018-10-10,CHX (M),12070937,19713946,8857096,40641979,703803893.764400,2649716456.150000,703671568.337800,4057191918.252200,6879,10441,7307,24627
2018-10-10,NYSE (N),1067838927,54814064,49968729,1172621720,47606866927.290008,5453225036.980097,3242871735.742900,56302963700.013005,3899359,185001,349242,4433602
2018-10-10,NYSE Arca (P),276790298,501866970,247456220,1026113488,11972175105.095698,32451222801.945305,14564668821.011101,58988066728.052104,2040443,1515602,1859915,5415960
2018-10-10,NASDAQ (Q),563981377,334739587,851682148,1750403112,28110260267.683411,26717306737.167095,56334535059.499030,111162102064.349536,5001540,1422536,5451563,11875639
2018-10-10,IEX (V),136653422,29093698,75331867,241078987,6675174834.558202,1963944155.876700,5031675692.276598,13670794682.711500,939259,129723,550098,1619080
2018-10-10,NASDAQ PSX (X),24792500,41253500,24271272,90317272,1051117787.974800,4524186615.980802,2198504756.687300,7773809160.642902,193316,175714,190599,559629
2018-10-10,BYX Equities (Y),234115326,126230822,105975166,466321314,7741512134.464700,6722689287.774996,4881168428.336601,19345369850.576297,1992286,648628,1010420,3651334
2018-10-10,BZX Equities (Z),305273402,228742987,206707830,740724219,13723625070.582502,17904378295.808296,13500299156.184000,45128302522.574798,2816377,1140009,1870609,5826995
2018-10-09,NYSE American (A),5761565,13918783,2488634,22168982,236661149.642300,163707050.018300,154637090.245900,555005289.906500,51290,40154,25640,117084
2018-10-09,NASDAQ BX (B),98086697,30197783,55133621,183418101,4639336106.896700,1696378432.947000,2896428628.699799,9232143168.543499,1016862,153191,575432,1745485
2018-10-09,NYSE National (C),39912465,16586990,17655183,74154638,1281924093.713500,600795763.706000,745949391.011300,2628669248.430800,369071,76497,180005,625573
2018-10-09,FINRA / NYSE TRF (DN),208156119,86536033,287920482,582612634,6906652210.116298,2995454574.613299,10475545013.028200,20377651797.757797,442695,183542,566374,1192611
2018-10-09,FINRA / Nasdaq TRF Carteret (DQ),1007250908,420338995,751008767,2178598670,41267053078.969599,24891226941.578696,32336671850.909006,98494951871.457301,3797550,811439,2432473,7041462
2018-10-09,EDGA Equities (J),42991967,25615546,26885363,95492876,1663917632.711400,1555369661.126100,1336546332.903600,4555833626.741100,382758,118734,217187,718679
2018-10-09,EDGX Equities (K),146433316,81687004,162722096,390842416,5890111876.120101,4692624699.833101,6476921819.781003,17059658395.734205,1141226,352023,926980,2420229
2018-10-09,CHX (M),9844917,15556492,11626204,37027613,705461928.220300,1646247857.424900,647587192.340000,2999296977.985200,4353,5527,4886,14766
2018-10-09,NYSE (N),805672929,28619091,34522464,868814484,34111420126.828098,2538908108.299899,1865070206.894900,38515398442.022897,2735306,100028,248369,3083703
2018-10-09,NYSE Arca (P),204836903,279441731,197642362,681920996,8481578240.989097,16003691798.995896,9157931020.788906,33643201060.773899,1502856,810727,1332642,3646225
2018-10-09,NASDAQ (Q),422059339,177336630,616686561,1216082530,20093638520.143496,12148492672.937999,33727152358.630003,65969283551.711498,3663192,765067,3811767,8240026
2018-10-09,IEX (V),112220212,18397623,60847392,191465227,5149134690.253400,1142102168.321100,3359412174.736601,9650649033.311101,775072,88399,437304,1300775
2018-10-09,NASDAQ PSX (X),18127858,19654125,15486817,53268800,695924048.423700,1807917033.742300,1186818242.333300,3690659324.499300,150081,82256,132621,364958
2018-10-09,BYX Equities (Y),183097842,77695223,82179418,342972483,5900523429.632501,3739593622.092599,3258435989.136199,12898553040.861299,1570923,401446,761242,2733611
2018-10-09,BZX Equities (Z),227244761,115881858,143640732,486767351,9561082056.735005,8116654068.205801,7995607704.309399,25673343829.250205,2054992,583384,1260611,3898987
2018-10-08,NYSE American (A),4971148,16004976,2422210,23398334,206862797.704600,161649826.410600,167397912.805000,535910536.920200,45508,41060,25203,111771
2018-10-08,NASDAQ BX (B),90556249,30545254,50572233,171673736,4223265416.286100,1734479425.121300,3041627299.580100,8999372140.987500,928590,158966,561441,1648997
2018-10-08,NYSE National (C),35581157,17059190,16160448,68800795,1132045910.965300,643432212.590000,764519470.021400,2539997593.576700,318910,75256,166752,560918
2018-10-08,FINRA / NYSE TRF (DN),197792143,100288952,261062954,559144049,6817194944.056401,3333742276.114599,12576171163.139497,22727108383.310497,442434,238178,609108,1289720
2018-10-08,FINRA / Nasdaq TRF Carteret (DQ),971584043,374243463,657828805,2003656311,38923895402.846407,21739577429.415106,35108290800.896893,95771763633.158406,3491925,1013303,2335230,6840458
2018-10-08,EDGA Equities (J),37773338,28233127,24419213,90425678,1444927594.802800,1754411055.860100,1354045133.771800,4553383784.434700,326878,136668,204401,667947
2018-10-08,EDGX Equities (K),131680903,84179986,154655850,370516739,5209407594.010199,5090585482.715400,6723297425.499603,17023290502.225202,1006194,362308,873700,2242202
2018-10-08,CHX (M),12560797,12255679,9761215,34577691,697960104.218500,1535480763.630000,887916909.227700,3121357777.076200,5832,4809,6260,16901
2018-10-08,NYSE (N),796637585,28517865,30943091,856098541,33666935603.322103,2465074400.863501,1871137544.455600,38003147548.641204,2594139,100737,218505,2913381
2018-10-08,NYSE Arca (P),191542684,296705281,176787134,665035099,7506558724.137799,17265637093.876800,9749659344.997796,34521855163.012395,1341291,849828,1315640,3506759
2018-10-08,NASDAQ (Q),407138671,191011934,601856383,1200006988,19038106313.990193,13366388051.963502,37350827652.991078,69755322018.944773,3479032,825345,3920197,8224574
2018-10-08,IEX (V),102807555,20741398,50178944,173727897,4495564112.940799,1176911570.142100,3293982371.775199,8966458054.858098,675052,88562,383452,1147066
2018-10-08,NASDAQ PSX (X),16494386,20358454,14721008,51573848,670839733.600000,1753269346.402100,1357769572.852800,3781878652.854900,135664,88031,133780,357475
2018-10-08,BYX Equities (Y),173664189,75624164,73330126,322618479,5379108101.033800,3598728940.872800,3261943051.790799,12239780093.697399,1420324,389714,723817,2533855
2018-10-08,BZX Equities (Z),211041590,118531606,134607789,464180985,8778173902.893800,8875011531.389597,8774716180.425800,26427901614.709197,1861014,600944,1229768,3691726
2018-10-05,NYSE American (A),4886593,21297072,3000602,29184267,206660529.335800,205349803.299400,186881730.323700,598892062.958900,47515,45535,29037,122087
2018-10-05,NASDAQ BX (B),88486612,36111377,60908496,185506485,4185376154.379600,2125516688.633100,3578954492.736400,9889847335.749100,924266,187893,641080,1753239
2018-10-05,NYSE National (C),36757228,21366017,20554722,78677967,1241858940.709000,804881365.937700,963612686.462500,3010352993.109200,343039,91271,209694,644004
2018-10-05,FINRA / NYSE TRF (DN),183311152,118819921,336449229,638580302,6258619353.106100,4050779755.820102,13461562023.578296,23770961132.504498,420693,254239,704948,1379880
2018-10-05,FINRA / Nasdaq TRF Carteret (DQ),930756222,468615228,777870510,2177241960,36318561330.387091,27454021218.102613,37591705239.753284,101364287788.242988,3417575,1059648,2596970,7074193
2018-10-05,EDGA Equities (J),38373529,31316480,30407799,100097808,1516180809.418400,1991981901.468300,1697221079.651400,5205383790.538100,344979,149302,243796,738077
2018-10-05,EDGX Equities (K),130742867,95327726,195713345,421783938,5246664878.957099,5738012644.133002,7979071850.752300,18963749373.842401,1003445,418014,988800,2410259
2018-10-05,CHX (M),9431958,11500506,5257231,26189695,379976023.781400,1507295413.547200,388773410.140100,2276044847.468700,4206,7500,6323,18029
2018-10-05,NYSE (N),841783976,36684206,38035046,916503228,34644168766.760898,3238176604.944700,2257334617.030399,40139679988.735997,2685450,123977,252175,3061602
2018-10-05,NYSE Arca (P),183213794,345542509,212557685,741313988,7494830709.829002,21158263166.997002,11632104110.921206,40285197987.747210,1350288,1044716,1486122,3881126
2018-10-05,NASDAQ (Q),391597393,219802018,697278595,1308678006,18936176307.943802,15563088012.473596,41798411726.740199,76297676047.157597,3457359,961493,4222723,8641575
2018-10-05,IEX (V),102591548,20514798,60608756,183715102,4642397334.215400,1293102270.098300,3794734692.752097,9730234297.065797,692956,92093,453645,1238694
2018-10-05,NASDAQ PSX (X),17362894,22288470,18131184,57782548,706081010.799700,2240175783.979500,1795936584.892400,4742193379.671600,141399,104421,155791,401611
2018-10-05,BYX Equities (Y),171112015,84007099,87880464,342999578,5551718130.405599,4233839040.281801,3953308812.875700,13738865983.563100,1488310,453957,823771,2766038
2018-10-05,BZX Equities (Z),210420498,140320297,154718916,505459711,9070108430.181800,10460493181.118397,10192007118.347200,29722608729.647397,1906035,727381,1407726,4041142
2018-10-04,NYSE American (A),6070926,17601532,2953362,26625820,256313554.417200,222510641.054300,206842066.688800,685666262.160300,55256,49753,31008,136017
2018-10-04,NASDAQ BX (B),95718835,40419685,58668095,194806615,4579277550.889600,2370353423.401600,3482402186.727500,10432033161.018700,1032821,197791,648926,1879538
2018-10-04,NYSE National (C),39064009,22362599,18732590,80159198,1255858653.758800,831629644.995600,903042537.801700,2990530836.556100,361207,89441,196020,646668
2018-10-04,FINRA / NYSE TRF (DN),203631891,116824081,428697107,749153079,7277666279.126999,3901520849.249100,12550273422.556108,23729460550.932207,458603,268048,736882,1463533
2018-10-04,FINRA / Nasdaq TRF Carteret (DQ),1021566057,500257665,945215606,2467039328,41035350023.627195,31067667996.126814,39006252261.867900,111109270281.621909,3768724,1209159,2650047,7627930
2018-10-04,EDGA Equities (J),41639839,34786056,40965451,117391346,1656446394.296700,2170642208.001000,1735080710.349700,5562169312.647400,377440,159733,256320,793493
2018-10-04,EDGX Equities (K),144141945,102791264,326615627,573548836,5965703115.510500,6199972864.634999,8046187036.223896,20211863016.369395,1119524,428771,1043139,2591434
2018-10-04,CHX (M),17415855,19284811,7155532,43856198,798743094.848200,2079258745.260000,909034289.284100,3787036129.392300,4645,6474,5885,17004
2018-10-04,NYSE (N),796672930,41222152,37714024,875609106,34079277569.532999,3370113270.983000,1910309453.551000,39359700294.066999,2904457,123897,232154,3260508
2018-10-04,NYSE Arca (P),201977836,376158055,260386576,838522467,8610744616.637602,21685361574.447404,11022230525.343807,41318336716.428813,1508273,1032768,1502721,4043762
2018-10-04,NASDAQ (Q),410187030,221891881,829775090,1461854001,20332229933.933901,15635189232.593000,41000428702.655396,76967847869.182297,3721310,936635,4300926,8958871
2018-10-04,IEX (V),107240649,25719996,66981351,199941996,5246132190.479500,1565569059.328400,4239976569.363301,11051677819.171201,750343,108742,468575,1327660
2018-10-04,NASDAQ PSX (X),17696020,25350238,17131794,60178052,719762076.709300,2387150971.536900,1541159272.355500,4648072320.601700,152122,106225,149623,407970
2018-10-04,BYX Equities (Y),176544833,95208989,98489940,370243762,5694351222.590200,4610489368.186401,3888179839.704801,14193020430.481402,1555753,471384,841006,2868143
2018-10-04,BZX Equities (Z),230809252,149245094,163214818,543269164,9965554928.356199,10698057393.035501,10454624869.528202,31118237190.919902,2110918,720495,1442258,4273671
2018-10-03,NYSE American (A),5644070,22632275,2899367,31175712,243888982.779100,196998778.706500,152099964.273200,592987725.758800,54307,57599,27424,139330
2018-10-03,NASDAQ BX (B),100100607,35277187,54133286,189511080,4654508845.142300,1773766576.141700,2853795493.782300,9282070915.066300,1067344,163789,582248,1813381
2018-10-03,NYSE National (C),35052489,17037052,15770404,67859945,1145328096.217800,618761161.623400,709680984.120900,2473770241.962100,320537,64910,157812,543259
2018-10-03,FINRA / NYSE TRF (DN),197501376,119259269,439496450,756257095,6693008025.271100,2816568619.462099,11161363356.571299,20670940001.304498,429860,273790,733015,1436665
2018-10-03,FINRA / Nasdaq TRF Carteret (DQ),1094127480,421945338,956059312,2472132130,42052795364.318596,22170778388.141901,33802795535.966483,98026369288.426980,3603386,940675,2478108,7022169
2018-10-03,EDGA Equities (J),38913549,28228325,29075480,96217354,1496421789.488000,1587448967.026700,1319157680.100400,4403028436.615100,352043,126316,212649,691008
2018-10-03,EDGX Equities (K),137229247,97267112,280655501,515151860,5347154161.348001,4371889116.342899,6254138491.014700,15973181768.705600,1042265,348694,933158,2324117
2018-10-03,CHX (M),11474040,12900204,6747040,31121284,569895482.838900,1643087269.040000,652137919.325200,2865120671.204100,4037,4593,5175,13805
2018-10-03,NYSE (N),874122466,33809747,33646820,941579033,35961492608.257401,2431239220.826700,1548603062.257300,39941334891.341401,2739647,99744,221546,3060937
2018-10-03,NYSE Arca (P),197353100,324455993,235735188,757544281,7477086628.392298,16560438494.443402,8819972413.583304,32857497536.419004,1384134,767559,1335176,3486869
2018-10-03,NASDAQ (Q),407851829,188001096,740939610,1336792535,18837491092.791200,11022237228.674897,33749625975.280296,63609354296.746393,3476790,699852,3755500,7932142
2018-10-03,IEX (V),107989587,20626457,58007620,186623664,4851747888.059800,1125276435.568900,3202530848.587099,9179555172.215799,714471,88560,410178,1213209
2018-10-03,NASDAQ PSX (X),17380137,18466397,15253198,51099732,667082100.757200,1540339415.456100,1079514916.272000,3286936432.485300,147307,72458,128505,348270
2018-10-03,BYX Equities (Y),178409951,82597076,85804894,346811921,5583268212.315500,3698623951.179700,3238185841.841101,12520078005.336301,1538954,399018,774041,2712013
2018-10-03,BZX Equities (Z),222366906,112913677,141409649,476690232,9205496897.140302,7284055130.741598,7647669332.997699,24137221360.879599,2018879,504851,1238267,3761997
2018-10-02,NYSE American (A),5814879,31792036,2937310,40544225,232794633.070700,285155082.037000,195802200.784000,713751915.891700,52586,83453,30294,166333
2018-10-02,NASDAQ BX (B),97339774,32058528,56281072,185679374,4593391924.588500,1577155614.862700,3193179652.105300,9363727191.556500,1045175,164481,626871,1836527
2018-10-02,NYSE National (C),38422781,16504628,18505671,73433080,1219621171.528200,592422702.770800,886582107.348000,2698625981.647000,356123,65661,195276,617060
2018-10-02,FINRA / NYSE TRF (DN),190961928,135937332,291370205,618269465,5904683593.161498,2962488556.001699,12017436654.025394,20884608803.188591,428924,374025,709850,1512799
2018-10-02,FINRA / Nasdaq TRF Carteret (DQ),1061898405,471829179,758503813,2292231397,41646589190.295995,22874782670.170194,36205321432.167596,100726693292.633785,3559859,1234524,2591703,7386086
2018-10-02,EDGA Equities (J),38941880,27421986,27160918,93524784,1426130213.935000,1484365414.676000,1409488164.553000,4319983793.164000,341094,130849,224230,696173
2018-10-02,EDGX Equities (K),129537942,100130270,159989473,389657685,5005247231.695001,3820686459.302699,6645234790.176598,15471168481.174298,970016,365456,923624,2259096
2018-10-02,CHX (M),17112356,14918617,6143820,38174793,815976279.098400,1401595462.329100,719403174.583700,2936974916.011200,3995,5098,4713,13806
2018-10-02,NYSE (N),807886861,26159787,34632783,868679431,32747894625.400098,1774941996.832400,1643509642.320900,36166346264.553398,2547464,95655,238050,2881169
2018-10-02,NYSE Arca (P),174284439,293600281,182306588,650191308,6738445896.987700,14752893440.497394,8994852880.683894,30486192218.168988,1237297,751242,1300610,3289149
2018-10-02,NASDAQ (Q),383202184,184311089,596198464,1163711737,17743660857.555206,9650305429.397604,34772344404.266588,62166310691.219398,3238485,723250,3787926,7749661
2018-10-02,IEX (V),101625657,21346149,61374808,184346614,4549431258.802100,1127683455.436500,3816699941.983602,9493814656.222202,694521,93737,426393,1214651
2018-10-02,NASDAQ PSX (X),15782684,15196825,14330054,45309563,593611203.726400,1271319453.209900,1022077802.269900,2887008459.206200,130464,64237,128924,323625
2018-10-02,BYX Equities (Y),170520197,79622150,79551824,329694171,5453055157.960000,3310371831.520200,3420514551.423000,12183941540.903200,1459680,384243,762329,2606252
2018-10-02,BZX Equities (Z),199292290,96712160,127517271,423521721,8072125901.321401,6040918903.661402,7291264791.701299,21404309596.684102,1770621,453028,1185038,3408687
2018-10-01,NYSE American (A),5082727,24058289,2482918,31623934,199605983.214400,179650286.280900,156151227.897200,535407497.392500,45680,60635,26453,132768
2018-10-01,NASDAQ BX (B),93776674,27919748,51590013,173286435,4398629897.293400,1542675650.678800,3064169460.901401,9005475008.873601,962340,140469,574541,1677350
2018-10-01,NYSE National (C),34998268,14346364,16771333,66115965,1106122315.581000,503170367.499200,743088224.139400,2352380907.219600,324665,56149,178674,559488
2018-10-01,FINRA / NYSE TRF (DN),199301739,121083989,265333066,585718794,6358906357.114101,3062019607.816101,11594408720.704807,21015334685.635009,455418,287406,673158,1415982
2018-10-01,FINRA / Nasdaq TRF Carteret (DQ),1003719266,420585320,723123304,2147427890,38195083276.827292,22970427070.515803,34958597114.493117,96124107461.836212,3453190,945050,2461059,6859299
2018-10-01,EDGA Equities (J),38584649,21657398,23117224,83359271,1421749091.615000,1361444092.260500,1228528396.497300,4011721580.372800,336924,103258,204685,644867
2018-10-01,EDGX Equities (K),133754331,85170926,146374264,365299521,5103936371.180299,3767324211.428301,6522428953.291900,15393689535.900500,980765,303177,875412,2159354
2018-10-01,CHX (M),23071364,11674786,8324760,43070910,1505060516.581200,1641142214.223200,764241063.910500,3910443794.714900,3868,4121,4409,12398
2018-10-01,NYSE (N),788554088,23516400,29358390,841428878,32796108517.990700,1963083407.478799,1485246646.558400,36244438572.027899,2613779,87265,216666,2917710
2018-10-01,NYSE Arca (P),191343659,252931578,172645809,616921046,7197636883.305001,14867560900.671501,9151823685.267901,31217021469.244403,1259844,673349,1262077,3195270
2018-10-01,NASDAQ (Q),380862002,153963913,589982168,1124808083,17567022764.242797,9719074727.991302,35267961962.732290,62554059454.966389,3209470,625827,3750976,7586273
2018-10-01,IEX (V),102720039,18128717,58837871,179686627,4581618700.845000,1136750977.878400,3428720865.250199,9147090543.973599,691141,77238,416645,1185024
2018-10-01,NASDAQ PSX (X),16717275,14162114,13339872,44219261,599056157.295000,1346266413.571000,1003752883.143700,2949075454.009700,128460,62261,118570,309291
2018-10-01,BYX Equities (Y),171035782,67471045,76477984,314984811,5310103922.328700,3055632852.767500,3257969464.796000,11623706239.892200,1425349,338825,742970,2507144
2018-10-01,BZX Equities (Z),192370859,87669229,121769422,401809510,8038045643.900899,6239072117.458903,7014530764.025199,21291648525.385001,1688098,420236,1123102,3231436
2018-09-28,NYSE American (A),5601934,26846462,3067841,35516237,271063893.517700,217454800.982800,190534396.493100,679053090.993600,56016,58301,30394,144711
2018-09-28,NASDAQ BX (B),95369868,31092892,52850473,179313233,4638888696.664600,1731038042.842600,3005867257.190400,9375793996.697600,1028353,144252,580337,1752942
2018-09-28,NYSE National (C),36877054,16450631,18169668,71497353,1225168720.786300,580882810.607200,793486221.119600,2599537752.513100,327588,60517,182947,571052
2018-09-28,FINRA / NYSE TRF (DN),169507099,118345950,244504246,532357295,5506953124.621998,2250956517.153500,11497015019.534508,19254924661.310006,392723,270386,584607,1247716
2018-09-28,FINRA / Nasdaq TRF Carteret (DQ),1024724440,404569320,736558958,2165852718,43482764673.126803,22381023894.135291,37033159101.938307,102896947669.200401,3507544,862177,2346687,6716408
2018-09-28,EDGA Equities (J),36556245,24098976,23834213,84489434,1477422862.727600,1531328482.346700,1350527466.906200,4359278811.980500,344400,109738,211430,665568
2018-09-28,EDGX Equities (K),126207473,85983079,128373704,340564256,5285173145.220600,3786389483.666401,6385115085.099402,15456677713.986403,987187,305119,835359,2127665
2018-09-28,CHX (M),19372704,17055835,13927180,50355719,703950445.845500,1511887129.702300,730219972.034500,2946057547.582300,4102,3474,4130,11706
2018-09-28,NYSE (N),956502231,24790720,30411434,1011704385,44050889431.966695,1919301195.609400,1791878512.279600,47762069139.855695,2401951,81810,210303,2694064
2018-09-28,NYSE Arca (P),166836247,268635595,161086839,596558681,7399524486.204398,15335488661.626901,9425062034.821605,32160075182.652904,1262269,667256,1221234,3150759
2018-09-28,NASDAQ (Q),345920593,160313576,657123261,1163357430,17445723776.947396,9732486669.408902,39442375822.724409,66620586269.080707,3101255,617203,3401863,7120321
2018-09-28,IEX (V),106006816,18412936,55702943,180122695,4690669140.238901,1185978075.722600,3455551678.527000,9332198894.488501,701775,78387,404725,1184887
2018-09-28,NASDAQ PSX (X),15131985,14402926,13873446,43408357,624302655.723500,1341497738.426000,1051740793.107000,3017541187.256500,128409,58634,129031,316074
2018-09-28,BYX Equities (Y),175038051,81975762,82463441,339477254,6101108566.746800,3710191854.642000,3559734211.181801,13371034632.570601,1581585,373065,829125,2783775
2018-09-28,BZX Equities (Z),182028184,87298900,120179978,389507062,8005118004.825098,6126416480.638599,7414663394.250700,21546197879.714397,1635114,397663,1102324,3135101
2018-09-27,NYSE American (A),4827721,16728239,2567839,24123799,212550686.712400,136749456.940300,153152613.212900,502452756.865600,50177,45868,26878,122923
2018-09-27,NASDAQ BX (B),90783661,25754441,51676606,168214708,4277159441.127200,1381780223.644000,2835713350.312400,8494653015.083600,956454,123271,553946,1633671
2018-09-27,NYSE National (C),36236949,15129724,17538012,68904685,1167692632.005900,532121380.251600,722298636.881600,2422112649.139100,340639,57846,174700,573185
2018-09-27,FINRA / NYSE TRF (DN),177060379,93033691,234890440,504984510,5690847790.180499,2156422097.126399,9938486560.588201,17785756447.895099,381644,189228,535934,1106806
2018-09-27,FINRA / Nasdaq TRF Carteret (DQ),956687948,317304039,639443944,1913435931,37006778095.242390,17268940466.575405,28914390626.556202,83190109188.373997,3295620,699697,2154532,6149849
2018-09-27,EDGA Equities (J),34097877,19886703,21499241,75483821,1327915976.596600,1134999360.780500,1123148226.731000,3586063564.108100,318052,90342,182626,591020
2018-09-27,EDGX Equities (K),117128177,66210372,133062254,316400803,4742013826.976500,3035383960.328699,5436837913.998702,13214235701.303901,920394,228942,773260,1922596
2018-09-27,CHX (M),11177652,13325672,17023216,41526540,569115132.532600,901640609.922000,1186184221.051500,2656939963.506100,3624,3378,4049,11051
2018-09-27,NYSE (N),750877516,22428219,26376384,799682119,31450503675.787896,1700953161.606000,1326737151.411400,34478193988.805296,2302129,72361,182256,2556746
2018-09-27,NYSE Arca (P),161458376,233885299,159124490,554468165,6736765928.718100,12716516106.898095,8445275976.676501,27898558012.292696,1156284,564069,1122141,2842494
2018-09-27,NASDAQ (Q),323437947,137817187,528092207,989347341,15617753676.229299,8837938163.676201,31076403621.760109,55532095461.665609,2799415,531227,3071723,6402365
2018-09-27,IEX (V),93385924,16155413,50509502,160050839,4259433754.171700,898976194.133900,2990785577.524000,8149195525.829600,604830,71566,359384,1035780
2018-09-27,NASDAQ PSX (X),13330582,13036570,11611683,37978835,528650988.541000,1137634440.766800,894767898.783400,2561053328.091200,116675,50698,105972,273345
2018-09-27,BYX Equities (Y),156400391,63240162,73054634,292695187,5247190059.455100,2800937383.418700,3068433505.243400,11116560948.117200,1385251,311891,727394,2424536
2018-09-27,BZX Equities (Z),174472816,79954934,107465399,361893149,7394210791.503401,5367733101.885397,6316167247.624501,19078111141.013299,1524864,358607,959748,2843219
2018-09-26,NYSE American (A),5497775,17145162,3093733,25736670,248386757.350900,150803656.562000,178723097.904700,577913511.817600,56153,46054,28969,131176
2018-09-26,NASDAQ BX (B),100094241,32996208,56845172,189935621,4776138071.227200,1781871530.132300,3118738060.891400,9676747662.250900,1033514,153439,607906,1794859
2018-09-26,NYSE National (C),35996332,18164345,18878803,73039480,1155483395.249800,630364037.657800,836521682.114200,2622369115.021800,341160,69803,187471,598434
2018-09-26,FINRA / NYSE TRF (DN),189642688,95203252,262729054,547574994,6449373811.876499,2351985158.052900,10778441613.689303,19579800583.618702,424808,191437,575612,1191857
2018-09-26,FINRA / Nasdaq TRF Carteret (DQ),1036294704,385650368,721291058,2143236130,40769297709.182706,22864198719.965698,32864821960.256895,96498318389.405299,3431461,774996,2274071,6480528
2018-09-26,EDGA Equities (J),37063945,25247809,24540373,86852127,1463383545.202500,1415059851.788800,1268256686.280200,4146700083.271500,337427,105625,197634,640686
2018-09-26,EDGX Equities (K),127128149,78977514,154852287,360957950,5186134917.945900,3980685096.486800,5807011283.038900,14973831297.471600,954635,276198,790270,2021103
2018-09-26,CHX (M),30875120,21021488,12689024,64585632,2320365897.005001,2153618539.256301,830692793.803700,5304677230.065002,4473,4376,4800,13649
2018-09-26,NYSE (N),829127615,29693952,27254333,886075900,35421555640.276499,2338913155.474900,1410486446.717300,39170955242.468699,2531138,92128,187542,2810808
2018-09-26,NYSE Arca (P),176647845,294274531,173643823,644566199,7455959195.885801,16258894928.451001,8860228200.388401,32575082324.725203,1281579,707134,1187862,3176575
2018-09-26,NASDAQ (Q),357725286,176006611,609050246,1142782143,17073034964.807201,11500380968.849008,33469677350.929212,62043093284.585421,3048395,655858,3395202,7099455
2018-09-26,IEX (V),107845245,17488842,59275344,184609431,4988537563.193200,979099276.358400,3567031163.163701,9534668002.715301,702392,77796,403282,1183470
2018-09-26,NASDAQ PSX (X),15797388,18964795,12480261,47242444,644529387.711900,1597390939.855300,950892230.891600,3192812558.458800,134575,69253,117200,321028
2018-09-26,BYX Equities (Y),174440997,75733647,82242188,332416832,5868264815.954499,3434403574.377600,3398093818.478801,12700762208.810900,1540741,368480,795470,2704691
2018-09-26,BZX Equities (Z),193367162,106486630,123504766,423358558,8309651423.314499,7005189514.300001,7280254320.565401,22595095258.179901,1719178,469649,1091633,3280460
2018-09-25,NYSE American (A),4896935,24578545,2919393,32394873,231065002.651800,138098653.101500,142653137.792800,511816793.546100,48127,48239,26949,123315
2018-09-25,NASDAQ BX (B),94318914,22360586,53894608,170574108,4611388903.805200,1182993921.521300,2857885287.098800,8652268112.425300,996554,112086,590111,1698751
2018-09-25,NYSE National (C),32048371,13516736,16272381,61837488,1025296855.325000,490481190.840600,643175784.910900,2158953831.076500,293995,50307,162111,506413
2018-09-25,FINRA / Nasdaq TRF Chicago (DB),12400,0,0,12400,1714300.000000,0.000000,0.000000,1714300.000000,1,0,0,1
2018-09-25,FINRA / NYSE TRF (DN),191532078,105640872,276475759,573648709,6355510792.377499,1932867954.260800,10058698810.425595,18347077557.063894,433136,195637,605366,1234139
2018-09-25,FINRA / Nasdaq TRF Carteret (DQ),1035513039,345673545,764500167,2145686751,41468908025.584890,16963538037.658095,33488742668.676607,91921188731.919592,3442859,755206,2338667,6536732
2018-09-25,EDGA Equities (J),34115333,17758386,21351699,73225418,1400325688.371700,911771232.804000,1114522761.241600,3426619682.417300,318466,78488,188416,585370
2018-09-25,EDGX Equities (K),125240855,75276104,146930706,347447665,5187068773.663598,2679951471.180400,5278386319.867301,13145406564.711299,1003322,236153,804664,2044139
2018-09-25,CHX (M),16646079,10085880,7891410,34623369,1197820528.974000,916694333.020400,849933522.668400,2964448384.662800,4710,2793,5370,12873
2018-09-25,NYSE (N),833081781,19125138,26559702,878766621,36153888440.327099,1344113796.580599,1221258593.345500,38719260830.253198,2219432,63909,181877,2465218
2018-09-25,NYSE Arca (P),171066259,212056782,169246984,552370025,7302820314.108802,11088388025.797195,8054332474.732202,26445540814.638199,1237296,530088,1181444,2948828
2018-09-25,NASDAQ (Q),332996633,128103582,578330637,1039430852,16525591765.765401,7399876430.296399,32509815313.150287,56435283509.212087,2837706,482739,3150445,6470890
2018-09-25,IEX (V),95846723,16702821,55521084,168070628,4409537077.394000,882362628.313100,3289262429.611700,8581162135.318800,642509,68857,387634,1099000
2018-09-25,NASDAQ PSX (X),13502042,10803077,12028192,36333311,578788873.323900,910426008.265100,891454114.947400,2380668996.536400,119201,45893,110091,275185
2018-09-25,BYX Equities (Y),164772456,61007941,77810690,303591087,5417605172.577300,2607386986.904500,3136107263.043600,11161099422.525400,1429347,309389,764158,2502894
2018-09-25,BZX Equities (Z),185290764,70725770,118927949,374944483,7935926543.432700,4499058578.965601,6442857113.295300,18877842235.693601,1613650,330878,1030738,2975266
2018-09-24,NYSE American (A),5796595,21593980,4327684,31718259,241867371.158500,143202020.350100,210238620.233000,595308011.741600,53661,51158,33116,137935
2018-09-24,NASDAQ BX (B),93922282,26612343,54904273,175438898,4291875162.650700,1388924470.113100,2769546379.951600,8450346012.715400,970687,128193,579686,1678566
2018-09-24,NYSE National (C),33926506,14907953,17897733,66732192,1032001167.163400,534463226.627500,719329298.684700,2285793692.475600,302614,58142,174068,534824
2018-09-24,FINRA / NYSE TRF (DN),193852255,99833302,272033743,565719300,5892436234.764500,2152383965.965601,10124176608.988490,18168996809.718591,440127,208498,594526,1243151
2018-09-24,FINRA / Nasdaq TRF Carteret (DQ),1009513279,360263589,756458246,2126235114,38198814502.440395,18404831624.380803,31973006855.350696,88576652982.171894,3478281,797036,2352145,6627462
2018-09-24,EDGA Equities (J),34852412,20703954,23545263,79101629,1350229796.355300,1101227800.024400,1203374038.855500,3654831635.235200,320150,93907,199688,613745
2018-09-24,EDGX Equities (K),130415176,83326275,160190430,373931881,5060217295.603900,3174587481.572600,5664267334.507900,13899072111.684400,966534,270851,823866,2061251
2018-09-24,CHX (M),18138094,9846546,13305732,41290372,784763009.318100,842431335.781400,1101524557.126300,2728718902.225800,7103,3356,5274,15733
2018-09-24,NYSE (N),854617648,21997625,30714552,907329825,36919800244.230299,1572480803.551501,1464973036.166300,39957254083.948100,2404062,76712,204595,2685369
2018-09-24,NYSE Arca (P),179912609,259618243,191787251,631318103,7288694181.914304,13206708736.970207,8575388273.512699,29070791192.397210,1276021,650523,1261215,3187759
2018-09-24,NASDAQ (Q),348161610,149156851,613742878,1111061339,16216747239.929703,9008783772.313297,33313025318.142496,58538556330.385496,2832650,584390,3243742,6660782
2018-09-24,IEX (V),104000571,17363574,62987330,184351475,4873194625.722499,951060544.437300,3497937627.143200,9322192797.302999,696920,83430,424168,1204518
2018-09-24,NASDAQ PSX (X),14791304,14048708,13882344,42722356,557846362.231800,1184880220.513800,945818047.661500,2688544630.407100,129769,59884,124388,314041
2018-09-24,BYX Equities (Y),175707233,65767989,85853677,327328899,5571096851.162600,2906790085.033200,3273713680.133299,11751600616.329099,1531797,336766,811572,2680135
2018-09-24,BZX Equities (Z),194427575,88247917,131636324,414311816,8030850724.275703,5477308854.941399,6695113731.588400,20203273310.805502,1709169,397985,1092077,3199231
2018-09-21,NYSE American (A),6687557,80402361,4694577,91784495,301324249.560200,484771482.084200,310423099.664200,1096518831.308600,64074,51903,42088,158065
2018-09-21,NASDAQ BX (B),107492322,34556736,64027377,206076435,5304624931.697100,1818427670.117600,3625225033.788599,10748277635.603299,1098316,160746,679486,1938548
2018-09-21,NYSE National (C),37207138,19878785,18196678,75282601,1163672728.685000,698512593.846000,730194313.725400,2592379636.256400,335711,66556,173753,576020
2018-09-21,FINRA / NYSE TRF (DN),170515401,96698793,253781329,520995523,5520345943.848198,2341802655.129100,10205485979.125102,18067634578.102400,412038,218927,615244,1246209
2018-09-21,FINRA / Nasdaq TRF Carteret (DQ),1386024579,471015839,1029308384,2886348802,60102709138.409604,35075113672.146795,56401523815.551971,151579346626.108370,3666252,845053,2481778,6993083
2018-09-21,EDGA Equities (J),40614583,25467426,25593625,91675634,1685490959.696200,1386185959.619100,1579610716.751900,4651287636.067200,365439,117948,226465,709852
2018-09-21,EDGX Equities (K),138846492,84489703,145873827,369210022,5930365535.698300,4241418990.975601,7249123918.275500,17420908444.949401,1017056,299293,915795,2232144
2018-09-21,CHX (M),26477980,18783572,11977110,57238662,1967365651.230200,1744407297.720000,1573780987.752300,5285553936.702500,4051,3585,3743,11379
2018-09-21,NYSE (N),2660310528,27442112,30473688,2718226328,125101517703.262716,2056556805.941500,1597828817.814800,128755903327.019016,2437463,86949,208556,2732968
2018-09-21,NYSE Arca (P),185295205,290388050,181748501,657431756,8145272026.025402,16060015704.579591,9651601200.557202,33856888931.162195,1313852,686623,1290598,3291073
2018-09-21,NASDAQ (Q),361719174,166231894,1650939126,2178890194,18194424503.991501,10582153946.381602,100136753881.659006,128913332332.032109,3019378,630531,3516756,7166665
2018-09-21,IEX (V),115924288,21319472,66929903,204173663,5251208998.213000,1135440608.003600,3944815173.915600,10331464780.132200,758856,94789,459466,1313111
2018-09-21,NASDAQ PSX (X),17079196,16864796,14289809,48233801,767580540.478500,1384805018.213700,1223185903.280900,3375571461.973100,152787,67320,139924,360031
2018-09-21,BYX Equities (Y),182909556,85234246,95996169,364139971,6304912699.559500,3858719218.477401,4196533674.224401,14360165592.261302,1563993,402222,901401,2867616
2018-09-21,BZX Equities (Z),215372193,104426420,136069024,455867637,9541029980.717201,6762963160.090800,8314152764.014702,24618145904.822703,1851267,464237,1194091,3509595
2018-09-20,NYSE American (A),6452065,13299303,3485216,23236584,306659435.842100,163018634.112600,208635418.956500,678313488.911200,65070,39566,36024,140660
2018-09-20,NASDAQ BX (B),107228142,31836970,59030360,198095472,5230536094.633100,1761839632.186200,3310805428.238500,10303181155.057800,1104102,149079,658953,1912134
2018-09-20,NYSE National (C),35219192,16965406,17178017,69362615,1132729673.104200,627767194.711000,659348849.499300,2419845717.314500,318142,64414,175534,558090
2018-09-20,FINRA / NYSE TRF (DN),187151520,74489415,271578311,533219246,6342822270.129101,2349739603.192500,10255571175.408510,18948133048.730111,458970,176468,657535,1292973
2018-09-20,FINRA / Nasdaq TRF Carteret (DQ),1004024135,373231001,705985722,2083240858,41868826969.932299,26967640115.657283,32137935271.819196,100974402357.408778,3725516,812370,2465622,7003508
2018-09-20,EDGA Equities (J),39363035,23478435,24305598,87147068,1617900285.825600,1498522043.798800,1316681886.158000,4433104215.782400,365624,108331,215096,689051
2018-09-20,EDGX Equities (K),136480048,66974216,153922673,357376937,5742431680.084504,3903974222.443300,6323046827.786796,15969452730.314600,1058342,263408,893587,2215337
2018-09-20,CHX (M),20309102,21400848,9188065,50898015,1366578330.940000,3017856308.570300,600895178.786100,4985329818.296400,5222,4834,4955,15011
2018-09-20,NYSE (N),815164967,25487369,28172446,868824782,36568978803.224305,1979033819.292800,1455159327.440000,40003171949.957105,2362393,83036,202812,2648241
2018-09-20,NYSE Arca (P),182035328,266714982,183869148,632619458,8158091175.524501,15192952586.173791,9257021569.513194,32608065331.211486,1366353,648922,1312101,3327376
2018-09-20,NASDAQ (Q),364214371,150181834,569430886,1083827091,18673655299.538398,10457027425.276500,33812416594.838086,62943099319.652984,3166061,590692,3421372,7178125
2018-09-20,IEX (V),112578159,21512737,59223493,193314389,5220277907.640900,1392492458.065100,3205839733.477300,9818610099.183300,760882,93388,433290,1287560
2018-09-20,NASDAQ PSX (X),16965405,17002409,13860854,47828668,719368587.939100,1470169957.568400,1049899957.866300,3239438503.373800,147036,68809,129528,345373
2018-09-20,BYX Equities (Y),176722818,78955846,80821696,336500360,6122033747.173600,3839930764.070600,3439617053.994901,13401581565.239101,1547449,377000,803683,2728132
2018-09-20,BZX Equities (Z),202617071,95779267,126534449,424930787,8994020457.515601,6903359216.888200,7307404551.948500,23204784226.352301,1853048,442422,1155052,3450522
2018-09-19,NYSE American (A),5153497,15368604,2822209,23344310,262608794.603900,215778587.502400,160593943.195100,638981325.301400,52903,40711,29903,123517
2018-09-19,NASDAQ BX (B),97779758,26724042,56652600,181156400,4876926862.268100,1360995350.007600,3212482440.884600,9450404653.160300,1032098,130276,621798,1784172
2018-09-19,NYSE National (C),31805656,16758037,16080869,64644562,1004575055.802500,567748195.301900,659359917.441200,2231683168.545600,286641,61520,161677,509838
2018-09-19,FINRA / NYSE TRF (DN),180722332,76469806,266949689,524141827,6400989315.291197,2105744594.727999,11371258624.572397,19877992534.591593,468482,175257,696917,1340656
2018-09-19,FINRA / Nasdaq TRF Carteret (DQ),971847119,341024000,646078858,1958949977,39485926428.343102,18375120973.389892,31051840004.123900,88912887405.856894,3483185,768743,2294425,6546353
2018-09-19,EDGA Equities (J),36755858,21243268,23063929,81063055,1505915616.673300,1172978656.187900,1266214692.512800,3945108965.374000,338805,97389,201265,637459
2018-09-19,EDGX Equities (K),130100367,62203418,145555957,337859742,5589513585.844502,3136913558.200100,6384298214.241498,15110725358.286100,983354,244477,831669,2059500
2018-09-19,CHX (M),17778367,9394925,6451395,33624687,1136973783.047000,942217385.340000,726013451.167900,2805204619.554900,4137,4824,5484,14445
2018-09-19,NYSE (N),826298630,20603255,27024054,873925939,35875811526.041098,1438774864.305999,1411667364.249900,38726253754.596997,2299250,71392,193471,2564113
2018-09-19,NYSE Arca (P),174141436,232450615,170566011,577158062,7806538078.544601,12190625002.244900,8986403626.992101,28983566707.781602,1284284,614482,1209465,3108231
2018-09-19,NASDAQ (Q),350721633,135585090,543001740,1029308463,17866360749.698499,8108182506.233998,32909726324.297692,58884269580.230189,3006271,545431,3252245,6803947
2018-09-19,IEX (V),106224985,17433979,56577259,180236223,4940996357.699999,1018052321.869200,3471991757.109299,9431040436.678498,733406,80922,418541,1232869
2018-09-19,NASDAQ PSX (X),15002462,13896576,12858515,41757553,660334661.038400,1049441778.430500,1006119141.376900,2715895580.845800,132978,59319,124943,317240
2018-09-19,BYX Equities (Y),164626908,70241826,74012518,308881252,5734172689.422401,3115282740.761600,3176345867.422500,12025801297.606501,1436030,348199,743385,2527614
2018-09-19,BZX Equities (Z),193509884,85180624,120028790,398719298,8666500029.223097,5598280315.995800,6912248836.076200,21177029181.295097,1709256,406740,1060360,3176356
2018-09-18,NYSE American (A),4810515,11441315,2985232,19237062,225706045.216800,120259618.222500,183346415.845400,529312079.284700,49934,33871,30481,114286
2018-09-18,NASDAQ BX (B),101108675,23729595,58752922,183591192,4988576102.757300,1282314896.990400,3375709230.413600,9646600230.161300,1082600,121255,664460,1868315
2018-09-18,NYSE National (C),32088022,14063053,17220960,63372035,986165486.167600,482800819.926400,703677409.293100,2172643715.387100,295987,55274,171453,522714
2018-09-18,FINRA / NYSE TRF (DN),173102398,69775567,280386851,523264816,6089538004.674103,2189670246.374801,11574273001.855098,19853481252.904002,433463,158576,612963,1205002
2018-09-18,FINRA / Nasdaq TRF Carteret (DQ),943570413,295460979,730248977,1969280369,38432673831.884307,18215415755.974503,33232253649.511994,89880343237.370804,3499657,754257,2377551,6631465
2018-09-18,EDGA Equities (J),33804527,18116884,23511010,75432421,1417946259.463400,1085316991.663500,1262096565.531800,3765359816.658700,324099,88221,206822,619142
2018-09-18,EDGX Equities (K),123313439,58592479,167752530,349658448,5283747269.652300,3216603983.909100,6434182817.100200,14934534070.661600,954297,229658,862500,2046455
2018-09-18,CHX (M),11429000,15460221,7875757,34764978,882845813.510000,1493527127.589000,580650779.709300,2957023720.808300,4223,3603,5047,12873
2018-09-18,NYSE (N),709194222,21008620,27298123,757500965,31690450756.061800,1600923826.803200,1498735501.881200,34790110084.746200,2245039,70225,204972,2520236
2018-09-18,NYSE Arca (P),162368497,225288720,177993238,565650455,7530450778.589699,12707689904.274202,9447915832.407199,29686056515.271100,1249314,587441,1253664,3090419
2018-09-18,NASDAQ (Q),328275539,128016922,555759728,1012052189,17256219667.136500,8173184989.385199,33100767894.221183,58530172550.742882,2944032,524483,3376303,6844818
2018-09-18,IEX (V),107428503,17522777,58591937,183543217,5425475924.996600,1026808422.650800,3590019847.338199,10042304194.985599,748659,82069,441588,1272316
2018-09-18,NASDAQ PSX (X),14467619,13219483,14459752,42146854,618823042.210400,1031466032.681900,1020825611.249100,2671114686.141400,128618,55525,137665,321808
2018-09-18,BYX Equities (Y),159284904,57794287,76999921,294079112,5549005685.999400,2653215172.689300,3406867889.009600,11609088747.698300,1442029,303401,791568,2536998
2018-09-18,BZX Equities (Z),186946310,77511838,128428222,392886370,8364610390.509099,5329139628.513300,7438327593.395404,21132077612.417803,1705236,383710,1129854,3218800
2018-09-17,NYSE American (A),4305100,11765496,2868178,18938774,204920928.841300,140676784.349400,147760908.870000,493358622.060700,46899,33524,28958,109381
2018-09-17,NASDAQ BX (B),97331996,24177751,57044251,178553998,4684801702.970900,1250720374.798500,3229489624.980099,9165011702.749499,1046333,123960,626766,1797059
2018-09-17,NYSE National (C),33285213,14406522,17763987,65455722,1014379850.370000,468731281.382900,732992484.659400,2216103616.412300,321598,63794,185249,570641
2018-09-17,FINRA / NYSE TRF (DN),172011319,63606098,267102654,502720071,5531895031.927498,2078098289.253500,11606255301.765296,19216248622.946294,417335,136078,553926,1107339
2018-09-17,FINRA / Nasdaq TRF Carteret (DQ),852132132,302609520,686433296,1841174948,35686464927.686696,20485361771.300594,31862875932.060698,88034702631.047988,3333606,753599,2295939,6383144
2018-09-17,EDGA Equities (J),31738367,17783141,22929644,72451152,1267192967.087300,1064031603.222900,1167225211.604100,3498449781.914300,305894,87097,191919,584910
2018-09-17,EDGX Equities (K),115540356,53559591,176033393,345133340,4769105293.184801,3117631334.897900,6054743290.575801,13941479918.658502,912606,211658,819001,1943265
2018-09-17,CHX (M),18249882,10625409,5925604,34800895,991137901.995200,1227905977.178000,732443864.270700,2951487743.443900,3990,4260,4760,13010
2018-09-17,NYSE (N),732236544,21045951,26108912,779391407,31809850863.708397,1729750305.898800,1459693340.865400,34999294510.472597,2231786,64663,198179,2494628
2018-09-17,NYSE Arca (P),156295475,234488121,172704397,563487993,6896678443.588200,13070298011.737198,8966070543.644099,28933046998.969497,1227874,604219,1217938,3050031
2018-09-17,NASDAQ (Q),320938263,137510916,600574562,1059023741,16283318041.786099,8954224737.946998,34595329989.224999,59832872768.958096,2899436,547629,3395819,6842884
2018-09-17,IEX (V),86424666,13166507,51812337,151403510,4164673780.282000,796342003.992000,3159897549.597400,8120913333.871400,628737,59589,379001,1067327
2018-09-17,NASDAQ PSX (X),14388871,14923240,14160411,43472522,605516000.378100,1246396459.767100,1231418275.965100,3083330736.110300,132813,60842,132842,326497
2018-09-17,BYX Equities (Y),151774026,59251113,73363119,284388258,5185444285.048800,2641584639.586999,3218913513.305600,11045942437.941399,1393713,319894,761736,2475343
2018-09-17,BZX Equities (Z),181330439,80373831,128782200,390486470,8145141887.609199,5630074948.236800,7573034511.746700,21348251347.592699,1721418,379488,1160802,3261708
2018-09-14,NYSE American (A),4760011,11199787,2420164,18379962,213413834.412100,128727533.903400,138682333.024400,480823701.339900,50440,32485,25480,108405
2018-09-14,NASDAQ BX (B),101501726,24669683,53248024,179419433,4912712514.552900,1325756844.731200,3013521420.085701,9251990779.369801,1084660,128051,595696,1808407
2018-09-14,NYSE National (C),34420786,14307131,17480616,66208533,1038535107.117600,475380060.010600,648360363.422700,2162275530.550900,334548,68628,176722,579898
2018-09-14,FINRA / NYSE TRF (DN),191180279,65751512,239718986,496650777,5787544919.287602,2027142357.699300,10700324772.175395,18515012049.162297,450007,131036,530257,1111300
2018-09-14,FINRA / Nasdaq TRF Carteret (DQ),947071420,296146337,634260494,1877478251,38038260738.841806,18123037830.907100,31463875009.474594,87625173579.223500,3408976,689390,2149781,6248147
2018-09-14,EDGA Equities (J),35435061,20746252,21397980,77579293,1421234337.860300,1279572166.485000,1208596025.537300,3909402529.882600,337326,96196,190486,624008
2018-09-14,EDGX Equities (K),126513787,53370944,125038289,304923020,4982974546.789300,2957652041.520802,5652458736.625401,13593085324.935503,947540,208930,744105,1900575
2018-09-14,CHX (M),11988019,18811828,6221283,37021130,840045295.913500,1676562338.155000,664856486.186600,3181464120.255100,4221,4603,5959,14783
2018-09-14,NYSE (N),762314249,24398243,25692179,812404671,32378335067.926596,1716871404.257800,1391875717.168200,35487082189.352596,2184943,73569,191851,2450363
2018-09-14,NYSE Arca (P),176353798,237669344,156579019,570602161,7132147745.193997,12899953821.967296,8512401733.104502,28544503300.265795,1276873,600575,1179984,3057432
2018-09-14,NASDAQ (Q),344995179,139146333,529923669,1014065181,16941614762.272701,8610015027.015699,32384874280.839996,57936504070.128396,3033908,520160,3189458,6743526
2018-09-14,IEX (V),94230427,14174431,50264006,158668864,4122689525.816200,881688331.246600,2903680147.851500,7908058004.914300,646492,59935,370332,1076759
2018-09-14,NASDAQ PSX (X),15350986,16125416,14841428,46317830,623670912.326500,1252959190.500100,1074275166.538100,2950905269.364700,133749,62154,131558,327461
2018-09-14,BYX Equities (Y),154057058,61024037,71791652,286872747,5277953147.040300,2705850788.660701,3126071162.477800,11109875098.178801,1373631,314891,727307,2415829
2018-09-14,BZX Equities (Z),179247063,82821265,120508645,382576973,7837381051.281001,5668578337.858100,7123351698.087102,20629311087.226203,1628855,387071,1055505,3071431
2018-09-13,NYSE American (A),4634399,12400187,2837394,19871980,206172364.616000,126739399.275200,154721961.548300,487633725.439500,46992,34557,27909,109458
2018-09-13,NASDAQ BX (B),98430823,29266327,55152257,182849407,4726331701.097200,1502868283.600900,3096271031.599001,9325471016.297101,1052968,142163,606943,1802074
2018-09-13,NYSE National (C),35100619,15350034,18256085,68706738,1069624986.185000,509323042.137300,715576155.328200,2294524183.650500,336634,68147,183231,588012
2018-09-13,FINRA / NYSE TRF (DN),204311800,77473670,290070751,571856221,6245468305.290401,2137235561.128800,12711338590.263394,21094042456.682595,490964,143864,623332,1258160
2018-09-13,FINRA / Nasdaq TRF Carteret (DQ),983459567,315279003,738307185,2037045755,40027507017.520697,16454494792.023802,36343518987.699881,92825520797.244380,3546211,725920,2393753,6665884
2018-09-13,EDGA Equities (J),37236861,23185439,24316521,84738821,1478659708.293100,1331464456.289200,1304297137.926000,4114421302.508300,345538,103109,211344,659991
2018-09-13,EDGX Equities (K),131290154,65185744,151244173,347720071,5230425011.002200,3034834005.405500,6425611368.186803,14690870384.594503,960547,228072,829592,2018211
2018-09-13,CHX (M),10347857,16160686,8054196,34562739,585851232.225200,1331651672.493000,894856186.033700,2812359090.751900,3588,4690,4832,13110
2018-09-13,NYSE (N),756841254,25789603,29099343,811730200,31552482284.227102,1720628417.853300,1517438342.599500,34790549044.679902,2258283,75079,210636,2543998
2018-09-13,NYSE Arca (P),181378703,277411334,174371926,633161963,7686274241.678897,13822368492.661408,9497002026.007006,31005644760.347311,1292142,648392,1249056,3189590
2018-09-13,NASDAQ (Q),366575000,151643202,555487137,1073705339,18534064251.233300,8904653282.863402,33916651150.002596,61355368684.099298,3183031,577969,3434212,7195212
2018-09-13,IEX (V),97079473,15338943,58436104,170854520,4547346815.412600,912594067.592500,3545418078.613601,9005358961.618701,657917,63229,405377,1126523
2018-09-13,NASDAQ PSX (X),17477213,17079377,15747185,50303775,640068807.626700,1218503420.363800,1174394091.927000,3032966319.917500,129640,64037,135100,328777
2018-09-13,BYX Equities (Y),162176897,68496112,75290714,305963723,5482570516.614000,3023834867.339800,3238634674.679699,11745040058.633499,1425176,344240,751761,2521177
2018-09-13,BZX Equities (Z),187755603,97080518,136265935,421102056,8103169473.715399,5938615976.691998,8000145872.661199,22041931323.068596,1649697,414488,1159397,3223582
2018-09-12,NYSE American (A),4737206,16893786,3166080,24797072,213603174.127200,146849200.846700,211161771.882100,571614146.856000,47999,42729,30338,121066
2018-09-12,NASDAQ BX (B),100845005,33304211,57027110,191176326,4777046395.240600,1605810033.708499,3312740327.012500,9695596755.961599,1060565,157179,636956,1854700
2018-09-12,NYSE National (C),37095149,17252223,17814762,72162134,1177786882.882200,538178707.731100,753399298.639000,2469364889.252300,353303,76629,185017,614949
2018-09-12,FINRA / NYSE TRF (DN),189325492,99043073,285642849,574011414,6420312594.993100,2577457766.379400,13272649741.388897,22270420102.761397,427131,165739,621360,1214230
2018-09-12,FINRA / Nasdaq TRF Carteret (DQ),1000181312,390504662,740057793,2130743767,39006524519.735202,20066102309.523403,35647448246.953300,94720075076.211905,3607283,803428,2428870,6839581
2018-09-12,EDGA Equities (J),38116512,26440899,25280465,89837876,1505104834.025400,1336419762.028800,1396278983.840500,4237803579.894700,352535,114419,213039,679993
2018-09-12,EDGX Equities (K),134472190,83347095,156586484,374405769,5363168561.623400,3771037947.992900,6578745008.437698,15712951518.053998,990276,295108,852765,2138149
2018-09-12,CHX (M),13882296,18378176,7348046,39608518,682761041.375800,1652939257.217300,646719613.692400,2982419912.285500,3882,9521,6359,19762
2018-09-12,NYSE (N),764185614,31427844,31022443,826635901,32190013959.135299,2216858306.743300,1670578562.060400,36077450827.938999,2367776,89145,209449,2666370
2018-09-12,NYSE Arca (P),185872104,323254916,181029127,690156147,7655304477.234501,15534621002.019298,10018355776.980803,33208281256.234602,1323600,754008,1301267,3378875
2018-09-12,NASDAQ (Q),380004089,181129400,574881741,1136015230,18992491546.208701,10398956246.579198,36020034463.336692,65411482256.124591,3331428,698912,3676340,7706680
2018-09-12,IEX (V),104952653,18467422,57845901,181265976,4705126574.117300,1037103791.416300,3355486307.272599,9097716672.806199,694717,77271,403669,1175657
2018-09-12,NASDAQ PSX (X),16096746,21221993,16126125,53444864,636043217.065700,1575885500.395500,1257152497.954400,3469081215.415600,131856,80609,140240,352705
2018-09-12,BYX Equities (Y),168468864,82147568,79514674,330131106,5518766856.788100,3431024554.194801,3388902172.994299,12338693583.977200,1503323,416588,788924,2708835
2018-09-12,BZX Equities (Z),203047832,113184572,138985498,455217902,8645959637.383998,7067699928.299302,8162829317.798498,23876488883.481798,1903685,537145,1256664,3697494
2018-09-11,NYSE American (A),4643301,10528269,2980574,18152144,208481946.296400,124553482.435300,193031141.161400,526066569.893100,47092,36201,29862,113155
2018-09-11,NASDAQ BX (B),93304327,26386536,56875239,176566102,4602549241.385700,1388760855.127900,3303642501.126800,9294952597.640400,1015296,133697,623298,1772291
2018-09-11,NYSE National (C),32808515,15590472,16864842,65263829,972082446.614800,533272586.060100,654514918.473300,2159869951.148200,308217,60700,171559,540476
2018-09-11,FINRA / NYSE TRF (DN),163215960,85238792,295747644,544202396,5653111151.724201,2414644587.432500,11130404478.872991,19198160218.029692,396687,164901,602693,1164281
2018-09-11,FINRA / Nasdaq TRF Carteret (DQ),876913709,349337170,732781822,1959032701,36634086059.112506,18801806648.666802,33651103247.866504,89086995955.645812,3351601,799571,2364537,6515709
2018-09-11,EDGA Equities (J),30324349,19607891,25263591,75195831,1273158423.981400,1081612725.879800,1318220875.969800,3672992025.831000,301045,87264,205619,593928
2018-09-11,EDGX Equities (K),114939493,60587180,164796106,340322779,4893047713.779899,3044829048.882499,5902015977.456802,13839892740.119200,910221,222649,813936,1946806
2018-09-11,CHX (M),16738383,14964564,9560580,41263527,1001859398.321000,1364490339.296400,1224703416.687200,3591053154.304600,3837,5238,4541,13616
2018-09-11,NYSE (N),680717103,21105628,28066488,729889219,29993856845.242494,1581150918.623100,1502839434.980800,33077847198.846394,2147667,69307,202024,2418998
2018-09-11,NYSE Arca (P),149273042,226047106,187265380,562585528,6504148180.059500,12327260785.662200,8991513115.764504,27822922081.486204,1129077,576441,1212887,2918405
2018-09-11,NASDAQ (Q),315159839,130856008,535597676,981613523,16088284708.718402,8086509944.855797,32040606661.127372,56215401314.701571,2820317,524004,3269211,6613532
2018-09-11,IEX (V),92346699,14914774,59820438,167081911,4439117186.438499,829256418.673100,3405104697.541801,8673478302.653400,648181,66862,413300,1128343
2018-09-11,NASDAQ PSX (X),13452073,16211742,15024304,44688119,564217484.057700,1211952976.492200,1139905169.130700,2916075629.680600,119860,65097,129069,314026
2018-09-11,BYX Equities (Y),150189111,66350487,83634487,300174085,5138799284.703800,2891753124.354500,3467511892.666200,11498064301.724500,1373305,343186,799006,2515497
2018-09-11,BZX Equities (Z),170477071,82867745,130810444,384155260,7332749392.677201,5280200362.307799,7546806479.338303,20159756234.323303,1602949,397696,1136747,3137392
2018-09-10,NYSE American (A),4410820,11157283,2952669,18520772,218207635.539400,129656674.649500,211065835.056900,558930145.245800,47132,32701,29412,109245
2018-09-10,NASDAQ BX (B),92632102,21184053,52442700,166258855,4752398113.856000,1151592071.210400,3074609795.959900,8978599981.026300,1029096,110808,605487,1745391
2018-09-10,NYSE National (C),30514745,12248724,16445435,59208904,942351167.539800,430364073.970100,672276780.133800,2044992021.643700,288195,56116,169591,513902
2018-09-10,FINRA / NYSE TRF (DN),142737392,55852272,247250624,445840288,5530573317.419000,1816086199.157600,10285356596.418804,17632016112.995404,375523,134465,541766,1051754
2018-09-10,FINRA / Nasdaq TRF Carteret (DQ),788202011,264595876,615291474,1668089361,33537889501.733995,15578412513.067799,29647566866.476578,78763868881.278372,3279824,727230,2226008,6233062
2018-09-10,EDGA Equities (J),32477066,16542047,24325119,73344232,1465735392.948700,1058246035.799300,1227786279.537500,3751767708.285500,324003,80482,200331,604816
2018-09-10,EDGX Equities (K),107310267,45339133,146464056,299113456,4908610200.182799,2437448775.401099,5810046277.341199,13156105252.925097,906388,189161,798416,1893965
2018-09-10,CHX (M),11121724,6762063,6861882,24745669,475420802.396000,693927474.607000,698582257.005000,1867930534.008000,4164,4325,4664,13153
2018-09-10,NYSE (N),700238827,17030138,24980356,742249321,31458802145.451692,1260155527.881100,1328635674.357400,34047593347.690192,2171853,60759,184387,2416999
2018-09-10,NYSE Arca (P),137838123,197803800,161549122,497191045,6615467539.264902,10808618275.543297,8385499667.537105,25809585482.345304,1119760,519976,1163286,2803022
2018-09-10,NASDAQ (Q),298584673,108427238,508841884,915853795,16298383735.485001,7048462097.622403,32535687010.060771,55882532843.168175,2831556,483361,3285670,6600587
2018-09-10,IEX (V),87765327,12926891,51727512,152419730,4166546401.575300,672618264.654000,3294486439.016501,8133651105.245801,616241,57317,379738,1053296
2018-09-10,NASDAQ PSX (X),12422413,12475800,13039582,37937795,548565765.279300,992775277.470600,971968092.246500,2513309134.996400,116995,53942,117748,288685
2018-09-10,BYX Equities (Y),139574327,53765429,69204307,262544063,4682675146.792800,2377766927.743100,2990941874.972701,10051383949.508601,1278217,292823,714307,2285347
2018-09-10,BZX Equities (Z),165270964,69897695,114058165,349226824,7617860357.630200,4508459796.530602,6673926444.032199,18800246598.193001,1620673,351361,1087926,3059960
2018-09-07,NYSE American (A),4636020,11473655,2882383,18992058,230450398.600000,141697632.841200,176002966.709200,548150998.150400,49307,32699,28742,110748
2018-09-07,NASDAQ BX (B),101193230,26994584,55972625,184160439,4872078746.982900,1574640626.048600,3323025369.841199,9769744742.872699,1053168,144991,621667,1819826
2018-09-07,NYSE National (C),36049572,15447531,18432267,69929370,1110325164.417800,553724638.931000,774801940.126500,2438851743.475300,344599,78758,191887,615244
2018-09-07,FINRA / NYSE TRF (DN),157269703,73276328,240179738,470725769,5503012427.275600,2401742491.902899,11383830038.100797,19288584957.279296,382024,143238,542093,1067355
2018-09-07,FINRA / Nasdaq TRF Carteret (DQ),844885783,309087172,661613923,1815586878,35671317402.364099,18588640231.194499,35437936314.877386,89697893948.435984,3291045,724263,2336661,6351969
2018-09-07,EDGA Equities (J),34385014,20884341,23802659,79072014,1451510684.927400,1349452390.114300,1393184015.563100,4194147090.604800,330935,100203,202360,633498
2018-09-07,EDGX Equities (K),122042703,63348446,137953402,323344551,5180232600.986102,3601227108.905301,6668159799.103901,15449619508.995304,970012,255448,835655,2061115
2018-09-07,CHX (M),11152864,11852782,8491682,31497328,513352760.956400,1241721447.832500,776895326.613100,2531969535.402000,4800,5653,5434,15887
2018-09-07,NYSE (N),707411690,24883393,26451903,758746986,31138140089.406601,2120508286.476801,1641373823.781200,34900022199.664602,2322454,80768,194935,2598157
2018-09-07,NYSE Arca (P),154212351,253180634,165737364,573130349,6973372511.334897,14450265866.833595,9817766257.994999,31241404636.163491,1190095,680523,1219019,3089637
2018-09-07,NASDAQ (Q),339485406,155139865,540583583,1035208854,17379635046.434699,10337089749.976002,36046844542.233491,63763569338.644192,3066447,658286,3455207,7179940
2018-09-07,IEX (V),94643911,15964584,54945131,165553626,4471994836.173400,978523767.875100,3463086577.808201,8913605181.856701,657902,65117,388226,1111245
2018-09-07,NASDAQ PSX (X),14885999,19997180,15772984,50656163,620602667.934100,1605696548.716001,1351729728.616300,3578028945.266401,127569,81863,131061,340493
2018-09-07,BYX Equities (Y),162858005,64233110,78981462,306072577,5627923126.484400,3004489439.673400,3589694653.531899,12222107219.689699,1470358,349920,793490,2613768
2018-09-07,BZX Equities (Z),191471415,99632980,127135366,418239761,8285509450.190999,6808425055.108199,8441785536.515496,23535720041.814694,1788806,492993,1172641,3454440
2018-09-06,NYSE American (A),4664475,11580912,3241835,19487222,226512567.908900,134814829.308500,205688692.303400,567016089.520800,51342,33716,31664,116722
2018-09-06,NASDAQ BX (B),100736067,28864981,58396303,187997351,5032301871.660800,1580475848.694500,3548888852.095701,10161666572.451001,1088595,142570,648788,1879953
2018-09-06,NYSE National (C),33605026,17520149,18110215,69235390,1056297067.634800,577000000.261100,738828914.739400,2372125982.635300,325926,77146,181085,584157
2018-09-06,FINRA / NYSE TRF (DN),178887804,77335644,265148910,521372358,6025160483.379199,2627256829.581900,13267146074.287701,21919563387.248800,403161,149617,613588,1166366
2018-09-06,FINRA / Nasdaq TRF Carteret (DQ),885359062,325422765,727121970,1937903797,36380647836.325189,17567433539.512494,38106083280.816419,92054164656.654102,3473659,747852,2518379,6739890
2018-09-06,EDGA Equities (J),37659352,23371253,27088222,88118827,1502061169.007900,1321569270.043800,1436884304.950700,4260514744.002400,340946,107565,210585,659096
2018-09-06,EDGX Equities (K),131151617,64591937,165714068,361457622,5510123086.822299,3575091849.799399,7264595267.952899,16349810204.574597,1030718,265115,887240,2183073
2018-09-06,CHX (M),14074495,14406695,10950805,39431995,756008472.741600,1336088553.530000,1410975612.094500,3503072638.366100,4074,6771,6173,17018
2018-09-06,NYSE (N),772794949,25640423,33289506,831724878,34133014585.442794,2051250740.312500,1820158842.497600,38004424168.252894,2528143,81938,223932,2834013
2018-09-06,NYSE Arca (P),161730174,253976841,183846146,599553161,7290535157.073700,14676167961.070701,10512076020.499798,32478779138.644199,1250917,718414,1325485,3294816
2018-09-06,NASDAQ (Q),355298406,153838525,585789465,1094926396,18148297250.801399,10127476413.111100,38580188221.592894,66855961885.505393,3296397,667531,3767080,7731008
2018-09-06,IEX (V),97746304,17263026,60134358,175143688,4740710913.793600,982947425.166700,3796292133.894300,9519950472.854600,695613,69084,424288,1188985
2018-09-06,NASDAQ PSX (X),14523927,19140869,16367053,50031849,618702580.521600,1523167221.175800,1356762677.950800,3498632479.648200,129965,79425,131087,340477
2018-09-06,BYX Equities (Y),161135201,67166179,79580835,307882215,5413057327.559801,2870878377.811099,3562559516.505600,11846495221.876500,1469710,345311,795329,2610350
2018-09-06,BZX Equities (Z),194875864,101452082,140603190,436931136,8559259827.197497,7037921606.477697,9070778189.837100,24667959623.512294,1881118,498873,1256279,3636270
2018-09-05,NYSE American (A),5231935,11907487,3796476,20935898,262618869.645000,128837936.592700,234465519.361500,625922325.599200,55866,35603,35447,126916
2018-09-05,NASDAQ BX (B),105831881,30232371,62709247,198773499,5286836181.679900,1743936655.742300,3770934796.213001,10801707633.635201,1143023,146352,686204,1975579
2018-09-05,NYSE National (C),38638404,14885875,20321942,73846221,1235395723.912800,513403102.394000,898471439.070200,2647270265.377000,380989,71423,207660,660072
2018-09-05,FINRA / NYSE TRF (DN),175827001,79352591,315643042,570822634,6720664217.082801,2406868775.405000,14591202254.610893,23718735247.098694,463528,162271,716531,1342330
2018-09-05,FINRA / Nasdaq TRF Carteret (DQ),901342188,383279290,768190463,2052811941,39974596614.334002,21813725292.834900,39029668000.113902,100817989907.282804,3633368,896831,2680737,7210936
2018-09-05,EDGA Equities (J),37810791,22739835,30243338,90793964,1608264168.101500,1507292973.119500,1679340056.373800,4794897197.594800,360072,100608,240517,701197
2018-09-05,EDGX Equities (K),133720630,60857990,191702480,386281100,6097990782.857100,3413677556.940000,7858807935.755400,17370476275.552500,1126887,240383,971260,2338530
2018-09-05,CHX (M),8759351,14052699,8126502,30938552,622725324.031000,1336498144.786800,1710318033.845100,3669541502.662900,5091,5217,5600,15908
2018-09-05,NYSE (N),814575786,22198960,33355230,870129976,36647966932.388407,1960786349.583900,1762908533.492400,40371661815.464707,2501570,78639,235802,2816011
2018-09-05,NYSE Arca (P),170233820,265316396,195442484,630992700,8062039284.862002,16108815367.456600,10941870232.470110,35112724884.788712,1395542,679361,1401048,3475951
2018-09-05,NASDAQ (Q),369242844,146974657,646086021,1162303522,19989447601.905502,10248143231.740499,41270410790.582602,71508001624.228603,3506375,623244,3980623,8110242
2018-09-05,IEX (V),96348882,18272834,65355808,179977524,4700883302.184700,1016726915.586300,4051853371.306201,9769463589.077201,691458,77225,446822,1215505
2018-09-05,NASDAQ PSX (X),15705317,19443229,16245583,51394129,675614934.827000,1683585630.987300,1273354619.986200,3632555185.800500,141898,77671,139457,359026
2018-09-05,BYX Equities (Y),169987704,69495530,85092075,324575309,5769872639.202799,3084999819.359700,3869837559.278003,12724710017.840502,1544573,343504,847968,2736045
2018-09-05,BZX Equities (Z),205525669,91989903,160504893,458020465,9410575396.478299,6492257777.821303,9729306885.075502,25632140059.375104,2078406,448846,1381845,3909097
2018-09-04,NYSE American (A),5230759,12497341,3233525,20961625,234170657.104000,129489183.356400,189014582.889100,552674423.349500,54272,37642,30272,122186
2018-09-04,NASDAQ BX (B),102328742,32750280,60281263,195360285,5077857489.327900,1730187687.858500,3464260402.925800,10272305580.112200,1119256,157488,659851,1936595
2018-09-04,NYSE National (C),36676294,16805538,19010754,72492586,1067564231.074000,540493506.223400,756072254.271600,2364129991.569000,359140,65881,195615,620636
2018-09-04,FINRA / NYSE TRF (DN),176801435,83752949,261856999,522411383,5969067903.634102,2764591312.657900,12462902280.567104,21196561496.859106,437860,174668,610656,1223184
2018-09-04,FINRA / Nasdaq TRF Carteret (DQ),874520481,390291363,681627610,1946439454,34874530421.237003,20974279150.100600,34987595325.165619,90836404896.503222,3473200,898980,2467320,6839500
2018-09-04,EDGA Equities (J),36440010,23570193,24368254,84378457,1536517558.312700,1354522361.303400,1339589031.495200,4230628951.111300,357182,107174,209037,673393
2018-09-04,EDGX Equities (K),130431140,63718048,151763436,345912624,5695425696.238798,3345475959.851500,6999191948.735599,16040093604.825897,1077826,255417,892266,2225509
2018-09-04,CHX (M),10437937,10347579,7090396,27875912,515502522.681000,1030849177.389200,693178625.860500,2239530325.930700,4398,6511,6049,16958
2018-09-04,NYSE (N),759693128,23356070,31591269,814640467,32642497272.973202,1710962725.085600,1625156935.110700,35978616933.169502,2432931,78075,219515,2730521
2018-09-04,NYSE Arca (P),158970750,297487641,163364044,619822435,7085816879.698198,15291829624.952699,9471241652.743003,31848888157.393900,1264095,679729,1231428,3175252
2018-09-04,NASDAQ (Q),333388459,144066572,557104798,1034559829,17198870606.434293,9163084821.430098,35072762565.841513,61434717993.705904,3081322,596892,3528621,7206835
2018-09-04,IEX (V),96544564,20458782,57716974,174720320,4382482118.739800,1081295996.565600,3414549681.142501,8878327796.447901,674768,79013,399098,1152879
2018-09-04,NASDAQ PSX (X),14564770,18691713,14925814,48182297,584505254.282600,1403556935.387300,1018730205.528000,3006792395.197900,132801,73966,120018,326785
2018-09-04,BYX Equities (Y),162219180,70627309,79371464,312217953,5367005061.518400,2984399901.026000,3533522017.061700,11884926979.606100,1471887,341044,808994,2621925
2018-09-04,BZX Equities (Z),189178430,93186746,125412698,407777874,8221854447.214902,6020150383.761396,7742320554.904001,21984325385.880299,1953301,457463,1210864,3621628
2018-08-31,NYSE American (A),4228664,11397915,2867510,18494089,191774963.837000,140398092.841600,155232569.579400,487405626.258000,45237,31946,26395,103578
2018-08-31,NASDAQ BX (B),96699737,28448232,50891672,176039641,4625462828.570700,1599612497.723600,2902422680.674699,9127498006.968999,1029166,132510,587068,1748744
2018-08-31,NYSE National (C),32921821,13417871,15879270,62218962,976987094.175900,480331758.875500,662727091.666500,2120045944.717900,313820,63177,162138,539135
2018-08-31,FINRA / NYSE TRF (DN),159203554,67081186,206054273,432339013,5185906098.174300,2046935162.941100,10118252343.557496,17351093604.672896,375570,140042,495472,1011084
2018-08-31,FINRA / Nasdaq TRF Carteret (DQ),773815552,281151089,578673900,1633640541,31998048951.599096,18451698777.166095,31298091838.321802,81747839567.086993,2925751,632099,1986851,5544701
2018-08-31,EDGA Equities (J),32074822,18646993,18935640,69657455,1301781817.218100,1122802640.530600,1120446469.693500,3545030927.442200,302833,84052,167891,554776
2018-08-31,EDGX Equities (K),120363664,57936930,126260821,304561415,4911641998.629700,3135187222.219300,6131634760.765602,14178463981.614602,941787,212258,733175,1887220
2018-08-31,CHX (M),8652531,11730025,6062271,26444827,429364058.373000,1015866691.100000,594282232.089700,2039512981.562700,3358,4010,4061,11429
2018-08-31,NYSE (N),833414763,21618522,22374539,877407824,38266855528.209399,1692364366.449500,1190714368.568400,41149934263.227299,2038616,63507,161477,2263600
2018-08-31,NYSE Arca (P),136473819,237535736,127522527,501532082,5828220380.908699,13802659140.851297,7849203040.499901,27480082562.259897,1050616,564076,971181,2585873
2018-08-31,NASDAQ (Q),286951030,129058269,519671429,935680728,14478983307.006998,8578562744.137098,34888355093.518807,57945901144.662903,2649051,514558,2847758,6011367
2018-08-31,IEX (V),81025666,14262074,45468502,140756242,3592217472.765500,827122193.926800,2795010142.674500,7214349809.366800,593602,57476,337844,988922
2018-08-31,NASDAQ PSX (X),12509983,16601378,11311325,40422686,510850058.531000,1291903458.587101,986281596.939400,2789035114.057501,113446,61184,95298,269928
2018-08-31,BYX Equities (Y),146613074,64596123,72960546,284169743,4920635621.194400,2889677489.621100,3138235581.524699,10948548692.340199,1337809,303357,733212,2374378
2018-08-31,BZX Equities (Z),162272111,83505089,101972579,347749779,6907021283.897901,5434736510.397501,6865784009.637203,19207541803.932605,1577148,385159,979604,2941911
2018-08-30,NYSE American (A),4427189,11126553,3324928,18878670,195736751.145200,115134274.312100,166525555.625400,477396581.082700,47056,36023,28203,111282
2018-08-30,NASDAQ BX (B),93272432,32175820,54190322,179638574,4535994351.338900,1797784038.607400,3183653774.179801,9517432164.126101,1009506,156361,608306,1774173
2018-08-30,NYSE National (C),31434045,16372401,15226079,63032525,926404277.242600,570141023.721600,621430901.885000,2117976202.849200,291662,72708,157725,522095
2018-08-30,FINRA / NYSE TRF (DN),178029242,78318478,240616762,496964482,6526788104.562702,2276959537.350601,13279220784.359909,22082968426.273212,415174,159097,592492,1166763
2018-08-30,FINRA / Nasdaq TRF Carteret (DQ),800967020,327039911,620910764,1748917695,32950604543.476493,18100274194.469302,33240038315.194207,84290917053.140002,3126249,736125,2214085,6076459
2018-08-30,EDGA Equities (J),32892194,20982865,22493142,76368201,1316293475.815000,1300279151.838900,1251628924.238600,3868201551.892500,315505,93916,185190,594611
2018-08-30,EDGX Equities (K),133476293,67006178,153008585,353491056,5575155247.266500,3599340458.698599,7180827608.689897,16355323314.654996,1000889,259399,836922,2097210
2018-08-30,CHX (M),34184890,15723838,4631752,54540480,1049394410.890000,1240935279.730000,613565056.351400,2903894746.971400,3950,6580,4744,15274
2018-08-30,NYSE (N),615303743,25258363,25442150,666004256,25620867590.811195,1834751425.345200,1459081932.590100,28914700948.746495,2163965,78497,182571,2425033
2018-08-30,NYSE Arca (P),144775804,271824746,152125043,568725593,6476188907.459600,14802454110.028909,9729499361.314903,31008142378.803412,1137759,662141,1128646,2928546
2018-08-30,NASDAQ (Q),320445490,158559651,478452036,957457177,16521028201.489298,9947678503.975899,31842053282.534404,58310759987.999601,3014764,630156,3282717,6927637
2018-08-30,IEX (V),80612416,16500211,47347250,144459877,3809878181.898500,987557938.748800,3089049774.649300,7886485895.296600,572309,67042,343711,983062
2018-08-30,NASDAQ PSX (X),13306396,18493128,13505854,45305378,535099659.100000,1391537850.516000,1148804716.420300,3075442226.036300,122272,71504,114221,307997
2018-08-30,BYX Equities (Y),147740098,74549787,73811783,296101668,4844087279.747300,3254880567.016900,3173469953.458600,11272437800.222800,1349131,353818,736202,2439151
2018-08-30,BZX Equities (Z),179584719,98806676,117634661,396026056,7798395794.543599,6502152124.680998,8037568224.679800,22338116143.904397,1700098,464226,1092449,3256773
2018-08-29,NYSE American (A),4258006,11959361,3356322,19573689,194932748.000000,124715555.465500,177191070.347100,496839373.812600,44638,33525,27068,105231
2018-08-29,NASDAQ BX (B),90802760,24052728,50592642,165448130,4550236983.195300,1352968552.697500,3016632381.907700,8919837917.800500,984170,111830,578305,1674305
2018-08-29,NYSE National (C),30082414,12813728,14347230,57243372,875598811.010000,395882674.361100,595570451.525700,1867051936.896800,284644,53339,147396,485379
2018-08-29,FINRA / NYSE TRF (DN),171536005,70323889,231072180,472932074,6297804317.106004,2045654144.323201,11305220995.364207,19648679456.793412,416375,155357,544165,1115897
2018-08-29,FINRA / Nasdaq TRF Carteret (DQ),832313175,292999584,604754801,1730067560,33675037452.266397,20712039638.769800,31677288694.661896,86064365785.698093,3256747,642956,2115592,6015295
2018-08-29,EDGA Equities (J),31036300,16492218,19538879,67067397,1243340267.036700,952711713.870600,1034046815.466100,3230098796.373400,299745,75479,168334,543558
2018-08-29,EDGX Equities (K),126388653,55757878,130773247,312919778,5333531040.820400,2683824373.816500,6222825262.920702,14240180677.557602,962510,202715,731451,1896676
2018-08-29,CHX (M),23112629,11875043,11541556,46529228,873802767.100000,898778348.545000,746825623.133500,2519406738.778500,3060,3223,3693,9976
2018-08-29,NYSE (N),649368862,19384797,22834028,691587687,27955611245.511198,1560264393.527200,1199026184.593100,30714901823.631498,2059209,60166,163776,2283151
2018-08-29,NYSE Arca (P),140013397,199514196,130574937,470102530,6219582960.383798,11239756743.916901,7830978747.569295,25290318451.869994,1073191,500291,978748,2552230
2018-08-29,NASDAQ (Q),297403786,117788272,458948510,874140568,15404012134.853502,7656244290.224500,30100343748.490975,53160600173.568977,2777523,479772,2819597,6076892
2018-08-29,IEX (V),83766195,12749508,44299212,140814915,3763133382.903200,791155159.536200,2710946644.785500,7265235187.224900,580171,54129,316518,950818
2018-08-29,NASDAQ PSX (X),12324598,14151794,11426877,37903269,490419294.615600,1157275694.639100,874531506.020800,2522226495.275500,110258,54284,94326,258868
2018-08-29,BYX Equities (Y),145022371,56367976,72756114,274146461,4869979493.166500,2435554114.951900,2978037800.712100,10283571408.830500,1329541,280851,721045,2331437
2018-08-29,BZX Equities (Z),168097448,69558277,103066199,340721924,7312621514.633099,4611223452.708201,6298164434.694500,18222009402.035800,1593055,328886,956856,2878797
2018-08-28,NYSE American (A),3821898,10461151,2544365,16827414,179311811.928200,115147906.011100,150938232.011600,445397949.950900,40819,31175,24323,96317
2018-08-28,NASDAQ BX (B),90869043,24203096,49910415,164982554,4543443258.338600,1402697443.080000,2589524520.565000,8535665221.983600,987357,126963,558751,1673071
2018-08-28,NYSE National (C),29856942,13207478,15839531,58903951,938752813.394800,465528590.529500,581062516.336100,1985343920.260400,280985,63689,161484,506158
2018-08-28,FINRA / NYSE TRF (DN),164334330,72719174,248708701,485762205,5913323243.509903,2081440908.299400,9836281795.966097,17831045947.775400,405581,156174,552503,1114258
2018-08-28,FINRA / Nasdaq TRF Carteret (DQ),793024704,269928795,597276844,1660230343,32804439665.285894,15432660835.013594,27947863044.392003,76184963544.691491,3042430,647212,2038169,5727811
2018-08-28,EDGA Equities (J),29748395,16634709,19917059,66300163,1225433600.449800,981736303.814000,989591125.289300,3196761029.553100,292798,80090,172684,545572
2018-08-28,EDGX Equities (K),117798362,52427948,144857800,315084110,5140081517.964000,2644672875.417399,5851529332.844600,13636283726.225999,906851,210143,760957,1877951
2018-08-28,CHX (M),11410971,13928830,12526829,37866630,632758821.479800,1286713956.674200,796783326.540100,2716256104.694100,2551,4352,4368,11271
2018-08-28,NYSE (N),617326051,18489545,24128342,659943938,27174364694.852601,1378033904.455600,1195211825.522200,29747610424.830401,1944558,58877,177287,2180722
2018-08-28,NYSE Arca (P),134344045,211108209,140416449,485868703,6222627218.853599,11276994769.568007,7206183255.816796,24705805244.238402,1047066,514333,999809,2561208
2018-08-28,NASDAQ (Q),305936176,122324328,486405205,914665709,16277196275.219894,7648650977.587504,28637828769.971392,52563676022.778790,2918336,546765,3037994,6503095
2018-08-28,IEX (V),74156243,13243217,45389538,132788998,3526176991.444800,767940454.435900,2474956967.282100,6769074413.162800,529876,56723,316924,903523
2018-08-28,NASDAQ PSX (X),12651990,13656642,12023023,38331655,505439896.605000,973946587.717000,790870580.414900,2270257064.736900,110522,54916,101916,267354
2018-08-28,BYX Equities (Y),139186487,57694856,73215290,270096633,4727292009.389500,2500699975.262100,2812010177.512800,10040002162.164400,1303927,298968,701665,2304560
2018-08-28,BZX Equities (Z),163312118,76120574,107113044,346545736,7242821609.173200,4768684333.568800,5962803897.931000,17974309840.673000,1579797,353400,946306,2879503
2018-08-27,NYSE American (A),4300694,12521407,2775942,19598043,190287845.699900,155382285.535400,175832103.154400,521502234.389700,44991,34212,26566,105769
2018-08-27,NASDAQ BX (B),87680950,27717543,49125974,164524467,4220742954.483900,1609754919.426700,2664178452.435800,8494676326.346400,917240,128214,549064,1594518
2018-08-27,NYSE National (C),29451272,13809600,15954193,59215065,895516194.015400,509020547.306200,596440980.747200,2000977722.068800,279063,63673,168286,511022
2018-08-27,FINRA / NYSE TRF (DN),174761744,76949834,305378657,557090235,6335464358.935100,2345345464.837999,12432311197.379100,21113121021.152199,449724,172403,642557,1264684
2018-08-27,FINRA / Nasdaq TRF Carteret (DQ),857102057,313620031,704819842,1875541930,35335145375.796495,18757684393.781498,32350268579.451074,86443098349.029067,3196864,719368,2238101,6154333
2018-08-27,EDGA Equities (J),31687467,18499484,25080142,75267093,1271029642.839700,1105835930.892600,1085610923.861500,3462476497.593800,299334,82428,192110,573872
2018-08-27,EDGX Equities (K),126485487,61981912,215650979,404118378,5612387418.263303,3115940335.054900,6385787762.804397,15114115516.122600,960306,232508,826603,2019417
2018-08-27,CHX (M),5180722,9404267,6501802,21086791,358984761.127000,1147310057.983300,1621847160.810700,3128141979.921000,3595,5197,4675,13467
2018-08-27,NYSE (N),709034716,19333247,28653291,757021254,30614449947.261398,1408263235.094600,1333453993.331800,33356167175.687798,2057728,63807,199846,2321381
2018-08-27,NYSE Arca (P),138013967,242190447,179307581,559511995,6424527155.510900,13171403617.467895,8224239218.915296,27820169991.894091,1088502,562585,1105136,2756223
2018-08-27,NASDAQ (Q),307077950,129827888,544152337,981058175,16209052692.683803,8312107633.717100,31231637687.412307,55752798013.813210,2870601,549208,3233286,6653095
2018-08-27,IEX (V),74849909,15949756,45033690,135833355,3506295855.076900,966545386.255500,2417390499.798100,6890231741.130500,522403,66215,312617,901235
2018-08-27,NASDAQ PSX (X),13720878,15595195,15685138,45001211,555528703.210000,1149487385.429800,970457087.639900,2675473176.279700,119383,61515,120183,301081
2018-08-27,BYX Equities (Y),140888233,64086163,71925458,276899854,4640007484.839700,2759180305.837400,2846462520.815300,10245650311.492400,1290695,307908,737887,2336490
2018-08-27,BZX Equities (Z),164843047,78075793,123750042,366668882,7313627835.723301,5041190392.976901,6497111057.683999,18851929286.384201,1572838,361120,1061842,2995800
2018-08-24,NYSE American (A),3933390,9532918,2420253,15886561,173169493.800000,105572541.237200,136572880.908500,415314915.945700,42633,29066,24930,96629
2018-08-24,NASDAQ BX (B),84367552,24822350,47537447,156727349,4067989389.191800,1414674559.720500,2597950200.216100,8080614149.128400,943651,124129,546259,1614039
2018-08-24,NYSE National (C),26315466,13452679,14411197,54179342,789518518.461500,449311508.634700,550091362.097300,1788921389.193500,261161,60903,147721,469785
2018-08-24,FINRA / NYSE TRF (DN),168679440,72790495,229554457,471024392,6109333125.533398,2455311535.125300,9415099222.270499,17979743882.929197,403322,147334,528904,1079560
2018-08-24,FINRA / Nasdaq TRF Carteret (DQ),772855821,288338853,582317018,1643511692,33485681040.920182,16356920019.619805,27712701063.976303,77555302124.516290,2850713,635946,1914956,5401615
2018-08-24,EDGA Equities (J),31558516,18149562,19241099,68949177,1255134924.207300,1078053374.987000,974070638.145100,3307258937.339400,305353,85457,168162,558972
2018-08-24,EDGX Equities (K),122176267,54715002,158029691,334920960,5354909363.842600,2867036172.458098,5660980504.975602,13882926041.276300,943093,206328,765819,1915240
2018-08-24,CHX (M),5154752,7910259,6764708,19829719,241663745.607700,798843900.377000,580458735.226600,1620966381.211300,2791,3880,3669,10340
2018-08-24,NYSE (N),611302476,18469039,23150531,652922046,26810436736.330003,1273993931.449900,1179056854.980400,29263487522.760303,1945223,57205,169076,2171504
2018-08-24,NYSE Arca (P),129375491,225206143,127588905,482170539,6019919771.297701,11752148781.236196,6674000835.201600,24446069387.735497,1017259,524143,947197,2488599
2018-08-24,NASDAQ (Q),280679154,122306539,464539004,867524697,14485081023.352006,8166989170.506900,27304588116.244202,49956658310.103108,2673399,523477,2817694,6014570
2018-08-24,IEX (V),72833235,13383687,43548973,129765895,3415219727.605000,795831043.919800,2376860074.496500,6587910846.021300,514709,56710,304930,876349
2018-08-24,NASDAQ PSX (X),12232839,14703227,12190925,39126991,491193488.549000,1074601559.122400,855350241.367300,2421145289.038700,106469,57800,95978,260247
2018-08-24,BYX Equities (Y),131590460,56748993,64745342,253084795,4280808338.360200,2470007020.473000,2672132304.028300,9422947662.861500,1222186,297321,673689,2193196
2018-08-24,BZX Equities (Z),149957455,73170780,96956141,320084376,6483808349.398902,4660287090.187100,5654032211.878201,16798127651.464203,1479425,354812,892112,2726349
2018-08-23,NYSE American (A),4000377,8894736,2575986,15471099,181390732.785000,96639892.094600,155794000.460200,433824625.339800,41745,27581,26179,95505
2018-08-23,NASDAQ BX (B),87319758,25001383,46740695,159061836,4378850885.197799,1347708814.253400,2662713065.499100,8389272764.950299,949447,120244,531162,1600853
2018-08-23,NYSE National (C),28414236,12760512,15533832,56708580,877141000.380500,435226837.421800,544900729.666700,1857268567.469000,280278,61441,156062,497781
2018-08-23,FINRA / NYSE TRF (DN),168817461,70345207,203315135,442477803,7510314959.311997,2278767014.456900,9439471626.752499,19228553600.521396,413057,138707,452142,1003906
2018-08-23,FINRA / Nasdaq TRF Carteret (DQ),821446271,307360934,582624816,1711432021,35192366980.241208,16861236571.876801,27301521923.565099,79355125475.683108,3116029,648523,1936209,5700761
2018-08-23,EDGA Equities (J),30156081,17669338,19035602,66861021,1239531743.217200,1005791654.902000,996084782.410900,3241408180.530100,291948,85165,161903,539016
2018-08-23,EDGX Equities (K),124630542,52951426,168433394,346015362,5713500121.093501,2699056082.130800,5590295463.581402,14002851666.805703,944535,204442,710462,1859439
2018-08-23,CHX (M),15492994,8643682,17079138,41215814,601352274.641900,788129312.645000,1056045081.268900,2445526668.555800,3413,4122,4522,12057
2018-08-23,NYSE (N),620947313,19217201,22818850,662983364,27068886526.019702,1193860909.173300,1100942821.725900,29363690256.918902,2036828,61406,162621,2260855
2018-08-23,NYSE Arca (P),141828334,228281562,129223286,499333182,6935325627.482000,11387127368.990901,6785847907.258398,25108300903.731299,1088836,532600,942614,2564050
2018-08-23,NASDAQ (Q),295392394,123696603,462921670,882010667,15815005981.626997,7584188387.233003,28007359533.903702,51406553902.763702,2796335,522950,2878959,6198244
2018-08-23,IEX (V),80524559,12946272,42348960,135819791,4073968308.909500,719999805.567100,2891024260.552201,7684992375.028801,533322,55122,299566,888010
2018-08-23,NASDAQ PSX (X),11857531,14670519,11822639,38350689,496407312.645000,1021618422.645500,836013759.375800,2354039494.666300,106686,54628,95927,257241
2018-08-23,BYX Equities (Y),135182463,60197071,63861505,259241039,4467259451.025200,2504677452.028100,2716144615.855800,9688081518.909100,1233916,317119,672080,2223115
2018-08-23,BZX Equities (Z),158442517,73872719,100271369,332586605,6914771664.732601,4637261526.515600,5934337187.881999,17486370379.130200,1484862,348313,895567,2728742
2018-08-22,NYSE American (A),4409750,10118137,2322778,16850665,199969299.630300,112700932.664700,131967148.872400,444637381.167400,44536,31108,23229,98873
2018-08-22,NASDAQ BX (B),90647002,23039110,47767572,161453684,4331788860.674500,1326457738.656700,2625638337.575600,8283884936.906800,1009008,121993,563118,1694119
2018-08-22,NYSE National (C),24203296,10045138,13107124,47355558,761141493.638000,325003846.908300,441985917.350200,1528131257.896500,238862,46395,129272,414529
2018-08-22,FINRA / NYSE TRF (DN),164636577,72549772,176885002,414071351,6068762036.264799,2287216630.213301,9043636120.757395,17399614787.235495,388178,141364,427126,956668
2018-08-22,FINRA / Nasdaq TRF Carteret (DQ),823285030,262100949,515280765,1600666744,33650338080.925689,14750028941.540901,25503011119.965904,73903378142.432494,3138763,635446,1874590,5648799
2018-08-22,EDGA Equities (J),33996850,17974537,17861836,69833223,1375848525.766100,1084798287.454000,923671131.280800,3384317944.500900,323458,86475,159876,569809
2018-08-22,EDGX Equities (K),122255954,50867931,117737340,290861225,5159665558.808997,2648631321.399799,4964067597.252201,12772364477.460997,920297,210640,665180,1796117
2018-08-22,CHX (M),11075041,11089950,14224266,36389257,867272565.340000,1013196846.810000,977393200.810200,2857862612.960200,3244,5449,3554,12247
2018-08-22,NYSE (N),588031298,16409903,22215078,626656279,24720336224.987998,1083310196.795300,1043310097.280000,26846956519.063298,1895332,63692,154196,2113220
2018-08-22,NYSE Arca (P),140375907,190521858,121099223,451996988,6330060952.310600,9791116280.894005,6411816366.997301,22532993600.201906,1087017,521624,903529,2512170
2018-08-22,NASDAQ (Q),295889158,116725558,409733183,822347899,15016151904.472605,7419054680.140298,25107754719.239896,47542961303.852799,2783053,516125,2737854,6037032
2018-08-22,IEX (V),82776900,11618152,46612828,141007880,3978112477.154000,656345153.689600,2477459658.580700,7111917289.424300,576339,53952,303045,933336
2018-08-22,NASDAQ PSX (X),13326435,12274779,10499980,36101194,548542865.183500,887364903.053400,752967340.086500,2188875108.323400,113842,52992,88559,255393
2018-08-22,BYX Equities (Y),142547216,54288390,61861032,258696638,4516278245.559500,2336159424.190000,2626676376.421099,9479114046.170599,1304696,289339,664134,2258169
2018-08-22,BZX Equities (Z),163799597,66890940,92035235,322725772,7125388646.977199,4257698243.375699,5235772904.374499,16618859794.727397,1527001,340340,868654,2735995
2018-08-21,NYSE American (A),4714747,9835350,2389019,16939116,210725920.886500,129800964.451200,143400421.539600,483927306.877300,44431,31504,24155,100090
2018-08-21,NASDAQ BX (B),97802244,27701781,49572296,175076321,4708579174.299900,1754607076.856600,2845564244.478500,9308750495.635000,1047165,136194,563694,1747053
2018-08-21,NYSE National (C),27399370,13318991,12990842,53709203,848814934.012700,481088588.260300,473130100.913800,1803033623.186800,250690,54688,128934,434312
2018-08-21,FINRA / NYSE TRF (DN),186946287,74272026,181895479,443113792,6776666970.812698,2558108982.090600,9707608928.193403,19042384881.096701,426926,151203,472286,1050415
2018-08-21,FINRA / Nasdaq TRF Carteret (DQ),1008105318,311858161,566619643,1886583122,41421741900.506989,18277904319.548598,30690939406.890900,90390585626.946487,3452324,718318,2054168,6224810
2018-08-21,EDGA Equities (J),36039952,18393084,17471954,71904990,1460302949.089800,1210315613.871500,1019000177.303500,3689618740.264800,342206,90077,162592,594875
2018-08-21,EDGX Equities (K),137679528,58618865,117196868,313495261,5873303191.631000,3446282695.427900,5820272546.636694,15139858433.695594,1066568,221003,754297,2041868
2018-08-21,CHX (M),11076947,14279999,10597622,35954568,675453910.670000,2004277087.816198,1468194242.272400,4147925240.758598,3663,4321,3560,11544
2018-08-21,NYSE (N),735767138,19339142,22460884,777567164,32082099996.894596,1475230725.256500,1205197691.869400,34762528414.020496,2096741,66848,175107,2338696
2018-08-21,NYSE Arca (P),155524610,219532064,128102577,503159251,6987357814.935900,11961521111.223397,7368379539.219800,26317258465.379097,1215492,584020,1009380,2808892
2018-08-21,NASDAQ (Q),327072988,135215248,455972354,918260590,16711997370.732704,9317841643.996397,29466115868.038802,55495954882.767903,3126749,560039,3020772,6707560
2018-08-21,IEX (V),90313543,13985824,44747657,149047024,4178846937.287500,959074126.989800,2802302374.604401,7940223438.881701,633150,59777,329715,1022642
2018-08-21,NASDAQ PSX (X),14234847,16258362,10936463,41429672,573460762.428500,1356936343.351199,867480669.064100,2797877774.843799,123766,63778,100981,288525
2018-08-21,BYX Equities (Y),158200536,64856229,68743868,291800633,5066962670.276900,3032311051.065599,2930077900.184900,11029351621.527399,1426413,342555,707780,2476748
2018-08-21,BZX Equities (Z),183135332,77353750,99171652,359660734,8054761233.322103,5428975441.279001,6002774799.399901,19486511474.001005,1765830,377390,962784,3106004
2018-08-20,NYSE American (A),3943717,9732654,2309823,15986194,175143860.470400,102891820.262300,159651857.059600,437687537.792300,39881,28863,23201,91945
2018-08-20,NASDAQ BX (B),86505469,21526751,46400670,154432890,4214705824.834600,1237850907.620900,2703604825.314700,8156161557.770200,933962,115021,536107,1585090
2018-08-20,NYSE National (C),23083194,10487646,12498732,46069572,656733659.539600,338139562.063800,427433768.872900,1422306990.476300,207246,44647,122382,374275
2018-08-20,FINRA / NYSE TRF (DN),186528192,69738604,178400520,434667316,6263603804.213801,2180981190.613600,10138952591.940798,18583537586.768199,427662,141812,472097,1041571
2018-08-20,FINRA / Nasdaq TRF Carteret (DQ),842073184,271183594,531471552,1644728330,36129770389.737294,15494448724.402492,30270231757.316792,81894450871.456578,3095765,650968,1954643,5701376
2018-08-20,EDGA Equities (J),31306213,16151306,17029528,64487047,1232189568.761100,871673281.720800,923857176.463400,3027720026.945300,305868,82291,158309,546468
2018-08-20,EDGX Equities (K),119001747,47674639,112722403,279398789,5091493776.410400,2426867977.765499,5596686871.031298,13115048625.207197,916338,197775,704629,1818742
2018-08-20,CHX (M),16102546,8186072,15764235,40052853,745759901.420000,823624780.390000,1083040776.219500,2652425458.029500,3028,4067,4060,11155
2018-08-20,NYSE (N),634519366,13816448,21394441,669730255,27189276592.470498,967594228.773299,1214860960.623500,29371731781.867297,1881100,58084,169813,2108997
2018-08-20,NYSE Arca (P),133650187,189006423,125392823,448049433,5897973787.240998,9799051641.816300,7367956352.898796,23064981781.956094,1054934,492749,973479,2521162
2018-08-20,NASDAQ (Q),291251821,112811639,443493927,847557387,14986229423.886996,6813590730.784504,29086022434.287089,50885842588.958589,2790229,509625,2924290,6224144
2018-08-20,IEX (V),79651732,12295340,40378766,132325838,3757971865.315399,709750113.618200,2628487907.517800,7096209886.451399,566424,52827,300409,919660
2018-08-20,NASDAQ PSX (X),12566573,13079090,10295444,35941107,500052401.044000,912005009.081300,791794118.710300,2203851528.835600,110714,54699,93594,259007
2018-08-20,BYX Equities (Y),140650931,55675253,61495131,257821315,4369703816.343600,2310301583.561500,2643532633.356000,9323538033.261100,1286219,309142,640321,2235682
2018-08-20,BZX Equities (Z),156320088,69797007,90458201,316575296,6791476527.371701,4185931021.293499,5629424801.244403,16606832349.909603,1545150,350035,870008,2765193
2018-08-17,NYSE American (A),3918645,14686719,2594365,21199729,175648242.222800,133796601.363400,185656399.797800,495101243.384000,39016,32123,24934,96073
2018-08-17,NASDAQ BX (B),92443345,33152557,51652979,177248881,4378430476.614800,1771792530.972300,3001766501.047900,9151989508.635000,971916,158746,560832,1691494
2018-08-17,NYSE National (C),22646337,11112276,11693358,45451971,655663765.450900,385558060.411000,418006012.076500,1459227837.938400,216315,49529,116854,382698
2018-08-17,FINRA / NYSE TRF (DN),180801719,83524824,184641379,448967922,5799719234.833702,2643054461.012399,10263213682.531294,18705987378.377395,397889,150817,459406,1008112
2018-08-17,FINRA / Nasdaq TRF Carteret (DQ),895288142,369961547,535568913,1800818602,35585608162.093497,20251305581.595311,31450887429.574597,87287801173.263405,3139791,747681,2028553,5916025
2018-08-17,EDGA Equities (J),33727009,22382706,20305005,76414720,1317535827.907800,1182381836.923400,1160513630.487600,3660431295.318800,307836,103599,171294,582729
2018-08-17,EDGX Equities (K),128641970,66167436,127136275,321945681,5333139964.787000,3401513324.279000,6480428942.739901,15215082231.805901,971037,255034,758031,1984102
2018-08-17,CHX (M),9943987,17100041,12300603,39344631,670792449.355900,1317601155.565000,1460838218.483700,3449231823.404600,2931,5612,4613,13156
2018-08-17,NYSE (N),763593562,20843304,24375473,808812339,32587405042.537598,1448187707.372300,1429010987.075000,35464603736.984898,1913931,77934,180690,2172555
2018-08-17,NYSE Arca (P),147432408,277875017,136588926,561896351,6403725887.656400,13715693927.629899,8455690008.514194,28575109823.800493,1116176,652116,1023359,2791651
2018-08-17,NASDAQ (Q),328978429,159984552,515930441,1004893422,16628667505.197499,9844554579.036795,34377369373.494417,60850591457.728711,3071000,674240,3212922,6958162
2018-08-17,IEX (V),84807996,17251327,45333323,147392646,3871503237.697700,1065301163.587000,3075875637.711601,8012680038.996301,590553,68815,336817,996185
2018-08-17,NASDAQ PSX (X),14165434,18678054,12269471,45112959,580506078.200800,1354733648.267400,1118542206.105900,3053781932.574100,114932,73642,104930,293504
2018-08-17,BYX Equities (Y),156085528,77924369,67194525,301204422,4705651481.026000,3175091927.368299,2976659222.187500,10857402630.581799,1361315,384042,678110,2423467
2018-08-17,BZX Equities (Z),175168735,92358371,103193543,370720649,7570921479.673601,5620298358.659600,7112995612.953701,20304215451.286902,1633149,428867,957793,3019809
2018-08-16,NYSE American (A),4794945,10534023,2505123,17834091,207639339.179200,111987457.283200,155225518.456600,474852314.919000,44657,33215,25455,103327
2018-08-16,NASDAQ BX (B),98335501,32899331,51354348,182589180,4660918512.558300,1760873038.662000,2889527318.311200,9311318869.531500,1015969,149805,570942,1736716
2018-08-16,NYSE National (C),25201376,11185990,12446019,48833385,740274549.217500,391917821.032800,442549076.069500,1574741446.319800,244077,51777,130033,425887
2018-08-16,FINRA / NYSE TRF (DN),196977119,88187394,201497952,486662465,6760015371.853701,2888264857.302999,9366952501.126100,19015232730.282800,431541,154994,462583,1049118
2018-08-16,FINRA / Nasdaq TRF Carteret (DQ),986883994,367043829,614280224,1968208047,40847647454.484414,20640695739.968399,31088484000.023299,92576827194.476112,3577937,807929,2133147,6519013
2018-08-16,EDGA Equities (J),38220970,21407406,21093760,80722136,1480957943.890800,1332717188.620600,1107108086.953300,3920783219.464700,345275,104766,182032,632073
2018-08-16,EDGX Equities (K),145654636,64946503,153714335,364315474,6143242051.137898,3616253852.337699,6020434719.982802,15779930623.458399,1066342,244041,761583,2071966
2018-08-16,CHX (M),21218642,20465762,8655426,50339830,1343886543.391200,1994215086.327000,1482985540.880600,4821087170.598800,3348,5978,3731,13057
2018-08-16,NYSE (N),706450803,20360878,25141901,751953582,29604405344.913701,1537581757.452200,1312865947.663500,32454853050.029401,2082082,74075,180068,2336225
2018-08-16,NYSE Arca (P),173838308,282472795,154834550,611145653,7644501633.771901,14797764490.742300,8175395839.978903,30617661964.493104,1297460,668599,1079837,3045896
2018-08-16,NASDAQ (Q),350814877,148981476,504479968,1004276321,18239356231.822598,9760024108.409303,30530395850.245421,58529776190.477322,3269856,644233,3187035,7101124
2018-08-16,IEX (V),101037929,19782173,50404403,171224505,4619440163.524200,1082181561.138600,3123079831.402000,8824701556.064800,672196,74780,352477,1099453
2018-08-16,NASDAQ PSX (X),14208457,18890902,12178102,45277461,570163293.684100,1415899238.674000,906359416.115400,2892421948.473500,122875,72653,105393,300921
2018-08-16,BYX Equities (Y),170738344,79279921,71350370,321368635,5173937756.040000,3281506890.424300,2923140514.777200,11378585161.241500,1440795,387658,716604,2545057
2018-08-16,BZX Equities (Z),197627480,88001752,107479622,393108854,8615246200.669900,5708978381.369099,6356681132.653101,20680905714.692100,1847695,399044,1005938,3252677
2018-08-15,NYSE American (A),6191230,15812179,3355886,25359295,292863466.177000,251604697.035300,193963866.535700,738432029.748000,62634,51897,32980,147511
2018-08-15,NASDAQ BX (B),117082917,48338007,61650563,227071487,5548940458.357700,2590864853.749899,3423292090.552499,11563097402.660098,1218451,221015,653700,2093166
2018-08-15,NYSE National (C),28599055,17197613,14772733,60569401,887954972.926500,588505810.676300,547255323.052500,2023716106.655300,297018,80180,147498,524696
2018-08-15,FINRA / NYSE TRF (DN),239331022,123231525,234119008,596681555,7462374629.592004,3679274114.374500,11200624242.001001,22342272985.967505,500803,213070,534245,1248118
2018-08-15,FINRA / Nasdaq TRF Carteret (DQ),1037165196,574735290,687754257,2299654743,40965062191.503802,29332210802.967609,36592437009.826605,106889710004.298016,3971476,1255117,2401398,7627991
2018-08-15,EDGA Equities (J),48665193,36330451,29058986,114054630,1855770296.023100,2018749432.752900,1658169407.984500,5532689136.760500,441492,171229,234792,847513
2018-08-15,EDGX Equities (K),171583203,107473809,160981930,440038942,7074985178.899602,5957813381.287403,8082779398.752899,21115577958.939904,1280318,418426,951438,2650182
2018-08-15,CHX (M),14632155,17319375,7589173,39540703,885498814.204800,1422781151.438700,669367019.135900,2977646984.779400,4757,6759,5744,17260
2018-08-15,NYSE (N),796658900,31500948,31164662,859324510,31921655109.494097,2473537809.609699,1846498936.718600,36241691855.822396,2498616,118717,227682,2845015
2018-08-15,NYSE Arca (P),202316075,438974387,179141062,820431524,8794062680.379697,21560623744.078099,10603664165.494904,40958350589.952700,1575715,1120452,1340370,4036537
2018-08-15,NASDAQ (Q),425546230,254989976,588514799,1269051005,21285369857.568501,15923236591.998181,39886409311.972794,77095015761.539476,4032100,1094147,3973423,9099670
2018-08-15,IEX (V),115161103,25640131,59851336,200652570,5180406283.422501,1351835927.019800,4065429894.699500,10597672105.141801,756524,105338,405296,1267158
2018-08-15,NASDAQ PSX (X),18207881,30361877,15566823,64136581,736275296.847200,2217397646.659699,1211229745.565000,4164902689.071899,155453,130008,135603,421064
2018-08-15,BYX Equities (Y),196741104,113543453,84903068,395187625,6032287704.744100,4589542179.831801,3625524826.493100,14247354711.069001,1698460,561041,814970,3074471
2018-08-15,BZX Equities (Z),238802922,152409190,135682559,526894671,10168666063.846099,9758751466.813600,9181131310.686502,29108548841.346201,2210699,705749,1246952,4163400
2018-08-14,NYSE American (A),4615803,10828827,2603360,18047990,209524158.323400,147877616.839300,148146267.631500,505548042.794200,47138,35363,26666,109167
2018-08-14,NASDAQ BX (B),101702153,26497546,55122711,183322410,4853772566.648300,1454772295.834800,2931327286.648999,9239872149.132099,1080030,128193,601105,1809328
2018-08-14,NYSE National (C),22823962,9981403,12449066,45254431,677485680.788000,342179401.930200,431323364.265400,1450988446.983600,226982,48371,130848,406201
2018-08-14,FINRA / NYSE TRF (DN),179085683,70732109,210977536,460795328,6122020622.483299,2219317414.772900,8758341726.967001,17099679764.223200,406902,137228,481616,1025746
2018-08-14,FINRA / Nasdaq TRF Carteret (DQ),916923571,348580115,612768032,1878271718,37492560312.513702,17974526715.552400,29792822779.203684,85259909807.269786,3388299,729109,2103121,6220529
2018-08-14,EDGA Equities (J),37195567,18941845,21137394,77274806,1411451999.733200,1071510043.992700,1005453591.251100,3488415634.977000,340407,89587,175552,605546
2018-08-14,EDGX Equities (K),131828879,54515676,132291895,318636450,5507999347.993500,2881126465.022900,5647594765.867802,14036720578.884202,1004257,216683,753111,1974051
2018-08-14,CHX (M),13212823,8856948,8365821,30435592,855701334.132000,842534643.400000,945977369.476700,2644213347.008700,3530,3898,4604,12032
2018-08-14,NYSE (N),657211468,15628926,23641260,696481654,27014749175.203399,1087964366.471400,1169674289.181100,29272387830.855899,2004905,63077,176485,2244467
2018-08-14,NYSE Arca (P),156891670,209328137,147264626,513484433,7025081329.888001,11017682003.992098,7024052764.954898,25066816098.834997,1208975,556773,1031469,2797217
2018-08-14,NASDAQ (Q),324599236,125314232,483603266,933516734,16494672505.611901,7764319799.242700,27953134077.296903,52212126382.151504,3092307,564360,3117740,6774407
2018-08-14,IEX (V),85424244,14960057,46603708,146988009,3998619509.754800,840529481.025900,2605344882.901200,7444493873.681900,597154,65006,322850,985010
2018-08-14,NASDAQ PSX (X),14105659,15037784,11743157,40886600,569279378.013600,1087062175.990500,786159637.073400,2442501191.077500,122949,61075,95833,279857
2018-08-14,BYX Equities (Y),161702576,61734495,70121761,293558832,4979134141.594100,2604225874.833301,2811342351.031100,10394702367.458501,1386822,307586,695059,2389467
2018-08-14,BZX Equities (Z),179184212,77863188,100146844,357194244,7658845178.203700,4895068905.937702,5563039032.759600,18116953116.901002,1723428,376507,952662,3052597
2018-08-13,NYSE American (A),4716242,13945598,2529575,21191415,206558159.872800,163334675.561400,149274282.695600,519167118.129800,49252,38942,25751,113945
2018-08-13,NASDAQ BX (B),102107027,34179667,52464477,188751171,4554475719.597300,1760536751.232200,2893430483.364100,9208442954.193600,1082229,158805,581876,1822910
2018-08-13,NYSE National (C),24364782,10286444,12180617,46831843,710535637.770100,374752489.037700,443707383.201100,1528995510.008900,233567,51839,128034,413440
2018-08-13,FINRA / NYSE TRF (DN),199564992,90558226,220291400,510414618,5791503363.004202,2770720125.980700,9763915421.676298,18326138910.661200,434015,171856,487723,1093594
2018-08-13,FINRA / Nasdaq TRF Carteret (DQ),958677504,380860118,604575475,1944113097,35789534999.702009,20079918039.646001,29423992630.596081,85293445669.944091,3382163,905656,2024105,6311924
2018-08-13,EDGA Equities (J),37475104,23860101,21099475,82434680,1327751211.744500,1219617958.293800,1054369422.997100,3601738593.035400,344074,109036,170437,623547
2018-08-13,EDGX Equities (K),139930219,72336620,134067620,346334459,5166004545.494501,3840697367.832299,5959088074.080701,14965789987.407501,997038,277233,745531,2019802
2018-08-13,CHX (M),9087252,7173922,6694103,22955277,544269852.702300,818418409.973500,892784443.624000,2255472706.299800,4221,4322,6186,14729
2018-08-13,NYSE (N),726100119,19480834,23434790,769015743,28687425546.648900,1515564485.195300,1249310775.866500,31452300807.710700,2064590,72664,168401,2305655
2018-08-13,NYSE Arca (P),160386142,299662746,151803662,611852550,6534839736.437001,15125945918.213705,7560878078.648101,29221663733.298807,1228970,731954,1024043,2984967
2018-08-13,NASDAQ (Q),345562572,165267133,477681055,988510760,16446312137.539500,10270318453.662598,29164356358.527193,55880986949.729291,3259500,712556,3109029,7081085
2018-08-13,IEX (V),88825077,18994376,42507180,150326633,3836092552.462100,1067199802.266800,2676226327.098600,7579518681.827500,593420,78513,306226,978159
2018-08-13,NASDAQ PSX (X),14163680,19555979,11412883,45132542,537113778.478100,1484016092.541200,780048455.258100,2801178326.277400,124535,73291,96877,294703
2018-08-13,BYX Equities (Y),170600098,84759619,70042186,325401903,5048930689.073500,3360961740.719800,2940397532.243200,11350289962.036500,1458587,388201,691271,2538059
2018-08-13,BZX Equities (Z),192077411,100210232,103319171,395606814,7732889828.136899,6641311107.868199,6549760696.782300,20923961632.787398,1803109,468276,1000119,3271504
2018-08-10,NYSE American (A),4865139,14228217,2631624,21724980,215739902.054400,215060499.300800,132695324.747800,563495726.103000,50834,46606,25904,123344
2018-08-10,NASDAQ BX (B),110535283,37950863,58613126,207099272,5148468837.791600,2056045697.309600,3133937845.977000,10338452381.078200,1188065,174888,627427,1990380
2018-08-10,NYSE National (C),22894943,10644125,11900699,45439767,691088848.622000,398554707.908400,416509793.821300,1506153350.351700,227564,52921,124398,404883
2018-08-10,FINRA / NYSE TRF (DN),184452913,83988235,229434700,497875848,5909509642.279899,2663564856.681600,9291152259.305107,17864226758.266606,396500,169253,490239,1055992
2018-08-10,FINRA / Nasdaq TRF Carteret (DQ),934058611,385731866,619873765,1939664242,36176031471.115083,21078647439.785514,30647041923.161580,87901720834.062177,3407109,936306,2177712,6521127
2018-08-10,EDGA Equities (J),37318716,24739200,23065433,85123349,1413482837.405600,1452394027.356500,1116135539.671700,3982012404.433800,349551,116612,185848,652011
2018-08-10,EDGX Equities (K),138741716,78493215,160422239,377657170,5571452484.572300,4383577956.225002,6371572585.792202,16326603026.589504,1035897,297281,817086,2150264
2018-08-10,CHX (M),9343183,11476477,12072475,32892135,502716483.795000,1222568292.578800,1244793154.988699,2970077931.362499,3850,5131,4325,13306
2018-08-10,NYSE (N),828276285,23814515,27056447,879147247,32396601043.353094,1776080909.669301,1464072527.802300,35636754480.824695,2139368,83719,195596,2418683
2018-08-10,NYSE Arca (P),172491680,295663742,179033984,647189406,7171173183.037502,15532804739.998999,8211992144.075800,30915970067.112301,1300525,799623,1125308,3225456
2018-08-10,NASDAQ (Q),351865301,168861709,534012678,1054739688,16946671951.441800,10872967863.076696,30896068480.755106,58715708295.273602,3303455,721873,3332376,7357704
2018-08-10,IEX (V),89410918,18603313,48574781,156589012,4013530193.723400,1109496750.658700,2874127458.817400,7997154403.199500,629107,76739,343442,1049288
2018-08-10,NASDAQ PSX (X),15463177,21317365,14020000,50800542,618800528.400000,1576732326.619000,1000830721.370200,3196363576.389200,137762,85373,113001,336136
2018-08-10,BYX Equities (Y),168670096,85878109,74765356,329313561,5351755248.064899,3607961770.988801,3108552491.713100,12068269510.766800,1523678,392811,723668,2640157
2018-08-10,BZX Equities (Z),197202178,108758437,112055639,418016254,8270852273.988401,7064702425.965500,6967103641.195497,22302658341.149398,1863897,494046,1065438,3423381
2018-08-09,NYSE American (A),4768536,10952494,2903690,18624720,201972949.444400,137263555.772000,156257626.571100,495494131.787500,48351,36070,27523,111944
2018-08-09,NASDAQ BX (B),104281854,21027073,60161951,185470878,4903656919.758200,1129767887.159800,3251790787.973100,9285215594.891100,1121277,110463,641208,1872948
2018-08-09,NYSE National (C),20859650,5299993,11563148,37722791,624375543.393000,199486202.579900,399527542.339800,1223389288.312700,209271,31391,118170,358832
2018-08-09,FINRA / NYSE TRF (DN),184499185,64958986,225361703,474819874,6055591942.861300,1796159354.740300,10085527722.756003,17937279020.357603,419595,128390,525230,1073215
2018-08-09,FINRA / Nasdaq TRF Carteret (DQ),955165362,257552500,640323564,1853041426,37376105797.502404,14224371950.391797,32151943546.232004,83752421294.126205,3494759,612525,2244048,6351332
2018-08-09,EDGA Equities (J),36200931,14225136,20993434,71419501,1402617222.816400,778162758.265100,1090167382.011000,3270947363.092500,335904,69576,178577,584057
2018-08-09,EDGX Equities (K),139974137,48355727,147222353,335552217,5555862532.341900,2367810174.403299,6286601251.705301,14210273958.450500,1001119,188685,802864,1992668
2018-08-09,CHX (M),16765441,6417591,16788369,39971401,749234573.384100,575235553.415000,1405461320.614200,2729931447.413300,3399,2811,4551,10761
2018-08-09,NYSE (N),651178846,12374669,25774351,689327866,27141767848.508399,877775206.526300,1483473711.988500,29503016767.023199,2049215,52399,197825,2299439
2018-08-09,NYSE Arca (P),168865270,175565263,163519012,507949545,7025761875.252804,8982966169.174598,8186344845.535093,24195072889.962495,1221729,480368,1086095,2788192
2018-08-09,NASDAQ (Q),331788302,96373297,493185361,921346960,16278496493.756096,5655345148.003901,30750094193.495289,52683935835.255286,3012231,440518,3136451,6589200
2018-08-09,IEX (V),96573519,13759699,50901930,161235148,4331630446.464500,773226960.340000,3030685538.829300,8135542945.633800,634099,55560,351979,1041638
2018-08-09,NASDAQ PSX (X),15577113,11275705,11827491,38680309,583487668.680200,827316073.901400,928448121.272300,2339251863.853900,127509,46124,104008,277641
2018-08-09,BYX Equities (Y),158472284,51574339,72146856,282193479,5073569975.444500,2209545928.677900,3031359650.347800,10314475554.470200,1408682,271782,713988,2394452
2018-08-09,BZX Equities (Z),181212905,62476114,105502776,349191795,7601799253.843299,3863162661.960101,6298308734.450502,17763270650.253902,1706273,305523,1003171,3014967
2018-08-08,NYSE American (A),4399308,13518082,2501183,20418573,176748645.209500,126134838.143400,141321919.823000,444205403.175900,43286,38056,25100,106442
2018-08-08,NASDAQ BX (B),101634900,24459913,60034137,186128950,4714495115.448100,1380319837.818300,3193052474.493200,9287867427.759600,1100176,126761,647615,1874552
2018-08-08,NYSE National (C),21130547,6978750,11784734,39894031,632783740.705000,247384921.988600,399979682.182600,1280148344.876200,212877,38427,120702,372006
2018-08-08,FINRA / NYSE TRF (DN),182225723,75963466,238641969,496831158,5869836580.387501,2170627479.634200,10264240343.154496,18304704403.176197,422222,145654,524126,1092002
2018-08-08,FINRA / Nasdaq TRF Carteret (DQ),899317820,274456116,634426925,1808200861,35224986968.860501,14667385813.425003,31315703382.173302,81208076164.458806,3409183,660062,2223897,6293142
2018-08-08,EDGA Equities (J),35430999,16289472,23541807,75262278,1360330299.744800,867164992.482100,1033776338.571200,3261271630.798100,331578,76397,178265,586240
2018-08-08,EDGX Equities (K),138659678,55054500,157374761,351088939,5480687013.712699,2625845483.081101,6298887224.086201,14405419720.880001,1023811,201084,822650,2047545
2018-08-08,CHX (M),13250415,14290964,8610287,36151666,473368016.049000,1309984565.590000,939197421.249500,2722550002.888500,3123,3111,4910,11144
2018-08-08,NYSE (N),661864889,13151840,25806882,700823611,26953093922.690402,937947952.579300,1453747233.036000,29344789108.305702,2134668,53885,196733,2385286
2018-08-08,NYSE Arca (P),158849544,198698853,181977004,539525401,6744106394.107102,9528048428.191000,8104912728.956003,24377067551.254105,1232998,514932,1112759,2860689
2018-08-08,NASDAQ (Q),321138559,111504437,508162566,940805562,15700800164.887902,6698629750.048301,30095342292.788200,52494772207.724403,2992582,472473,3206006,6671061
2018-08-08,IEX (V),93131181,13449429,54424060,161004670,4128643138.015400,719860979.333300,3101864406.421599,7950368523.770299,620563,52749,361480,1034792
2018-08-08,NASDAQ PSX (X),13568317,12278458,12178017,38024792,541167145.800500,884802026.554800,830812469.686900,2256781642.042200,120711,50675,99427,270813
2018-08-08,BYX Equities (Y),152721968,55308496,72054864,280085328,4763904134.222400,2275290155.064300,2851507357.384500,9890701646.671200,1374516,273610,691426,2339552
2018-08-08,BZX Equities (Z),180746587,73856859,106581824,361185270,7460981562.620301,4445993602.914599,6276842122.508801,18183817288.043701,1749288,329706,1026651,3105645
2018-08-07,NYSE American (A),4602046,13384191,2675739,20661976,203023406.556400,151138805.712400,172597861.596300,526760073.865100,46704,39954,26398,113056
2018-08-07,NASDAQ BX (B),102475738,23178771,57461289,183115798,4891712542.823400,1295772418.461500,3263185866.850901,9450670828.135801,1099028,119721,618617,1837366
2018-08-07,NYSE National (C),21117380,6803103,12170469,40090952,646424093.496200,272473966.419200,439591756.217400,1358489816.132800,207078,36078,124923,368079
2018-08-07,FINRA / NYSE TRF (DN),205945874,67282874,252612317,525841065,6718484489.814902,2098435220.965900,11222934998.601000,20039854709.381802,464932,152719,564717,1182368
2018-08-07,FINRA / Nasdaq TRF Carteret (DQ),946151131,289730008,666252471,1902133610,37474042746.103996,16589173253.460898,34251331972.796113,88314547972.361007,3516760,701002,2222056,6439818
2018-08-07,EDGA Equities (J),36041704,15455942,30940550,82438196,1347470536.280700,866756698.829600,1126488914.934500,3340716150.044800,339966,76896,188117,604979
2018-08-07,EDGX Equities (K),146715409,53045720,169289729,369050858,5913066770.185400,2791427034.801700,6816830886.029901,15521324691.017001,1064183,207447,822491,2094121
2018-08-07,CHX (M),8196181,9181023,8219234,25596438,433685615.968500,832272103.830000,686528686.981200,1952486406.779700,3360,3405,5152,11917
2018-08-07,NYSE (N),724454356,13623644,25458009,763536009,29645292272.913397,1000428693.815700,1440637044.029700,32086358010.758797,2244606,57631,191884,2494121
2018-08-07,NYSE Arca (P),174281652,205138921,191443246,570863819,7187022342.655802,10870918612.081101,8620207815.312098,26678148770.049001,1281042,552660,1103955,2937657
2018-08-07,NASDAQ (Q),348636103,110658402,544017080,1003311585,17575838877.252107,7143182177.540200,32941077946.873789,57660099001.666096,3226995,484808,3343948,7055751
2018-08-07,IEX (V),102665454,14224962,52786142,169676558,4405853914.614100,845411061.440200,3246445488.079000,8497710464.133300,651267,61990,361451,1074708
2018-08-07,NASDAQ PSX (X),14442285,14635807,12713133,41791225,586933657.533500,1079231937.261500,963095818.944100,2629261413.739100,130738,57253,109191,297182
2018-08-07,BYX Equities (Y),164276882,54990845,75484629,294752356,5231953824.582900,2516772358.779900,3140938326.551200,10889664509.914000,1457198,283114,720982,2461294
2018-08-07,BZX Equities (Z),185438238,69135875,104885753,359459866,7880924455.242600,4616227422.864702,6652366599.075701,19149518477.183003,1772663,340991,1004404,3118058
2018-08-06,NYSE American (A),4195232,11264200,2480389,17939821,185130859.510000,138996289.071500,138078170.435100,462205319.016600,40878,34496,23645,99019
2018-08-06,NASDAQ BX (B),98914921,20916458,53601175,173432554,4816010019.360600,1163098436.543400,2846921930.461500,8826030386.365500,1055681,105815,577421,1738917
2018-08-06,NYSE National (C),16170409,5636584,10045287,31852280,482320095.450000,218104732.995500,343389263.705000,1043814092.150500,161910,27918,100802,290630
2018-08-06,FINRA / NYSE TRF (DN),185401359,65353330,274499029,525253718,6077829029.068199,2104398907.599999,9671161874.823698,17853389811.491896,435542,144340,526546,1106428
2018-08-06,FINRA / Nasdaq TRF Carteret (DQ),845920446,249936290,644433911,1740290647,35878389106.012201,14624947205.261199,29655063190.732488,80158399502.005888,3297439,674990,2080735,6053164
2018-08-06,EDGA Equities (J),33220101,13970794,38709060,85899955,1310791552.371500,863263373.117200,990447719.282500,3164502644.771200,311089,70639,186964,568692
2018-08-06,EDGX Equities (K),133520663,47403686,187562763,368487112,5834408275.128399,2423956365.938100,5594550669.375697,13852915310.442196,1016787,182916,755826,1955529
2018-08-06,CHX (M),14023679,7482811,17354649,38861139,600587013.175300,661426514.030500,1505721038.705800,2767734565.911600,3153,3151,4354,10658
2018-08-06,NYSE (N),661955109,12362304,29239725,703557138,28587801584.813302,909173801.996600,1325448227.401300,30822423614.211202,2047733,53503,184641,2285877
2018-08-06,NYSE Arca (P),149726905,190199876,218230329,558157110,7002121560.491299,9908708004.802802,7041794026.237302,23952623591.531403,1191996,507951,1017757,2717704
2018-08-06,NASDAQ (Q),313288877,101006903,525413737,939709517,16576554006.671101,6334111410.144301,28669907717.539520,51580573134.354922,2958401,436048,3001174,6395623
2018-08-06,IEX (V),86536851,10771387,49211174,146519412,3869363938.171500,673983463.424700,2945199491.117201,7488546892.713401,576660,48417,327070,952147
2018-08-06,NASDAQ PSX (X),12987710,12710456,11084656,36782822,534577618.847700,880135596.389300,781300412.233300,2196013627.470300,118488,51606,93306,263400
2018-08-06,BYX Equities (Y),151471502,50145442,78608234,280225178,5007016922.348900,2165541279.514399,2878710819.107201,10051269020.970500,1348527,255642,697127,2301296
2018-08-06,BZX Equities (Z),171688683,62614181,104834603,339137467,7619907912.355003,4094269865.075399,5946584089.393299,17660761866.823701,1668540,317539,947487,2933566
2018-08-03,NYSE American (A),5051773,12212093,2830994,20094860,225090277.705600,175060361.048800,170314156.465800,570464795.220200,51710,39682,27527,118919
2018-08-03,NASDAQ BX (B),109304385,23638199,61351063,194293647,5088940319.624000,1302588579.453800,3250523039.760701,9642051938.838501,1168281,122694,655269,1946244
2018-08-03,NYSE National (C),14252805,6052306,8680925,28986036,412082839.700000,249843762.003200,273018931.971200,934945533.674400,140073,33809,84483,258365
2018-08-03,FINRA / NYSE TRF (DN),170741565,65683235,209960317,446385117,5795829631.663899,2087427844.293101,9622362757.107300,17505620233.064300,412567,133347,510458,1056372
2018-08-03,FINRA / Nasdaq TRF Carteret (DQ),888309419,264692473,624967432,1777969324,36502598994.369894,16298314601.770005,29281801224.340194,82082714820.480093,3485841,688361,2226859,6401061
2018-08-03,EDGA Equities (J),34690036,16606111,22227686,73523833,1386720333.700000,942591019.242900,1066037250.970800,3395348603.913700,334260,80685,190830,605775
2018-08-03,EDGX Equities (K),136622387,56435890,136741076,329799353,5820692798.947800,2998526145.365699,6047163040.355398,14866381984.668897,1093588,235373,842539,2171500
2018-08-03,CHX (M),7939620,11864046,9254837,29058503,445002954.461200,1215817178.918400,1046119731.116200,2706939864.495800,3531,3135,3575,10241
2018-08-03,NYSE (N),705241210,15487284,28469684,749198178,29908260846.240406,1194347316.237100,1578592858.608300,32681201021.085806,2247782,67200,210035,2525017
2018-08-03,NYSE Arca (P),170570046,209414559,153606755,533591360,7408795616.625199,11195805992.544597,7731465544.846696,26336067154.016492,1295461,567683,1073856,2937000
2018-08-03,NASDAQ (Q),344883621,117764265,519409415,982057301,17684136064.729999,7763882171.822103,30769413116.976408,56217431353.528510,3244569,532988,3298212,7075769
2018-08-03,IEX (V),94802485,12977749,55252359,163032593,4283438128.919000,802982089.419100,2900873475.821500,7987293694.159600,641879,57748,349416,1049043
2018-08-03,NASDAQ PSX (X),15424821,13378357,12490166,41293344,661958647.250000,989609639.407900,991934699.339900,2643502985.997800,134133,57776,107907,299816
2018-08-03,BYX Equities (Y),157899801,55092682,76717536,289710019,5171801052.189200,2468800629.368700,3045769831.341700,10686371512.899600,1407570,269376,736977,2413923
2018-08-03,BZX Equities (Z),187962205,74377915,113913035,376253155,8191573534.619401,4993188976.907997,6674941002.363798,19859703513.891196,1823963,369005,1074213,3267181
2018-08-02,NYSE American (A),5383512,12881426,3327640,21592578,246980572.130000,169651780.336000,197559847.728100,614192200.194100,54331,41513,29565,125409
2018-08-02,NASDAQ BX (B),121205005,27356117,63360451,211921573,5874593927.202400,1587406806.701800,3727055896.023700,11189056629.927900,1274602,141144,698182,2113928
2018-08-02,NYSE National (C),13120610,4780868,8297365,26198843,412932809.980000,184068680.129500,287334617.750000,884336107.859500,131947,27570,78574,238091
2018-08-02,FINRA / NYSE TRF (DN),205300355,80125171,198007892,483433418,6842324441.648602,2492962896.275600,11656371293.364000,20991658631.288202,476989,153376,555198,1185563
2018-08-02,FINRA / Nasdaq TRF Carteret (DQ),1061904840,337010522,654746769,2053662131,43097684747.150809,19681872557.196105,37872014594.156609,100651571898.503523,4020157,905807,2490455,7416419
2018-08-02,EDGA Equities (J),39154698,18601339,21758324,79514361,1502629839.512100,1025905754.916300,1299014339.089500,3827549933.517900,363612,91681,195904,651197
2018-08-02,EDGX Equities (K),156445393,67517992,134547835,358511220,6531662241.556600,3642931443.430399,7523989379.657198,17698583064.644197,1209012,270574,918958,2398544
2018-08-02,CHX (M),11302920,10407162,14030067,35740149,591681149.128600,1002536310.385000,1419371954.006000,3013589413.519600,4311,4053,4405,12769
2018-08-02,NYSE (N),768307426,18018466,28686265,815012157,32594543622.425498,1396873201.106400,1695122181.380900,35686539004.912798,2622485,77001,218145,2917631
2018-08-02,NYSE Arca (P),192358295,249984968,160498538,602841801,8592588151.434500,13547429298.561401,9787149027.173198,31927166477.169099,1491464,684888,1205646,3381998
2018-08-02,NASDAQ (Q),398953835,138422019,547804735,1085180589,20752517730.507702,8938260098.011200,37137665210.710402,66828443039.229304,3798299,613383,3686654,8098336
2018-08-02,IEX (V),112655986,15857296,58327370,186840652,5266427399.221400,859441910.776600,4097445583.822702,10223314893.820702,731387,68821,394725,1194933
2018-08-02,NASDAQ PSX (X),16963642,17136954,14294318,48394914,708775785.025000,1229394878.545000,1151578119.667100,3089748783.237100,142804,69953,120017,332774
2018-08-02,BYX Equities (Y),178603263,64441840,80690896,323735999,5742633611.230000,2796845750.743900,3580556578.524201,12120035940.498101,1553809,319632,776140,2649581
2018-08-02,BZX Equities (Z),219728546,90300875,127114616,437144037,9431079131.802900,6013464827.778398,8587630318.281898,24032174277.863196,2065208,430107,1183787,3679102
2018-08-01,NYSE American (A),5496313,14185465,3317455,22999233,251622779.840600,162272510.956300,193420874.370300,607316165.167200,53445,41171,31357,125973
2018-08-01,NASDAQ BX (B),123227960,28195521,71096947,222520428,5921228459.203900,1617471252.352600,3846286374.550700,11384986086.107200,1312985,144802,747042,2204829
2018-08-01,NYSE National (C),13336159,5549076,9064515,27949750,433520010.300000,206753039.350100,288309891.475200,928582941.125300,130256,28422,83491,242169
2018-08-01,FINRA / NYSE TRF (DN),192484848,77186913,194874625,464546386,6534317665.311601,2319427907.433300,11409023658.317307,20262769231.062208,439326,153656,511034,1104016
2018-08-01,FINRA / Nasdaq TRF Carteret (DQ),1031656434,352025875,709327749,2093010058,42866132032.945196,19452352149.494397,38261647524.653487,100580131707.093080,3910320,752318,2491484,7154122
2018-08-01,EDGA Equities (J),39617718,19634035,24105980,83357733,1593847553.508700,1076636401.555100,1426410835.022200,4096894790.086000,381056,97590,212366,691012
2018-08-01,EDGX Equities (K),158926317,67578086,131672645,358177048,6657221085.732399,3684173535.952401,7363731771.586902,17705126393.271702,1281347,284249,951790,2517386
2018-08-01,CHX (M),9403866,9867599,12422425,31693890,478607954.105200,916224531.890100,1134421854.721600,2529254340.716900,3877,3053,4904,11834
2018-08-01,NYSE (N),792009144,19271711,28759148,840040003,34091572606.514303,1467547342.226200,1565093081.222700,37124213029.963203,2621813,80797,216764,2919374
2018-08-01,NYSE Arca (P),191410961,260742249,166391743,618544953,8798490605.142900,14259154811.334396,10171161519.250605,33228806935.727901,1524133,674897,1242319,3441349
2018-08-01,NASDAQ (Q),403050541,143601863,575474464,1122126868,21504901239.112698,9256023229.240600,37971625260.782490,68732549729.135788,3926246,638021,3868694,8432961
2018-08-01,IEX (V),114542002,15423562,62382621,192348185,5161584539.966000,861469241.514800,3707890173.427199,9730943954.907999,742112,64370,404295,1210777
2018-08-01,NASDAQ PSX (X),16321991,16696788,14425229,47444008,733810217.670500,1213413645.344200,1075890371.281000,3023114234.295700,145754,64015,118997,328766
2018-08-01,BYX Equities (Y),187746934,65180937,93242217,346170088,6079692442.296600,3039290552.798701,3857285991.151300,12976268986.246601,1655187,330661,858190,2844038
2018-08-01,BZX Equities (Z),222120310,90327744,132398743,444846797,9828365702.516200,6028715101.336598,8477868237.811402,24334949041.664200,2148182,442929,1246408,3837519
2018-07-31,NYSE American (A),5540157,17483280,2863224,25886661,252170261.205600,212609379.936900,174836895.067000,639616536.209500,53901,46588,28978,129467
2018-07-31,NASDAQ BX (B),126126006,34556728,65578284,226261018,6154555662.713600,2024670212.497900,3773118276.239899,11952344151.451399,1312035,157805,728528,2198368
2018-07-31,NYSE National (C),14409168,9277499,9128854,32815521,444928059.829000,354761435.382200,316405724.033100,1116095219.244300,131762,37006,84903,253671
2018-07-31,FINRA / NYSE TRF (DN),195887622,83670721,199065816,478624159,6997894020.919004,2360608598.788101,11066861815.105697,20425364434.812802,447906,154857,533453,1136216
2018-07-31,FINRA / Nasdaq TRF Carteret (DQ),1166424756,332141160,665828277,2164394193,49839453843.835486,19425152130.867600,38103261787.537805,107367867762.240891,3948533,735361,2429499,7113393
2018-07-31,EDGA Equities (J),40219567,20916909,23039011,84175487,1596209805.514300,1221878804.373200,1279596595.831800,4097685205.719300,365493,93558,205192,664243
2018-07-31,EDGX Equities (K),166315105,83941413,139976785,390233303,7169396205.163800,4360907850.584500,7439027259.790598,18969331315.538898,1221664,288393,933374,2443431
2018-07-31,CHX (M),10053905,16497421,13244606,39795932,512524420.669400,1270782574.874300,1413302983.619000,3196609979.162700,3586,5083,5010,13679
2018-07-31,NYSE (N),1046066204,20727258,29508320,1096301782,45904237444.091604,1694185725.756900,1917303043.180001,49515726213.028505,2488415,79772,219341,2787528
2018-07-31,NYSE Arca (P),185922778,281092032,160064045,627078855,8585861150.411298,16987795132.933090,9878520103.110098,35452176386.454486,1387006,713038,1169562,3269606
2018-07-31,NASDAQ (Q),387628535,151275365,604713009,1143616909,20717538448.559104,10160912815.007400,38997993164.247901,69876444427.814405,3540076,619997,3600975,7761048
2018-07-31,IEX (V),109248595,19880666,56875757,186005018,5140937181.301700,1148156779.317100,3787579082.337499,10076673042.956299,726485,77749,403326,1207560
2018-07-31,NASDAQ PSX (X),18651990,19109010,14165620,51926620,774811139.428800,1395489186.405100,1063249185.204400,3233549511.038300,142860,71744,118785,333389
2018-07-31,BYX Equities (Y),215876528,83607975,95986401,395470904,6759678752.980600,3881404532.991800,3939170825.464699,14580254111.437099,1698546,363614,877130,2939290
2018-07-31,BZX Equities (Z),218527505,99990410,128575464,447093379,9662885704.817402,6912830160.760801,8063360018.645299,24639075884.223502,2026996,438225,1180701,3645922
2018-07-30,NYSE American (A),5096741,16466428,3603644,25166813,242026232.105300,182907958.946400,285322947.572500,710257138.624200,51699,47346,35655,134700
2018-07-30,NASDAQ BX (B),112088423,25968676,64023222,202080321,5444867430.380200,1566444420.525700,3842109222.026701,10853421072.932601,1209728,138568,711536,2059832
2018-07-30,NYSE National (C),13621700,5113548,9171385,27906633,448931366.045000,202355285.017000,368069782.462900,1019356433.524900,131478,29853,89533,250864
2018-07-30,FINRA / NYSE TRF (DN),199090167,87249474,212427437,498767078,7162897993.351799,2477809207.763000,12432570174.859907,22073277375.974706,479298,163906,585052,1228256
2018-07-30,FINRA / Nasdaq TRF Carteret (DQ),972040128,319824364,666032531,1957897023,42745629595.866699,19398889345.304006,40246180638.458395,102390699579.629100,3684874,750696,2475001,6910571
2018-07-30,EDGA Equities (J),37178717,19036269,22855096,79070082,1476813954.451500,1239372437.919900,1471873120.718200,4188059513.089600,349913,98080,211587,659580
2018-07-30,EDGX Equities (K),156308794,75155102,134984110,366448006,7068527421.273102,4005730954.879300,8117152770.722302,19191411146.874704,1178498,282814,957351,2418663
2018-07-30,CHX (M),10682022,13208733,12503491,36394246,546576509.707500,1164605803.126900,1151053415.748200,2862235728.582600,3770,3949,6370,14089
2018-07-30,NYSE (N),730632380,18461919,32500948,781595247,31632461207.480805,1571802359.737900,2309844258.316799,35514107825.535504,2430956,80474,233442,2744872
2018-07-30,NYSE Arca (P),167557383,215892923,150800475,534250781,8011649143.491400,13033136469.025605,9199899275.699598,30244684888.216603,1373966,646733,1189717,3210416
2018-07-30,NASDAQ (Q),362617733,129656679,545786363,1038060775,19507442250.135499,8991695476.987803,37502106937.629919,66001244664.753221,3441054,602991,3801330,7845375
2018-07-30,IEX (V),96234860,14702538,57412457,168349855,4615958143.866500,867603903.938800,3945063072.649800,9428625120.455100,663669,63723,397428,1124820
2018-07-30,NASDAQ PSX (X),15668278,16553571,15553023,47774872,703617376.008500,1257867808.600300,1222554120.695300,3184039305.304100,140889,68335,129473,338697
2018-07-30,BYX Equities (Y),184668848,69749758,91225344,345643950,6013050768.399200,3297911047.018800,4291455607.742900,13602417423.160900,1595103,350950,873420,2819473
2018-07-30,BZX Equities (Z),197704097,85853278,135270252,418827627,9125345859.942601,6223923216.674601,9136167668.181504,24485436744.798706,1996498,438404,1246433,3681335
2018-07-27,NYSE American (A),5259114,16434662,3228978,24922754,232924682.732700,195077413.440600,219159273.189800,647161369.363100,50213,49125,32367,131705
2018-07-27,NASDAQ BX (B),113035253,29693803,65337923,208066979,5297042663.462100,1823252778.617800,3963719449.104199,11084014891.184099,1189710,148844,709593,2048147
2018-07-27,NYSE National (C),13259652,5140819,8545418,26945889,409152583.805000,185190467.967300,320067959.510000,914411011.282300,120336,28461,82765,231562
2018-07-27,FINRA / NYSE TRF (DN),217101350,97293000,216107247,530501597,7170682193.178600,2598308938.138501,12854603777.966708,22623594909.283809,471416,162969,564425,1198810
2018-07-27,FINRA / Nasdaq TRF Carteret (DQ),977419361,350222484,639165569,1966807414,40444044987.512311,21823192781.620599,39560066682.577512,101827304451.710422,3678241,717469,2448708,6844418
2018-07-27,EDGA Equities (J),45086620,21107267,25270349,91464236,1698721778.882300,1308254184.025600,1560447023.108500,4567422986.016400,414493,102157,232864,749514
2018-07-27,EDGX Equities (K),183654963,80781159,146567394,411003516,8115555365.200100,4458351252.742497,9520752646.671601,22094659264.614198,1380450,318005,1091118,2789573
2018-07-27,CHX (M),25874134,14854923,12588882,53317939,642149281.768700,1295714953.521700,1596348586.952000,3534212822.242400,4712,5321,3895,13928
2018-07-27,NYSE (N),756304380,21119729,35774560,813198669,31687440483.036298,1743195098.937400,2552947711.162201,35983583293.135899,2522539,90134,254190,2866863
2018-07-27,NYSE Arca (P),199182993,272040805,166602793,637826591,9200436160.908799,16219013475.724500,11456024340.749005,36875473977.382304,1552748,784255,1348561,3685564
2018-07-27,NASDAQ (Q),385454600,157635736,566168086,1109258422,19833197655.119197,11032684667.253403,39988328427.797690,70854210750.170290,3550653,711511,3937248,8199412
2018-07-27,IEX (V),102060389,14001986,61159875,177222250,4918191598.438800,914470201.346000,4161255692.530801,9993917492.315601,693566,60064,407749,1161379
2018-07-27,NASDAQ PSX (X),17175019,19984450,19114417,56273886,730999661.375000,1664117061.658599,1736426112.196400,4131542835.229999,147851,81456,170829,400136
2018-07-27,BYX Equities (Y),177967102,68002458,84755136,330724696,5524925562.343900,3110820131.799899,3800145945.854402,12435891639.998201,1522289,334594,825300,2682183
2018-07-27,BZX Equities (Z),215544735,100574594,143025713,459145042,9674462004.024899,7576961497.730302,10005627944.470498,27257051446.225699,2032262,500866,1336892,3870020
2018-07-26,NYSE American (A),5453051,15313234,3633810,24400095,249183620.768300,191507734.653800,245058212.006000,685749567.428100,52774,41032,34224,128030
2018-07-26,NASDAQ BX (B),118508835,28403113,65615353,212527301,5702843916.324000,1573559050.244000,4299391466.976499,11575794433.544499,1230749,145839,728136,2104724
2018-07-26,NYSE National (C),13533270,4269095,7168975,24971340,417545888.840000,154632757.457300,271242256.705500,843420903.002800,125028,22165,70552,217745
2018-07-26,FINRA / NYSE TRF (DN),216840322,74305263,203390359,494535944,7347943386.224497,2124587127.678000,13652744227.325208,23125274741.227705,490682,143476,622626,1256784
2018-07-26,FINRA / Nasdaq TRF Carteret (DQ),1118538465,366023822,727098461,2211660748,48117183347.863003,21487741335.104895,47961449149.087894,117566373832.055792,4087437,734955,2780753,7603145
2018-07-26,EDGA Equities (J),45894362,19970562,25444052,91308976,1811266421.310800,1223121064.406000,1724838531.314200,4759226017.031000,418541,96977,235910,751428
2018-07-26,EDGX Equities (K),182054080,70251707,140420763,392726550,8226290251.977600,3742626312.085298,10060959157.357201,22029875721.420099,1377519,276857,1052013,2706389
2018-07-26,CHX (M),10454701,9794523,15304603,35553827,473796169.822100,1056863925.845800,1545713735.843200,3076373831.511100,4875,4070,4602,13547
2018-07-26,NYSE (N),815559627,19065995,31377532,866003154,34926426904.075699,1426099752.422399,2094720357.195299,38447247013.693397,2552951,82912,224496,2860359
2018-07-26,NYSE Arca (P),205283825,244746383,173116312,623146520,9512611815.760198,13646821386.514898,14654905396.310802,37814338598.585898,1613001,651275,1380725,3645001
2018-07-26,NASDAQ (Q),398982219,137449027,589900560,1126331806,21088585969.636594,9054291161.317306,45737423917.668984,75880301048.622884,3606650,602503,3805031,8014184
2018-07-26,IEX (V),115703719,16212755,69052090,200968564,5597045255.748600,915307221.002900,5102421934.357500,11614774411.109000,729650,66550,443454,1239654
2018-07-26,NASDAQ PSX (X),17151250,17124230,17562057,51837537,763077642.000200,1267891883.616600,1351487076.976900,3382456602.593700,150992,68075,149159,368226
2018-07-26,BYX Equities (Y),179747182,68368709,88472675,336588566,5723193057.256100,3106368888.116600,4286222623.924801,13115784569.297501,1578705,342102,880838,2801645
2018-07-26,BZX Equities (Z),223589733,86273172,131818780,441681685,10170566137.715099,5740535677.335997,8979419085.418697,24890520900.469793,2097465,435445,1247811,3780721
2018-07-25,NYSE American (A),5607380,15170627,2999674,23777681,262833326.850000,214927538.344600,187113173.783800,664874038.978400,53659,45881,28528,128068
2018-07-25,NASDAQ BX (B),117731899,33149710,59785447,210667056,5818964970.901499,1943586973.768400,3551585181.338601,11314137126.008500,1240558,158161,662292,2061011
2018-07-25,NYSE National (C),13234573,4324731,6867094,24426398,441139987.147200,160934125.370600,264355657.819000,866429770.336800,128100,25374,70166,223640
2018-07-25,FINRA / NYSE TRF (DN),216953828,80004528,175532439,472490795,7980654434.512398,2303628083.309001,10016420406.772098,20300702924.593497,494113,149786,472514,1116413
2018-07-25,FINRA / Nasdaq TRF Carteret (DQ),1061893369,327942290,585347890,1975183549,45440609615.315197,22454781281.750605,33527720749.507401,101423111646.573203,3959232,717346,2222075,6898653
2018-07-25,EDGA Equities (J),50420610,23706454,23241564,97368628,2120836479.036000,1475892246.596600,1385438013.045300,4982166738.677900,465168,111917,216969,794054
2018-07-25,EDGX Equities (K),189705241,80034523,130911187,400650951,8904193758.751597,4589991435.821801,8204698235.249796,21698883429.823194,1445267,307452,966297,2719016
2018-07-25,CHX (M),14036684,15174648,9500417,38711749,679361392.860800,1321810438.400400,653872128.250900,2655043959.512100,4771,6028,3641,14440
2018-07-25,NYSE (N),795392729,22601336,31799160,849793225,34565398028.233500,1730182029.035300,2050062272.055101,38345642329.323901,2597825,93396,222892,2914113
2018-07-25,NYSE Arca (P),153393413,232951263,133131518,519476194,7049444494.278101,13672851385.526704,10271247672.568996,30993543552.373801,1208972,540027,932958,2681957
2018-07-25,NASDAQ (Q),413196894,161657534,507976823,1082831251,22400774397.879098,10984723974.882201,36523097181.947197,69908595554.708496,3764399,677210,3461494,7903103
2018-07-25,IEX (V),111863070,17002897,54182634,183048601,5539062079.947901,1056534734.463800,3370321930.458300,9965918744.870001,755702,69192,372754,1197648
2018-07-25,NASDAQ PSX (X),18169095,19157501,15457894,52784490,806656877.920000,1496028530.598300,1096213540.903600,3398898949.421900,150899,69445,126664,347008
2018-07-25,BYX Equities (Y),187590688,74193981,81937773,343722442,6190648659.251000,3402784792.123701,3575334169.105399,13168767620.480100,1653020,352409,796425,2801854
2018-07-25,BZX Equities (Z),235211123,106376392,125156262,466743777,11382686389.697398,7509765281.752498,7968014963.107100,26860466634.556996,2271731,510953,1236844,4019528
2018-07-24,NYSE American (A),5271463,14703356,2839578,22814397,259403585.075000,175836258.739100,186423774.910900,621663618.725000,52335,43009,27930,123274
2018-07-24,NASDAQ BX (B),117406262,29351277,60730205,207487744,5752757178.592099,1598011779.074600,3508056663.009599,10858825620.676298,1232630,143599,680055,2056284
2018-07-24,NYSE National (C),12208966,3195105,6979939,22384010,397275168.290000,112108982.934700,247733777.741800,757117928.966500,118503,19858,70272,208633
2018-07-24,FINRA / NYSE TRF (DN),173981313,66642490,183166308,423790111,6444801261.037600,2130683786.204800,9461851299.170308,18037336346.412708,417232,140595,493065,1050892
2018-07-24,FINRA / Nasdaq TRF Carteret (DQ),1063409288,330512804,653724086,2047646178,47164637740.681403,20418164089.026108,38040997923.305496,105623799753.013007,3796043,745013,2289062,6830118
2018-07-24,EDGA Equities (J),42475371,22249295,21400159,86124825,1724544073.039200,1273280100.528401,1230147422.142500,4227971595.710101,388307,105071,187933,681311
2018-07-24,EDGX Equities (K),167026796,73320016,134657115,375003927,7824249829.790602,4098308477.744999,7795193679.550102,19717751987.085703,1269705,289940,914698,2474343
2018-07-24,CHX (M),9461689,13891743,13306649,36660081,487334404.738400,1326387905.717200,1653852001.743600,3467574312.199200,4161,3921,4497,12579
2018-07-24,NYSE (N),780704971,19466449,28425338,828596758,33974301783.032694,1563220366.413101,1888811137.531101,37426333286.976896,2458213,79991,205369,2743573
2018-07-24,NYSE Arca (P),187622391,274762643,144023380,606408414,9077611435.604399,15251335112.202700,8741260497.306800,33070207045.113899,1492339,729196,1135824,3357359
2018-07-24,NASDAQ (Q),367660360,143563483,506073549,1017297392,20070373935.367501,9484066965.843096,34917338731.701584,64471779632.912181,3410096,622505,3410908,7443509
2018-07-24,IEX (V),103640404,15352027,53049006,172041437,5104368179.971400,937485984.976700,3617697576.077900,9659551741.026000,696361,65300,363944,1125605
2018-07-24,NASDAQ PSX (X),16487458,19175517,15032051,50695026,756011016.132900,1332124103.164200,1138310240.127300,3226445359.424400,145729,72794,134543,353066
2018-07-24,BYX Equities (Y),176347881,69097777,81600207,327045865,5875282375.013200,3111104971.109900,3569230569.015198,12555617915.138298,1563068,330544,777832,2671444
2018-07-24,BZX Equities (Z),206715015,93426743,116888038,417029796,9755992837.384099,6475455952.098298,7668902142.235499,23900350931.717896,2032614,438618,1107460,3578692
2018-07-23,NYSE American (A),4393013,12504719,2206067,19103799,204371832.248500,154649930.088800,158066880.940800,517088643.278100,43097,35534,22731,101362
2018-07-23,NASDAQ BX (B),97461169,25175130,51049692,173685991,4634318558.333100,1342614556.523000,3018528258.469000,8995461373.325100,1047661,115964,586311,1749936
2018-07-23,NYSE National (C),10288690,2598192,5886296,18773178,281619599.109800,89589831.225900,191710690.940400,562920121.276100,93596,16891,57777,168264
2018-07-23,FINRA / NYSE TRF (DN),141335060,50887297,134778437,327000794,4752330193.554599,1532978643.750800,7211888283.273500,13497197120.578899,359135,116297,389776,865208
2018-07-23,FINRA / Nasdaq TRF Carteret (DQ),919683500,310596809,559711075,1789991384,36780784024.470203,16677563576.740499,32384920270.570701,85843267871.781403,3294140,678462,2021673,5994275
2018-07-23,EDGA Equities (J),36082340,17001933,17359863,70444136,1384608107.234600,910903441.323700,1008982810.961200,3304494359.519500,329961,78972,159178,568111
2018-07-23,EDGX Equities (K),145108173,54044304,105736972,304889449,6363848132.877200,2699091957.599001,6208129013.978700,15271069104.454901,1090933,207910,751334,2050177
2018-07-23,CHX (M),20657052,12086001,8210824,40953877,845955884.363500,937058278.475000,683285689.892700,2466299852.731200,3046,3174,3042,9262
2018-07-23,NYSE (N),669455390,14656578,24086499,708198467,28195815325.539697,1135357115.050300,1676291174.870401,31007463615.460398,2051536,61828,178746,2292110
2018-07-23,NYSE Arca (P),158038490,211571947,121051807,490662244,7146461811.493100,10517654092.929791,8020079163.808103,25684195068.230994,1233736,531548,994836,2760120
2018-07-23,NASDAQ (Q),303320704,110442523,425945742,839708969,15764392740.447098,6656741063.671102,28927505512.538095,51348639316.656295,2766905,458018,2829987,6054910
2018-07-23,IEX (V),89355269,12058131,44063894,145477294,4219549339.780700,696839124.615800,2969465924.396900,7885854388.793400,599510,51516,308223,959249
2018-07-23,NASDAQ PSX (X),13497429,13909755,11955515,39362699,583452717.136000,959752353.014600,964523036.699500,2507728106.850100,117299,51374,110965,279638
2018-07-23,BYX Equities (Y),150527100,56122391,64845372,271494863,4853002287.031999,2293230630.181300,2971879749.011200,10118112666.224499,1350506,255470,661072,2267048
2018-07-23,BZX Equities (Z),169288420,70869822,91383433,331541675,7554693615.037003,4295831709.320100,5790499408.680201,17641024733.037304,1687449,327921,908897,2924267
2018-07-20,NYSE American (A),4549113,15414898,2316759,22280770,207080493.610500,176821844.537200,147376874.692500,531279212.840200,43116,33907,22857,99880
2018-07-20,NASDAQ BX (B),106035684,27563516,52572698,186171898,4894937950.353000,1556115685.136001,2907698865.425500,9358752500.914501,1083907,134955,572329,1791191
2018-07-20,NYSE National (C),11626597,2809363,6375009,20810969,345520920.955000,107446015.100400,222639955.488000,675606891.543400,110466,17365,63953,191784
2018-07-20,FINRA / NYSE TRF (DN),145900671,47217035,136197349,329315055,4624267540.708600,1586706379.936000,6646138084.438799,12857112005.083399,351787,103888,379042,834717
2018-07-20,FINRA / Nasdaq TRF Carteret (DQ),954633533,317890698,585660467,1858184698,38536224994.640401,23294740571.137708,33050921860.288787,94881887426.066896,3292894,659310,1924099,5876303
2018-07-20,EDGA Equities (J),40323951,18252925,18538297,77115173,1479774773.455300,1090611622.228400,1064292204.360200,3634678600.043900,350393,88735,163313,602441
2018-07-20,EDGX Equities (K),162316413,60496641,112313618,335126672,6746913994.609300,3883484574.258999,5976949107.927700,16607347676.795999,1129439,245164,741743,2116346
2018-07-20,CHX (M),9573723,16504900,11968047,38046670,501885209.243500,1364256743.458000,1267965791.812300,3134107744.513800,3639,3269,2882,9790
2018-07-20,NYSE (N),822912486,17895897,27233571,868041954,35105525353.649798,1447464486.751000,1829657480.643300,38382647321.044098,2136765,74138,197280,2408183
2018-07-20,NYSE Arca (P),186481967,246042705,120702338,553227010,7811701215.801403,13587914666.561303,6902665302.830599,28302281185.193305,1302635,599191,913030,2814856
2018-07-20,NASDAQ (Q),334383566,128322582,497983528,960689676,16345211103.234099,8807842885.701202,34146954932.201905,59300008921.137206,2808537,536066,2731545,6076148
2018-07-20,IEX (V),88759444,13727503,43607262,146094209,4171880340.366400,806492835.763500,2925089149.069601,7903462325.199501,551314,57834,281451,890599
2018-07-20,NASDAQ PSX (X),15912324,16410597,12978408,45301329,686351845.495000,1281721953.297100,1038995852.174400,3007069650.966500,131802,63766,113544,309112
2018-07-20,BYX Equities (Y),167734789,63904593,72202316,303841698,5164599722.966200,2838875126.142801,3077265926.952400,11080740776.061401,1396084,287364,673591,2357039
2018-07-20,BZX Equities (Z),192107878,81281041,95888563,369277482,8341251446.324501,5446359422.895000,6157566171.475303,19945177040.694804,1727253,376396,885873,2989522
2018-07-19,NYSE American (A),4834791,14477731,2331074,21643596,227958802.110000,188608110.122100,146592588.080900,563159500.313000,45083,41762,22330,109175
2018-07-19,NASDAQ BX (B),104332966,31805839,54647157,190785962,4979533910.574800,1678106520.329600,3017689911.702900,9675330342.607300,1101155,150527,599837,1851519
2018-07-19,NYSE National (C),11989661,3311157,6792537,22093355,353660545.494500,112705473.503000,215569198.314200,681935217.311700,115443,19993,66705,202141
2018-07-19,FINRA / NYSE TRF (DN),150630744,62741140,143315307,356687191,5562289319.040902,1873669515.806700,7307852034.523902,14743810869.371504,374431,125226,394839,894496
2018-07-19,FINRA / Nasdaq TRF Carteret (DQ),1044487580,354902176,641424673,2040814429,43424203845.904383,19373629536.512804,34685161685.665002,97482995068.082189,3442459,735820,2062511,6240790
2018-07-19,EDGA Equities (J),39887134,21586830,20589340,82063304,1577058050.218800,1165659003.560500,1171558302.741800,3914275356.521100,360214,96136,182037,638387
2018-07-19,EDGX Equities (K),164001781,73601256,123038046,360641083,7360898938.019898,3937830810.991701,6555287431.379801,17854017180.391400,1223144,284850,820272,2328266
2018-07-19,CHX (M),10460711,8180954,11229390,29871055,551575985.345000,749119966.389200,977812327.709000,2278508279.443200,4408,4049,2960,11417
2018-07-19,NYSE (N),735140122,21462829,27552670,784155621,31455188092.196598,1718778916.154400,1639020131.751000,34812987140.101998,2238039,86309,187500,2511848
2018-07-19,NYSE Arca (P),183832789,272932121,141132551,597897461,8392118961.449601,13761362582.675699,7895849354.559898,30049330898.685198,1388897,684531,1028382,3101810
2018-07-19,NASDAQ (Q),354006963,149135322,475726640,978868925,18215658155.475900,9096952713.130499,29769786525.438006,57082397394.044405,3162250,602999,2960948,6726197
2018-07-19,IEX (V),92814968,16656189,45889959,155361116,4347695116.993700,883484498.496800,2592080490.841900,7823260106.332400,579602,65721,292366,937689
2018-07-19,NASDAQ PSX (X),15146700,20427059,13200342,48774101,660758874.854700,1438034428.363300,1049709949.801500,3148503253.019500,126999,71416,115321,313736
2018-07-19,BYX Equities (Y),161935296,74796771,72974572,309706639,5152425539.390700,3134694496.719499,3085991790.047100,11373111826.157299,1416706,342595,701431,2460732
2018-07-19,BZX Equities (Z),204865140,97337746,106464100,408666986,9243786957.032603,6143222819.199797,6650732961.246599,22037742737.478999,1919699,441451,980430,3341580
2018-07-18,NYSE American (A),4152988,17520565,2214276,23887829,204804200.025900,155845954.105800,140871664.706200,501521818.837900,40344,37080,21106,98530
2018-07-18,NASDAQ BX (B),102458882,26755764,53567173,182781819,5071651474.929401,1282264346.621100,3088264183.850700,9442180005.401201,1098680,127060,594841,1820581
2018-07-18,NYSE National (C),9818131,2339575,5769557,17927263,267340357.720400,91523961.096400,159116065.635800,517980384.452600,97532,16305,56969,170806
2018-07-18,FINRA / NYSE TRF (DN),141017833,54345430,153214988,348578251,4991042607.930501,1667633972.683501,6867477104.580195,13526153685.194197,346232,117862,398023,862117
2018-07-18,FINRA / Nasdaq TRF Carteret (DQ),1009354773,329231305,654917623,1993503701,41762412292.414105,18462846086.638697,34611082414.054278,94836340793.107080,3361642,676118,2033791,6071551
2018-07-18,EDGA Equities (J),37090655,18298025,20516122,75904802,1535081610.549600,950897578.057300,1072276322.989700,3558255511.596600,335657,88489,168607,592753
2018-07-18,EDGX Equities (K),137846186,59473732,121081239,318401157,6071271466.121701,2943853670.476100,5852605814.648599,14867730951.246400,1012404,232499,738306,1983209
2018-07-18,CHX (M),12631259,9593822,14476580,36701661,625910759.159000,1129338337.012500,1988296105.724800,3743545201.896300,3336,3136,3606,10078
2018-07-18,NYSE (N),710130879,16655853,25537435,752324167,30858399895.113400,1193174568.230800,1542186244.297300,33593760707.641500,2152915,69185,173018,2395118
2018-07-18,NYSE Arca (P),162055968,221549855,131679817,515285640,7606257795.967498,11129364208.082094,6861940581.978002,25597562586.027594,1280503,571385,955460,2807348
2018-07-18,NASDAQ (Q),330926277,112611826,468908540,912446643,17513148884.803193,6620982347.489300,29712165746.261402,53846296978.553895,3003578,483820,2896761,6384159
2018-07-18,IEX (V),92782751,14433858,44677817,151894426,4439346638.902700,759031850.176500,2689294995.943400,7887673485.022600,593662,60296,295515,949473
2018-07-18,NASDAQ PSX (X),13983642,14528675,10799149,39311466,626125453.450800,991113416.449600,865798601.218000,2483037471.118400,116859,55563,86230,258652
2018-07-18,BYX Equities (Y),160320331,66855729,72556395,299732455,5170691571.292900,2644496725.533500,2996669179.214400,10811857476.040800,1416746,305730,684319,2406795
2018-07-18,BZX Equities (Z),186989705,78187115,101193777,366370597,8506596831.434999,4576907715.071399,6081729621.363899,19165234167.870297,1912969,376121,954393,3243483
2018-07-17,NYSE American (A),4252188,16205347,2416150,22873685,198843490.781600,170340036.942000,233743057.634700,602926585.358300,40187,46259,23773,110219
2018-07-17,NASDAQ BX (B),100143013,32837099,53293699,186273811,4721046504.756300,1523288324.113200,3461368613.951898,9705703442.821398,1047599,150730,606928,1805257
2018-07-17,NYSE National (C),9686836,2400568,4916169,17003573,242912032.011500,82127380.125400,164317034.907000,489356447.043900,95602,16519,51778,163899
2018-07-17,FINRA / NYSE TRF (DN),121286838,56341652,128694984,306323474,4258621650.153301,1606711488.833400,7417896523.189100,13283229662.175801,320360,135817,396101,852278
2018-07-17,FINRA / Nasdaq TRF Carteret (DQ),1035779422,359810492,624393398,2019983312,40128309356.130597,18185157587.074905,39434369328.506391,97747836271.711893,3299834,781900,2111177,6192911
2018-07-17,EDGA Equities (J),34849329,25950345,18064702,78864376,1439474721.435600,1105388185.786100,1195260838.459800,3740123745.681500,312873,109525,160403,582801
2018-07-17,EDGX Equities (K),130937720,81584309,112124237,324646266,5608198054.421400,3588639403.396000,7023009125.146701,16219846582.964101,934472,294434,735108,1964014
2018-07-17,CHX (M),10863882,15968420,8421624,35253926,594721280.986700,1093727638.032800,906533084.648000,2594982003.667500,2532,4652,4097,11281
2018-07-17,NYSE (N),708373314,18942523,23715999,751031836,30293018623.633900,1402051342.186600,1516796228.439300,33211866194.259800,2114401,76453,166815,2357669
2018-07-17,NYSE Arca (P),158014722,255813078,121984070,535811870,7168388061.510802,12692275419.426596,8583303400.733998,28443966881.671396,1213230,633636,971952,2818818
2018-07-17,NASDAQ (Q),317480762,184243339,436779335,938503436,16746542270.974203,8902115243.308401,33569824583.684802,59218482097.967406,2863868,660792,2950629,6475289
2018-07-17,IEX (V),83741989,14618952,41215956,139576897,3818649676.691900,757065427.867800,3049683598.240401,7625398702.800101,553789,55131,289522,898442
2018-07-17,NASDAQ PSX (X),13548890,22637396,11267864,47454150,589713134.845000,1331805344.363200,956598573.236900,2878117052.445100,112872,77413,92198,282483
2018-07-17,BYX Equities (Y),160257841,69058538,69572073,298888452,5047035434.603800,2661244247.840300,3320710058.647100,11028989741.091200,1378253,316834,677722,2372809
2018-07-17,BZX Equities (Z),175705095,88208882,95358431,359272408,7762091169.368999,5355148903.806702,6659134392.032800,19776374465.208501,1665976,392977,916756,2975709
2018-07-16,NYSE American (A),3806953,11439613,1995276,17241842,178417549.897200,129019333.682300,115355659.714700,422792543.294200,36506,35173,19432,91111
2018-07-16,NASDAQ BX (B),91807658,23186454,50343128,165337240,4339611473.918100,1140618936.396500,2976665633.515400,8456896043.830000,974857,117273,559950,1652080
2018-07-16,NYSE National (C),9289162,2159355,5134034,16582551,244050072.615400,74566750.404200,128251684.174500,446868507.194100,91273,13377,51537,156187
2018-07-16,FINRA / NYSE TRF (DN),100581694,39147817,109333141,249062652,3510819807.335201,1174929640.920600,5066198381.219700,9751947829.475501,268328,98358,323815,690501
2018-07-16,FINRA / Nasdaq TRF Carteret (DQ),877533158,287416913,620963929,1785914000,34766361895.327398,14978295951.759904,31716373495.913310,81461031343.000612,3126696,670589,1985063,5782348
2018-07-16,EDGA Equities (J),31901774,16370802,17095919,65368495,1247441367.858800,840574004.836300,892348044.201800,2980363416.896900,282317,77873,148963,509153
2018-07-16,EDGX Equities (K),129199985,53326702,117647396,300174083,5386703899.281801,2711383710.632200,5676010659.778196,13774098269.692197,900672,204743,690084,1795499
2018-07-16,CHX (M),10404723,7013432,8692036,26110191,469088030.570000,688900592.940000,845023304.410400,2003011927.920400,2667,3068,3176,8911
2018-07-16,NYSE (N),712827558,14367175,22514052,749708785,30345488283.970200,1109694982.223700,1149362401.957800,32604545668.151700,2081892,63582,168534,2314008
2018-07-16,NYSE Arca (P),145560795,188423525,122513124,456497444,6537615240.444200,10645525872.983397,7231434473.366707,24414575586.794304,1108879,529342,900666,2538887
2018-07-16,NASDAQ (Q),298521154,100402886,454184572,853108612,15307181248.960803,6422221643.790896,28173763670.940497,49903166563.692196,2692840,453429,2767935,5914204
2018-07-16,IEX (V),84345862,10302481,37746872,132395215,3884656301.729100,582230288.912900,2536467670.172100,7003354260.814100,522589,44886,254047,821522
2018-07-16,NASDAQ PSX (X),12958635,12582444,10777694,36318773,562449694.112200,929831432.385000,850234050.665200,2342515177.162400,106898,52153,86248,245299
2018-07-16,BYX Equities (Y),149419578,54437608,67594006,271451192,4640114284.988500,2183707672.211600,2702320249.053300,9526142206.253400,1286240,252773,642655,2181668
2018-07-16,BZX Equities (Z),161708950,67265704,92825026,321799680,7195479142.520798,4203468642.320799,5436593834.456600,16835541619.298197,1544804,329764,850692,2725260
2018-07-13,NYSE American (A),3816644,12527681,2209220,18553545,171881875.055000,170020214.736500,130605622.576500,472507712.368000,37814,34112,21578,93504
2018-07-13,NASDAQ BX (B),87244284,24201610,48801521,160247415,4207729365.545600,1285755188.816700,2694403179.605400,8187887733.967700,949075,121064,542016,1612155
2018-07-13,NYSE National (C),7527593,2084081,4138508,13750182,192836516.576300,79305505.026300,96166203.026300,368308224.628900,76989,13000,42073,132062
2018-07-13,FINRA / NYSE TRF (DN),91830073,45843950,105624365,243298388,3440433879.114502,1294060333.721600,5170201125.008301,9904695337.844403,264722,100804,318226,683752
2018-07-13,FINRA / Nasdaq TRF Carteret (DQ),819973608,317946741,601924820,1739845169,34128282350.057293,16745772286.632699,31036774057.682186,81910828694.372178,2988071,650289,1965781,5604141
2018-07-13,EDGA Equities (J),29695651,15901914,18301865,63899430,1197440754.483700,990228817.742500,927868651.866400,3115538224.092600,276042,75775,153632,505449
2018-07-13,EDGX Equities (K),124548100,60245352,123651081,308444533,5461147645.728498,3074237438.094599,5931415866.344900,14466800950.167997,895800,230159,728731,1854690
2018-07-13,CHX (M),9045175,7800472,9126502,25972149,509269847.732000,714594783.110000,820162384.378800,2044027015.220800,2687,3237,3522,9446
2018-07-13,NYSE (N),634964291,15584696,22468926,673017913,27737115484.207206,1212020695.255500,1152954813.704700,30102090993.167406,2022559,66464,166743,2255766
2018-07-13,NYSE Arca (P),139592018,210563431,126653748,476809197,6522126784.857298,11591905829.246801,6611594641.600900,24725627255.704999,1091960,571466,892344,2555770
2018-07-13,NASDAQ (Q),287549199,109591797,442662090,839803086,15346615627.025298,7175816532.689102,27456480732.667081,49978912892.381481,2673642,483333,2735869,5892844
2018-07-13,IEX (V),69874222,11883092,41925899,123683213,3206269858.887400,702484306.624400,2451121162.984000,6359875328.495800,468142,49038,267061,784241
2018-07-13,NASDAQ PSX (X),12728993,14119569,11707470,38556032,576872767.858000,1036840580.733000,917850645.747800,2531563994.338800,110561,55765,90982,257308
2018-07-13,BYX Equities (Y),142227752,54686706,69501267,266415725,4548646037.376000,2411061218.875600,2785120789.089700,9744828045.341300,1288264,258665,664203,2211132
2018-07-13,BZX Equities (Z),159181164,73042488,98807221,331030873,7391532602.129500,4822036133.720098,6031352155.630302,18244920891.479900,1568992,347102,915717,2831811
2018-07-12,NYSE American (A),4273745,12370837,2413234,19057816,179210298.570400,179471754.546400,155851731.892700,514533785.009500,43536,36659,25202,105397
2018-07-12,NASDAQ BX (B),98428353,27895043,59548659,185872055,4765543393.867400,1585952755.921900,3412108526.133300,9763604675.922600,1150209,140743,699983,1990935
2018-07-12,NYSE National (C),7618557,2072836,4615919,14307312,186493059.758700,77092124.823000,100379739.727400,363964924.309100,77997,13056,44525,135578
2018-07-12,FINRA / NYSE TRF (DN),98764973,40209148,115826724,254800845,3665917769.974700,1354238536.357000,6123814962.160702,11143971268.492402,277247,99121,352385,728753
2018-07-12,FINRA / Nasdaq TRF Carteret (DQ),897975958,361521725,691639803,1951137486,36964396461.367180,19205479134.221802,37780087195.920388,93949962791.509370,3356736,684978,2341878,6383592
2018-07-12,EDGA Equities (J),33562486,19238793,20629101,73430380,1342102822.144100,1156777773.504400,1157378520.991400,3656259116.639900,326554,94326,186753,607633
2018-07-12,EDGX Equities (K),132080521,63657515,127931725,323669761,5647103647.984899,3574337918.803200,7009596846.288904,16231038413.077003,1016220,250214,876954,2143388
2018-07-12,CHX (M),7455423,10835072,7380024,25670519,424065952.852700,1087316330.445000,647668495.360500,2159050778.658200,3452,4023,4101,11576
2018-07-12,NYSE (N),682958564,18614374,24096898,725669836,30202059034.931506,1458931576.366301,1264365953.096600,32925356564.394407,2448388,78492,188930,2715810
2018-07-12,NYSE Arca (P),147974216,237266935,143940135,529181286,6718517618.421401,13503838293.343802,8062698462.345500,28285054374.110703,1228599,628789,1068845,2926233
2018-07-12,NASDAQ (Q),307549782,125246481,486987928,919784191,16117696827.689401,8414720848.672502,33017164125.548496,57549581801.910399,3187858,557936,3405496,7151290
2018-07-12,IEX (V),77888348,13852375,49082993,140823716,3442230355.570100,806035794.333800,3121231653.126102,7369497803.030002,537433,54931,315148,907512
2018-07-12,NASDAQ PSX (X),12765810,16335580,12408557,41509947,552826249.490000,1212655367.972100,1009720464.908200,2775202082.370300,119922,63328,105612,288862
2018-07-12,BYX Equities (Y),155747324,63184496,78093251,297025071,4879617886.927700,2727265526.064300,3258245270.607000,10865128683.599000,1535005,301660,840813,2677478
2018-07-12,BZX Equities (Z),169187779,83962633,106235303,359385715,7645412040.080399,5776291384.000901,6797386862.896102,20219090286.977402,1729614,405689,1043445,3178748
2018-07-11,NYSE American (A),4387389,12892859,2592070,19872318,188745953.491000,209449832.051700,158821020.186000,557016805.728700,45413,39818,25032,110263
2018-07-11,NASDAQ BX (B),101060639,34775513,54531712,190367864,4677747212.646900,1967446064.161400,2810064415.196200,9455257692.004500,1084499,166695,602920,1854114
2018-07-11,NYSE National (C),7731813,2199500,4484129,14415442,198258515.173300,78753241.395300,105530510.993300,382542267.561900,76388,14643,44883,135914
2018-07-11,FINRA / NYSE TRF (DN),84273249,35659587,83107830,203040666,3087433677.887600,1265105382.951100,3533627080.952800,7886166141.791500,237315,95445,269409,602169
2018-07-11,FINRA / Nasdaq TRF Carteret (DQ),966183142,414654406,628346189,2009183737,37923733053.141701,22345185460.367702,31511168454.656400,91780086968.165803,3348840,831768,2047966,6228574
2018-07-11,EDGA Equities (J),36459649,23807623,20605434,80872706,1469960200.172200,1574915732.027899,1056706841.867200,4101582774.067299,349874,111020,185326,646220
2018-07-11,EDGX Equities (K),144673850,77992460,117844729,340511039,5996603013.773501,4507571946.500599,5978915240.860600,16483090201.134700,1044147,316700,777220,2138067
2018-07-11,CHX (M),9289730,11687340,8997019,29974089,512004717.750600,1466594508.124600,664829970.658400,2643429196.533600,2702,5368,3437,11507
2018-07-11,NYSE (N),697256696,22547967,25569774,745374437,29070783986.978193,1858536544.102999,1364107150.956700,32293427682.037892,2294248,94975,194918,2584141
2018-07-11,NYSE Arca (P),158853242,297518395,133544410,589916047,7125632996.345499,16694244288.322995,7101256865.188901,30921134149.857395,1266660,774323,995630,3036613
2018-07-11,NASDAQ (Q),321943206,157192132,456325485,935460823,16385932753.642901,10619534969.424401,28154136845.892297,55159604568.959599,2996125,703616,2936003,6635744
2018-07-11,IEX (V),85372432,16796442,40349156,142518030,3821536875.660200,973269238.339000,2247049340.127400,7041855454.126600,568028,70581,279940,918549
2018-07-11,NASDAQ PSX (X),13585653,20460050,11573565,45619268,581117191.065700,1649231819.022000,898270714.904300,3128619724.992000,122378,79724,97956,300058
2018-07-11,BYX Equities (Y),168355350,81851134,72778534,322985018,5085619439.887200,3434483491.360400,2859818087.824800,11379921019.072400,1477100,385659,701062,2563821
2018-07-11,BZX Equities (Z),186759009,108375823,107832283,402967115,8379069040.696199,7332707601.986099,6400653779.958398,22112430422.640696,1815835,514191,1006649,3336675
2018-07-10,NYSE American (A),4335061,11816003,2093186,18244250,178982043.847300,145980255.614700,122005663.922100,446967963.384100,39919,37509,19876,97304
2018-07-10,NASDAQ BX (B),100576569,23398087,51984300,175958956,4663738928.295100,1277151988.706900,2756868100.851800,8697759017.853800,1071272,130539,589037,1790848
2018-07-10,NYSE National (C),8369925,1744608,3912794,14027327,192758571.813500,62230565.394300,94934959.450900,349924096.658700,76822,11525,41346,129693
2018-07-10,FINRA / NYSE TRF (DN),83298576,35523642,84272522,203094740,3125176525.433799,1180628198.877000,3492139914.831600,7797944639.142399,251467,97495,281300,630262
2018-07-10,FINRA / Nasdaq TRF Carteret (DQ),1083120762,365491669,646475982,2095088413,40326598373.253403,20704947981.492799,32657253371.589899,93688799726.336101,3401990,779313,2048405,6229708
2018-07-10,EDGA Equities (J),35864758,16782426,18784301,71431485,1408629239.857800,985984855.182900,1011603692.920900,3406217787.961600,326062,81441,168008,575511
2018-07-10,EDGX Equities (K),140395658,60961239,116794647,318151544,5679060714.504500,3293914291.340899,5575663807.980699,14548638813.826098,990172,257152,738222,1985546
2018-07-10,CHX (M),7639979,9610907,4979658,22230544,430109844.502000,983188055.636400,393462980.738500,1806760880.876900,2569,2729,3079,8377
2018-07-10,NYSE (N),709358543,17068213,22097088,748523844,30027780080.251805,1196666322.352600,1130668122.917700,32355114525.522105,2182583,74844,166915,2424342
2018-07-10,NYSE Arca (P),154538942,234318337,121500547,510357826,6739351022.244599,13239953129.939097,6363726384.542598,26343030536.726294,1214358,642362,934245,2790965
2018-07-10,NASDAQ (Q),310074378,118596639,449710505,878381522,15789891044.081593,7531441088.621300,27416377254.831110,50737709387.534003,2837308,542034,2786532,6165874
2018-07-10,IEX (V),88609792,12247277,39804721,140661790,3843714607.620800,692299536.611200,2223688178.280801,6759702322.512801,559780,49467,273269,882516
2018-07-10,NASDAQ PSX (X),12844008,15517483,10277342,38638833,535894998.152300,1093944343.215800,820918131.747700,2450757473.115800,110723,64256,86038,261017
2018-07-10,BYX Equities (Y),159696154,56967633,66804557,283468344,4929636076.639000,2545432763.616100,2721771658.697801,10196840498.952901,1380479,298132,651467,2330078
2018-07-10,BZX Equities (Z),181423163,84055746,95746898,361225807,7887869541.187799,5507699138.588298,5612178771.365899,19007747451.141996,1758814,421582,928622,3109018
2018-07-09,NYSE American (A),4704409,15531501,2573636,22809546,225875380.674000,214796075.783400,142366043.819600,583037500.277000,50289,42528,23844,116661
2018-07-09,NASDAQ BX (B),103540955,29203996,53123408,185868359,4922502874.412400,1535242710.735900,2857607865.813300,9315353450.961600,1137739,146052,624806,1908597
2018-07-09,NYSE National (C),6419145,1464050,3520204,11403399,174540738.035000,54908919.345400,85660731.319000,315110388.699400,75322,13200,42831,131353
2018-07-09,FINRA / NYSE TRF (DN),87525949,39716116,90429375,217671440,3343590194.520800,1267983914.415600,3628423562.849200,8239997671.785600,275860,102655,301322,679837
2018-07-09,FINRA / Nasdaq TRF Carteret (DQ),1006385602,373927812,679146588,2059460002,40104925584.758889,20184727929.800593,32919393090.663208,93209046605.222690,3587428,862600,2217554,6667582
2018-07-09,EDGA Equities (J),37910238,20659114,20196157,78765509,1514007111.623700,1216072088.805000,1061978006.369900,3792057206.798600,357686,97334,183168,638188
2018-07-09,EDGX Equities (K),151435718,69219190,127951090,348605998,6377343487.285300,3465581758.084399,5864186943.507101,15707112188.876800,1084376,277238,807468,2169082
2018-07-09,CHX (M),8275965,10392916,5655754,24324635,421729399.089200,976518855.583000,692542241.032200,2090790495.704400,2799,3270,4133,10202
2018-07-09,NYSE (N),744500729,17092904,23274845,784868478,31982654319.745901,1141603092.403600,1145707095.351700,34269964507.501201,2261054,74794,174585,2510433
2018-07-09,NYSE Arca (P),156067407,242803245,134821654,533692306,6939825247.158599,12858974500.722901,6445085708.981295,26243885456.862795,1268882,677375,1004277,2950534
2018-07-09,NASDAQ (Q),323594640,128206931,483185586,934987157,16533053603.898204,8030957209.324700,28669775893.793177,53233786707.016081,2983774,583659,2903773,6471206
2018-07-09,IEX (V),80971738,16080917,39681904,136734559,3545943762.768200,857258818.774400,2199546654.523500,6602749236.066100,536303,64917,269475,870695
2018-07-09,NASDAQ PSX (X),15533514,15247937,12151176,42932627,623317371.807500,1010361145.921300,890510971.460200,2524189489.189000,135572,65127,100684,301383
2018-07-09,BYX Equities (Y),159123109,67274078,69905570,296302757,5168703859.913500,2914457385.341500,2832505747.359200,10915666992.614200,1437637,317983,692789,2448409
2018-07-09,BZX Equities (Z),184077411,87417915,98826671,370321997,8065704381.001995,5687318685.662800,5615071514.888400,19368094581.553195,1795938,427660,931137,3154735
2018-07-06,NYSE American (A),4205674,12209141,2253993,18668808,176955402.330000,165364245.507000,138338480.729300,480658128.566300,42818,33787,22671,99276
2018-07-06,NASDAQ BX (B),89352694,28024942,51249247,168626883,4083175229.740500,1612421898.980200,2781502501.623500,8477099630.344200,1022757,147871,615168,1785796
2018-07-06,NYSE National (C),5687062,1075663,3057104,9819829,137475823.359700,49028626.004300,74187755.578100,260692204.942100,60535,9496,36041,106072
2018-07-06,FINRA / NYSE TRF (DN),71081023,30993746,86234560,188309329,2390354989.466901,1137856674.050000,3613717265.880000,7141928929.396901,224816,85965,287147,597928
2018-07-06,FINRA / Nasdaq TRF Carteret (DQ),795028240,338132912,599984590,1733145742,30436435030.009702,19301852280.571305,30681615513.098110,80419902823.679117,3034124,774946,2074176,5883246
2018-07-06,EDGA Equities (J),31520883,18314210,19599527,69434620,1227812460.561000,1176194709.617300,1045612977.489700,3449620147.668000,304831,94706,174252,573789
2018-07-06,EDGX Equities (K),125726516,65482338,118274741,309483595,5158612295.468201,3778500757.171600,5692053874.908000,14629166927.547801,943014,282704,772644,1998362
2018-07-06,CHX (M),7928073,12416888,5480561,25825522,352467899.799600,1047417109.205600,475176798.715700,1875061807.720900,2507,3288,4668,10463
2018-07-06,NYSE (N),666675766,18249803,23189907,708115476,29982909816.570498,1445057135.112601,1218827783.311800,32646794734.994899,2186091,82320,181670,2450081
2018-07-06,NYSE Arca (P),134561728,235630313,126110458,496302499,5842592552.389400,13539813270.759294,6593643734.137401,25976049557.286095,1080235,682937,939134,2702306
2018-07-06,NASDAQ (Q),277942441,126432643,467163707,871538791,14467487400.402305,8543141829.398402,29343100875.156895,52353730104.957602,2702483,577972,2988399,6268854
2018-07-06,IEX (V),66551108,13952328,35365154,115868590,2925757315.461700,756497436.794800,2011763502.643300,5694018254.899800,477338,56338,253556,787232
2018-07-06,NASDAQ PSX (X),12158676,15259541,11433905,38852122,522368888.560700,1140812375.698900,945552197.807100,2608733462.066700,113318,65330,99009,277657
2018-07-06,BYX Equities (Y),145635373,62746838,71253359,279635570,4542832337.453600,2828565863.699800,2875547797.235300,10246945998.388700,1371574,323852,733289,2428715
2018-07-06,BZX Equities (Z),156204736,86579280,97954565,340738581,6832355052.519300,6020747701.187600,5990368985.946402,18843471739.653302,1576545,419099,950396,2946040
2018-07-05,NYSE American (A),4766466,13922817,2386496,21075779,196259767.100000,227037376.818900,142436147.215200,565733291.134100,44790,40486,23680,108956
2018-07-05,NASDAQ BX (B),97881353,28975557,53892879,180749789,4471248175.920200,1562670812.837900,2795396401.005800,8829315389.763900,1059481,153953,617059,1830493
2018-07-05,NYSE National (C),4669071,982044,3214465,8865580,115086406.588200,38654323.930100,84040321.101200,237781051.619500,51527,9631,35470,96628
2018-07-05,FINRA / NYSE TRF (DN),74319612,34146692,75615488,184081792,2540948764.033100,1189609844.034200,3334744324.222001,7065302932.289301,226060,94082,267832,587974
2018-07-05,FINRA / Nasdaq TRF Carteret (DQ),921341765,358985320,600856592,1881183677,35685575705.045903,18930453532.647192,31605895462.336300,86221924700.029395,3244408,835158,2059193,6138759
2018-07-05,EDGA Equities (J),33899398,21313218,19051824,74264440,1270740006.748600,1202720302.941900,1001459581.364400,3474919891.054900,311648,102332,169571,583551
2018-07-05,EDGX Equities (K),139131204,68720850,116268704,324120758,5655740024.492799,3753340659.714300,6092861923.586299,15501942607.793398,1045694,282619,803592,2131905
2018-07-05,CHX (M),4940060,8561505,3689188,17190753,265689229.290000,779291941.180800,361920144.482700,1406901314.953500,3204,3235,4403,10842
2018-07-05,NYSE (N),810096067,19508990,23563965,853169022,33895561538.799801,1334952579.517800,1202175423.627900,36432689541.945501,2261639,88914,178679,2529232
2018-07-05,NYSE Arca (P),155965540,263674763,127468930,547109233,6696497871.449400,14431917607.058502,6672636371.258604,27801051849.766506,1257592,729133,1004427,2991152
2018-07-05,NASDAQ (Q),319063301,132309196,509694310,961066807,16122412890.559796,8539869051.126100,30943306845.246307,55605588786.932203,3043380,621310,3048006,6712696
2018-07-05,IEX (V),73226023,13982308,37528272,124736603,3186713641.730700,794823404.129200,2056080666.292600,6037617712.152500,502572,59361,257269,819202
2018-07-05,NASDAQ PSX (X),13093891,15268965,10740010,39102866,560248567.581700,1126599175.018500,753452141.865900,2440299884.466100,116064,68062,94761,278887
2018-07-05,BYX Equities (Y),156231170,66354692,70945004,293530866,4756403725.261600,2809480773.101300,2868677049.841800,10434561548.204700,1398623,327296,696440,2422359
2018-07-05,BZX Equities (Z),171535661,90989674,99777541,362302876,7379493023.665001,6073989751.888099,6026033211.268800,19479515986.821900,1702534,455828,998180,3156542
2018-07-03,NYSE American (A),3524711,10919763,1685853,16130327,163300401.303100,133980491.122700,103190213.997200,400471106.423000,33191,35021,16377,84589
2018-07-03,NASDAQ BX (B),62904601,22212573,35174071,120291245,2905583226.850300,1115503440.770200,1820515517.797800,5841602185.418300,673147,112139,394083,1179369
2018-07-03,NYSE National (C),2769897,491069,1700587,4961553,75202348.445000,19923886.755500,41651615.744600,136777850.945100,27547,4436,18318,50301
2018-07-03,FINRA / NYSE TRF (DN),51036257,27914957,54433211,133384425,1767788168.956500,844936635.703000,2313284396.078900,4926009200.738400,150136,73957,185045,409138
2018-07-03,FINRA / Nasdaq TRF Carteret (DQ),577675357,278155618,395313969,1251144944,21748203266.657498,13448593748.726196,20080739074.329006,55277536089.712700,2196865,691318,1375202,4263385
2018-07-03,EDGA Equities (J),22837868,16518400,13433273,52789541,911128866.392100,835557370.201400,699603550.382500,2446289786.976000,209178,76157,114954,400289
2018-07-03,EDGX Equities (K),99417142,57243290,81786168,238446600,4072492434.973000,2718344130.783000,4291163946.506299,11082000512.262299,737662,232664,568254,1538580
2018-07-03,CHX (M),6765775,6432394,3669581,16867750,296141359.408000,708678120.483800,362353355.697800,1367172835.589600,2733,3139,3860,9732
2018-07-03,NYSE (N),489151812,11729283,15844476,516725571,20540957831.344797,837301682.499100,795632815.418300,22173892329.262197,1655376,58474,118382,1832232
2018-07-03,NYSE Arca (P),100338104,184006851,93101549,377446504,4459310998.720900,10097643048.246299,4847425364.342198,19404379411.309397,827445,518935,674543,2020923
2018-07-03,NASDAQ (Q),211891186,100641693,326543224,639076103,10770344573.570401,6398201413.935901,20563442405.872505,37731988393.378807,1984623,469858,2137524,4592005
2018-07-03,IEX (V),50129854,10932053,24675650,85737557,2121474381.222100,575051636.638900,1360226554.961100,4056752572.822100,322604,44669,169430,536703
2018-07-03,NASDAQ PSX (X),9784711,11579239,8081255,29445205,440888356.431600,870741453.676900,574328256.288900,1885958066.397400,86352,53385,71570,211307
2018-07-03,BYX Equities (Y),99508964,47029358,44368525,190906847,2985080197.133200,1881726655.182300,1772533482.810000,6639340335.125500,910187,248056,440538,1598781
2018-07-03,BZX Equities (Z),123731147,68314776,71613638,263659561,5353224375.536000,4375423840.774700,4392616471.606401,14121264687.917101,1272045,370383,723111,2365539
2018-07-02,NYSE American (A),4650971,16497422,2421468,23569861,214215756.734000,219499822.783200,154299210.204900,588014789.722100,45398,53322,24471,123191
2018-07-02,NASDAQ BX (B),104482501,35715643,55583296,195781440,4645441465.334400,1904836068.351600,2819425237.471800,9369702771.157800,1101239,179675,630330,1911244
2018-07-02,NYSE National (C),5229146,982676,3705401,9917223,140801495.951000,39747022.349600,99365141.702300,279913660.002900,55998,8702,39613,104313
2018-07-02,FINRA / NYSE TRF (DN),90611414,52256657,81530468,224398539,2951362566.484699,1820244774.566400,3592582219.858198,8364189560.909297,239016,121087,269767,629870
2018-07-02,FINRA / Nasdaq TRF Carteret (DQ),962399615,496468773,618359808,2077228196,36338840258.247096,26471488427.736398,32746178473.313613,95556507159.297107,3507854,1086574,2097400,6691828
2018-07-02,EDGA Equities (J),40192606,27982326,21088552,89263484,1542237178.244700,1454062755.011100,1119571716.267200,4115871649.523000,366257,122880,188041,677178
2018-07-02,EDGX Equities (K),163505413,86789384,116830050,367124847,6132792696.725801,4604023380.614602,6047960406.628000,16784776483.968403,1153868,345306,837609,2336783
2018-07-02,CHX (M),7053400,10069183,5726923,22849506,465362752.156100,1133315268.283900,546632047.062300,2145310067.502300,3685,3895,5619,13199
2018-07-02,NYSE (N),755879434,19612727,23096364,798588525,31822958049.376301,1525959115.668000,1209444821.916900,34558361986.961201,2525108,94387,186826,2806321
2018-07-02,NYSE Arca (P),167346992,297896928,130524558,595768478,7161168979.135301,16543548205.002793,6870967685.145198,30575684869.283292,1327390,790089,1032232,3149711
2018-07-02,NASDAQ (Q),340470494,147580476,490669515,978720485,16916210602.220396,9614654523.391108,30517568263.540694,57048433389.152198,3209336,676340,3260238,7145914
2018-07-02,IEX (V),81603401,17808295,39233035,138644731,3576248358.532300,972636721.925400,2258981870.866800,6807866951.324500,544452,71921,278333,894706
2018-07-02,NASDAQ PSX (X),13449351,19951835,11155437,44556623,572342799.666500,1396801444.639200,787320760.769800,2756465005.075500,117212,85409,97559,300180
2018-07-02,BYX Equities (Y),169529483,81775934,74200703,325506120,5197059984.252100,3551852341.862400,2982735591.869300,11731647917.983800,1504097,373250,731915,2609262
2018-07-02,BZX Equities (Z),188635988,106095870,103755079,398486937,8224713071.638000,7028310617.080301,6221823662.680100,21474847351.398401,1887668,507534,1028413,3423615
2018-06-29,NYSE American (A),5853724,21824492,3153368,30831584,268973172.819400,263546708.498000,186616748.664800,719136629.982200,56695,58173,30757,145625
2018-06-29,NASDAQ BX (B),117213777,38909821,63349562,219473160,5464433134.754300,2165703565.492800,3255288876.220900,10885425576.468000,1223792,186673,685343,2095808
2018-06-29,NYSE National (C),3181881,852152,2479654,6513687,77113532.150000,39551235.403800,53351221.695000,170015989.248800,30368,6500,23114,59982
2018-06-29,FINRA / NYSE TRF (DN),93904803,42001115,94000733,229906651,3393630452.433600,1273848262.039500,3443063775.675401,8110542490.148501,243689,102753,265129,611571
2018-06-29,FINRA / Nasdaq TRF Carteret (DQ),1105033238,462017191,760200953,2327251382,45771972331.968990,28004963195.255391,37067347291.697300,110844282818.921681,3678196,935708,2145574,6759478
2018-06-29,EDGA Equities (J),40086819,25651085,23425368,89163272,1652794312.274100,1481351790.990300,1204699472.862600,4338845576.127000,363269,116145,193563,672977
2018-06-29,EDGX Equities (K),161287407,90948488,135196543,387432438,6821020692.286799,4948310637.416997,6167487848.762400,17936819178.466196,1185589,354451,859782,2399822
2018-06-29,CHX (M),9272284,14566608,8115401,31954293,557640398.164000,1371853698.980000,578403279.670200,2507897376.814200,3851,4826,4077,12754
2018-06-29,NYSE (N),982351408,22467093,28100998,1032919499,44738980962.735397,1746947283.062300,1373206432.555200,47859134678.352897,2609903,99238,197862,2907003
2018-06-29,NYSE Arca (P),187183201,315500104,146415988,649099293,8892114068.299302,18142921041.397098,7319105783.836802,34354140893.533202,1484251,797701,1063797,3345749
2018-06-29,NASDAQ (Q),373352696,168593591,678404310,1220350597,19535605242.846205,11240556581.985906,39067186554.093374,69843348378.925485,3448863,707096,3374172,7530131
2018-06-29,IEX (V),87638630,18061999,43857795,149558424,4085951799.649400,945842174.668500,2439409909.631200,7471203883.949100,597706,67370,305273,970349
2018-06-29,NASDAQ PSX (X),16640663,22012559,13559233,52212455,780910291.611000,1712966368.999200,1071487344.096300,3565364004.706500,145806,91327,113980,351113
2018-06-29,BYX Equities (Y),189694912,86297601,85764776,361757289,6087588417.411300,3759763045.671900,3369726782.350001,13217078245.433201,1655937,391768,787458,2835163
2018-06-29,BZX Equities (Z),214104684,113855091,122796308,450756083,9865846576.279001,7924086833.654901,7283840768.988002,25073774178.921904,2093006,536587,1126881,3756474
2018-06-28,NYSE American (A),6481802,22741263,3727850,32950915,289859045.857100,195026500.971000,208426532.244000,693312079.072100,68518,62038,37642,168198
2018-06-28,NASDAQ BX (B),122142033,35615399,69800323,227557755,5603633431.864901,2035191236.584100,3580035938.313700,11218860606.762701,1269243,184007,749119,2202369
2018-06-28,NYSE National (C),3080141,498852,2586055,6165048,66044686.545000,19506478.052500,50667917.690000,136219082.287500,30900,3901,23619,58420
2018-06-28,FINRA / NYSE TRF (DN),92336824,55879611,101074966,249291401,3416631361.311099,1425245130.663700,4061237586.528101,8903114078.502900,251469,128800,304479,684748
2018-06-28,FINRA / Nasdaq TRF Carteret (DQ),1096206472,466401393,790392408,2353000273,42561677455.745688,21613834979.474496,37268289853.725299,101443802288.945483,3963876,1145380,2541100,7650356
2018-06-28,EDGA Equities (J),42033455,26622199,25900538,94556192,1668670713.256300,1509052766.768200,1366380066.020600,4544103546.045100,386003,128321,232347,746671
2018-06-28,EDGX Equities (K),168734977,111789220,145617358,426141555,7191863195.670599,5500978454.944697,6909616706.866400,19602458357.481696,1314200,430879,1002233,2747312
2018-06-28,CHX (M),11268360,18337061,9924545,39529966,603850489.418400,1459800955.339200,881414835.594000,2945066280.351600,4082,5353,5912,15347
2018-06-28,NYSE (N),809167271,22517479,36341086,868025836,33245371520.212796,1617400206.234799,1797370617.563800,36660142344.011395,2769971,111494,249257,3130722
2018-06-28,NYSE Arca (P),185612555,310654753,154643690,650910998,8611055212.444099,16774094779.742691,7772473131.078997,33157623123.265787,1504403,907997,1180548,3592948
2018-06-28,NASDAQ (Q),384900798,187072378,563954137,1135927313,19873734539.383304,11896505545.718999,33776886084.426803,65547126169.529106,3645397,866924,3786012,8298333
2018-06-28,IEX (V),95731355,17378029,52164106,165273490,4287413682.829500,898569564.796400,2808431381.749100,7994414629.375000,631908,71891,346970,1050769
2018-06-28,NASDAQ PSX (X),18208699,23666196,15418682,57293577,785449713.317500,1930844195.801999,1063082799.516200,3779376708.635699,156365,109301,138295,403961
2018-06-28,BYX Equities (Y),194826927,83505796,94348825,372681548,6167095341.594500,3543721160.049599,3662695922.543000,13373512424.187099,1750181,404927,895924,3051032
2018-06-28,BZX Equities (Z),230373549,134815039,142976107,508164695,10244403174.382204,9340429107.598798,8604859141.705702,28189691423.686704,2197595,671762,1318477,4187834
2018-06-27,NYSE American (A),6315054,21991011,3868108,32174173,280655677.613600,289119135.558600,222144579.818200,791919392.990400,59840,63601,35178,158619
2018-06-27,NASDAQ BX (B),124009712,43445782,69561702,237017196,5676474478.462401,2483680663.322000,3717914777.456500,11878069919.240901,1255647,208018,733641,2197306
2018-06-27,NYSE National (C),3491798,954507,2758031,7204336,70630478.105000,49349050.578800,60017610.427400,179997139.111200,30745,7258,26198,64201
2018-06-27,FINRA / NYSE TRF (DN),107863935,51721627,106041624,265627186,3893253984.190499,1624082481.202101,4704286938.944602,10221623404.337202,279049,116851,336170,732070
2018-06-27,FINRA / Nasdaq TRF Carteret (DQ),1234817278,559349061,813818865,2607985204,46756600254.053308,27532032203.140700,39936697269.994399,114225329727.188407,3958670,1035073,2577365,7571108
2018-06-27,EDGA Equities (J),45254741,31167891,27324418,103747050,1785470285.783900,1795898944.123900,1397930953.888400,4979300183.796200,401167,145499,227781,774447
2018-06-27,EDGX Equities (K),185477298,111476383,162224565,459178246,7490439695.954701,6142569799.340500,8039717580.579299,21672727075.874500,1328745,422173,1064867,2815785
2018-06-27,CHX (M),14381416,15633926,8271250,38286592,591961710.092000,1540664107.634500,894420109.150700,3027045926.877200,4949,5536,5609,16094
2018-06-27,NYSE (N),896515196,28092936,32184185,956792317,36558731138.149303,2200618632.134199,1680118120.678800,40439467890.962302,2936612,126810,231290,3294712
2018-06-27,NYSE Arca (P),202605215,350022969,180035173,732663357,9044860921.260801,20058620380.959708,9294450975.422297,38397932277.642806,1600587,1018025,1302180,3920792
2018-06-27,NASDAQ (Q),412808780,202607905,597483523,1212900208,20633698928.634801,13653933770.650495,36552445245.559099,70840077944.844395,3800936,885268,4016721,8702925
2018-06-27,IEX (V),108772741,22561529,53857944,185192214,4657934125.689100,1145606800.956700,3103959928.631300,8907500855.277100,670915,84464,359469,1114848
2018-06-27,NASDAQ PSX (X),17080519,25374230,16045496,58500245,743162507.723800,2070984725.345000,1197412081.538400,4011559314.607200,147246,107125,136506,390877
2018-06-27,BYX Equities (Y),202297003,101025723,97242329,400565055,6228022719.371099,4407125489.527199,3751361568.769700,14386509777.667998,1713023,484064,874570,3071657
2018-06-27,BZX Equities (Z),242303548,148357332,148938788,539599668,10592701775.057595,10418844728.502499,9258886057.154502,30270432560.714596,2264732,689167,1356194,4310093
2018-06-26,NYSE American (A),6132182,12831930,3273936,22238048,243928357.330000,226010156.667000,174005775.909300,643944289.906300,54843,43812,29714,128369
2018-06-26,NASDAQ BX (B),119085824,31338624,63814348,214238796,5260732349.596400,1773953963.714300,3285100169.069501,10319786482.380201,1177675,161368,693051,2032094
2018-06-26,NYSE National (C),3672800,676485,2489039,6838324,67260453.350000,38243574.974800,57259572.148600,162763600.473400,30504,4930,23882,59316
2018-06-26,FINRA / NYSE TRF (DN),101014114,34629303,90256159,225899576,3692014054.934001,1322027901.509200,4094121327.389001,9108163283.832202,255115,86881,307945,649941
2018-06-26,FINRA / Nasdaq TRF Carteret (DQ),1169808269,383370489,752664567,2305843325,44632014688.675296,19843264957.550894,39530681298.321998,104005960944.548188,3711574,887891,2391576,6991041
2018-06-26,EDGA Equities (J),39381650,22799797,22829720,85011167,1529832673.186400,1303847689.294600,1159608276.221500,3993288638.702500,341179,107203,200175,648557
2018-06-26,EDGX Equities (K),167397068,76010885,136078802,379486755,6914257779.295400,4285675898.113500,6773633113.822099,17973566791.230999,1213059,315879,948291,2477229
2018-06-26,CHX (M),14585138,9411086,10704098,34700322,541722138.558000,1087969727.260000,928331169.947100,2558023035.765100,3687,6388,4318,14393
2018-06-26,NYSE (N),856128976,17482093,27035400,900646469,35617480714.472803,1278657949.267400,1270585754.288600,38166724418.028803,2564793,78445,190907,2834145
2018-06-26,NYSE Arca (P),191649896,255484379,150961442,598095717,8339953752.266003,14589827618.133201,7914864514.417402,30844645884.816606,1451479,757849,1163920,3373248
2018-06-26,NASDAQ (Q),365676836,143719358,531370860,1040767054,18286591109.902503,9765240761.605100,33907966410.837811,61959798282.345414,3297578,664507,3498758,7460843
2018-06-26,IEX (V),101953408,15117916,48705175,165776499,4281308265.645900,827075612.183100,2725856936.776899,7834240814.605899,632070,62345,325947,1020362
2018-06-26,NASDAQ PSX (X),15088064,18140614,13266530,46495208,617546838.944100,1452138976.674301,942159911.731000,3011845727.349401,126381,78717,116531,321629
2018-06-26,BYX Equities (Y),201527002,75763586,89413634,366704222,6110610930.593800,3444685692.356601,3523938342.590100,13079234965.540501,1653944,376850,842275,2873069
2018-06-26,BZX Equities (Z),215800593,109033556,126014935,450849084,9449866794.471900,7525683727.767800,7460120774.261301,24435671296.501001,2021928,550338,1177152,3749418
2018-06-25,NYSE American (A),6808930,15550647,4182347,26541924,309552600.902100,264614373.788500,273650758.785300,847817733.475900,64404,51991,39094,155489
2018-06-25,NASDAQ BX (B),119499647,44640009,70961456,235101112,5461428663.449400,2692145773.414999,4069874921.531400,12223449358.395799,1222291,221068,763137,2206496
2018-06-25,NYSE National (C),3412217,1728054,2876288,8016559,74422650.295000,53265723.868200,62713006.359900,190401380.523100,33575,5653,25427,64655
2018-06-25,FINRA / NYSE TRF (DN),109361182,42737997,108537176,260636355,4525087018.116100,1813895910.102499,5864830546.699798,12203813474.918397,320496,116720,399628,836844
2018-06-25,FINRA / Nasdaq TRF Carteret (DQ),1130256548,516156807,820457410,2466870765,46366113242.617903,34422020903.924302,46712643958.493103,127500778105.035308,4167708,1253167,2895369,8316244
2018-06-25,EDGA Equities (J),42455331,32910602,27564218,102930151,1736438041.861300,2063426592.400700,1672502832.249800,5472367466.511800,377180,160030,243655,780865
2018-06-25,EDGX Equities (K),176088282,115127838,172648664,463864784,7573019694.676501,7445409109.463399,9597191003.930799,24615619808.070699,1334858,492442,1192513,3019813
2018-06-25,CHX (M),11479946,18010604,12336152,41826702,666199255.646900,2007302624.946700,1315188397.664900,3988690278.258500,5201,6117,6419,17737
2018-06-25,NYSE (N),899651804,29742910,32458265,961852979,39905582449.491009,2579604106.588999,1858206006.471101,44343392562.551109,3106614,130438,239026,3476078
2018-06-25,NYSE Arca (P),197103882,377070616,180159906,754334404,9448187452.399600,24319923518.650196,10461929903.748694,44230040874.798490,1641961,1103409,1420315,4165685
2018-06-25,NASDAQ (Q),406185627,216317169,651851959,1274354755,21545634161.135902,16187290393.859997,44433985962.460307,82166910517.456206,3867103,1009477,4460677,9337257
2018-06-25,IEX (V),113584763,22077824,63412614,199075201,5339063697.347200,1351089777.685500,3876049041.767799,10566202516.800499,763283,101056,435820,1300159
2018-06-25,NASDAQ PSX (X),17917318,28586106,18839592,65343016,836370291.366000,2547324720.205099,1565726209.883000,4949421221.454099,157508,135551,158330,451389
2018-06-25,BYX Equities (Y),199775187,98955430,101377574,400108191,6403164836.150700,4562473779.523399,4523918732.341699,15489557348.015798,1753954,488128,965887,3207969
2018-06-25,BZX Equities (Z),229706135,161644586,155531222,546881943,10619820458.675901,12333929852.768199,10629456944.000502,33583207255.444602,2226075,789232,1447650,4462957
2018-06-22,NYSE American (A),8770391,179568772,5167731,193506894,342557039.540000,661897916.093600,247746126.531800,1252201082.165400,86661,54598,51997,193256
2018-06-22,NASDAQ BX (B),129678231,32908640,78094262,240681133,5585453065.500700,1728231948.411100,3648802453.701000,10962487467.612800,1372339,167225,814055,2353619
2018-06-22,NYSE National (C),5114763,1509804,3515328,10139895,93293127.595000,47655330.203200,69619583.568700,210568041.366900,42156,5813,32073,80042
2018-06-22,FINRA / NYSE TRF (DN),115717521,31745560,103234176,250697257,4014933771.209300,1146609675.368400,4347337837.072001,9508881283.649701,294202,79947,329456,703605
2018-06-22,FINRA / Nasdaq TRF Carteret (DQ),1640678235,384334497,1394459223,3419471955,63172662870.471498,19637596640.289895,59354471277.220205,142164730787.981598,4064837,805345,2497546,7367728
2018-06-22,EDGA Equities (J),44939169,21946093,26808601,93693863,1786932252.902600,1321222765.524200,1369923262.927400,4478078281.354200,403076,102089,231302,736467
2018-06-22,EDGX Equities (K),174101886,78356745,151971527,404430158,6758738099.617900,4343685579.718099,6715462565.521201,17817886244.857200,1190173,290852,949976,2431001
2018-06-22,CHX (M),11244652,7210804,6224447,24679903,459696393.705000,1031892644.220000,612848501.329900,2104437539.254900,3976,3972,5698,13646
2018-06-22,NYSE (N),2216273405,16773738,27490694,2260537837,85751726349.526694,1274367254.500600,1263845018.591000,88289938622.618294,2841864,74300,199352,3115516
2018-06-22,NYSE Arca (P),193824071,251973380,157063369,602860820,8073095208.429598,14198927345.144099,7438367605.859797,29710390159.433494,1445327,684266,1118917,3248510
2018-06-22,NASDAQ (Q),378847327,137144142,1701476605,2217468074,18062769348.732004,9099690649.333995,67751956643.014895,94914416641.080894,3349097,606264,3842009,7797370
2018-06-22,IEX (V),106082872,16134982,58463377,180681231,4582354616.450700,895537658.383400,3275341473.069201,8753233747.903301,698184,72359,389337,1159880
2018-06-22,NASDAQ PSX (X),18429708,15508559,15572245,49510512,803777665.244000,1222666799.101800,1051977825.598200,3078422289.944000,168365,70912,136865,376142
2018-06-22,BYX Equities (Y),198884602,75601816,95934000,370420418,6152107064.115301,3336486601.940500,3696531646.273100,13185125312.328901,1644198,371628,861480,2877306
2018-06-22,BZX Equities (Z),225532083,105939143,130826989,462298215,9310234806.550701,7090215813.884299,7395019180.576197,23795469801.011197,2092243,512473,1209149,3813865
2018-06-21,NYSE American (A),6797309,12250710,4250314,23298333,270773881.597400,274144304.411600,237415293.581200,782333479.590200,61780,46203,39553,147536
2018-06-21,NASDAQ BX (B),114375902,34995217,71283876,220654995,5145653965.354101,2019432356.415300,3523796694.314900,10688883016.084301,1188564,174416,769067,2132047
2018-06-21,NYSE National (C),4445719,1710047,2651593,8807359,73777941.835000,47386741.664400,54120076.090000,175284759.589400,35622,4454,24344,64420
2018-06-21,FINRA / NYSE TRF (DN),96372888,32614322,115349291,244336501,3587324870.667201,1359789546.363901,5083992971.948501,10031107388.979603,275252,83358,371001,729611
2018-06-21,FINRA / Nasdaq TRF Carteret (DQ),1108558282,430386920,865464556,2404409758,45279421297.989195,25497646084.028994,42702265321.950806,113479332703.968995,3716662,914252,2654859,7285773
2018-06-21,EDGA Equities (J),39265595,24069671,26460562,89795828,1558843143.268200,1466708464.850500,1401815474.361400,4427367082.480100,350642,116851,230550,698043
2018-06-21,EDGX Equities (K),155782930,76152442,162749323,394684695,6440818198.899302,4561701587.821599,7838371501.923500,18840891288.644401,1101565,309848,1034018,2445431
2018-06-21,CHX (M),8314970,12448505,11465095,32228570,490195632.134300,984782103.200000,1729354469.090700,3204332204.425000,3797,4216,5936,13949
2018-06-21,NYSE (N),790600463,17021841,25743568,833365872,33671893536.474799,1357736666.270300,1361494050.698600,36391124253.443699,2598690,86429,185421,2870540
2018-06-21,NYSE Arca (P),173569162,252557478,172181161,598307801,7735375495.701299,14907142045.944994,8400675734.444000,31043193276.090293,1359870,757023,1212540,3329433
2018-06-21,NASDAQ (Q),347178117,147672774,596212895,1091063786,17503064926.387001,10326365704.425399,35687860938.529701,63517291569.342101,3243700,680478,3919637,7843815
2018-06-21,IEX (V),104868570,17340125,60743856,182952551,4626454465.496400,1024052502.096600,3359731554.847901,9010238522.440901,698796,71871,411737,1182404
2018-06-21,NASDAQ PSX (X),15605056,19080656,15286101,49971813,671109933.478200,1541804733.958900,1102542073.677600,3315456741.114700,137981,83496,131030,352507
2018-06-21,BYX Equities (Y),169984557,77763967,85323607,333072131,5381117629.190700,3284756874.340400,3397803902.020000,12063678405.551100,1468248,372276,794274,2634798
2018-06-21,BZX Equities (Z),200863117,110611893,134481652,445956662,8729042373.757897,7494799526.340701,8071694661.814399,24295536561.912997,1873569,545655,1253515,3672739
2018-06-20,NYSE American (A),6417191,11180049,3798347,21395587,256654662.699200,201076133.225000,218365811.808500,676096607.732700,60121,38008,36612,134741
2018-06-20,NASDAQ BX (B),111037127,29036403,69629560,209703090,4818445670.966800,1579392981.950300,3577169823.625800,9975008476.542900,1163657,151646,754513,2069816
2018-06-20,NYSE National (C),4142817,1351130,2904525,8398472,79091046.720000,38830389.560000,64347941.053000,182269377.333000,37381,4390,26566,68337
2018-06-20,FINRA / NYSE TRF (DN),92729177,31579920,112266511,236575608,3533787371.530700,1167229446.088800,4947855789.373802,9648872606.993302,272931,78362,354147,705440
2018-06-20,FINRA / Nasdaq TRF Carteret (DQ),1104884058,383413593,874377564,2362675215,43684123317.546305,21444790749.315400,42976165511.188098,108105079578.049803,3748382,776382,2657761,7182525
2018-06-20,EDGA Equities (J),38123097,21337144,24890047,84350288,1468243771.880300,1281396919.453200,1340189065.650800,4089829756.984300,333906,103985,217154,655045
2018-06-20,EDGX Equities (K),158047285,64229331,167256225,389532841,6400611949.614599,3730714879.029702,8229952321.813297,18361279150.457598,1084296,261667,986427,2332390
2018-06-20,CHX (M),21766012,12503127,12691211,46960350,993665201.326100,1154403684.930000,1374387777.913700,3522456664.169800,4222,3623,4071,11916
2018-06-20,NYSE (N),776173238,13089122,26098967,815361327,33035377606.004705,987139035.935900,1332023499.933700,35354540141.874305,2420461,66615,193509,2680585
2018-06-20,NYSE Arca (P),173540915,229961898,176824962,580327775,7666371894.703800,12854518896.755496,9046474648.183698,29567365439.642994,1309193,636903,1178792,3124888
2018-06-20,NASDAQ (Q),345173947,116799095,552282912,1014255954,17365307520.621999,7746075976.482296,34902885075.933897,60014268573.038192,3115505,548429,3537983,7201917
2018-06-20,IEX (V),107248593,14622989,62135799,184007381,4670273677.251300,842683072.491500,3596946805.561400,9109903555.304200,699579,63510,411439,1174528
2018-06-20,NASDAQ PSX (X),15158699,14998459,14417410,44574568,641555411.476100,1058247727.050900,1032165224.088100,2731968362.615100,133517,63207,126368,323092
2018-06-20,BYX Equities (Y),182969529,67603418,83874363,334447310,5661260019.433400,3005539306.282701,3523255337.287600,12190054663.003701,1542194,326470,766145,2634809
2018-06-20,BZX Equities (Z),194732128,89358933,132972511,417063572,8406907644.629198,5886034126.201399,8235114991.935199,22528056762.765796,1806594,447853,1182870,3437317
2018-06-19,NYSE American (A),7148615,14409880,3735995,25294490,293120608.970000,297481637.219500,220075853.264800,810678099.454300,65785,43666,36493,145944
2018-06-19,NASDAQ BX (B),115075077,34939706,70363876,220378659,5212689598.064199,2108717723.292400,3746730816.869500,11068138138.226099,1205042,182549,762012,2149603
2018-06-19,NYSE National (C),4154122,1513466,2178731,7846319,72884050.405000,50178069.403100,47849287.575000,170911407.383100,36993,4836,21263,63092
2018-06-19,FINRA / NYSE TRF (DN),97767014,36057204,107144647,240968865,3937668886.423999,1513230814.584500,5005421484.410403,10456321185.418902,288660,94086,373606,756352
2018-06-19,FINRA / Nasdaq TRF Carteret (DQ),1167135908,433077244,811639200,2411852352,48738854831.108492,28937313968.945006,44222483412.714279,121898652212.767777,3940596,1034086,2657611,7632293
2018-06-19,EDGA Equities (J),38837234,26118442,23620101,88575777,1490501648.843100,1610917392.641000,1263162534.951600,4364581576.435700,339527,132261,207284,679072
2018-06-19,EDGX Equities (K),166323857,85101596,152942726,404368179,7008261615.054801,5190005319.859201,8220522076.229299,20418789011.143301,1176849,353255,1019996,2550100
2018-06-19,CHX (M),12221073,20518537,13291888,46031498,652413678.309000,2029970434.769500,1623056891.801700,4305441004.880200,3682,4622,5749,14053
2018-06-19,NYSE (N),981297781,17686164,22653554,1021637499,42719685474.688499,1406326560.330500,1231590928.385400,45357602963.404399,2596512,87166,180286,2863964
2018-06-19,NYSE Arca (P),193152673,301116651,173872510,668141834,8742808714.697698,17563088139.445802,9188716832.250702,35494613686.394202,1464097,849387,1232531,3546015
2018-06-19,NASDAQ (Q),366845317,149937909,614827789,1131611015,18812898668.044601,10583635803.976900,39724645589.441309,69121180061.462810,3320963,693375,3715523,7729861
2018-06-19,IEX (V),105912047,18296029,56930160,181138236,4505105505.247401,1142023951.033400,3357258331.270500,9004387787.551301,691889,78689,385956,1156534
2018-06-19,NASDAQ PSX (X),16742946,19317650,14768709,50829305,699702105.655300,1551469794.071200,1035479855.948500,3286651755.675000,145951,85914,129505,361370
2018-06-19,BYX Equities (Y),190528807,82656497,88505701,361691005,5942059471.488901,3873129760.158500,3732657135.707400,13547846367.354801,1602086,411925,822286,2836297
2018-06-19,BZX Equities (Z),208019785,106142317,126867905,441030007,9141334174.848501,7494638950.113800,8036357680.843601,24672330805.805902,1923231,529776,1174640,3627647
2018-06-18,NYSE American (A),6684335,13144889,3289224,23118448,252197261.255000,215271838.082200,187459548.242000,654928647.579200,59842,41020,32507,133369
2018-06-18,NASDAQ BX (B),106611276,30810840,64867734,202289850,4622199620.243800,1665253444.812300,3169247259.355300,9456700324.411400,1096027,152977,705435,1954439
2018-06-18,NYSE National (C),3901108,1868492,2366121,8135721,66429872.490000,48972999.580000,44785313.349000,160188185.419000,35225,5313,23685,64223
2018-06-18,FINRA / NYSE TRF (DN),89785682,32819518,98100278,220705478,3238615244.965300,1169063530.846800,4119096055.754899,8526774831.566999,271514,86394,342888,700796
2018-06-18,FINRA / Nasdaq TRF Carteret (DQ),1076761977,361427934,770240277,2208430188,43401871446.955702,20482942254.431304,38819625378.519497,102704439079.906503,3704093,861054,2528298,7093445
2018-06-18,EDGA Equities (J),37696289,20096673,20715976,78508938,1438309567.234500,1184032849.499100,1037862119.402400,3660204536.136000,329934,98183,183286,611403
2018-06-18,EDGX Equities (K),157118614,64712369,142268083,364099066,6290727702.209500,3715195002.407400,6765744553.147302,16771667257.764202,1087431,266776,908168,2262375
2018-06-18,CHX (M),13582701,21982818,7760622,43326141,786917480.231800,1792552797.144800,981592246.532100,3561062523.908700,3085,3501,4189,10775
2018-06-18,NYSE (N),859111444,12411022,22068424,893590890,36048997192.256598,903163430.371300,1101448926.630400,38053609549.258298,2389204,60295,175174,2624673
2018-06-18,NYSE Arca (P),163767348,232861353,151245633,547874334,7377851913.020800,13047549719.992599,7685131524.641100,28110533157.654499,1267237,622356,1101773,2991366
2018-06-18,NASDAQ (Q),321608395,116234501,551290159,989133055,15955364339.370698,7673496906.872998,33165611059.084126,56794472305.327822,2887888,538881,3267994,6694763
2018-06-18,IEX (V),99329373,14360167,54260121,167949661,4156576144.170901,818868030.227300,2764948002.108400,7740392176.506601,653307,65693,374316,1093316
2018-06-18,NASDAQ PSX (X),15567470,14067213,13403401,43038084,638510256.546200,1048665292.047500,858393510.313700,2545569058.907400,136241,63675,114510,314426
2018-06-18,BYX Equities (Y),171777040,66760311,81476014,320013365,5341642372.600200,2907062434.689200,3173297387.250500,11422002194.539900,1460960,323901,751264,2536125
2018-06-18,BZX Equities (Z),192826550,83814254,119307934,395948738,8203414148.831401,5394649790.361498,6618626191.768899,20216690130.961798,1822472,428943,1078438,3329853
2018-06-15,NYSE American (A),9008432,48913585,4301390,62223407,386398366.145100,578793634.218200,270747869.111800,1235939869.475100,84003,52738,42250,178991
2018-06-15,NASDAQ BX (B),131518002,41205234,73126728,245849964,5799641736.849000,2363218994.165601,3815547363.665300,11978408094.679901,1340230,197904,777199,2315333
2018-06-15,NYSE National (C),3503329,1769231,2675593,7948153,65649351.455000,52733203.660000,50116732.157000,168499287.272000,32448,5666,23384,61498
2018-06-15,FINRA / NYSE TRF (DN),101805871,33079931,94233970,229119772,3874840197.719800,1239950365.585099,3927844977.272800,9042635540.577699,289357,86384,323992,699733
2018-06-15,FINRA / Nasdaq TRF Carteret (DQ),1408311763,466677102,961042877,2836031742,58572813310.997917,36345815262.598917,49073307706.329210,143991936279.926044,4163557,994064,2497627,7655248
2018-06-15,EDGA Equities (J),47535228,26811913,25485465,99832606,1865490193.608100,1638482764.694200,1419251474.288900,4923224432.591200,419661,120840,217585,758086
2018-06-15,EDGX Equities (K),178437226,91373262,144741680,414552168,7326231331.516500,5692430977.104597,7618364131.851699,20637026440.472796,1245426,362713,948601,2556740
2018-06-15,CHX (M),20082068,24863163,11961530,56906761,1457095167.545000,2072945778.954200,1349507412.000200,4879548358.499400,3744,4508,6255,14507
2018-06-15,NYSE (N),2371197787,17202706,23599686,2412000179,109002252200.319195,1357504064.035200,1243974889.354800,111603731153.709195,2843608,80027,179559,3103194
2018-06-15,NYSE Arca (P),208289447,319045694,156812680,684147821,9247918880.521901,18787942915.871895,8767086982.117296,36802948778.511092,1515126,854191,1130775,3500092
2018-06-15,NASDAQ (Q),395784736,174014656,1256978641,1826778033,19632050128.391002,12212091859.819699,75933850703.876164,107777992692.086865,3443091,719161,3693473,7855725
2018-06-15,IEX (V),113164421,20262798,55333895,188761114,5006020538.370500,1289881822.687900,3099329937.947500,9395232299.005900,750506,92450,383254,1226210
2018-06-15,NASDAQ PSX (X),20174198,21736102,15496584,57406884,921958369.749500,1749363069.511300,1316866497.257000,3988187936.517800,176224,92058,132721,401003
2018-06-15,BYX Equities (Y),204642406,92296370,89784445,386723221,6253422783.612300,4024946290.362600,3686181987.150800,13964551061.125700,1651684,411841,807507,2871032
2018-06-15,BZX Equities (Z),238538342,120801960,134300589,493640891,10420513876.985803,7976673258.272898,8223864635.148399,26621051770.407100,2182930,558074,1230614,3971618
2018-06-14,NYSE American (A),7347554,13286260,4144394,24778208,301946561.960000,271280699.045200,235298640.407900,808525901.413100,66440,41887,37039,145366
2018-06-14,NASDAQ BX (B),115228233,31860047,69777156,216865436,5089779012.907900,1707939420.764000,3419438170.949300,10217156604.621200,1178143,151725,740103,2069971
2018-06-14,NYSE National (C),3815462,1227317,2382147,7424926,66225349.955000,35723928.900000,43532381.342900,145481660.197900,32564,4571,22215,59350
2018-06-14,FINRA / NYSE TRF (DN),100022732,30311535,102446444,232780711,3992194552.737101,1132165779.534100,4659949143.641202,9784309475.912403,284616,78542,348979,712137
2018-06-14,FINRA / Nasdaq TRF Carteret (DQ),1111375689,364224574,804515742,2280116005,45339148985.109102,25128466202.894800,40290946655.628715,110758561843.632617,3831835,762200,2536058,7130093
2018-06-14,EDGA Equities (J),40201972,20953073,24452180,85607225,1614533009.114400,1429427369.054200,1316887746.507400,4360848124.676000,361882,96905,221361,680148
2018-06-14,EDGX Equities (K),166710139,66417204,149154943,382282286,7216659447.916799,3974941766.158800,7734686484.119202,18926287698.194801,1145178,260643,947350,2353171
2018-06-14,CHX (M),13604029,18833968,12357973,44795970,817954992.062000,1656255276.195001,862973732.140200,3337184000.397201,3508,3900,3972,11380
2018-06-14,NYSE (N),933622516,12896472,26044828,972563816,39831519320.649802,943266147.415500,1325309718.871000,42100095186.936302,2520067,62775,181737,2764579
2018-06-14,NYSE Arca (P),184392888,250333268,159346892,594073048,8367512920.208402,15004931507.195400,8734057889.452098,32106502316.855900,1378173,659641,1132889,3170703
2018-06-14,NASDAQ (Q),358617848,119515515,565773690,1043907053,18258659801.163303,7971811966.615300,35467636752.533405,61698108520.312008,3194138,532614,3444211,7170963
2018-06-14,IEX (V),105431473,16018705,50773282,172223460,4832037116.384500,973017971.515800,2894553260.770800,8699608348.671100,706350,69121,365238,1140709
2018-06-14,NASDAQ PSX (X),17321848,14203827,15250571,46776246,768874512.787300,1063503252.240700,1110721166.054600,2943098931.082600,155912,62655,129357,347924
2018-06-14,BYX Equities (Y),181000641,70901496,82299565,334201702,5794746243.434299,3118582942.050200,3285507944.454900,12198837129.939399,1508220,314340,749831,2572391
2018-06-14,BZX Equities (Z),202245904,84530465,124914860,411691229,8956209028.094301,5661308702.556700,7291988778.061599,21909506508.712600,1860773,393788,1128602,3383163
2018-06-13,NYSE American (A),6791260,14369433,3534073,24694766,284573299.027600,245867018.233300,207125479.501300,737565796.762200,63794,44016,33021,140831
2018-06-13,NASDAQ BX (B),114132399,31250431,64288038,209670868,5170320069.162500,1644346020.002600,3316840596.884800,10131506686.049900,1169016,156865,683484,2009365
2018-06-13,NYSE National (C),2344311,538915,1347909,4231135,50313588.700000,33539756.986000,33252471.602800,117105817.288800,22429,3650,14181,40260
2018-06-13,FINRA / NYSE TRF (DN),107559883,31866990,96731143,236158016,4222265763.605002,1162561644.566000,4175314150.195000,9560141558.366002,291694,84110,312593,688397
2018-06-13,FINRA / Nasdaq TRF Carteret (DQ),1262456121,374891407,802891542,2440239070,52786008309.070708,23854026662.773195,40902572502.028709,117542607473.872612,4022021,812594,2387391,7222006
2018-06-13,EDGA Equities (J),41201442,22684860,22344304,86230606,1698751024.032500,1481616853.517000,1221983165.753200,4402351043.302700,382514,114341,200926,697781
2018-06-13,EDGX Equities (K),182004384,75897728,147893353,405795465,7920411317.247699,4523685522.076800,7458124671.209799,19902221510.534298,1317320,327043,969855,2614218
2018-06-13,CHX (M),14118433,14782292,7555566,36456291,746978217.002000,1944276104.309101,573707608.955000,3264961930.266101,4084,3924,4192,12200
2018-06-13,NYSE (N),959333821,14226520,23448886,997009227,41345864659.459402,1083487339.034400,1185691389.377900,43615043387.871702,2734826,70466,171904,2977196
2018-06-13,NYSE Arca (P),209061946,263814807,157897801,630774554,9623173754.922998,15425665664.988803,8273559660.060003,33322399079.971804,1548112,742701,1127698,3418511
2018-06-13,NASDAQ (Q),388597840,143047087,589728435,1121373362,19665630295.638704,9329740940.583803,36382292390.392989,65377663626.615496,3523932,648846,3562264,7735042
2018-06-13,IEX (V),104536313,13737382,52135661,170409356,5003411531.068200,868628576.525000,2956229955.679300,8828270063.272500,718753,61736,358314,1138803
2018-06-13,NASDAQ PSX (X),19220937,18382220,15064125,52667282,851672043.901200,1337163025.317100,1160075868.417200,3348910937.635500,168008,73360,122954,364322
2018-06-13,BYX Equities (Y),189191002,70188283,81445262,340824547,5971894512.057001,3102232815.815999,3289896522.774400,12364023850.647400,1604939,361336,750990,2717265
2018-06-13,BZX Equities (Z),220229178,101818174,131527415,453574767,9810204640.695398,6502880519.513300,7873250528.374899,24186335688.583597,2134866,508746,1219271,3862883
2018-06-12,NYSE American (A),6610021,12266823,3455209,22332053,275367687.949700,224647754.640100,185834375.112100,685849817.701900,61484,44601,33820,139905
2018-06-12,NASDAQ BX (B),110619343,26066818,61371830,198057991,4830643693.366500,1391208598.309600,2923333865.236900,9145186156.913000,1154915,133502,680133,1968550
2018-06-12,NYSE National (C),2373544,385868,1358102,4117514,54444548.185000,25937955.905000,32056092.378500,112438596.468500,24650,2929,14425,42004
2018-06-12,FINRA / NYSE TRF (DN),95529284,28266695,99367473,223163452,3741718912.899100,1000268976.017300,3869079160.590399,8611067049.506799,274722,79373,316294,670389
2018-06-12,FINRA / Nasdaq TRF Carteret (DQ),1127424460,384588082,747633763,2259646305,45585217326.414410,26862199569.465799,34844745967.427896,107292162863.308105,3863085,776070,2366236,7005391
2018-06-12,EDGA Equities (J),37134986,17651842,20461269,75248097,1458788789.201200,1071133543.975100,970084166.924200,3500006500.100500,340619,80069,179772,600460
2018-06-12,EDGX Equities (K),168155167,56263636,145060336,369479139,7227015641.346801,3495534742.649000,6697113779.190501,17419664163.186302,1212610,231775,921769,2366154
2018-06-12,CHX (M),11554155,12019253,8828977,32402385,565095581.943000,1590069460.163400,919131859.573700,3074296901.680100,2770,3789,3730,10289
2018-06-12,NYSE (N),833179670,12335945,21772969,867288584,35963609422.598803,861112451.215600,1055332771.917100,37880054645.731503,2497885,58699,165141,2721725
2018-06-12,NYSE Arca (P),196128908,198936281,150863592,545928781,9054032603.598801,11416595344.248194,7196814446.556300,27667442394.403295,1409799,552613,1076129,3038541
2018-06-12,NASDAQ (Q),351864238,98291454,503411953,953567645,17851911846.217203,6658077758.010804,30385601654.494802,54895591258.722809,3131960,459099,3203889,6794948
2018-06-12,IEX (V),96964301,13320930,46737158,157022389,4326579783.633800,818702974.186200,2450369456.746701,7595652214.566701,645608,59649,329894,1035151
2018-06-12,NASDAQ PSX (X),17286744,14816772,13371143,45474659,737036628.432900,1026828842.858600,831489950.617800,2595355421.909300,157207,59306,114540,331053
2018-06-12,BYX Equities (Y),173148606,62885104,79899949,315933659,5537600658.203200,2756032365.196400,3058416369.284600,11352049392.684200,1499447,287364,738184,2524995
2018-06-12,BZX Equities (Z),207729834,74841303,116299356,398870493,9267856758.836902,4940740789.659601,6216043894.399298,20424641442.895801,1967355,371575,1057644,3396574
2018-06-11,NYSE American (A),6613849,13317761,3468413,23400023,263714572.385200,191333061.082000,178845065.166100,633892698.633300,60431,44709,33723,138863
2018-06-11,NASDAQ BX (B),102567341,25772989,60882124,189222454,4479822420.729100,1397299634.985900,2822718963.440800,8699841019.155800,1093528,136479,681228,1911235
2018-06-11,NYSE National (C),2743165,390174,1449651,4582990,51308187.700000,21319601.930000,32637431.410000,105265221.040000,25424,3492,15281,44197
2018-06-11,FINRA / NYSE TRF (DN),102052341,32403317,96229405,230685063,3658411272.311900,991083272.099700,3674507129.730701,8324001674.142301,267885,83944,325705,677534
2018-06-11,FINRA / Nasdaq TRF Carteret (DQ),1081570938,341152157,736327751,2159050846,42455792456.358892,21231586352.652395,33300311637.537697,96987690446.548984,3646774,724755,2309662,6681191
2018-06-11,EDGA Equities (J),35657529,15850237,19996585,71504351,1415039614.974800,1032261301.962200,955653941.638100,3402954858.575100,320737,76954,177079,574770
2018-06-11,EDGX Equities (K),154286958,56782853,141112682,352182493,6405132117.346499,3504001453.778400,6101066144.061801,16010199715.186700,1122787,237338,871898,2232023
2018-06-11,CHX (M),17892229,8009625,6165123,32066977,680002240.380400,846831409.960300,521848704.886000,2048682355.226700,3209,4448,3191,10848
2018-06-11,NYSE (N),784619232,10167914,22423687,817210833,33105339976.876902,731759056.119100,998564410.137700,34835663443.133702,2325250,54729,157523,2537502
2018-06-11,NYSE Arca (P),176927679,212401603,144770440,534099722,7812504118.187502,11871928428.123293,6602102099.454203,26286534645.764998,1296878,552975,1036161,2886014
2018-06-11,NASDAQ (Q),325298120,99037453,480486330,904821903,15928746460.112199,6750166198.530599,28106420878.682095,50785333537.324893,2868868,465088,3116212,6450168
2018-06-11,IEX (V),97343746,12051174,46969165,156364085,4380026403.226900,723142702.307300,2524291722.740901,7627460828.275101,673688,57128,346680,1077496
2018-06-11,NASDAQ PSX (X),15479798,11917823,12404239,39801860,648465470.594100,860054689.859400,783788674.408700,2292308834.862200,138463,52239,103108,293810
2018-06-11,BYX Equities (Y),169444476,57462413,77460973,304367862,5338668151.914600,2515904787.678900,2976101998.102600,10830674937.696100,1477586,282868,737823,2498277
2018-06-11,BZX Equities (Z),189634272,71625653,109220676,370480601,8165065011.005301,4818926550.329402,5835029580.950798,18819021142.285501,1870019,365894,1012217,3248130
2018-06-08,NYSE American (A),6730717,12954420,3810218,23495355,284698205.703200,235031832.564700,231437714.894100,751167753.162000,63170,43881,37019,144070
2018-06-08,NASDAQ BX (B),108573351,32321853,63129787,204024991,4706584878.680400,1875085110.248300,3150011389.617300,9731681378.546000,1150592,168913,701359,2020864
2018-06-08,NYSE National (C),2171027,465977,1165301,3802305,47592374.345000,28865588.776000,29388316.149600,105846279.270600,22527,3819,12489,38835
2018-06-08,FINRA / NYSE TRF (DN),84608307,31131965,96378115,212118387,3154128314.823800,989556357.210100,3756833435.535403,7900518107.569303,236288,78155,307752,622195
2018-06-08,FINRA / Nasdaq TRF Carteret (DQ),979445083,370220606,699254683,2048920372,37921655796.417302,23685848893.772592,33892918051.118714,95500422741.308608,3384659,769580,2248652,6402891
2018-06-08,EDGA Equities (J),35302139,19855122,19769004,74926265,1392936599.688800,1216522268.226900,1029072361.115500,3638531229.031200,326393,98682,178952,604027
2018-06-08,EDGX Equities (K),177556398,68713001,150381923,396651322,7386893717.311301,4091833946.064701,7115306776.209099,18594034439.585101,1296268,297930,978693,2572891
2018-06-08,CHX (M),11545991,12531630,7094577,31172198,433498167.183800,1039994576.677000,708148495.353800,2181641239.214600,3355,4535,2669,10559
2018-06-08,NYSE (N),777951872,10893570,22798507,811643949,33069678797.269001,878726123.892900,1255009864.792500,35203414785.954401,2312909,58941,187363,2559213
2018-06-08,NYSE Arca (P),178931962,234132704,147407143,560471809,7681535905.934198,13410325351.031006,7331092402.012098,28422953658.977302,1358572,683696,1067704,3109972
2018-06-08,NASDAQ (Q),311116066,127708582,494641623,933466271,15036776395.299902,8276397863.540103,30207629497.899706,53520803756.739711,2824354,578008,3081286,6483648
2018-06-08,IEX (V),91341376,15094319,45284929,151720624,3987662837.414600,881379571.125900,2482668935.575800,7351711344.116300,620356,67213,320244,1007813
2018-06-08,NASDAQ PSX (X),16071567,15696612,14615731,46383910,662712350.442700,1101066691.242400,1019827378.301000,2783606419.986100,148115,68001,136009,352125
2018-06-08,BYX Equities (Y),164785109,67120662,72039121,303944892,5056023850.358400,3001250970.753500,2902756411.453500,10960031232.565400,1410892,343083,689559,2443534
2018-06-08,BZX Equities (Z),192725822,86202941,112044590,390973353,8408516048.209799,5766934212.438600,6573593014.809302,20749043275.457701,1855887,443098,1078218,3377203
2018-06-07,NYSE American (A),7652696,12569647,4025079,24247422,281838776.965000,284131925.337400,238313912.335700,804284614.638100,65167,49706,38027,152900
2018-06-07,NASDAQ BX (B),120374367,35950128,70243125,226567620,5204218281.188699,1857485040.689000,3605664575.644600,10667367897.522299,1265413,192270,765394,2223077
2018-06-07,NYSE National (C),1981145,362908,1108625,3452678,46702776.790000,18747596.375000,29284462.890000,94734836.055000,19442,2709,12200,34351
2018-06-07,FINRA / NYSE TRF (DN),100876874,37389459,114689228,252955561,3804769053.006600,1491186172.697300,4538050087.989800,9834005313.693700,279773,90306,363921,734000
2018-06-07,FINRA / Nasdaq TRF Carteret (DQ),1244688186,400050812,863148305,2507887303,48081513907.682588,23805980007.495708,40933347045.703218,112820840960.881514,3872989,936210,2658734,7467933
2018-06-07,EDGA Equities (J),42586036,24957086,26579228,94122350,1651616511.387000,1505035136.164200,1417530388.871200,4574182036.422400,374215,120235,222066,716516
2018-06-07,EDGX Equities (K),207703345,84745068,186912162,479360575,8649758294.717400,4992879869.788800,8970550617.842701,22613188782.348901,1557875,373902,1210683,3142460
2018-06-07,CHX (M),10860020,17037082,12805729,40702831,360763483.012400,1427702363.417400,928685797.920900,2717151644.350700,3503,5082,3879,12464
2018-06-07,NYSE (N),883168924,13861113,25035547,922065584,35723398360.670697,1039406583.748100,1314122510.012900,38076927454.431697,2616801,74002,196483,2887286
2018-06-07,NYSE Arca (P),219665096,300813617,185218347,705697060,9135175734.761403,16978427514.524803,9588601076.242099,35702204325.528305,1554139,877400,1275746,3707285
2018-06-07,NASDAQ (Q),352132669,157787720,548626731,1058547120,16784407979.297604,10353234927.622401,34077070494.759796,61214713401.679801,3120602,725640,3506585,7352827
2018-06-07,IEX (V),108121694,17580774,54832392,180534860,4640423268.167899,1094273867.553000,3277177082.321200,9011874218.042099,717014,78605,388784,1184403
2018-06-07,NASDAQ PSX (X),18259640,20319298,17265471,55844409,731768111.038200,1569777626.928400,1276809887.791500,3578355625.758100,158738,84471,146533,389742
2018-06-07,BYX Equities (Y),196860598,80305120,89803980,366969698,5784699086.411799,3579637510.715400,3549803073.737100,12914139670.864299,1673326,407530,830495,2911351
2018-06-07,BZX Equities (Z),227152428,112657987,139435417,479245832,9984129664.817400,7444368246.200898,8575165826.619502,26003663737.637800,2137187,558115,1295976,3991278
2018-06-06,NYSE American (A),7037291,13808986,3864485,24710762,280929150.685000,221734273.756400,220879774.408000,723543198.849400,60992,40132,34977,136101
2018-06-06,NASDAQ BX (B),118501914,30632662,68608821,217743397,5232913589.523900,1590275791.393100,3489709832.468300,10312899213.385300,1220468,153890,741022,2115380
2018-06-06,NYSE National (C),2036331,254526,1119655,3410512,49866910.890000,12864498.180000,27471684.708000,90203093.778000,18995,1946,11928,32869
2018-06-06,FINRA / NYSE TRF (DN),104572328,34795451,109037837,248405616,3962983296.924099,1209347255.164600,4702004725.664602,9874335277.753301,281570,88754,341528,711852
2018-06-06,FINRA / Nasdaq TRF Carteret (DQ),1169437503,412060443,828095567,2409593513,46088631113.296605,23838352834.575601,39373546236.555216,109300530184.427422,3820634,796584,2504982,7122200
2018-06-06,EDGA Equities (J),40673507,19326538,22998189,82998234,1647274075.453900,1170738928.448800,1194246994.996000,4012259998.898700,357855,92748,194974,645577
2018-06-06,EDGX Equities (K),194829775,69379762,163618525,427828062,8185537037.102100,4203588848.647500,8022783290.370101,20411909176.119701,1381303,288120,1010513,2679936
2018-06-06,CHX (M),12269755,9189535,9041283,30500573,610038164.068600,1078931540.619000,669680847.130000,2358650551.817600,3369,4423,2931,10723
2018-06-06,NYSE (N),957440714,10286594,21638437,989365745,42364030148.867801,794269839.419500,1061167686.711900,44219467674.999201,2455236,56436,172111,2683783
2018-06-06,NYSE Arca (P),200453756,240035005,166549811,607038572,8696733745.724000,13923611675.696202,8285556409.133299,30905901830.553501,1480916,645946,1137912,3264774
2018-06-06,NASDAQ (Q),342956243,117421788,534167693,994545724,16418023451.923297,8192992866.981899,33241114139.259591,57852130458.164787,2955315,534737,3112671,6602723
2018-06-06,IEX (V),109260126,14804815,52796844,176861785,4925157069.405101,892530839.670600,3085996375.906101,8903684284.981802,700027,64101,350113,1114241
2018-06-06,NASDAQ PSX (X),17272383,15305383,15581405,48159171,743961108.439800,1236463659.235400,1010442955.043100,2990867722.718300,155694,65963,131039,352696
2018-06-06,BYX Equities (Y),181637846,67186621,85169770,333994237,5767119753.361501,3010751974.707400,3282156790.090600,12060028518.159501,1525829,316475,751749,2594053
2018-06-06,BZX Equities (Z),204401379,80803692,115814807,401019878,8820141998.992499,5406968892.619602,6762147439.825898,20989258331.437999,1895767,392080,1062874,3350721
2018-06-05,NYSE American (A),6886078,12254388,3487029,22627495,267668319.228000,235698446.990300,205696085.100800,709062851.319100,62867,43976,33958,140801
2018-06-05,NASDAQ BX (B),114805623,28763113,66530847,210099583,4776940277.387200,1414272564.351800,3207391204.303400,9398604046.042400,1180694,157143,715276,2053113
2018-06-05,NYSE National (C),1424094,142745,1175613,2742452,38288435.360000,6213945.890500,31888963.212800,76391344.463300,14763,1063,12380,28206
2018-06-05,FINRA / NYSE TRF (DN),101536405,33630480,98949580,234116465,3784899308.230100,1132420975.757000,4319861254.344798,9237181538.331898,272664,85373,315061,673098
2018-06-05,FINRA / Nasdaq TRF Carteret (DQ),1141629846,375469256,766356603,2283455705,43140506527.019701,19690416437.740504,37941501174.747293,100772424139.507498,3809347,874802,2400607,7084756
2018-06-05,EDGA Equities (J),38519945,18711057,21450090,78681092,1495380828.940200,1096480231.410500,1108547495.557300,3700408555.908000,343329,94974,182947,621250
2018-06-05,EDGX Equities (K),194307746,67113770,152858616,414280132,8058232490.385799,3684497585.281800,7595976064.431301,19338706140.098900,1412674,283435,1012950,2709059
2018-06-05,CHX (M),12561245,9497094,7234134,29292473,635385241.963000,867093783.585600,809833912.709600,2312312938.258200,3599,2935,3118,9652
2018-06-05,NYSE (N),876889824,10156974,22682338,909729136,35424056219.180603,688071183.058600,1142500426.656200,37254627828.895403,2413756,54376,178084,2646216
2018-06-05,NYSE Arca (P),194620936,225363406,147280198,567264540,8187646780.879300,12848157166.780998,7726273396.349899,28762077344.010197,1443345,620665,1095128,3159138
2018-06-05,NASDAQ (Q),334614637,115748882,510223383,960586902,15563141135.550097,7486213913.466004,31008399816.785293,54057754865.801394,2895559,535319,3114841,6545719
2018-06-05,IEX (V),98888696,15193906,49887576,163970178,4229676676.247799,878628634.220100,2830542008.901900,7938847319.369799,662016,70548,341856,1074420
2018-06-05,NASDAQ PSX (X),16848299,14393524,14153816,45395639,675800229.487800,1022430257.701500,871677216.029200,2569907703.218500,154641,62881,124141,341663
2018-06-05,BYX Equities (Y),182811523,66636000,84415011,333862534,5444795516.946999,2783571556.203100,3202531809.035900,11430898882.185999,1543431,315279,754589,2613299
2018-06-05,BZX Equities (Z),207205668,79236563,116586408,403028639,8722050428.549899,4928455623.693199,6658529083.607299,20309035135.850397,1838018,371092,1045874,3254984
2018-06-04,NYSE American (A),6936025,12176351,3900888,23013264,281690512.380000,195689732.007700,212891502.011700,690271746.399400,64361,39589,36664,140614
2018-06-04,NASDAQ BX (B),109764521,24710015,67427842,201902378,4671198154.808800,1262636632.111200,3249916195.061300,9183750981.981300,1179381,140235,724838,2044454
2018-06-04,NYSE National (C),1415334,255473,884468,2555275,34612381.690000,11924006.465000,21806321.200000,68342709.355000,14954,2064,10222,27240
2018-06-04,FINRA / NYSE TRF (DN),92384723,32945286,106586404,231916413,3517386178.703500,1151245573.068300,4722843504.644400,9391475256.416200,282606,89764,339140,711510
2018-06-04,FINRA / Nasdaq TRF Carteret (DQ),1087026481,382604342,784931948,2254562771,42781797937.788287,19293310691.121502,37222567157.709398,99297675786.619187,3713212,757143,2486874,6957229
2018-06-04,EDGA Equities (J),37539617,16439808,21272822,75252247,1458695610.661900,997110696.849600,1120540105.483000,3576346412.994500,354964,82905,186284,624153
2018-06-04,EDGX Equities (K),190896065,61338272,158164793,410399130,7895831976.302599,3483991398.602900,8174689708.475399,19554513083.380898,1350057,265321,1023309,2638687
2018-06-04,CHX (M),12256263,11869364,5974764,30100391,747574569.422800,1003774437.524700,979238238.711400,2730587245.658900,3227,3503,2928,9658
2018-06-04,NYSE (N),872741352,9148898,23037130,904927380,35931945032.267296,684101550.970000,1118839274.208100,37734885857.445396,2494125,51807,189542,2735474
2018-06-04,NYSE Arca (P),193721072,203195769,154827080,551743921,8564971802.439802,11851670654.030501,8086523947.061497,28503166403.531800,1462502,570924,1129416,3162842
2018-06-04,NASDAQ (Q),326661799,102797153,558294711,987753663,15276954192.855895,7076617180.931001,31392413054.831891,53745984428.618787,2842191,488378,3271340,6601909
2018-06-04,IEX (V),92513325,14553184,51734028,158800537,4117393495.817400,837140353.889500,2955770876.681200,7910304726.388100,638787,60920,356396,1056103
2018-06-04,NASDAQ PSX (X),16206766,13619666,14813342,44639774,639246638.944600,1051089212.384400,934940314.191600,2625276165.520600,146695,57340,132305,336340
2018-06-04,BYX Equities (Y),168628511,59225952,83195185,311049648,5250583907.990701,2558447262.382100,3164918927.779000,10973950098.151801,1501913,298369,758271,2558553
2018-06-04,BZX Equities (Z),201406975,72299817,117126272,390833064,8468043231.761702,4716607125.014601,6651570808.371899,19836221165.148202,1774940,345734,1049625,3170299
2018-06-01,NYSE American (A),8050758,13788186,3920654,25759598,285664228.710900,220860000.548100,218013798.465600,724538027.724600,69741,45616,36735,152092
2018-06-01,NASDAQ BX (B),121307004,33114076,69538824,223959904,5054306983.193500,1907497635.896200,3456169836.679400,10417974455.769100,1241095,177563,745043,2163701
2018-06-01,NYSE National (C),1250089,170660,994964,2415713,36924654.255000,8150162.620000,29021530.095000,74096346.970000,12106,1286,10894,24286
2018-06-01,FINRA / NYSE TRF (DN),99174503,35275443,102275070,236725016,3546942237.210401,1298082157.516300,4124331321.123100,8969355715.849801,267225,92134,318087,677446
2018-06-01,FINRA / Nasdaq TRF Carteret (DQ),1176873651,394073250,816720015,2387666916,41889231913.097900,23243257318.144999,37864017505.694298,102996506736.937197,4017840,842747,2490810,7351397
2018-06-01,EDGA Equities (J),43035394,21784273,22604786,87424453,1559048910.602600,1349664229.923100,1214284222.708500,4122997363.234200,375706,108960,191057,675723
2018-06-01,EDGX Equities (K),211014152,80832060,159282576,451128788,8579637956.262497,4605610066.692099,8842096118.717500,22027344141.672096,1476723,325455,1051792,2853970
2018-06-01,CHX (M),14303097,13550587,11562805,39416489,716948357.120100,1364506828.178400,1049433235.973400,3130888421.271900,3911,3943,3668,11522
2018-06-01,NYSE (N),858589623,13777837,22898681,895266141,34041182247.978097,1062971257.264300,1167471214.481500,36271624719.723897,2606404,73821,180266,2860491
2018-06-01,NYSE Arca (P),218968258,265891408,159351317,644210983,8861967073.714201,15728779647.616201,8360799030.873701,32951545752.204103,1551822,724908,1103912,3380642
2018-06-01,NASDAQ (Q),372589238,145227564,561982201,1079799003,16920244275.074097,9691332755.762600,32846090469.387393,59457667500.224090,3158007,639531,3291577,7089115
2018-06-01,IEX (V),114615988,16251677,52590947,183458612,4809463594.935499,1020399442.041000,3090184554.108501,8920047591.085000,761074,74676,373108,1208858
2018-06-01,NASDAQ PSX (X),18674051,20110579,15484848,54269478,717131478.909000,1530368519.789700,1099598719.969300,3347098718.668000,166336,82945,133281,382562
2018-06-01,BYX Equities (Y),204816501,74842788,92367747,372027036,6039113176.988299,3285907507.185701,3610904862.022101,12935925546.196101,1727868,364122,830340,2922330
2018-06-01,BZX Equities (Z),231049094,100004956,120758247,451812297,9307317232.079001,6638658319.512097,7758979398.105701,23704954949.696799,1963036,455015,1083871,3501922
2018-05-31,NYSE American (A),7801876,19413975,4393854,31609705,327984595.108100,311693883.209000,261046588.672500,900725066.989600,73774,49426,43092,166292
2018-05-31,NASDAQ BX (B),128509929,38586145,74513856,241609930,5624119998.263201,2402535794.992100,3910085448.944601,11936741242.199902,1331614,206105,804084,2341803
2018-05-31,NYSE National (C),546083,334444,414747,1295274,20396030.170000,22715108.356700,18900974.940000,62012113.466700,5038,1447,4117,10602
2018-05-31,FINRA / NYSE TRF (DN),89925465,37163500,113237785,240326750,3329233469.185100,1282345464.713500,3928206894.927601,8539785828.826201,247411,85323,310194,642928
2018-05-31,FINRA / Nasdaq TRF Carteret (DQ),1226384519,489249063,873778002,2589411584,49536265911.209287,30636305976.602600,42643433697.766508,122816005585.578395,3816644,956210,2407995,7180849
2018-05-31,EDGA Equities (J),43719245,25940143,24427480,94086868,1747955227.579500,1732126791.823800,1331848337.866100,4811930357.269400,391291,126392,209576,727259
2018-05-31,EDGX Equities (K),207315769,89151568,183435732,479903069,8721776554.148300,5187925546.625800,9063494908.947597,22973197009.721697,1531530,363590,1164575,3059695
2018-05-31,CHX (M),8799284,9555090,8537476,26891850,508781109.837800,1234617369.150000,824056147.781200,2567454626.769000,4589,5007,3635,13231
2018-05-31,NYSE (N),1374170088,15391032,23749456,1413310576,65171001302.673404,1274361766.168701,1175041910.749700,67620404979.591805,2736411,83505,192405,3012321
2018-05-31,NYSE Arca (P),214023448,301555207,161657550,677236205,9314705545.833998,18455024052.349303,8562322610.886998,36332052209.070299,1600702,836561,1164461,3601724
2018-05-31,NASDAQ (Q),378578950,160203652,765992115,1304774717,18429325606.747405,11385909491.389195,48251743754.861761,78066978852.998361,3420072,721227,3563917,7705216
2018-05-31,IEX (V),101669395,19425179,56701174,177795748,4558062368.373400,1214527558.649800,3151941634.682100,8924531561.705300,714383,87199,379611,1181193
2018-05-31,NASDAQ PSX (X),18782249,22614036,16425828,57822113,784841259.257600,1828115237.428600,1129706517.336800,3742663014.023000,173147,94473,141958,409578
2018-05-31,BYX Equities (Y),210917555,89606325,95790334,396314214,6677207070.404801,3970298289.477899,3934455855.299600,14581961215.182300,1811358,418306,881453,3111117
2018-05-31,BZX Equities (Z),229965739,119350223,130309663,479625625,10143804344.911600,8278328873.553502,7743902863.177401,26166036081.642503,2067324,538405,1179197,3784926
2018-05-30,NYSE American (A),6576315,14774264,3390617,24741196,283781200.770000,284149083.033300,173806685.464100,741736969.267400,61332,47895,32121,141348
2018-05-30,NASDAQ BX (B),120436938,33871189,68474487,222782614,5311491364.529501,1831678797.948700,3287371185.660900,10430541348.139101,1289693,175144,733941,2198778
2018-05-30,NYSE National (C),248583,89947,175298,513828,7466034.180000,4693829.520000,4548771.850000,16708635.550000,1928,233,818,2979
2018-05-30,FINRA / NYSE TRF (DN),96485104,36770867,116336285,249592256,3507493770.449001,1293852441.810800,3849651861.354999,8650998073.614800,264005,91631,305542,661178
2018-05-30,FINRA / Nasdaq TRF Carteret (DQ),1146193720,409504841,736833885,2292532446,44920531514.006195,22965261940.279498,35190885260.750885,103076678715.036578,3934918,909007,2316260,7160185
2018-05-30,EDGA Equities (J),40346278,23768296,20535269,84649843,1575383951.612400,1563216627.111000,1032494281.831800,4171094860.555200,366585,120549,175903,663037
2018-05-30,EDGX Equities (K),200766800,80937738,160672403,442376941,8473247463.150697,4520188729.556499,7431257471.863897,20424693664.571093,1444350,334561,979905,2758816
2018-05-30,CHX (M),17130275,14274719,7918196,39323190,1112116956.675000,1549912758.854100,837783750.146600,3499813465.675700,3728,4719,2705,11152
2018-05-30,NYSE (N),855233026,14880507,22314381,892427914,35954691928.840702,1094092337.459000,1096799022.711100,38145583289.010802,2518025,81271,181403,2780699
2018-05-30,NYSE Arca (P),205241175,278917354,140862177,625020706,9041600424.328502,15831506366.265797,6996960669.527501,31870067460.121800,1529817,752324,1035358,3317499
2018-05-30,NASDAQ (Q),353164779,137541861,521030212,1011736852,17287090757.310803,9593935480.297696,31345051656.234009,58226077893.842508,3140559,630560,3046162,6817281
2018-05-30,IEX (V),99965208,16985456,47772976,164723640,4481788590.884700,1023843795.327700,2497625192.806700,8003257579.019100,674333,76078,328468,1078879
2018-05-30,NASDAQ PSX (X),18113821,19529789,14508441,52152051,777889290.538400,1517212189.763700,906698492.346400,3201799972.648500,165967,83316,123112,372395
2018-05-30,BYX Equities (Y),193084003,81355456,83779908,358219367,5951387251.084100,3601224871.499801,3205285273.740300,12757897396.324201,1664704,395428,769477,2829609
2018-05-30,BZX Equities (Z),213508198,105019023,113703682,432230903,9154789058.678698,6922888064.491502,6147618590.378399,22225295713.548599,1902090,473235,999985,3375310
2018-05-29,NYSE American (A),6403657,14412719,3529288,24345664,283881421.041400,331798929.476500,198210281.982000,813890632.499900,60179,52827,33685,146691
2018-05-29,NASDAQ BX (B),121311116,44666628,66134004,232111748,5284936538.844600,2257590963.813100,3192389433.099401,10734916935.757101,1229916,218057,696433,2144406
2018-05-29,NYSE National (C),736175,320106,370304,1426585,24695424.140000,25993098.170000,15147683.195000,65836205.505000,8812,2056,5831,16699
2018-05-29,FINRA / NYSE TRF (DN),96854192,42762834,129055256,268672282,3747377929.946301,1696416335.581200,3973457596.127701,9417251861.655202,279189,108237,290431,677857
2018-05-29,FINRA / Nasdaq TRF Carteret (DQ),1150664494,606366146,712116108,2469146748,45120206017.787295,35738511214.387602,34037434490.855590,114896151723.030487,3961571,1242082,2217097,7420750
2018-05-29,EDGA Equities (J),46697888,33693696,23960039,104351623,1870465965.425500,2128588869.919501,1317728696.120800,5316783531.465801,399000,160923,192311,752234
2018-05-29,EDGX Equities (K),203551516,109509980,173308120,486369616,9010088684.949000,6203197644.317700,8436978845.604900,23650265174.871600,1478024,454700,1025576,2958300
2018-05-29,CHX (M),15197371,12429138,4911568,32538077,1245625363.700000,1417738031.320000,594195454.420800,3257558849.440800,4582,7766,3570,15918
2018-05-29,NYSE (N),941593371,21816994,23289097,986699462,40434196072.681102,1735915405.139699,1268186395.009100,43438297872.829901,2801187,117107,192011,3110305
2018-05-29,NYSE Arca (P),219991836,385596001,159570169,765158006,9671437560.025597,22182352099.526001,8324992998.462002,40178782658.013600,1626622,1014128,1119456,3760206
2018-05-29,NASDAQ (Q),392498013,197024539,533783727,1123306279,19148056775.242806,13856348412.087096,32695338302.660399,65699743489.990301,3441350,885604,3281368,7608322
2018-05-29,IEX (V),99970605,22346239,45930374,168247218,4658525820.326300,1283431593.263100,2867735924.353800,8809693337.943200,701880,95792,327449,1125121
2018-05-29,NASDAQ PSX (X),18957173,28033390,16249835,63240398,793127444.592700,2245361366.627400,1187126830.158000,4225615641.378100,166899,120795,133090,420784
2018-05-29,BYX Equities (Y),200159881,105970246,82660132,388790259,5992112496.884300,4621572239.140999,3258905976.488300,13872590712.513599,1642955,499240,734388,2876583
2018-05-29,BZX Equities (Z),228730305,146005439,120514532,495250276,10061804400.449201,9645106020.984298,7326114436.447896,27033024857.881395,1984844,648447,1050432,3683723
2018-05-25,NYSE American (A),5093460,11227323,2992268,19313051,211295327.452700,175157233.521800,157017091.874200,543469652.848700,45906,38601,26920,111427
2018-05-25,NASDAQ BX (B),101130041,29375500,55211653,185717194,4237538575.692900,1412339861.566400,2501303413.938300,8151181851.197600,1054907,148330,602856,1806093
2018-05-25,NYSE National (C),93559,81159,51557,226275,1612656.220000,4494394.770000,1067248.730000,7174299.720000,617,408,177,1202
2018-05-25,FINRA / NYSE TRF (DN),90120908,29745798,134506626,254373332,3112730924.673900,993679361.902800,3037069098.294001,7143479384.870701,237374,73402,259878,570654
2018-05-25,FINRA / Nasdaq TRF Carteret (DQ),955874528,342312605,625537154,1923724287,37428114160.019003,18783706035.106300,26836411694.923391,83048231890.048694,3357996,749729,1931459,6039184
2018-05-25,EDGA Equities (J),35873251,20925677,18619228,75418156,1349197872.555200,1204600016.485800,941446293.842000,3495244182.883000,315020,100030,150525,565575
2018-05-25,EDGX Equities (K),167080288,67938779,144644390,379663457,6978193540.643900,3586975384.355399,6172375647.759700,16737544572.758999,1175826,274556,808791,2259173
2018-05-25,CHX (M),21500975,9190536,9863047,40554558,1587721376.817000,857151172.430000,1302446659.979900,3747319209.226900,3065,2761,2181,8007
2018-05-25,NYSE (N),719452273,12535652,20188410,752176335,29413696081.005790,827884368.611600,1074344537.626200,31315924987.243590,2208899,65322,163968,2438189
2018-05-25,NYSE Arca (P),175636442,233495469,131113819,540245730,7434391386.829701,12729197966.258102,5987304301.753198,26150893654.841001,1274202,607829,873619,2755650
2018-05-25,NASDAQ (Q),300389695,123091378,415394916,838875989,14255454772.703803,7700964712.945902,24239000956.747604,46195420442.397309,2626779,542964,2540524,5710267
2018-05-25,IEX (V),84305854,13689287,37938859,135934000,3592438073.579400,774100058.635600,2150548227.441900,6517086359.656900,575429,60920,278605,914954
2018-05-25,NASDAQ PSX (X),14704362,16821393,12599575,44125330,595277451.224500,1185050048.785701,849837048.086900,2630164548.097101,128098,67776,105057,300931
2018-05-25,BYX Equities (Y),156094838,66550321,67042732,289687891,4572789533.067200,2746141871.304700,2464766649.330900,9783698053.702800,1318710,310535,608466,2237711
2018-05-25,BZX Equities (Z),187916065,89347242,96253953,373517260,7922271758.205100,5361332694.058400,5501322179.063898,18784926631.327398,1631850,392077,838471,2862398
2018-05-24,NYSE American (A),5543244,10366375,3080538,18990157,231261202.126200,185438836.407100,169817970.871900,586518009.405200,51063,38833,29842,119738
2018-05-24,NASDAQ BX (B),108838067,29542365,62477429,200857861,4650825422.020500,1445139466.497200,2873521143.972501,8969486032.490201,1128910,151525,662691,1943126
2018-05-24,NYSE National (C),83764,7493,19742,110999,1608131.540000,252869.330000,565040.580000,2426041.450000,506,46,180,732
2018-05-24,FINRA / NYSE TRF (DN),88043129,29899782,135085609,253028520,3211656377.027300,1277706748.686800,3650032382.406500,8139395508.120600,233907,77083,283533,594523
2018-05-24,FINRA / Nasdaq TRF Carteret (DQ),1054309842,347853820,729915761,2132079423,41342785879.507305,21722255881.007801,32563089023.953197,95628130784.468303,3537423,789488,2133274,6460185
2018-05-24,EDGA Equities (J),41046658,19992507,22303491,83342656,1614247459.746800,1337039690.833400,1084059979.903800,4035347130.484000,356070,99863,176100,632033
2018-05-24,EDGX Equities (K),179606375,69423491,175899776,424929642,7468831874.415099,3818085348.319499,6956513117.076900,18243430339.811498,1247671,284400,910896,2442967
2018-05-24,CHX (M),12786765,11645707,16273393,40705865,883312505.115200,1095332158.167499,1686574068.687500,3665218731.970199,3324,4006,2733,10063
2018-05-24,NYSE (N),803543816,14606173,22269547,840419536,33523768266.314096,1141873707.986900,1140949973.095800,35806591947.396796,2417165,75535,174380,2667080
2018-05-24,NYSE Arca (P),195057973,248454440,146545780,590058193,8384545154.773001,14389829282.856505,7066134995.037298,29840509432.666804,1388438,685803,994901,3069142
2018-05-24,NASDAQ (Q),319013103,122932228,473471294,915416625,15177448021.594399,8556221532.694797,26579069801.716705,50312739356.005901,2728368,582741,2827218,6138327
2018-05-24,IEX (V),97950719,14083020,47139110,159172849,4336831662.144600,842068617.343900,2544383528.365300,7723283807.853800,654038,65426,321125,1040589
2018-05-24,NASDAQ PSX (X),16214578,17022111,14702569,47939258,653297318.824100,1361518311.833899,923598366.697100,2938413997.355099,137252,72547,117059,326858
2018-05-24,BYX Equities (Y),167218738,63190785,77009854,307419377,5142743377.897900,2726415357.026801,2783399729.484900,10652558464.409601,1434484,309004,676037,2419525
2018-05-24,BZX Equities (Z),196497772,90605157,109267608,396370537,8433656582.121302,6056685469.857101,5953688098.395199,20444030150.373602,1690426,416147,916833,3023406
2018-05-23,NYSE American (A),5336688,11179298,3123933,19639919,233177990.671300,196636513.359200,173008378.894700,602822882.925200,51165,41755,30792,123712
2018-05-23,NASDAQ BX (B),108336078,29761379,62042719,200140176,4795049350.242000,1473486515.093800,2822824394.395800,9091360259.731600,1150966,153604,662706,1967276
2018-05-23,NYSE National (C),206,0,200,406,7119.300000,0.000000,4840.000000,11959.300000,3,0,2,5
2018-05-23,FINRA / NYSE TRF (DN),89410417,30106052,127237918,246754387,3243360767.591600,1182173911.988400,3173370720.800600,7598905400.380600,236914,77595,274690,589199
2018-05-23,FINRA / Nasdaq TRF Carteret (DQ),1063121304,363058809,710940353,2137120466,41097682159.648396,21320798913.248697,31232286197.636893,93650767270.533986,3546279,788565,2108975,6443819
2018-05-23,EDGA Equities (J),41078123,20065486,21612684,82756293,1630632710.808500,1175644756.507000,1090092542.350800,3896370009.666300,362063,96156,180952,639171
2018-05-23,EDGX Equities (K),187174992,67269604,161358828,415803424,7652110304.049900,3759031308.265700,7107095139.968001,18518236752.283601,1287271,288340,929628,2505239
2018-05-23,CHX (M),14841036,12325750,6942585,34109371,940585672.692400,1243976788.775000,659804141.143200,2844366602.610600,3636,4084,3212,10932
2018-05-23,NYSE (N),811545025,13604482,21371556,846521063,34312161774.894791,1037922659.018000,1023141294.007300,36373225727.920091,2439286,70286,171768,2681340
2018-05-23,NYSE Arca (P),199552923,250720595,147189279,597462797,8673248564.445897,14347036734.149201,6741756374.255500,29762041672.850598,1435694,686708,992337,3114739
2018-05-23,NASDAQ (Q),336554016,123143675,492594978,952292669,16073706941.649097,8515856181.967701,28753038889.230995,53342602012.847793,2869815,584809,2892791,6347415
2018-05-23,IEX (V),99650345,14284308,46348965,160283618,4781162289.493800,835054612.534300,2492524991.820100,8108741893.848200,664539,65832,309731,1040102
2018-05-23,NASDAQ PSX (X),15578811,16754458,13656933,45990202,633112983.240900,1265329143.743600,904191407.160800,2802633534.145300,134733,70628,115733,321094
2018-05-23,BYX Equities (Y),168487279,65076049,76154476,309717804,5193132281.938500,2835488555.359300,2777667975.189800,10806288812.487600,1460776,318844,686929,2466549
2018-05-23,BZX Equities (Z),192500114,85079190,106514730,384094034,8396594135.591198,5627252690.146398,5754928901.816401,19778775727.553997,1684568,411452,929422,3025442
2018-05-22,NYSE American (A),5205309,11956289,2819358,19980956,209836094.572800,186016381.196600,148878154.005700,544730629.775100,50232,40415,27523,118170
2018-05-22,NASDAQ BX (B),111834326,26374932,60333878,198543136,4865583636.612700,1346406619.110700,2733811549.952000,8945801805.675400,1184600,138071,683273,2005944
2018-05-22,NYSE National (C),300,200,10,510,20991.000000,14686.000000,41.100000,35718.100000,3,2,1,6
2018-05-22,FINRA / NYSE TRF (DN),100831128,30982544,112033836,243847508,3393878146.824599,1137800621.730700,3016693260.277900,7548372028.833199,250816,88176,290048,629040
2018-05-22,FINRA / Nasdaq TRF Carteret (DQ),1115951440,326340874,729765084,2172057398,41837862433.863198,17969950562.244097,30657995475.570501,90465808471.677796,3580080,743039,2142686,6465805
2018-05-22,EDGA Equities (J),41278957,16813733,21462917,79555607,1591050686.392000,966857140.329300,1010487484.516400,3568395311.237700,357553,80130,177356,615039
2018-05-22,EDGX Equities (K),183786666,59603245,155236001,398625912,7352876188.462900,3083441848.108700,6370963653.053296,16807281689.624896,1231161,233298,881913,2346372
2018-05-22,CHX (M),14635903,10145537,7858463,32639903,1017418851.448000,1128513394.847500,1039931300.272000,3185863546.567500,3963,4046,2847,10856
2018-05-22,NYSE (N),820845261,10454662,20376364,851676287,32827681936.473398,829119144.066900,931819383.461400,34588620464.001698,2330858,56851,157710,2545419
2018-05-22,NYSE Arca (P),192374169,206630353,136517639,535522161,8027960019.163395,11396929157.653002,6218366005.374302,25643255182.190699,1349494,564499,954404,2868397
2018-05-22,NASDAQ (Q),328544184,100932672,461716297,891193153,15618535239.501398,6674587786.986698,25771998483.362503,48065121509.850599,2746539,465832,2774843,5987214
2018-05-22,IEX (V),97323671,10313613,41153557,148790841,4263724556.021100,607531129.865400,2183161830.799300,7054417516.685800,626439,51562,286233,964234
2018-05-22,NASDAQ PSX (X),15720654,13878424,11927936,41527014,611700245.591600,1040156971.574900,768380085.577800,2420237302.744300,135511,54872,106610,296993
2018-05-22,BYX Equities (Y),166506821,56961083,69768224,293236128,5053147578.324900,2439973950.288800,2555268829.523400,10048390358.137100,1434439,287634,644280,2366353
2018-05-22,BZX Equities (Z),189304765,72007092,96458389,357770246,7784969833.298002,4504979098.310701,4941589611.901800,17231538543.510503,1595039,329354,874992,2799385
2018-05-21,NYSE American (A),4524577,12124518,2950185,19599280,193908496.426900,177729406.146200,168132617.198200,539770519.771300,45518,37309,27013,109840
2018-05-21,NASDAQ BX (B),103018618,22226988,61906369,187151975,4450307762.199800,1273422026.894100,2832382194.324700,8556111983.418600,1096906,132849,668637,1898392
2018-05-21,NYSE National (C),300,200,2256,2756,24870.000000,14744.000000,48720.140000,88334.140000,4,2,29,35
2018-05-21,FINRA / NYSE TRF (DN),88013620,30954339,122983018,241950977,3132831046.716300,1189715426.106800,3453987032.064999,7776533504.888099,248770,86855,314339,649964
2018-05-21,FINRA / Nasdaq TRF Carteret (DQ),1070576480,315578813,772545984,2158701277,40047715853.978191,18523541435.438098,35183654294.754893,93754911584.171182,3431860,747012,2250233,6429105
2018-05-21,EDGA Equities (J),36664058,16285962,21162525,74112545,1412355275.294400,1027886427.427000,1068486729.890600,3508728432.612000,322594,86661,177671,586926
2018-05-21,EDGX Equities (K),163246881,54996127,152720702,370963710,6703946906.710399,3156179081.119900,6951539112.899301,16811665100.729600,1100313,225693,887839,2213845
2018-05-21,CHX (M),13171676,15254171,4493447,32919294,1034569446.447000,1203357519.740000,656639959.286800,2894566925.473800,3265,3834,3462,10561
2018-05-21,NYSE (N),712235097,8957943,19015457,740208497,29876628640.771605,716871868.684300,909667998.237500,31503168507.693405,2122984,51338,151235,2325557
2018-05-21,NYSE Arca (P),165808402,197792808,140150275,503751485,7215730437.842097,11713090541.653504,6651611303.759199,25580432283.254800,1205032,540930,942906,2688868
2018-05-21,NASDAQ (Q),285253348,92715357,472799931,850768636,13771885528.045700,6669130336.282899,27393594414.144692,47834610278.473291,2434551,443785,2764875,5643211
2018-05-21,IEX (V),81258974,10264443,44029721,135553138,3650019956.832600,617571084.357500,2351109664.633900,6618700705.824000,557793,54098,303121,915012
2018-05-21,NASDAQ PSX (X),13287190,11155933,13044961,37488084,566224056.128600,931279249.948200,879341739.039800,2376845045.116600,125262,51499,115234,291995
2018-05-21,BYX Equities (Y),150591399,48760712,71069889,270422000,4680018729.687700,2162077701.038200,2705317415.241801,9547413845.967701,1324855,248717,652628,2226200
2018-05-21,BZX Equities (Z),165835680,65754109,98353773,329943562,7158810075.169201,4501514401.786301,5405381559.304502,17065706036.260004,1440930,311699,881680,2634309
2018-05-18,NYSE American (A),4996347,16025946,3047402,24069695,203787597.427700,193118886.763300,160727240.284800,557633724.475800,47841,40103,29111,117055
2018-05-18,NASDAQ BX (B),111705279,23957453,64493485,200156217,4631049887.480600,1206134001.860400,2929346317.440500,8766530206.781500,1174121,131407,706728,2012256
2018-05-18,FINRA / NYSE TRF (DN),87621238,25857433,98951198,212429869,3073419588.261000,938070444.043000,3125554075.320601,7137044107.624601,229649,70903,276517,577069
2018-05-18,FINRA / Nasdaq TRF Carteret (DQ),1172291656,320668690,735098872,2228059218,44178861309.566109,21613131997.578290,34282682711.717809,100074676018.862208,3455852,731777,2185916,6373545
2018-05-18,EDGA Equities (J),38035433,17522420,21137464,76695317,1431206925.727700,1080967482.766400,1096680732.688200,3608855141.182300,325399,88665,172875,586939
2018-05-18,EDGX Equities (K),168647990,56570214,138615344,363833548,6857856600.845698,3300071916.113000,6569688563.927699,16727617080.886397,1175390,236806,877589,2289785
2018-05-18,CHX (M),12653708,11694276,21678592,46026576,1022888070.465000,1230772738.540000,1209775502.544500,3463436311.549500,3127,2569,3400,9096
2018-05-18,NYSE (N),872020840,10200873,19932180,902153893,37196065307.557097,726830954.671200,990563833.615900,38913460095.844197,2201718,55676,153185,2410579
2018-05-18,NYSE Arca (P),179933944,200843578,131342154,512119676,7537672438.859000,11500250235.257395,6827364993.443399,25865287667.559794,1287869,562899,949620,2800388
2018-05-18,NASDAQ (Q),297491225,103217275,515009070,915717570,14212717452.211401,7062084159.671201,30346648510.565885,51621450122.448487,2550360,491870,2844690,5886920
2018-05-18,IEX (V),89805184,11546944,46298702,147650830,4137631704.497200,667781526.695900,2530174414.720500,7335587645.913600,611072,54084,315370,980526
2018-05-18,NASDAQ PSX (X),14312817,13185835,13199730,40698382,596619400.532900,997149611.506800,878564183.265400,2472333195.305100,129965,55843,115127,300935
2018-05-18,BYX Equities (Y),159790844,51451404,72078371,283320619,4798466763.408899,2329813011.236800,2805879351.723900,9934159126.369599,1352840,262993,663418,2279251
2018-05-18,BZX Equities (Z),173963955,72697627,101310555,347972137,7425031340.115600,4777220288.780899,5804974604.445701,18007226233.342200,1497601,343895,890098,2731594
2018-05-17,NYSE American (A),5845227,12418265,3184867,21448359,230623265.411000,235761781.562000,167186790.998800,633571837.971800,55203,41320,30585,127108
2018-05-17,NASDAQ BX (B),114298243,25991037,64477210,204766490,4696112418.544100,1315961369.957600,2931503191.496601,8943576979.998301,1212684,140162,719746,2072592
2018-05-17,FINRA / NYSE TRF (DN),107172577,30639115,106368948,244180640,3382640450.612800,1201948561.995400,3365685683.390401,7950274695.998601,258079,83206,285913,627198
2018-05-17,FINRA / Nasdaq TRF Carteret (DQ),1232840432,360226246,736766033,2329832711,44105092997.913303,20089646562.012802,33472493249.680007,97667232809.606112,3718408,811513,2246639,6776560
2018-05-17,EDGA Equities (J),42008118,19870337,20389504,82267959,1535959156.452800,1289489221.948600,1057522845.304600,3882971223.706000,355860,102713,177429,636002
2018-05-17,EDGX Equities (K),196858561,64161570,148275764,409295895,7660161310.414401,3650709715.870602,6602594650.188100,17913465676.473103,1334559,261766,942673,2538998
2018-05-17,CHX (M),21046365,10451769,24750183,56248317,889413018.270000,1173134957.900000,691317705.237400,2753865681.407400,3244,3440,3956,10640
2018-05-17,NYSE (N),742768667,10289826,17635240,770693733,28966604486.633603,752990027.177300,831692697.066600,30551287210.877503,2329692,52712,142056,2524460
2018-05-17,NYSE Arca (P),196331362,226147162,136191666,558670190,8082423807.251598,12786309010.410401,6460733495.720299,27329466313.382298,1438533,604388,1010755,3053676
2018-05-17,NASDAQ (Q),331090154,113721560,455840355,900652069,15364861592.659402,7878823708.116494,25447658893.854500,48691344194.630396,2833295,515137,2952117,6300549
2018-05-17,IEX (V),102438404,13641359,50155197,166234960,4391059110.785000,791587043.467200,2474183001.471200,7656829155.723400,658201,67852,331962,1058015
2018-05-17,NASDAQ PSX (X),15980594,14693627,13145848,43820069,605964232.163500,1048056757.721500,824085105.468700,2478106095.353700,138761,61386,113488,313635
2018-05-17,BYX Equities (Y),176638346,61002831,73418036,311059213,5158265677.039100,2760749599.001200,2779079733.248299,10698095009.288599,1485655,303455,682852,2471962
2018-05-17,BZX Equities (Z),192840029,82348216,108376620,383564865,8107173645.611103,5366911783.391902,5740230039.692399,19214315468.695404,1685515,382310,962906,3030731
2018-05-16,NYSE American (A),5717815,11703662,3079145,20500622,245876593.525200,168060530.758900,149456556.628300,563393680.912400,55645,36815,29890,122350
2018-05-16,NASDAQ BX (B),110870946,24089650,65716373,200676969,4551222344.988700,1232589591.221300,2832607312.484800,8616419248.694800,1168323,129305,707241,2004869
2018-05-16,FINRA / NYSE TRF (DN),94221667,28762007,138259642,261243316,3208529650.095000,1162852978.672300,3112578954.841799,7483961583.609099,243717,78955,291909,614581
2018-05-16,FINRA / Nasdaq TRF Carteret (DQ),1110348987,330809221,782566377,2223724585,41281673923.241698,19647170283.130300,31429514658.582808,92358358864.954806,3668880,785296,2292893,6747069
2018-05-16,EDGA Equities (J),38592471,18062621,20922944,77578036,1450535029.334600,1103471071.324400,1023028561.818600,3577034662.477600,337828,90268,172671,600767
2018-05-16,EDGX Equities (K),180018229,59453955,177938644,417410828,7048609436.529100,3239541177.053900,6559731248.786700,16847881862.369700,1228998,242831,918447,2390276
2018-05-16,CHX (M),11936583,12697083,6278501,30912167,664257672.561000,1313391955.935200,493149767.428000,2470799395.924200,2534,3212,2363,8109
2018-05-16,NYSE (N),755277643,9601618,18081371,782960632,30612562359.043702,653757131.998900,816454507.327300,32082773998.369902,2272696,49816,139841,2462353
2018-05-16,NYSE Arca (P),176654618,203646801,137660410,517961829,7454560611.439597,11345145733.365995,6036580614.277101,24836286959.082693,1327659,544681,937398,2809738
2018-05-16,NASDAQ (Q),313371837,105549835,507300482,926222154,14607208230.129199,7172334724.835602,26836399890.839805,48615942845.804606,2707992,481853,2905568,6095413
2018-05-16,IEX (V),91201387,12699784,46324205,150225376,4076202818.098400,729782063.246300,2354419525.527500,7160404406.872200,639445,61917,311319,1012681
2018-05-16,NASDAQ PSX (X),14041855,13347563,13793032,41182450,570717244.898800,943645964.553500,828209249.910000,2342572459.362300,131554,57279,115064,303897
2018-05-16,BYX Equities (Y),168315756,54016284,80759481,303091521,5128732990.266500,2379452332.341700,2815747294.794600,10323932617.402800,1473947,269693,698725,2442365
2018-05-16,BZX Equities (Z),177918342,72364197,104389364,354671903,7590922787.524697,4666326941.999002,5291127068.273399,17548376797.797098,1593428,346322,907766,2847516
2018-05-15,NYSE American (A),5896622,14810389,3361637,24068648,233515504.568400,304604870.031300,160515982.045800,698636356.645500,57457,44893,32868,135218
2018-05-15,NASDAQ BX (B),115102445,32823711,68686312,216612468,4966731166.142700,1558629981.431900,3279124041.254800,9804485188.829400,1228766,158103,754822,2141691
2018-05-15,FINRA / NYSE TRF (DN),80237935,33723302,119419524,233380761,2944581783.592701,1344092131.204300,3246103642.607000,7534777557.404001,221934,88137,294191,604262
2018-05-15,FINRA / Nasdaq TRF Carteret (DQ),1049607376,419061949,729932593,2198601918,39213253147.906305,24440600272.222100,34630496960.089492,98284350380.217897,3645564,882544,2313985,6842093
2018-05-15,EDGA Equities (J),41375895,26337938,23384694,91098527,1590840358.025300,1672283646.073400,1266039189.680600,4529163193.779300,374659,119943,196277,690879
2018-05-15,EDGX Equities (K),188245430,86549134,184658533,459453097,7749640475.217200,4872968180.957500,8554072715.194100,21176681371.368800,1378806,333511,1053594,2765911
2018-05-15,CHX (M),11613552,12938029,6772647,31324228,667440928.318300,1494409787.420000,681694744.416000,2843545460.154300,3503,4501,3576,11580
2018-05-15,NYSE (N),800583975,13904575,19968644,834457194,34374737129.120196,1031037627.194900,1042992135.788400,36448766892.103496,2490252,69877,155873,2716002
2018-05-15,NYSE Arca (P),176965797,282408828,147698094,607072719,7906791301.110500,16327472084.765107,7750467038.856899,31984730424.732506,1413652,768712,993549,3175913
2018-05-15,NASDAQ (Q),335544088,150249170,543746040,1029539298,16529782851.000894,10873959493.723998,34031307501.611997,61435049846.336889,3046744,670070,3311305,7028119
2018-05-15,IEX (V),97307612,15223808,50423762,162955182,4358326245.406100,949090622.404000,2854907960.777800,8162324828.587900,680621,68524,336474,1085619
2018-05-15,NASDAQ PSX (X),15000282,19746229,17472323,52218834,621706370.656600,1611000222.036101,1270351423.400200,3503058016.092901,138213,80043,135634,353890
2018-05-15,BYX Equities (Y),180267509,76713668,83201682,340182859,5525415413.481600,3278004140.563901,3284548440.271700,12087967994.317201,1600154,359695,748597,2708446
2018-05-15,BZX Equities (Z),193450807,108837583,121661216,423949606,8643007315.173502,7437650566.874299,7462302289.153100,23542960171.200901,1752410,495816,1047039,3295265
2018-05-14,NYSE American (A),4917930,12114193,3236498,20268621,214256809.635000,165764935.203900,152252947.754500,532274692.593400,50568,38259,31140,119967
2018-05-14,NASDAQ BX (B),99296113,23835421,67284693,190416227,4396649087.545000,1196798754.596200,2932591659.996700,8526039502.137900,1089851,121342,702471,1913664
2018-05-14,FINRA / NYSE TRF (DN),79766861,29209545,115641086,224617492,3082501261.557300,1049123852.781000,3110915244.713700,7242540359.052000,234520,84212,298803,617535
2018-05-14,FINRA / Nasdaq TRF Carteret (DQ),1003631799,370223131,778131664,2151986594,42002968214.615813,19830414839.464105,34611766155.834600,96445149209.914518,3395945,755968,2365941,6517854
2018-05-14,EDGA Equities (J),36294044,16966692,22217118,75477854,1473682904.858500,1133756071.277900,1070933019.911800,3678371996.048200,326248,84841,184865,595954
2018-05-14,EDGX Equities (K),164612098,58767358,167912031,391291487,7129736144.115598,3269875197.922300,7184749519.528401,17584360861.566299,1165813,233257,963010,2362080
2018-05-14,CHX (M),7835506,9780206,8546931,26162643,464921165.631000,948816646.522000,656971667.357000,2070709479.510000,3057,3650,3271,9978
2018-05-14,NYSE (N),735712388,9003631,18387532,763103551,32800246142.120098,624886878.203300,896385888.693300,34321518909.016698,2271892,46243,146037,2464172
2018-05-14,NYSE Arca (P),160833175,190981975,135885118,487700268,7270199209.226897,11790130040.010098,6127252173.448700,25187581422.685695,1273125,542632,944423,2760180
2018-05-14,NASDAQ (Q),289108218,96497521,520624766,906230505,14225048415.107800,7062946254.086801,28864935176.824101,50152929846.018702,2560371,451173,3073236,6084780
2018-05-14,IEX (V),81180144,11985751,51331657,144497552,3833324890.294100,683918485.578100,2701162621.274200,7218405997.146400,577829,54868,345203,977900
2018-05-14,NASDAQ PSX (X),14138444,12497438,14848742,41484624,602527629.174800,992196223.196100,886171101.419900,2480894953.790800,128019,51876,123953,303848
2018-05-14,BYX Equities (Y),147145345,49946628,74181996,271273969,4652130191.905000,2169653022.819800,2724765054.369700,9546548269.094500,1302736,237716,665682,2206134
2018-05-14,BZX Equities (Z),169894852,70726148,107624158,348245158,7485377854.068499,4751613028.890399,5432597413.687800,17669588296.646698,1502790,336186,937165,2776141
2018-05-11,NYSE American (A),4920876,10009348,3327645,18257869,209623160.223100,140088447.802800,164034511.667600,513746119.693500,48476,32746,31948,113170
2018-05-11,NASDAQ BX (B),102084219,21590324,65253872,188928415,4384406471.679900,1177410084.342600,2900313514.274800,8462130070.297300,1099919,118090,692034,1910043
2018-05-11,FINRA / NYSE TRF (DN),76517531,29133368,132759004,238409903,2908256038.375200,1067122710.674700,3595528172.928600,7570906921.978500,218699,75923,301359,595981
2018-05-11,FINRA / Nasdaq TRF Carteret (DQ),930025820,321361589,760634290,2012021699,37464271166.225812,18690601421.087297,33214847826.657586,89369720413.970695,3270219,702447,2349273,6321939
2018-05-11,EDGA Equities (J),33250560,15499492,22866945,71616997,1323802708.544600,981308791.136900,1070964514.362200,3376076014.043700,303591,77485,186328,567404
2018-05-11,EDGX Equities (K),159645211,59024686,180015710,398685607,6748052761.347400,3265919055.150500,7401475449.786796,17415447266.284696,1138231,225756,995926,2359913
2018-05-11,CHX (M),10278789,11864626,5213093,27356508,484568834.092000,1428728735.902100,536079978.275700,2449377548.269800,2783,3706,4020,10509
2018-05-11,NYSE (N),715795442,7425904,18023760,741245106,31547759607.587703,545516429.112700,786755976.457500,32880032013.157903,2231103,39805,141237,2412145
2018-05-11,NYSE Arca (P),157439185,207191334,136474485,501105004,7121834640.548700,12657691422.288593,6292060717.096398,26071586779.933691,1259686,543057,931286,2734029
2018-05-11,NASDAQ (Q),274987987,101162082,517205267,893355336,13446742776.113202,7329839110.316399,29129384134.790896,49905966021.220497,2486171,461921,3067705,6015797
2018-05-11,IEX (V),82038896,12150964,49455491,143645351,3846400375.569400,727601678.869300,2631878289.713200,7205880344.151900,571911,58849,324364,955124
2018-05-11,NASDAQ PSX (X),13691442,12944312,13953918,40589672,573827822.783300,1028015284.780100,891742048.885900,2493585156.449300,127584,54480,122417,304481
2018-05-11,BYX Equities (Y),148017494,50585155,72798119,271400768,4600098024.151900,2302863010.754101,2696342110.897900,9599303145.803901,1301674,257122,661679,2220475
2018-05-11,BZX Equities (Z),166161086,75736827,107376383,349274296,7346348549.768899,4809795511.101701,5675273142.613100,17831417203.483700,1508550,342313,953052,2803915
2018-05-10,NYSE American (A),6344471,11917667,3580562,21842700,245156188.593000,227486234.433800,186433190.445600,659075613.472400,57456,40598,33844,131898
2018-05-10,NASDAQ BX (B),111504095,29387817,68980900,209872812,4710522392.296100,1582392013.441900,3176786494.788400,9469700900.526400,1168246,143834,724703,2036783
2018-05-10,FINRA / NYSE TRF (DN),95939500,33972841,129888840,259801181,3558554809.893700,1356542278.634000,3751037033.315903,8666134121.843603,254862,85554,319246,659662
2018-05-10,FINRA / Nasdaq TRF Carteret (DQ),1150051394,417296635,842577535,2409925564,43544374602.845702,24477006393.635096,35654771106.771403,103676152103.252201,3716941,857976,2505552,7080469
2018-05-10,EDGA Equities (J),43437308,22292588,24029986,89759882,1633879439.071700,1389435776.806300,1234761962.290000,4258077178.168000,375024,105098,198003,678125
2018-05-10,EDGX Equities (K),187741256,76201035,196945814,460888105,7740464822.306801,4254479066.742600,8077524317.485099,20072468206.534500,1298511,293820,1033901,2626232
2018-05-10,CHX (M),8801986,9189894,8254270,26246150,425926924.390000,1186580295.980000,809693123.086000,2422200343.456000,2695,3879,3336,9910
2018-05-10,NYSE (N),787758026,8881377,19454185,816093588,32098006518.464601,717482605.567200,881610339.966600,33697099463.998401,2543873,50178,150851,2744902
2018-05-10,NYSE Arca (P),190019902,263260459,166459155,619739516,7760724465.841095,14535649478.270297,7292100170.740801,29588474114.852193,1394636,692597,998975,3086208
2018-05-10,NASDAQ (Q),318020376,123919801,527603334,969543511,14537579949.939699,8458774013.585401,29899799158.952791,52896153122.477891,2772638,539114,3248127,6559879
2018-05-10,IEX (V),96799229,20021926,52446902,169268057,4161738379.373700,1116743614.861700,3124373878.433899,8402855872.669299,654871,79682,345786,1080339
2018-05-10,NASDAQ PSX (X),17994171,17483990,14932089,50410250,653843510.350800,1246307811.734800,934431795.351600,2834583117.437200,150733,68241,122361,341335
2018-05-10,BYX Equities (Y),173994553,68368972,78925414,321288939,5239731152.164400,2991139572.238000,3059734465.942700,11290605190.345100,1453389,312606,692426,2458421
2018-05-10,BZX Equities (Z),192237871,95003953,116373166,403614990,7895245236.077301,5979792683.474597,6289808779.820202,20164846699.372100,1663377,419311,1007068,3089756
2018-05-09,NYSE American (A),7672815,13215551,3675781,24564147,285235852.524700,187157023.980100,169306246.068000,641699122.572800,66601,41884,35150,143635
2018-05-09,NASDAQ BX (B),126079446,25939109,73890655,225909210,5319916396.780799,1336788331.914900,3412344685.553899,10069049414.249598,1308633,134154,788028,2230815
2018-05-09,FINRA / NYSE TRF (DN),108115160,34183458,111023800,253322418,3717909916.043700,1243062156.571600,3616294121.576399,8577266194.191699,271060,84435,312134,667629
2018-05-09,FINRA / Nasdaq TRF Carteret (DQ),1327746588,375005220,836493003,2539244811,47024635438.190095,19553259306.489507,36441809876.607299,103019704621.286901,4075514,807212,2579008,7461734
2018-05-09,EDGA Equities (J),49670884,20378835,25022441,95072160,1792795606.898000,1238407366.703800,1264100044.680400,4295303018.282200,424628,95671,213462,733761
2018-05-09,EDGX Equities (K),217860072,72514116,182931354,473305542,8884661977.894200,3866469748.611901,8352901064.554994,21104032791.061095,1484229,284658,1120377,2889264
2018-05-09,CHX (M),10074549,14663131,6944244,31681924,469722816.273100,1245493686.250000,771831811.986200,2487048314.509300,3844,3451,3210,10505
2018-05-09,NYSE (N),940292966,8209086,21502350,970004402,35102010838.601700,717213350.560600,877395315.238000,36696619504.400300,2846443,48758,157604,3052805
2018-05-09,NYSE Arca (P),213115251,232971274,150692360,596778885,9016200676.492001,13278706993.166100,7279899282.829202,29574806952.487303,1592822,649408,1065752,3307982
2018-05-09,NASDAQ (Q),363880844,116702058,555499944,1036082846,16686579517.176408,8134700812.251301,31948148124.005688,56769428453.433397,3138779,550096,3552827,7241702
2018-05-09,IEX (V),110335602,15070709,56007923,181414234,4750973145.086401,902913598.540600,3084067866.593801,8737954610.220802,731461,67896,371171,1170528
2018-05-09,NASDAQ PSX (X),19481036,15012233,16134447,50627716,755038463.179900,1120736331.849800,1056217068.651300,2931991863.681000,171954,65651,142616,380221
2018-05-09,BYX Equities (Y),197965594,61184369,83053713,342203676,5836873474.832099,2634568064.013400,3106885067.286400,11578326606.131899,1640494,299705,758368,2698567
2018-05-09,BZX Equities (Z),221362183,84965465,127393237,433720885,9273208303.822898,5496739212.622599,6853582031.976804,21623529548.422301,1914211,405808,1113074,3433093
2018-05-08,NYSE American (A),6724000,11621487,3265809,21611296,271726958.772000,226007264.945800,150351967.632000,648086191.349800,63646,42789,32815,139250
2018-05-08,NASDAQ BX (B),120742102,29516436,68564829,218823367,5089686515.529200,1376225953.066100,3011035858.762600,9476948327.357900,1232799,144848,732751,2110398
2018-05-08,FINRA / NYSE TRF (DN),102499158,35144403,100116733,237760294,3662838358.064100,1377873685.214100,3331468046.577701,8372180089.855901,253922,91079,280816,625817
2018-05-08,FINRA / Nasdaq TRF Carteret (DQ),1223341455,382838797,735157024,2341337276,47687912542.419786,20477338153.784199,34305045898.493104,102470296594.697089,3939442,861090,2329630,7130162
2018-05-08,EDGA Equities (J),46529418,24250983,23140150,93920551,1759054145.631300,1286736468.063800,1078609226.379900,4124399840.075000,412974,114025,200327,727326
2018-05-08,EDGX Equities (K),223911193,82548015,165474067,471933275,9329930894.432599,4417617087.142002,7282187099.679102,21029735081.253703,1627942,330166,1087283,3045391
2018-05-08,CHX (M),11597415,9713946,11024440,32335801,621826906.946600,1012932631.585000,874043356.169300,2508802894.700900,2191,3675,2040,7906
2018-05-08,NYSE (N),893766530,9287366,17028926,920082822,37230133293.370809,800640390.474300,740341848.989100,38771115532.834209,3000393,54067,140881,3195341
2018-05-08,NYSE Arca (P),209210665,262336752,136481622,608029039,9133958674.665103,13919887234.190400,6531978675.957302,29585824584.812805,1644811,746242,1029018,3420071
2018-05-08,NASDAQ (Q),359625479,139389169,535970551,1034985199,16920369267.903101,9015275434.573499,29795214862.471108,55730859564.947708,3278734,640420,3462701,7381855
2018-05-08,IEX (V),115827754,16799403,56786578,189413735,5172682360.734800,911101814.882200,2791926430.699600,8875710606.316600,787031,82870,382697,1252598
2018-05-08,NASDAQ PSX (X),18506154,19338589,16309738,54154481,770931044.731000,1376045463.504900,1040305567.379500,3187282075.615400,167173,81173,147290,395636
2018-05-08,BYX Equities (Y),190661880,67283922,80821727,338767529,5549497467.353902,2720226314.573099,2947405592.544000,11217129374.471001,1617280,315931,745302,2678513
2018-05-08,BZX Equities (Z),222162223,110472834,120835157,453470214,9418906674.102203,6932035401.680098,6456365762.989799,22807307838.772100,1996507,511398,1106851,3614756
2018-05-07,NYSE American (A),5536353,10952744,2989806,19478903,228670510.976000,187465893.007800,169863141.366000,585999545.349800,53269,36068,29521,118858
2018-05-07,NASDAQ BX (B),113237248,26203481,65881405,205322134,4855708900.208700,1346803986.208000,3166845403.154700,9369358289.571400,1194658,133515,721200,2049373
2018-05-07,FINRA / NYSE TRF (DN),95749175,33343584,99220225,228312984,3760791464.553100,1211726882.931000,4000845638.057702,8973363985.541802,258901,87152,291416,637469
2018-05-07,FINRA / Nasdaq TRF Carteret (DQ),1074111969,356508901,705389571,2136010441,43467241951.904312,19583478952.293302,35830197106.574404,98880918010.772018,3749866,817729,2320148,6887743
2018-05-07,EDGA Equities (J),38740710,20360889,21468748,80570347,1511808876.672900,1280052242.221200,1104292190.921900,3896153309.816000,346031,98765,178350,623146
2018-05-07,EDGX Equities (K),189664180,68727519,157815967,416207666,8391512238.332000,3720124776.057500,7978354055.490099,20089991069.879599,1415166,282776,1018638,2716580
2018-05-07,CHX (M),10755649,8157067,5499206,24411922,616264615.497000,861771212.380000,604619790.775600,2082655618.652600,1880,3405,1759,7044
2018-05-07,NYSE (N),758721294,7501401,16932379,783155074,32255159021.877803,714108441.855700,814745985.064800,33784013448.798303,2497371,42282,133944,2673597
2018-05-07,NYSE Arca (P),175673767,217959269,130076804,523709840,8067161830.841403,12397585977.230001,6993326321.330998,27458074129.402402,1406142,602831,979170,2988143
2018-05-07,NASDAQ (Q),326537972,107354599,498194865,932087436,16129247749.553798,7306323105.829299,30624164101.672392,54059734957.055489,2987455,505550,3243518,6736523
2018-05-07,IEX (V),93427260,14493379,46258505,154179144,4186316413.515700,876871908.290300,2596217841.873200,7659406163.679200,657023,64984,325366,1047373
2018-05-07,NASDAQ PSX (X),16258663,13616970,15015949,44891582,668956669.855500,972280193.819900,1018688154.178600,2659925017.854000,147064,59889,126514,333467
2018-05-07,BYX Equities (Y),176070311,59338416,74841091,310249818,5329981783.095600,2522147267.520700,2903440461.630999,10755569512.247299,1534419,285296,698803,2518518
2018-05-07,BZX Equities (Z),192329963,79115634,111068202,382513799,8492871778.474200,5042985352.695501,6566904309.532100,20102761440.701801,1752339,373195,1004464,3129998
2018-05-04,NYSE American (A),6051897,10140911,3399185,19591993,256916283.511400,225564578.872700,199912427.321900,682393289.706000,57675,36859,32718,127252
2018-05-04,NASDAQ BX (B),117599023,24917129,69529023,212045175,5040949193.159599,1359100088.045300,3309953085.488500,9710002366.693399,1214955,126330,737003,2078288
2018-05-04,FINRA / NYSE TRF (DN),96450467,31870889,99614515,227935871,3850024062.292300,1316023446.410100,3698924398.321101,8864971907.023501,253241,78733,272150,604124
2018-05-04,FINRA / Nasdaq TRF Carteret (DQ),1055657889,358026500,707739240,2121423629,42446916479.455987,23204330304.917094,35295049794.739375,100946296579.112456,3914539,775576,2421186,7111301
2018-05-04,EDGA Equities (J),37486164,20104969,20860906,78452039,1539789566.066800,1522297770.652000,1254641955.154000,4316729291.872800,353739,97357,194840,645936
2018-05-04,EDGX Equities (K),197512971,69493739,164014425,431021135,9009613653.142600,4216816627.500599,8661541988.842001,21887972269.485200,1459873,282338,1069812,2812023
2018-05-04,CHX (M),8932743,14530930,7031525,30495198,491512130.845800,1489442847.432800,640414386.727500,2621369365.006100,3390,6345,3501,13236
2018-05-04,NYSE (N),765726094,8129790,16553285,790409169,32142436153.588698,860500281.029300,871625980.518500,33874562415.136498,2542790,48423,135677,2726890
2018-05-04,NYSE Arca (P),191336013,228083368,138575313,557994694,9249083073.235298,13868039980.854407,7641757338.918201,30758880393.007906,1506674,680207,1033690,3220571
2018-05-04,NASDAQ (Q),343395704,113324587,534993090,991713381,17768221811.006298,8678107472.817798,33366576704.144194,59812905987.968290,3167049,538015,3451420,7156484
2018-05-04,IEX (V),100902456,14071258,50073545,165047259,4726093757.595500,926580703.577400,2957678763.064901,8610353224.237801,689115,67272,348530,1104917
2018-05-04,NASDAQ PSX (X),15357568,15927950,16104299,47389817,629058533.221300,1263887336.356900,1106539477.707300,2999485347.285500,146172,65962,137727,349861
2018-05-04,BYX Equities (Y),182819485,58376583,82784316,323980384,5590826280.505999,2663579484.848399,3315363629.725700,11569769395.080098,1551545,283797,745914,2581256
2018-05-04,BZX Equities (Z),216032749,88777924,129256727,434067400,9825609697.257902,6150343105.584798,7730667349.700802,23706620152.543502,1932378,427869,1157422,3517669
2018-05-03,NYSE American (A),6869363,10938046,4094635,21902044,294665213.993400,276416904.801400,208202418.512000,779284537.306800,66241,46228,38664,151133
2018-05-03,NASDAQ BX (B),129403583,31905960,75442086,236751629,5783178931.502300,1572759836.148200,3586428129.934600,10942366897.585100,1333680,157275,777024,2267979
2018-05-03,FINRA / NYSE TRF (DN),106861572,35326148,114299303,256487023,4350901009.698800,1737836170.199899,4007082373.895501,10095819553.794200,273088,82026,261298,616412
2018-05-03,FINRA / Nasdaq TRF Carteret (DQ),1239509785,421175738,843862708,2504548231,50942176512.166380,27924151208.127203,40010225053.061821,118876552773.355404,4395810,1031919,2615851,8043580
2018-05-03,EDGA Equities (J),48828330,27251754,28844915,104924999,1929148888.026800,1923205568.512900,1538317871.183900,5390672327.723600,437382,137916,243230,818528
2018-05-03,EDGX Equities (K),223424193,94716710,193636477,511777380,10051451994.337301,6191245494.348901,9488352188.571296,25731049677.257498,1657538,416071,1216845,3290454
2018-05-03,CHX (M),16008599,16201133,8609588,40819320,779489259.887800,2117420754.365400,779480721.606100,3676390735.859300,3951,7292,4839,16082
2018-05-03,NYSE (N),856731813,10124710,18407549,885264072,36608283554.686895,681565458.023900,944149359.514100,38233998372.224895,3065418,59156,159716,3284290
2018-05-03,NYSE Arca (P),236452582,315802837,165267778,717523197,11048323043.863500,19944908481.711096,8825571387.197699,39818802912.772295,1872693,966530,1202013,4041236
2018-05-03,NASDAQ (Q),412897540,168372790,578545723,1159816053,20842258246.079705,13876627021.769586,35803504488.365487,70522389756.214778,3866522,819823,4087426,8773771
2018-05-03,IEX (V),122663318,19114834,59598766,201376918,5602960072.979001,1240078165.672000,3408835509.097201,10251873747.748202,828374,94685,409847,1332906
2018-05-03,NASDAQ PSX (X),17897036,23947531,18550652,60395219,760123932.177000,2280344282.463800,1348606182.767900,4389074397.408700,157960,101560,151086,410606
2018-05-03,BYX Equities (Y),197122742,77157381,92474465,366754588,6217172423.315498,3491771739.771000,3583620048.713401,13292564211.799899,1681291,376516,802321,2860128
2018-05-03,BZX Equities (Z),252864385,137096680,154146061,544107126,11920956367.732899,10806006737.064201,9532332630.274896,32259295735.071996,2319276,669353,1362508,4351137
2018-05-02,NYSE American (A),8601127,12553323,3405791,24560241,299392310.257300,240688511.633400,200404646.099700,740485467.990400,72477,42332,33569,148378
2018-05-02,NASDAQ BX (B),140808994,29856862,70921281,241587137,5951524372.590500,1590145419.824500,3596689094.692800,11138358887.107800,1434917,150729,763417,2349063
2018-05-02,FINRA / NYSE TRF (DN),108225864,26438778,106395334,241059976,4097781745.481400,1058545086.304400,3656405579.456900,8812732411.242700,243788,68467,242745,555000
2018-05-02,FINRA / Nasdaq TRF Carteret (DQ),1312331958,354670725,766701128,2433703811,49440635097.639196,21557765427.831295,38294894750.108892,109293295275.579383,4440123,876382,2488444,7804949
2018-05-02,EDGA Equities (J),51497095,23816917,25828613,101142625,1919717813.116900,1540127957.888701,1466312025.944400,4926157796.950001,467585,113156,221844,802585
2018-05-02,EDGX Equities (K),234524481,74606465,182407019,491537965,9993963906.624703,4442350667.853702,9367264002.185903,23803578576.664308,1746670,318496,1202147,3267313
2018-05-02,CHX (M),11987163,13533519,9397493,34918175,633251097.503200,1529899659.720000,948051689.289600,3111202446.512800,4018,4496,4523,13037
2018-05-02,NYSE (N),915795448,7769477,17917592,941482517,38384454206.530893,718310972.352700,946506442.799500,40049271621.683093,2949241,43050,150423,3142714
2018-05-02,NYSE Arca (P),231984079,257220246,141489891,630694216,10399894447.308795,14879576313.914593,7870527456.686001,33149998217.909389,1912840,756815,1107719,3777374
2018-05-02,NASDAQ (Q),409474318,132776926,545241558,1087492802,20041377457.450103,9225727386.384606,34515069115.535194,63782173959.369903,3784824,577041,3702695,8064560
2018-05-02,IEX (V),125183607,16244700,52793996,194222303,5270882549.637600,957966969.848800,3199865399.806099,9428714919.292499,823657,77154,368759,1269570
2018-05-02,NASDAQ PSX (X),20066406,18247821,15277109,53591336,782186470.755300,1460543863.239200,1055708772.824700,3298439106.819200,172476,72811,140821,386108
2018-05-02,BYX Equities (Y),216139308,67259402,83746676,367145386,6359849096.088700,2863076049.691700,3400714844.864900,12623639990.645300,1811899,317682,775110,2904691
2018-05-02,BZX Equities (Z),260400256,99834465,136342901,496577622,11469090314.971498,6924061965.092800,8253788267.385800,26646940547.450098,2358075,486812,1236697,4081584
2018-05-01,NYSE American (A),6003026,10355265,3126239,19484530,241669371.043800,231998790.288400,165657643.465500,639325804.797700,58487,39902,30940,129329
2018-05-01,NASDAQ BX (B),121941462,25570194,64419424,211931080,5277149594.434399,1359281103.143700,3130630447.017100,9767061144.595199,1293477,134126,695879,2123482
2018-05-01,FINRA / NYSE TRF (DN),91671469,27462967,89404927,208539363,3580674607.780800,1315436125.759900,3559098900.469601,8455209634.010301,217440,73847,214046,505333
2018-05-01,FINRA / Nasdaq TRF Carteret (DQ),1174911099,376092319,687223876,2238227294,45915585631.061712,22575842660.624601,33865708349.957894,102357136641.644207,4074166,905518,2268360,7248044
2018-05-01,EDGA Equities (J),46579360,21132864,23521747,91233971,1872907538.806600,1383974007.184600,1303744440.012100,4560625986.003300,429537,106706,204280,740523
2018-05-01,EDGX Equities (K),205689773,70376122,158185302,434251197,8987033342.548300,4335852115.880600,8334964306.894203,21657849765.323103,1535326,294318,1046002,2875646
2018-05-01,CHX (M),8977538,11979276,7414136,28370950,602033246.411400,1340306260.125000,899002436.902100,2841341943.438500,3746,5437,3419,12602
2018-05-01,NYSE (N),807172241,7139722,12568571,826880534,33484706860.551602,569785916.270200,644320969.921800,34698813746.743602,2691274,38950,112452,2842676
2018-05-01,NYSE Arca (P),197046812,244329165,128896924,570272901,9056190483.750401,14398035709.579697,7573356258.605700,31027582451.935798,1680700,718171,1008863,3407734
2018-05-01,NASDAQ (Q),372342579,126675547,500677280,999695406,18927174523.225104,9382879310.857498,31268135792.295104,59578189626.377706,3540764,603633,3434135,7578532
2018-05-01,IEX (V),105443129,16254580,49403338,171101047,4855398376.718899,980974366.475100,2900687907.203300,8737060650.397299,722910,76667,341567,1141144
2018-05-01,NASDAQ PSX (X),16315680,18718378,13520716,48554774,656277567.995000,1430590500.320300,998791920.722200,3085659989.037500,142970,75034,121663,339667
2018-05-01,BYX Equities (Y),182331801,62956871,75689411,320978083,5579154270.900600,2752855688.620300,3009945025.965200,11341954985.486100,1602330,308050,709922,2620302
2018-05-01,BZX Equities (Z),226400300,98662564,118616939,443679803,10240016120.654802,6896149412.329799,7078402353.425698,24214567886.410299,2102958,478037,1091024,3672019
2018-04-30,NYSE American (A),6407484,12048409,2951925,21407818,245562701.890000,259853740.550800,164587415.972400,670003858.413200,57677,37133,29067,123877
2018-04-30,NASDAQ BX (B),121851976,29976663,62975430,214804069,5283125220.024200,1545199221.084099,2998102450.238400,9826426891.346699,1238646,146767,662290,2047703
2018-04-30,FINRA / NYSE TRF (DN),86976971,25857668,86338374,199173013,3185299436.812800,1180261479.180600,3321391803.824001,7686952719.817401,209211,69749,216728,495688
2018-04-30,FINRA / Nasdaq TRF Carteret (DQ),1192866001,353224466,709354921,2255445388,46902246633.629504,22477014251.297398,36812340596.168009,106191601481.094911,3862174,769762,2196362,6828298
2018-04-30,EDGA Equities (J),44025831,22274695,22141234,88441760,1678567124.863100,1354530201.125600,1188714816.005400,4221812141.994100,375509,99860,187864,663233
2018-04-30,EDGX Equities (K),196848234,71299308,157073324,425220866,8382696861.299500,4231376722.444499,8057038043.578600,20671111627.322599,1400784,275192,987891,2663867
2018-04-30,CHX (M),16012348,8643132,6060838,30716318,784863130.503100,1047021460.315000,606299798.914300,2438184389.732400,2286,4672,2198,9156
2018-04-30,NYSE (N),1009301792,7945436,13795873,1031043101,44963310087.186202,799520738.490100,624526682.247300,46387357507.923602,2567691,41804,120316,2729811
2018-04-30,NYSE Arca (P),190276153,255332402,124191150,569799705,8287895434.106003,15440061327.795507,6748882076.848401,30476838838.749911,1471605,674469,933205,3079279
2018-04-30,NASDAQ (Q),354281018,127338536,551620421,1033239975,17605883557.498100,9094528743.884900,34903432291.177196,61603844592.560196,3214141,565800,3287509,7067450
2018-04-30,IEX (V),105161014,16431021,48101044,169693079,4904048710.103700,997873552.377900,2947092510.505501,8849014772.987101,719350,73780,335707,1128837
2018-04-30,NASDAQ PSX (X),15734160,16748367,14153637,46636164,636540372.244600,1328532887.927600,1010563120.331200,2975636380.503400,142631,66431,123661,332723
2018-04-30,BYX Equities (Y),191287361,65531096,80235026,337053483,5929757985.516300,2825063944.775900,3092130665.369500,11846952595.661700,1612151,308678,709280,2630109
2018-04-30,BZX Equities (Z),218482314,99682676,119580545,437745535,9675387002.010297,6566304151.011302,7089180104.145601,23330871257.167200,1912764,443504,1058737,3415005
2018-04-27,NYSE American (A),5694137,8527504,3295958,17517599,235974573.003800,156831940.122600,191775723.505700,584582236.632100,54368,31472,31094,116934
2018-04-27,NASDAQ BX (B),117768810,21634663,63701270,203104743,4918812007.900900,1112568877.856700,3528693848.473101,9560074734.230701,1190670,116294,686647,1993611
2018-04-27,FINRA / NYSE TRF (DN),74756438,23227458,94240500,192224396,2877808546.567400,1048381008.603800,4480217246.382497,8406406801.553697,197480,57953,236551,491984
2018-04-27,FINRA / Nasdaq TRF Carteret (DQ),1018120843,265885885,740376124,2024382852,39984435477.691091,15423472791.129093,43493766842.240000,98901675111.060184,3680867,653018,2390571,6724456
2018-04-27,EDGA Equities (J),39659915,14837307,23822060,78319282,1515857168.514700,941531352.433200,1466210198.016600,3923598718.964500,346064,76438,202083,624585
2018-04-27,EDGX Equities (K),196450551,61474989,168982815,426908355,8223633292.293201,3706526351.178701,10445944247.556099,22376103891.028001,1375871,256042,1081689,2713602
2018-04-27,CHX (M),14246261,9964636,6488746,30699643,900551509.593100,1036171515.770000,545024131.837800,2481747157.200900,2571,3734,2395,8700
2018-04-27,NYSE (N),728703339,7384434,18312042,754399815,30422179730.130499,592654139.405901,941929093.460000,31956762962.996400,2442201,39371,114878,2596450
2018-04-27,NYSE Arca (P),186962914,201881768,132123346,520968028,8325374899.275801,12166028376.248501,9052463143.469501,29543866418.993803,1537766,612607,1031210,3181583
2018-04-27,NASDAQ (Q),340401489,102562010,516974027,959937526,16844073166.720798,7511586935.332398,36933469601.896694,61289129703.949890,3080339,493308,3527643,7101290
2018-04-27,IEX (V),100278997,11390168,53293713,164962878,4567251360.824000,765033695.523000,3955024730.543099,9287309786.890099,682188,55243,364654,1102085
2018-04-27,NASDAQ PSX (X),15295364,13940911,15466910,44703185,628175262.321800,1103429825.777000,1192385929.527700,2923991017.626500,137836,56461,127432,321729
2018-04-27,BYX Equities (Y),182067577,48759905,79580351,310407833,5395819240.872300,2161140812.662400,3431174785.897899,10988134839.432599,1521678,249925,711344,2482947
2018-04-27,BZX Equities (Z),214112041,84022850,133698800,431833691,9432825463.362198,5613141657.880397,9698493331.615998,24744460452.858593,1883448,409824,1206161,3499433
2018-04-26,NYSE American (A),7015082,10569820,3142364,20727266,291216990.559200,204123296.790300,183635649.646200,678975936.995700,61977,37547,29637,129161
2018-04-26,NASDAQ BX (B),129479154,25026044,69179053,223684251,5799837686.628401,1427953892.860400,3907803750.339301,11135595329.828102,1311443,127979,716450,2155872
2018-04-26,FINRA / NYSE TRF (DN),92006711,26472670,95486850,213966231,3860819638.991901,1132925512.529300,3693950172.148301,8687695323.669502,232350,67868,231795,532013
2018-04-26,FINRA / Nasdaq TRF Carteret (DQ),1207832364,339108126,779093973,2326034463,50364317813.168617,19800448471.445702,41004096056.376406,111168862340.990725,4191194,772091,2466122,7429407
2018-04-26,EDGA Equities (J),46304329,18717388,26191295,91213012,1851034448.875400,1266942688.636600,1477665549.645000,4595642687.157000,405007,93498,217185,715690
2018-04-26,EDGX Equities (K),218938904,63835933,172001622,454776459,9579775313.883197,3870261235.665800,10570133002.385799,24020169551.934796,1531730,265108,1094729,2891567
2018-04-26,CHX (M),17537765,13576618,13238631,44353014,938844461.976200,1183706427.309000,1143025108.765300,3265575998.050500,1962,4928,1930,8820
2018-04-26,NYSE (N),832517914,5990416,12157595,850665925,35898883106.929996,544905427.980800,628279415.274900,37072067950.185696,2705308,30209,100754,2836271
2018-04-26,NYSE Arca (P),209359656,234043813,150976250,594379719,9672370172.197099,14123526584.642300,10148053305.204800,33943950062.044199,1739100,656852,1124475,3520427
2018-04-26,NASDAQ (Q),366541100,109235133,531252744,1007028977,18521633917.675101,8001070398.647899,37583152785.208197,64105857101.531197,3212960,533699,3426488,7173147
2018-04-26,IEX (V),112595492,13446219,52744475,178786186,5511291740.319199,907845765.482800,3323158355.989701,9742295861.791700,772727,65636,357153,1195516
2018-04-26,NASDAQ PSX (X),17009954,14439164,16399807,47848925,734088640.820900,1105110476.175800,1213426687.768500,3052625804.765200,149875,59520,129546,338941
2018-04-26,BYX Equities (Y),192172302,59015056,84153150,335340508,6011323959.847600,2706197257.767100,3631449265.915699,12348970483.530399,1624418,285700,736286,2646404
2018-04-26,BZX Equities (Z),241618369,92207142,135204132,469029643,10952222417.983404,6120636304.712499,8441277943.966802,25514136666.662705,2101622,437421,1168066,3707109
2018-04-25,NYSE American (A),6338024,11951069,3371274,21660367,275371091.307400,207331467.894300,180927874.977500,663630434.179200,61662,45482,32348,139492
2018-04-25,NASDAQ BX (B),122068442,25052033,69265376,216385851,5516968318.556700,1514945814.156200,3419112530.392000,10451026663.104900,1255072,133027,718346,2106445
2018-04-25,FINRA / NYSE TRF (DN),83885506,32193267,88543107,204621880,3430976970.709701,1592638514.396099,3554540613.372600,8578156098.478400,210523,78550,217029,506102
2018-04-25,FINRA / Nasdaq TRF Carteret (DQ),1157182967,376794740,729526632,2263504339,47397653241.211313,24708665004.108903,38002471641.161501,110108789886.481717,3921835,932611,2348466,7202912
2018-04-25,EDGA Equities (J),44442432,22180122,23600221,90222775,1729810514.775800,1445460259.796100,1303957094.596000,4479227869.167900,381774,111149,207183,700106
2018-04-25,EDGX Equities (K),211666294,83922209,172932622,468521125,9163015528.850201,5164989706.938599,9456550089.237999,23784555325.026799,1500146,358254,1092300,2950700
2018-04-25,CHX (M),17973090,14367458,9233916,41574464,873107784.896600,1944895270.030000,1031148996.383800,3849152051.310400,2016,7408,3202,12626
2018-04-25,NYSE (N),788023579,6751608,9145974,803921161,33708282434.765999,597076647.892000,449851764.238400,34755210846.896399,2801718,24274,77863,2903855
2018-04-25,NYSE Arca (P),206308467,264354896,146761428,617424791,9523181131.237400,16311473766.425697,8527582434.208600,34362237331.871697,1622797,805995,1075774,3504566
2018-04-25,NASDAQ (Q),371550327,145283351,508180743,1025014421,19082512630.486701,11102642609.487003,32968716241.443194,63153871481.416898,3468016,704547,3587873,7760436
2018-04-25,IEX (V),102903552,15864325,49626205,168394082,4993754206.622500,985712522.497500,3121794112.424200,9101260841.544200,732720,76268,345458,1154446
2018-04-25,NASDAQ PSX (X),17854724,18573218,18153537,54581479,792971846.283500,1518167034.426800,1429444293.262900,3740583173.973200,158046,75799,140828,374673
2018-04-25,BYX Equities (Y),192131056,63190972,86410939,341732967,5924899696.328300,2891703440.313400,3358570677.282199,12175173813.923899,1635055,324351,745520,2704926
2018-04-25,BZX Equities (Z),241358456,119438712,141089099,501886267,11030277535.664103,8147374963.529000,8811539039.232502,27989191538.425605,2133162,583390,1244969,3961521
2018-04-24,NYSE American (A),7664734,12105742,3420143,23190619,332166830.334400,248768031.931400,189585119.818300,770519982.084100,67667,49107,32103,148877
2018-04-24,NASDAQ BX (B),128917939,32307629,71835725,233061293,5879429110.097600,1783037592.772600,3908548296.653201,11571014999.523401,1324064,162547,746671,2233282
2018-04-24,FINRA / NYSE TRF (DN),92037118,34748885,91802044,218588047,3784514451.398200,1820888674.284200,4173861733.135498,9779264858.817898,243729,95349,245931,585009
2018-04-24,FINRA / Nasdaq TRF Carteret (DQ),1141408098,430888976,743406458,2315703532,48626294007.422190,26121474715.060302,42348710527.763484,117096479250.245976,4130252,1090366,2462591,7683209
2018-04-24,EDGA Equities (J),49325789,26561881,26837748,102725418,1991632953.726200,1666762496.935300,1590564724.999100,5248960175.660600,434479,124058,224705,783242
2018-04-24,EDGX Equities (K),220392053,99271802,181360690,501024545,9919685049.973599,6225823046.466998,10718480566.275604,26863988662.716201,1616707,422239,1195421,3234367
2018-04-24,CHX (M),8406221,22227479,7129323,37763023,623997416.684400,2627576538.419001,788783863.715500,4040357818.818901,2333,8242,3116,13691
2018-04-24,NYSE (N),861223231,3584303,3146429,867953963,38077562108.836002,546659853.579400,191218043.336000,38815440005.751402,3033925,23691,28565,3086181
2018-04-24,NYSE Arca (P),210778693,322167538,147081051,680027282,10072434554.127102,20224461146.363504,9214115797.558795,39511011498.049401,1782869,1032314,1132927,3948110
2018-04-24,NASDAQ (Q),403563144,170132111,562275436,1135970691,20944379703.118197,13301226490.702200,38901092817.926825,73146699011.747222,3799025,798418,3925561,8523004
2018-04-24,IEX (V),110673738,20261787,51997842,182933367,5396954747.592300,1454669712.985800,3437865087.274500,10289489547.852600,795637,97469,364262,1257368
2018-04-24,NASDAQ PSX (X),18747923,24796233,20595091,64139247,847816055.063300,2023336107.801800,1700522395.275300,4571674558.140400,161135,100719,154356,416210
2018-04-24,BYX Equities (Y),208351750,75673675,90665558,374690983,6389811391.787802,3417752576.983600,3820396320.233901,13627960289.005303,1729025,393756,790151,2912932
2018-04-24,BZX Equities (Z),254534029,144632410,152724532,551890971,12322332812.385101,10327377410.938300,10055763119.928101,32705473343.251502,2328027,674256,1334095,4336378
2018-04-23,NYSE American (A),4903776,10674000,2451391,18029167,185633199.511700,192569164.678000,128043520.975000,506245885.164700,44566,37861,23585,106012
2018-04-23,NASDAQ BX (B),103332133,25789654,57599511,186721298,4292470313.513400,1198127177.604500,2867852085.261500,8358449576.379400,1038876,123766,614860,1777502
2018-04-23,FINRA / NYSE TRF (DN),74249188,28324111,75777290,178350589,2521901401.018500,1235002302.612800,2954629835.243801,6711533538.875101,197345,72697,204601,474643
2018-04-23,FINRA / Nasdaq TRF Carteret (DQ),980240455,389309564,611207228,1980757247,38910728356.958102,21642790881.785396,31883548399.060208,92437067637.803706,3483415,769777,2086558,6339750
2018-04-23,EDGA Equities (J),38075695,19676835,19775261,77527791,1417069589.610700,1144204304.688800,1097230056.468100,3658503950.767600,330183,91951,175122,597256
2018-04-23,EDGX Equities (K),173466318,64252901,142480914,380200133,7285797315.130201,3473804602.630503,7757993780.601600,18517595698.362304,1245060,255731,934245,2435036
2018-04-23,CHX (M),12052031,16101757,18501721,46655509,605823555.547800,2069633441.640001,939288543.225600,3614745540.413401,1906,4234,2349,8489
2018-04-23,NYSE (N),729655540,1694066,2408119,733757725,31560289339.198196,213245275.423400,101714049.808100,31875248664.429696,2299642,10934,19865,2330441
2018-04-23,NYSE Arca (P),168191933,236284547,113987426,518463906,7504715222.690599,13357502058.848903,6773055727.362304,27635273008.901806,1414402,670970,928789,3014161
2018-04-23,NASDAQ (Q),296594325,113075598,465571695,875241618,14476227996.959798,7868915206.754400,30111939060.668118,52457082264.382316,2720881,517318,3036792,6274991
2018-04-23,IEX (V),81105712,13798693,39378157,134282562,3492921766.753000,794424258.651900,2578248837.061999,6865594862.466899,565468,61868,283001,910337
2018-04-23,NASDAQ PSX (X),13169938,15373063,13719226,42262227,522918180.796300,1041929642.183600,1004360613.729300,2569208436.709200,118078,62332,118585,298995
2018-04-23,BYX Equities (Y),164035088,59795194,70343032,294173314,4792201840.031299,2543351943.391600,2806275304.821500,10141829088.244399,1363742,289645,646516,2299903
2018-04-23,BZX Equities (Z),191326467,88293083,111287117,390906667,8395280788.247001,5488349890.432402,6589771013.028499,20473401691.707902,1707327,421355,1020927,3149609
2018-04-20,NYSE American (A),5743586,12634536,2922323,21300445,235472265.624100,192473238.640600,158833384.054800,586778888.319500,53419,36502,27689,117610
2018-04-20,NASDAQ BX (B),110543822,28202121,61047120,199793063,4732411209.563500,1382074052.600700,2970748484.055300,9085233746.219500,1103232,136991,627656,1867879
2018-04-20,FINRA / NYSE TRF (DN),81553328,26776506,73463056,181792890,2923735289.139800,1190842962.589700,3334737597.269102,7449315848.998602,205291,73949,211796,491036
2018-04-20,FINRA / Nasdaq TRF Carteret (DQ),1038620243,393248469,664020728,2095889440,41269482563.614785,27227140624.894882,37143360795.755907,105639983984.265574,3541722,877738,2185310,6604770
2018-04-20,EDGA Equities (J),44834406,21872757,24710174,91417337,1729110303.920800,1402332404.069800,1380781956.021300,4512224664.011900,381218,107243,205809,694270
2018-04-20,EDGX Equities (K),193258348,73302445,152993939,419554732,8055781791.947201,4459443371.820900,8735524613.389296,21250749777.157397,1341340,296564,1005387,2643291
2018-04-20,CHX (M),16860969,20766522,11192159,48819650,898774880.366000,2316996164.569401,1128228568.753300,4343999613.688701,1840,4789,1684,8313
2018-04-20,NYSE (N),920909830,1190,162980,921074000,41610511027.382999,30776.790000,2260110.655000,41612801914.827999,2474667,14,825,2475506
2018-04-20,NYSE Arca (P),192716619,264720103,129092804,586529526,8599504615.402001,15744617826.075703,7564105854.116703,31908228295.594407,1498011,751761,964608,3214380
2018-04-20,NASDAQ (Q),328727631,132729242,546973720,1008430593,16003057326.379599,9984176331.636496,36075127035.176895,62062360693.192990,2971941,601013,3187573,6760527
2018-04-20,IEX (V),88898267,16397652,46016538,151312457,4192767841.958301,1143120982.289300,2888744411.370700,8224633235.618301,615857,76789,326762,1019408
2018-04-20,NASDAQ PSX (X),15435091,19074858,16454739,50964688,641236680.828400,1435922888.801300,1183435361.191900,3260594930.821600,135013,78498,135237,348748
2018-04-20,BYX Equities (Y),172823955,63386319,77944590,314154864,5273606743.657600,2811700250.687800,3183458454.369501,11268765448.714901,1449433,311931,702715,2464079
2018-04-20,BZX Equities (Z),217341801,106471517,128170798,451984116,9698201356.220002,7295693518.016400,8040971963.608301,25034866837.844703,1883068,494470,1109834,3487372
2018-04-19,NYSE American (A),5859240,12309257,3169472,21337969,244037359.073000,272034112.786600,160775016.704600,676846488.564200,53687,43607,29677,126971
2018-04-19,NASDAQ BX (B),115027503,31200773,65799970,212028246,4987143333.467600,1491236789.740500,3313782505.634900,9792162628.843000,1153642,148201,661239,1963082
2018-04-19,FINRA / NYSE TRF (DN),81755539,29700168,84871184,196326891,3150070591.014400,1316685215.157900,3252699879.905100,7719455686.077400,211402,80075,216083,507560
2018-04-19,FINRA / Nasdaq TRF Carteret (DQ),1087021781,436956019,715713591,2239691391,44298846546.897901,24584122318.316498,36430177749.467791,105313146614.682190,3710288,914012,2264369,6888669
2018-04-19,EDGA Equities (J),44844385,25014135,25362809,95221329,1787334755.317000,1556179571.082499,1359657684.007200,4703172010.406699,386557,118722,209785,715064
2018-04-19,EDGX Equities (K),206112610,84257198,174391936,464761744,8804564307.264699,4758749779.263101,9189761680.973507,22753075767.501307,1431093,335680,1085858,2852631
2018-04-19,CHX (M),10680951,15203185,9563301,35447437,439340344.514400,1538245560.295300,1541840180.818600,3519426085.628300,2037,4478,1960,8475
2018-04-19,NYSE (N),753837060,4528,138139,753979727,32082049338.272297,39029.700000,2498841.560000,32084587209.532297,2610637,14,588,2611239
2018-04-19,NYSE Arca (P),193689411,258357273,134960962,587007646,9093381249.301699,15067808234.757498,7601051057.444202,31762240541.503399,1601656,780954,1013811,3396421
2018-04-19,NASDAQ (Q),342873468,145276682,488061556,976211706,17411369864.882500,10322756362.579797,31332174041.207193,59066300268.669490,3163070,630130,3294632,7087832
2018-04-19,IEX (V),97684019,17981303,47630642,163295964,4774844509.594899,1138584107.558800,3063513588.417799,8976942205.571498,654852,77041,324120,1056013
2018-04-19,NASDAQ PSX (X),14780532,20618077,16639370,52037979,642121656.959200,1518428402.404400,1169296735.928200,3329846795.291800,132537,81979,136876,351392
2018-04-19,BYX Equities (Y),188961673,75573569,82459115,346994357,5721330088.143500,3394111857.286800,3251823364.991000,12367265310.421300,1569692,371105,730035,2670832
2018-04-19,BZX Equities (Z),231992626,116169597,133337208,481499431,10616050741.578402,7669248945.829299,7993415327.988603,26278715015.396304,2039975,528526,1139787,3708288
2018-04-18,NYSE American (A),5693529,13328864,2795559,21817952,235587890.599000,170991468.340300,134518979.957600,541098338.896900,52950,40711,26140,119801
2018-04-18,NASDAQ BX (B),117701925,30324456,62162356,210188737,4931692007.606600,1384369698.964500,2965305327.922101,9281367034.493201,1175307,140742,641325,1957374
2018-04-18,FINRA / NYSE TRF (DN),91327697,34162891,92080693,217571281,3078216165.601600,1241846500.843200,2965913855.854300,7285976522.299100,222156,81684,221890,525730
2018-04-18,FINRA / Nasdaq TRF Carteret (DQ),1153735738,427069999,730027082,2310832819,44730060965.189703,22947367241.497596,34901339061.542303,102578767268.229602,3644640,879480,2158893,6683013
2018-04-18,EDGA Equities (J),44217060,21862386,22571632,88651078,1664843668.647400,1195918523.196001,1205390663.328800,4066152855.172201,370498,100378,189030,659906
2018-04-18,EDGX Equities (K),205009454,76321256,162200893,443531603,8482066993.040596,3853913936.885098,8044553755.962504,20380534685.888198,1368108,289771,959507,2617386
2018-04-18,CHX (M),14963532,20828476,6038976,41830984,674016820.001900,1834354118.184500,617040763.353800,3125411701.540200,1891,3782,2037,7710
2018-04-18,NYSE (N),770221308,2003,119425,770342736,32213202093.823903,15642.130000,2488275.885000,32215706011.838903,2417801,16,722,2418539
2018-04-18,NYSE Arca (P),183533361,255870784,121057138,560461283,8282296283.727498,12444392643.467295,6605039088.968102,27331728016.162895,1447907,661480,912865,3022252
2018-04-18,NASDAQ (Q),326097395,130411532,466322142,922831069,15829477904.215799,7923702005.774601,28601250990.286797,52354430900.277197,2869153,532333,2986221,6387707
2018-04-18,IEX (V),92766652,17124559,41447458,151338669,4434737390.931000,898062376.474200,2462668842.104000,7795468609.509200,623672,74161,291917,989750
2018-04-18,NASDAQ PSX (X),15630573,17550963,15221174,48402710,637559648.757400,1173182178.101600,1016416458.107300,2827158284.966300,135039,75980,126080,337099
2018-04-18,BYX Equities (Y),174170896,68421650,73929010,316521556,5297961023.594200,2716857850.282699,2973521814.530900,10988340688.407799,1458424,329719,668093,2456236
2018-04-18,BZX Equities (Z),216965560,104234227,112732003,433931790,9521107237.115199,5948614702.331500,6544109298.644499,22013831238.091198,1870489,460135,993107,3323731
2018-04-17,NYSE American (A),5673740,11014522,2443506,19131768,211869157.324600,205766849.770900,130935507.125100,548571514.220600,49357,40067,24263,113687
2018-04-17,NASDAQ BX (B),111106959,24977121,64303856,200387936,4723369598.692700,1315478323.196300,3315432219.573899,9354280141.462899,1132696,132896,667912,1933504
2018-04-17,FINRA / NYSE TRF (DN),80270726,29019101,96574087,205863914,3201572458.925300,1250252291.369700,3380266215.417700,7832090965.712700,214854,87004,242041,543899
2018-04-17,FINRA / Nasdaq TRF Carteret (DQ),1195511233,382436967,731170389,2309118589,47879453051.167002,23156435732.111903,38892061771.102998,109927950554.381903,3623584,922669,2289032,6835285
2018-04-17,EDGA Equities (J),39626211,18562433,21896025,80084669,1533175863.134900,1283637046.252000,1320541364.553700,4137354273.940600,347711,97026,182218,626955
2018-04-17,EDGX Equities (K),187164327,69076648,171014458,427255433,8443684767.476900,4214384262.189901,9458508610.401602,22116577640.068403,1346014,287453,1019024,2652491
2018-04-17,CHX (M),7918764,12006309,8798417,28723490,431228435.749700,1286931599.298099,1690192385.752800,3408352420.800599,1990,4435,2069,8494
2018-04-17,NYSE (N),719909780,1081,112076,720022937,31238060826.017004,26663.530000,2486350.790000,31240573840.337004,2327201,18,559,2327778
2018-04-17,NYSE Arca (P),171130847,213716571,125201613,510049031,8244393103.302398,12681818205.176297,7408625905.041002,28334837213.519697,1413080,630619,957707,3001406
2018-04-17,NASDAQ (Q),302288851,111623787,472960682,886873320,15369325955.384699,7733005271.351299,32104789724.883906,55207120951.619904,2780916,502452,3084880,6368248
2018-04-17,IEX (V),85115390,14773537,40999555,140888482,4030586465.353099,995458872.699200,2552410908.493300,7578456246.545599,600278,72196,283859,956333
2018-04-17,NASDAQ PSX (X),14702347,15944364,15049519,45696230,598329824.049900,1224818602.079900,1135151625.538200,2958300051.668000,128616,74144,131135,333895
2018-04-17,BYX Equities (Y),164986553,61064194,73127211,299177958,5037113821.735799,2750614248.381001,3064798397.079701,10852526467.196501,1407770,320154,660149,2388073
2018-04-17,BZX Equities (Z),200787301,89371304,111729519,401888124,9030778527.257303,5885690168.707900,6675640716.435499,21592109412.400702,1751428,415838,973164,3140430
2018-04-16,NYSE American (A),5286241,10600410,2306978,18193629,216745028.179600,193388130.399900,110236180.753200,520369339.332700,50017,36576,22173,108766
2018-04-16,NASDAQ BX (B),108461671,23647085,57437694,189546450,4679383099.755300,1200061894.764200,2683768290.464100,8563213284.983600,1099977,125680,599612,1825269
2018-04-16,FINRA / NYSE TRF (DN),70477880,25963492,95675756,192117128,2555024830.797300,1174627934.904500,2766276836.293901,6495929601.995701,179399,72234,206622,458255
2018-04-16,FINRA / Nasdaq TRF Carteret (DQ),958919762,338234354,661196588,1958350704,38036090545.339401,19725293216.411896,28495783219.214399,86257166980.965696,3337266,798355,2013929,6149550
2018-04-16,EDGA Equities (J),39988811,18597558,20881874,79468243,1560366655.852800,1216741175.950900,1105615855.361100,3882723687.164800,343039,94582,177515,615136
2018-04-16,EDGX Equities (K),170565282,66841664,162137325,399544271,7402595136.918600,4038029887.417300,7062727986.518004,18503353010.853904,1251671,281829,908505,2442005
2018-04-16,CHX (M),8909715,9340126,6754653,25004494,425441409.489500,1122001906.246000,757224288.610200,2304667604.345700,1711,4945,2688,9344
2018-04-16,NYSE (N),748085473,187,66325,748151985,32426492182.895497,6082.890000,1562747.235000,32428061013.020497,2302252,7,373,2302632
2018-04-16,NYSE Arca (P),165557377,213138189,113944004,492639570,7740353327.947803,12783696672.828803,6053967805.830198,26578017806.606804,1396886,620279,878928,2896093
2018-04-16,NASDAQ (Q),291968866,104669314,454356429,850994609,14685574892.998000,7261331407.304003,26332094524.543892,48279000824.845895,2720407,473763,2841108,6035278
2018-04-16,IEX (V),76776487,14552026,36736066,128064579,3668043301.513500,904774111.174400,2060268633.742000,6633086046.429900,533866,70336,256209,860411
2018-04-16,NASDAQ PSX (X),15480186,14738536,13372243,43590965,655725968.887500,1152349021.433500,885496747.917900,2693571738.238900,137284,60967,117522,315773
2018-04-16,BYX Equities (Y),161236732,60447791,70974703,292659226,5040596687.642299,2622595076.220900,2675820097.895300,10339011861.758499,1388922,315113,648375,2352410
2018-04-16,BZX Equities (Z),199027872,86581371,104615883,390225126,8879635818.580101,5608059720.721002,5667194663.508100,20154890202.809203,1764142,414332,941058,3119532
2018-04-13,NYSE American (A),5357701,13130393,2327062,20815156,215964425.374100,180068492.917700,116330756.731200,512363675.023000,50102,43986,23364,117452
2018-04-13,NASDAQ BX (B),106687922,26446079,55683098,188817099,4480120791.372400,1305031457.025500,2566925109.609400,8352077358.007300,1090005,139055,574147,1803207
2018-04-13,FINRA / NYSE TRF (DN),67833125,29965552,82484718,180283395,2745067609.237201,1309967442.935700,2666671348.269001,6721706400.441902,186790,78307,198154,463251
2018-04-13,FINRA / Nasdaq TRF Carteret (DQ),967992786,363177722,642123027,1973293535,38187307806.351900,21312447113.856100,29918543640.901311,89418298561.109311,3290331,802945,1937135,6030411
2018-04-13,EDGA Equities (J),38482990,22063941,20940830,81487761,1486604351.916800,1416928270.405800,1074228666.428100,3977761288.750700,342138,107740,171491,621369
2018-04-13,EDGX Equities (K),165118713,78227189,161442297,404788199,7014401811.124298,4907633716.371997,7469913152.168501,19391948679.664796,1196790,324729,915817,2437336
2018-04-13,CHX (M),8271778,9362926,8205222,25839926,392832869.479600,1240890848.870200,802618668.370400,2436342386.720200,1996,5191,2267,9454
2018-04-13,NYSE (N),718299294,100,212933,718512327,30969211530.006004,3440.000000,2561750.300000,30971776720.306004,2378347,1,879,2379227
2018-04-13,NYSE Arca (P),164440931,250436609,114979330,529856870,7440075172.673102,15375712093.706706,6013903125.735899,28829690392.115707,1360099,753156,860075,2973330
2018-04-13,NASDAQ (Q),292255705,129741646,445299588,867296939,14366804104.199398,9259435448.337801,26833537608.548903,50459777161.086102,2741988,575838,2934153,6251979
2018-04-13,IEX (V),81997415,15219201,38488117,135704733,3900817918.860400,1034243464.901400,2205729778.636500,7140791162.398300,586777,70028,272807,929612
2018-04-13,NASDAQ PSX (X),14916488,17859591,14872064,47648143,588600497.456100,1576464918.317000,1104233836.616400,3269299252.389500,126391,71777,122355,320523
2018-04-13,BYX Equities (Y),161169887,65621711,70356891,297148489,4921728657.529999,2886871610.884400,2778316413.004000,10586916681.418399,1405727,350523,650976,2407226
2018-04-13,BZX Equities (Z),195721197,101109233,110746047,407576477,8589490131.896604,7075970811.380399,6449608702.872897,22115069646.149900,1747200,488817,977100,3213117
2018-04-12,NYSE American (A),5335084,14486343,2658166,22479593,209695827.256500,216447556.212600,127304467.868600,553447851.337700,48191,45403,24726,118320
2018-04-12,NASDAQ BX (B),106961501,24872310,62414597,194248408,4372772647.381000,1196542473.147000,2772220383.426000,8341535503.954000,1082530,126457,634509,1843496
2018-04-12,FINRA / NYSE TRF (DN),65994154,29698494,98166101,193858749,2433061394.822900,1226243895.832200,2988065875.879599,6647371166.534699,180824,74655,213228,468707
2018-04-12,FINRA / Nasdaq TRF Carteret (DQ),989380804,364254133,767080612,2120715549,37696895962.574303,19312724691.490303,32989039035.750603,89998659689.815209,3280837,788959,2163094,6232890
2018-04-12,EDGA Equities (J),36805401,20530861,23257287,80593549,1357777913.507900,1329834036.755200,1194678664.850300,3882290615.113400,318608,99373,191466,609447
2018-04-12,EDGX Equities (K),167434743,76208413,192540281,436183437,7056562039.666102,4601684725.433599,7849954328.585497,19508201093.685198,1194355,293990,980074,2468419
2018-04-12,CHX (M),8938890,16984351,6417163,32340404,369484986.710700,1791506481.507000,562691182.515800,2723682650.733500,1865,4848,2599,9312
2018-04-12,NYSE (N),746256543,539,81134,746338216,31352277279.381304,19512.920000,1621145.645000,31353917937.946304,2244253,6,503,2244762
2018-04-12,NYSE Arca (P),169993647,233223862,140570377,543787886,7773535183.274098,13390844636.832108,6381154061.558598,27545533881.664804,1387072,679048,939424,3005544
2018-04-12,NASDAQ (Q),286245493,114234551,483612800,884092844,13874478393.774001,8064204173.124499,28187201832.423593,50125884399.322093,2662487,507347,2990048,6159882
2018-04-12,IEX (V),89708049,14425532,42233940,146367521,4010786820.514400,975454241.478500,2453974832.219000,7440215894.211900,587210,66968,291715,945893
2018-04-12,NASDAQ PSX (X),14036723,17206336,15406665,46649724,553350821.734000,1406132097.487600,971134743.202700,2930617662.424300,123457,65771,120033,309261
2018-04-12,BYX Equities (Y),165635231,63124360,78250181,307009772,5016752683.987100,2773859171.991200,2996765708.854600,10787377564.832900,1409048,322009,693775,2424832
2018-04-12,BZX Equities (Z),192613323,93363031,114399145,400375499,8334237146.849799,6336339954.473000,6170849515.702300,20841426617.025099,1696559,454214,995753,3146526
2018-04-11,NYSE American (A),5471428,14492215,2643220,22606863,212094361.138100,207888096.355300,134791351.969300,554773809.462700,49185,47882,24265,121332
2018-04-11,NASDAQ BX (B),113899353,30311709,61809865,206020927,4602045854.170600,1382902667.383000,2847585197.920500,8832533719.474100,1154576,148546,644179,1947301
2018-04-11,FINRA / NYSE TRF (DN),63707880,31516831,77230414,172455125,2187879637.903200,1303005055.813600,2700428618.177700,6191313311.894500,171575,79768,193976,445319
2018-04-11,FINRA / Nasdaq TRF Carteret (DQ),951401438,390743256,706052381,2048197075,35263724392.306008,22179315847.456395,34791492697.457681,92234532937.220084,3318579,870026,2077129,6265734
2018-04-11,EDGA Equities (J),38990255,24913130,21269053,85172438,1393870221.046200,1441572456.475800,1097001522.147400,3932444199.669400,329298,116914,172863,619075
2018-04-11,EDGX Equities (K),178411212,85614289,175762386,439787887,7122484914.589100,4891732309.725500,8005848939.482401,20020066163.797001,1256268,345884,975532,2577684
2018-04-11,CHX (M),9336640,18140669,7202223,34679532,539072016.754000,1724345603.933999,769967108.383500,3033384729.071499,2129,5735,3716,11580
2018-04-11,NYSE (N),727474160,105,97224,727571489,29411740609.832706,2080.000000,1255213.325000,29412997903.157706,2369004,2,416,2369422
2018-04-11,NYSE Arca (P),180284363,294184074,135383764,609852201,8258506847.648101,16152507668.106600,6705664070.949103,31116678586.703804,1475473,827382,945607,3248462
2018-04-11,NASDAQ (Q),293246815,137626565,445417648,876291028,13618177203.234497,9084542900.504895,26623797334.075714,49326517437.815106,2740522,607859,3013261,6361642
2018-04-11,IEX (V),84807075,18132084,41058206,143997365,3739529525.469000,1107532684.270900,2618334491.735600,7465396701.475500,570195,81673,284896,936764
2018-04-11,NASDAQ PSX (X),14968977,18631028,15137497,48737502,625936027.504200,1554227506.840300,1127207270.127700,3307370804.472200,138421,76857,128621,343899
2018-04-11,BYX Equities (Y),176775137,74266406,73502123,324543666,4936462413.765500,2976277273.688501,2930091363.856500,10842831051.310501,1467012,373079,676333,2516424
2018-04-11,BZX Equities (Z),215750207,118574832,119532275,453857314,9095054577.806100,7295735013.453301,6728848472.415400,23119638063.674801,1912722,577115,1064176,3554013
2018-04-10,NYSE American (A),7065301,14618913,3291898,24976112,283283590.699600,275766673.615500,164864374.030200,723914638.345300,62349,51253,30789,144391
2018-04-10,NASDAQ BX (B),124901704,33909815,71217800,230029319,5434116544.912100,1731198445.896500,3519314730.467099,10684629721.275699,1259740,168277,730326,2158343
2018-04-10,FINRA / NYSE TRF (DN),78196918,32965231,104000300,215162449,2672847174.968600,1457115370.247200,3602143768.282701,7732106313.498501,195706,84246,225379,505331
2018-04-10,FINRA / Nasdaq TRF Carteret (DQ),1097926075,447585736,803572715,2349084526,40999394367.300807,26103095496.988984,37171853983.448698,104274343847.738489,3694781,990430,2310582,6995793
2018-04-10,EDGA Equities (J),46251684,26637177,27934563,100823424,1802065837.494900,1833990911.936700,1412832980.441700,5048889729.873300,404401,133028,216848,754277
2018-04-10,EDGX Equities (K),203717921,100853015,215398767,519969703,8441273788.204698,6225688367.451099,9626849600.297201,24293811755.952998,1441305,418838,1154442,3014585
2018-04-10,CHX (M),13089341,12379333,5670274,31138948,1298167968.248000,1644524163.847699,463521471.599100,3406213603.694799,2234,6627,3819,12680
2018-04-10,NYSE (N),886231649,433,202987,886435069,37004908237.828007,12872.840000,1667178.255000,37006588288.923007,2789781,5,677,2790463
2018-04-10,NYSE Arca (P),203850448,319835533,144574568,668260549,9279517897.671796,19154235878.620510,7871714630.815802,36305468407.108108,1673045,897186,1074828,3645059
2018-04-10,NASDAQ (Q),366077270,164670769,582918235,1113666274,17907788460.634099,11397367466.005303,35634573229.719902,64939729156.359304,3384997,733439,3614468,7732904
2018-04-10,IEX (V),97121777,20638869,46553600,164314246,4459034151.960400,1353223730.813000,2936657933.311900,8748915816.085300,664951,96401,324934,1086286
2018-04-10,NASDAQ PSX (X),17548179,25434895,18874797,61857871,770719469.824300,2322408763.278600,1454736890.875400,4547865123.978300,157137,101455,153426,412018
2018-04-10,BYX Equities (Y),195135728,79476079,90011371,364623178,5939043091.668000,3660548373.052400,3630691348.617300,13230282813.337700,1646367,411119,782382,2839868
2018-04-10,BZX Equities (Z),242017280,138652069,137802591,518471940,10621698752.607901,9754329714.676799,8112220405.018499,28488248872.303199,2129020,656870,1212907,3998797
2018-04-09,NYSE American (A),5651232,11693315,2936837,20281384,212443566.083600,190184610.561000,134116956.820700,536745133.465300,51681,42599,28480,122760
2018-04-09,NASDAQ BX (B),109624824,29212130,64633929,203470883,4520651310.602300,1454475676.845100,3017094745.449100,8992221732.896500,1130612,144590,664271,1939473
2018-04-09,FINRA / NYSE TRF (DN),65338965,29023225,96293493,190655683,2377858990.250700,1387669364.835999,2916540775.073799,6682069130.160498,174152,81626,206023,461801
2018-04-09,FINRA / Nasdaq TRF Carteret (DQ),970569087,362403387,761228387,2094200861,37940673086.204301,23265068295.995107,33115971668.232004,94321713050.431412,3234103,921687,2128883,6284673
2018-04-09,EDGA Equities (J),40425555,21819274,30928265,93173094,1564453950.777000,1396495034.585200,1284176165.703600,4245125151.065800,354092,110149,199133,663374
2018-04-09,EDGX Equities (K),162837075,76826695,197265945,436929715,6871972689.439299,4817602104.529099,7982047611.700399,19671622405.668797,1220270,326514,1020991,2567775
2018-04-09,CHX (M),6371669,9410695,5823460,21605824,439818563.543400,1258843421.093700,494942151.567300,2193604136.204400,2158,6818,3296,12272
2018-04-09,NYSE (N),799049571,380,196354,799246305,33489085483.394901,12269.600000,1934185.710000,33491031938.704901,2499679,4,889,2500572
2018-04-09,NYSE Arca (P),167110705,280203600,137346288,584660593,7727484612.528100,18466988907.649101,7163518582.534500,33357992102.711701,1433714,806235,980607,3220556
2018-04-09,NASDAQ (Q),294546959,124020103,533147992,951715054,14433859885.896300,9093097240.495001,31773810262.139807,55300767388.531108,2799670,567657,3319671,6686998
2018-04-09,IEX (V),82687149,16348703,42973156,142009008,3709424508.671500,1105160047.904000,2587547444.173202,7402132000.748702,578829,75463,301516,955808
2018-04-09,NASDAQ PSX (X),14034520,18697079,16008203,48739802,606979477.516600,1625920524.145199,1191521330.174300,3424421331.836099,129051,77684,133919,340654
2018-04-09,BYX Equities (Y),168413977,65696209,83153644,317263830,5178799023.816901,2996649411.669800,3120094047.414199,11295542482.900900,1472701,344043,733796,2550540
2018-04-09,BZX Equities (Z),189481356,105546789,117287534,412315679,8169921687.790800,7635594350.509500,6429636464.593800,22235152502.894100,1707091,496843,1018364,3222298
2018-04-06,NYSE American (A),6283896,13017325,4144894,23446115,267206000.462700,258185409.732100,219215025.457600,744606435.652400,62284,49871,38523,150678
2018-04-06,NASDAQ BX (B),117497124,35333416,68762889,221593429,4920094776.654700,1937591723.877500,3181465194.960700,10039151695.492900,1202424,170427,685456,2058307
2018-04-06,FINRA / NYSE TRF (DN),65504375,33998092,117729881,217232348,2546723076.274000,1726543866.887400,3564466915.173000,7837733858.334400,183500,94570,225540,503610
2018-04-06,FINRA / Nasdaq TRF Carteret (DQ),940776872,444250155,844640977,2229668004,36959415434.064502,33408543165.283203,36531423989.732908,106899382589.080613,3418538,1067403,2247547,6733488
2018-04-06,EDGA Equities (J),42703176,29596504,27345989,99645669,1691500652.010600,2163369818.655800,1434131567.021400,5289002037.687800,382049,150596,217566,750211
2018-04-06,EDGX Equities (K),190849113,112330119,218930552,522109784,8246636192.473100,7664402861.171199,9552403121.814701,25463442175.459000,1428172,477035,1167683,3072890
2018-04-06,CHX (M),12411786,20466243,5766976,38645005,1233944227.321601,3857136310.165800,459993953.101900,5551074490.589301,2664,12167,3825,18656
2018-04-06,NYSE (N),879452084,0,0,879452084,36840444060.245201,0.000000,0.000000,36840444060.245201,2869042,0,0,2869042
2018-04-06,NYSE Arca (P),194524270,358665313,152036192,705225775,8898260246.037099,24055040473.135599,8239936043.413202,41193236762.585900,1663728,1106527,1120334,3890589
2018-04-06,NASDAQ (Q),353499828,188816689,619178697,1161495214,17370606712.780499,14369152080.186797,37424853019.974112,69164611812.941408,3394586,857930,3716018,7968534
2018-04-06,IEX (V),86583131,19864869,43964118,150412118,4133605005.515300,1340896667.058500,2855142497.999000,8329644170.572800,639641,94707,317943,1052291
2018-04-06,NASDAQ PSX (X),16852288,31738071,20367502,68957861,765536783.968100,3176175768.687500,1583048150.133400,5524760702.789000,158964,127230,165853,452047
2018-04-06,BYX Equities (Y),180972865,84931498,91067688,356972051,5507866035.165600,3955053352.820099,3436473997.680300,12899393385.665999,1562886,420572,778678,2762136
2018-04-06,BZX Equities (Z),224482293,159740592,145845430,530068315,10285167649.468902,12180906976.576699,8773410306.619799,31239484932.665400,2047780,768195,1239691,4055666
2018-04-05,NYSE American (A),5451180,11617125,3534940,20603245,223516262.868200,190382463.347100,170615836.557300,584514562.772600,53063,45464,31860,130387
2018-04-05,NASDAQ BX (B),109944314,28462740,66091390,204498444,4636727624.717400,1430394630.362400,3280895089.655800,9348017344.735600,1130718,154840,680989,1966547
2018-04-05,FINRA / NYSE TRF (DN),72975562,30255893,99772732,203004187,2649156061.019300,1397919017.524100,3595647489.975000,7642722568.518400,190526,80076,242049,512651
2018-04-05,FINRA / Nasdaq TRF Carteret (DQ),1049936463,403568831,818573809,2272079103,42094177653.882091,23873634587.774498,39028231877.259098,104996044118.915687,3546902,914907,2357811,6819620
2018-04-05,EDGA Equities (J),41151051,21021141,24439954,86612146,1642711759.306800,1379340073.330600,1347723054.617900,4369774887.255300,360635,105657,202307,668599
2018-04-05,EDGX Equities (K),184969908,77125036,191543540,453638484,7838367391.764401,4776447728.859999,9303705147.342999,21918520267.967399,1333188,317004,1095282,2745474
2018-04-05,CHX (M),8135498,13494326,5866701,27496525,414087422.372500,1952663127.793000,860181721.181700,3226932271.347200,2406,8524,3842,14772
2018-04-05,NYSE (N),753642313,0,0,753642313,32190248331.486001,0.000000,0.000000,32190248331.486001,2555644,0,0,2555644
2018-04-05,NYSE Arca (P),182001661,253588885,137135290,572725836,8425061934.996099,15712332827.030308,7776953602.199999,31914348364.226406,1512897,779128,1035342,3327367
2018-04-05,NASDAQ (Q),324963763,129519999,531491310,985975072,16155894477.100701,9279637156.824001,32650347768.442511,58085879402.367213,3026633,604358,3410828,7041819
2018-04-05,IEX (V),90071540,15304835,47537572,152913947,4178660376.859600,917028551.860400,2986636194.451998,8082325123.171998,640071,71951,332964,1044986
2018-04-05,NASDAQ PSX (X),14926342,17763507,17636921,50326770,643445685.309200,1550127944.253700,1316149130.749900,3509722760.312800,138663,74417,143025,356105
2018-04-05,BYX Equities (Y),177292765,65673077,84467108,327432950,5423512925.036901,2948202288.602700,3375523431.521800,11747238645.161401,1533926,349451,751825,2635202
2018-04-05,BZX Equities (Z),214968064,101928300,124946961,441843325,9248749772.655700,7043187716.324699,7598232476.949201,23890169965.929600,1878757,493484,1090953,3463194
2018-04-04,NYSE American (A),6381957,15800077,3879660,26061694,257486386.902600,325452227.740600,194741402.306300,777680016.949500,63307,54071,35754,153132
2018-04-04,NASDAQ BX (B),122279531,33320030,73350726,228950287,5235659317.804900,1758296926.450200,3559186729.640000,10553142973.895100,1253867,170700,750608,2175175
2018-04-04,FINRA / NYSE TRF (DN),70447412,35947369,83344257,189739038,2733459013.625500,1739896600.927300,3758997914.148501,8232353528.701301,194568,89688,235686,519942
2018-04-04,FINRA / Nasdaq TRF Carteret (DQ),989668866,480512097,785968819,2256149782,40259268226.665693,29252233146.376300,43512382326.384218,113023883699.426211,3681813,1039491,2453744,7175048
2018-04-04,EDGA Equities (J),42733519,28577397,25120921,96431837,1675989357.222900,1956230766.466500,1404335415.292400,5036555538.981800,388231,134220,215927,738378
2018-04-04,EDGX Equities (K),193140735,102898152,201446257,497485144,8584235002.589400,6710001789.363503,10326657082.225894,25620893874.178797,1499618,419802,1241609,3161029
2018-04-04,CHX (M),7342382,16237281,13626280,37205943,495524607.917100,2336975938.627900,1281330388.748800,4113830935.293800,2584,12742,5062,20388
2018-04-04,NYSE (N),855397188,0,0,855397188,37506361775.345399,0.000000,0.000000,37506361775.345399,2836211,0,0,2836211
2018-04-04,NYSE Arca (P),197769434,337404750,164183335,699357519,9423547597.247800,21943771330.129697,9057429013.923301,40424747941.300798,1713990,1045727,1203021,3962738
2018-04-04,NASDAQ (Q),355045659,171232699,597807094,1124085452,17928296916.857197,12581648566.952601,39087683479.910302,69597628963.720100,3406345,786488,3870013,8062846
2018-04-04,IEX (V),90513268,19841122,48260905,158615295,4381415471.411600,1450683705.633500,3015194250.044900,8847293427.090000,667731,92076,348304,1108111
2018-04-04,NASDAQ PSX (X),17516510,24815293,22609126,64940929,769282731.020300,2093008631.771799,1890755299.516900,4753046662.308999,165377,95037,176869,437283
2018-04-04,BYX Equities (Y),189412186,79709726,94082521,363204433,5893284228.591599,3812747133.432500,3764346430.185700,13470377792.209799,1662275,442485,859749,2964509
2018-04-04,BZX Equities (Z),231585641,142472570,147906885,521965096,10559046505.630701,10017854660.653500,8966832855.059400,29543734021.343601,2140291,674785,1320776,4135852
2018-04-03,NYSE American (A),6494728,14024892,4138262,24657882,273977605.739000,335624438.484600,193860393.535800,803462437.759400,65514,57303,38346,161163
2018-04-03,NASDAQ BX (B),124167232,33123627,76624469,233915328,5173412634.777800,1834778340.309000,3752543227.085000,10760734202.171800,1289953,179273,769599,2238825
2018-04-03,FINRA / NYSE TRF (DN),65352288,32995883,96325162,194673333,2270722242.611101,1517431865.703500,3792932071.396899,7581086179.711500,182761,87525,238376,508662
2018-04-03,FINRA / Nasdaq TRF Carteret (DQ),956349537,518664807,821792324,2296806668,38659925460.335506,33159860750.072398,42109143513.211200,113928929723.619104,3828436,1150653,2549474,7528563
2018-04-03,EDGA Equities (J),43944721,27338558,27157706,98440985,1708428153.051700,1846377186.960000,1463844500.045100,5018649840.056800,395595,138079,229129,762803
2018-04-03,EDGX Equities (K),191017451,94874080,205011628,490903159,8355153901.909200,6358009244.128999,9783443039.780199,24496606185.818398,1569284,402752,1259873,3231909
2018-04-03,CHX (M),20507050,15043624,13315336,48866010,1976266866.905200,2126470000.551800,1258633407.125700,5361370274.582700,3015,9437,5340,17792
2018-04-03,NYSE (N),899865878,0,0,899865878,40886844121.297301,0.000000,0.000000,40886844121.297301,2994227,0,0,2994227
2018-04-03,NYSE Arca (P),197437202,305212104,152788593,655437899,9456372073.995203,19265801159.206200,9165467707.185995,37887640940.387398,1748164,980726,1198915,3927805
2018-04-03,NASDAQ (Q),362680914,160767030,614729802,1138177746,18283236149.151597,12121239286.407297,37997796593.591894,68402272029.150788,3545354,760648,4028229,8334231
2018-04-03,IEX (V),92655735,19692641,50216631,162565007,4441573337.050500,1345483772.584300,3100223763.932900,8887280873.567700,681541,97574,351246,1130361
2018-04-03,NASDAQ PSX (X),16953981,24373511,22815418,64142910,779370778.031300,2304770168.895600,1898934180.121500,4983075127.048400,164421,100400,172782,437603
2018-04-03,BYX Equities (Y),190987013,81831932,99051607,371870552,5942285092.116299,3857321037.619900,3875020428.177901,13674626557.914100,1686957,434102,878864,2999923
2018-04-03,BZX Equities (Z),227427302,135216582,146937635,509581519,10137823598.079903,9923316379.176799,9276128402.902496,29337268380.159198,2097637,665979,1310322,4073938
2018-04-02,NYSE American (A),7001444,15030083,4313921,26345448,299962341.020400,373043341.976500,260133739.987200,933139422.984100,66875,61907,40129,168911
2018-04-02,NASDAQ BX (B),130039939,40489865,79481327,250011131,5469174429.215100,2398336176.227100,3877061904.270000,11744572509.712200,1327392,215712,801566,2344670
2018-04-02,FINRA / NYSE TRF (DN),80542901,42181559,94853320,217577780,2811775658.351800,2278659780.882100,4375381180.190702,9465816619.424602,217574,124628,277161,619363
2018-04-02,FINRA / Nasdaq TRF Carteret (DQ),1056652983,587014197,809996108,2453663288,39479851004.867199,43421172098.277193,45299994697.691996,128201017800.836388,3961739,1474128,2754976,8190843
2018-04-02,EDGA Equities (J),46517254,33024690,30368345,109910289,1880670267.855800,2387592179.338800,1736601993.012000,6004864440.206600,418271,169972,265930,854173
2018-04-02,EDGX Equities (K),217634250,128543717,209457836,555635803,9543402249.435202,8597590499.945199,11489526858.294392,29630519607.674793,1675258,558470,1414935,3648663
2018-04-02,CHX (M),8329967,14388540,9216449,31934956,468634235.201600,2161677205.643399,897834829.450800,3528146270.295799,2084,12462,5571,20117
2018-04-02,NYSE (N),915397538,0,0,915397538,39573743958.633100,0.000000,0.000000,39573743958.633100,3356966,0,0,3356966
2018-04-02,NYSE Arca (P),211570359,398017473,167225370,776813202,10089810325.158200,26139882456.984105,10182200074.603802,46411892856.746107,1913673,1343948,1385384,4643005
2018-04-02,NASDAQ (Q),391460195,218917058,652710039,1263087292,19371858967.278998,16328767700.708403,43312343217.256499,79012969885.243900,3726107,1036850,4448730,9211687
2018-04-02,IEX (V),93837205,27328165,52270181,173435551,4288200086.174300,1974130231.695699,3495772124.443801,9758102442.313800,694561,129470,382147,1206178
2018-04-02,NASDAQ PSX (X),19086199,33556947,24940305,77583451,913334420.422100,2895779262.394100,2082003166.386500,5891116849.202700,178196,135657,199663,513516
2018-04-02,BYX Equities (Y),206571362,100968045,101676280,409215687,6262406843.481499,4744972650.433699,4170379109.523601,15177758603.438799,1795818,541207,932917,3269942
2018-04-02,BZX Equities (Z),251146129,185331312,166162485,602639926,11503790760.600900,13741131583.393000,10664080142.684201,35909002486.678101,2330812,909501,1508961,4749274
2018-03-29,NYSE American (A),6303122,15047519,3860917,25211558,267515305.073500,294114919.580400,215422769.059000,777052993.712900,63129,49926,36988,150043
2018-03-29,NASDAQ BX (B),129718366,33370015,82594963,245683344,5325639690.313500,1839424991.988900,3949556452.137500,11114621134.439900,1351052,167529,816691,2335272
2018-03-29,FINRA / NYSE TRF (DN),71817929,30662417,94124156,196604502,2726520824.740700,1561036263.844200,4438800966.578301,8726358055.163201,180654,77827,260434,518915
2018-03-29,FINRA / Nasdaq TRF Carteret (DQ),1042448697,429235897,888600283,2360284877,39165886938.113196,29018822990.594997,48156657503.061201,116341367431.769394,3640707,910635,2634141,7185483
2018-03-29,EDGA Equities (J),42622981,24723295,28591392,95937668,1639341447.383700,1813632880.064100,1651347546.819600,5104321874.267400,378001,117320,229478,724799
2018-03-29,EDGX Equities (K),181595903,88335743,216512513,486444159,7441418139.015002,6141045551.298601,10674123398.540602,24256587088.854205,1317697,362440,1206481,2886618
2018-03-29,CHX (M),11242076,14349222,10580896,36172194,691021285.950000,1974313095.664502,1259298977.190600,3924633358.805102,2463,9405,4851,16719
2018-03-29,NYSE (N),997741775,0,0,997741775,43672392047.216498,0.000000,0.000000,43672392047.216498,2788429,0,0,2788429
2018-03-29,NYSE Arca (P),205640002,316889859,168620671,691150532,9604306778.199203,20925446016.405394,10277279619.864505,40807032414.469102,1743451,930131,1261709,3935291
2018-03-29,NASDAQ (Q),349620234,156959549,774055052,1280634835,17079483415.343902,11625880647.855198,49227357120.591191,77932721183.790291,3253133,696975,4008808,7958916
2018-03-29,IEX (V),93599144,21384306,55225175,170208625,4160437593.268100,1479285900.010800,3588173221.828999,9227896715.107899,660903,98808,373591,1133302
2018-03-29,NASDAQ PSX (X),17823420,20325117,22384527,60533064,771356973.859800,1583266130.066700,1804608946.332600,4159232050.259100,157530,80057,175951,413538
2018-03-29,BYX Equities (Y),196466689,84089346,100725642,381281677,5883860439.228001,3981207245.422999,4038533070.373300,13903600755.024300,1701268,415033,869376,2985677
2018-03-29,BZX Equities (Z),225720630,125708567,147522896,498952093,9985035953.324197,9401306662.701599,10255600577.436204,29641943193.462000,1995324,580862,1290012,3866198
2018-03-28,NYSE American (A),7238499,15451646,4666209,27356354,311837116.878500,320361071.661100,279423856.070700,911622044.610300,70931,64505,43092,178528
2018-03-28,NASDAQ BX (B),141397735,41875698,86853721,270127154,5811568298.782599,2180283333.495400,4879442437.224099,12871294069.502098,1413299,215943,877554,2506796
2018-03-28,FINRA / NYSE TRF (DN),85019978,37282480,95272374,217574832,3048235406.093900,1583657284.623700,4772926577.001501,9404819267.719101,206591,89323,285819,581733
2018-03-28,FINRA / Nasdaq TRF Carteret (DQ),1116046768,530579403,841312670,2487938841,42477576715.974103,32673926717.953192,49915088184.226782,125066591618.154077,3783963,1051047,2728413,7563423
2018-03-28,EDGA Equities (J),48313293,32474764,31829316,112617373,1898344496.782500,2214341069.362100,1983311947.066000,6095997513.210600,441007,157302,278320,876629
2018-03-28,EDGX Equities (K),222998120,122908080,222976698,568882898,9072770959.675599,7725507557.582701,12793125631.110797,29591404148.369097,1626122,531118,1474810,3632050
2018-03-28,CHX (M),8301010,26386884,16010270,50698164,423867699.822000,3236385285.847999,1905519098.431900,5565772084.101899,3602,12242,6761,22605
2018-03-28,NYSE (N),928788528,0,0,928788528,38213358103.352002,0.000000,0.000000,38213358103.352002,3439182,0,0,3439182
2018-03-28,NYSE Arca (P),250590038,390434634,204660741,845685413,11229480233.366596,25104653780.306202,12760743481.002202,49094877494.675000,2156048,1278104,1550108,4984260
2018-03-28,NASDAQ (Q),427007630,206349954,663267053,1296624637,19975584914.583802,13981853127.203101,46189124675.611602,80146562717.398505,3959168,983691,4811812,9754671
2018-03-28,IEX (V),113175575,25660403,61991389,200827367,5056748376.291000,1897504130.995699,4268896855.612600,11223149362.899299,785585,120022,427735,1333342
2018-03-28,NASDAQ PSX (X),22402603,28535757,28482264,79420624,1049236588.308400,2061020303.362601,2596282815.814700,5706539707.485701,201370,110373,222157,533900
2018-03-28,BYX Equities (Y),218190905,101080314,106148820,425420039,6495568057.591500,4634773182.355199,4753925798.210800,15884267038.157499,1872372,537596,981879,3391847
2018-03-28,BZX Equities (Z),286252459,192516689,188486244,667255392,12784790512.947699,13138793335.277197,13465525587.188400,39389109435.413296,2521674,930967,1676259,5128900
2018-03-27,NYSE American (A),6325997,15704435,3943386,25973818,282428181.910000,319718650.986500,219347810.072900,821494642.969400,63004,61331,38105,162440
2018-03-27,NASDAQ BX (B),131101863,39647739,80732651,251482253,5403516097.727900,2323914702.414500,4097747984.649300,11825178784.791700,1319318,206471,825369,2351158
2018-03-27,FINRA / NYSE TRF (DN),85147678,36582812,89562554,211293044,3057555839.863500,1846244325.888200,4876462104.650499,9780262270.402199,218524,95161,292200,605885
2018-03-27,FINRA / Nasdaq TRF Carteret (DQ),1114057277,463137189,803086420,2380280886,42764931838.326807,28938214348.898001,49100793464.597398,120803939651.822206,3766757,1010861,2623842,7401460
2018-03-27,EDGA Equities (J),46895092,30524925,28934344,106354361,1842164729.863900,2209537068.675100,1738801031.692600,5790502830.231600,409100,144279,253499,806878
2018-03-27,EDGX Equities (K),216720321,112430996,203459403,532610720,8598247692.330799,7139718279.945699,12010002321.339193,27747968293.615691,1553247,464502,1364268,3382017
2018-03-27,CHX (M),17620846,15958426,8157771,41737043,777625287.866800,2468407622.804300,925434520.822500,4171467431.493600,3119,11516,6723,21358
2018-03-27,NYSE (N),935340971,0,0,935340971,38655748610.283806,0.000000,0.000000,38655748610.283806,3193653,0,0,3193653
2018-03-27,NYSE Arca (P),222980797,386651336,165833375,775465508,9872508738.349004,24024349280.938096,10453066430.414101,44349924449.701201,1764876,1110126,1265821,4140823
2018-03-27,NASDAQ (Q),396596068,193680671,623498128,1213774867,18802718018.139495,13894511734.008703,44282373892.654402,76979603644.802600,3702669,867596,4395749,8966014
2018-03-27,IEX (V),106106351,21248287,50656346,178010984,4580709144.749600,1598929463.794301,3405579495.169901,9585218103.713802,701179,101017,358239,1160435
2018-03-27,NASDAQ PSX (X),19447049,27625298,24861657,71934004,894956152.215500,2172665213.267900,2084576543.182300,5152197908.665700,170331,109394,194511,474236
2018-03-27,BYX Equities (Y),201641491,95066960,98339262,395047713,6076849443.583000,4375565346.120800,4148621791.107800,14601036580.811600,1736382,485380,925889,3147651
2018-03-27,BZX Equities (Z),261347869,160736596,166418363,588502828,11561700557.849000,11450181046.138200,11323778095.885999,34335659699.873199,2340904,745574,1514207,4600685
2018-03-26,NYSE American (A),6290266,14546960,3849504,24686730,273933527.514700,339636229.273800,215866705.649100,829436462.437600,62958,56837,38878,158673
2018-03-26,NASDAQ BX (B),126306810,35968242,79608507,241883559,5209687272.411699,1953647679.157400,4220693620.295400,11384028571.864499,1264287,179239,820199,2263725
2018-03-26,FINRA / NYSE TRF (DN),84915760,39325323,97009726,221250809,3091794988.111300,1762507617.343500,4708011494.114600,9562314099.569400,215076,95288,284858,595222
2018-03-26,FINRA / Nasdaq TRF Carteret (DQ),1069043363,491678719,831386894,2392108976,41801158239.754399,35336714218.371593,47963113999.796769,125100986457.922761,3820365,1095670,2742909,7658944
2018-03-26,EDGA Equities (J),43567898,28652809,26502682,98723389,1706397187.911200,1923241796.683300,1610438199.541000,5240077184.135500,391451,139434,233772,764657
2018-03-26,EDGX Equities (K),203836161,102592401,195636682,502065244,8393401083.196200,6656857996.804599,10956185116.866403,26006444196.867202,1493172,421509,1302658,3217339
2018-03-26,CHX (M),9592754,13119465,12133740,34845959,720702267.725000,1974075636.018101,1554891374.475600,4249669278.218701,3375,8185,6079,17639
2018-03-26,NYSE (N),899390130,0,0,899390130,38179028397.088000,0.000000,0.000000,38179028397.088000,2853346,0,0,2853346
2018-03-26,NYSE Arca (P),194954680,329041186,155626182,679622048,8878731413.894101,20963269184.864406,9437739802.005201,39279740400.763708,1558830,974331,1185332,3718493
2018-03-26,NASDAQ (Q),358452630,167406610,621024215,1146883455,17404413682.516102,12064135680.321803,41543577046.436227,71012126409.274132,3337769,759482,4028017,8125268
2018-03-26,IEX (V),92539215,22486171,51901428,166926814,4147774844.007600,1546096435.631500,3376908906.793199,9070780186.432299,631325,105174,358771,1095270
2018-03-26,NASDAQ PSX (X),17743031,24402750,23485360,65631141,761593139.230000,1834277328.537200,1895040135.207900,4490910602.975100,163676,101945,186368,451989
2018-03-26,BYX Equities (Y),200671656,90779696,96559428,388010780,6118129247.698898,4170009897.164000,4191557164.457099,14479696309.319997,1709512,447166,897010,3053688
2018-03-26,BZX Equities (Z),230782753,135831563,146646098,513260414,10180615865.861001,9454265496.039898,9440068040.923402,29074949402.824301,2010562,646407,1302553,3959522
2018-03-23,NYSE American (A),6798840,16798977,3803603,27401420,286870084.420100,318633007.668400,204560638.564300,810063730.652800,67109,62564,36780,166453
2018-03-23,NASDAQ BX (B),128221990,44574814,77956353,250753157,5316059692.772799,2341745988.886401,3829994886.437299,11487800568.096499,1301777,213660,798429,2313866
2018-03-23,FINRA / NYSE TRF (DN),85086358,45111474,100254172,230452004,3516400973.034500,2095290882.288000,4718411599.496897,10330103454.819397,225639,118018,292027,635684
2018-03-23,FINRA / Nasdaq TRF Carteret (DQ),1094100932,594487151,827163779,2515751862,43718876422.953486,42411671799.254504,44725635224.130326,130856183446.338316,3999734,1336029,2792483,8128246
2018-03-23,EDGA Equities (J),48502374,39331136,31044658,118878168,1875540102.855400,2543901531.639601,1708361790.045200,6127803424.540201,422694,183413,256920,863027
2018-03-23,EDGX Equities (K),235255780,139420523,215661852,590338155,9879859884.249804,8632295247.450003,11536519423.238299,30048674554.938106,1712917,581780,1359738,3654435
2018-03-23,CHX (M),12387628,19232880,9160768,40781276,653646516.612600,2795744562.852999,1139592888.737100,4588983968.202699,3689,12485,5006,21180
2018-03-23,NYSE (N),988601502,0,0,988601502,41444910398.874907,0.000000,0.000000,41444910398.874907,3245941,0,0,3245941
2018-03-23,NYSE Arca (P),226446693,419176297,173849913,819472903,10490397686.300197,25892169964.067599,10403907058.888300,46786474709.256096,1812337,1276372,1307287,4395996
2018-03-23,NASDAQ (Q),402681494,219529950,674172352,1296383796,19593755026.060703,15655510466.299399,43219479263.906800,78468744756.266902,3726995,978457,4229841,8935293
2018-03-23,IEX (V),99274164,25726924,51888776,176889864,4528873721.922900,1707836445.719700,3244743693.524700,9481453861.167300,679759,118055,357268,1155082
2018-03-23,NASDAQ PSX (X),19712890,30121151,24455831,74289872,911894854.001100,2267702628.961000,2066606955.699800,5246204438.661900,177982,120217,184908,483107
2018-03-23,BYX Equities (Y),217056420,110567689,101282401,428906510,6441445257.143600,5008661766.289601,4160779678.635200,15610886702.068401,1844277,543740,919136,3307153
2018-03-23,BZX Equities (Z),265258097,189863693,165068186,620189976,12145709483.944703,13230851374.216201,10939646897.513601,36316207755.674505,2343735,880818,1409025,4633578
2018-03-22,NYSE American (A),6384801,14301442,3908924,24595167,285056222.056500,274367119.389500,206947666.770500,766371008.216500,63682,50858,35155,149695
2018-03-22,NASDAQ BX (B),128341263,41092323,76463416,245897002,5503140109.553200,2229835702.970900,3743470706.206800,11476446518.730900,1316944,206236,771375,2294555
2018-03-22,FINRA / NYSE TRF (DN),86171164,43076550,94595394,223843108,3704720808.392500,2000343643.664500,4472875817.270799,10177940269.327799,220799,112407,263217,596423
2018-03-22,FINRA / Nasdaq TRF Carteret (DQ),1129338749,509763289,827682058,2466784096,46474610230.713694,33141601866.277508,44192064514.596085,123808276611.587287,3961805,1230042,2653365,7845212
2018-03-22,EDGA Equities (J),44809927,35047144,29308808,109165879,1839800827.544600,2387352836.676500,1665538795.390900,5892692459.612000,398659,164299,234447,797405
2018-03-22,EDGX Equities (K),232307837,128882345,214605005,575795187,10304228687.331900,8023936345.542401,11386177712.975804,29714342745.850105,1664015,532327,1306766,3503108
2018-03-22,CHX (M),9540618,17315910,11682750,38539278,639435724.895200,2465840959.624300,1911182091.070200,5016458775.589700,3462,11076,5225,19763
2018-03-22,NYSE (N),949914946,0,0,949914946,41116043205.431197,0.000000,0.000000,41116043205.431197,3055362,0,0,3055362
2018-03-22,NYSE Arca (P),214340482,381666159,161109684,757116325,10193358337.207501,24464954563.788688,9564027704.415798,44222340605.411987,1707399,1164270,1191526,4063195
2018-03-22,NASDAQ (Q),379716564,199711962,621115370,1200543896,18889551492.397701,14246527636.390693,40205513729.181594,73341592857.969988,3485332,866397,3954612,8306341
2018-03-22,IEX (V),104478753,23287125,53536616,181302494,4974291257.568799,1749530604.421000,3475371720.048800,10199193582.038599,719709,111078,365102,1195889
2018-03-22,NASDAQ PSX (X),18555921,27293099,21787237,67636257,878972571.427700,2036361029.504700,1721530626.074301,4636864227.006701,163887,104897,168087,436871
2018-03-22,BYX Equities (Y),215590159,105839012,103470510,424899681,6774871686.337199,4792709019.997601,4272126261.263898,15839706967.598698,1874389,540207,919561,3334157
2018-03-22,BZX Equities (Z),245969812,169863737,151712819,567546368,11549243687.159802,11927842748.899303,9773555175.342800,33250641611.401905,2192179,775524,1303378,4271081
2018-03-21,NYSE American (A),5306067,17030716,3329787,25666570,218685639.904800,196146083.414500,173901945.381500,588733668.700800,54509,49669,30638,134816
2018-03-21,NASDAQ BX (B),115433173,34316857,66623381,216373411,4763676356.686300,1584077412.972800,3521841555.522600,9869595325.181700,1167299,166306,682869,2016474
2018-03-21,FINRA / NYSE TRF (DN),81685059,39439894,87709640,208834593,2962367999.035700,1376883132.112200,4141284025.559901,8480535156.707801,205663,90378,239777,535818
2018-03-21,FINRA / Nasdaq TRF Carteret (DQ),1073746032,436143405,720142409,2230031846,41431901977.250297,21927810851.657298,40369075593.776999,103728788422.684594,3618611,938461,2284767,6841839
2018-03-21,EDGA Equities (J),40929146,26646314,22675427,90250887,1531139230.056300,1596659462.932600,1341925882.498300,4469724575.487200,354111,126740,188110,668961
2018-03-21,EDGX Equities (K),220011277,109919679,181216790,511147746,8700487188.573101,5570539953.490300,9717056285.570095,23988083427.633496,1491822,428350,1085274,3005446
2018-03-21,CHX (M),9552901,14040786,10562996,34156683,589944616.868700,1865510398.972699,1083011569.708600,3538466585.549999,2306,9420,3646,15372
2018-03-21,NYSE (N),795325772,0,0,795325772,32054716093.238304,0.000000,0.000000,32054716093.238304,2684111,0,0,2684111
2018-03-21,NYSE Arca (P),203155218,310463150,129931242,643549610,8997751458.479400,16354300710.210698,8078641694.171103,33430693862.861201,1550320,877661,990136,3418117
2018-03-21,NASDAQ (Q),349593025,164440362,508105767,1022139154,16254715849.600703,10027830813.720304,33829519639.441820,60112066302.762827,3069143,670157,3288662,7027962
2018-03-21,IEX (V),96707269,19485747,43961293,160154309,4173471781.914400,1266717877.791400,2967711153.770900,8407900813.476700,629466,89245,302340,1021051
2018-03-21,NASDAQ PSX (X),16476989,20052277,17195090,53724356,727445737.749300,1292997058.861700,1310867614.260200,3331310410.871200,143999,76267,140784,361050
2018-03-21,BYX Equities (Y),193820236,84401079,81799315,360020630,5637873216.957800,3510229274.972200,3385215839.762501,12533318331.692501,1645250,419881,746248,2811379
2018-03-21,BZX Equities (Z),233044029,134152618,125979469,493176116,9921684704.548200,8163655164.411599,8431582719.328698,26516922588.288497,1963976,599674,1091940,3655590
2018-03-20,NYSE American (A),4803206,18474543,2936340,26214089,209931063.201700,148399748.876900,178878607.709500,537209419.788100,48035,44661,28739,121435
2018-03-20,NASDAQ BX (B),107668552,25053130,65117646,197839328,4678413371.590200,1201578872.035400,3630064579.262900,9510056822.888500,1118451,124818,700777,1944046
2018-03-20,FINRA / NYSE TRF (DN),77340857,44148964,84537337,206027158,2781675515.483300,1218763316.684400,3982559694.441801,7982998526.609501,203203,86709,244495,534407
2018-03-20,FINRA / Nasdaq TRF Carteret (DQ),1076027882,403370936,722587027,2201985845,40637936366.859296,20977852074.313499,38980789837.812185,100596578278.984980,3549325,825322,2392311,6766958
2018-03-20,EDGA Equities (J),38015355,19282831,20920600,78218786,1450554902.153200,1124347878.803300,1186046003.996600,3760948784.953100,332912,87600,182761,603273
2018-03-20,EDGX Equities (K),191719767,76593229,175112178,443425174,7766930881.647301,3484658513.883300,9534100883.966209,20785690279.496810,1312634,278536,1067465,2658635
2018-03-20,CHX (M),10301107,16728646,8959811,35989564,478806154.892800,1871256884.803800,963906795.011700,3313969834.708300,2483,5202,3047,10732
2018-03-20,NYSE (N),819811769,0,0,819811769,34158310707.889900,0.000000,0.000000,34158310707.889900,2441307,0,0,2441307
2018-03-20,NYSE Arca (P),172809201,236907422,125433896,535150519,7826945508.141498,12570933265.647300,8030274844.973599,28428153618.762397,1325702,630593,957261,2913556
2018-03-20,NASDAQ (Q),292863913,106687966,516264219,915816098,14048711386.317500,6288078126.342098,33788059507.044301,54124849019.703899,2572911,430251,3138710,6141872
2018-03-20,IEX (V),91388830,13695020,43424798,148508648,3928227924.263800,838542967.375600,2887524362.993200,7654295254.632600,598353,61389,304035,963777
2018-03-20,NASDAQ PSX (X),13880373,13579996,16055461,43515830,595716607.885400,855854495.457200,1199898525.793400,2651469629.136000,125877,53357,137355,316589
2018-03-20,BYX Equities (Y),175804755,64582188,81552861,321939804,5438304020.114100,2770293885.332200,3539585397.249001,11748183302.695301,1519936,322886,757187,2600009
2018-03-20,BZX Equities (Z),200160353,86632855,113100036,399893244,8598400167.783800,5206692776.066300,7702055586.705696,21507148530.555796,1686428,386188,983548,3056164
2018-03-19,NYSE American (A),5085199,14134363,3089783,22309345,196867393.478900,186980664.352600,176103432.779500,559951490.611000,49407,39383,28186,116976
2018-03-19,NASDAQ BX (B),115074771,34146383,76307956,225529110,4788340067.567800,1714043090.261100,3967551870.154402,10469935027.983302,1198989,169328,781892,2150209
2018-03-19,FINRA / NYSE TRF (DN),70158076,40030908,90474473,200663457,2562041332.312700,1605907112.538100,4260652022.003700,8428600466.854500,197960,101827,270947,570734
2018-03-19,FINRA / Nasdaq TRF Carteret (DQ),1015902174,455692882,838246736,2309841792,40760429338.563211,26537605535.129797,48261412606.483296,115559447480.176304,3608154,1095223,2704354,7407731
2018-03-19,EDGA Equities (J),40354932,28062733,29101155,97518820,1562709852.102000,1888855227.851800,1760882519.255200,5212447599.209000,370558,141511,251910,763979
2018-03-19,EDGX Equities (K),195705496,101480081,215970894,513156471,7959283077.885401,5847890434.579999,11436685778.041995,25243859290.507395,1389779,402270,1284600,3076649
2018-03-19,CHX (M),14353330,14319894,6724488,35397712,851317575.554000,2074930235.459399,904999240.327500,3831247051.340899,2573,9695,4528,16796
2018-03-19,NYSE (N),863476035,0,0,863476035,36990525891.674500,0.000000,0.000000,36990525891.674500,2680620,0,0,2680620
2018-03-19,NYSE Arca (P),188876034,296287463,161182374,646345871,8569148283.537200,17782643855.613010,10146787242.348097,36498579381.498307,1503188,910762,1165378,3579328
2018-03-19,NASDAQ (Q),328703131,152639549,621287802,1102630482,15526007513.152800,10509971898.837100,40902481079.095976,66938460491.085876,3049613,661025,3919783,7630421
2018-03-19,IEX (V),86247505,18683725,50845803,155777033,3870749753.292700,1354233226.862800,3594561119.859001,8819544100.014501,602279,86149,355861,1044289
2018-03-19,NASDAQ PSX (X),16972696,19479141,21619438,58071275,725034917.286300,1406312618.573200,1699410682.750300,3830758218.609800,155889,78961,180146,414996
2018-03-19,BYX Equities (Y),183093311,87713954,97130743,367938008,5614038332.408000,3890185510.812701,4148599403.445599,13652823246.666300,1621743,446963,884351,2953057
2018-03-19,BZX Equities (Z),203460101,131079601,140836842,475376544,8910971889.102601,8562234660.475698,9760737793.649101,27233944343.227400,1817745,581280,1235038,3634063
2018-03-16,NYSE American (A),5584568,49518793,3078141,58181502,221076772.819600,368524423.259500,173434004.908400,763035200.987500,55288,52207,30619,138114
2018-03-16,NASDAQ BX (B),127042303,31039189,75312796,233394288,5323898429.558300,1535091257.141000,3517046672.075102,10376036358.774402,1293185,145632,771277,2210094
2018-03-16,FINRA / NYSE TRF (DN),66560072,28750143,82660654,177970869,2429842446.028800,1029806748.294500,2886324111.105000,6345973305.428300,186852,72228,228230,487310
2018-03-16,FINRA / Nasdaq TRF Carteret (DQ),1475644804,440740487,999119481,2915504772,58304436660.355001,34335958028.493484,51452741449.784720,144093136138.633205,3620445,878368,2388644,6887457
2018-03-16,EDGA Equities (J),41446885,21186791,23867614,86501290,1637534266.465300,1373483565.968200,1181879213.573200,4192897046.006700,368318,100151,194057,662526
2018-03-16,EDGX Equities (K),189573358,71825246,191745129,453143733,7895826030.053397,4129536014.740001,8271581790.769099,20296943835.562497,1340187,286755,1078698,2705640
2018-03-16,CHX (M),10896574,18735664,9011410,38643648,609189069.736000,2266358694.509200,1102462210.975600,3978009975.220800,2877,5718,2460,11055
2018-03-16,NYSE (N),2530327293,0,0,2530327293,107489437000.641110,0.000000,0.000000,107489437000.641110,2488801,0,0,2488801
2018-03-16,NYSE Arca (P),183157241,231282559,131939224,546379024,8464097050.945202,13942588359.390402,6893278154.865098,29299963565.200702,1392599,650408,960438,3003445
2018-03-16,NASDAQ (Q),302726915,119675919,1303853585,1726256419,14426410579.652797,7980413628.376099,73044610616.505406,95451434824.534302,2680589,494892,3234782,6410263
2018-03-16,IEX (V),87817426,18870369,43609972,150297767,3962878442.297400,1124773636.071800,2512448996.852600,7600101075.221800,612078,78751,309994,1000823
2018-03-16,NASDAQ PSX (X),17017270,15339780,17055549,49412599,731935945.385600,1038900123.773900,1162265072.787900,2933101141.947400,151508,63477,152164,367149
2018-03-16,BYX Equities (Y),190486474,78320848,93764095,362571417,5972757832.165200,3468602502.521000,3655100545.287900,13096460879.974100,1661878,379256,833003,2874137
2018-03-16,BZX Equities (Z),200866180,88979298,114955498,404800976,8729697071.270900,5732169810.737899,6855857782.707600,21317724664.716399,1732420,397774,998504,3128698
2018-03-15,NYSE American (A),5265255,14789042,3328719,23383016,205573649.935200,230974910.664900,183542044.063700,620090604.663800,52116,54155,30585,136856
2018-03-15,NASDAQ BX (B),128323340,34551117,70618657,233493114,5391650549.964900,1489200709.800500,3364727461.216700,10245578720.982100,1323074,153529,718908,2195511
2018-03-15,FINRA / NYSE TRF (DN),81602095,35131309,83867636,200601040,2979821531.690000,1270594394.051500,3230698916.424699,7481114842.166199,212095,85868,230799,528762
2018-03-15,FINRA / Nasdaq TRF Carteret (DQ),1181236473,431388231,725876455,2338501159,44378247876.239792,24737490599.261395,32734590183.359684,101850328658.860871,3939681,904388,2379404,7223473
2018-03-15,EDGA Equities (J),42938526,26079892,22974188,91992606,1562549318.182500,1381439393.155800,1110632914.102300,4054621625.440600,380749,113927,194422,689098
2018-03-15,EDGX Equities (K),205208485,80590790,179817139,465616414,8612917872.716703,4138799182.407200,8324148044.129198,21075865099.253101,1466076,314363,1082117,2862556
2018-03-15,CHX (M),11727024,13345787,9763285,34836096,793819035.231300,1488710506.702500,839156379.903500,3121685921.837300,2894,7885,3036,13815
2018-03-15,NYSE (N),813690485,0,0,813690485,33122352396.418500,0.000000,0.000000,33122352396.418500,2557342,0,0,2557342
2018-03-15,NYSE Arca (P),193042142,258755676,130620500,582418318,8769536543.502598,15813697433.512898,7003123938.725501,31586357915.740997,1499791,718946,970072,3188809
2018-03-15,NASDAQ (Q),349951151,127847849,516124779,993923779,16660766802.993695,7748477922.623996,29277434665.657093,53686679391.274784,3153583,519574,3168011,6841168
2018-03-15,IEX (V),100648827,18897509,46697544,166243880,4435274719.673900,1059235843.878900,2853190056.404200,8347700619.957000,677975,77191,323120,1078286
2018-03-15,NASDAQ PSX (X),19050667,17354743,17284175,53689585,766611322.454700,1102848232.165900,1136819980.601500,3006279535.222100,168332,65466,150784,384582
2018-03-15,BYX Equities (Y),189219589,80112867,86569170,355901626,5793266446.861998,3188067927.391800,3376775094.013400,12358109468.267198,1672099,381247,787380,2840726
2018-03-15,BZX Equities (Z),221807728,98762661,114755631,435326020,9519145279.214699,5815104049.699400,6634272808.282699,21968522137.196798,1916470,429124,994526,3340120
2018-03-14,NYSE American (A),5105482,12619932,3217787,20943201,203161297.103000,238367649.218300,169283232.867200,610812179.188500,50245,46034,31696,127975
2018-03-14,NASDAQ BX (B),121244978,28955652,68745605,218946235,5169322390.939101,1598756296.512300,3368540482.681800,10136619170.133201,1243889,145620,714807,2104316
2018-03-14,FINRA / NYSE TRF (DN),84311852,29985069,86468302,200765223,3090624497.613300,1445561425.454500,3526143747.300699,8062329670.368499,204753,77858,237055,519666
2018-03-14,FINRA / Nasdaq TRF Carteret (DQ),1061084302,376692007,756333015,2194109324,41032268760.337906,26126840853.154603,36876765197.504896,104035874810.997405,3669364,822040,2402181,6893585
2018-03-14,EDGA Equities (J),40648395,21170763,24267880,86087038,1538349759.297600,1389367750.071200,1319770253.917700,4247487763.286500,357988,103386,209457,670831
2018-03-14,EDGX Equities (K),202061468,75362820,188988299,466412587,8655732848.275298,4836736820.851898,9023601537.229800,22516071206.356996,1418037,315806,1139683,2873526
2018-03-14,CHX (M),8327628,21272219,11034475,40634322,483704858.214300,2669973015.322400,856261956.264000,4009939829.800700,2830,14797,3907,21534
2018-03-14,NYSE (N),829161241,0,0,829161241,35251249254.914398,0.000000,0.000000,35251249254.914398,2600924,0,0,2600924
2018-03-14,NYSE Arca (P),198949856,243106733,139524917,581581506,9026377192.579999,15794568741.605196,7722348430.508099,32543294364.693294,1545453,770335,1088750,3404538
2018-03-14,NASDAQ (Q),338801616,121079118,552685456,1012566190,16743500606.017903,9031829125.883702,33106613236.681086,58881942968.582691,3142187,543134,3471976,7157297
2018-03-14,IEX (V),92721594,16388940,50777680,159888214,4313405902.331700,1057058514.081600,3075100551.491399,8445564967.904699,649873,72918,349817,1072608
2018-03-14,NASDAQ PSX (X),18092471,17164061,19264450,54520982,817449602.611400,1480410439.887800,1430109350.739300,3727969393.238500,158581,71880,162828,393289
2018-03-14,BYX Equities (Y),182874016,71929198,86620681,341423895,5740382161.913000,3257268180.641101,3535058183.076401,12532708525.630502,1599839,362236,791830,2753905
2018-03-14,BZX Equities (Z),211252319,103235253,125026160,439513732,9571637348.967399,7472662161.651802,7907430583.166103,24951730093.785304,1860901,473728,1110922,3445551
2018-03-13,NYSE American (A),5132645,13169952,3908898,22211495,213193262.556800,255585144.132500,239252216.808100,708030623.497400,52330,44992,40456,137778
2018-03-13,NASDAQ BX (B),125101536,31611607,76914405,233627548,5205085888.036400,1667727885.913500,3784955949.121098,10657769723.070998,1253803,150572,784812,2189187
2018-03-13,FINRA / NYSE TRF (DN),76948057,35065590,109376260,221389907,2852468954.755200,1453303182.657501,4828968407.875200,9134740545.287901,207202,84645,293206,585053
2018-03-13,FINRA / Nasdaq TRF Carteret (DQ),1065491854,385533915,891135216,2342160985,41788199046.811696,25268197750.235901,45388283467.202900,112444680264.250497,3645887,860766,2781586,7288239
2018-03-13,EDGA Equities (J),40822499,25354417,31536774,97713690,1631365498.647200,1701988115.914200,1677679200.769200,5011032815.330600,365586,115694,253739,735019
2018-03-13,EDGX Equities (K),199617587,83945060,226312926,509875573,8691436243.047700,5395941165.532299,11384819253.548199,25472196662.128198,1433606,337393,1314544,3085543
2018-03-13,CHX (M),7529850,17865544,8371184,33766578,384112638.985400,2198737157.493299,625088436.724800,3207938233.203499,2635,9162,3384,15181
2018-03-13,NYSE (N),780893311,0,0,780893311,34072606261.248995,0.000000,0.000000,34072606261.248995,2557312,0,0,2557312
2018-03-13,NYSE Arca (P),187675345,258101086,170635664,616412095,8912538921.867205,17032104468.104994,9569472055.319696,35514115445.291895,1536619,792722,1218678,3548019
2018-03-13,NASDAQ (Q),333030414,128594200,616839000,1078463614,16911182820.978296,9239997751.329799,37076001869.757803,63227182442.065898,3162878,552000,3852497,7567375
2018-03-13,IEX (V),91190953,16791381,57753566,165735900,4206149284.526300,1254060139.046500,3811328889.881899,9271538313.454699,624823,74292,371108,1070223
2018-03-13,NASDAQ PSX (X),18663383,17069359,22612009,58344751,787614042.606500,1266601221.815900,1581412537.622000,3635627802.044400,166268,74159,188320,428747
2018-03-13,BYX Equities (Y),185503730,76160943,95980945,357645618,5960404906.781701,3436819411.378200,3979917804.944901,13377142123.104802,1624040,373157,879291,2876488
2018-03-13,BZX Equities (Z),206696749,105947689,147850823,460495261,9385113573.644901,7584749993.469800,9327944307.948102,26297807875.062803,1843529,483198,1266273,3593000
2018-03-12,NYSE American (A),5275601,13252138,3652695,22180434,218659086.626400,213086347.681000,222034840.845300,653780275.152700,53528,44262,32628,130418
2018-03-12,NASDAQ BX (B),122506444,29132144,75777410,227415998,5278994908.422400,1488919046.860800,3718735588.158600,10486649543.441800,1285215,144976,779313,2209504
2018-03-12,FINRA / NYSE TRF (DN),75416622,29865028,103552742,208834392,2893633540.495200,1150376385.481700,4079139123.728497,8123149049.705397,208109,82688,290120,580917
2018-03-12,FINRA / Nasdaq TRF Carteret (DQ),1018084491,374364443,867252567,2259701501,42154289859.104709,23730019410.806210,43990659994.342186,109874969264.253105,3706864,878449,2674463,7259776
2018-03-12,EDGA Equities (J),39252710,20529467,27182017,86964194,1584767418.319100,1320283806.218000,1487676418.146000,4392727642.683100,360343,100289,227836,688468
2018-03-12,EDGX Equities (K),183904097,68349719,210711534,462965350,8099829182.115202,4084720036.004399,10527796871.730704,22712346089.850305,1319002,281610,1188182,2788794
2018-03-12,CHX (M),8665685,12172824,7554850,28393359,664114610.338500,1829185387.035799,785849834.962500,3279149832.336799,2311,8610,3665,14586
2018-03-12,NYSE (N),798502456,0,0,798502456,35873671206.125709,0.000000,0.000000,35873671206.125709,2438287,0,0,2438287
2018-03-12,NYSE Arca (P),175097560,224356179,156292091,555745830,8353222214.551803,13362058882.766896,8689406306.850003,30404687404.168702,1419730,656967,1106760,3183457
2018-03-12,NASDAQ (Q),309087501,109467458,568029426,986584385,15641968182.115500,7317795751.343100,35164230098.856391,58123994032.314991,2925970,463317,3477167,6866454
2018-03-12,IEX (V),85264175,15355404,54345005,154964584,4009602512.549000,1182085984.602100,3625544437.695899,8817232934.846999,598102,74030,339688,1011820
2018-03-12,NASDAQ PSX (X),17765034,13467549,18354866,49587449,781705251.366700,938747116.260200,1243388955.353100,2963841322.980000,163101,59453,165530,388084
2018-03-12,BYX Equities (Y),181344820,72095181,92763828,346203829,5914344562.080000,3180901577.650400,3834953267.642299,12930199407.372699,1627976,363614,833293,2824883
2018-03-12,BZX Equities (Z),196795767,87829258,129015096,413640121,8838862205.269399,5907243702.988901,7904706078.219499,22650811986.477799,1753048,402008,1106190,3261246
2018-03-09,NYSE American (A),5000950,13452637,4067152,22520739,212225870.218300,222132025.525600,220403162.196100,654761057.940000,50339,42524,34686,127549
2018-03-09,NASDAQ BX (B),121886446,31412417,74689501,227988364,5233479827.344300,1757699974.925300,3490221719.512000,10481401521.781600,1255911,153464,768870,2178245
2018-03-09,FINRA / NYSE TRF (DN),83408001,35664297,104747532,223819830,3246477493.135100,1399604816.283801,3506422934.448900,8152505243.867801,212987,90081,273621,576689
2018-03-09,FINRA / Nasdaq TRF Carteret (DQ),1073259579,431703214,830468331,2335431124,44018879150.658391,30054242468.983015,38861722225.455692,112934843845.097098,3809588,941569,2598317,7349474
2018-03-09,EDGA Equities (J),42169629,23258826,27423493,92851948,1690802993.367600,1709780257.424399,1410644918.278300,4811228169.070299,378227,110319,225300,713846
2018-03-09,EDGX Equities (K),208530981,82255520,211835226,502621727,9364764895.141201,5430021165.883099,10418213011.495298,25212999072.519598,1482882,330007,1218302,3031191
2018-03-09,CHX (M),9602570,9061233,8424506,27088309,484314492.004700,923431147.395000,663823873.472600,2071569512.872300,2154,1835,1245,5234
2018-03-09,NYSE (N),814297536,0,0,814297536,35957505088.876096,0.000000,0.000000,35957505088.876096,2507788,0,0,2507788
2018-03-09,NYSE Arca (P),195071206,259206045,155573275,609850526,9552954734.083601,16505754727.826404,8650580601.474199,34709290063.384204,1542265,764463,1113589,3420317
2018-03-09,NASDAQ (Q),317058716,124792080,594908817,1036759613,16101392000.041403,9454194522.930896,35521632429.887120,61077218952.859419,2905841,525081,3449952,6880874
2018-03-09,IEX (V),91772476,18544255,57231498,167548229,4360438732.952501,1718215003.185301,3374298274.573499,9452952010.711301,641587,86519,365471,1093577
2018-03-09,NASDAQ PSX (X),16968493,15909095,18221954,51099542,760829869.379800,1221141777.891100,1237388033.528900,3219359680.799800,156287,65696,155181,377164
2018-03-09,BYX Equities (Y),186459292,76245884,91036014,353741190,5968403991.383800,3578076179.967099,3693040645.958600,13239520817.309499,1642826,383562,834029,2860417
2018-03-09,BZX Equities (Z),211388474,97960038,131428033,440776545,9679809796.905002,7197668014.120102,8074923336.224604,24952401147.249708,1850531,457784,1116284,3424599
2018-03-08,NYSE American (A),4821806,14668535,3226247,22716588,199501842.438700,225173667.584500,165388975.862700,590064485.885900,48076,44050,31312,123438
2018-03-08,NASDAQ BX (B),109111627,25993208,69300947,204405782,4585257248.274700,1383216957.771300,3107481222.503600,9075955428.549600,1123922,130203,708368,1962493
2018-03-08,FINRA / NYSE TRF (DN),73674393,34815776,106655995,215146164,2950481411.646400,1268782816.339200,3401582158.538001,7620846386.523601,201340,85070,256283,542693
2018-03-08,FINRA / Nasdaq TRF Carteret (DQ),1056178036,354759939,854627139,2265565114,44460924680.026591,18977546884.031597,36564714570.904092,100003186134.962280,3583022,818760,2455278,6857060
2018-03-08,EDGA Equities (J),37176790,19748357,26978072,83903219,1469712497.409500,1233333380.070100,1177328967.958100,3880374845.437700,334637,96381,212890,643908
2018-03-08,EDGX Equities (K),191957502,71817771,218560974,482336247,8282560030.938699,4140307229.529299,8866614900.629899,21289482161.097897,1354983,274648,1149239,2778870
2018-03-08,CHX (M),8386844,10875798,7947284,27209926,352761245.267000,1403428493.890000,851322173.162600,2607511912.319600,2128,8799,3412,14339
2018-03-08,NYSE (N),764897720,0,0,764897720,32936945168.731005,0.000000,0.000000,32936945168.731005,2460917,0,0,2460917
2018-03-08,NYSE Arca (P),180740969,238998039,150545602,570284610,8687466208.609003,14702216439.199700,7394253200.456803,30783935848.265506,1454447,694378,1042893,3191718
2018-03-08,NASDAQ (Q),312839988,113152198,562467846,988460032,15748904972.839001,7316283616.728596,30704492062.490191,53769680652.057788,2926310,476469,3352733,6755512
2018-03-08,IEX (V),86672237,14620801,47319009,148612047,4239943856.929500,1110995042.029400,2691259458.139001,8042198357.097901,613084,67713,326827,1007624
2018-03-08,NASDAQ PSX (X),15688422,14259104,17339167,47286693,702377941.704000,1008090428.821200,1105634045.794300,2816102416.319500,139851,57939,145556,343346
2018-03-08,BYX Equities (Y),164924987,64469155,87762788,317156930,5192129190.878901,2961049035.287402,3263099134.176400,11416277360.342703,1432649,334840,762054,2529543
2018-03-08,BZX Equities (Z),198971724,88961377,125009506,412942607,8967850592.333401,5934908536.665800,6995898474.738099,21898657603.737300,1740995,423745,1048023,3212763
2018-03-07,NYSE American (A),4873226,16519438,3377478,24770142,193870608.074700,226611978.449900,159352249.657800,579834836.182400,48317,50559,31319,130195
2018-03-07,NASDAQ BX (B),116940801,28747148,72738961,218426910,4778350552.237401,1543569738.872800,3305992443.045500,9627912734.155701,1233560,150014,750138,2133712
2018-03-07,FINRA / NYSE TRF (DN),77480637,39476599,82778742,199735978,2968030216.569800,1465272338.313500,3847028072.853298,8280330627.736598,213206,94297,248825,556328
2018-03-07,FINRA / Nasdaq TRF Carteret (DQ),1064313498,402669353,790044105,2257026956,43419079547.667103,22850350754.075288,39954169826.736997,106223600128.479388,3706105,904491,2503019,7113615
2018-03-07,EDGA Equities (J),42048896,24328825,26117355,92495076,1631185536.359500,1612035874.116600,1334245707.411200,4577467117.887300,383332,114543,227831,725706
2018-03-07,EDGX Equities (K),205122442,86254194,195127720,486504356,8536608204.357498,5228626006.417600,9925327578.000307,23690561788.775405,1449694,347450,1202933,3000077
2018-03-07,CHX (M),10052069,10336611,8724275,29112955,420325496.552900,1276554024.810000,694710446.442200,2391589967.805100,2012,7005,2518,11535
2018-03-07,NYSE (N),839678205,0,0,839678205,34925379532.496604,0.000000,0.000000,34925379532.496604,2629235,0,0,2629235
2018-03-07,NYSE Arca (P),199084951,275544932,148520826,623150709,9033451586.733300,15834149190.005698,7963565652.867805,32831166429.606803,1583318,836880,1114870,3535068
2018-03-07,NASDAQ (Q),343818672,136235063,580179036,1060232771,16486148362.779303,9627010182.991798,34457457688.795813,60570616234.566914,3209566,591196,3540251,7341013
2018-03-07,IEX (V),87144631,20011707,49223257,156379595,4095315193.555800,1434114180.664300,2994019328.853400,8523448703.073500,612548,83184,336848,1032580
2018-03-07,NASDAQ PSX (X),17683925,16558107,20083538,54325570,778193097.473400,1196739367.854500,1358617291.956800,3333549757.284700,166181,72327,165636,404144
2018-03-07,BYX Equities (Y),183018423,74558628,87786147,345363198,5619479175.036598,3377267865.097998,3531969881.035200,12528716921.169796,1631198,382390,816417,2830005
2018-03-07,BZX Equities (Z),215436105,106626510,133913363,455975978,9366525295.247700,7234231549.712400,7590037787.323399,24190794632.283499,1901835,521012,1148993,3571840
2018-03-06,NYSE American (A),5717861,15746828,3669761,25134450,239278555.692000,226065266.256500,189794181.466800,655138003.415300,55665,53288,36153,145106
2018-03-06,NASDAQ BX (B),121068937,29498089,72019542,222586568,4998934752.765000,1590431867.943900,3471214003.344900,10060580624.053800,1258760,153101,757746,2169607
2018-03-06,FINRA / NYSE TRF (DN),77875457,36333166,80577808,194786431,3030004868.547800,1439873723.452200,3556218083.182701,8026096675.182701,209941,88408,246977,545326
2018-03-06,FINRA / Nasdaq TRF Carteret (DQ),1026801602,593813333,748156729,2368771664,40962884974.378187,34182278083.148319,40018790970.189929,115163954027.716435,3800725,904519,2529818,7235062
2018-03-06,EDGA Equities (J),45425535,23227912,26160544,94813991,1763620701.862700,1415034998.959500,1429373031.873700,4608028732.695900,404791,107026,241839,753656
2018-03-06,EDGX Equities (K),210233182,83739810,189438490,483411482,8978717211.010100,4829004714.007601,10048084821.458896,23855806746.476597,1510053,332684,1214846,3057583
2018-03-06,CHX (M),11762135,17711774,11689337,41163246,537908935.143400,1702059641.141100,1511772859.653900,3751741435.938400,1951,6680,3452,12083
2018-03-06,NYSE (N),835035420,0,0,835035420,34918474436.469699,0.000000,0.000000,34918474436.469699,2714320,0,0,2714320
2018-03-06,NYSE Arca (P),198561716,273212215,143840525,615614456,9266624259.389701,15863020273.399495,8330285895.381005,33459930428.170201,1630045,820848,1127868,3578761
2018-03-06,NASDAQ (Q),350250118,135494994,575964583,1061709695,17129542799.569799,8691962798.571000,35245426804.890304,61066932403.031103,3363388,578079,3591182,7532649
2018-03-06,IEX (V),87710950,16461767,46434173,150606890,4109329379.308301,1201660371.782000,2774616678.059599,8085606429.149900,607359,77819,328113,1013291
2018-03-06,NASDAQ PSX (X),18461120,17238033,20054804,55753957,818922828.435500,1153137993.473300,1397934253.595200,3369995075.504000,176635,69549,177719,423903
2018-03-06,BYX Equities (Y),180517995,73933478,83448159,337899632,5738712164.572700,3385764116.909800,3584045181.483400,12708521462.965900,1603565,360476,803647,2767688
2018-03-06,BZX Equities (Z),219613073,104030864,131465705,455109642,9570672944.222402,6841447152.210403,7744776213.759598,24156896310.192403,1956187,500676,1168134,3624997
2018-03-05,NYSE American (A),5967662,15179213,3650271,24797146,238738890.135000,296838599.933800,189175290.269700,724752780.338500,58404,47821,36110,142335
2018-03-05,NASDAQ BX (B),124847479,28567069,72471789,225886337,5079573248.145300,1543466206.087900,3428776048.343601,10051815502.576801,1278968,157667,752865,2189500
2018-03-05,FINRA / NYSE TRF (DN),85834146,34633679,77809130,198276955,3293106671.084800,1392781525.270100,3448905791.936602,8134793988.291502,229376,91265,242578,563219
2018-03-05,FINRA / Nasdaq TRF Carteret (DQ),1205156688,407443253,741674500,2354274441,48174632754.986402,25660068477.027594,38344121613.778176,112178822845.792172,4148549,961873,2512519,7622941
2018-03-05,EDGA Equities (J),48735131,25160145,24918019,98813295,1838296717.234700,1748923180.817700,1410819655.660400,4998039553.712800,426682,121677,225511,773870
2018-03-05,EDGX Equities (K),223508426,80195856,180135472,483839754,9373780625.778500,5092241554.070800,9532779452.095200,23998801631.944500,1570267,342084,1180356,3092707
2018-03-05,CHX (M),11091984,13841384,12237280,37170648,487595741.004300,1955447580.789999,1741201806.164000,4184245127.958299,2282,12477,4586,19345
2018-03-05,NYSE (N),892739682,0,0,892739682,37972246994.831801,0.000000,0.000000,37972246994.831801,2799741,0,0,2799741
2018-03-05,NYSE Arca (P),217073179,284382617,142209380,643665176,9935964784.622706,17370730707.041606,8060063390.959196,35366758882.623508,1738599,837655,1141016,3717270
2018-03-05,NASDAQ (Q),372802721,138151512,546582587,1057536820,18131099684.328193,9369447081.912997,33718331345.716507,61218878111.957697,3496407,622335,3579867,7698609
2018-03-05,IEX (V),97387245,17646673,44690483,159724401,4381539627.082700,1472907015.561200,2616403529.957500,8470850172.601400,653689,84098,319922,1057709
2018-03-05,NASDAQ PSX (X),20447664,16663968,18819997,55931629,907182933.169300,1042717561.452800,1290881324.810100,3240781819.432200,188058,75486,177222,440766
2018-03-05,BYX Equities (Y),190770688,80009541,84473712,355253941,5870855668.475200,3837278592.423000,3531691862.147300,13239826123.045500,1651229,395231,813282,2859742
2018-03-05,BZX Equities (Z),237278346,110431673,127199000,474909019,10363004494.112099,8029388763.462901,7650790070.259201,26043183327.834201,2063985,546505,1132275,3742765
2018-03-02,NYSE American (A),6124442,14877351,4099830,25101623,249841350.689800,346504474.132600,237125553.606700,833471378.429100,58284,57817,38070,154171
2018-03-02,NASDAQ BX (B),134207501,35572846,78119669,247900016,5530592698.313100,2084228726.814799,3732142776.518599,11346964201.646498,1346938,193078,788945,2328961
2018-03-02,FINRA / NYSE TRF (DN),90327931,43851839,81297411,215477181,3429850128.185300,1859535240.281800,3938829691.057898,9228215059.524998,238227,108738,238094,585059
2018-03-02,FINRA / Nasdaq TRF Carteret (DQ),1197581626,489552801,779848410,2466982837,45480877672.991996,32912321270.018500,41722332068.410681,120115531011.421177,4363205,1238832,2677910,8279947
2018-03-02,EDGA Equities (J),52826931,39528811,28635031,120990773,2032864849.641800,2461208219.636801,1599515140.833200,6093588210.111801,447384,171309,243154,861847
2018-03-02,EDGX Equities (K),245473714,108105214,203081673,556660601,10431439502.726998,6907885648.441201,10912871392.312501,28252196543.480700,1770800,462801,1303095,3536696
2018-03-02,CHX (M),11697762,14864022,12678441,39240225,649967030.335600,1730410583.037199,1890389300.570900,4270766913.943699,2797,10242,3047,16086
2018-03-02,NYSE (N),920275907,0,0,920275907,38477711427.231900,0.000000,0.000000,38477711427.231900,3169249,0,0,3169249
2018-03-02,NYSE Arca (P),237850910,354343060,166361308,758555278,10796716851.972199,22524820387.928510,9825429116.310797,43146966356.211506,1868954,1110443,1243298,4222695
2018-03-02,NASDAQ (Q),410521737,180466906,609748261,1200736904,19993701703.450898,12994363064.746300,38753643841.928988,71741708610.126186,3854236,819801,4059580,8733617
2018-03-02,IEX (V),101548464,23786375,54090407,179425246,4794162256.950099,2114551647.236900,3373091768.179001,10281805672.366000,688134,111807,372449,1172390
2018-03-02,NASDAQ PSX (X),21226502,23289760,23727277,68243539,992149752.440500,1698882548.235200,1888811531.444200,4579843832.119900,190238,98528,185655,474421
2018-03-02,BYX Equities (Y),201331541,89392563,94036419,384760523,6151284744.802701,4223675988.551200,3890509177.334200,14265469910.688101,1689458,432618,849427,2971503
2018-03-02,BZX Equities (Z),260263366,154043914,155760480,570067760,11596229327.688399,11353058293.673098,9952445491.651103,32901733113.012600,2231069,763779,1305236,4300084
2018-03-01,NYSE American (A),7456593,18197087,4608648,30262328,309007158.438600,404492030.882200,252517513.587800,966016702.908600,73368,74257,45249,192874
2018-03-01,NASDAQ BX (B),156234061,50366170,86544771,293145002,6442306888.936600,3008807371.410300,4276107825.127798,13727222085.474698,1574505,236993,882229,2693727
2018-03-01,FINRA / NYSE TRF (DN),96658962,54698096,88584114,239941172,3585427368.702600,2506623692.118401,4317496479.657701,10409547540.478702,267498,128231,272475,668204
2018-03-01,FINRA / Nasdaq TRF Carteret (DQ),1348861057,604474327,837423825,2790759209,50258185571.390778,39831121919.278394,44965831762.802698,135055139253.471870,4707843,1274301,2849808,8831952
2018-03-01,EDGA Equities (J),64539835,46772565,32808397,144120797,2426123589.871700,3284581337.672600,1854851842.244001,7565556769.788301,565118,214114,286296,1065528
2018-03-01,EDGX Equities (K),288510818,147891404,218862786,655265008,12028082817.579901,9645304965.849297,12026994985.229900,33700382768.659098,2069277,607037,1490746,4167060
2018-03-01,CHX (M),13430028,16957291,22333045,52720364,707252039.168000,2538855245.778000,1857515589.442400,5103622874.388400,3853,13025,4123,21001
2018-03-01,NYSE (N),1035538420,0,0,1035538420,43207218688.524008,0.000000,0.000000,43207218688.524008,3932645,0,0,3932645
2018-03-01,NYSE Arca (P),292037598,475241631,185672927,952952156,13407599614.641103,29387216864.071291,11040714320.215501,53835530798.927895,2379486,1480724,1448174,5308384
2018-03-01,NASDAQ (Q),508651426,248604563,656954476,1414210465,24578244339.055400,17792029022.294910,42216179838.158219,84586453199.508529,4936032,1089388,4850155,10875575
2018-03-01,IEX (V),125777373,30794022,56380928,212952323,5766691546.752200,2609092848.111402,3677357864.728600,12053142259.592202,834272,133071,399650,1366993
2018-03-01,NASDAQ PSX (X),26510460,37082041,29068365,92660866,1295359217.728200,2846549408.329300,2399064649.149400,6540973275.206900,239425,139877,224180,603482
2018-03-01,BYX Equities (Y),232456462,119705079,103920161,456081702,6876381443.646600,5879661727.182400,4393632537.146998,17149675707.975998,1936620,553308,950552,3440480
2018-03-01,BZX Equities (Z),317829621,224644476,175849384,718323481,14351263371.775102,16082695523.736703,11375992809.485400,41809951704.997205,2855707,1042921,1587329,5485957
2018-02-28,NYSE American (A),6078799,30490946,3985956,40555701,245179207.173000,293500492.080300,204481223.196200,743160922.449500,59621,63487,36689,159797
2018-02-28,NASDAQ BX (B),138100822,36910221,80152802,255163845,5449335274.292299,2136823472.436900,3555564532.287200,11141723279.016399,1394260,178007,797266,2369533
2018-02-28,FINRA / NYSE TRF (DN),100911105,50344923,93700237,244956265,3854785098.353400,1692246525.595000,3382476371.377700,8929507995.326100,257562,106054,247388,611004
2018-02-28,FINRA / Nasdaq TRF Carteret (DQ),1378702484,501671664,870908269,2751282417,55106194946.899393,29039514901.452303,41293156779.126694,125438866627.478390,4336955,959673,2601591,7898219
2018-02-28,EDGA Equities (J),50694919,35955258,26632161,113282338,1825617114.138000,2138178474.713400,1327061646.929400,5290857235.780800,434447,149582,224810,808839
2018-02-28,EDGX Equities (K),241422601,98652905,200005918,540081424,9979496967.177897,5812335938.290098,9360769816.540800,25152602722.008795,1687612,367812,1231650,3287074
2018-02-28,CHX (M),15138747,12875146,8511709,36525602,775273020.496600,1774742013.785000,572728133.790800,3122743168.072400,5170,7419,2881,15470
2018-02-28,NYSE (N),1102453487,0,0,1102453487,47259811225.773699,0.000000,0.000000,47259811225.773699,3093818,0,0,3093818
2018-02-28,NYSE Arca (P),233243298,345079370,154377149,732699817,10530521548.061000,21856701096.031621,8257732186.129595,40644954830.222216,1842118,932912,1172348,3947378
2018-02-28,NASDAQ (Q),409401592,167778941,645352244,1222532777,19191266263.358998,11258625457.267500,38310362095.782296,68760253816.408794,3751544,663105,3790365,8205014
2018-02-28,IEX (V),104328538,21651223,54003498,179983259,4735925377.113801,1391209553.535400,3305238491.343200,9432373421.992401,687616,89149,358672,1135437
2018-02-28,NASDAQ PSX (X),20402463,21796572,21010761,63209796,920660967.990900,1708654582.358600,1507046410.618600,4136361960.968100,183296,84355,180328,447979
2018-02-28,BYX Equities (Y),199598885,83821523,90903946,374324354,5947338517.064900,4019655331.579801,3595712680.285600,13562706528.930301,1703870,392487,825690,2922047
2018-02-28,BZX Equities (Z),244097480,133558386,135399479,513055345,10477127253.965300,9467934957.369500,7965421366.392200,27910483577.727000,2122167,600428,1191556,3914151
2018-02-27,NYSE American (A),6101615,17622666,3706777,27431058,236210011.630500,400205365.181600,198709819.590000,835125196.402100,59555,52631,35579,147765
2018-02-27,NASDAQ BX (B),131237524,38088467,72911170,242237161,5467573930.873600,2116850614.012900,3516723399.213600,11101147944.100100,1350830,204500,752420,2307750
2018-02-27,FINRA / NYSE TRF (DN),95686555,46529282,82694711,224910548,3562172093.257200,1741027525.531500,3311619782.333000,8614819401.121700,254682,109714,240338,604734
2018-02-27,FINRA / Nasdaq TRF Carteret (DQ),1145841177,517665481,760815752,2424322410,44594783612.895114,27662813789.235906,36554047656.687703,108811645058.818723,4054935,1100474,2421824,7577233
2018-02-27,EDGA Equities (J),49426569,32480202,27866932,109773703,1840046514.522300,2140592061.206900,1593362770.206000,5574001345.935200,433611,159715,240692,834018
2018-02-27,EDGX Equities (K),239617297,101148741,191299523,532065561,10345391862.635404,6031026930.838601,10295340236.124198,26671759029.598203,1674597,399833,1227584,3302014
2018-02-27,CHX (M),22516042,15441474,5649908,43607424,1494974895.392500,2029640340.226801,503859234.200800,4028474469.820101,2228,5987,2068,10283
2018-02-27,NYSE (N),895116303,0,0,895116303,38162408477.084099,0.000000,0.000000,38162408477.084099,2977668,0,0,2977668
2018-02-27,NYSE Arca (P),229719872,343141611,149803836,722665319,10519460470.499199,20207648269.031999,8753049269.811899,39480158009.343097,1824629,1018987,1150332,3993948
2018-02-27,NASDAQ (Q),383670533,161777457,573626512,1119074502,18539330267.170600,11048622634.680100,34630411986.050820,64218364887.901520,3625881,714947,3736846,8077674
2018-02-27,IEX (V),99109181,21219098,49142709,169470988,4489903169.898600,1419521415.525700,2763088959.878901,8672513545.303201,669208,95559,329619,1094386
2018-02-27,NASDAQ PSX (X),19281651,22753254,20709861,62744766,831198814.579900,1642547559.005600,1564795054.319800,4038541427.905300,170559,91926,178969,441454
2018-02-27,BYX Equities (Y),190015042,82226554,86345396,358586992,5847697024.650000,3875246925.200400,3652305304.392200,13375249254.242600,1627522,414641,809873,2852036
2018-02-27,BZX Equities (Z),244734430,138922713,137679514,521336657,10995924702.871801,9470212047.408800,8518382502.258798,28984519252.539399,2138884,621163,1223106,3983153
2018-02-26,NYSE American (A),5639623,11915961,3152295,20707879,232511142.290600,196790979.654200,199820081.626400,629122203.571200,54513,38508,29266,122287
2018-02-26,NASDAQ BX (B),122369214,31167534,68617019,222153767,4964446020.740600,1673289845.670100,3230520512.214301,9868256378.625001,1271412,153504,712295,2137211
2018-02-26,FINRA / NYSE TRF (DN),91749818,35241984,74682662,201674464,3399311477.044400,1509574357.783300,3282358138.515400,8191243973.343100,253917,91401,238173,583491
2018-02-26,FINRA / Nasdaq TRF Carteret (DQ),1137203582,374973664,673705123,2185882369,44897474363.081013,24912733698.714811,35753377163.550206,105563585225.346030,3901885,865162,2289482,7056529
2018-02-26,EDGA Equities (J),43374476,20592496,22608513,86575485,1616856414.726000,1355312524.870800,1258720869.054100,4230889808.650900,368434,99499,194579,662512
2018-02-26,EDGX Equities (K),206862460,67857554,164326193,439046207,8662955110.592202,4300641073.450500,8948343924.941502,21911940108.984204,1382124,281336,1018100,2681560
2018-02-26,CHX (M),10357285,9061848,13693027,33112160,516419881.579600,1195030274.610000,1016365255.594600,2727815411.784200,2180,4268,1826,8274
2018-02-26,NYSE (N),813091260,0,0,813091260,35247916913.693304,0.000000,0.000000,35247916913.693304,2462795,0,0,2462795
2018-02-26,NYSE Arca (P),196281376,239550239,127454527,563286142,8956058490.668401,14914202560.258999,7470725250.805701,31340986301.733101,1491354,705483,950532,3147369
2018-02-26,NASDAQ (Q),331043079,112087712,486032938,929163729,15969517639.549802,8067710480.195402,31105711293.432498,55142939413.177702,3037200,509392,3123810,6670402
2018-02-26,IEX (V),93102427,15218764,46282705,154603896,4121938837.971800,1045088222.219600,2742319659.744000,7909346719.935400,610177,73321,296280,979778
2018-02-26,NASDAQ PSX (X),17212494,14917749,17043561,49173804,748932462.040000,1008554360.849200,1211563742.319000,2969050565.208200,154115,63396,146283,363794
2018-02-26,BYX Equities (Y),166189417,59908561,72777967,298875945,5183457818.060700,2835902831.271900,3132586771.860199,11151947421.192799,1411846,289622,675259,2376727
2018-02-26,BZX Equities (Z),202119057,85506736,106184930,393810723,8793795192.611699,6160098056.352600,6266605858.118900,21220499107.083199,1719717,408768,916284,3044769
2018-02-23,NYSE American (A),4876015,12847697,2945951,20669663,182243268.477800,240299625.085400,164325650.972100,586868544.535300,47274,44151,28512,119937
2018-02-23,NASDAQ BX (B),113181495,28241170,66642944,208065609,4340151957.012900,1633315406.278200,3125232646.535700,9098700009.826800,1175140,158374,703058,2036572
2018-02-23,FINRA / NYSE TRF (DN),82137986,29371724,74087629,185597339,2779531941.081100,1196515595.343900,3106687855.711100,7082735392.136100,227019,80711,224238,531968
2018-02-23,FINRA / Nasdaq TRF Carteret (DQ),1066318748,392036453,682949601,2141304802,38486259675.527407,25713593714.031593,34731511228.854795,98931364618.413795,3691559,796086,2275283,6762928
2018-02-23,EDGA Equities (J),39575230,22657749,23310778,85543757,1408300311.522500,1594828051.838200,1289754566.708300,4292882930.069000,338566,104315,198231,641112
2018-02-23,EDGX Equities (K),192737471,71238757,166240982,430217210,7761475022.310302,4524096306.392201,9157588863.777905,21443160192.480408,1307995,295912,1048882,2652789
2018-02-23,CHX (M),9426703,12731729,8309045,30467477,465801715.022200,1159218977.960000,842927846.049500,2467948539.031700,2107,3318,1788,7213
2018-02-23,NYSE (N),726137076,0,0,726137076,29641423131.097101,0.000000,0.000000,29641423131.097101,2381979,0,0,2381979
2018-02-23,NYSE Arca (P),186764672,242214209,131523514,560502395,8210168773.112503,15738626459.271488,7613088650.317599,31561883882.701590,1428040,725705,972754,3126499
2018-02-23,NASDAQ (Q),319748067,117555696,484137867,921441630,14800887422.467502,8652219463.381403,30464085871.880094,53917192757.728999,2842119,537590,3164389,6544098
2018-02-23,IEX (V),86634935,15745155,45353645,147733735,3705577721.990500,1148434815.574200,2463184968.697201,7317197506.261901,570421,74230,291302,935953
2018-02-23,NASDAQ PSX (X),15416744,15973257,17409547,48799548,653869322.178000,1148617693.722000,1221306111.484100,3023793127.384100,136204,68916,144446,349566
2018-02-23,BYX Equities (Y),158758735,58568483,74595597,291922815,4706947773.886400,2799461062.980600,3112327954.195100,10618736791.062100,1332470,284227,673744,2290441
2018-02-23,BZX Equities (Z),198655174,90606038,110042761,399303973,8036011382.502201,6516727034.300101,6694010683.573597,21246749100.375899,1667130,442890,936818,3046838
2018-02-22,NYSE American (A),5523526,11474991,3328446,20326963,209701795.027600,223258912.285700,195294456.604700,628255163.918000,53785,43302,32444,129531
2018-02-22,NASDAQ BX (B),125057383,31832074,65924923,222814380,4852432530.261700,1758908390.660900,3150830694.235700,9762171615.158300,1284597,169233,700594,2154424
2018-02-22,FINRA / NYSE TRF (DN),94439800,37417877,75822013,207679690,3041890249.976100,1444321959.727700,3041118141.175501,7527330350.879301,233282,84785,216897,534964
2018-02-22,FINRA / Nasdaq TRF Carteret (DQ),1261951766,385375350,701106090,2348433206,45005143258.313100,24747646711.083910,34294580515.124098,104047370484.521108,3991943,856134,2276916,7124993
2018-02-22,EDGA Equities (J),45408677,26484429,22182808,94075914,1579016271.208200,1733056330.950200,1225318994.222600,4537391596.381000,386794,124633,194782,706209
2018-02-22,EDGX Equities (K),228034926,82888435,168599493,479522854,8770788912.134701,5236600116.233698,8899955549.131697,22907344577.500096,1561330,362340,1136363,3060033
2018-02-22,CHX (M),11909305,9979460,9689189,31577954,771538724.561800,837607580.518400,1022912351.165400,2632058656.245600,2262,4883,2484,9629
2018-02-22,NYSE (N),835170394,0,0,835170394,34041402978.377397,0.000000,0.000000,34041402978.377397,2881326,0,0,2881326
2018-02-22,NYSE Arca (P),212766235,292385360,128547703,633699298,9425557769.673000,20798549945.380597,7162260879.993901,37386368595.047498,1657479,884962,994358,3536799
2018-02-22,NASDAQ (Q),375681007,144221058,502961604,1022863669,17261888936.116205,10184539548.126800,30298999012.918998,57745427497.162003,3456138,663317,3477883,7597338
2018-02-22,IEX (V),95681713,16862593,44905866,157450172,4059090385.323600,1175861962.374100,2523808180.394301,7758760528.092001,643980,76782,306090,1026852
2018-02-22,NASDAQ PSX (X),18572007,19710989,18219175,56502171,796230679.181000,1307304605.840700,1337836408.341699,3441371693.363399,159331,87595,159696,406622
2018-02-22,BYX Equities (Y),182760102,66260874,74322550,323343526,5275570707.604100,3112164179.529400,3180104751.659698,11567839638.793198,1513097,330166,708415,2551678
2018-02-22,BZX Equities (Z),227665260,112304067,111971779,451941106,9474289053.538603,7818060072.680702,6674735268.394201,23967084394.613506,1948311,563767,997892,3509970
2018-02-21,NYSE American (A),6113270,12470512,3151215,21734997,241008072.811400,257397341.698100,187222692.015500,685628106.525000,58040,46991,31260,136291
2018-02-21,NASDAQ BX (B),129148389,35629710,68853150,233631249,5239674284.353100,1914085226.275100,3459757686.864099,10613517197.492299,1313997,188465,733623,2236085
2018-02-21,FINRA / NYSE TRF (DN),96006545,35525558,73310005,204842108,3659950330.951200,1565428074.072900,3500022176.074600,8725400581.098700,249016,95598,230461,575075
2018-02-21,FINRA / Nasdaq TRF Carteret (DQ),1217102438,436054898,693355652,2346512988,48010268092.440302,26741816929.210912,37411858071.466003,112163943093.117217,4079722,975377,2339023,7394122
2018-02-21,EDGA Equities (J),49090982,27967375,24153890,101212247,1827181256.576100,1899508759.985400,1389788413.214500,5116478429.776000,418240,145233,211543,775016
2018-02-21,EDGX Equities (K),232725411,89871775,174883677,497480863,9694634421.610999,5663501521.655100,9923650151.843001,25281786095.109100,1595889,385007,1172152,3153048
2018-02-21,CHX (M),8832674,13878789,7761894,30473357,755515879.844600,1332807957.300000,814601671.914500,2902925509.059100,2647,5047,2049,9743
2018-02-21,NYSE (N),889696164,0,0,889696164,37283729292.398704,0.000000,0.000000,37283729292.398704,2991207,0,0,2991207
2018-02-21,NYSE Arca (P),224797441,310687207,135846914,671331562,10413948428.104299,19631431521.239601,8178818777.565294,38224198726.909194,1764906,978254,1063631,3806791
2018-02-21,NASDAQ (Q),399575968,156934667,515215607,1071726242,19233032181.014699,11146191894.865596,33476311082.577696,63855535158.457991,3678182,728796,3563875,7970853
2018-02-21,IEX (V),94053205,17119765,43882931,155055901,4209037734.941400,1221268446.021500,2681308317.631200,8111614498.594100,631158,84283,308026,1023467
2018-02-21,NASDAQ PSX (X),20734236,21898925,19936778,62569939,964747041.658000,1557087492.974400,1470719067.374000,3992553602.006400,178786,92992,171826,443604
2018-02-21,BYX Equities (Y),183839586,70013788,76400459,330253833,5445330732.680200,3322893855.801300,3299954100.999599,12068178689.481099,1514695,353752,721585,2590032
2018-02-21,BZX Equities (Z),237327420,125088422,119369549,481785391,10057145168.230498,8906264512.958200,7441550134.542900,26404959815.731598,2026510,631863,1053742,3712115
2018-02-20,NYSE American (A),5859937,13480761,3103124,22443822,217962898.901500,201998614.171400,174202546.751000,594164059.823900,55094,45577,31497,132168
2018-02-20,NASDAQ BX (B),130272965,34570810,70068837,234912612,5087089072.570800,1787691905.721200,3497774072.596400,10372555050.888400,1318517,184703,741310,2244530
2018-02-20,FINRA / NYSE TRF (DN),93456880,37140042,67480253,198077175,3304179902.226700,1470084715.054400,3324004381.590600,8098268998.871700,261657,101059,230037,592753
2018-02-20,FINRA / Nasdaq TRF Carteret (DQ),1154406484,482151892,671456889,2308015265,45495612102.805595,29550060855.822596,37587971469.930098,112633644428.558289,3980077,983491,2314859,7278427
2018-02-20,EDGA Equities (J),50191945,25930957,24372258,100495160,1897188232.322700,1778043383.059700,1471731824.848000,5146963440.230400,415914,129030,214791,759735
2018-02-20,EDGX Equities (K),221314622,88832503,164888596,475035721,9353887828.916101,5484735963.870898,9644245938.327800,24482869731.114799,1527591,372954,1107955,3008500
2018-02-20,CHX (M),10666877,17427895,9283645,37378417,529352187.511900,1730401511.189999,677782681.003000,2937536379.704899,2365,5293,1784,9442
2018-02-20,NYSE (N),852909912,0,0,852909912,35798091591.699509,0.000000,0.000000,35798091591.699509,2793360,0,0,2793360
2018-02-20,NYSE Arca (P),230528448,321158646,133071026,684758120,10589872263.106498,19390477903.825699,8086339798.762401,38066689965.694598,1780878,908857,1064390,3754125
2018-02-20,NASDAQ (Q),377147611,151066088,527099715,1055313414,18010368389.152102,10409889771.297595,33747617986.433601,62167876146.883298,3448704,683838,3512754,7645296
2018-02-20,IEX (V),89453473,21040362,44208708,154702543,4016677655.291700,1279369743.982400,3034665376.173400,8330712775.447500,599603,93025,315173,1007801
2018-02-20,NASDAQ PSX (X),20403809,19423196,17642069,57469074,831431807.526400,1401263210.467999,1254706238.025700,3487401256.020099,167212,81908,161791,410911
2018-02-20,BYX Equities (Y),182678890,72074965,74492215,329246070,5511413231.170600,3362323773.998200,3334932916.130500,12208669921.299300,1527630,358506,710841,2596977
2018-02-20,BZX Equities (Z),227631924,113918296,114705311,456255531,9667428525.056299,7768235704.728600,7045043587.047002,24480707816.831901,1943420,560401,1025312,3529133
2018-02-16,NYSE American (A),5772574,14617889,3456553,23847016,226176620.805000,231061155.143900,165524918.261100,622762694.210000,53395,46730,33889,134014
2018-02-16,NASDAQ BX (B),128834076,34826316,70743773,234404165,5116904707.552400,2018332444.865200,3253316728.496801,10388553880.914401,1288155,188683,724522,2201360
2018-02-16,FINRA / NYSE TRF (DN),83408688,44014286,78014538,205437512,3180483196.061900,1734367886.727800,3419708246.423700,8334559329.213400,240468,105586,241082,587136
2018-02-16,FINRA / Nasdaq TRF Carteret (DQ),1121139588,506120983,719739608,2347000179,43325042879.033797,42255427063.766809,38091562942.939106,123672032885.739712,3954167,1089456,2387289,7430912
2018-02-16,EDGA Equities (J),45046206,27446654,24766625,97259485,1700148981.947700,2077584261.338099,1402627665.679000,5180360908.964799,389170,136374,215598,741142
2018-02-16,EDGX Equities (K),211951721,97780955,168807611,478540287,9114976116.525801,6548156084.986801,9006240101.686699,24669372303.199301,1504106,415706,1082742,3002554
2018-02-16,CHX (M),10034960,24340385,11833544,46208889,558394460.882200,2566585757.908000,1275662598.745000,4400642817.535200,2885,6014,3048,11947
2018-02-16,NYSE (N),945644145,0,0,945644145,42049815171.791200,0.000000,0.000000,42049815171.791200,2833380,0,0,2833380
2018-02-16,NYSE Arca (P),218792557,309452416,139502263,667747236,10231130378.006600,19781034968.686293,8072497483.393399,38084662830.086292,1724949,961718,1059348,3746015
2018-02-16,NASDAQ (Q),362984975,164536135,558045521,1085566631,17546170734.171201,11974964160.668903,35305574432.192796,64826709327.032900,3321541,760266,3468019,7549826
2018-02-16,IEX (V),90605665,19562728,43636722,153805115,4087035736.665900,1378946495.155600,2567047548.788900,8033029780.610400,603415,96288,303653,1003356
2018-02-16,NASDAQ PSX (X),19180043,23006553,20504149,62690745,888991613.845000,1723977370.294600,1626212694.880799,4239181679.020399,160449,94373,162602,417424
2018-02-16,BYX Equities (Y),174974270,72876980,78677139,326528389,5325118168.424000,3634316432.811600,3341214985.523700,12300649586.759300,1458747,371879,726935,2557561
2018-02-16,BZX Equities (Z),228559906,131545837,119982010,480087753,9848929732.940400,9434170747.950000,7309071530.585299,26592172011.475699,1947642,634931,1043676,3626249
2018-02-15,NYSE American (A),6237754,13696864,3612219,23546837,238396080.308800,242995901.748700,190228627.955800,671620610.013300,58716,46670,35850,141236
2018-02-15,NASDAQ BX (B),132193250,35957825,73104762,241255837,5436795671.841100,1912044265.316901,3681430345.607400,11030270282.765401,1372293,191184,764662,2328139
2018-02-15,FINRA / NYSE TRF (DN),98173939,41529130,90679932,230383001,3823264630.925000,1747763976.802100,4147658607.890901,9718687215.618001,253504,103467,256594,613565
2018-02-15,FINRA / Nasdaq TRF Carteret (DQ),1225494353,450012017,782337124,2457843494,48648823310.646905,29133630999.403207,40901663305.790694,118684117615.840806,4300192,1034147,2627930,7962269
2018-02-15,EDGA Equities (J),46236906,29563176,25159288,100959370,1750226705.352200,1974016320.005900,1515529444.749300,5239772470.107400,404423,144643,227510,776576
2018-02-15,EDGX Equities (K),216063922,96661865,176440853,489166640,9366296213.938100,6161356135.979003,10032712691.959398,25560365041.876501,1551252,401887,1146328,3099467
2018-02-15,CHX (M),12650173,21267657,8890975,42808805,657030283.300000,2478108540.085600,843513305.810200,3978652129.195800,2545,7169,3198,12912
2018-02-15,NYSE (N),825350148,0,0,825350148,34345501362.367002,0.000000,0.000000,34345501362.367002,2860163,0,0,2860163
2018-02-15,NYSE Arca (P),220242890,315577507,142016456,677836853,10341328146.835602,20076778594.866195,8653337816.029601,39071444557.731398,1764789,949932,1118853,3833574
2018-02-15,NASDAQ (Q),378240542,161806799,550844166,1090891507,18315369911.139798,11405593872.944103,35721978412.432697,65442942196.516598,3525313,713933,3696326,7935572
2018-02-15,IEX (V),97210033,21539018,50440795,169189846,4410113641.171000,1535187742.550900,3214960198.804701,9160261582.526601,651837,95444,336368,1083649
2018-02-15,NASDAQ PSX (X),19043790,21925107,20740763,61709660,833028969.158900,1467614029.127300,1561616017.104500,3862259015.390700,162202,90557,169169,421928
2018-02-15,BYX Equities (Y),184537439,72366225,78789170,335692834,5707985397.872500,3527101839.179500,3540057431.846300,12775144668.898300,1579413,368379,743618,2691410
2018-02-15,BZX Equities (Z),234468584,123992089,121008191,479468864,9682034621.527499,8312686440.056503,7512782561.624702,25507503623.208704,1975755,578837,1051790,3606382
2018-02-14,NYSE American (A),6491368,15243556,3964244,25699168,260890255.340000,331286670.018600,217097320.130600,809274245.489200,62930,55704,38017,156651
2018-02-14,NASDAQ BX (B),149404201,43659886,77760358,270824445,5911004235.838600,2361339505.021201,3746833434.148901,12019177175.008702,1499890,232052,809304,2541246
2018-02-14,FINRA / NYSE TRF (DN),99270225,44863058,84268105,228401388,3817913156.509801,1721339825.092100,3897874298.133201,9437127279.735102,246664,112456,245268,604388
2018-02-14,FINRA / Nasdaq TRF Carteret (DQ),1250016149,520962018,769496731,2540474898,47848081606.819198,29322814451.179286,39101684621.037108,116272580679.035592,4477449,1166311,2703032,8346792
2018-02-14,EDGA Equities (J),51330156,37103201,26170655,114604012,1887483269.183200,2572088541.607800,1513298037.905800,5972869848.696800,445115,179025,234694,858834
2018-02-14,EDGX Equities (K),237699069,123755060,186990142,548444271,9826976773.053902,8026451740.988902,10452151677.255298,28305580191.298102,1649349,501653,1221636,3372638
2018-02-14,CHX (M),10469175,20924265,9904788,41298228,624522881.806200,1822447486.940799,1217929855.710000,3664900224.456999,2965,11492,3857,18314
2018-02-14,NYSE (N),930234772,0,0,930234772,38496883402.648803,0.000000,0.000000,38496883402.648803,3098862,0,0,3098862
2018-02-14,NYSE Arca (P),244007708,410077887,162774375,816859970,11049689860.284197,24993184251.096293,9483494043.118396,45526368154.498886,1891099,1193246,1261229,4345574
2018-02-14,NASDAQ (Q),430476983,207811051,601346743,1239634777,20461568717.127398,14453057404.530295,37890307570.469679,72804933692.127372,3848358,909752,4002489,8760599
2018-02-14,IEX (V),115114209,27034750,53306127,195455086,5218606341.559800,1919172545.643900,3135590164.062800,10273369051.266500,755877,116960,360596,1233433
2018-02-14,NASDAQ PSX (X),20907541,27024363,22148124,70080028,958407525.257900,1705495430.804100,1655071032.690999,4318973988.752999,173620,106658,183340,463618
2018-02-14,BYX Equities (Y),202365108,88023183,87121164,377509455,6258338199.497301,4189037365.399700,3750721508.047200,14198097072.944201,1703551,436991,810561,2951103
2018-02-14,BZX Equities (Z),264160018,165899080,132386982,562446080,10718952029.705902,10869768733.951996,8012960601.170703,29601681364.828601,2180737,791104,1153075,4124916
2018-02-13,NYSE American (A),4997700,11473344,3243291,19714335,192191861.700000,277744959.848900,159284272.646800,629221094.195700,48035,41931,31333,121299
2018-02-13,NASDAQ BX (B),125456309,30069516,70594963,226120788,4978597760.018700,1537116906.245700,3257270773.803601,9772985440.068001,1291596,169757,739808,2201161
2018-02-13,FINRA / NYSE TRF (DN),86946271,35186299,71866673,193999243,3099131014.426801,1542212655.268900,3080585248.419502,7721928918.115203,220576,83886,206505,510967
2018-02-13,FINRA / Nasdaq TRF Carteret (DQ),1129611732,402986751,644023689,2176622172,43122659512.237501,25808301699.297104,31890010811.063605,100820972022.598210,3995055,916006,2281754,7192815
2018-02-13,EDGA Equities (J),45151947,23624682,22288986,91065615,1647171510.836300,1606824095.969000,1232867047.951500,4486862654.756800,396224,122486,196401,715111
2018-02-13,EDGX Equities (K),204070533,80038230,147099075,431207838,8404528242.575198,4879466208.918199,7515693149.663901,20799687601.157298,1452362,343920,984162,2780444
2018-02-13,CHX (M),11032160,14887196,10095454,36014810,470619410.250000,1412289464.033900,1204492088.158000,3087400962.441900,2530,6599,2206,11335
2018-02-13,NYSE (N),806972854,0,0,806972854,33194521732.363301,0.000000,0.000000,33194521732.363301,2602380,0,0,2602380
2018-02-13,NYSE Arca (P),216822550,248342776,129879610,595044936,9859089857.152599,15135088427.137004,6877747894.217701,31871926178.507304,1689330,871797,1002435,3563562
2018-02-13,NASDAQ (Q),355992477,134817467,478359280,969169224,16593550037.308200,9443859483.407901,28593007775.500698,54630417296.216799,3197623,637838,3185911,7021372
2018-02-13,IEX (V),95087781,18346283,45408805,158842869,4368141375.372200,1339274482.819100,2666229105.092000,8373644963.283300,648903,88445,318441,1055789
2018-02-13,NASDAQ PSX (X),17905609,17844763,17052080,52802452,774629318.944600,1092205848.550500,1208068789.721400,3074903957.216500,151023,74013,146147,371183
2018-02-13,BYX Equities (Y),176514237,62896819,79395182,318806238,5502142165.061900,3008039964.650400,3230536338.297498,11740718468.009798,1515813,338763,735804,2590380
2018-02-13,BZX Equities (Z),226983398,111838341,111013513,449835252,9325986601.193502,7570903730.674301,6070963670.127499,22967854001.995302,1910431,582560,962133,3455124
2018-02-12,NYSE American (A),7416900,22147369,4337042,33901311,308884443.435000,584622134.361300,240411006.845100,1133917584.641400,72302,64649,42533,179484
2018-02-12,NASDAQ BX (B),146592711,48737689,78297732,273628132,5942886996.094000,2603186399.570800,3803368696.849500,12349442092.514300,1482212,263721,814936,2560869
2018-02-12,FINRA / NYSE TRF (DN),90673308,44457819,83608670,218739797,3446736225.693101,1873832742.342500,3891793526.168499,9212362494.204100,239745,117262,245093,602100
2018-02-12,FINRA / Nasdaq TRF Carteret (DQ),1199807151,581987228,772323599,2554117978,48671221486.231501,38721309541.848716,40673647580.424875,128066178608.505092,4267022,1282892,2581381,8131295
2018-02-12,EDGA Equities (J),49423250,36128509,24734294,110286053,1860897760.404600,2270028573.990201,1440719452.619700,5571645787.014501,430594,176812,213343,820749
2018-02-12,EDGX Equities (K),234560661,125745207,178262735,538568603,9748668233.220200,7668567776.548498,9899536052.358501,27316772062.127199,1727162,543883,1211837,3482882
2018-02-12,CHX (M),6493438,21821284,16847894,45162616,399678924.480800,2859426363.650000,2671629114.366000,5930734402.496800,3520,14504,3772,21796
2018-02-12,NYSE (N),1027557871,0,0,1027557871,45235340236.706900,0.000000,0.000000,45235340236.706900,3253629,0,0,3253629
2018-02-12,NYSE Arca (P),263161789,450585934,159501768,873249491,12151274649.791900,27801018724.637996,9477037841.818300,49429331216.248196,2078726,1373964,1257738,4710428
2018-02-12,NASDAQ (Q),448023441,219211479,637482307,1304717227,21387669670.024700,15330728253.042097,41116001821.422711,77834399744.489508,4175681,1001416,4156010,9333107
2018-02-12,IEX (V),102637568,29885077,50552197,183074842,4942530134.393301,2242694865.004900,3193809356.423700,10379034355.821901,743914,161695,368213,1273822
2018-02-12,NASDAQ PSX (X),24062345,28696803,22933615,75692763,1138861718.645000,1784231454.655300,1842913494.541800,4766006667.842100,199017,116836,182950,498803
2018-02-12,BYX Equities (Y),205584188,100954372,89041195,395579755,6355496480.227300,4632366746.317101,3790582123.034498,14778445349.578899,1758003,507634,826714,3092351
2018-02-12,BZX Equities (Z),263234301,175335540,132731474,571301315,10921431689.311997,11848892506.565504,8053219241.022902,30823543436.900403,2294653,866818,1166696,4328167
2018-02-09,NYSE American (A),10027678,21087472,6149806,37264956,407391062.032100,546707945.017000,371677208.567000,1325776215.616100,93822,77792,56497,228111
2018-02-09,NASDAQ BX (B),193488208,66512187,106730729,366731124,7243435270.732901,3697383303.441800,5274771512.238201,16215590086.412902,1850433,360742,1047343,3258518
2018-02-09,FINRA / NYSE TRF (DN),138600526,70422229,110152805,319175560,5218672405.462600,3296135963.198300,6151173264.481002,14665981633.141902,346307,185280,352155,883742
2018-02-09,FINRA / Nasdaq TRF Carteret (DQ),1579548332,888783253,1011705805,3480037390,60732575159.816169,61103280941.153302,60863047301.652796,182698903402.622267,5960986,2126577,3696875,11784438
2018-02-09,EDGA Equities (J),76247816,62816365,39982246,179046427,2817173241.210300,4017466392.091599,2420050234.250300,9254689867.552199,650768,306600,346016,1303384
2018-02-09,EDGX Equities (K),345513165,236978873,257746559,840238597,13993888713.164099,14752016008.678296,14528146262.219302,43274050984.061697,2448261,1001848,1754694,5204803
2018-02-09,CHX (M),14499793,53150096,13034701,80684590,879558646.172200,6434770294.838500,2201818738.303801,9516147679.314501,4617,32599,5666,42882
2018-02-09,NYSE (N),1313433492,0,0,1313433492,53133397167.133988,0.000000,0.000000,53133397167.133988,4732643,0,0,4732643
2018-02-09,NYSE Arca (P),393912453,731013431,248805237,1373731121,17769673557.854800,46391405575.324609,15784823793.140396,79945902926.319805,3043726,2340700,1934576,7319002
2018-02-09,NASDAQ (Q),691437522,393642402,887647029,1972726953,32110299370.492896,27407222876.085893,59411608997.730342,118929131244.309131,6286336,1741979,6313304,14341619
2018-02-09,IEX (V),157599145,56191891,72563771,286354807,7033266724.146999,4758504082.798300,4921687108.126600,16713457915.071899,1095856,253913,525026,1874795
2018-02-09,NASDAQ PSX (X),40767897,65764325,39950110,146482332,2141314769.184700,3998614838.939000,3175956213.083600,9315885821.207300,303841,225522,275162,804525
2018-02-09,BYX Equities (Y),300752991,151420334,132518869,584692194,8701495965.447199,7067885393.380699,5653722512.564901,21423103871.392799,2411386,739433,1171615,4322434
2018-02-09,BZX Equities (Z),434284402,365546723,238343693,1038174818,18264778440.262398,25844197194.812002,15077599001.054897,59186574636.129297,3662697,1817519,2003296,7483512
2018-02-08,NYSE American (A),9416414,17290626,5798734,32505774,410258506.672900,514178909.209100,340529683.565200,1264967099.447200,90427,77593,54983,223003
2018-02-08,NASDAQ BX (B),189579270,61955280,97184861,348719411,7458359627.652298,3433418613.686601,5001240178.214301,15893018419.553200,1820684,336353,976862,3133899
2018-02-08,FINRA / NYSE TRF (DN),128969985,55892538,91550770,276413293,4917100571.385700,2940325307.893000,4664413095.379799,12521838974.658499,322732,154189,289673,766594
2018-02-08,FINRA / Nasdaq TRF Carteret (DQ),1594042152,749306258,894100210,3237448620,62630648276.872793,55218609101.782589,50716952785.579900,168566210164.235282,5414690,1739874,3130863,10285427
2018-02-08,EDGA Equities (J),68812642,46951683,33775870,149540195,2615156603.721200,3061077477.458200,2054953699.525400,7731187780.704800,583598,231285,288909,1103792
2018-02-08,EDGX Equities (K),321360545,182106402,228765993,732232940,13664891283.124899,11794642267.142799,13224038378.622899,38683571928.890597,2283370,822756,1602948,4709074
2018-02-08,CHX (M),15645848,30409467,10435714,56491029,869380704.542000,3776241211.299002,1378156996.679900,6023778912.520902,4962,17402,2530,24894
2018-02-08,NYSE (N),1229253926,0,0,1229253926,50663762461.087406,0.000000,0.000000,50663762461.087406,4218519,0,0,4218519
2018-02-08,NYSE Arca (P),363033876,608825133,213872568,1185731577,16347032290.890299,38729827438.740003,13124334415.420602,68201194145.050904,2719223,1895366,1659036,6273625
2018-02-08,NASDAQ (Q),613870775,321231489,759474136,1694576400,28244257464.012699,23380740275.468203,50238193609.773972,101863191349.254874,5395060,1487700,5383597,12266357
2018-02-08,IEX (V),141765161,40585562,65347818,247698541,6317157747.427200,3398350689.819199,4209200636.809102,13924709074.055501,957415,191672,461266,1610353
2018-02-08,NASDAQ PSX (X),35028063,52677953,32955810,120661826,1803819275.571000,3460264251.218400,2633999983.121500,7898083509.910900,276587,192091,250717,719395
2018-02-08,BYX Equities (Y),274280249,129636337,114760954,518677540,8433168432.638799,6335316570.172600,5127122806.575999,19895607809.387398,2250153,655438,1053894,3959485
2018-02-08,BZX Equities (Z),348787331,260571573,182723931,792082835,14203228271.138999,18968034032.767191,11358843212.313601,44530105516.219791,2949570,1348694,1563211,5861475
2018-02-07,NYSE American (A),7202972,22110167,4236958,33550097,330462118.405800,455341963.041800,237882651.874900,1023686733.322500,70836,68683,40797,180316
2018-02-07,NASDAQ BX (B),165158310,53711520,84026668,302896498,6888317920.320001,2957517974.598999,4395794691.438300,14241630586.357300,1623543,284331,853590,2761464
2018-02-07,FINRA / NYSE TRF (DN),116662671,50692057,90944503,258299231,4224476458.750900,2251814936.082700,4487053450.692399,10963344845.525999,290663,134146,263602,688411
2018-02-07,FINRA / Nasdaq TRF Carteret (DQ),1405807542,656643509,809190920,2871641971,53564824748.697415,41778975662.030389,47301538502.528697,142645338913.256501,4821638,1477431,2828069,9127138
2018-02-07,EDGA Equities (J),61279897,43437135,29489268,134206300,2329623026.024100,2761538441.307300,1801377659.822900,6892539127.154300,511964,203480,251246,966690
2018-02-07,EDGX Equities (K),277934438,155373331,194053254,627361023,12203942135.594203,10094424352.256900,11678978572.361500,33977345060.212603,2002978,673836,1359371,4036185
2018-02-07,CHX (M),11356029,25565850,10460369,47382248,521002943.435700,2427715667.090000,1274783451.263000,4223502061.788700,3562,8507,2239,14308
2018-02-07,NYSE (N),1137860567,0,0,1137860567,46706847031.811599,0.000000,0.000000,46706847031.811599,3753293,0,0,3753293
2018-02-07,NYSE Arca (P),301108653,520115990,181817754,1003042397,13895428667.908002,31279882043.095611,11272018242.569897,56447328953.573510,2286274,1600993,1393183,5280450
2018-02-07,NASDAQ (Q),487638351,274156129,645046195,1406840675,22617338051.405496,19991140675.977100,42508775875.380603,85117254602.763199,4273795,1185823,4389181,9848799
2018-02-07,IEX (V),126704604,36086020,56491981,219282605,5729547805.276800,2805485069.458400,3743577807.429400,12278610682.164600,835382,167119,400368,1402869
2018-02-07,NASDAQ PSX (X),26134741,42097330,27637771,95869842,1321742941.370800,2807229025.448000,2293366850.978300,6422338817.797100,203131,152079,197557,552767
2018-02-07,BYX Equities (Y),237669127,110512941,99913581,448095649,7704213667.936501,5432840656.536699,4519992197.453501,17657046521.926701,1977578,548625,907573,3433776
2018-02-07,BZX Equities (Z),283786445,221527247,146714170,652027862,11765940673.428799,16090488355.729102,9437741790.130200,37294170819.288101,2442366,1081510,1282355,4806231
2018-02-06,NYSE American (A),9339909,24489741,5907024,39736674,439987270.503000,782510642.801400,356976011.511200,1579473924.815600,89555,86953,56952,233460
2018-02-06,NASDAQ BX (B),212819945,75664573,112439438,400923956,9026715646.338996,4969786751.597199,5911102389.623600,19907604787.559795,2100292,427876,1122028,3650196
2018-02-06,FINRA / NYSE TRF (DN),136379958,69713568,114742252,320835778,5985947991.372901,3400977705.869501,6092788400.672498,15479714097.914900,361218,199656,355822,916696
2018-02-06,FINRA / Nasdaq TRF Carteret (DQ),1653381400,880898974,1001319831,3535600205,70745792508.445092,69337818650.480602,56664340252.328798,196747951411.254492,6244883,2263001,3696257,12204141
2018-02-06,EDGA Equities (J),78774781,62189305,38054506,179018592,3021928081.319900,4500656577.128999,2384630485.799900,9907215144.248799,670131,339696,331743,1341570
2018-02-06,EDGX Equities (K),348827889,247762125,256729218,853319232,15751194826.226502,17363932885.285403,15742156801.294403,48857284512.806308,2674897,1169481,1887383,5731761
2018-02-06,CHX (M),13792442,28873962,9939974,52606378,864515607.447900,4273276870.436999,1273291935.221400,6411084413.106299,4098,4574,2440,11112
2018-02-06,NYSE (N),1447329640,0,0,1447329640,62865929414.166495,0.000000,0.000000,62865929414.166495,5336928,0,0,5336928
2018-02-06,NYSE Arca (P),411914690,850392544,248996155,1511303389,19826859936.505705,61027228336.805103,15169489847.543705,96023578120.854513,3159383,2841319,1961378,7962080
2018-02-06,NASDAQ (Q),713154948,459467159,896041783,2068663890,35585132588.116199,34299260810.119317,59068402191.278905,128952795589.514421,6431647,2120562,6309198,14861407
2018-02-06,IEX (V),148602234,58716274,72202227,279520735,7513089867.433200,4734194495.671499,5022438726.006301,17269723089.111000,1047009,287203,520456,1854668
2018-02-06,NASDAQ PSX (X),38382790,73606945,37625028,149614763,2013380223.130000,5257379903.950002,3050139414.947400,10320899542.027402,296065,263190,273885,833140
2018-02-06,BYX Equities (Y),298798495,153440259,131482375,583721129,9541121571.605402,8479877861.924000,6423460820.743699,24444460254.273101,2476391,812090,1229807,4518288
2018-02-06,BZX Equities (Z),405856076,380686266,222798757,1009341099,17662379359.318100,28832031939.278608,14571263797.908400,61065675096.505108,3550161,1972468,1989839,7512468
2018-02-05,NYSE American (A),9148456,29186306,5815893,44150655,393787000.827200,733687935.201800,327105551.818700,1454580487.847700,83233,97586,53185,234004
2018-02-05,NASDAQ BX (B),188851656,80478993,106065698,375396347,7765587343.837800,5076535650.601600,5779783196.275701,18621906190.715101,1820702,400095,1048427,3269224
2018-02-05,FINRA / NYSE TRF (DN),127476950,81655987,129403130,338536067,5361295384.282499,3585731022.632601,5763643328.384402,14710669735.299502,350444,199685,363556,913685
2018-02-05,FINRA / Nasdaq TRF Carteret (DQ),1546124723,910385076,1008372028,3464881827,64917863426.751806,60598212293.309022,55292386086.462507,180808461806.523335,5731494,2136734,3526465,11394693
2018-02-05,EDGA Equities (J),71542988,66784122,40692850,179019960,2745601588.663300,4885941300.226701,2457209101.187300,10088751990.077301,609264,336741,325697,1271702
2018-02-05,EDGX Equities (K),315716231,244157363,261128941,821002535,14090138944.200301,16873659339.217203,14269092681.616293,45232890965.033797,2359075,1092081,1707492,5158648
2018-02-05,CHX (M),10779228,25658355,9359129,45796712,573330756.794000,3599325835.380001,1012502291.709400,5185158883.883401,5370,9796,4140,19306
2018-02-05,NYSE (N),1323461823,0,0,1323461823,58049183660.281705,0.000000,0.000000,58049183660.281705,4728014,0,0,4728014
2018-02-05,NYSE Arca (P),344171313,789717856,259231881,1393121050,16375428975.952605,52892050581.322239,15158440271.184799,84425919828.459643,2642840,2527964,1830535,7001339
2018-02-05,NASDAQ (Q),598629225,414167873,893941296,1906738394,29465249995.849795,32351670621.001300,58641079286.667882,120457999903.518977,5379788,1924897,5758622,13063307
2018-02-05,IEX (V),142284269,49570758,66827289,258682316,6814057122.143800,3833716805.170401,4827950299.417600,15475724226.731801,893081,216193,466150,1575424
2018-02-05,NASDAQ PSX (X),33893175,63490502,36197810,133581487,1681175173.660000,5356716341.538901,2925848286.610000,9963739801.808901,265243,238969,249667,753879
2018-02-05,BYX Equities (Y),270637564,160027128,130358017,561022709,8562962094.753101,8695143883.765700,5954582113.283100,23212688091.801901,2222839,797813,1145587,4166239
2018-02-05,BZX Equities (Z),328130420,331930376,195821335,855882131,13986156522.967200,23965947525.495701,12271354516.260698,50223458564.723599,2908935,1636675,1664985,6210595
2018-02-02,NYSE American (A),7750145,24788574,4587103,37125822,323338637.905000,343991510.422300,310789255.426300,978119403.753600,67102,75312,40821,183235
2018-02-02,NASDAQ BX (B),157227153,57752376,86488396,301467925,6524633974.879900,3417678102.952500,4881542588.226198,14823854666.058598,1494171,271878,876518,2642567
2018-02-02,FINRA / NYSE TRF (DN),113971536,61781058,114378181,290130775,4688954741.075999,2419929372.270900,5161181291.915200,12270065405.262099,286062,153281,302425,741768
2018-02-02,FINRA / Nasdaq TRF Carteret (DQ),1423385336,721335317,940534440,3085255093,57578584349.654191,44222381766.264303,54416114907.669418,156217081023.587912,4985697,1703848,3169056,9858601
2018-02-02,EDGA Equities (J),54343136,44012925,30796214,129152275,2052441435.261500,2962574929.759499,1957555877.054700,6972572242.075699,450989,212267,251852,915108
2018-02-02,EDGX Equities (K),246510233,147410489,215094965,609015687,11048685376.026101,9609667503.301101,12542652696.598998,33201005575.926200,1765441,622226,1362116,3749783
2018-02-02,CHX (M),9599753,19264942,8297741,37162436,492040628.870000,2001801943.915000,1357102360.735000,3850944933.520000,3822,7586,3156,14564
2018-02-02,NYSE (N),1024072308,0,0,1024072308,43942761393.594996,0.000000,0.000000,43942761393.594996,3339237,0,0,3339237
2018-02-02,NYSE Arca (P),262979096,507517801,192956082,963452979,12517954735.741201,32607313722.375709,12787233320.055704,57912501778.172614,2006648,1525582,1439008,4971238
2018-02-02,NASDAQ (Q),433220566,251930543,686611622,1371762731,21349206595.888201,18850382798.124901,48095825584.637987,88295414978.651089,3836013,1058822,4382949,9277784
2018-02-02,IEX (V),114697469,32219602,57192698,204109769,5463476259.263500,2146586738.057100,4349829576.150599,11959892573.471199,743669,138816,388007,1270492
2018-02-02,NASDAQ PSX (X),23571040,35037048,25471368,84079456,1105160994.044500,2937960218.304900,2076715397.871500,6119836610.220900,193485,137744,204565,535794
2018-02-02,BYX Equities (Y),220082140,117328510,105162415,442573065,6829724687.588401,5946353149.518199,4749795671.035299,17525873508.141899,1755563,564225,920100,3239888
2018-02-02,BZX Equities (Z),248811732,190196066,139589411,578597209,10525886084.758801,13861330134.967905,9338474349.481101,33725690569.207807,2082091,927772,1167946,4177809
2018-02-01,NYSE American (A),5949988,19179581,3666523,28796092,271476718.955000,250162443.238800,255877842.747000,777517004.940800,56484,56346,34524,147354
2018-02-01,NASDAQ BX (B),140704871,45050257,80304119,266059247,6295907380.542001,2589292275.796400,4322046982.581898,13207246638.920299,1423210,232298,834858,2490366
2018-02-01,FINRA / NYSE TRF (DN),95039502,48895814,89682331,233617647,4256612044.482500,1499437423.530800,4483515795.036600,10239565263.049900,247747,105716,258947,612410
2018-02-01,FINRA / Nasdaq TRF Carteret (DQ),1355145826,584513791,876356347,2816015964,57598801208.292998,33239453972.611109,49610842530.851003,140449097711.755110,4533434,1110384,2854516,8498334
2018-02-01,EDGA Equities (J),49511415,33231601,28098999,110842015,1975291427.424900,2096483192.347000,1593184469.871500,5664959089.643400,431886,157974,233446,823306
2018-02-01,EDGX Equities (K),224009624,101891183,187462607,513363414,10709936155.434398,6225869000.132901,11480434329.283301,28416239484.850600,1703387,425294,1271951,3400632
2018-02-01,CHX (M),10313317,12642341,9007989,31963647,565801958.761700,1615451427.213300,1044885264.077900,3226138650.052900,3125,3974,2143,9242
2018-02-01,NYSE (N),913258788,0,0,913258788,39923975396.617205,0.000000,0.000000,39923975396.617205,2999839,0,0,2999839
2018-02-01,NYSE Arca (P),241192925,342895266,166820382,750908573,12290023284.023997,20952821105.053210,12305139507.250201,45547983896.327408,1862919,985496,1292403,4140818
2018-02-01,NASDAQ (Q),391762257,169520550,585308010,1146590817,20088696147.121698,11483646734.925204,41310651829.002425,72882994711.049327,3495250,735802,3929944,8160996
2018-02-01,IEX (V),114285766,25803876,56221982,196311624,5614301971.117199,1570586673.153400,4014284926.600500,11199173570.871099,735231,97562,369015,1201808
2018-02-01,NASDAQ PSX (X),20821527,25511588,20666738,66999853,1005445592.600300,1996215910.191100,1531316498.917200,4532978001.708600,178376,102274,181648,462298
2018-02-01,BYX Equities (Y),191776500,84626551,89252534,365655585,6443036930.888701,4248597059.255399,4094962200.533501,14786596190.677601,1609560,416893,804402,2830855
2018-02-01,BZX Equities (Z),223617496,126795656,118340104,468753256,9699996857.844003,8707916993.888799,7397000019.548501,25804913871.281303,1881322,591457,1012794,3485573
2018-01-31,NYSE American (A),6967349,16872433,3915568,27755350,351611187.835600,265875866.163900,246772928.576000,864259982.575500,63591,50612,36941,151144
2018-01-31,NASDAQ BX (B),148612385,44816282,80286194,273714861,6756062020.352800,2754756527.272600,4115494177.881902,13626312725.507302,1544780,220487,839593,2604860
2018-01-31,FINRA / NYSE TRF (DN),100417621,43078561,87705486,231201668,4235054192.341200,1615146647.848500,4066181079.668100,9916381919.857800,244698,100497,256184,601379
2018-01-31,FINRA / Nasdaq TRF Carteret (DQ),1416356028,584708928,891345744,2892410700,61544240597.307188,37108230295.480719,46525982815.819587,145178453708.607494,4442488,1113182,2785847,8341517
2018-01-31,EDGA Equities (J),50766386,33847278,28665077,113278741,2014360605.409700,2283957870.371300,1575968871.345100,5874287347.126100,431399,157597,229739,818735
2018-01-31,EDGX Equities (K),225933340,115376460,197402634,538712434,10220654495.608598,7307839256.922702,10511985899.707596,28040479652.238896,1627119,473940,1200684,3301743
2018-01-31,CHX (M),14994887,16051696,10319516,41366099,889264737.285700,1931829853.955000,1162974040.287200,3984068631.527900,2634,5092,1980,9706
2018-01-31,NYSE (N),1125726172,0,0,1125726172,51955637649.542600,0.000000,0.000000,51955637649.542600,2984068,0,0,2984068
2018-01-31,NYSE Arca (P),234896737,401801866,178635727,815334330,11820947496.899204,25205818469.583803,11123896689.083196,48150662655.566203,1833499,1022631,1253464,4109594
2018-01-31,NASDAQ (Q),387773752,185883108,658756408,1232413268,19768876487.943704,13500591576.328495,41993959550.209877,75263427614.482076,3490094,764833,3746521,8001448
2018-01-31,IEX (V),112546736,24026439,55020180,191593355,5363341593.648100,1586024976.040000,3516983290.331799,10466349860.019899,714809,97681,355769,1168259
2018-01-31,NASDAQ PSX (X),20455311,24171258,22730431,67357000,935913098.282400,2013613831.396400,1490905652.964400,4440432582.643200,170567,94280,174884,439731
2018-01-31,BYX Equities (Y),202909337,86868857,93986332,383764526,6969376808.361500,4491156802.618500,4216754303.156500,15677287914.136500,1704728,413145,831746,2949619
2018-01-31,BZX Equities (Z),227921445,139624183,120228732,487774360,9707214283.945002,9749737704.876998,6923659882.730298,26380611871.552298,1904454,607495,998994,3510943
2018-01-30,NYSE American (A),5476162,19907037,3900564,29283763,252822344.275000,281320185.905800,252485586.644100,786628116.824900,53867,54085,35366,143318
2018-01-30,NASDAQ BX (B),141936275,47355089,79104781,268396145,6399432583.533299,2877314627.450700,4052623673.906601,13329370884.890600,1466843,234651,810274,2511768
2018-01-30,FINRA / NYSE TRF (DN),106751229,49380880,86889975,243022084,4447073951.557100,1823640103.457700,4084754124.862401,10355468179.877201,261037,122432,254214,637683
2018-01-30,FINRA / Nasdaq TRF Carteret (DQ),1384536415,765596684,796145022,2946278121,55971897682.185808,50029422678.991570,42672893631.793507,148674213992.970885,4599685,1332677,2665750,8598112
2018-01-30,EDGA Equities (J),49938753,38699618,26116175,114754546,1964575080.680800,2543439270.185100,1436371545.686600,5944385896.552500,430362,179675,220791,830828
2018-01-30,EDGX Equities (K),231557427,121575634,188586834,541719895,10369432114.207901,7451960515.173101,10132937103.942394,27954329733.323396,1642999,500739,1208786,3352524
2018-01-30,CHX (M),13154051,14424863,12662778,40241692,848524846.549000,1393580634.561500,1412034146.926600,3654139628.037100,2907,5823,2181,10911
2018-01-30,NYSE (N),914891874,0,0,914891874,39822501552.340498,0.000000,0.000000,39822501552.340498,3007527,0,0,3007527
2018-01-30,NYSE Arca (P),233025787,384393778,161164035,778583600,12186517231.186399,24830233502.680987,9623021187.575902,46639771921.443288,1848223,1130541,1203287,4182051
2018-01-30,NASDAQ (Q),387010702,191040999,552253680,1130305381,20067317396.112501,14188836847.480107,35479214646.095309,69735368889.687917,3438608,802781,3643377,7884766
2018-01-30,IEX (V),108386002,28943786,51358489,188688277,5427625781.938300,1985366724.599300,3452039988.015501,10865032494.553101,712139,111671,342830,1166640
2018-01-30,NASDAQ PSX (X),19812379,27914051,21212824,68939254,934742268.166200,2335123709.666400,1446754019.957100,4716619997.789700,166986,113758,173222,453966
2018-01-30,BYX Equities (Y),194669398,91619148,88550066,374838612,6627631112.343700,4645558128.429800,3870715368.642299,15143904609.415799,1635136,452713,792854,2880703
2018-01-30,BZX Equities (Z),220928366,151644900,115483678,488056944,9547543264.265801,10740356171.296792,6717508375.921402,27005407811.483995,1871814,716181,988102,3576097
2018-01-29,NYSE American (A),5122688,19578784,3868292,28569764,228535745.279700,257800712.842800,232209282.121300,718545740.243800,49590,52699,36652,138941
2018-01-29,NASDAQ BX (B),125519094,41902827,73267392,240689313,5517368227.824400,2346860119.883500,3856986225.229999,11721214572.937899,1259326,202075,756601,2218002
2018-01-29,FINRA / NYSE TRF (DN),97905795,38709986,93248077,229863858,4170830530.675301,1461277600.024300,4164217411.025200,9796325541.724801,235358,108048,273355,616761
2018-01-29,FINRA / Nasdaq TRF Carteret (DQ),1259575652,490611254,805354640,2555541546,53197756060.869803,29443805956.438583,43811128407.869994,126452690425.178380,4113512,1097566,2658910,7869988
2018-01-29,EDGA Equities (J),46186788,28759909,25911886,100858583,1835224402.115400,1942470323.327100,1503759708.466600,5281454433.909100,398368,144208,221313,763889
2018-01-29,EDGX Equities (K),196516721,88560272,172401204,457478197,8746997351.576400,5685475360.442900,9345962484.552807,23778435196.572107,1389831,382396,1084267,2856494
2018-01-29,CHX (M),6800793,15739714,13332140,35872647,342167108.797800,1294757190.165000,1305186451.577400,2942110750.540200,3136,5147,1819,10102
2018-01-29,NYSE (N),828537558,0,0,828537558,36491573214.711806,0.000000,0.000000,36491573214.711806,2654610,0,0,2654610
2018-01-29,NYSE Arca (P),205935939,321242598,145412482,672591019,10389102575.777802,20303746110.370300,8809494927.393295,39502343613.541397,1556403,885629,1079369,3521401
2018-01-29,NASDAQ (Q),340264617,144094006,526578341,1010936964,17246835728.365799,9880946317.556405,34316918665.245380,61444700711.167584,2968523,612823,3329381,6910727
2018-01-29,IEX (V),90961306,21286852,49589867,161838025,4636271393.356800,1412490951.696900,3504412670.862000,9553175015.915700,601128,89101,324132,1014361
2018-01-29,NASDAQ PSX (X),17800827,20122329,18711571,56634727,843267338.258700,1568844583.168000,1285223807.502300,3697335728.929000,147221,81996,154144,383361
2018-01-29,BYX Equities (Y),174822548,79009210,82903268,336735026,5953755636.025801,3879080831.051799,3796451579.968300,13629288047.045900,1478784,389543,754703,2623030
2018-01-29,BZX Equities (Z),191477397,112429017,103841883,407748297,8071269791.040799,7971203548.847304,6160099868.975900,22202573208.864003,1601544,518976,882494,3003014
2018-01-26,NYSE American (A),4721948,14282479,3411859,22416286,208758153.393200,207441723.111500,225295383.496600,641495260.001300,44404,43089,31040,118533
2018-01-26,NASDAQ BX (B),119389165,31283756,70669747,221342668,5401325194.651900,1813401818.920600,3496398567.162100,10711125580.734600,1198476,157828,717833,2074137
2018-01-26,FINRA / NYSE TRF (DN),93376801,32710223,86527204,212614228,3994511177.931400,1207677584.891200,4119136025.704399,9321324788.526999,233634,87819,254739,576192
2018-01-26,FINRA / Nasdaq TRF Carteret (DQ),1260525751,449432520,801783019,2511741290,56083157876.777715,32881843237.386014,43181422860.303283,132146423974.467012,4024055,922375,2595629,7542059
2018-01-26,EDGA Equities (J),42747593,21948860,24764110,89460563,1708891621.896800,1502942538.248800,1334357274.394400,4546191434.540000,364189,102432,205221,671842
2018-01-26,EDGX Equities (K),181611999,69162378,167456136,418230513,8456586253.357100,4323007620.410500,8930881112.126897,21710474985.894497,1272402,286680,1021289,2580371
2018-01-26,CHX (M),10913922,14717500,8039207,33670629,558348994.765700,1473878649.015000,775446156.683100,2807673800.463800,2519,3205,1280,7004
2018-01-26,NYSE (N),807463966,0,0,807463966,36781494648.215195,0.000000,0.000000,36781494648.215195,2416949,0,0,2416949
2018-01-26,NYSE Arca (P),194625854,243514694,147079436,585219984,10090134813.150703,15831885699.061494,8626596577.573799,34548617089.785996,1478612,683595,1059236,3221443
2018-01-26,NASDAQ (Q),308435411,112567654,524420828,945423893,15938784395.315802,8178908912.845797,34957927565.326695,59075620873.488294,2666381,478807,3155062,6300250
2018-01-26,IEX (V),91511334,17399922,49813465,158724721,4563936935.240100,1390770280.726800,3307179916.424800,9261887132.391700,573019,69859,316670,959548
2018-01-26,NASDAQ PSX (X),16767129,16716767,17391037,50874933,796039207.871300,1294056758.183400,1197405234.730000,3287501200.784700,135090,65906,142788,343784
2018-01-26,BYX Equities (Y),162437682,62042941,77182226,301662849,5601728205.009700,3188393253.642900,3438443144.153201,12228564602.805801,1353112,305407,683146,2341665
2018-01-26,BZX Equities (Z),180155214,84212192,102166148,366533554,7884279523.953101,6467990286.873498,6253256086.458697,20605525897.285296,1497706,383686,855781,2737173
2018-01-25,NYSE American (A),5582266,17575336,3032397,26189999,238365266.782100,235314347.108600,176933211.111000,650612825.001700,51078,54266,28833,134177
2018-01-25,NASDAQ BX (B),136888159,40472137,70672742,248033038,5969665947.188901,2266681361.543200,3600538705.674800,11836886014.406901,1348218,194235,727279,2269732
2018-01-25,FINRA / NYSE TRF (DN),103011814,37953562,86430726,227396102,4263139778.122999,1424695996.774700,3745020287.885300,9432856062.782999,237394,99259,245364,582017
2018-01-25,FINRA / Nasdaq TRF Carteret (DQ),1331264352,474071032,807684274,2613019658,54586256335.390186,29703247360.118593,39775432041.821911,124064935737.330690,4281276,1051318,2510526,7843120
2018-01-25,EDGA Equities (J),47833179,31610220,23869160,103312559,1733720646.971000,1918370401.155000,1275618805.109000,4927709853.235000,398458,144683,203177,746318
2018-01-25,EDGX Equities (K),219344329,92440625,170207676,481992630,9337494054.219100,5186916470.005300,8581894173.349607,23106304697.574007,1473290,393490,1057622,2924402
2018-01-25,CHX (M),14631098,16948872,9469954,41049924,767835443.653300,1511328904.065500,859984454.708800,3139148802.427600,2872,5806,2069,10747
2018-01-25,NYSE (N),887201249,0,0,887201249,36934075927.596990,0.000000,0.000000,36934075927.596990,2741112,0,0,2741112
2018-01-25,NYSE Arca (P),231210857,327884616,150946551,710042024,10884274502.659500,18620669435.730595,8296861667.745197,37801805606.135292,1695456,900583,1093449,3689488
2018-01-25,NASDAQ (Q),371180520,155736115,507683087,1034599722,18211687407.333000,10347144573.666700,31412209524.211602,59971041505.211302,3136998,667118,3237486,7041602
2018-01-25,IEX (V),106405923,20388115,48462412,175256450,5053821505.430800,1297777907.168500,3371397974.645300,9722997387.244600,670182,79682,326949,1076813
2018-01-25,NASDAQ PSX (X),20310993,22674351,18864284,61849628,915770420.490000,1682875159.167100,1374983911.296700,3973629490.953800,163947,92310,155366,411623
2018-01-25,BYX Equities (Y),185729527,77096658,80127196,342953381,5844232723.837701,3656085038.558801,3540179644.786299,13040497407.182801,1487771,373934,711933,2573638
2018-01-25,BZX Equities (Z),212513429,123893487,103930303,440337219,8593998337.912000,8153067273.283001,6067734966.410201,22814800577.605202,1676975,542818,867610,3087403
2018-01-24,NYSE American (A),4944944,16978755,3609317,25533016,214159679.890000,249128748.126500,229149962.900000,692438390.916500,46151,50298,33577,130026
2018-01-24,NASDAQ BX (B),138130368,44445189,75820052,258395609,5910363562.218500,2441034251.073200,3785483187.310700,12136881000.602400,1360360,215677,762604,2338641
2018-01-24,FINRA / NYSE TRF (DN),104002673,41475570,95957570,241435813,4336559379.495899,1600752022.998199,4594813415.399800,10532124817.893898,240391,109627,269402,619420
2018-01-24,FINRA / Nasdaq TRF Carteret (DQ),1396358040,535189689,880621772,2812169501,56667847441.987810,36894375304.750782,47385259206.704786,140947481953.443378,4324848,1122808,2735239,8182895
2018-01-24,EDGA Equities (J),52739193,32259235,26060055,111058483,1941624215.644700,2113997082.728401,1394848111.003500,5450469409.376601,440522,160874,222688,824084
2018-01-24,EDGX Equities (K),227205506,105461086,188918013,521584605,9793717529.938003,6368429604.148497,10428315180.635900,26590462314.722400,1560522,439711,1224805,3225038
2018-01-24,CHX (M),18364844,18476967,10813130,47654941,1205337862.202500,1882468304.932600,1181290892.740000,4269097059.875100,2826,5380,3281,11487
2018-01-24,NYSE (N),949837636,0,0,949837636,39992839587.953797,0.000000,0.000000,39992839587.953797,2772957,0,0,2772957
2018-01-24,NYSE Arca (P),251348612,354888072,158915013,765151697,11378963350.579902,22431450971.509900,9721429152.206000,43531843474.295802,1798359,1018313,1211806,4028478
2018-01-24,NASDAQ (Q),388472656,167818807,566477119,1122768582,18853010571.880193,12162772885.754802,37516830699.691395,68532614157.326390,3321428,718256,3725621,7765305
2018-01-24,IEX (V),100968957,22628620,53262550,176860127,4728220393.461001,1586197415.794299,3521550276.646800,9835968085.902100,632100,89395,334333,1055828
2018-01-24,NASDAQ PSX (X),19926983,26157976,20381635,66466594,877037492.852000,1989699044.362501,1550447839.924700,4417184377.139201,159612,97557,168370,425539
2018-01-24,BYX Equities (Y),204711694,85585525,89479581,379776800,6524479325.939100,4096915091.439698,4004141407.154600,14625535824.533398,1672701,415545,808913,2897159
2018-01-24,BZX Equities (Z),222261138,128231207,117012983,467505328,9102823238.793199,9150343822.366101,7386263076.132600,25639430137.291900,1814888,596041,1017452,3428381
2018-01-23,NYSE American (A),4398618,14308967,3168964,21876549,186269675.110000,170615590.780100,188651054.317900,545536320.208000,42229,47181,29614,119024
2018-01-23,NASDAQ BX (B),128638511,33486330,72823499,234948340,5716140306.325199,1860571841.604600,3613518566.413400,11190230714.343199,1279316,166625,750120,2196061
2018-01-23,FINRA / NYSE TRF (DN),94936253,38686630,89987896,223610779,3930557026.073000,1306834601.064900,3803743644.704900,9041135271.842800,240994,115195,261594,617783
2018-01-23,FINRA / Nasdaq TRF Carteret (DQ),1242366855,479872270,845115941,2567355066,50268288534.332305,32571079062.654884,43053944387.518096,125893311984.505285,4035082,983592,2643701,7662375
2018-01-23,EDGA Equities (J),47530094,23866699,26065620,97462413,1809767731.526100,1550103778.737500,1403562884.756800,4763434395.020400,403086,111950,224887,739923
2018-01-23,EDGX Equities (K),197293018,79472005,175349155,452114178,8854802199.174802,4778428649.714703,9063155883.741100,22696386732.630605,1359530,326406,1080544,2766480
2018-01-23,CHX (M),17377267,19659376,8245336,45281979,1454022526.595200,1662175888.220000,1283104623.060700,4399303037.875900,2881,3521,2074,8476
2018-01-23,NYSE (N),793057868,0,0,793057868,35647610392.433799,0.000000,0.000000,35647610392.433799,2464194,0,0,2464194
2018-01-23,NYSE Arca (P),207288638,258142782,145829023,611260443,10171379715.745203,15593687560.810802,8609490044.501098,34374557321.057103,1514797,717018,1100086,3331901
2018-01-23,NASDAQ (Q),321740008,119594491,511000339,952334838,16008821970.062701,8105356254.775404,33833839376.274999,57948017601.113104,2750960,500733,3205341,6457034
2018-01-23,IEX (V),95840233,15163562,49921900,160925695,4500213691.424500,1025602568.253500,2985585908.437400,8511402168.115400,580163,61713,305484,947360
2018-01-23,NASDAQ PSX (X),16835343,16610861,17660167,51106371,721646338.509600,1295836273.515900,1188146067.197700,3205628679.223200,140215,66383,149612,356210
2018-01-23,BYX Equities (Y),182193350,65859021,83714974,331767345,5963565515.853601,3236142664.625900,3677722173.505298,12877430353.984799,1486596,312584,747445,2546625
2018-01-23,BZX Equities (Z),191648115,89196811,106963869,387808795,7897011106.565699,6280321642.963100,6139126123.333100,20316458872.861899,1568270,401066,908372,2877708
2018-01-22,NYSE American (A),4808318,13786785,3322756,21917859,199730757.955000,191444011.427800,177787985.961600,568962755.344400,44934,39182,32181,116297
2018-01-22,NASDAQ BX (B),131918735,29662261,71724161,233305157,5588051311.063000,1710163886.004800,3438187257.555100,10736402454.622900,1315625,144664,753536,2213825
2018-01-22,FINRA / NYSE TRF (DN),94995713,36414544,91150336,222560593,3890606409.925400,1197956491.612300,3518795676.614500,8607358578.152200,238675,97286,263684,599645
2018-01-22,FINRA / Nasdaq TRF Carteret (DQ),1203247810,423010273,832769755,2459027838,50059040168.461615,27792829843.815602,41372686865.925929,119224556878.203146,3991867,919744,2571716,7483327
2018-01-22,EDGA Equities (J),44107521,21382986,23362070,88852577,1666580278.841300,1437292480.139700,1203699795.013100,4307572553.994100,373125,97496,200121,670742
2018-01-22,EDGX Equities (K),181507251,64336420,167488579,413332250,7971892775.742799,4089047494.420200,8144120781.377101,20205061051.540100,1256823,263153,999050,2519026
2018-01-22,CHX (M),14306906,17953762,9457199,41717867,796786267.961900,1378106199.163700,987151289.373400,3162043756.499000,3078,2476,1966,7520
2018-01-22,NYSE (N),855193864,0,0,855193864,38317289055.111203,0.000000,0.000000,38317289055.111203,2406514,0,0,2406514
2018-01-22,NYSE Arca (P),194208260,243858100,143114942,581181302,9316373089.321094,17685304157.662398,8167917230.713700,35169594477.697192,1447356,641341,1041178,3129875
2018-01-22,NASDAQ (Q),308221792,101133707,531580886,940936385,15036436410.501705,7389705658.766201,32842359643.855000,55268501713.122906,2671727,427931,3092836,6192494
2018-01-22,IEX (V),88783232,15072825,48262599,152118656,4196774136.040900,1046711760.931800,2958034321.428701,8201520218.401401,556575,61588,307921,926084
2018-01-22,NASDAQ PSX (X),16403852,13985246,16155714,46544812,713399747.713000,1058147399.828300,1051759587.622000,2823306735.163300,134879,57512,136133,328524
2018-01-22,BYX Equities (Y),175566125,59193647,82183554,316943326,5632533840.047400,2999668428.540899,3492484004.067699,12124686272.655998,1426805,285903,737502,2450210
2018-01-22,BZX Equities (Z),176212789,76029693,97741673,349984155,7289881758.431802,5727687477.409097,5352877090.775700,18370446326.616599,1479739,344467,835778,2659984
2018-01-19,NYSE American (A),4976839,14570171,3130192,22677202,193243898.530000,239825079.465800,167133506.564600,600202484.560400,43878,43601,29711,117190
2018-01-19,NASDAQ BX (B),127761585,31318306,68652972,227732863,5588052668.986400,1848588949.408500,3153137955.237200,10589779573.632100,1238827,158759,686379,2083965
2018-01-19,FINRA / NYSE TRF (DN),90802878,36143210,75379502,202325590,3797950731.688200,1112615852.703000,2920497655.053700,7831064239.444900,220849,88979,208820,518648
2018-01-19,FINRA / Nasdaq TRF Carteret (DQ),1216751946,496580350,764090959,2477423255,50787906259.193109,43291612653.520982,39366792944.719490,133446311857.433581,4081460,934607,2329891,7345958
2018-01-19,EDGA Equities (J),45432532,22598788,21822098,89853418,1739841713.040800,1527584285.901000,1123113776.253900,4390539775.195700,374101,103292,183767,661160
2018-01-19,EDGX Equities (K),184577858,68215321,146176786,398969965,8039979828.890200,4072825732.614099,7004315867.501400,19117121429.005699,1228725,270934,896110,2395769
2018-01-19,CHX (M),21846462,18839106,12158018,52843586,1440156848.194500,2054125652.612000,1301727397.342100,4796009898.148600,3531,3148,2216,8895
2018-01-19,NYSE (N),1035795064,0,0,1035795064,48271640427.851296,0.000000,0.000000,48271640427.851296,2495073,0,0,2495073
2018-01-19,NYSE Arca (P),204672737,251940714,133487223,590100674,9648539412.547302,16669984225.801899,7133947521.026900,33452471159.376101,1484088,670920,988482,3143490
2018-01-19,NASDAQ (Q),313330023,112546391,544464122,970340536,14950338236.359006,8090608878.874399,34402633562.362907,57443580677.596312,2608895,475665,2890834,5975394
2018-01-19,IEX (V),96192077,16334279,44734050,157260406,4485868992.709400,1223115635.775300,2657541805.035400,8366526433.520100,591421,67365,294318,953104
2018-01-19,NASDAQ PSX (X),17003241,16048111,15774893,48826245,730289112.669500,1251425068.819500,1004559072.907900,2986273254.396900,138125,65011,131079,334215
2018-01-19,BYX Equities (Y),180598948,61893934,78067723,320560605,6012264352.934900,3235907039.538800,3258273375.732600,12506444768.206300,1449934,293346,691356,2434636
2018-01-19,BZX Equities (Z),184493563,82467584,97540728,364501875,7889207322.060700,6149222730.237899,5586649593.401898,19625079645.700497,1494854,375199,795648,2665701
2018-01-18,NYSE American (A),4368562,14223351,3249716,21841629,176737333.390000,174030681.902500,196052524.160400,546820539.452900,41953,41018,30995,113966
2018-01-18,NASDAQ BX (B),131842400,32296587,71669971,235808958,5797479407.553800,1812522872.579300,3373161941.909300,10983164222.042400,1345588,166689,718958,2231235
2018-01-18,FINRA / NYSE TRF (DN),96542538,37279170,93910255,227731963,3758711199.595399,1276634241.275500,3627653275.868899,8662998716.739798,236321,96214,226751,559286
2018-01-18,FINRA / Nasdaq TRF Carteret (DQ),1329546566,497642732,802351525,2629540823,53134813399.308692,33087959584.520102,37581352906.616501,123804125890.445295,4048656,974126,2374605,7397387
2018-01-18,EDGA Equities (J),47989724,23256788,24855337,96101849,1792698838.148900,1540690169.545700,1213635583.109200,4547024590.803800,402184,112930,199079,714193
2018-01-18,EDGX Equities (K),195650830,75164480,158486418,429301728,8182405146.956799,4423393322.642201,7071797987.265500,19677596456.864500,1291206,329883,941252,2562341
2018-01-18,CHX (M),11362801,19557305,6518391,37438497,547515211.221300,1769647915.491000,534359803.900100,2851522930.612400,3520,3949,1865,9334
2018-01-18,NYSE (N),867130887,0,0,867130887,36374468957.103798,0.000000,0.000000,36374468957.103798,2462463,0,0,2462463
2018-01-18,NYSE Arca (P),210209289,271532213,137378617,619120119,9693126880.948100,16801530055.229406,7152685989.450100,33647342925.627606,1544080,756137,996804,3297021
2018-01-18,NASDAQ (Q),325293543,122199088,497140606,944633237,15286444108.879404,8301263310.179902,28671888519.333818,52259595938.393124,2748109,530027,2983536,6261672
2018-01-18,IEX (V),100026967,14883091,45780881,160690939,5033746741.516101,1002676278.078700,2750694842.504999,8787117862.099800,599515,58334,284542,942391
2018-01-18,NASDAQ PSX (X),18439206,17693359,16798909,52931474,768601944.669000,1473779275.787500,1077251663.044900,3319632883.501400,145768,70215,139843,355826
2018-01-18,BYX Equities (Y),177916624,67771617,82271157,327959398,5873018919.683000,3296915462.937400,3345272146.085000,12515206528.705400,1463945,319334,709009,2492288
2018-01-18,BZX Equities (Z),186980863,91294785,97000653,375276301,7678420561.519001,6290550294.240996,5381101503.709399,19350072359.469396,1504712,428176,814408,2747296
2018-01-17,NYSE American (A),4465764,15012616,3319161,22797541,180747700.790000,203881453.119300,188089816.472900,572718970.382200,43605,42226,32455,118286
2018-01-17,NASDAQ BX (B),135364976,37512434,76728132,249605542,5867631845.237501,2060653969.720900,3624190136.214599,11552475951.173000,1348702,180574,773385,2302661
2018-01-17,FINRA / NYSE TRF (DN),95357266,39066022,95875734,230299022,3618888968.022201,1371915445.645100,3509759315.848901,8500563729.516202,238622,95746,248677,583045
2018-01-17,FINRA / Nasdaq TRF Carteret (DQ),1244310846,545237932,872781108,2662329886,48599240987.543304,37552133365.079994,39368971432.776300,125520345785.399598,4118217,1077349,2612855,7808421
2018-01-17,EDGA Equities (J),52868462,26502433,29100812,108471707,1971487167.398300,1723257600.774400,1314558819.394300,5009303587.567000,425237,122727,223603,771567
2018-01-17,EDGX Equities (K),212292117,81370614,186823709,480486440,9117689812.250600,4676695303.189399,8879870435.783001,22674255551.223000,1397241,331992,1140240,2869473
2018-01-17,CHX (M),16469134,15016967,8010783,39496884,986716787.359600,1361432707.990000,886556151.310000,3234705646.659600,3809,4122,2561,10492
2018-01-17,NYSE (N),913184494,0,0,913184494,39420170497.190691,0.000000,0.000000,39420170497.190691,2681757,0,0,2681757
2018-01-17,NYSE Arca (P),229906934,304832875,157392437,692132246,10354812056.547000,18908416780.616303,8497682579.133500,37760911416.296803,1623729,811785,1150227,3585741
2018-01-17,NASDAQ (Q),352979952,137853660,550781635,1041615247,16598160435.118598,9533021564.466699,32921893787.128007,59053075786.713304,2922427,566679,3415225,6904331
2018-01-17,IEX (V),103987259,19275290,51017018,174279567,4749222816.179601,1382726530.097000,3196943946.803400,9328893293.080001,613876,74839,315932,1004647
2018-01-17,NASDAQ PSX (X),20092408,18496800,18956419,57545627,822360962.900400,1391514598.275100,1171983801.289000,3385859362.464500,152432,73477,154984,380893
2018-01-17,BYX Equities (Y),194565031,74513773,88576544,357655348,6227437629.271600,3685246348.789800,3571361468.587201,13484045446.648601,1572003,339840,776611,2688454
2018-01-17,BZX Equities (Z),214503197,100073900,106548252,421125349,8379490385.217700,6839565312.599899,5951779722.342099,21170835420.159698,1656554,442241,903043,3001838
2018-01-16,NYSE American (A),4624335,18497879,3361970,26484184,183907715.409400,245075837.824400,206146429.182900,635129982.416700,42988,51216,31471,125675
2018-01-16,NASDAQ BX (B),144188730,50384445,79476131,274049306,6006154090.522101,2669501562.905100,3832460936.345800,12508116589.773001,1372958,218427,771049,2362434
2018-01-16,FINRA / NYSE TRF (DN),111580798,50771610,106861083,269213491,4491785589.995801,1811286161.642100,4166608857.205399,10469680608.843300,286703,128128,296968,711799
2018-01-16,FINRA / Nasdaq TRF Carteret (DQ),1470021214,598095844,914015354,2982132412,60007457442.174123,38189926806.444490,45759466643.708103,143956850892.326716,4511322,1260035,2774308,8545665
2018-01-16,EDGA Equities (J),54791535,31588467,28092063,114472065,2052703263.554500,2094096191.163899,1491312557.788900,5638112012.507299,449641,145403,223483,818527
2018-01-16,EDGX Equities (K),240006883,96526669,194085617,530619169,10201279352.223701,5794558357.412299,9395513281.890901,25391350991.526901,1604298,413055,1193985,3211338
2018-01-16,CHX (M),12189960,11468305,3802965,27461230,723914927.917700,1096781474.180000,381243454.727500,2201939856.825200,3585,5579,2566,11730
2018-01-16,NYSE (N),1094997897,0,0,1094997897,47038261300.103212,0.000000,0.000000,47038261300.103212,3063223,0,0,3063223
2018-01-16,NYSE Arca (P),252257545,349797589,168051540,770106674,11522625465.735303,21703723058.626792,9450842336.360506,42677190860.722601,1807676,965099,1221376,3994151
2018-01-16,NASDAQ (Q),388370828,169147992,619417307,1176936127,18314084635.936699,12063586642.177595,37215644264.167716,67593315542.282010,3282583,698088,3677274,7657945
2018-01-16,IEX (V),118245474,23439421,49433995,191118890,5354128667.202199,1543510745.526100,3401815904.779201,10299455317.507500,660634,93887,314582,1069103
2018-01-16,NASDAQ PSX (X),20926517,23044601,19908409,63879527,920224968.266600,1777041476.237400,1435845027.991300,4133111472.495300,164240,94701,170957,429898
2018-01-16,BYX Equities (Y),216545139,90778787,95802814,403126740,6730362349.227101,4460597305.626600,4054892518.294301,15245852173.148002,1702715,420850,808781,2932346
2018-01-16,BZX Equities (Z),234142949,127808556,117485445,479436950,9268955854.668802,8809923138.705398,6993454646.070899,25072333639.445099,1835925,555186,980844,3371955
2018-01-12,NYSE American (A),4274654,14841326,2721680,21837660,161944192.510000,251022926.489600,150274758.150000,563241877.149600,39577,42802,26968,109347
2018-01-12,NASDAQ BX (B),132436445,36062491,67552582,236051518,5630822867.555800,2077604090.236100,3435745648.743600,11144172606.535500,1306102,175681,714169,2195952
2018-01-12,FINRA / NYSE TRF (DN),93758811,37857464,85432520,217048795,3507326923.625401,1385723836.149300,3484473647.807800,8377524407.582501,242155,100299,256184,598638
2018-01-12,FINRA / Nasdaq TRF Carteret (DQ),1211693586,529379600,764808774,2505881960,46870745530.116297,33249312317.193002,38242202804.704492,118362260652.013791,4083076,1012592,2534158,7629826
2018-01-12,EDGA Equities (J),48847105,24818898,23551747,97217750,1919669687.511900,1608085837.701600,1237284650.085100,4765040175.298600,411851,111345,193250,716446
2018-01-12,EDGX Equities (K),199954751,78645841,166466043,445066635,8458147908.703800,4719573257.056802,8376586370.648700,21554307536.409302,1275145,290968,957520,2523633
2018-01-12,CHX (M),13703739,13281908,11132231,38117878,1072559267.427000,1272688895.220000,1331959060.430500,3677207223.077500,3187,3874,1856,8917
2018-01-12,NYSE (N),874652145,0,0,874652145,37271609865.561704,0.000000,0.000000,37271609865.561704,2427976,0,0,2427976
2018-01-12,NYSE Arca (P),209893870,300186109,138683404,648763383,9691898474.004700,17823441631.876212,8312570344.094299,35827910449.975211,1526153,704834,1004896,3235883
2018-01-12,NASDAQ (Q),314931881,124371506,495117236,934420623,14711365464.280695,8716820193.140799,30583232978.412990,54011418635.834484,2662221,472887,2914633,6049741
2018-01-12,IEX (V),86917248,20062247,41658345,148637840,3963479876.725300,1315036723.162700,2748644455.922100,8027161055.810100,539511,73481,272457,885449
2018-01-12,NASDAQ PSX (X),17166829,16676039,15676608,49519476,716216770.655800,1165067940.468600,1028122017.832200,2909406728.956600,137955,65560,131325,334840
2018-01-12,BYX Equities (Y),185700145,73008352,79231991,337940488,5855636495.790100,3793984191.137500,3382011148.541000,13031631835.468600,1490229,322251,711188,2523668
2018-01-12,BZX Equities (Z),193291999,91317823,94575306,379185128,7522947909.834999,6255528376.944700,5533232349.425301,19311708636.205000,1514045,407098,794187,2715330
2018-01-11,NYSE American (A),4367019,15564758,2877174,22808951,171399628.780000,164732965.781100,135868046.004000,472000640.565100,40587,43917,28159,112663
2018-01-11,NASDAQ BX (B),132070217,31845205,69149242,233064664,5399453997.929000,1726205865.252300,2952027669.764200,10077687532.945500,1300636,160989,709277,2170902
2018-01-11,FINRA / NYSE TRF (DN),105176713,38289768,84078557,227545038,3832842404.293400,1157272710.264400,2884720618.127400,7874835732.685200,237356,95789,235287,568432
2018-01-11,FINRA / Nasdaq TRF Carteret (DQ),1280505622,468865077,803088007,2552458706,47577938778.674097,26122473585.420798,32686244904.142010,106386657268.236905,4142314,968876,2448601,7559791
2018-01-11,EDGA Equities (J),47475204,22597565,22864600,92937369,1682401298.323600,1370029543.171899,1038860313.946700,4091291155.442199,395056,103344,190335,688735
2018-01-11,EDGX Equities (K),212425607,67172693,167814559,447412859,8301494488.682297,3549009475.144799,6812980572.024700,18663484535.851796,1316151,257366,952197,2525714
2018-01-11,CHX (M),10924028,12520276,6055487,29499791,453805034.449000,1602274946.395600,454401240.838000,2510481221.682600,2937,4382,1545,8864
2018-01-11,NYSE (N),827909401,0,0,827909401,32932096563.959505,0.000000,0.000000,32932096563.959505,2477134,0,0,2477134
2018-01-11,NYSE Arca (P),206519152,241025421,139564359,587108932,9021921266.431903,13796186022.382598,6394231129.053997,29212338417.868498,1487291,637777,995749,3120817
2018-01-11,NASDAQ (Q),313037627,103478744,483373613,899889984,13897473815.440297,6725612047.201200,25037979707.815291,45661065570.456788,2589802,417784,2882696,5890282
2018-01-11,IEX (V),95137722,16272937,44094900,155505559,4283702696.036700,964872184.380000,2327958983.908200,7576533864.324900,569603,64751,264287,898641
2018-01-11,NASDAQ PSX (X),16468363,13944590,14929306,45342259,635256149.375100,953945810.755300,813852902.859200,2403054862.989600,133769,58261,126011,318041
2018-01-11,BYX Equities (Y),191955098,63571609,82419902,337946609,5800665911.852500,3111230094.966700,3105874498.797800,12017770505.617000,1558835,297152,737810,2593797
2018-01-11,BZX Equities (Z),201725057,79347495,94868124,375940676,7492453101.447499,5326356536.679401,4570113320.134099,17388922958.260999,1571531,340933,782567,2695031
2018-01-10,NYSE American (A),4538439,20549560,3075627,28163626,186357123.375000,195819636.337100,164159620.103000,546336379.815100,44347,52583,30010,126940
2018-01-10,NASDAQ BX (B),135152669,36930401,70268407,242351477,5272882725.623300,2033362661.956899,3007017994.415500,10313263381.995699,1333979,184191,725811,2243981
2018-01-10,FINRA / NYSE TRF (DN),90999825,42322947,86500853,219823625,3294700741.547100,1141934616.887300,2791698826.726600,7228334185.161000,222473,102409,227818,552700
2018-01-10,FINRA / Nasdaq TRF Carteret (DQ),1273289506,535287563,869107799,2677684868,48804711982.693990,30432142810.244489,36037370349.312703,115274225142.251182,4111350,1071968,2556646,7739964
2018-01-10,EDGA Equities (J),46909920,25724458,24036955,96671333,1650227680.647000,1471489087.316200,1087821051.999900,4209537819.963100,387424,119464,193020,699908
2018-01-10,EDGX Equities (K),200946896,79497590,173506188,453950674,7793855785.592703,4007263975.104100,7029953400.515200,18831073161.212003,1294586,289388,983129,2567103
2018-01-10,CHX (M),9685529,23651257,10571390,43908176,569849065.765900,2180550302.941700,988930483.544600,3739329852.252200,2611,4453,1932,8996
2018-01-10,NYSE (N),811663649,0,0,811663649,33531394271.106897,0.000000,0.000000,33531394271.106897,2463259,0,0,2463259
2018-01-10,NYSE Arca (P),203892914,275264557,149670988,628828459,8816445896.301100,15047630084.109206,6887631972.119799,30751707952.530105,1495862,733629,1025478,3254969
2018-01-10,NASDAQ (Q),298027352,123325861,493287097,914640310,13260593555.996099,7560828673.017697,26061660267.125803,46883082496.139599,2567504,487114,2964169,6018787
2018-01-10,IEX (V),95421396,19930036,48276797,163628229,4692996912.835100,1178077162.650900,2410079186.138600,8281153261.624600,581050,78501,299133,958684
2018-01-10,NASDAQ PSX (X),15445643,15823642,16043913,47313198,627349110.835800,1065303938.147500,869693698.199700,2562346747.183000,127361,64976,129560,321897
2018-01-10,BYX Equities (Y),198927856,74479552,87209622,360617030,5999837174.823700,3608924948.532001,3294440779.448402,12903202902.804103,1578983,331707,767904,2678594
2018-01-10,BZX Equities (Z),195007572,94030120,100879421,389917113,7431223573.655100,5994900259.286200,4888909840.878997,18315033673.820297,1567261,393625,826941,2787827
2018-01-09,NYSE American (A),4491906,20757465,3179881,28429252,176218086.170000,152221980.705600,156889103.902600,485329170.778200,43431,50278,30713,124422
2018-01-09,NASDAQ BX (B),138981112,33016367,72544643,244542122,5694001867.146799,1756881072.055701,3216364946.421301,10667247885.623801,1356273,158622,753353,2268248
2018-01-09,FINRA / NYSE TRF (DN),81247545,49214714,93978651,224440910,3113808646.254499,1146782439.366700,2944851406.700400,7205442492.321599,215950,113380,247579,576909
2018-01-09,FINRA / Nasdaq TRF Carteret (DQ),1184086469,455123839,831154550,2470364858,45770697338.259094,22409028902.344793,34121741715.886499,102301467956.490386,4154373,980583,2603297,7738253
2018-01-09,EDGA Equities (J),46948889,21924553,24877957,93751399,1698632038.379400,1298902175.937700,1167806713.210200,4165340927.527300,392268,97778,203891,693937
2018-01-09,EDGX Equities (K),201270532,82192463,202259461,485722456,8379250141.631499,3858901972.945101,7863067588.449899,20101219703.026499,1341776,272416,1077703,2691895
2018-01-09,CHX (M),10960345,17425029,6031638,34417012,732631723.438200,1681747890.741601,523508329.719600,2937887943.899401,2377,4022,1561,7960
2018-01-09,NYSE (N),800959285,0,0,800959285,33231794170.676105,0.000000,0.000000,33231794170.676105,2384497,0,0,2384497
2018-01-09,NYSE Arca (P),198233242,259836649,148537065,606606956,8833925017.908203,13969957818.156798,6862692670.530899,29666575506.595900,1446454,655873,1032034,3134361
2018-01-09,NASDAQ (Q),303022299,111217423,523600255,937839977,14185424115.169803,6928466479.414201,27948935136.708893,49062825731.292897,2626199,419063,3064262,6109524
2018-01-09,IEX (V),99946382,15932639,47134969,163013990,4430050094.706600,977829710.145800,2595347258.693900,8003227063.546300,603922,65701,306523,976146
2018-01-09,NASDAQ PSX (X),16828079,15504085,16615468,48947632,696398844.089700,1051453935.656000,985780658.730200,2733633438.475900,138892,60839,145818,345549
2018-01-09,BYX Equities (Y),191048437,59364831,87552694,337965962,5918047591.535700,2882271243.643300,3399376456.249999,12199695291.428999,1525502,273848,767823,2567173
2018-01-09,BZX Equities (Z),189445295,80131814,98347277,367924386,7481733667.782599,5620837047.526999,5148556240.218700,18251126955.528298,1513904,339438,823537,2676879
2018-01-08,NYSE American (A),4156685,19877840,2794662,26829187,155661731.167000,153313395.651600,131026438.616500,440001565.435100,39118,47700,27314,114132
2018-01-08,NASDAQ BX (B),117924356,26530858,66932736,211387950,4982644550.000400,1404616684.215100,2991450281.997000,9378711516.212500,1211930,141946,705329,2059205
2018-01-08,FINRA / NYSE TRF (DN),84376206,44678176,84432246,213486628,3322743080.656800,1096024121.667300,2952502304.763599,7371269507.087699,220616,106315,264842,591773
2018-01-08,FINRA / Nasdaq TRF Carteret (DQ),1139032699,449782867,820919792,2409735358,46367708037.547089,22442319319.009906,37856221248.614809,106666248605.171804,3961243,960076,2647065,7568384
2018-01-08,EDGA Equities (J),40607029,17082089,22782756,80471874,1492964272.539100,1030317846.173800,1027398914.358500,3550681033.071400,350482,82193,193436,626111
2018-01-08,EDGX Equities (K),173708711,65441043,172961920,412111674,7268360821.546301,3095918724.645700,7346907183.768701,17711186729.960702,1184305,230259,1021208,2435772
2018-01-08,CHX (M),15452695,14876737,5854084,36183516,1053035451.787000,1256587114.845000,439293477.763000,2748916044.395000,1957,3312,1382,6651
2018-01-08,NYSE (N),809363845,0,0,809363845,35038082300.379801,0.000000,0.000000,35038082300.379801,2262189,0,0,2262189
2018-01-08,NYSE Arca (P),173892991,236178989,132497920,542569900,7660950708.190999,14493429878.825402,6265171318.868704,28419551905.885105,1304456,564816,983161,2852433
2018-01-08,NASDAQ (Q),265231685,93850340,522811233,881893258,12348855462.492901,5572515176.248101,28319440624.336906,46240811263.077908,2322956,354118,3012485,5689559
2018-01-08,IEX (V),82381211,16550570,41887533,140819314,3863391318.591000,997707525.131300,2662953824.568400,7524052668.290700,509051,63255,277197,849503
2018-01-08,NASDAQ PSX (X),13559988,10806777,13283165,37649930,572709476.438000,724260080.234900,799553887.032200,2096523443.705100,119894,45534,123344,288772
2018-01-08,BYX Equities (Y),164829222,53094720,77073309,294997251,5315023846.333600,2489332026.515200,3041238184.012500,10845594056.861300,1380417,252373,704144,2336934
2018-01-08,BZX Equities (Z),161652007,65038542,90780358,317470907,6356179844.451700,4322206831.010000,4535672727.933401,15214059403.395101,1324713,282694,760976,2368383
2018-01-05,NYSE American (A),4473169,18057823,3065845,25596837,204333815.820000,174301051.111000,167927459.480300,546562326.411300,42769,48986,29682,121437
2018-01-05,NASDAQ BX (B),117559317,29483744,67164468,214207529,4896202884.111300,1724187692.570100,2944385777.922299,9564776354.603699,1190255,156246,682440,2028941
2018-01-05,FINRA / NYSE TRF (DN),93023961,41529828,87101556,221655345,3604865463.244400,1261277382.716100,2979620343.029499,7845763188.989999,227522,104777,251212,583511
2018-01-05,FINRA / Nasdaq TRF Carteret (DQ),1128211201,434701776,799999470,2362912447,45290039456.156604,26994401123.812095,32894410103.679404,105178850683.648103,3943114,969122,2557928,7470164
2018-01-05,EDGA Equities (J),43184151,19825867,22317756,85327774,1616130909.911500,1288490210.492700,1093837610.768600,3998458731.172800,366224,90943,186717,643884
2018-01-05,EDGX Equities (K),178004683,65441485,171566649,415012817,7620630937.625403,3616220871.745799,6981028990.138002,18217880799.509204,1174899,247031,945018,2366948
2018-01-05,CHX (M),15294100,14785283,8877361,38956744,1187381189.872800,1715826818.449999,771635200.765000,3674843209.087799,2135,3881,1662,7678
2018-01-05,NYSE (N),771200801,0,0,771200801,33557409937.010298,0.000000,0.000000,33557409937.010298,2307337,0,0,2307337
2018-01-05,NYSE Arca (P),183975539,228854689,135201321,548031549,8422293562.573903,15033073757.517996,6472955851.413899,29928323171.505798,1363898,608535,975332,2947765
2018-01-05,NASDAQ (Q),274654437,98565786,502557487,875777710,13349158165.865399,6955016375.187699,27293513395.451698,47597687936.504796,2394336,397289,2873995,5665620
2018-01-05,IEX (V),83172604,16784694,41223184,141180482,3878484080.414000,1122887694.728600,2253431672.819000,7254803447.961600,522559,69728,274156,866443
2018-01-05,NASDAQ PSX (X),13512052,11971117,13561412,39044581,592227639.455900,954871090.594700,835791330.364500,2382890060.415100,121341,53483,122423,297247
2018-01-05,BYX Equities (Y),166360963,57578277,79879814,303819054,5394114554.031201,2948053526.963499,3209259851.208700,11551427932.203400,1393001,274468,705739,2373208
2018-01-05,BZX Equities (Z),166654773,68381663,91484074,326520510,6687159978.253899,5166114438.821602,4895128637.215901,16748403054.291402,1324610,304091,757144,2385845
2018-01-04,NYSE American (A),5204613,18557652,3312979,27075244,239156222.900000,228087799.415400,174537423.238800,641781445.554200,49559,48205,31989,129753
2018-01-04,NASDAQ BX (B),132007636,38629766,71195654,241833056,5452232907.476600,2074626327.004200,3097073766.267800,10623933000.748600,1308726,173732,728995,2211453
2018-01-04,FINRA / NYSE TRF (DN),100056807,41977123,89007409,231041339,3589765705.336200,1348274970.961700,3035674461.601399,7973715137.899299,235503,104836,265283,605622
2018-01-04,FINRA / Nasdaq TRF Carteret (DQ),1263534934,498435954,819686883,2581657771,46899979223.558398,28546639103.872504,34299381014.226900,109745999341.657802,4237036,1045776,2638614,7921426
2018-01-04,EDGA Equities (J),49249325,22237921,23461869,94949115,1733449492.437900,1362074762.613600,1123744541.540200,4219268796.591700,409498,99461,203014,711973
2018-01-04,EDGX Equities (K),203925531,72775130,174104006,450804667,8202238119.356101,3969033082.173601,7432385202.906998,19603656404.436700,1313128,283932,1008801,2605861
2018-01-04,CHX (M),12886872,12501481,7295187,32683540,912192963.825900,1652824182.430000,595552180.078500,3160569326.334400,2557,3678,1924,8159
2018-01-04,NYSE (N),895322697,0,0,895322697,36457866985.112599,0.000000,0.000000,36457866985.112599,2524299,0,0,2524299
2018-01-04,NYSE Arca (P),216987205,258563526,146415625,621966356,9242939300.814904,15861091571.788898,6837139686.753100,31941170559.356902,1573060,696360,1048718,3318138
2018-01-04,NASDAQ (Q),328352500,117996172,524726557,971075229,14784622652.477700,7873712312.036000,28276927659.591185,50935262624.104885,2738071,462299,3105191,6305561
2018-01-04,IEX (V),93570127,19502544,46482463,159555134,4372312642.753000,1390871589.334900,2407614783.419800,8170799015.507700,581331,76361,292326,950018
2018-01-04,NASDAQ PSX (X),15860215,14332412,15316869,45509496,640146091.364800,1051144524.161300,829146621.164800,2520437236.690900,137812,63487,134770,336069
2018-01-04,BYX Equities (Y),189988967,70292658,86690190,346971815,5925250045.124800,3396464728.629799,3339045586.272899,12660760360.027498,1521544,307440,761854,2590838
2018-01-04,BZX Equities (Z),190398398,81242618,95532696,367173712,7244358872.552599,5459085934.504498,4746741813.664999,17450186620.722096,1455580,345954,781362,2582896
2018-01-03,NYSE American (A),4895926,20968452,3759720,29624098,223980893.162500,236282920.656000,203676388.014700,663940201.833200,49502,58086,37035,144623
2018-01-03,NASDAQ BX (B),139224709,39183169,77417520,255825398,5906132907.512501,2028472836.947500,3491573763.508899,11426179507.968900,1427694,191317,796097,2415108
2018-01-03,FINRA / NYSE TRF (DN),94847337,38556723,86152775,219556835,3642670685.267300,1237123869.303600,3328238630.746899,8208033185.317799,230339,108491,250854,589684
2018-01-03,FINRA / Nasdaq TRF Carteret (DQ),1259022223,551895539,873623856,2684541618,48510757025.669391,31787698903.623493,38568458772.875517,118866914702.168401,4304996,1242753,2706122,8253871
2018-01-03,EDGA Equities (J),47523956,26141397,24739924,98405277,1728598217.229400,1586279922.624800,1212342496.985000,4527220636.839200,405038,120992,209824,735854
2018-01-03,EDGX Equities (K),191825986,79930084,174339479,446095549,7713043801.461999,4196553850.488101,7673923437.047705,19583521088.997805,1265596,303122,1007991,2576709
2018-01-03,CHX (M),10758671,14999247,5639676,31397594,382116339.021000,1787659554.940000,539500343.478000,2709276237.439000,2638,3489,1759,7886
2018-01-03,NYSE (N),808322916,0,0,808322916,33292369744.902302,0.000000,0.000000,33292369744.902302,2616409,0,0,2616409
2018-01-03,NYSE Arca (P),202426497,287032200,154699312,644158009,8903332741.222198,17255325698.229293,7452775399.390204,33611433838.841695,1528747,781380,1069751,3379878
2018-01-03,NASDAQ (Q),312239572,125009172,516575589,953824333,14144805081.300900,8025831157.807302,28770922619.760308,50941558858.868510,2682784,493579,3176488,6352851
2018-01-03,IEX (V),97586031,23292766,50792504,171671301,4609476169.209600,1389763078.237200,2878503145.441501,8877742392.888301,606128,86873,315456,1008457
2018-01-03,NASDAQ PSX (X),14999981,15417017,16602533,47019531,606418769.760000,1094251506.957300,939488777.411300,2640159054.128600,133469,65382,144386,343237
2018-01-03,BYX Equities (Y),185167282,79148081,88463607,352778970,5988773637.275400,3621775638.027000,3523205984.593701,13133755259.896101,1559061,346661,790880,2696602
2018-01-03,BZX Equities (Z),175190256,87963305,100329625,363483186,6737404059.691999,6206615139.478599,5192765025.210798,18136784224.381396,1419757,385227,822196,2627180
2018-01-02,NYSE American (A),4790083,18543715,3229481,26563279,219329069.520000,199065828.378400,167707375.415300,586102273.313700,46687,55659,31748,134094
2018-01-02,NASDAQ BX (B),126470750,38817164,72447537,237735451,5093678568.482601,2034258746.988000,3184966017.064800,10312903332.535401,1263163,189975,738185,2191323
2018-01-02,FINRA / NYSE TRF (DN),94091428,37828157,74187653,206107238,3526661506.631200,1458884816.182400,2748959540.935702,7734505863.749302,236723,110471,226437,573631
2018-01-02,FINRA / Nasdaq TRF Carteret (DQ),1178317937,556079976,735300806,2469698719,46067014888.305586,34460405673.438296,32868717674.299192,113396138236.043074,4123401,1130924,2502988,7757313
2018-01-02,EDGA Equities (J),46481959,25599071,23284859,95365889,1645533466.360000,1699753730.475400,1283878976.794800,4629166173.630200,392578,122805,204882,720265
2018-01-02,EDGX Equities (K),184103305,77656724,150592935,412352964,7410444009.094201,4455575241.967401,6896010371.876200,18762029622.937802,1209373,297926,942624,2449923
2018-01-02,CHX (M),17120792,9019294,4574618,30714704,1603932798.514900,874721992.759600,434353809.015000,2913008600.289500,2182,3582,1435,7199
2018-01-02,NYSE (N),815277329,0,0,815277329,35021987386.143396,0.000000,0.000000,35021987386.143396,2448081,0,0,2448081
2018-01-02,NYSE Arca (P),181481547,295922235,128434945,605838727,8214123496.286303,17807750668.767504,6778608284.425098,32800482449.478905,1382252,729767,976122,3088141
2018-01-02,NASDAQ (Q),298884327,120676952,506934990,926496269,13673183773.587999,8217246655.536202,29215790337.986110,51106220767.110311,2568353,483194,3025656,6077203
2018-01-02,IEX (V),86835570,19384215,39947433,146167218,3926529127.160000,1139104257.871200,2323419906.542600,7389053291.573800,533559,88061,267978,889598
2018-01-02,NASDAQ PSX (X),14245978,15364386,13802404,43412768,574973573.606700,1192299652.990600,803495238.835800,2570768465.433100,126884,66440,126065,319389
2018-01-02,BYX Equities (Y),180234347,75529503,85185492,340949342,5644350457.872900,3511765817.527400,3430072822.088699,12586189097.488999,1485286,334633,764605,2584524
2018-01-02,BZX Equities (Z),169103890,84039800,91785692,344929382,6484714597.582700,6094761345.991601,4828536612.854400,17408012556.428701,1358832,374343,775879,2509054
