Day,Market Participant,Tape A Shares,Tape B Shares,Tape C Shares,Total Shares,Tape A Notional,Tape B Notional,Tape C Notional,Total Notional,Tape A Trade Count,Tape B Trade Count,Tape C Trade Count,Total Trade Count
2008-01-02,AMEX (A),0,42202441,1400,42203841,0.0,0.0,0.0,0.0,0,78169,3,78172
2008-01-02,NSX (C),5352085,11489818,25148835,41990738,0.0,0.0,0.0,0.0,32684,29575,116835,179094
2008-01-02,NSX (DC),61334732,16477169,67706809,145518710,0.0,0.0,0.0,0.0,211518,31660,192544,435722
2008-01-02,NYSE (DN),139458100,52456900,157147169,349062169,0.0,0.0,0.0,0.0,895571,184453,823291,1903315
2008-01-02,Nasdaq (DQ),586912460,191403158,450119111,1228434729,0.0,0.0,0.0,0.0,848668,93479,553704,1495851
2008-01-02,ADF (D),51123400,6892600,38668400,96684400,0.0,0.0,0.0,0.0,190759,14637,126217,331613
2008-01-02,ISE (I),52834100,559000,2430600,55823700,0.0,0.0,0.0,0.0,329442,753,8006,338201
2008-01-02,CHX (M),15611493,5435000,8452432,29498925,0.0,0.0,0.0,0.0,22193,1939,9696,33828
2008-01-02,NYSE (N),1421111320,0,0,1421111320,0.0,0.0,0.0,0.0,4844141,0,0,4844141
2008-01-02,NYSE Arca (P),423825100,256488715,339385061,1019698876,0.0,0.0,0.0,0.0,2587870,689558,1558008,4835436
2008-01-02,Nasdaq (Q),671299775,306442852,1055808494,2033551121,0.0,0.0,0.0,0.0,3631714,887902,4381319,8900935
2008-01-02,CBOE (W),2471500,3493300,2244300,8209100,0.0,0.0,0.0,0.0,1806,1829,884,4519
2008-01-02,PHLX (X),3641300,136600,3737607,7515507,0.0,0.0,0.0,0.0,2879,63,3157,6099
2008-01-03,AMEX (A),0,35978413,2300,35980713,0.0,0.0,0.0,0.0,0,68095,3,68098
2008-01-03,NSX (C),4581652,8990200,29822766,43394618,0.0,0.0,0.0,0.0,25731,23809,127526,177066
2008-01-03,NSX (DC),67389460,17602015,79914877,164906352,0.0,0.0,0.0,0.0,233223,32213,251151,516587
2008-01-03,NYSE (DN),129110000,40646200,134463308,304219508,0.0,0.0,0.0,0.0,828805,144594,714611,1688010
2008-01-03,Nasdaq (DQ),657718990,126720998,467926966,1252366954,0.0,0.0,0.0,0.0,892423,86536,551513,1530472
2008-01-03,ADF (D),54947100,6807200,38959500,100713800,0.0,0.0,0.0,0.0,183799,14658,119151,317608
2008-01-03,ISE (I),45474000,495200,2674100,48643300,0.0,0.0,0.0,0.0,285994,581,7458,294033
2008-01-03,CHX (M),22367901,5612300,8611103,36591304,0.0,0.0,0.0,0.0,22788,1628,8595,33011
2008-01-03,NYSE (N),1322824980,0,0,1322824980,0.0,0.0,0.0,0.0,4406086,0,0,4406086
2008-01-03,NYSE Arca (P),424620667,194940876,279628615,899190158,0.0,0.0,0.0,0.0,2493857,524742,1287866,4306465
2008-01-03,Nasdaq (Q),672088983,233716069,975894274,1881699326,0.0,0.0,0.0,0.0,3543931,679789,3990248,8213968
2008-01-03,CBOE (W),2460500,6249800,3118700,11829000,0.0,0.0,0.0,0.0,1942,1265,689,3896
2008-01-03,PHLX (X),5592100,327100,1919075,7838275,0.0,0.0,0.0,0.0,4313,50,2946,7309
2008-01-04,AMEX (A),0,43605486,386400,43991886,0.0,0.0,0.0,0.0,0,84535,163,84698
2008-01-04,NSX (C),5739881,14240338,49060593,69040812,0.0,0.0,0.0,0.0,31326,33362,194586,259274
2008-01-04,NSX (DC),98049444,27035521,93110337,218195302,0.0,0.0,0.0,0.0,335433,52877,279190,667500
2008-01-04,NYSE (DN),161799200,67787400,180041260,409627860,0.0,0.0,0.0,0.0,1024040,222543,932007,2178590
2008-01-04,Nasdaq (DQ),734272620,172105042,551053485,1457431147,0.0,0.0,0.0,0.0,996899,115428,640369,1752696
2008-01-04,ADF (D),59226720,12264300,57749300,129240320,0.0,0.0,0.0,0.0,207969,20548,163269,391786
2008-01-04,ISE (I),62432200,737600,3837300,67007100,0.0,0.0,0.0,0.0,394871,747,11698,407316
2008-01-04,CHX (M),23439500,2941800,8307890,34689190,0.0,0.0,0.0,0.0,28535,1747,11108,41390
2008-01-04,NYSE (N),1647468490,0,0,1647468490,0.0,0.0,0.0,0.0,5357110,0,0,5357110
2008-01-04,NYSE Arca (P),531387750,315164387,388294455,1234846592,0.0,0.0,0.0,0.0,3117892,779464,1608844,5506200
2008-01-04,Nasdaq (Q),805338400,345823896,1241866596,2393028892,0.0,0.0,0.0,0.0,4277066,985998,4803251,10066315
2008-01-04,CBOE (W),4551800,3913500,724200,9189500,0.0,0.0,0.0,0.0,2525,2137,880,5542
2008-01-04,PHLX (X),5380800,2072700,1836667,9290167,0.0,0.0,0.0,0.0,3658,56,3345,7059
2008-01-07,AMEX (A),0,50985276,275400,51260676,0.0,0.0,0.0,0.0,0,82118,165,82283
2008-01-07,NSX (C),10931904,13730348,53248710,77910962,0.0,0.0,0.0,0.0,67044,34658,226580,328282
2008-01-07,NSX (DC),75845874,22846883,75546887,174239644,0.0,0.0,0.0,0.0,291558,44891,249336,585785
2008-01-07,NYSE (DN),182081000,69633000,209034682,460748682,0.0,0.0,0.0,0.0,1186407,247751,1075120,2509278
2008-01-07,Nasdaq (DQ),732965260,179837882,573042392,1485845534,0.0,0.0,0.0,0.0,1050668,108768,683718,1843154
2008-01-07,ADF (D),43718600,8443800,46015200,98177600,0.0,0.0,0.0,0.0,165210,17014,143101,325325
2008-01-07,ISE (I),65100000,824400,5324500,71248900,0.0,0.0,0.0,0.0,415093,955,14312,430360
2008-01-07,CHX (M),22208650,1756200,6342867,30307717,0.0,0.0,0.0,0.0,28289,1828,9812,39929
2008-01-07,NYSE (N),1712692940,0,0,1712692940,0.0,0.0,0.0,0.0,5979457,0,0,5979457
2008-01-07,NYSE Arca (P),544435008,331865375,425628668,1301929051,0.0,0.0,0.0,0.0,3291985,858292,1872119,6022396
2008-01-07,Nasdaq (Q),829937777,394025786,1308671630,2532635193,0.0,0.0,0.0,0.0,4617205,1144882,5319053,11081140
2008-01-07,CBOE (W),2706000,4256200,870800,7833000,0.0,0.0,0.0,0.0,3922,2909,1082,7913
2008-01-07,PHLX (X),3808300,271500,2481954,6561754,0.0,0.0,0.0,0.0,2523,88,2708,5319
2008-01-08,AMEX (A),0,48461250,117900,48579150,0.0,0.0,0.0,0.0,0,90555,56,90611
2008-01-08,NSX (C),13231299,17610010,49511370,80352679,0.0,0.0,0.0,0.0,79456,41884,200325,321665
2008-01-08,NSX (DC),109211831,30087023,78306400,217605254,0.0,0.0,0.0,0.0,361702,51557,234451,647710
2008-01-08,NYSE (DN),205419300,85110900,200048770,490578970,0.0,0.0,0.0,0.0,1331776,273188,1025262,2630226
2008-01-08,Nasdaq (DQ),852087540,210332651,586533340,1648953531,0.0,0.0,0.0,0.0,1009871,104615,617537,1732023
2008-01-08,ADF (D),51492200,10900300,43208400,105600900,0.0,0.0,0.0,0.0,196082,19828,148167,364077
2008-01-08,ISE (I),69849400,637600,4928500,75415500,0.0,0.0,0.0,0.0,437389,779,14514,452682
2008-01-08,CHX (M),30960750,3878703,9459232,44298685,0.0,0.0,0.0,0.0,26029,1621,10345,37995
2008-01-08,NYSE (N),1844092100,0,0,1844092100,0.0,0.0,0.0,0.0,6054033,0,0,6054033
2008-01-08,NYSE Arca (P),595765506,392191962,438966086,1426923554,0.0,0.0,0.0,0.0,3465178,942583,1910145,6317906
2008-01-08,Nasdaq (Q),975082035,450151655,1301069086,2726302776,0.0,0.0,0.0,0.0,5225695,1220308,5178697,11624700
2008-01-08,CBOE (W),2463200,4223800,2720700,9407700,0.0,0.0,0.0,0.0,4182,2305,1220,7707
2008-01-08,PHLX (X),4960700,166400,2239240,7366340,0.0,0.0,0.0,0.0,2965,61,2158,5184
2008-01-09,AMEX (A),0,45994075,265600,46259675,0.0,0.0,0.0,0.0,0,91706,152,91858
2008-01-09,NSX (C),5662589,17398691,46067736,69129016,0.0,0.0,0.0,0.0,33152,46013,187487,266652
2008-01-09,NSX (DC),116762802,32613722,99536351,248912875,0.0,0.0,0.0,0.0,358409,62145,322333,742887
2008-01-09,NYSE (DN),181376300,71147400,171265068,423788768,0.0,0.0,0.0,0.0,1064403,254208,894981,2213592
2008-01-09,Nasdaq (DQ),954214730,218566135,617153300,1789934165,0.0,0.0,0.0,0.0,1157184,123024,702612,1982820
2008-01-09,ADF (D),68898550,12690900,58041000,139630450,0.0,0.0,0.0,0.0,255620,28992,191175,475787
2008-01-09,ISE (I),83242800,854800,5844300,89941900,0.0,0.0,0.0,0.0,497990,1030,17282,516302
2008-01-09,CHX (M),26402450,5206405,14743977,46352832,0.0,0.0,0.0,0.0,30553,1609,10777,42939
2008-01-09,NYSE (N),2056791400,0,0,2056791400,0.0,0.0,0.0,0.0,6765557,0,0,6765557
2008-01-09,NYSE Arca (P),685816525,424783800,494301656,1604901981,0.0,0.0,0.0,0.0,4039721,1058935,2198694,7297350
2008-01-09,Nasdaq (Q),1131313751,498259533,1424704155,3054277439,0.0,0.0,0.0,0.0,6037416,1368824,5861106,13267346
2008-01-09,CBOE (W),2849400,4499900,2265000,9614300,0.0,0.0,0.0,0.0,6123,2380,1479,9982
2008-01-09,PHLX (X),7517000,157500,2028544,9703044,0.0,0.0,0.0,0.0,2176,67,3246,5489
2008-01-10,AMEX (A),0,48363974,508100,48872074,0.0,0.0,0.0,0.0,0,92192,404,92596
2008-01-10,NSX (C),6218186,20692255,34996737,61907178,0.0,0.0,0.0,0.0,34288,49774,147430,231492
2008-01-10,NSX (DC),81387926,23679497,59720963,164788386,0.0,0.0,0.0,0.0,253567,47149,181677,482393
2008-01-10,NYSE (DN),183883700,80021600,167507807,431413107,0.0,0.0,0.0,0.0,1205864,253172,919189,2378225
2008-01-10,Nasdaq (DQ),802252060,238463635,545448105,1586163800,0.0,0.0,0.0,0.0,979718,104217,604556,1688491
2008-01-10,ADF (D),47459020,12250600,44370200,104079820,0.0,0.0,0.0,0.0,180953,28415,139802,349170
2008-01-10,ISE (I),71181000,1534200,6444500,79159700,0.0,0.0,0.0,0.0,454956,1956,20027,476939
2008-01-10,CHX (M),26947055,3209600,8101225,38257880,0.0,0.0,0.0,0.0,27365,1475,4965,33805
2008-01-10,NYSE (N),2060028470,0,0,2060028470,0.0,0.0,0.0,0.0,6941249,0,0,6941249
2008-01-10,NYSE Arca (P),712238275,473458529,437388658,1623085462,0.0,0.0,0.0,0.0,4228379,1155531,1988451,7372361
2008-01-10,Nasdaq (Q),1151182624,549152638,1397867022,3098202284,0.0,0.0,0.0,0.0,6315986,1472229,5828522,13616737
2008-01-10,CBOE (W),3845000,3635400,2628400,10108800,0.0,0.0,0.0,0.0,7759,2629,1721,12109
2008-01-10,PHLX (X),5319900,681800,2195689,8197389,0.0,0.0,0.0,0.0,1205,94,1188,2487
2008-01-11,AMEX (A),0,41452488,5700,41458188,0.0,0.0,0.0,0.0,0,80101,4,80105
2008-01-11,NSX (C),4176562,9425333,32821954,46423849,0.0,0.0,0.0,0.0,22396,20794,113576,156766
2008-01-11,NSX (DC),81278597,26906423,71359370,179544390,0.0,0.0,0.0,0.0,255113,48964,226803,530880
2008-01-11,NYSE (DN),177986400,77116500,172268290,427371190,0.0,0.0,0.0,0.0,1113651,249459,891796,2254906
2008-01-11,Nasdaq (DQ),763177450,193636180,516868110,1473681740,0.0,0.0,0.0,0.0,954005,103275,596299,1653579
2008-01-11,ADF (D),49800100,9494100,43469300,102763500,0.0,0.0,0.0,0.0,171115,22358,137570,331043
2008-01-11,ISE (I),64900800,9265200,20166700,94332700,0.0,0.0,0.0,0.0,411009,27787,94158,532954
2008-01-11,CHX (M),29242660,6651200,5373347,41267207,0.0,0.0,0.0,0.0,28771,1778,7504,38053
2008-01-11,NYSE (N),1786495940,0,0,1786495940,0.0,0.0,0.0,0.0,5960670,0,0,5960670
2008-01-11,NYSE Arca (P),577086548,347321053,379638385,1304045986,0.0,0.0,0.0,0.0,3248760,867449,1664417,5780626
2008-01-11,Nasdaq (Q),927783533,436597840,1215413764,2579795137,0.0,0.0,0.0,0.0,4905652,1148997,4834824,10889473
2008-01-11,CBOE (W),4170900,8621200,2228200,15020300,0.0,0.0,0.0,0.0,6365,1642,1246,9253
2008-01-11,PHLX (X),4417200,766700,1419324,6603224,0.0,0.0,0.0,0.0,1713,114,2240,4067
2008-01-14,AMEX (A),0,39816412,3200,39819612,0.0,0.0,0.0,0.0,0,67901,3,67904
2008-01-14,NSX (C),3521305,9913335,57316150,70750790,0.0,0.0,0.0,0.0,18240,24777,198438,241455
2008-01-14,NSX (DC),69003136,21619757,43578886,134201779,0.0,0.0,0.0,0.0,212167,42169,133797,388133
2008-01-14,NYSE (DN),150471100,47486100,161557615,359514815,0.0,0.0,0.0,0.0,920226,167196,823650,1911072
2008-01-14,Nasdaq (DQ),687182100,155913478,503112304,1346207882,0.0,0.0,0.0,0.0,861233,101395,551087,1513715
2008-01-14,ADF (D),54379900,7930800,49452100,111762800,0.0,0.0,0.0,0.0,178579,17515,129445,325539
2008-01-14,ISE (I),49918000,926000,4378800,55222800,0.0,0.0,0.0,0.0,307499,2478,15718,325695
2008-01-14,CHX (M),24949160,5880100,7957723,38786983,0.0,0.0,0.0,0.0,25221,1486,9216,35923
2008-01-14,NYSE (N),1409426010,0,0,1409426010,0.0,0.0,0.0,0.0,4611253,0,0,4611253
2008-01-14,NYSE Arca (P),472169377,248548656,358730173,1079448206,0.0,0.0,0.0,0.0,2698385,612847,1547414,4858646
2008-01-14,Nasdaq (Q),727302290,280737362,1050363616,2058403268,0.0,0.0,0.0,0.0,3978392,768670,4171978,8919040
2008-01-14,CBOE (W),2392200,3053100,4055300,9500600,0.0,0.0,0.0,0.0,2964,1659,1320,5943
2008-01-14,PHLX (X),7759200,651100,2485166,10895466,0.0,0.0,0.0,0.0,2464,138,1939,4541
2008-01-15,AMEX (A),0,43905960,100500,44006460,0.0,0.0,0.0,0.0,0,80952,166,81118
2008-01-15,NSX (C),4611283,16211913,64111619,84934815,0.0,0.0,0.0,0.0,23304,40097,241895,305296
2008-01-15,NSX (DC),76956618,27049792,43200305,147206715,0.0,0.0,0.0,0.0,254462,54748,151894,461104
2008-01-15,NYSE (DN),193457400,78040900,190257478,461755778,0.0,0.0,0.0,0.0,1204300,262878,997317,2464495
2008-01-15,Nasdaq (DQ),804898200,194979228,491671291,1491548719,0.0,0.0,0.0,0.0,1033616,122845,612414,1768875
2008-01-15,ADF (D),48687300,10278500,45798200,104764000,0.0,0.0,0.0,0.0,180186,22331,143981,346498
2008-01-15,ISE (I),67478400,1677000,6132000,75287400,0.0,0.0,0.0,0.0,413298,4867,21700,439865
2008-01-15,CHX (M),16301172,3315800,4130521,23747493,0.0,0.0,0.0,0.0,13118,730,2367,16215
2008-01-15,NYSE (N),1815728400,0,0,1815728400,0.0,0.0,0.0,0.0,5832144,0,0,5832144
2008-01-15,NYSE Arca (P),590080680,353954506,428823068,1372858254,0.0,0.0,0.0,0.0,3294430,890823,1841478,6026731
2008-01-15,Nasdaq (Q),927550541,394528969,1252735699,2574815209,0.0,0.0,0.0,0.0,4910359,1091214,5023359,11024932
2008-01-15,CBOE (W),3595700,2818900,4753200,11167800,0.0,0.0,0.0,0.0,3821,1232,1492,6545
2008-01-15,PHLX (X),3892400,330000,2225980,6448380,0.0,0.0,0.0,0.0,2609,139,2370,5118
2008-01-16,AMEX (A),0,54082622,92200,54174822,0.0,0.0,0.0,0.0,0,98474,158,98632
2008-01-16,NSX (C),6442738,20221202,85616449,112280389,0.0,0.0,0.0,0.0,34654,54559,301480,390693
2008-01-16,NSX (DC),141804060,52295406,117085706,311185172,0.0,0.0,0.0,0.0,655014,135197,484049,1274260
2008-01-16,NYSE (DN),186220000,74299000,201479747,461998747,0.0,0.0,0.0,0.0,1133590,247493,993064,2374147
2008-01-16,Nasdaq (DQ),900718810,263719511,751522337,1915960658,0.0,0.0,0.0,0.0,1084502,150186,727545,1962233
2008-01-16,ADF (D),59058230,13175300,72951200,145184730,0.0,0.0,0.0,0.0,213256,31038,188568,432862
2008-01-16,ISE (I),91215200,1914700,7563400,100693300,0.0,0.0,0.0,0.0,556632,5084,26022,587738
2008-01-16,CHX (M),22296450,4888300,22196124,49380874,0.0,0.0,0.0,0.0,22083,1243,7502,30828
2008-01-16,NYSE (N),2104050330,0,0,2104050330,0.0,0.0,0.0,0.0,6958652,0,0,6958652
2008-01-16,NYSE Arca (P),715271250,465978356,572335992,1753585598,0.0,0.0,0.0,0.0,4115663,1164077,2369142,7648882
2008-01-16,Nasdaq (Q),1159310289,554217677,1724655398,3438183364,0.0,0.0,0.0,0.0,6282844,1414689,6414881,14112414
2008-01-16,CBOE (W),4501500,6108600,5348000,15958100,0.0,0.0,0.0,0.0,6485,2054,1645,10184
2008-01-16,PHLX (X),3955100,2158500,2398290,8511890,0.0,0.0,0.0,0.0,1819,323,5054,7196
2008-01-17,AMEX (A),0,69006357,49000,69055357,0.0,0.0,0.0,0.0,0,97773,83,97856
2008-01-17,NSX (C),6092163,21960095,68984771,97037029,0.0,0.0,0.0,0.0,32397,56770,263288,352455
2008-01-17,NSX (DC),102235800,30296503,55172694,187704997,0.0,0.0,0.0,0.0,339593,65310,184709,589612
2008-01-17,NYSE (DN),232186900,100960300,237453052,570600252,0.0,0.0,0.0,0.0,1507244,332852,1194083,3034179
2008-01-17,Nasdaq (DQ),883177870,230927462,569383113,1683488445,0.0,0.0,0.0,0.0,1104724,144603,601541,1850868
2008-01-17,ADF (D),52288300,13934200,53341200,119563700,0.0,0.0,0.0,0.0,196152,25999,147713,369864
2008-01-17,ISE (I),91430200,2889600,8226500,102546300,0.0,0.0,0.0,0.0,578651,7512,31173,617336
2008-01-17,CHX (M),32618155,8660102,7316560,48594817,0.0,0.0,0.0,0.0,37775,1646,12252,51673
2008-01-17,NYSE (N),2168837090,0,0,2168837090,0.0,0.0,0.0,0.0,7063486,0,0,7063486
2008-01-17,NYSE Arca (P),760864316,488045629,467383816,1716293761,0.0,0.0,0.0,0.0,4338100,1214169,2043800,7596069
2008-01-17,Nasdaq (Q),1214194200,580117407,1449816565,3244128172,0.0,0.0,0.0,0.0,6429252,1482153,5579720,13491125
2008-01-17,CBOE (W),5965000,4171300,4719500,14855800,0.0,0.0,0.0,0.0,10519,2201,1848,14568
2008-01-17,PHLX (X),4163000,1665300,1739143,7567443,0.0,0.0,0.0,0.0,2305,463,4302,7070
2008-01-18,AMEX (A),0,65754054,74400,65828454,0.0,0.0,0.0,0.0,0,96245,155,96400
2008-01-18,NSX (C),7569309,19620888,69963653,97153850,0.0,0.0,0.0,0.0,40258,56689,266313,363260
2008-01-18,NSX (DC),139854856,39531558,90696926,270083340,0.0,0.0,0.0,0.0,478975,78891,295813,853679
2008-01-18,NYSE (DN),251835400,104702300,234114427,590652127,0.0,0.0,0.0,0.0,1674421,359911,1224040,3258372
2008-01-18,Nasdaq (DQ),900374270,215637792,577308082,1693320144,0.0,0.0,0.0,0.0,1147132,164282,660445,1971859
2008-01-18,ADF (D),16079800,3240800,20661600,39982200,0.0,0.0,0.0,0.0,60914,5465,66042,132421
2008-01-18,ISE (I),93029500,2386100,6617300,102032900,0.0,0.0,0.0,0.0,611252,5598,23553,640403
2008-01-18,CHX (M),29780400,13830500,7789055,51399955,0.0,0.0,0.0,0.0,30146,2911,11239,44296
2008-01-18,NYSE (N),2445481330,0,0,2445481330,0.0,0.0,0.0,0.0,7360244,0,0,7360244
2008-01-18,NYSE Arca (P),792540901,470492065,457729132,1720762098,0.0,0.0,0.0,0.0,4495401,1175422,2069627,7740450
2008-01-18,Nasdaq (Q),1277376039,573062600,1745493661,3595932300,0.0,0.0,0.0,0.0,6864074,1489218,5822733,14176025
2008-01-18,CBOE (W),6528000,5081400,2920200,14529600,0.0,0.0,0.0,0.0,11648,2076,2097,15821
2008-01-18,PHLX (X),5686200,1336700,2069629,9092529,0.0,0.0,0.0,0.0,1579,298,1298,3175
2008-01-22,AMEX (A),0,73775767,229900,74005667,0.0,0.0,0.0,0.0,0,99020,255,99275
2008-01-22,NSX (C),16804361,26523507,81854101,125181969,0.0,0.0,0.0,0.0,94098,74455,329668,498221
2008-01-22,NSX (DC),124148605,39574712,81015573,244738890,0.0,0.0,0.0,0.0,447928,81092,261962,790982
2008-01-22,NYSE (DN),281559500,129673000,219371409,630603909,0.0,0.0,0.0,0.0,1926142,453103,1185093,3564338
2008-01-22,Nasdaq (DQ),844878600,271603330,499810898,1616292828,0.0,0.0,0.0,0.0,1214587,171866,639925,2026378
2008-01-22,ADF (D),18124150,2774700,17286200,38185050,0.0,0.0,0.0,0.0,69185,6321,56466,131972
2008-01-22,ISE (I),136667900,1466400,6949200,145083500,0.0,0.0,0.0,0.0,890152,3245,18364,911761
2008-01-22,CHX (M),25790700,4996100,7432516,38219316,0.0,0.0,0.0,0.0,21578,2467,9515,33560
2008-01-22,NYSE (N),2545563120,0,0,2545563120,0.0,0.0,0.0,0.0,8513830,0,0,8513830
2008-01-22,NYSE Arca (P),880046240,592951204,547141608,2020139052,0.0,0.0,0.0,0.0,5251402,1412360,2437104,9100866
2008-01-22,Nasdaq (Q),1553606398,758313379,1841695300,4153615077,0.0,0.0,0.0,0.0,8600553,1944429,6884482,17429464
2008-01-22,CBOE (W),7019800,4712300,2025100,13757200,0.0,0.0,0.0,0.0,18287,2654,2442,23383
2008-01-22,PHLX (X),4628300,169800,909839,5707939,0.0,0.0,0.0,0.0,831,93,1053,1977
2008-01-23,AMEX (A),0,54953229,365000,55318229,0.0,0.0,0.0,0.0,0,88919,330,89249
2008-01-23,NSX (C),17132319,34639289,95929837,147701445,0.0,0.0,0.0,0.0,81053,92516,395800,569369
2008-01-23,NSX (DC),152640361,41631939,94863931,289136231,0.0,0.0,0.0,0.0,569228,86498,326489,982215
2008-01-23,NYSE (DN),349256200,148303000,297102247,794661447,0.0,0.0,0.0,0.0,2312197,492671,1551566,4356434
2008-01-23,Nasdaq (DQ),1132695690,334708187,673638780,2141042657,0.0,0.0,0.0,0.0,1331801,186467,793925,2312193
2008-01-23,ADF (D),21322320,4742200,19828900,45893420,0.0,0.0,0.0,0.0,76906,8872,59643,145421
2008-01-23,ISE (I),151129900,2527500,8620300,162277700,0.0,0.0,0.0,0.0,951249,4163,23692,979104
2008-01-23,CHX (M),37350458,7704000,8736067,53790525,0.0,0.0,0.0,0.0,38485,3078,13132,54695
2008-01-23,NYSE (N),2820391570,0,0,2820391570,0.0,0.0,0.0,0.0,9439411,0,0,9439411
2008-01-23,NYSE Arca (P),1095034710,636192230,648936102,2380163042,0.0,0.0,0.0,0.0,6412150,1556983,2894676,10863809
2008-01-23,Nasdaq (Q),1680575543,795802260,1883204706,4359582509,0.0,0.0,0.0,0.0,9057575,1974832,7594140,18626547
2008-01-23,CBOE (W),15009300,5892400,3179400,24081100,0.0,0.0,0.0,0.0,20988,2170,3135,26293
2008-01-23,PHLX (X),10111500,2497900,2925307,15534707,0.0,0.0,0.0,0.0,1248,275,1680,3203
2008-01-24,AMEX (A),0,55051717,26100,55077817,0.0,0.0,0.0,0.0,0,71852,86,71938
2008-01-24,NSX (C),13762407,20371743,76391289,110525439,0.0,0.0,0.0,0.0,64287,52193,298759,415239
2008-01-24,NSX (DC),142762784,34408553,112976903,290148240,0.0,0.0,0.0,0.0,491640,69095,330047,890782
2008-01-24,NYSE (DN),281459300,106090800,247508831,635058931,0.0,0.0,0.0,0.0,1797421,387213,1305660,3490294
2008-01-24,Nasdaq (DQ),978820870,300013622,626776586,1905611078,0.0,0.0,0.0,0.0,1173588,142888,747557,2064033
2008-01-24,ADF (D),14950420,2906000,15356400,33212820,0.0,0.0,0.0,0.0,57384,6351,51186,114921
2008-01-24,ISE (I),110424100,1940000,7067500,119431600,0.0,0.0,0.0,0.0,691043,2230,18048,711321
2008-01-24,CHX (M),12942085,3482050,3681260,20105395,0.0,0.0,0.0,0.0,8005,389,3788,12182
2008-01-24,NYSE (N),2173744740,0,0,2173744740,0.0,0.0,0.0,0.0,7098174,0,0,7098174
2008-01-24,NYSE Arca (P),757127000,392894029,511036734,1661057763,0.0,0.0,0.0,0.0,4329128,995784,2207551,7532463
2008-01-24,Nasdaq (Q),1201406652,455886765,1507695783,3164989200,0.0,0.0,0.0,0.0,6485760,1234106,5919653,13639519
2008-01-24,CBOE (W),8643100,7490500,4616200,20749800,0.0,0.0,0.0,0.0,12256,2212,1946,16414
2008-01-24,PHLX (X),5058100,308500,3880785,9247385,0.0,0.0,0.0,0.0,995,274,1556,2825
2008-01-25,AMEX (A),0,36300807,21400,36322207,0.0,0.0,0.0,0.0,0,48920,55,48975
2008-01-25,NSX (C),43215666,31939542,60220423,135375631,0.0,0.0,0.0,0.0,163983,64852,220436,449271
2008-01-25,NSX (DC),73279495,19537022,84888513,177705030,0.0,0.0,0.0,0.0,267203,41752,252543,561498
2008-01-25,NYSE (DN),222804800,101376900,226811920,550993620,0.0,0.0,0.0,0.0,1489719,335090,1165160,2989969
2008-01-25,Nasdaq (DQ),847566635,214260905,548687143,1610514683,0.0,0.0,0.0,0.0,966498,139001,641676,1747175
2008-01-25,ADF (D),13564440,1721200,13040300,28325940,0.0,0.0,0.0,0.0,51815,4452,47495,103762
2008-01-25,ISE (I),79298200,1095000,5517000,85910200,0.0,0.0,0.0,0.0,525548,1975,13962,541485
2008-01-25,CHX (M),32222539,4067400,9326649,45616588,0.0,0.0,0.0,0.0,23670,2430,11978,38078
2008-01-25,NYSE (N),1879149091,0,0,1879149091,0.0,0.0,0.0,0.0,6350160,0,0,6350160
2008-01-25,NYSE Arca (P),673861320,360050213,426329862,1460241395,0.0,0.0,0.0,0.0,3995072,944410,1859666,6799148
2008-01-25,Nasdaq (Q),1025217256,431365798,1325899026,2782482080,0.0,0.0,0.0,0.0,5706974,1133329,5277576,12117879
2008-01-25,CBOE (W),5827700,2012200,1557100,9397000,0.0,0.0,0.0,0.0,11547,1547,1322,14416
2008-01-25,PHLX (X),4764300,249800,1323427,6337527,0.0,0.0,0.0,0.0,1002,316,2770,4088
2008-01-28,AMEX (A),0,50750989,115400,50866389,0.0,0.0,0.0,0.0,0,66667,352,67019
2008-01-28,NSX (C),37753405,25980271,49096725,112830401,0.0,0.0,0.0,0.0,141753,55765,208365,405883
2008-01-28,NSX (DC),69704129,16646305,62860504,149210938,0.0,0.0,0.0,0.0,255290,40277,204168,499735
2008-01-28,NYSE (DN),192281400,80596600,202225610,475103610,0.0,0.0,0.0,0.0,1306363,283326,1050469,2640158
2008-01-28,Nasdaq (DQ),695181345,158437661,443198767,1296817773,0.0,0.0,0.0,0.0,908526,120644,523098,1552268
2008-01-28,ADF (D),10962200,1633800,9950000,22546000,0.0,0.0,0.0,0.0,41837,3231,35609,80677
2008-01-28,ISE (I),68513800,1294230,3817400,73625430,0.0,0.0,0.0,0.0,463281,1567,10905,475753
2008-01-28,CHX (M),18395430,3575800,6663447,28634677,0.0,0.0,0.0,0.0,19591,2280,10093,31964
2008-01-28,NYSE (N),1638367246,0,0,1638367246,0.0,0.0,0.0,0.0,5501450,0,0,5501450
2008-01-28,NYSE Arca (P),569364490,308828483,348410012,1226602985,0.0,0.0,0.0,0.0,3368318,808134,1637247,5813699
2008-01-28,Nasdaq (Q),791972205,343053198,1041876421,2176901824,0.0,0.0,0.0,0.0,4421067,922717,4222683,9566467
2008-01-28,CBOE (W),4908800,4969100,1665100,11543000,0.0,0.0,0.0,0.0,9000,2398,1191,12589
2008-01-28,PHLX (X),2555500,1277400,1234416,5067316,0.0,0.0,0.0,0.0,1240,162,1306,2708
2008-01-29,AMEX (A),0,36786122,129200,36915322,0.0,0.0,0.0,0.0,0,61272,406,61678
2008-01-29,NSX (C),42170191,22445725,59673487,124289403,0.0,0.0,0.0,0.0,152517,50436,223241,426194
2008-01-29,NSX (DC),74367124,14680652,63473570,152521346,0.0,0.0,0.0,0.0,263119,29707,188397,481223
2008-01-29,NYSE (DN),208598400,67065400,194679933,470343733,0.0,0.0,0.0,0.0,1329792,225448,978579,2533819
2008-01-29,Nasdaq (DQ),791097701,156260595,499613525,1446971821,0.0,0.0,0.0,0.0,978063,105735,564297,1648095
2008-01-29,ADF (D),11303830,1407500,8605000,21316330,0.0,0.0,0.0,0.0,41387,3314,30062,74763
2008-01-29,ISE (I),76127280,1220300,4590100,81937680,0.0,0.0,0.0,0.0,478179,2119,12854,493152
2008-01-29,CHX (M),19508322,6288000,8392082,34188404,0.0,0.0,0.0,0.0,20696,1727,9752,32175
2008-01-29,NYSE (N),1554786618,0,0,1554786618,0.0,0.0,0.0,0.0,5094744,0,0,5094744
2008-01-29,NYSE Arca (P),554864375,242023000,348006588,1144893963,0.0,0.0,0.0,0.0,3213753,632872,1550439,5397064
2008-01-29,Nasdaq (Q),864751476,297216812,1106980296,2268948584,0.0,0.0,0.0,0.0,4581023,805135,4246480,9632638
2008-01-29,CBOE (W),3984900,1828900,2125400,7939200,0.0,0.0,0.0,0.0,6801,904,1298,9003
2008-01-29,PHLX (X),5257800,1114600,943384,7315784,0.0,0.0,0.0,0.0,711,140,1573,2424
2008-01-30,AMEX (A),0,44337543,194400,44531943,0.0,0.0,0.0,0.0,0,68726,603,69329
2008-01-30,NSX (C),41346079,35402807,68565037,145313923,0.0,0.0,0.0,0.0,157909,78938,245281,482128
2008-01-30,NSX (DC),59119687,15767772,60142089,135029548,0.0,0.0,0.0,0.0,226955,31720,178518,437193
2008-01-30,NYSE (DN),202631200,102178600,213785928,518595728,0.0,0.0,0.0,0.0,1358737,344825,1094271,2797833
2008-01-30,Nasdaq (DQ),764898041,215710805,556128478,1536737324,0.0,0.0,0.0,0.0,950575,140822,580328,1671725
2008-01-30,ADF (D),11891120,2405900,9706900,24003920,0.0,0.0,0.0,0.0,42871,4241,32385,79497
2008-01-30,ISE (I),101590100,1917510,5661900,109169510,0.0,0.0,0.0,0.0,646888,2167,14008,663063
2008-01-30,CHX (M),23420800,7752300,7975797,39148897,0.0,0.0,0.0,0.0,21368,2081,10197,33646
2008-01-30,NYSE (N),1800240954,0,0,1800240954,0.0,0.0,0.0,0.0,6172628,0,0,6172628
2008-01-30,NYSE Arca (P),648762075,442565800,479832753,1571160628,0.0,0.0,0.0,0.0,3848810,1011121,2099251,6959182
2008-01-30,Nasdaq (Q),1059805218,522249553,1280728522,2862783293,0.0,0.0,0.0,0.0,5629572,1301229,4969631,11900432
2008-01-30,CBOE (W),5192500,3166100,1510800,9869400,0.0,0.0,0.0,0.0,7399,1022,1388,9809
2008-01-30,PHLX (X),5252800,1008000,1043474,7304274,0.0,0.0,0.0,0.0,987,305,1556,2848
2008-01-31,AMEX (A),0,52674085,266800,52940885,0.0,0.0,0.0,0.0,0,74458,620,75078
2008-01-31,NSX (C),44667186,32117121,79694078,156478385,0.0,0.0,0.0,0.0,169735,74213,280942,524890
2008-01-31,NSX (DC),68608205,16833137,69179129,154620471,0.0,0.0,0.0,0.0,263365,39815,211555,514735
2008-01-31,NYSE (DN),244769600,111143300,238784901,594697801,0.0,0.0,0.0,0.0,1664161,388864,1242261,3295286
2008-01-31,Nasdaq (DQ),786468526,202537513,628172580,1617178619,0.0,0.0,0.0,0.0,1037438,151787,633999,1823224
2008-01-31,ADF (D),15121470,3372300,11670400,30164170,0.0,0.0,0.0,0.0,60127,5869,42306,108302
2008-01-31,ISE (I),100247200,1399000,7521300,109167500,0.0,0.0,0.0,0.0,653004,2129,17246,672379
2008-01-31,CHX (M),30441300,3924400,6599106,40964806,0.0,0.0,0.0,0.0,23159,1950,11260,36369
2008-01-31,NYSE (N),2185810715,0,0,2185810715,0.0,0.0,0.0,0.0,7004447,0,0,7004447
2008-01-31,NYSE Arca (P),692802775,423971100,479491718,1596265593,0.0,0.0,0.0,0.0,4169019,1068024,2119258,7356301
2008-01-31,Nasdaq (Q),1168039879,542275951,1508601876,3218917706,0.0,0.0,0.0,0.0,6355508,1344773,5595505,13295786
2008-01-31,CBOE (W),5992000,5011600,2261500,13265100,0.0,0.0,0.0,0.0,10178,1632,1636,13446
2008-01-31,PHLX (X),3350400,1640200,1602151,6592751,0.0,0.0,0.0,0.0,1195,198,1707,3100
2008-02-01,AMEX (A),0,38652134,171200,38823334,0.0,0.0,0.0,0.0,0,62522,341,62863
2008-02-01,NSX (C),59231836,33893369,101834100,194959305,0.0,0.0,0.0,0.0,220749,80895,367772,669416
2008-02-01,NSX (DC),71439235,16028267,96347438,183814940,0.0,0.0,0.0,0.0,255940,37224,272680,565844
2008-02-01,NYSE (DN),206343400,82281900,249318149,537943449,0.0,0.0,0.0,0.0,1412643,311120,1265667,2989430
2008-02-01,Nasdaq (DQ),774064446,160932018,674252381,1609248845,0.0,0.0,0.0,0.0,1057361,129637,715062,1902060
2008-02-01,ADF (D),12775220,2206600,13129400,28111220,0.0,0.0,0.0,0.0,47214,5199,41993,94406
2008-02-01,ISE (I),78648000,1076000,6670100,86394100,0.0,0.0,0.0,0.0,527696,2485,14316,544497
2008-02-01,CHX (M),25730450,3943300,13695310,43369060,0.0,0.0,0.0,0.0,23369,1847,13065,38281
2008-02-01,NYSE (N),1787053039,0,0,1787053039,0.0,0.0,0.0,0.0,5935744,0,0,5935744
2008-02-01,NYSE Arca (P),593717100,330762400,519592194,1444071694,0.0,0.0,0.0,0.0,3542519,886556,2174388,6603463
2008-02-01,Nasdaq (Q),993882132,410900317,1487966270,2892748719,0.0,0.0,0.0,0.0,5440525,1089942,5491020,12021487
2008-02-01,CBOE (W),3670000,2535800,2532700,8738500,0.0,0.0,0.0,0.0,7884,1689,1663,11236
2008-02-01,PHLX (X),4238800,252400,1958544,6449744,0.0,0.0,0.0,0.0,976,170,546,1692
2008-02-04,AMEX (A),0,38405440,161500,38566940,0.0,0.0,0.0,0.0,0,60336,404,60740
2008-02-04,NSX (C),49241648,21968154,63334482,134544284,0.0,0.0,0.0,0.0,215833,49241,252926,518000
2008-02-04,NSX (DC),61110411,14255143,72116921,147482475,0.0,0.0,0.0,0.0,223785,32072,214775,470632
2008-02-04,NYSE (DN),166558200,58365600,192251075,417174875,0.0,0.0,0.0,0.0,1127930,229207,998556,2355693
2008-02-04,Nasdaq (DQ),592643064,133812577,505163343,1231618984,0.0,0.0,0.0,0.0,849494,107552,583608,1540654
2008-02-04,ADF (D),8800353,1708600,8546000,19054953,0.0,0.0,0.0,0.0,34002,4699,28483,67184
2008-02-04,ISE (I),58119700,931900,4445300,63496900,0.0,0.0,0.0,0.0,397642,1684,11766,411092
2008-02-04,CHX (M),18572401,5166400,7917697,31656498,0.0,0.0,0.0,0.0,22249,1282,9605,33136
2008-02-04,NYSE (N),1359550621,0,0,1359550621,0.0,0.0,0.0,0.0,4700649,0,0,4700649
2008-02-04,NYSE Arca (P),414224850,219169300,321254589,954648739,0.0,0.0,0.0,0.0,2531306,610994,1459975,4602275
2008-02-04,Nasdaq (Q),735921731,264680260,1014383049,2014985040,0.0,0.0,0.0,0.0,4123675,762859,4129634,9016168
2008-02-04,CBOE (W),2992600,1132100,1735700,5860400,0.0,0.0,0.0,0.0,5264,1377,976,7617
2008-02-04,PHLX (X),3683200,142600,902807,4728607,0.0,0.0,0.0,0.0,627,87,1728,2442
2008-02-05,AMEX (A),0,42991298,215000,43206298,0.0,0.0,0.0,0.0,0,62075,461,62536
2008-02-05,NSX (C),61834727,34781112,77497639,174113478,0.0,0.0,0.0,0.0,283919,82231,327831,693981
2008-02-05,NSX (DC),71305427,16683294,81638866,169627587,0.0,0.0,0.0,0.0,260346,41015,245241,546602
2008-02-05,NYSE (DN),216607600,97167100,227774716,541549416,0.0,0.0,0.0,0.0,1419489,344792,1150436,2914717
2008-02-05,Nasdaq (DQ),644899046,203354076,512484586,1360737708,0.0,0.0,0.0,0.0,859399,121277,558070,1538746
2008-02-05,ADF (D),12041250,3338900,14226700,29606850,0.0,0.0,0.0,0.0,46540,6821,46741,100102
2008-02-05,ISE (I),80533500,1237100,5809200,87579800,0.0,0.0,0.0,0.0,524013,1483,16451,541947
2008-02-05,CHX (M),24310113,4506300,7979079,36795492,0.0,0.0,0.0,0.0,23064,1900,11813,36777
2008-02-05,NYSE (N),1674997958,0,0,1674997958,0.0,0.0,0.0,0.0,5583696,0,0,5583696
2008-02-05,NYSE Arca (P),571007875,372011600,417038766,1360058241,0.0,0.0,0.0,0.0,3492405,951011,1819435,6262851
2008-02-05,Nasdaq (Q),913924633,447931036,1225952730,2587808399,0.0,0.0,0.0,0.0,5060558,1184612,4769870,11015040
2008-02-05,CBOE (W),4499400,3421700,1941700,9862800,0.0,0.0,0.0,0.0,8011,2854,1371,12236
2008-02-05,PHLX (X),4817500,542300,1019874,6379674,0.0,0.0,0.0,0.0,1535,171,2470,4176
2008-02-06,AMEX (A),0,37533551,356600,37890151,0.0,0.0,0.0,0.0,0,59721,572,60293
2008-02-06,NSX (C),44808572,25650042,67840673,138299287,0.0,0.0,0.0,0.0,222474,60520,311136,594130
2008-02-06,NSX (DC),60192811,14844968,76863377,151901156,0.0,0.0,0.0,0.0,226389,31735,234196,492320
2008-02-06,NYSE (DN),189178700,83493700,221093371,493765771,0.0,0.0,0.0,0.0,1248758,282052,1088149,2618959
2008-02-06,Nasdaq (DQ),671687498,175866646,528181720,1375735864,0.0,0.0,0.0,0.0,959364,118603,620387,1698354
2008-02-06,ADF (D),9865470,1946000,11169300,22980770,0.0,0.0,0.0,0.0,34856,4287,34040,73183
2008-02-06,ISE (I),74627900,827600,5134700,80590200,0.0,0.0,0.0,0.0,486752,987,13331,501070
2008-02-06,CHX (M),23010800,3351600,6598619,32961019,0.0,0.0,0.0,0.0,28536,1553,11180,41269
2008-02-06,NYSE (N),1545151151,0,0,1545151151,0.0,0.0,0.0,0.0,5220245,0,0,5220245
2008-02-06,NYSE Arca (P),523320200,311322200,401324872,1235967272,0.0,0.0,0.0,0.0,3154881,780181,1717868,5652930
2008-02-06,Nasdaq (Q),834307993,388643411,1208955808,2431907212,0.0,0.0,0.0,0.0,4613474,986472,4597923,10197869
2008-02-06,CBOE (W),4580700,3406800,2467100,10454600,0.0,0.0,0.0,0.0,7105,1216,1662,9983
2008-02-06,PHLX (X),3443200,510600,1953149,5906949,0.0,0.0,0.0,0.0,1171,154,1850,3175
2008-02-07,AMEX (A),0,38844200,165700,39009900,0.0,0.0,0.0,0.0,0,57356,391,57747
2008-02-07,NSX (C),50041191,30249803,78090305,158381299,0.0,0.0,0.0,0.0,235086,73701,355660,664447
2008-02-07,NSX (DC),67673626,16902160,89420638,173996424,0.0,0.0,0.0,0.0,247306,36104,276558,559968
2008-02-07,NYSE (DN),214703100,94343100,268422816,577469016,0.0,0.0,0.0,0.0,1420401,333390,1289019,3042810
2008-02-07,Nasdaq (DQ),774130941,182612245,616351076,1573094262,0.0,0.0,0.0,0.0,1028738,126356,670452,1825546
2008-02-07,ADF (D),10420730,2189800,10910200,23520730,0.0,0.0,0.0,0.0,38733,4115,36346,79194
2008-02-07,ISE (I),82391900,946500,6647000,89985400,0.0,0.0,0.0,0.0,529438,959,15072,545469
2008-02-07,CHX (M),23488002,2935900,8995775,35419677,0.0,0.0,0.0,0.0,27012,2026,11759,40797
2008-02-07,NYSE (N),1733605118,0,0,1733605118,0.0,0.0,0.0,0.0,5946884,0,0,5946884
2008-02-07,NYSE Arca (P),622137625,369125500,505583398,1496846523,0.0,0.0,0.0,0.0,3708219,935607,2118278,6762104
2008-02-07,Nasdaq (Q),971506958,465724635,1452063969,2889295562,0.0,0.0,0.0,0.0,5299933,1203533,5498789,12002255
2008-02-07,CBOE (W),5653400,3052100,4191700,12897200,0.0,0.0,0.0,0.0,10225,1705,2471,14401
2008-02-07,PHLX (X),3282400,454200,1189282,4925882,0.0,0.0,0.0,0.0,1980,71,1747,3798
2008-02-08,AMEX (A),0,33525454,73800,33599254,0.0,0.0,0.0,0.0,0,52056,225,52281
2008-02-08,NSX (C),51279124,29756007,65792895,146828026,0.0,0.0,0.0,0.0,243563,70704,281461,595728
2008-02-08,NSX (DC),62446790,17220601,81253060,160920451,0.0,0.0,0.0,0.0,234018,43740,237978,515736
2008-02-08,NYSE (DN),181946200,68011000,220769446,470726646,0.0,0.0,0.0,0.0,1208442,253954,1069262,2531658
2008-02-08,Nasdaq (DQ),594507787,166209570,451475682,1212193039,0.0,0.0,0.0,0.0,852798,105186,537445,1495429
2008-02-08,ADF (D),8838920,2845700,7021400,18706020,0.0,0.0,0.0,0.0,35786,6376,24762,66924
2008-02-08,ISE (I),67220400,1112700,4343400,72676500,0.0,0.0,0.0,0.0,441402,1564,12583,455549
2008-02-08,CHX (M),19115602,2434500,7995586,29545688,0.0,0.0,0.0,0.0,22611,1588,9866,34065
2008-02-08,NYSE (N),1448603688,0,0,1448603688,0.0,0.0,0.0,0.0,5043787,0,0,5043787
2008-02-08,NYSE Arca (P),521244975,291007000,372180650,1184432625,0.0,0.0,0.0,0.0,3113959,764573,1630356,5508888
2008-02-08,Nasdaq (Q),777779675,354784234,1094955014,2227518923,0.0,0.0,0.0,0.0,4361575,949631,4354695,9665901
2008-02-08,CBOE (W),4750400,4988000,2927500,12665900,0.0,0.0,0.0,0.0,6292,2919,1318,10529
2008-02-08,PHLX (X),3921000,162700,2227517,6311217,0.0,0.0,0.0,0.0,1239,56,1087,2382
2008-02-11,AMEX (A),0,38497985,326400,38824385,0.0,0.0,0.0,0.0,0,57063,602,57665
2008-02-11,NSX (C),35668077,24234687,26256577,86159341,0.0,0.0,0.0,0.0,164017,61949,139087,365053
2008-02-11,NSX (DC),51703751,11084784,93687897,156476432,0.0,0.0,0.0,0.0,203982,27950,290428,522360
2008-02-11,NYSE (DN),174535600,73531000,201546168,449612768,0.0,0.0,0.0,0.0,1146341,279820,986858,2413019
2008-02-11,Nasdaq (DQ),546263871,136142761,436391405,1118798037,0.0,0.0,0.0,0.0,860593,98938,514502,1474033
2008-02-11,ADF (D),4361710,1444300,5275500,11081510,0.0,0.0,0.0,0.0,17286,2909,16781,36976
2008-02-11,ISE (I),57249900,592500,6524600,64367000,0.0,0.0,0.0,0.0,389877,1339,22390,413606
2008-02-11,CHX (M),16743043,3353800,6340074,26436917,0.0,0.0,0.0,0.0,23978,1802,8811,34591
2008-02-11,NYSE (N),1392819272,0,0,1392819272,0.0,0.0,0.0,0.0,4970882,0,0,4970882
2008-02-11,NYSE Arca (P),523240600,275053000,357385057,1155678657,0.0,0.0,0.0,0.0,3144244,762076,1568069,5474389
2008-02-11,Nasdaq (Q),757864100,338017472,1037136151,2133017723,0.0,0.0,0.0,0.0,4227992,956457,4105113,9289562
2008-02-11,CBOE (W),4369800,2950700,6602000,13922500,0.0,0.0,0.0,0.0,7245,1732,1356,10333
2008-02-11,PHLX (X),5608200,333700,1335164,7277064,0.0,0.0,0.0,0.0,866,141,1016,2023
2008-02-12,AMEX (A),0,35848105,188000,36036105,0.0,0.0,0.0,0.0,0,59843,450,60293
2008-02-12,NSX (C),52729470,28650102,49868764,131248336,0.0,0.0,0.0,0.0,245767,62672,238836,547275
2008-02-12,NSX (DC),83769653,21316144,106687786,211773583,0.0,0.0,0.0,0.0,310200,46012,325894,682106
2008-02-12,NYSE (DN),205228300,82133600,210424791,497786691,0.0,0.0,0.0,0.0,1301150,289479,1052468,2643097
2008-02-12,Nasdaq (DQ),682275214,207326108,472495576,1362096898,0.0,0.0,0.0,0.0,926042,117654,551781,1595477
2008-02-12,ADF (D),10553170,3362200,6949400,20864770,0.0,0.0,0.0,0.0,41762,6170,26662,74594
2008-02-12,ISE (I),74049700,748700,5917200,80715600,0.0,0.0,0.0,0.0,475746,1126,12267,489139
2008-02-12,CHX (M),26055350,3707200,6872674,36635224,0.0,0.0,0.0,0.0,28765,1965,10460,41190
2008-02-12,NYSE (N),1528768828,0,0,1528768828,0.0,0.0,0.0,0.0,5075398,0,0,5075398
2008-02-12,NYSE Arca (P),546326500,343870500,359466300,1249663300,0.0,0.0,0.0,0.0,3278605,860631,1616915,5756151
2008-02-12,Nasdaq (Q),799212720,389768215,1054085201,2243066136,0.0,0.0,0.0,0.0,4384870,1051628,4145916,9582414
2008-02-12,CBOE (W),3976600,2996600,2376700,9349900,0.0,0.0,0.0,0.0,8228,3035,2553,13816
2008-02-12,PHLX (X),5372800,430300,1414438,7217538,0.0,0.0,0.0,0.0,1247,205,1102,2554
2008-02-13,AMEX (A),0,31875459,183300,32058759,0.0,0.0,0.0,0.0,0,52945,522,53467
2008-02-13,NSX (C),42612752,19554063,39082345,101249160,0.0,0.0,0.0,0.0,197508,46099,186800,430407
2008-02-13,NSX (DC),69623472,15840262,95788134,181251868,0.0,0.0,0.0,0.0,275032,37508,320771,633311
2008-02-13,NYSE (DN),198663200,68608900,218366322,485638422,0.0,0.0,0.0,0.0,1233244,255818,1069207,2558269
2008-02-13,Nasdaq (DQ),736094824,159267412,499556120,1394918356,0.0,0.0,0.0,0.0,906874,98629,562016,1567519
2008-02-13,ADF (D),7889130,3165200,8587900,19642230,0.0,0.0,0.0,0.0,31749,4490,29997,66236
2008-02-13,ISE (I),63125200,1881000,9001500,74007700,0.0,0.0,0.0,0.0,407984,5201,32182,445367
2008-02-13,CHX (M),19945802,4437400,6772809,31156011,0.0,0.0,0.0,0.0,24012,1659,9228,34899
2008-02-13,NYSE (N),1413155852,0,0,1413155852,0.0,0.0,0.0,0.0,4726152,0,0,4726152
2008-02-13,NYSE Arca (P),526058450,268393200,355719179,1150170829,0.0,0.0,0.0,0.0,3097864,715110,1584753,5397727
2008-02-13,Nasdaq (Q),741375840,316808397,1075034523,2133218760,0.0,0.0,0.0,0.0,4078624,850659,4230954,9160237
2008-02-13,CBOE (W),4260600,3023500,1974000,9258100,0.0,0.0,0.0,0.0,8628,2771,2496,13895
2008-02-13,PHLX (X),7326100,156700,1334147,8816947,0.0,0.0,0.0,0.0,1413,129,1059,2601
2008-02-14,AMEX (A),0,33712098,228700,33940798,0.0,0.0,0.0,0.0,0,55266,548,55814
2008-02-14,NSX (C),48776073,25568389,51921996,126266458,0.0,0.0,0.0,0.0,229381,55194,243773,528348
2008-02-14,NSX (DC),69850313,17044686,106157392,193052391,0.0,0.0,0.0,0.0,279718,39589,333898,653205
2008-02-14,NYSE (DN),176649900,77654900,221728738,476033538,0.0,0.0,0.0,0.0,1126396,273948,1068286,2468630
2008-02-14,Nasdaq (DQ),644483680,153999414,496221392,1294704486,0.0,0.0,0.0,0.0,794312,103376,548666,1446354
2008-02-14,ADF (D),7731322,2542300,7209500,17483122,0.0,0.0,0.0,0.0,30068,4957,26093,61118
2008-02-14,ISE (I),57191600,861900,4485800,62539300,0.0,0.0,0.0,0.0,377292,1239,9725,388256
2008-02-14,CHX (M),23412250,3656600,11645394,38714244,0.0,0.0,0.0,0.0,22989,1179,9750,33918
2008-02-14,NYSE (N),1400097824,0,0,1400097824,0.0,0.0,0.0,0.0,4821059,0,0,4821059
2008-02-14,NYSE Arca (P),495875200,295753800,359120598,1150749598,0.0,0.0,0.0,0.0,2983883,752930,1616373,5353186
2008-02-14,Nasdaq (Q),693256820,336062501,1058038449,2087357770,0.0,0.0,0.0,0.0,3856755,890172,4230271,8977198
2008-02-14,CBOE (W),4952500,3045400,2170200,10168100,0.0,0.0,0.0,0.0,6164,1762,1308,9234
2008-02-14,PHLX (X),3075800,546600,1685726,5308126,0.0,0.0,0.0,0.0,869,90,1497,2456
2008-02-15,AMEX (A),0,35828811,136500,35965311,0.0,0.0,0.0,0.0,0,49213,459,49672
2008-02-15,NSX (C),44853731,21402818,46706720,112963269,0.0,0.0,0.0,0.0,208774,47493,221103,477370
2008-02-15,NSX (DC),64111431,15396975,89275517,168783923,0.0,0.0,0.0,0.0,254657,35360,274178,564195
2008-02-15,NYSE (DN),164705900,65683400,199241343,429630643,0.0,0.0,0.0,0.0,1058494,244007,959492,2261993
2008-02-15,Nasdaq (DQ),617977779,127789082,466066159,1211833020,0.0,0.0,0.0,0.0,775673,98868,492467,1367008
2008-02-15,ADF (D),7783120,2113800,5044300,14941220,0.0,0.0,0.0,0.0,25645,5800,16864,48309
2008-02-15,ISE (I),51774300,764705,4928700,57467705,0.0,0.0,0.0,0.0,344505,1242,10792,356539
2008-02-15,CHX (M),15818000,6673300,6891105,29382405,0.0,0.0,0.0,0.0,19533,1677,8508,29718
2008-02-15,NYSE (N),1498295981,0,0,1498295981,0.0,0.0,0.0,0.0,4364304,0,0,4364304
2008-02-15,NYSE Arca (P),455223125,235655100,312432089,1003310314,0.0,0.0,0.0,0.0,2703898,624851,1419789,4748538
2008-02-15,Nasdaq (Q),629832600,276223100,1054987860,1961043560,0.0,0.0,0.0,0.0,3484069,748320,3652757,7885146
2008-02-15,CBOE (W),4331900,3690900,2464400,10487200,0.0,0.0,0.0,0.0,4473,2727,943,8143
2008-02-15,PHLX (X),2149900,533700,818344,3501944,0.0,0.0,0.0,0.0,995,197,1294,2486
2008-02-19,AMEX (A),0,35094237,90400,35184637,0.0,0.0,0.0,0.0,0,58048,384,58432
2008-02-19,NSX (C),53185642,21516241,46418465,121120348,0.0,0.0,0.0,0.0,248602,54121,231116,533839
2008-02-19,NSX (DC),76160921,17400638,102136316,195697875,0.0,0.0,0.0,0.0,296563,41836,338846,677245
2008-02-19,NYSE (DN),188001000,69067600,204687103,461755703,0.0,0.0,0.0,0.0,1205468,264518,988518,2458504
2008-02-19,Nasdaq (DQ),580446878,144412060,429893447,1154752385,0.0,0.0,0.0,0.0,861680,112996,536325,1511001
2008-02-19,ADF (D),8515430,2805800,7394000,18715230,0.0,0.0,0.0,0.0,37265,6800,25208,69273
2008-02-19,ISE (I),60326400,912400,4059300,65298100,0.0,0.0,0.0,0.0,395817,973,10139,406929
2008-02-19,CHX (M),17987100,2939100,5800306,26726506,0.0,0.0,0.0,0.0,24127,1575,9766,35468
2008-02-19,NYSE (N),1423402645,0,0,1423402645,0.0,0.0,0.0,0.0,4781532,0,0,4781532
2008-02-19,NYSE Arca (P),464176950,264383600,319880013,1048440563,0.0,0.0,0.0,0.0,2805071,698424,1467712,4971207
2008-02-19,Nasdaq (Q),702157400,287593849,930320121,1920071370,0.0,0.0,0.0,0.0,3859228,817716,3701914,8378858
2008-02-19,CBOE (W),4134200,2272200,2450500,8856900,0.0,0.0,0.0,0.0,5495,2013,999,8507
2008-02-19,PHLX (X),2457000,1162200,2874317,6493517,0.0,0.0,0.0,0.0,898,193,785,1876
2008-02-20,AMEX (A),0,34355363,92700,34448063,0.0,0.0,0.0,0.0,0,61040,322,61362
2008-02-20,NSX (C),54845239,23569918,55426092,133841249,0.0,0.0,0.0,0.0,264579,60971,234764,560314
2008-02-20,NSX (DC),76533554,17282320,112290710,206106584,0.0,0.0,0.0,0.0,301294,45338,332154,678786
2008-02-20,NYSE (DN),218782300,85940900,225096908,529820108,0.0,0.0,0.0,0.0,1383193,339566,1120704,2843463
2008-02-20,Nasdaq (DQ),615566938,166492063,470967382,1253026383,0.0,0.0,0.0,0.0,876101,110261,564387,1550749
2008-02-20,ADF (D),7458600,2421600,5622500,15502700,0.0,0.0,0.0,0.0,30752,6634,17288,54674
2008-02-20,ISE (I),71087100,1553100,5616700,78256900,0.0,0.0,0.0,0.0,449675,1615,11973,463263
2008-02-20,CHX (M),15600400,4900701,6285955,26787056,0.0,0.0,0.0,0.0,19867,1752,10429,32048
2008-02-20,NYSE (N),1469419172,0,0,1469419172,0.0,0.0,0.0,0.0,5163605,0,0,5163605
2008-02-20,NYSE Arca (P),531322100,304118200,371559000,1206999300,0.0,0.0,0.0,0.0,3225362,861714,1642952,5730028
2008-02-20,Nasdaq (Q),768897310,376558380,1088227854,2233683544,0.0,0.0,0.0,0.0,4339964,1082544,4403768,9826276
2008-02-20,CBOE (W),3674100,2120400,4061300,9855800,0.0,0.0,0.0,0.0,7574,1925,1221,10720
2008-02-20,PHLX (X),2463600,580000,2112551,5156151,0.0,0.0,0.0,0.0,1093,100,1432,2625
2008-02-21,AMEX (A),0,38469766,258100,38727866,0.0,0.0,0.0,0.0,0,62069,552,62621
2008-02-21,NSX (C),62918964,22497459,53223999,138640422,0.0,0.0,0.0,0.0,301813,59747,246040,607600
2008-02-21,NSX (DC),71835265,17782958,95596414,185214637,0.0,0.0,0.0,0.0,285040,44602,308443,638085
2008-02-21,NYSE (DN),193771600,77928900,223313325,495013825,0.0,0.0,0.0,0.0,1246246,322638,1114489,2683373
2008-02-21,Nasdaq (DQ),611813611,145436261,505439643,1262689515,0.0,0.0,0.0,0.0,794436,106183,562533,1463152
2008-02-21,ADF (D),6216500,3410200,5072600,14699300,0.0,0.0,0.0,0.0,24719,7874,14611,47204
2008-02-21,ISE (I),73720100,594800,5606500,79921400,0.0,0.0,0.0,0.0,491067,1124,12372,504563
2008-02-21,CHX (M),18611400,5882000,7994605,32488005,0.0,0.0,0.0,0.0,27784,1771,13599,43154
2008-02-21,NYSE (N),1421482667,0,0,1421482667,0.0,0.0,0.0,0.0,4780367,0,0,4780367
2008-02-21,NYSE Arca (P),471938400,304524800,356783072,1133246272,0.0,0.0,0.0,0.0,2884725,828332,1619450,5332507
2008-02-21,Nasdaq (Q),733236290,349489889,1079476680,2162202859,0.0,0.0,0.0,0.0,4142636,980390,4250728,9373754
2008-02-21,CBOE (W),4421100,3327200,2751700,10500000,0.0,0.0,0.0,0.0,8221,3016,1101,12338
2008-02-21,PHLX (X),3272300,948200,1693749,5914249,0.0,0.0,0.0,0.0,894,51,959,1904
2008-02-22,AMEX (A),0,33296336,85600,33381936,0.0,0.0,0.0,0.0,0,57599,340,57939
2008-02-22,NSX (C),53911189,22665731,54717669,131294589,0.0,0.0,0.0,0.0,248517,58158,237310,543985
2008-02-22,NSX (DC),94868986,29039613,131501302,255409901,0.0,0.0,0.0,0.0,452529,83616,449643,985788
2008-02-22,NYSE (DN),166146000,65493500,206128391,437767891,0.0,0.0,0.0,0.0,1120057,256705,1051694,2428456
2008-02-22,Nasdaq (DQ),541340320,135841261,526570959,1203752540,0.0,0.0,0.0,0.0,777859,106943,574580,1459382
2008-02-22,ADF (D),5565370,2714200,5792600,14072170,0.0,0.0,0.0,0.0,23385,4949,20205,48539
2008-02-22,ISE (I),64170500,796400,6207900,71174800,0.0,0.0,0.0,0.0,422591,828,11786,435205
2008-02-22,CHX (M),16782300,6046232,6670300,29498832,0.0,0.0,0.0,0.0,30621,1728,14453,46802
2008-02-22,NYSE (N),1416017053,0,0,1416017053,0.0,0.0,0.0,0.0,4942549,0,0,4942549
2008-02-22,NYSE Arca (P),475499700,296972000,363807542,1136279242,0.0,0.0,0.0,0.0,2940617,801715,1647791,5390123
2008-02-22,Nasdaq (Q),708152770,356107389,1077226234,2141486393,0.0,0.0,0.0,0.0,3956257,981165,4246564,9183986
2008-02-22,CBOE (W),3318800,3497000,890100,7705900,0.0,0.0,0.0,0.0,7776,2865,1274,11915
2008-02-22,PHLX (X),2809900,2378500,958905,6147305,0.0,0.0,0.0,0.0,896,341,844,2081
2008-02-25,AMEX (A),0,44231345,183300,44414645,0.0,0.0,0.0,0.0,0,71554,504,72058
2008-02-25,NSX (C),52990695,28023820,48798368,129812883,0.0,0.0,0.0,0.0,253132,71691,243604,568427
2008-02-25,NSX (DC),59110456,15259661,78639922,153010039,0.0,0.0,0.0,0.0,230753,34051,254836,519640
2008-02-25,NYSE (DN),191634000,82074200,218092695,491800895,0.0,0.0,0.0,0.0,1354329,323545,1134818,2812692
2008-02-25,Nasdaq (DQ),599819136,137251579,437827777,1174898492,0.0,0.0,0.0,0.0,880125,118202,536742,1535069
2008-02-25,ADF (D),9520240,3367800,6101900,18989940,0.0,0.0,0.0,0.0,35726,5601,20941,62268
2008-02-25,ISE (I),74800000,1711900,4713200,81225100,0.0,0.0,0.0,0.0,502520,1459,10490,514469
2008-02-25,CHX (M),18331000,4316009,7477546,30124555,0.0,0.0,0.0,0.0,28781,2068,12586,43435
2008-02-25,NYSE (N),1512983321,0,0,1512983321,0.0,0.0,0.0,0.0,5266243,0,0,5266243
2008-02-25,NYSE Arca (P),507626700,329477800,340284066,1177388566,0.0,0.0,0.0,0.0,3149395,828233,1588765,5566393
2008-02-25,Nasdaq (Q),797864120,368652721,1050132714,2216649555,0.0,0.0,0.0,0.0,4438122,1013838,4347864,9799824
2008-02-25,CBOE (W),4356900,2156200,4322500,10835600,0.0,0.0,0.0,0.0,7475,1988,1206,10669
2008-02-25,PHLX (X),3660200,445900,876675,4982775,0.0,0.0,0.0,0.0,1643,180,1067,2890
2008-02-26,AMEX (A),0,46230527,195000,46425527,0.0,0.0,0.0,0.0,0,71505,528,72033
2008-02-26,NSX (C),62529758,24685396,56015985,143231139,0.0,0.0,0.0,0.0,287315,63218,268879,619412
2008-02-26,NSX (DC),70568302,18999113,93109643,182677058,0.0,0.0,0.0,0.0,275879,41519,308637,626035
2008-02-26,NYSE (DN),201390900,80538700,227887473,509817073,0.0,0.0,0.0,0.0,1382883,317922,1177898,2878703
2008-02-26,Nasdaq (DQ),734830714,178659650,497453718,1410944082,0.0,0.0,0.0,0.0,976224,131466,623731,1731421
2008-02-26,ADF (D),10764520,2546400,6410900,19721820,0.0,0.0,0.0,0.0,37439,5611,20207,63257
2008-02-26,ISE (I),78864600,1034600,5786700,85685900,0.0,0.0,0.0,0.0,508496,1124,14032,523652
2008-02-26,CHX (M),24743649,4905102,8026624,37675375,0.0,0.0,0.0,0.0,34139,1671,13980,49790
2008-02-26,NYSE (N),1535536855,0,0,1535536855,0.0,0.0,0.0,0.0,5085542,0,0,5085542
2008-02-26,NYSE Arca (P),514654525,299018300,360400822,1174073647,0.0,0.0,0.0,0.0,3098411,803183,1654284,5555878
2008-02-26,Nasdaq (Q),833481480,359038846,1119257725,2311778051,0.0,0.0,0.0,0.0,4570077,1039989,4553007,10163073
2008-02-26,CBOE (W),6263900,2536100,1498800,10298800,0.0,0.0,0.0,0.0,6601,1994,1269,9864
2008-02-26,PHLX (X),2524800,451400,1504777,4480977,0.0,0.0,0.0,0.0,1412,110,1272,2794
2008-02-27,AMEX (A),0,38304349,147200,38451549,0.0,0.0,0.0,0.0,0,57039,460,57499
2008-02-27,NSX (C),55470005,23305218,49062669,127837892,0.0,0.0,0.0,0.0,249858,59508,243540,552906
2008-02-27,NSX (DC),70849545,21210949,95622377,187682871,0.0,0.0,0.0,0.0,266689,42257,303475,612421
2008-02-27,NYSE (DN),205611400,78089000,217902850,501603250,0.0,0.0,0.0,0.0,1412177,317177,1143466,2872820
2008-02-27,Nasdaq (DQ),655121798,182712445,486918475,1324752718,0.0,0.0,0.0,0.0,944014,130731,589392,1664137
2008-02-27,ADF (D),10549010,2444800,6246600,19240410,0.0,0.0,0.0,0.0,38832,5531,20397,64760
2008-02-27,ISE (I),74628320,680300,5042800,80351420,0.0,0.0,0.0,0.0,482866,1125,11363,495354
2008-02-27,CHX (M),25805200,3331901,6770284,35907385,0.0,0.0,0.0,0.0,32147,2094,12725,46966
2008-02-27,NYSE (N),1461137767,0,0,1461137767,0.0,0.0,0.0,0.0,4790464,0,0,4790464
2008-02-27,NYSE Arca (P),513784100,291504200,349837818,1155126118,0.0,0.0,0.0,0.0,3072900,789312,1574649,5436861
2008-02-27,Nasdaq (Q),789267930,320341857,1057275639,2166885426,0.0,0.0,0.0,0.0,4334673,910026,4242418,9487117
2008-02-27,CBOE (W),6264000,3188900,1583500,11036400,0.0,0.0,0.0,0.0,6387,2165,1246,9798
2008-02-27,PHLX (X),8292100,922800,1290694,10505594,0.0,0.0,0.0,0.0,1736,119,1520,3375
2008-02-28,AMEX (A),0,35972322,194400,36166722,0.0,0.0,0.0,0.0,0,63168,495,63663
2008-02-28,NSX (C),58373007,21347780,47569733,127290520,0.0,0.0,0.0,0.0,269349,58597,251869,579815
2008-02-28,NSX (DC),72291299,18194748,88317479,178803526,0.0,0.0,0.0,0.0,267538,41951,303421,612910
2008-02-28,NYSE (DN),193190800,68451300,198214716,459856816,0.0,0.0,0.0,0.0,1304881,273422,1041579,2619882
2008-02-28,Nasdaq (DQ),659883113,137108407,458644044,1255635564,0.0,0.0,0.0,0.0,993896,115723,622629,1732248
2008-02-28,ADF (D),13419040,1470800,7012200,21902040,0.0,0.0,0.0,0.0,43430,2901,24183,70514
2008-02-28,ISE (I),73426600,702900,4000200,78129700,0.0,0.0,0.0,0.0,474464,1379,8750,484593
2008-02-28,CHX (M),22856465,5309400,9520398,37686263,0.0,0.0,0.0,0.0,37236,1819,12507,51562
2008-02-28,NYSE (N),1461196455,0,0,1461196455,0.0,0.0,0.0,0.0,4693990,0,0,4693990
2008-02-28,NYSE Arca (P),491611500,236792200,356472935,1084876635,0.0,0.0,0.0,0.0,2875678,666467,1606411,5148556
2008-02-28,Nasdaq (Q),786282980,300910395,974863843,2062057218,0.0,0.0,0.0,0.0,4138509,883660,4010195,9032364
2008-02-28,CBOE (W),5366700,4409900,6078000,15854600,0.0,0.0,0.0,0.0,6234,1972,1380,9586
2008-02-28,PHLX (X),7389700,616100,1112514,9118314,0.0,0.0,0.0,0.0,1630,149,1328,3107
2008-02-29,AMEX (A),0,44466328,118900,44585228,0.0,0.0,0.0,0.0,0,65343,389,65732
2008-02-29,NSX (C),65841926,29370573,55775066,150987565,0.0,0.0,0.0,0.0,285042,71270,265259,621571
2008-02-29,NSX (DC),84289214,23374506,101505930,209169650,0.0,0.0,0.0,0.0,293694,47316,313100,654110
2008-02-29,NYSE (DN),212534500,94209700,228249015,534993215,0.0,0.0,0.0,0.0,1431285,355130,1175904,2962319
2008-02-29,Nasdaq (DQ),686706662,178793180,536555136,1402054978,0.0,0.0,0.0,0.0,998807,130914,630446,1760167
2008-02-29,ADF (D),19121420,1986700,9012700,30120820,0.0,0.0,0.0,0.0,63711,4138,30218,98067
2008-02-29,ISE (I),75248300,1057600,4907400,81213300,0.0,0.0,0.0,0.0,480737,1909,10338,492984
2008-02-29,CHX (M),20620223,3753201,7502135,31875559,0.0,0.0,0.0,0.0,42610,2456,15298,60364
2008-02-29,NYSE (N),1759706109,0,0,1759706109,0.0,0.0,0.0,0.0,4987231,0,0,4987231
2008-02-29,NYSE Arca (P),524323100,317397200,384894777,1226615077,0.0,0.0,0.0,0.0,3081076,787419,1678736,5547231
2008-02-29,Nasdaq (Q),872693080,412735433,1295408133,2580836646,0.0,0.0,0.0,0.0,4551752,1067730,4491016,10110498
2008-02-29,CBOE (W),5620500,11937300,2748100,20305900,0.0,0.0,0.0,0.0,8858,2681,2086,13625
2008-02-29,PHLX (X),4312400,227900,1164369,5704669,0.0,0.0,0.0,0.0,1822,203,2118,4143
2008-03-03,AMEX (A),0,39660367,91300,39751667,0.0,0.0,0.0,0.0,0,63897,362,64259
2008-03-03,NSX (C),60469938,24393958,54090302,138954198,0.0,0.0,0.0,0.0,279371,66482,280548,626401
2008-03-03,NSX (DC),82245125,20670617,97990289,200906031,0.0,0.0,0.0,0.0,290366,48834,332755,671955
2008-03-03,NYSE (DN),208319500,93051100,217602257,518972857,0.0,0.0,0.0,0.0,1414723,365491,1175507,2955721
2008-03-03,Nasdaq (DQ),659599133,169453781,458601723,1287654637,0.0,0.0,0.0,0.0,1032124,137967,648778,1818869
2008-03-03,ADF (D),24006180,1945800,14004300,39956280,0.0,0.0,0.0,0.0,76919,3999,42288,123206
2008-03-03,ISE (I),78206900,1068700,3472400,82748000,0.0,0.0,0.0,0.0,509801,1835,8064,519700
2008-03-03,CHX (M),24576101,5077400,6485172,36138673,0.0,0.0,0.0,0.0,48631,2603,19406,70640
2008-03-03,NYSE (N),1569012813,0,0,1569012813,0.0,0.0,0.0,0.0,5198701,0,0,5198701
2008-03-03,NYSE Arca (P),517728900,302332600,347440489,1167501989,0.0,0.0,0.0,0.0,3043405,805849,1663023,5512277
2008-03-03,Nasdaq (Q),851096170,363180050,1039622111,2253898331,0.0,0.0,0.0,0.0,4585461,1066052,4409815,10061328
2008-03-03,CBOE (W),3371900,2940600,1661800,7974300,0.0,0.0,0.0,0.0,7308,2492,1672,11472
2008-03-03,PHLX (X),4283400,700000,1459788,6443188,0.0,0.0,0.0,0.0,2125,446,1500,4071
2008-03-04,AMEX (A),0,45987534,195100,46182634,0.0,0.0,0.0,0.0,0,79026,518,79544
2008-03-04,NSX (C),68190496,28816410,58680317,155687223,0.0,0.0,0.0,0.0,290252,78483,282145,650880
2008-03-04,NSX (DC),96963277,25650183,130522345,253135805,0.0,0.0,0.0,0.0,353783,60162,405551,819496
2008-03-04,NYSE (DN),261413600,111504000,271157861,644075461,0.0,0.0,0.0,0.0,1704563,417785,1341271,3463619
2008-03-04,Nasdaq (DQ),766491304,180280635,539821766,1486593705,0.0,0.0,0.0,0.0,1072391,149782,641313,1863486
2008-03-04,ADF (D),20815300,2444100,12679900,35939300,0.0,0.0,0.0,0.0,68973,6814,38608,114395
2008-03-04,ISE (I),93984160,2483000,5564900,102032060,0.0,0.0,0.0,0.0,584780,2901,10759,598440
2008-03-04,CHX (M),30899070,5006300,9228752,45134122,0.0,0.0,0.0,0.0,48251,2574,14124,64949
2008-03-04,NYSE (N),1784637782,0,0,1784637782,0.0,0.0,0.0,0.0,5922636,0,0,5922636
2008-03-04,NYSE Arca (P),605665825,406096900,435594730,1447357455,0.0,0.0,0.0,0.0,3601544,1065259,1918334,6585137
2008-03-04,Nasdaq (Q),980476560,491367544,1291661310,2763505414,0.0,0.0,0.0,0.0,5342053,1350489,4989684,11682226
2008-03-04,CBOE (W),5087500,1709800,2270500,9067800,0.0,0.0,0.0,0.0,10510,1839,2200,14549
2008-03-04,PHLX (X),3309200,874000,2240459,6423659,0.0,0.0,0.0,0.0,2824,233,2138,5195
2008-03-05,AMEX (A),0,40763441,202000,40965441,0.0,0.0,0.0,0.0,0,70579,585,71164
2008-03-05,NSX (C),53544012,25655772,47359406,126559190,0.0,0.0,0.0,0.0,234865,69655,244296,548816
2008-03-05,NSX (DC),84166263,24105597,108233024,216504884,0.0,0.0,0.0,0.0,314915,53166,359290,727371
2008-03-05,NYSE (DN),218501900,100564800,229107259,548173959,0.0,0.0,0.0,0.0,1486978,378302,1188381,3053661
2008-03-05,Nasdaq (DQ),739971668,191625548,437891633,1369488849,0.0,0.0,0.0,0.0,932620,115580,530614,1578814
2008-03-05,ADF (D),17418380,2394700,11196100,31009180,0.0,0.0,0.0,0.0,59867,6261,35719,101847
2008-03-05,ISE (I),79172800,1686900,5754400,86614100,0.0,0.0,0.0,0.0,507791,1989,8306,518086
2008-03-05,CHX (M),26471715,6029715,10968574,43470004,0.0,0.0,0.0,0.0,49095,2400,14061,65556
2008-03-05,NYSE (N),1618483251,0,0,1618483251,0.0,0.0,0.0,0.0,5437588,0,0,5437588
2008-03-05,NYSE Arca (P),532539000,352143700,381456427,1266139127,0.0,0.0,0.0,0.0,3256005,922387,1680069,5858461
2008-03-05,Nasdaq (Q),874665210,431087920,1079126690,2384879820,0.0,0.0,0.0,0.0,4830144,1218985,4506976,10556105
2008-03-05,CBOE (W),4631500,3126400,2906800,10664700,0.0,0.0,0.0,0.0,9630,2228,1784,13642
2008-03-05,PHLX (X),5017100,1019700,658160,6694960,0.0,0.0,0.0,0.0,2567,156,1384,4107
2008-03-06,AMEX (A),0,45780680,103900,45884580,0.0,0.0,0.0,0.0,0,67655,374,68029
2008-03-06,NSX (C),91039605,25292272,52433711,168765588,0.0,0.0,0.0,0.0,464825,68226,252230,785281
2008-03-06,NSX (DC),87366906,22890762,100799981,211057649,0.0,0.0,0.0,0.0,309111,53369,326385,688865
2008-03-06,NYSE (DN),226619600,102155500,233511454,562286554,0.0,0.0,0.0,0.0,1492306,363111,1169312,3024729
2008-03-06,Nasdaq (DQ),709428269,171598909,471281964,1352309142,0.0,0.0,0.0,0.0,999256,120870,542740,1662866
2008-03-06,ADF (D),18646561,2165400,8273400,29085361,0.0,0.0,0.0,0.0,58774,5578,27353,91705
2008-03-06,ISE (I),37707400,1000200,3039100,41746700,0.0,0.0,0.0,0.0,239241,1189,5102,245532
2008-03-06,CHX (M),24507600,4225300,7689402,36422302,0.0,0.0,0.0,0.0,45739,2150,13686,61575
2008-03-06,NYSE (N),1612181127,0,0,1612181127,0.0,0.0,0.0,0.0,5051699,0,0,5051699
2008-03-06,NYSE Arca (P),593600250,353189700,383180142,1329970092,0.0,0.0,0.0,0.0,3442843,896336,1673523,6012702
2008-03-06,Nasdaq (Q),868638650,381450484,1035046138,2285135272,0.0,0.0,0.0,0.0,4592742,1082985,4044641,9720368
2008-03-06,CBOE (W),4523200,4600600,5137500,14261300,0.0,0.0,0.0,0.0,7898,2542,1410,11850
2008-03-06,PHLX (X),4694500,611100,1211511,6517111,0.0,0.0,0.0,0.0,1692,121,1675,3488
2008-03-07,AMEX (A),0,53826521,160600,53987121,0.0,0.0,0.0,0.0,0,78263,519,78782
2008-03-07,NSX (C),64084537,31491248,53422857,148998642,0.0,0.0,0.0,0.0,269940,85207,266685,621832
2008-03-07,NSX (DC),90477092,26388251,100972800,217838143,0.0,0.0,0.0,0.0,311735,55192,330726,697653
2008-03-07,NYSE (DN),240703100,123723300,237684038,602110438,0.0,0.0,0.0,0.0,1648303,483318,1271533,3403154
2008-03-07,Nasdaq (DQ),698968978,211616355,459564497,1370149830,0.0,0.0,0.0,0.0,1018390,155754,572591,1746735
2008-03-07,ADF (D),20973270,5680200,9687900,36341370,0.0,0.0,0.0,0.0,69190,8132,32485,109807
2008-03-07,ISE (I),90197300,1023400,4625700,95846400,0.0,0.0,0.0,0.0,574972,1063,8222,584257
2008-03-07,CHX (M),23059011,3813300,9332591,36204902,0.0,0.0,0.0,0.0,39712,2485,11818,54015
2008-03-07,NYSE (N),1702556892,0,0,1702556892,0.0,0.0,0.0,0.0,5493497,0,0,5493497
2008-03-07,NYSE Arca (P),629317175,443622500,405644746,1478584421,0.0,0.0,0.0,0.0,3719459,1159363,1851523,6730345
2008-03-07,Nasdaq (Q),962929020,523354581,1145221523,2631505124,0.0,0.0,0.0,0.0,5225368,1445446,4751980,11422794
2008-03-07,CBOE (W),5120500,3174300,5227300,13522100,0.0,0.0,0.0,0.0,9992,2909,2281,15182
2008-03-07,PHLX (X),4930000,481800,1155297,6567097,0.0,0.0,0.0,0.0,2752,124,1440,4316
2008-03-10,AMEX (A),0,47332642,83100,47415742,0.0,0.0,0.0,0.0,0,78611,322,78933
2008-03-10,NSX (C),57888451,25325210,53054154,136267815,0.0,0.0,0.0,0.0,259033,75518,273859,608410
2008-03-10,NSX (DC),84594842,22950426,96708984,204254252,0.0,0.0,0.0,0.0,299977,48510,328715,677202
2008-03-10,NYSE (DN),240088400,106709200,218109302,564906902,0.0,0.0,0.0,0.0,1630505,438098,1182390,3250993
2008-03-10,Nasdaq (DQ),639097905,214156008,430525497,1283779410,0.0,0.0,0.0,0.0,1059337,149871,600836,1810044
2008-03-10,ADF (D),18504610,2713400,11515000,32733010,0.0,0.0,0.0,0.0,68158,7234,36469,111861
2008-03-10,ISE (I),82301900,1023601,3685400,87010901,0.0,0.0,0.0,0.0,541272,1317,7590,550179
2008-03-10,CHX (M),22555999,4095500,5051534,31703033,0.0,0.0,0.0,0.0,35976,2195,9695,47866
2008-03-10,NYSE (N),1611464920,0,0,1611464920,0.0,0.0,0.0,0.0,5276897,0,0,5276897
2008-03-10,NYSE Arca (P),570212600,356339600,367176500,1293728700,0.0,0.0,0.0,0.0,3491888,977495,1669749,6139132
2008-03-10,Nasdaq (Q),890831993,418688973,1008081588,2317602554,0.0,0.0,0.0,0.0,4970202,1210284,4155075,10335561
2008-03-10,CBOE (W),7061500,3861300,3838300,14761100,0.0,0.0,0.0,0.0,9791,2167,2564,14522
2008-03-10,PHLX (X),3433300,302900,1795787,5531987,0.0,0.0,0.0,0.0,2542,107,1408,4057
2008-03-11,AMEX (A),0,48063268,138800,48202068,0.0,0.0,0.0,0.0,0,79538,456,79994
2008-03-11,NSX (C),68900205,33015877,57526135,159442217,0.0,0.0,0.0,0.0,300245,89801,282452,672498
2008-03-11,NSX (DC),102200994,25964988,113599093,241765075,0.0,0.0,0.0,0.0,359155,56690,370582,786427
2008-03-11,NYSE (DN),285847500,129202500,255578940,670628940,0.0,0.0,0.0,0.0,1912801,498362,1361499,3772662
2008-03-11,Nasdaq (DQ),907664183,252517827,545226593,1705408603,0.0,0.0,0.0,0.0,1234782,155556,679304,2069642
2008-03-11,ADF (D),20982990,2208900,10529700,33721590,0.0,0.0,0.0,0.0,68252,4864,31683,104799
2008-03-11,ISE (I),101607101,1505200,5114600,108226901,0.0,0.0,0.0,0.0,632112,1052,9646,642810
2008-03-11,CHX (M),29465225,4186500,7257262,40908987,0.0,0.0,0.0,0.0,44249,2334,13777,60360
2008-03-11,NYSE (N),1936236532,0,0,1936236532,0.0,0.0,0.0,0.0,5841325,0,0,5841325
2008-03-11,NYSE Arca (P),733137050,472080000,421483310,1626700360,0.0,0.0,0.0,0.0,4235450,1143227,1892260,7270937
2008-03-11,Nasdaq (Q),1104090638,518662456,1183710347,2806463441,0.0,0.0,0.0,0.0,5871624,1404865,4679023,11955512
2008-03-11,CBOE (W),6225300,2093200,1815200,10133700,0.0,0.0,0.0,0.0,10340,2163,2227,14730
2008-03-11,PHLX (X),6213500,663400,1207199,8084099,0.0,0.0,0.0,0.0,3805,184,2364,6353
2008-03-12,AMEX (A),0,34718908,56100,34775008,0.0,0.0,0.0,0.0,0,62672,256,62928
2008-03-12,NSX (C),65219331,26736495,50603611,142559437,0.0,0.0,0.0,0.0,266192,68413,258642,593247
2008-03-12,NSX (DC),98684896,20677811,97540213,216902920,0.0,0.0,0.0,0.0,329262,40412,328876,698550
2008-03-12,NYSE (DN),226012500,103199900,212632203,541844603,0.0,0.0,0.0,0.0,1511914,391929,1155360,3059203
2008-03-12,Nasdaq (DQ),810317776,187650747,486023364,1483991887,0.0,0.0,0.0,0.0,1062362,125889,590564,1778815
2008-03-12,ADF (D),17677493,2174500,8609100,28461093,0.0,0.0,0.0,0.0,59412,5765,27471,92648
2008-03-12,ISE (I),88135400,1253200,3785900,93174500,0.0,0.0,0.0,0.0,559965,856,10660,571481
2008-03-12,CHX (M),23256410,4210600,6187113,33654123,0.0,0.0,0.0,0.0,40608,1733,10326,52667
2008-03-12,NYSE (N),1560391983,0,0,1560391983,0.0,0.0,0.0,0.0,4987664,0,0,4987664
2008-03-12,NYSE Arca (P),577599425,340660800,337163125,1255423350,0.0,0.0,0.0,0.0,3433112,865351,1539039,5837502
2008-03-12,Nasdaq (Q),919178432,370157654,983232095,2272568181,0.0,0.0,0.0,0.0,4939495,1051937,4209450,10200882
2008-03-12,CBOE (W),5121900,3064000,4082200,12268100,0.0,0.0,0.0,0.0,6962,2223,2211,11396
2008-03-12,PHLX (X),7074600,307900,2542818,9925318,0.0,0.0,0.0,0.0,2754,142,1404,4300
2008-03-13,AMEX (A),0,47942040,78600,48020640,0.0,0.0,0.0,0.0,0,78480,312,78792
2008-03-13,NSX (C),71019657,36521789,58269007,165810453,0.0,0.0,0.0,0.0,302727,96833,294245,693805
2008-03-13,NSX (DC),153417631,46101433,159287149,358806213,0.0,0.0,0.0,0.0,697729,141977,634442,1474148
2008-03-13,NYSE (DN),234516800,121076500,202620239,558213539,0.0,0.0,0.0,0.0,1606429,476187,1106185,3188801
2008-03-13,Nasdaq (DQ),816756724,233191097,580545265,1630493086,0.0,0.0,0.0,0.0,1087856,148218,612067,1848141
2008-03-13,ADF (D),21387450,2810900,11929100,36127450,0.0,0.0,0.0,0.0,69401,7931,36159,113491
2008-03-13,ISE (I),105461300,1778000,7126300,114365600,0.0,0.0,0.0,0.0,696311,1550,31895,729756
2008-03-13,CHX (M),28054250,6348400,7049660,41452310,0.0,0.0,0.0,0.0,49972,2212,14615,66799
2008-03-13,NYSE (N),1840607977,0,0,1840607977,0.0,0.0,0.0,0.0,6122567,0,0,6122567
2008-03-13,NYSE Arca (P),692853875,485510200,434781913,1613145988,0.0,0.0,0.0,0.0,4127263,1267000,1947451,7341714
2008-03-13,Nasdaq (Q),1109032110,576842505,1150074182,2835948797,0.0,0.0,0.0,0.0,6125296,1640573,4815224,12581093
2008-03-13,CBOE (W),3989200,2908300,2986400,9883900,0.0,0.0,0.0,0.0,9906,2869,2573,15348
2008-03-13,PHLX (X),9992500,496800,3174641,13663941,0.0,0.0,0.0,0.0,2514,126,2268,4908
2008-03-14,AMEX (A),0,48330819,63500,48394319,0.0,0.0,0.0,0.0,0,80353,282,80635
2008-03-14,NSX (C),53068213,34735709,58972111,146776033,0.0,0.0,0.0,0.0,225556,98496,298899,622951
2008-03-14,NSX (DC),82967593,23243862,90350420,196561875,0.0,0.0,0.0,0.0,333954,59328,342299,735581
2008-03-14,NYSE (DN),283648200,130854200,219822745,634325145,0.0,0.0,0.0,0.0,1978168,510676,1188013,3676857
2008-03-14,Nasdaq (DQ),726865407,228285935,409847334,1364998676,0.0,0.0,0.0,0.0,1145397,148411,560921,1854729
2008-03-14,ADF (D),20958910,2869900,12807700,36636510,0.0,0.0,0.0,0.0,68450,7861,37230,113541
2008-03-14,ISE (I),110287800,1314700,4632200,116234700,0.0,0.0,0.0,0.0,742757,1254,13913,757924
2008-03-14,CHX (M),27698332,6248000,9222912,43169244,0.0,0.0,0.0,0.0,47298,2923,12203,62424
2008-03-14,NYSE (N),1856031643,0,0,1856031643,0.0,0.0,0.0,0.0,6482215,0,0,6482215
2008-03-14,NYSE Arca (P),779332900,610210900,466574229,1856118029,0.0,0.0,0.0,0.0,4745849,1434114,2078132,8258095
2008-03-14,Nasdaq (Q),1340694579,722630966,1353540303,3416865848,0.0,0.0,0.0,0.0,7587044,2027475,5514706,15129225
2008-03-14,CBOE (W),4390400,2684700,1701300,8776400,0.0,0.0,0.0,0.0,9171,3511,2140,14822
2008-03-14,PHLX (X),6527300,601000,1017463,8145763,0.0,0.0,0.0,0.0,1395,326,1186,2907
2008-03-17,AMEX (A),0,47949226,51500,48000726,0.0,0.0,0.0,0.0,0,80407,219,80626
2008-03-17,NSX (C),81608017,30903663,48510359,161022039,0.0,0.0,0.0,0.0,343940,89833,260809,694582
2008-03-17,NSX (DC),123993255,27081564,87292666,238367485,0.0,0.0,0.0,0.0,448546,70910,331458,850914
2008-03-17,NYSE (DN),343091200,153566200,228109787,724767187,0.0,0.0,0.0,0.0,2297834,584343,1291128,4173305
2008-03-17,Nasdaq (DQ),866214284,227587169,430374416,1524175869,0.0,0.0,0.0,0.0,1309492,165447,601530,2076469
2008-03-17,ADF (D),22599060,4231600,10559000,37389660,0.0,0.0,0.0,0.0,80682,11602,32013,124297
2008-03-17,ISE (I),126190500,5959600,9082600,141232700,0.0,0.0,0.0,0.0,793118,18054,44366,855538
2008-03-17,CHX (M),30425026,5261906,5061214,40748146,0.0,0.0,0.0,0.0,49904,2692,12700,65296
2008-03-17,NYSE (N),1980052443,0,0,1980052443,0.0,0.0,0.0,0.0,6571518,0,0,6571518
2008-03-17,NYSE Arca (P),846823900,501685000,400991117,1749500017,0.0,0.0,0.0,0.0,4993640,1327219,1889535,8210394
2008-03-17,Nasdaq (Q),1404200012,636341722,1221682047,3262223781,0.0,0.0,0.0,0.0,7735760,1848247,5151812,14735819
2008-03-17,CBOE (W),4043100,3832600,3946300,11822000,0.0,0.0,0.0,0.0,4947,3175,2464,10586
2008-03-17,PHLX (X),2264200,1043500,6476770,9784470,0.0,0.0,0.0,0.0,2530,317,1422,4269
2008-03-18,AMEX (A),0,42001757,61800,42063557,0.0,0.0,0.0,0.0,0,75422,245,75667
2008-03-18,NSX (C),87715350,40934784,65965396,194615530,0.0,0.0,0.0,0.0,358241,109863,332319,800423
2008-03-18,NSX (DC),118753775,68875011,153960045,341588831,0.0,0.0,0.0,0.0,411142,232633,676556,1320331
2008-03-18,NYSE (DN),270059500,83879700,137529414,491468614,0.0,0.0,0.0,0.0,1869219,296919,774923,2941061
2008-03-18,Nasdaq (DQ),903247768,242264529,466497834,1612010131,0.0,0.0,0.0,0.0,1280132,160423,629934,2070489
2008-03-18,ADF (D),23121230,3478000,9580900,36180130,0.0,0.0,0.0,0.0,71527,8073,29762,109362
2008-03-18,ISE (I),107735900,1859700,4489000,114084600,0.0,0.0,0.0,0.0,694999,1311,9251,705561
2008-03-18,CHX (M),32183350,9260000,4691088,46134438,0.0,0.0,0.0,0.0,44680,2543,10747,57970
2008-03-18,NYSE (N),1943244217,0,0,1943244217,0.0,0.0,0.0,0.0,6206250,0,0,6206250
2008-03-18,NYSE Arca (P),728214625,482964500,413263988,1624443113,0.0,0.0,0.0,0.0,4409312,1187907,1883117,7480336
2008-03-18,Nasdaq (Q),1273834474,596325252,1222807181,3092966907,0.0,0.0,0.0,0.0,7124833,1659622,5001620,13786075
2008-03-18,CBOE (W),6558300,2930800,3206900,12696000,0.0,0.0,0.0,0.0,12938,2751,3849,19538
2008-03-18,PHLX (X),5924200,985500,1073186,7982886,0.0,0.0,0.0,0.0,3933,474,2737,7144
2008-03-19,AMEX (A),0,48156720,40200,48196920,0.0,0.0,0.0,0.0,0,77515,170,77685
2008-03-19,NSX (C),86818767,37405564,54507576,178731907,0.0,0.0,0.0,0.0,378047,104310,282631,764988
2008-03-19,NSX (DC),118800891,30453867,90709945,239964703,0.0,0.0,0.0,0.0,428873,72329,325100,826302
2008-03-19,NYSE (DN),310660300,152783600,232477390,695921290,0.0,0.0,0.0,0.0,2115129,585997,1262352,3963478
2008-03-19,Nasdaq (DQ),886945927,238744592,456650958,1582341477,0.0,0.0,0.0,0.0,1285918,187014,608198,2081130
2008-03-19,ADF (D),22938261,4106600,8990700,36035561,0.0,0.0,0.0,0.0,75404,10658,26668,112730
2008-03-19,ISE (I),88303100,1472500,3849800,93625400,0.0,0.0,0.0,0.0,555014,1235,8264,564513
2008-03-19,CHX (M),26578160,9856400,7697548,44132108,0.0,0.0,0.0,0.0,55083,4124,13871,73078
2008-03-19,NYSE (N),1971410449,0,0,1971410449,0.0,0.0,0.0,0.0,6108473,0,0,6108473
2008-03-19,NYSE Arca (P),717590775,464951800,393085298,1575627873,0.0,0.0,0.0,0.0,4342978,1217880,1785346,7346204
2008-03-19,Nasdaq (Q),1196509338,556929559,1130290498,2883729395,0.0,0.0,0.0,0.0,6669371,1582282,4622872,12874525
2008-03-19,CBOE (W),7293800,6360500,4844600,18498900,0.0,0.0,0.0,0.0,11524,5980,3614,21118
2008-03-19,PHLX (X),4072000,626400,1468138,6166538,0.0,0.0,0.0,0.0,2311,173,2237,4721
2008-03-20,AMEX (A),0,49281719,108300,49390019,0.0,0.0,0.0,0.0,0,76336,449,76785
2008-03-20,NSX (C),73225271,33824656,53303563,160353490,0.0,0.0,0.0,0.0,298908,98760,281387,679055
2008-03-20,NSX (DC),91772032,21963046,75496018,189231096,0.0,0.0,0.0,0.0,343792,55502,276774,676068
2008-03-20,NYSE (DN),278018300,121871100,201968892,601858292,0.0,0.0,0.0,0.0,1819466,460588,1149485,3429539
2008-03-20,Nasdaq (DQ),1115261878,207396962,527285452,1849944292,0.0,0.0,0.0,0.0,1306796,182586,636531,2125913
2008-03-20,ADF (D),24988563,3799500,9258900,38046963,0.0,0.0,0.0,0.0,81131,10778,29494,121403
2008-03-20,ISE (I),96672000,4204500,3388500,104265000,0.0,0.0,0.0,0.0,612283,4569,7414,624266
2008-03-20,CHX (M),30053529,5557600,7076246,42687375,0.0,0.0,0.0,0.0,44620,3192,12005,59817
2008-03-20,NYSE (N),2750298375,0,0,2750298375,0.0,0.0,0.0,0.0,5781435,0,0,5781435
2008-03-20,NYSE Arca (P),680918600,434185700,363409719,1478514019,0.0,0.0,0.0,0.0,3895607,1077989,1663597,6637193
2008-03-20,Nasdaq (Q),1147068091,475096567,2175120126,3797284784,0.0,0.0,0.0,0.0,6040983,1379869,4301844,11722696
2008-03-20,CBOE (W),5365900,5429200,2574200,13369300,0.0,0.0,0.0,0.0,8747,5334,1954,16035
2008-03-20,PHLX (X),3058900,6097300,1033067,10189267,0.0,0.0,0.0,0.0,2122,212,1916,4250
2008-03-24,AMEX (A),0,37576367,78700,37655067,0.0,0.0,0.0,0.0,0,64090,260,64350
2008-03-24,NSX (C),91139311,24597275,59157177,174893763,0.0,0.0,0.0,0.0,432929,74971,291038,798938
2008-03-24,NSX (DC),107715948,21784949,100256034,229756931,0.0,0.0,0.0,0.0,374275,56408,327024,757707
2008-03-24,NYSE (DN),255048150,109569000,228366388,592983538,0.0,0.0,0.0,0.0,1682202,440207,1232102,3354511
2008-03-24,Nasdaq (DQ),773361838,207694364,504017099,1485073301,0.0,0.0,0.0,0.0,1242945,168370,693132,2104447
2008-03-24,ADF (D),18924490,2056400,9421500,30402390,0.0,0.0,0.0,0.0,60193,5734,29703,95630
2008-03-24,ISE (I),54419100,3396600,3945300,61761000,0.0,0.0,0.0,0.0,335855,2896,8875,347626
2008-03-24,CHX (M),28154300,6819700,6571717,41545717,0.0,0.0,0.0,0.0,54336,2491,17322,74149
2008-03-24,NYSE (N),1564840297,0,0,1564840297,0.0,0.0,0.0,0.0,4969215,0,0,4969215
2008-03-24,NYSE Arca (P),581527900,319930100,388562884,1290020884,0.0,0.0,0.0,0.0,3461871,853331,1688421,6003623
2008-03-24,Nasdaq (Q),976313455,376864745,1069572916,2422751116,0.0,0.0,0.0,0.0,5296152,1092569,4327996,10716717
2008-03-24,CBOE (W),5053300,3981300,2312100,11346700,0.0,0.0,0.0,0.0,4277,2826,1385,8488
2008-03-24,PHLX (X),1907900,529600,2211108,4648608,0.0,0.0,0.0,0.0,2741,230,2406,5377
2008-03-25,AMEX (A),0,36300183,96100,36396283,0.0,0.0,0.0,0.0,0,62780,411,63191
2008-03-25,NSX (C),58125083,26609110,63238882,147973075,0.0,0.0,0.0,0.0,261834,82961,313583,658378
2008-03-25,NSX (DC),62874227,12835160,63768145,139477532,0.0,0.0,0.0,0.0,234483,33155,221420,489058
2008-03-25,NYSE (DN),226185275,95972600,203946124,526103999,0.0,0.0,0.0,0.0,1509682,394435,1109966,3014083
2008-03-25,Nasdaq (DQ),757831509,171290038,497931982,1427053529,0.0,0.0,0.0,0.0,1117096,140096,633839,1891031
2008-03-25,ADF (D),18524270,2822600,9455500,30802370,0.0,0.0,0.0,0.0,62510,5882,30731,99123
2008-03-25,ISE (I),77520800,4624300,4792300,86937400,0.0,0.0,0.0,0.0,498881,5263,12485,516629
2008-03-25,CHX (M),21637600,5261500,7755222,34654322,0.0,0.0,0.0,0.0,44653,2396,11533,58582
2008-03-25,NYSE (N),1476917572,0,0,1476917572,0.0,0.0,0.0,0.0,4651201,0,0,4651201
2008-03-25,NYSE Arca (P),537448925,291525800,339061461,1168036186,0.0,0.0,0.0,0.0,3195085,834729,1537015,5566829
2008-03-25,Nasdaq (Q),914361598,364756202,979481201,2258599001,0.0,0.0,0.0,0.0,4998130,1088478,3914091,10000699
2008-03-25,CBOE (W),1400300,3107200,1675000,6182500,0.0,0.0,0.0,0.0,596,2509,357,3462
2008-03-25,PHLX (X),2319300,872400,986220,4177920,0.0,0.0,0.0,0.0,2351,177,2096,4624
2008-03-26,AMEX (A),0,38355721,80900,38436621,0.0,0.0,0.0,0.0,0,54266,244,54510
2008-03-26,NSX (C),50424382,19819557,44066907,114310846,0.0,0.0,0.0,0.0,233405,60620,222371,516396
2008-03-26,NSX (DC),83762226,16260077,80883621,180905924,0.0,0.0,0.0,0.0,295841,42013,267547,605401
2008-03-26,NYSE (DN),221871100,89979900,191000266,502851266,0.0,0.0,0.0,0.0,1477156,363296,1026158,2866610
2008-03-26,Nasdaq (DQ),787708234,154008082,422882505,1364598821,0.0,0.0,0.0,0.0,1037845,127045,549487,1714377
2008-03-26,ADF (D),17701360,2063000,8578100,28342460,0.0,0.0,0.0,0.0,62464,5206,25501,93171
2008-03-26,ISE (I),72027800,4117400,4671400,80816600,0.0,0.0,0.0,0.0,458001,4721,16594,479316
2008-03-26,CHX (M),24299470,3964700,6110886,34375056,0.0,0.0,0.0,0.0,49751,2131,11101,62983
2008-03-26,NYSE (N),1429434168,0,0,1429434168,0.0,0.0,0.0,0.0,4406079,0,0,4406079
2008-03-26,NYSE Arca (P),494642100,261197100,320305509,1076144709,0.0,0.0,0.0,0.0,2941240,723334,1429516,5094090
2008-03-26,Nasdaq (Q),852563154,352250584,908886941,2113700679,0.0,0.0,0.0,0.0,4669955,1004794,3606127,9280876
2008-03-26,CBOE (W),2281200,8717700,4642900,15641800,0.0,0.0,0.0,0.0,2717,6717,1167,10601
2008-03-26,PHLX (X),4262500,380500,1273254,5916254,0.0,0.0,0.0,0.0,1927,110,1406,3443
2008-03-27,AMEX (A),0,36349690,103700,36453390,0.0,0.0,0.0,0.0,0,47499,298,47797
2008-03-27,NSX (C),60703081,20718748,49249747,130671576,0.0,0.0,0.0,0.0,272639,66220,252737,591596
2008-03-27,NSX (DC),82248229,16871575,81824267,180944071,0.0,0.0,0.0,0.0,290551,44514,272382,607447
2008-03-27,NYSE (DN),229589500,88677100,203135627,521402227,0.0,0.0,0.0,0.0,1567293,358841,1075199,3001333
2008-03-27,Nasdaq (DQ),691280045,161615479,435379752,1288275276,0.0,0.0,0.0,0.0,926303,111269,527234,1564806
2008-03-27,ADF (D),6631280,2632400,4917000,14180680,0.0,0.0,0.0,0.0,25993,5680,15002,46675
2008-03-27,ISE (I),70174300,4943000,4611100,79728400,0.0,0.0,0.0,0.0,455626,4918,13466,474010
2008-03-27,CHX (M),25056011,4430700,6054105,35540816,0.0,0.0,0.0,0.0,44996,1985,11349,58330
2008-03-27,NYSE (N),1426882847,0,0,1426882847,0.0,0.0,0.0,0.0,4627279,0,0,4627279
2008-03-27,NYSE Arca (P),505775250,259662700,322327185,1087765135,0.0,0.0,0.0,0.0,3107957,743847,1447087,5298891
2008-03-27,Nasdaq (Q),904441706,363687586,986180300,2254309592,0.0,0.0,0.0,0.0,5159672,1082993,3848181,10090846
2008-03-27,CBOE (W),1680000,9129800,3388100,14197900,0.0,0.0,0.0,0.0,1807,10096,1083,12986
2008-03-27,PHLX (X),3109300,502000,1554781,5166081,0.0,0.0,0.0,0.0,2335,124,2206,4665
2008-03-28,AMEX (A),0,31372490,66100,31438590,0.0,0.0,0.0,0.0,0,48321,242,48563
2008-03-28,NSX (C),47407688,17593222,40824752,105825662,0.0,0.0,0.0,0.0,209406,59076,216717,485199
2008-03-28,NSX (DC),74397671,12781360,75678928,162857959,0.0,0.0,0.0,0.0,263060,34429,260142,557631
2008-03-28,NYSE (DN),202468100,81720600,176462866,460651566,0.0,0.0,0.0,0.0,1365068,341094,988268,2694430
2008-03-28,Nasdaq (DQ),624562838,162596312,398770888,1185930038,0.0,0.0,0.0,0.0,927876,102682,528019,1558577
2008-03-28,ADF (D),15978000,1896600,8267100,26141700,0.0,0.0,0.0,0.0,56023,4786,25142,85951
2008-03-28,ISE (I),62173000,2759500,4835000,69767500,0.0,0.0,0.0,0.0,406591,3611,17064,427266
2008-03-28,CHX (M),21892600,5966800,4262380,32121780,0.0,0.0,0.0,0.0,34683,2502,9598,46783
2008-03-28,NYSE (N),1352749517,0,0,1352749517,0.0,0.0,0.0,0.0,4131150,0,0,4131150
2008-03-28,NYSE Arca (P),454293425,217685000,278663944,950642369,0.0,0.0,0.0,0.0,2691585,633441,1318731,4643757
2008-03-28,Nasdaq (Q),798782704,306204015,868189210,1973175929,0.0,0.0,0.0,0.0,4493067,907883,3473201,8874151
2008-03-28,CBOE (W),2635900,8891000,3267900,14794800,0.0,0.0,0.0,0.0,2737,9847,1324,13908
2008-03-28,PHLX (X),2834400,786000,1284905,4905305,0.0,0.0,0.0,0.0,1723,90,1374,3187
2008-03-31,AMEX (A),0,37348175,72100,37420275,0.0,0.0,0.0,0.0,0,51702,212,51914
2008-03-31,NSX (C),63077836,20485439,39743426,123306701,0.0,0.0,0.0,0.0,258086,63877,214933,536896
2008-03-31,NSX (DC),86028933,15897456,73969486,175895875,0.0,0.0,0.0,0.0,295914,38719,259647,594280
2008-03-31,NYSE (DN),222535700,75499400,169601455,467636555,0.0,0.0,0.0,0.0,1450884,316743,983255,2750882
2008-03-31,Nasdaq (DQ),779890326,144613294,419109169,1343612789,0.0,0.0,0.0,0.0,1086195,108827,577398,1772420
2008-03-31,ADF (D),16321210,1504000,8062400,25887610,0.0,0.0,0.0,0.0,56072,4620,27119,87811
2008-03-31,ISE (I),66579700,3262300,3777200,73619200,0.0,0.0,0.0,0.0,436051,3906,13418,453375
2008-03-31,CHX (M),35591831,2618400,6488948,44699179,0.0,0.0,0.0,0.0,37071,1798,9856,48725
2008-03-31,NYSE (N),1574717416,0,0,1574717416,0.0,0.0,0.0,0.0,4438656,0,0,4438656
2008-03-31,NYSE Arca (P),503544600,230917200,280545601,1015007401,0.0,0.0,0.0,0.0,2911907,652597,1331215,4895719
2008-03-31,Nasdaq (Q),842217655,297506085,909001845,2048725585,0.0,0.0,0.0,0.0,4634860,884875,3459377,8979112
2008-03-31,CBOE (W),2809900,5747700,1363100,9920700,0.0,0.0,0.0,0.0,3254,6546,1199,10999
2008-03-31,PHLX (X),6740300,711700,652716,8104716,0.0,0.0,0.0,0.0,2350,94,1384,3828
2008-04-01,AMEX (A),0,52447170,72000,52519170,0.0,0.0,0.0,0.0,0,63899,162,64061
2008-04-01,NSX (C),73421007,29343363,56213497,158977867,0.0,0.0,0.0,0.0,304682,88526,277637,670845
2008-04-01,NSX (DC),105560485,22234639,94881701,222676825,0.0,0.0,0.0,0.0,370082,54705,321197,745984
2008-04-01,NYSE (DN),280171900,116983500,213059447,610214847,0.0,0.0,0.0,0.0,1813896,453596,1204037,3471529
2008-04-01,Nasdaq (DQ),852114318,220344462,501929617,1574388397,0.0,0.0,0.0,0.0,1242843,170738,681189,2094770
2008-04-01,ADF (D),23150960,3065300,10742500,36958760,0.0,0.0,0.0,0.0,81956,7101,36680,125737
2008-04-01,ISE (I),79565400,3616800,4678600,87860800,0.0,0.0,0.0,0.0,503226,3357,15557,522140
2008-04-01,CHX (M),28396650,3692200,5601867,37690717,0.0,0.0,0.0,0.0,24642,1184,8762,34588
2008-04-01,NYSE (N),1698407866,0,0,1698407866,0.0,0.0,0.0,0.0,5017254,0,0,5017254
2008-04-01,NYSE Arca (P),611765050,341812100,335070077,1288647227,0.0,0.0,0.0,0.0,3421998,894216,1555385,5871599
2008-04-01,Nasdaq (Q),1039912474,421165642,961659646,2422737762,0.0,0.0,0.0,0.0,5628427,1276716,4063829,10968972
2008-04-01,CBOE (W),2688900,10752700,1292300,14733900,0.0,0.0,0.0,0.0,4069,6816,1701,12586
2008-04-01,PHLX (X),8076500,606800,2393885,11077185,0.0,0.0,0.0,0.0,2090,116,1936,4142
2008-04-02,AMEX (A),0,32965229,79100,33044329,0.0,0.0,0.0,0.0,0,56189,208,56397
2008-04-02,NSX (C),61095807,24253464,45684454,131033725,0.0,0.0,0.0,0.0,241611,75514,240312,557437
2008-04-02,NSX (DC),98381742,19515590,95437788,213335120,0.0,0.0,0.0,0.0,350233,48534,303127,701894
2008-04-02,NYSE (DN),270331600,104801200,208118341,583251141,0.0,0.0,0.0,0.0,1771261,406249,1201937,3379447
2008-04-02,Nasdaq (DQ),774596823,152947496,463487918,1391032237,0.0,0.0,0.0,0.0,1280714,139928,679174,2099816
2008-04-02,ADF (D),21381780,1321400,9393400,32096580,0.0,0.0,0.0,0.0,68941,4392,30161,103494
2008-04-02,ISE (I),78516100,3616500,4615800,86748400,0.0,0.0,0.0,0.0,490561,3950,9673,504184
2008-04-02,CHX (M),19687800,4653800,6203493,30545093,0.0,0.0,0.0,0.0,28882,1745,6538,37165
2008-04-02,NYSE (N),1443944001,0,0,1443944001,0.0,0.0,0.0,0.0,4697633,0,0,4697633
2008-04-02,NYSE Arca (P),564731200,284155000,336711214,1185597414,0.0,0.0,0.0,0.0,3429784,810715,1591974,5832473
2008-04-02,Nasdaq (Q),946244455,352801559,890441003,2189487017,0.0,0.0,0.0,0.0,5293044,1096232,3947825,10337101
2008-04-02,CBOE (W),3020600,4769800,2157200,9947600,0.0,0.0,0.0,0.0,5434,4525,1862,11821
2008-04-02,PHLX (X),3489700,780200,852297,5122197,0.0,0.0,0.0,0.0,1777,141,1527,3445
2008-04-03,AMEX (A),0,30371700,58700,30430400,0.0,0.0,0.0,0.0,0,52935,149,53084
2008-04-03,NSX (C),45201032,22487692,45633380,113322104,0.0,0.0,0.0,0.0,196902,63382,225029,485313
2008-04-03,NSX (DC),88209826,15245653,82653975,186109454,0.0,0.0,0.0,0.0,316447,38263,259640,614350
2008-04-03,NYSE (DN),239878100,86254200,211496906,537629206,0.0,0.0,0.0,0.0,1617950,361266,1163697,3142913
2008-04-03,Nasdaq (DQ),789978331,150012581,466465914,1406456826,0.0,0.0,0.0,0.0,1076685,126821,595245,1798751
2008-04-03,ADF (D),19561900,1702100,8543000,29807000,0.0,0.0,0.0,0.0,66912,4760,26522,98194
2008-04-03,ISE (I),63281300,4083000,3999200,71363500,0.0,0.0,0.0,0.0,408553,4977,11097,424627
2008-04-03,CHX (M),22295400,3608200,3979741,29883341,0.0,0.0,0.0,0.0,24907,1245,7978,34130
2008-04-03,NYSE (N),1252919408,0,0,1252919408,0.0,0.0,0.0,0.0,4190148,0,0,4190148
2008-04-03,NYSE Arca (P),538839925,260633000,349858603,1149331528,0.0,0.0,0.0,0.0,3207436,741766,1641496,5590698
2008-04-03,Nasdaq (Q),820033743,293572536,828407831,1942014110,0.0,0.0,0.0,0.0,4652315,903805,3655000,9211120
2008-04-03,CBOE (W),3660000,3332400,2319900,9312300,0.0,0.0,0.0,0.0,7331,5191,2030,14552
2008-04-03,PHLX (X),5891200,469000,2118056,8478256,0.0,0.0,0.0,0.0,2326,182,1946,4454
2008-04-04,AMEX (A),0,30956392,83600,31039992,0.0,0.0,0.0,0.0,0,49609,298,49907
2008-04-04,NSX (C),48388787,21432249,45119196,114940232,0.0,0.0,0.0,0.0,197240,67922,218235,483397
2008-04-04,NSX (DC),87964720,17944702,92244561,198153983,0.0,0.0,0.0,0.0,303855,45496,283804,633155
2008-04-04,NYSE (DN),224413600,98425900,211897945,534737445,0.0,0.0,0.0,0.0,1543259,428864,1187851,3159974
2008-04-04,Nasdaq (DQ),683677069,149349966,461784674,1294811709,0.0,0.0,0.0,0.0,1131761,143455,614528,1889744
2008-04-04,ADF (D),18906130,1523400,10051600,30481130,0.0,0.0,0.0,0.0,64965,4235,31277,100477
2008-04-04,ISE (I),59112000,2170300,4032200,65314500,0.0,0.0,0.0,0.0,395812,3145,6985,405942
2008-04-04,CHX (M),26672490,2906000,5158172,34736662,0.0,0.0,0.0,0.0,21437,1122,5538,28097
2008-04-04,NYSE (N),1239631190,0,0,1239631190,0.0,0.0,0.0,0.0,4076237,0,0,4076237
2008-04-04,NYSE Arca (P),513075800,269847000,345658786,1128581586,0.0,0.0,0.0,0.0,3095711,809358,1629504,5534573
2008-04-04,Nasdaq (Q),765392657,310979141,814708269,1891080067,0.0,0.0,0.0,0.0,4433949,1008514,3540712,8983175
2008-04-04,CBOE (W),2446700,4533000,2544900,9524600,0.0,0.0,0.0,0.0,439,6990,780,8209
2008-04-04,PHLX (X),2692900,301300,921493,3915693,0.0,0.0,0.0,0.0,2063,156,2543,4762
2008-04-07,AMEX (A),0,29641510,113400,29754910,0.0,0.0,0.0,0.0,0,50117,226,50343
2008-04-07,NSX (C),48344475,19641473,44359779,112345727,0.0,0.0,0.0,0.0,201176,60128,215467,476771
2008-04-07,NSX (DC),88903337,16133795,83671686,188708818,0.0,0.0,0.0,0.0,303132,40344,252355,595831
2008-04-07,NYSE (DN),211131100,82886500,183755164,477772764,0.0,0.0,0.0,0.0,1430339,345534,1039274,2815147
2008-04-07,Nasdaq (DQ),688462039,135875026,406753975,1231091040,0.0,0.0,0.0,0.0,1119612,134454,594667,1848733
2008-04-07,ADF (D),19282050,1567800,8990300,29840150,0.0,0.0,0.0,0.0,65064,4183,28522,97769
2008-04-07,ISE (I),61620400,2118000,4542500,68280900,0.0,0.0,0.0,0.0,387068,3020,6624,396712
2008-04-07,CHX (M),17961102,2496900,4484346,24942348,0.0,0.0,0.0,0.0,26058,1172,7128,34358
2008-04-07,NYSE (N),1271113418,0,0,1271113418,0.0,0.0,0.0,0.0,4113812,0,0,4113812
2008-04-07,NYSE Arca (P),511959050,230330000,313064828,1055353878,0.0,0.0,0.0,0.0,2998518,705281,1510782,5214581
2008-04-07,Nasdaq (Q),790045497,276412131,728629980,1795087608,0.0,0.0,0.0,0.0,4388621,873613,3245552,8507786
2008-04-07,CBOE (W),2932500,3170300,1197800,7300600,0.0,0.0,0.0,0.0,459,3940,646,5045
2008-04-07,PHLX (X),4679100,411400,1073136,6163636,0.0,0.0,0.0,0.0,2259,335,2278,4872
2008-04-08,AMEX (A),0,24012479,52800,24065279,0.0,0.0,0.0,0.0,0,40484,133,40617
2008-04-08,NSX (C),49578746,17428013,42443405,109450164,0.0,0.0,0.0,0.0,199795,53658,203171,456624
2008-04-08,NSX (DC),82001282,13523082,73859258,169383622,0.0,0.0,0.0,0.0,273436,31991,231752,537179
2008-04-08,NYSE (DN),207263300,76388000,174764609,458415909,0.0,0.0,0.0,0.0,1328376,312756,984018,2625150
2008-04-08,Nasdaq (DQ),668359231,123362938,363759182,1155481351,0.0,0.0,0.0,0.0,978399,108982,507782,1595163
2008-04-08,ADF (D),16457644,1176000,8038500,25672144,0.0,0.0,0.0,0.0,54060,3837,25224,83121
2008-04-08,ISE (I),57597500,2251500,3497800,63346800,0.0,0.0,0.0,0.0,353506,2606,6783,362895
2008-04-08,CHX (M),15894811,4423400,4313793,24632004,0.0,0.0,0.0,0.0,30909,1105,6649,38663
2008-04-08,NYSE (N),1195735576,0,0,1195735576,0.0,0.0,0.0,0.0,3810129,0,0,3810129
2008-04-08,NYSE Arca (P),507423700,216573500,299303932,1023301132,0.0,0.0,0.0,0.0,2878500,644016,1431079,4953595
2008-04-08,Nasdaq (Q),774734854,264963741,707830842,1747529437,0.0,0.0,0.0,0.0,4173370,828366,3100208,8101944
2008-04-08,CBOE (W),1589100,2223900,2221600,6034600,0.0,0.0,0.0,0.0,326,2794,456,3576
2008-04-08,PHLX (X),4124100,661700,1554096,6339896,0.0,0.0,0.0,0.0,2783,122,1552,4457
2008-04-09,AMEX (A),0,30100782,104100,30204882,0.0,0.0,0.0,0.0,0,48082,283,48365
2008-04-09,NSX (C),46359268,18637672,43530258,108527198,0.0,0.0,0.0,0.0,191579,53029,192297,436905
2008-04-09,NSX (DC),78145053,17788563,80898576,176832192,0.0,0.0,0.0,0.0,276407,40160,227770,544337
2008-04-09,NYSE (DN),207261500,98782100,189567624,495611224,0.0,0.0,0.0,0.0,1380165,376282,1045003,2801450
2008-04-09,Nasdaq (DQ),636563471,161557665,416667665,1214788801,0.0,0.0,0.0,0.0,925073,114419,496416,1535908
2008-04-09,ADF (D),14968670,1630900,7290400,23889970,0.0,0.0,0.0,0.0,55266,4929,22885,83080
2008-04-09,ISE (I),54259900,1425900,4287100,59972900,0.0,0.0,0.0,0.0,333680,1848,8538,344066
2008-04-09,CHX (M),14399458,4172500,18983888,37555846,0.0,0.0,0.0,0.0,26205,1345,8627,36177
2008-04-09,NYSE (N),1214927007,0,0,1214927007,0.0,0.0,0.0,0.0,3946759,0,0,3946759
2008-04-09,NYSE Arca (P),505686200,265052800,350193124,1120932124,0.0,0.0,0.0,0.0,3043558,742111,1629380,5415049
2008-04-09,Nasdaq (Q),743893346,312768528,819855260,1876517134,0.0,0.0,0.0,0.0,4224506,936469,3435948,8596923
2008-04-09,CBOE (W),2371400,4938600,2087900,9397900,0.0,0.0,0.0,0.0,376,3124,785,4285
2008-04-09,PHLX (X),8773300,196300,987135,9956735,0.0,0.0,0.0,0.0,1958,94,1675,3727
2008-04-10,AMEX (A),0,31085947,44600,31130547,0.0,0.0,0.0,0.0,0,44231,133,44364
2008-04-10,NSX (C),47358539,18189957,47030568,112579064,0.0,0.0,0.0,0.0,199502,47131,197773,444406
2008-04-10,NSX (DC),84289712,16870961,96277266,197437939,0.0,0.0,0.0,0.0,275537,35658,264791,575986
2008-04-10,NYSE (DN),216761700,94716300,218675694,530153694,0.0,0.0,0.0,0.0,1446708,365450,1115760,2927918
2008-04-10,Nasdaq (DQ),663564676,139898849,499819636,1303283161,0.0,0.0,0.0,0.0,1016908,118461,587483,1722852
2008-04-10,ADF (D),25688040,1062500,10790200,37540740,0.0,0.0,0.0,0.0,92951,3410,30111,126472
2008-04-10,ISE (I),52495800,1258000,4409100,58162900,0.0,0.0,0.0,0.0,332327,1659,7747,341733
2008-04-10,CHX (M),15662161,2901319,6686945,25250425,0.0,0.0,0.0,0.0,26250,1080,7878,35208
2008-04-10,NYSE (N),1284368820,0,0,1284368820,0.0,0.0,0.0,0.0,4128198,0,0,4128198
2008-04-10,NYSE Arca (P),503269950,247244700,398999845,1149514495,0.0,0.0,0.0,0.0,3044902,695534,1688642,5429078
2008-04-10,Nasdaq (Q),773389189,306622056,927802932,2007814177,0.0,0.0,0.0,0.0,4382727,894861,3686538,8964126
2008-04-10,CBOE (W),3810400,6737100,5323200,15870700,0.0,0.0,0.0,0.0,350,2160,486,2996
2008-04-10,PHLX (X),3936800,542600,1270592,5749992,0.0,0.0,0.0,0.0,2016,99,2124,4239
2008-04-11,AMEX (A),0,38804665,110100,38914765,0.0,0.0,0.0,0.0,0,46395,261,46656
2008-04-11,NSX (C),51259344,19982067,43859322,115100733,0.0,0.0,0.0,0.0,186168,55927,191423,433518
2008-04-11,NSX (DC),113670659,19282740,89245623,222199022,0.0,0.0,0.0,0.0,335516,42589,260192,638297
2008-04-11,NYSE (DN),214448800,93653000,184590543,492692343,0.0,0.0,0.0,0.0,1315766,344998,986413,2647177
2008-04-11,Nasdaq (DQ),675048159,160619697,453564228,1289232084,0.0,0.0,0.0,0.0,988104,111796,530295,1630195
2008-04-11,ADF (D),18156517,1174300,7515400,26846217,0.0,0.0,0.0,0.0,57358,3563,22750,83671
2008-04-11,ISE (I),53314700,2400700,5647700,61363100,0.0,0.0,0.0,0.0,335143,5585,12184,352912
2008-04-11,CHX (M),15466793,4731957,5519746,25718496,0.0,0.0,0.0,0.0,29301,1137,7314,37752
2008-04-11,NYSE (N),1263530375,0,0,1263530375,0.0,0.0,0.0,0.0,3802338,0,0,3802338
2008-04-11,NYSE Arca (P),512566525,260275900,344959903,1117802328,0.0,0.0,0.0,0.0,2809602,699346,1558803,5067751
2008-04-11,Nasdaq (Q),790802930,313438268,821875358,1926116556,0.0,0.0,0.0,0.0,4282625,886765,3470910,8640300
2008-04-11,CBOE (W),3162900,6828700,3374200,13365800,0.0,0.0,0.0,0.0,526,3705,637,4868
2008-04-11,PHLX (X),5376700,154300,980636,6511636,0.0,0.0,0.0,0.0,2181,108,1413,3702
2008-04-14,AMEX (A),0,35656606,93800,35750406,0.0,0.0,0.0,0.0,0,43045,177,43222
2008-04-14,NSX (C),41386927,14056458,34513192,89956577,0.0,0.0,0.0,0.0,167104,41620,155816,364540
2008-04-14,NSX (DC),92026487,16336836,77694216,186057539,0.0,0.0,0.0,0.0,288323,37323,227197,552843
2008-04-14,NYSE (DN),212185357,78923877,156655568,447764802,0.0,0.0,0.0,0.0,1344406,311954,871420,2527780
2008-04-14,Nasdaq (DQ),660375570,132420651,377476616,1170272837,0.0,0.0,0.0,0.0,1021714,109500,504457,1635671
2008-04-14,ADF (D),13250517,1343308,5665322,20259147,0.0,0.0,0.0,0.0,46269,3886,17239,67394
2008-04-14,ISE (I),41975700,1166300,3279200,46421200,0.0,0.0,0.0,0.0,255368,1852,6075,263295
2008-04-14,CHX (M),19631515,2510000,4287817,26429332,0.0,0.0,0.0,0.0,25055,905,8805,34765
2008-04-14,NYSE (N),1175879326,0,0,1175879326,0.0,0.0,0.0,0.0,3565969,0,0,3565969
2008-04-14,NYSE Arca (P),534275104,219631898,290730908,1044637910,0.0,0.0,0.0,0.0,3027995,629576,1403103,5060674
2008-04-14,Nasdaq (Q),759167219,276336247,690321166,1725824632,0.0,0.0,0.0,0.0,4038446,843511,2966999,7848956
2008-04-14,CBOE (W),1642800,2670700,3204300,7517800,0.0,0.0,0.0,0.0,346,2029,454,2829
2008-04-14,PHLX (X),2117500,73300,621804,2812604,0.0,0.0,0.0,0.0,1904,143,1433,3480
2008-04-15,AMEX (A),0,25832984,52800,25885784,0.0,0.0,0.0,0.0,0,43263,192,43455
2008-04-15,NSX (C),44218519,14080899,37597057,95896475,0.0,0.0,0.0,0.0,184015,39967,164832,388814
2008-04-15,NSX (DC),85577336,15359494,80655121,181591951,0.0,0.0,0.0,0.0,273058,34982,238616,546656
2008-04-15,NYSE (DN),225174621,87328987,186122632,498626240,0.0,0.0,0.0,0.0,1436289,335668,1018580,2790537
2008-04-15,Nasdaq (DQ),664105062,125393532,416272773,1205771367,0.0,0.0,0.0,0.0,1070055,110814,549555,1730424
2008-04-15,ADF (D),12399249,1136097,7576802,21112148,0.0,0.0,0.0,0.0,45615,3622,21415,70652
2008-04-15,ISE (I),50605200,1920900,5068200,57594300,0.0,0.0,0.0,0.0,319237,2853,8729,330819
2008-04-15,CHX (M),16130610,2537446,5222597,23890653,0.0,0.0,0.0,0.0,27587,819,8517,36923
2008-04-15,NYSE (N),1234366792,0,0,1234366792,0.0,0.0,0.0,0.0,3867704,0,0,3867704
2008-04-15,NYSE Arca (P),509484704,228238396,362412175,1100135275,0.0,0.0,0.0,0.0,3035429,657707,1647180,5340316
2008-04-15,Nasdaq (Q),739859838,273180160,803119765,1816159763,0.0,0.0,0.0,0.0,4168285,842893,3377116,8388294
2008-04-15,CBOE (W),2196500,3846800,2664400,8707700,0.0,0.0,0.0,0.0,374,2493,793,3660
2008-04-15,PHLX (X),1586200,249000,1414980,3250180,0.0,0.0,0.0,0.0,1753,111,1211,3075
2008-04-16,AMEX (A),0,34524422,87700,34612122,0.0,0.0,0.0,0.0,0,56661,214,56875
2008-04-16,NSX (C),53261150,19198067,43857270,116316487,0.0,0.0,0.0,0.0,207331,50448,177136,434915
2008-04-16,NSX (DC),107161651,20626793,94795536,222583980,0.0,0.0,0.0,0.0,328766,50974,265207,644947
2008-04-16,NYSE (DN),262943512,104563095,206192314,573698921,0.0,0.0,0.0,0.0,1638172,364753,1107082,3110007
2008-04-16,Nasdaq (DQ),789453688,167662106,469692769,1426808563,0.0,0.0,0.0,0.0,1193413,147002,604115,1944530
2008-04-16,ADF (D),20247472,1620527,8931129,30799128,0.0,0.0,0.0,0.0,68719,4601,27083,100403
2008-04-16,ISE (I),57853400,1907900,4720000,64481300,0.0,0.0,0.0,0.0,360676,2443,9348,372467
2008-04-16,CHX (M),18658648,5379424,5576622,29614694,0.0,0.0,0.0,0.0,27885,1408,7053,36346
2008-04-16,NYSE (N),1442006786,0,0,1442006786,0.0,0.0,0.0,0.0,4227579,0,0,4227579
2008-04-16,NYSE Arca (P),589088985,278360404,381789233,1249238622,0.0,0.0,0.0,0.0,3350537,760257,1703224,5814018
2008-04-16,Nasdaq (Q),881390798,348258423,930941304,2160590525,0.0,0.0,0.0,0.0,4848119,1018827,3787265,9654211
2008-04-16,CBOE (W),3067100,5857400,3205100,12129600,0.0,0.0,0.0,0.0,497,1792,1008,3297
2008-04-16,PHLX (X),4774500,398400,1359598,6532498,0.0,0.0,0.0,0.0,2050,138,1321,3509
2008-04-17,AMEX (A),0,33186837,119100,33305937,0.0,0.0,0.0,0.0,0,44682,360,45042
2008-04-17,NSX (C),40639986,16314787,33120465,90075238,0.0,0.0,0.0,0.0,173100,41077,157642,371819
2008-04-17,NSX (DC),85269092,15733044,74719534,175721670,0.0,0.0,0.0,0.0,271454,37555,228179,537188
2008-04-17,NYSE (DN),231612961,96946965,182614309,511174235,0.0,0.0,0.0,0.0,1472087,355433,999751,2827271
2008-04-17,Nasdaq (DQ),674734182,158953946,426189944,1259878072,0.0,0.0,0.0,0.0,1077771,118324,550486,1746581
2008-04-17,ADF (D),16544595,1663250,8296920,26504765,0.0,0.0,0.0,0.0,59517,3927,23803,87247
2008-04-17,ISE (I),48956500,2814400,3875000,55645900,0.0,0.0,0.0,0.0,315135,4518,7712,327365
2008-04-17,CHX (M),24431053,3893387,3936873,32261313,0.0,0.0,0.0,0.0,26808,848,6468,34124
2008-04-17,NYSE (N),1228177441,0,0,1228177441,0.0,0.0,0.0,0.0,3983884,0,0,3983884
2008-04-17,NYSE Arca (P),519460619,248254293,345929952,1113644864,0.0,0.0,0.0,0.0,3043290,702410,1579388,5325088
2008-04-17,Nasdaq (Q),810913692,310802446,781814883,1903531021,0.0,0.0,0.0,0.0,4454812,882430,3311349,8648591
2008-04-17,CBOE (W),2540100,4626300,5212600,12379000,0.0,0.0,0.0,0.0,518,2670,1590,4778
2008-04-17,PHLX (X),5369500,1199300,902413,7471213,0.0,0.0,0.0,0.0,1888,66,1528,3482
2008-04-18,AMEX (A),0,38669812,73000,38742812,0.0,0.0,0.0,0.0,0,48065,216,48281
2008-04-18,NSX (C),31674652,15933972,31068499,78677123,0.0,0.0,0.0,0.0,147446,44268,154443,346157
2008-04-18,NSX (DC),141038472,37652470,115632869,294323811,0.0,0.0,0.0,0.0,596063,115306,427460,1138829
2008-04-18,NYSE (DN),200669583,92813634,181749168,475232385,0.0,0.0,0.0,0.0,1286933,341563,948292,2576788
2008-04-18,Nasdaq (DQ),754926910,181510082,477018295,1413455287,0.0,0.0,0.0,0.0,1260189,151381,670401,2081971
2008-04-18,ADF (D),17157713,1623893,9279637,28061243,0.0,0.0,0.0,0.0,60291,4602,26060,90953
2008-04-18,ISE (I),52908600,1851100,6122200,60881900,0.0,0.0,0.0,0.0,330313,2038,10367,342718
2008-04-18,CHX (M),17913296,5166093,7550279,30629668,0.0,0.0,0.0,0.0,27648,2604,7828,38080
2008-04-18,NYSE (N),1482037635,0,0,1482037635,0.0,0.0,0.0,0.0,4194876,0,0,4194876
2008-04-18,NYSE Arca (P),580565118,299166962,408685679,1288417759,0.0,0.0,0.0,0.0,3321181,814928,1779892,5916001
2008-04-18,Nasdaq (Q),904333100,349030144,989891704,2243254948,0.0,0.0,0.0,0.0,4835556,954153,3660383,9450092
2008-04-18,CBOE (W),3100100,5091600,4515900,12707600,0.0,0.0,0.0,0.0,906,1659,1712,4277
2008-04-18,PHLX (X),4321500,1050700,1030955,6403155,0.0,0.0,0.0,0.0,2037,225,1139,3401
2008-04-21,AMEX (A),0,31340581,116500,31457081,0.0,0.0,0.0,0.0,0,41409,241,41650
2008-04-21,NSX (C),40842952,12057990,29184702,82085644,0.0,0.0,0.0,0.0,172626,35037,149491,357154
2008-04-21,NSX (DC),90921167,15665212,73504374,180090753,0.0,0.0,0.0,0.0,298719,39955,227634,566308
2008-04-21,NYSE (DN),189740204,68852768,164740469,423333441,0.0,0.0,0.0,0.0,1182777,264715,924415,2371907
2008-04-21,Nasdaq (DQ),654011802,117272201,373408611,1144692614,0.0,0.0,0.0,0.0,1074758,118410,550921,1744089
2008-04-21,ADF (D),17383462,1315200,8070080,26768742,0.0,0.0,0.0,0.0,66346,4363,26032,96741
2008-04-21,ISE (I),41242700,891000,4401800,46535500,0.0,0.0,0.0,0.0,242952,1198,7993,252143
2008-04-21,CHX (M),17709305,2666555,5619225,25995085,0.0,0.0,0.0,0.0,24826,937,7351,33114
2008-04-21,NYSE (N),1124668175,0,0,1124668175,0.0,0.0,0.0,0.0,3548327,0,0,3548327
2008-04-21,NYSE Arca (P),473275833,186423754,302911758,962611345,0.0,0.0,0.0,0.0,2740293,576475,1479869,4796637
2008-04-21,Nasdaq (Q),741567281,229472573,690190120,1661229974,0.0,0.0,0.0,0.0,4009798,692209,3062400,7764407
2008-04-21,CBOE (W),1029900,2366000,1759000,5154900,0.0,0.0,0.0,0.0,537,590,1028,2155
2008-04-21,PHLX (X),2387400,502100,1274896,4164396,0.0,0.0,0.0,0.0,1913,126,1568,3607
2008-04-22,AMEX (A),0,30898593,49700,30948293,0.0,0.0,0.0,0.0,0,48843,152,48995
2008-04-22,NSX (C),46165561,17895359,36562429,100623349,0.0,0.0,0.0,0.0,203591,47610,165074,416275
2008-04-22,NSX (DC),92125677,16596996,84926736,193649409,0.0,0.0,0.0,0.0,315813,40455,264359,620627
2008-04-22,NYSE (DN),231774036,96825419,196351873,524951328,0.0,0.0,0.0,0.0,1430772,351968,1067268,2850008
2008-04-22,Nasdaq (DQ),716733702,156925148,454276141,1327934991,0.0,0.0,0.0,0.0,1168360,128844,593421,1890625
2008-04-22,ADF (D),19912922,2514071,9227668,31654661,0.0,0.0,0.0,0.0,70587,4957,29601,105145
2008-04-22,ISE (I),56320000,1429200,7283500,65032700,0.0,0.0,0.0,0.0,350050,2037,20394,372481
2008-04-22,CHX (M),19497207,4052716,6095116,29645039,0.0,0.0,0.0,0.0,27036,993,7770,35799
2008-04-22,NYSE (N),1329638488,0,0,1329638488,0.0,0.0,0.0,0.0,4227527,0,0,4227527
2008-04-22,NYSE Arca (P),572317363,242908020,368358546,1183583929,0.0,0.0,0.0,0.0,3234565,723338,1725306,5683209
2008-04-22,Nasdaq (Q),837037669,287247981,824434415,1948720065,0.0,0.0,0.0,0.0,4585602,847251,3544496,8977349
2008-04-22,CBOE (W),1359800,2585300,2002400,5947500,0.0,0.0,0.0,0.0,572,1105,1180,2857
2008-04-22,PHLX (X),5715900,1275300,1683874,8675074,0.0,0.0,0.0,0.0,2442,81,1833,4356
2008-04-23,AMEX (A),0,27693488,47900,27741388,0.0,0.0,0.0,0.0,0,45520,153,45673
2008-04-23,NSX (C),50729905,15005132,42373523,108108560,0.0,0.0,0.0,0.0,207491,43737,171377,422605
2008-04-23,NSX (DC),104726569,16942552,94640724,216309845,0.0,0.0,0.0,0.0,346460,40232,272620,659312
2008-04-23,NYSE (DN),249959463,93928355,211234359,555122177,0.0,0.0,0.0,0.0,1490092,343061,1085141,2918294
2008-04-23,Nasdaq (DQ),770833705,139825579,498127516,1408786800,0.0,0.0,0.0,0.0,1151349,126092,604846,1882287
2008-04-23,ADF (D),18963178,1902775,9473887,30339840,0.0,0.0,0.0,0.0,69568,5295,27750,102613
2008-04-23,ISE (I),52841600,1050600,4665200,58557400,0.0,0.0,0.0,0.0,312335,1547,9281,323163
2008-04-23,CHX (M),19025694,2724128,6603933,28353755,0.0,0.0,0.0,0.0,33596,1228,9845,44669
2008-04-23,NYSE (N),1352274329,0,0,1352274329,0.0,0.0,0.0,0.0,4171731,0,0,4171731
2008-04-23,NYSE Arca (P),585755724,243871077,409355919,1238982720,0.0,0.0,0.0,0.0,3295628,708188,1806073,5809889
2008-04-23,Nasdaq (Q),864958930,279817508,905706549,2050482987,0.0,0.0,0.0,0.0,4668232,803381,3699253,9170866
2008-04-23,CBOE (W),1762600,3067100,4016100,8845800,0.0,0.0,0.0,0.0,666,1104,10672,12442
2008-04-23,PHLX (X),5221700,303900,3125801,8651401,0.0,0.0,0.0,0.0,1974,63,1822,3859
2008-04-24,AMEX (A),0,32052407,78400,32130807,0.0,0.0,0.0,0.0,0,52437,197,52634
2008-04-24,NSX (C),58131667,22109262,52236314,132477243,0.0,0.0,0.0,0.0,231376,60493,215433,507302
2008-04-24,NSX (DC),115931454,21026488,106162908,243120850,0.0,0.0,0.0,0.0,389527,52012,326403,767942
2008-04-24,NYSE (DN),262410091,115389178,238875731,616675000,0.0,0.0,0.0,0.0,1586943,414389,1233750,3235082
2008-04-24,Nasdaq (DQ),820426776,177081240,484455375,1481963391,0.0,0.0,0.0,0.0,1297627,159707,674534,2131868
2008-04-24,ADF (D),21947351,1370959,10566528,33884838,0.0,0.0,0.0,0.0,70451,4110,31880,106441
2008-04-24,ISE (I),57475100,2243200,5372500,65090800,0.0,0.0,0.0,0.0,335638,3123,11795,350556
2008-04-24,CHX (M),23262568,5411120,8722812,37396500,0.0,0.0,0.0,0.0,39168,1527,11906,52601
2008-04-24,NYSE (N),1451170023,0,0,1451170023,0.0,0.0,0.0,0.0,4689932,0,0,4689932
2008-04-24,NYSE Arca (P),631701134,302046657,432367022,1366114813,0.0,0.0,0.0,0.0,3557551,830204,1916886,6304641
2008-04-24,Nasdaq (Q),975306378,366573198,1007457186,2349336762,0.0,0.0,0.0,0.0,5212266,1001939,4196961,10411166
2008-04-24,CBOE (W),1268000,4101200,4468300,9837500,0.0,0.0,0.0,0.0,696,1685,12777,15158
2008-04-24,PHLX (X),2936900,788800,1878407,5604107,0.0,0.0,0.0,0.0,2663,95,2384,5142
2008-04-25,AMEX (A),0,29964469,78300,30042769,0.0,0.0,0.0,0.0,0,46475,169,46644
2008-04-25,NSX (C),51949660,19862089,44101083,115912832,0.0,0.0,0.0,0.0,208147,48111,191063,447321
2008-04-25,NSX (DC),110341490,16984993,101108031,228434514,0.0,0.0,0.0,0.0,329872,39278,302681,671831
2008-04-25,NYSE (DN),222120988,95813294,205914444,523848726,0.0,0.0,0.0,0.0,1339155,344277,1069031,2752463
2008-04-25,Nasdaq (DQ),764846178,160692481,421297351,1346836010,0.0,0.0,0.0,0.0,1167791,127515,600950,1896256
2008-04-25,ADF (D),17742562,1268925,8555112,27566599,0.0,0.0,0.0,0.0,61656,3163,27645,92464
2008-04-25,ISE (I),47879400,1248900,6008000,55136300,0.0,0.0,0.0,0.0,293899,2159,18723,314781
2008-04-25,CHX (M),16095957,2412840,9465701,27974498,0.0,0.0,0.0,0.0,29720,1087,9528,40335
2008-04-25,NYSE (N),1280028978,0,0,1280028978,0.0,0.0,0.0,0.0,4102994,0,0,4102994
2008-04-25,NYSE Arca (P),536391078,227932599,341884221,1106207898,0.0,0.0,0.0,0.0,3012547,640155,1555736,5208438
2008-04-25,Nasdaq (Q),825402025,284441597,860525150,1970368772,0.0,0.0,0.0,0.0,4472602,788092,3679775,8940469
2008-04-25,CBOE (W),743600,2069300,5063000,7875900,0.0,0.0,0.0,0.0,514,1281,10555,12350
2008-04-25,PHLX (X),4515300,1606900,832806,6955006,0.0,0.0,0.0,0.0,2486,100,1659,4245
2008-04-28,AMEX (A),0,55892094,38500,55930594,0.0,0.0,0.0,0.0,0,42363,100,42463
2008-04-28,NSX (C),47082439,16626137,45111818,108820394,0.0,0.0,0.0,0.0,195218,38081,193579,426878
2008-04-28,NSX (DC),87823190,14180442,89387639,191391271,0.0,0.0,0.0,0.0,282109,30268,265672,578049
2008-04-28,NYSE (DN),193764923,67599271,170547040,431911234,0.0,0.0,0.0,0.0,1161321,250003,912306,2323630
2008-04-28,Nasdaq (DQ),741825529,114695086,448297598,1304818213,0.0,0.0,0.0,0.0,1273839,115307,638415,2027561
2008-04-28,ADF (D),16805763,1169310,6831634,24806707,0.0,0.0,0.0,0.0,56368,3261,20211,79840
2008-04-28,ISE (I),40158200,1057900,3766000,44982100,0.0,0.0,0.0,0.0,245022,1768,8928,255718
2008-04-28,CHX (M),17334243,1466692,5169828,23970763,0.0,0.0,0.0,0.0,30916,876,9239,41031
2008-04-28,NYSE (N),1208719639,0,0,1208719639,0.0,0.0,0.0,0.0,3743702,0,0,3743702
2008-04-28,NYSE Arca (P),470162919,172703499,279463098,922329516,0.0,0.0,0.0,0.0,2624119,486980,1342629,4453728
2008-04-28,Nasdaq (Q),751178818,206597809,744108067,1701884694,0.0,0.0,0.0,0.0,4034752,592612,3186956,7814320
2008-04-28,CBOE (W),1631800,1527900,5702400,8862100,0.0,0.0,0.0,0.0,448,1018,9525,10991
2008-04-28,PHLX (X),5457900,162200,621715,6241815,0.0,0.0,0.0,0.0,3813,178,1431,5422
2008-04-29,AMEX (A),0,27428178,37400,27465578,0.0,0.0,0.0,0.0,0,41190,110,41300
2008-04-29,NSX (C),50764608,17593549,38757980,107116137,0.0,0.0,0.0,0.0,214269,41928,175940,432137
2008-04-29,NSX (DC),89302110,16549843,77802143,183654096,0.0,0.0,0.0,0.0,301683,35918,230618,568219
2008-04-29,NYSE (DN),220226926,81684819,167875058,469786803,0.0,0.0,0.0,0.0,1313880,302070,909994,2525944
2008-04-29,Nasdaq (DQ),779693658,124302999,442122840,1346119497,0.0,0.0,0.0,0.0,1250507,130245,581118,1961870
2008-04-29,ADF (D),17771795,1219037,7478190,26469022,0.0,0.0,0.0,0.0,60098,3595,21110,84803
2008-04-29,ISE (I),44583100,1608200,3627400,49818700,0.0,0.0,0.0,0.0,271773,2780,9282,283835
2008-04-29,CHX (M),22872447,1966079,5588019,30426545,0.0,0.0,0.0,0.0,36643,1421,8174,46238
2008-04-29,NYSE (N),1228341924,0,0,1228341924,0.0,0.0,0.0,0.0,3870286,0,0,3870286
2008-04-29,NYSE Arca (P),516398563,191128561,282199714,989726838,0.0,0.0,0.0,0.0,2931057,574751,1311075,4816883
2008-04-29,Nasdaq (Q),805290302,244781901,753769363,1803841566,0.0,0.0,0.0,0.0,4428704,684016,3190296,8303016
2008-04-29,CBOE (W),6767500,4665900,6229400,17662800,0.0,0.0,0.0,0.0,792,1551,9948,12291
2008-04-29,PHLX (X),6267200,406000,998906,7672106,0.0,0.0,0.0,0.0,2745,89,1433,4267
2008-04-30,AMEX (A),0,34902034,38700,34940734,0.0,0.0,0.0,0.0,0,53159,136,53295
2008-04-30,NSX (C),46795604,16928044,34117628,97841276,0.0,0.0,0.0,0.0,177802,45204,147779,370785
2008-04-30,NSX (DC),92912615,21245948,85207430,199365993,0.0,0.0,0.0,0.0,318091,48037,267541,633669
2008-04-30,NYSE (DN),279848977,106671123,195479692,581999792,0.0,0.0,0.0,0.0,1697484,407108,1066484,3171076
2008-04-30,Nasdaq (DQ),833711352,155769620,545509101,1534990073,0.0,0.0,0.0,0.0,1324206,145426,714482,2184114
2008-04-30,ADF (D),20993963,2313267,9699958,33007188,0.0,0.0,0.0,0.0,78191,4818,31020,114029
2008-04-30,ISE (I),60448600,6800900,11585800,78835300,0.0,0.0,0.0,0.0,367298,17696,40818,425812
2008-04-30,CHX (M),34285767,4034181,8836666,47156614,0.0,0.0,0.0,0.0,31735,1569,9711,43015
2008-04-30,NYSE (N),1442027194,0,0,1442027194,0.0,0.0,0.0,0.0,4556061,0,0,4556061
2008-04-30,NYSE Arca (P),638964215,284966053,344559228,1268489496,0.0,0.0,0.0,0.0,3660333,811671,1631744,6103748
2008-04-30,Nasdaq (Q),1010572387,356586447,980852523,2348011357,0.0,0.0,0.0,0.0,5629431,1019585,4121576,10770592
2008-04-30,CBOE (W),1642500,2697600,2970000,7310100,0.0,0.0,0.0,0.0,565,2971,14685,18221
2008-04-30,PHLX (X),5372700,452000,6265727,12090427,0.0,0.0,0.0,0.0,4236,145,1724,6105
2008-05-01,AMEX (A),0,40788385,32900,40821285,0.0,0.0,0.0,0.0,0,56668,122,56790
2008-05-01,NSX (C),52809016,24464172,57696440,134969628,0.0,0.0,0.0,0.0,216817,59814,247514,524145
2008-05-01,NSX (DC),96554637,21656361,103932571,222143569,0.0,0.0,0.0,0.0,324108,49294,294255,667657
2008-05-01,NYSE (DN),265209505,119444181,214983103,599636789,0.0,0.0,0.0,0.0,1678214,431231,1140390,3249835
2008-05-01,Nasdaq (DQ),866128146,192921774,554919751,1613969671,0.0,0.0,0.0,0.0,1500128,175783,832927,2508838
2008-05-01,ADF (D),27582293,1625685,12732822,41940800,0.0,0.0,0.0,0.0,105575,4111,41180,150866
2008-05-01,ISE (I),54109500,2202800,5456400,61768700,0.0,0.0,0.0,0.0,324240,3247,12772,340259
2008-05-01,CHX (M),28224724,3019476,12548127,43792327,0.0,0.0,0.0,0.0,40121,1787,11255,53163
2008-05-01,NYSE (N),1398682163,0,0,1398682163,0.0,0.0,0.0,0.0,4709316,0,0,4709316
2008-05-01,NYSE Arca (P),611158059,287809759,420248032,1319215850,0.0,0.0,0.0,0.0,3678660,810503,1917910,6407073
2008-05-01,Nasdaq (Q),994254673,356158269,977840175,2328253117,0.0,0.0,0.0,0.0,5551485,977583,4123402,10652470
2008-05-01,CBOE (W),1646100,2569000,3198900,7414000,0.0,0.0,0.0,0.0,639,1583,12791,15013
2008-05-01,PHLX (X),7309500,1072500,1564245,9946245,0.0,0.0,0.0,0.0,2712,154,1614,4480
2008-05-02,AMEX (A),0,30537138,51300,30588438,0.0,0.0,0.0,0.0,0,48566,129,48695
2008-05-02,NSX (C),50762164,19510166,54909522,125181852,0.0,0.0,0.0,0.0,206338,54575,227545,488458
2008-05-02,NSX (DC),90333183,18966597,105030243,214330023,0.0,0.0,0.0,0.0,314818,42020,288331,645169
2008-05-02,NYSE (DN),244015030,114647593,218795570,577458193,0.0,0.0,0.0,0.0,1532388,427678,1157958,3118024
2008-05-02,Nasdaq (DQ),766643826,134949450,554097345,1455690621,0.0,0.0,0.0,0.0,1279187,151808,790290,2221285
2008-05-02,ADF (D),30364499,2535866,12339087,45239452,0.0,0.0,0.0,0.0,116865,6710,38992,162567
2008-05-02,ISE (I),48007300,1450700,5975000,55433000,0.0,0.0,0.0,0.0,296962,1942,13840,312744
2008-05-02,CHX (M),27961220,5629594,8922351,42513165,0.0,0.0,0.0,0.0,32975,1224,9612,43811
2008-05-02,NYSE (N),1271164900,0,0,1271164900,0.0,0.0,0.0,0.0,4243638,0,0,4243638
2008-05-02,NYSE Arca (P),531601066,254382554,400682783,1186666403,0.0,0.0,0.0,0.0,3203309,742736,1850231,5796276
2008-05-02,Nasdaq (Q),861210441,316145824,927645987,2105002252,0.0,0.0,0.0,0.0,4845587,920622,3851348,9617557
2008-05-02,CBOE (W),1017700,1788600,3063000,5869300,0.0,0.0,0.0,0.0,461,1322,11408,13191
2008-05-02,PHLX (X),5122100,2543600,1400312,9066012,0.0,0.0,0.0,0.0,3104,39,1550,4693
2008-05-05,AMEX (A),0,26448565,47000,26495565,0.0,0.0,0.0,0.0,0,44254,154,44408
2008-05-05,NSX (C),40466040,17710320,53374453,111550813,0.0,0.0,0.0,0.0,177046,44428,207323,428797
2008-05-05,NSX (DC),74670531,15033395,100967302,190671228,0.0,0.0,0.0,0.0,269799,33209,265922,568930
2008-05-05,NYSE (DN),204292162,79940606,190673385,474906153,0.0,0.0,0.0,0.0,1272762,310599,971691,2555052
2008-05-05,Nasdaq (DQ),677067718,117184046,521896127,1316147891,0.0,0.0,0.0,0.0,1173749,124053,748784,2046586
2008-05-05,ADF (D),32687252,1509197,14872362,49068811,0.0,0.0,0.0,0.0,139045,4133,47295,190473
2008-05-05,ISE (I),43861000,952400,5551500,50364900,0.0,0.0,0.0,0.0,275486,1425,12615,289526
2008-05-05,CHX (M),25635279,2590632,6980715,35206626,0.0,0.0,0.0,0.0,26478,1040,5662,33180
2008-05-05,NYSE (N),1106979491,0,0,1106979491,0.0,0.0,0.0,0.0,3812745,0,0,3812745
2008-05-05,NYSE Arca (P),448089641,177860596,355302946,981253183,0.0,0.0,0.0,0.0,2688415,562738,1618361,4869514
2008-05-05,Nasdaq (Q),730247482,215337852,844079004,1789664338,0.0,0.0,0.0,0.0,4039962,644782,3376402,8061146
2008-05-05,CBOE (W),1059800,1276600,2598300,4934700,0.0,0.0,0.0,0.0,409,752,9132,10293
2008-05-05,PHLX (X),3787400,136100,791449,4714949,0.0,0.0,0.0,0.0,3614,65,1418,5097
2008-05-06,AMEX (A),0,29812103,114300,29926403,0.0,0.0,0.0,0.0,0,56469,301,56770
2008-05-06,NSX (C),51284306,21857173,52724797,125866276,0.0,0.0,0.0,0.0,216090,51819,208943,476852
2008-05-06,NSX (DC),90742627,20544429,97090779,208377835,0.0,0.0,0.0,0.0,318611,43260,277215,639086
2008-05-06,NYSE (DN),236871957,107490298,204012870,548375125,0.0,0.0,0.0,0.0,1480311,396177,1037499,2913987
2008-05-06,Nasdaq (DQ),800618218,148893462,560237592,1509749272,0.0,0.0,0.0,0.0,1279096,146608,739694,2165398
2008-05-06,ADF (D),30604093,3005503,11581700,45191296,0.0,0.0,0.0,0.0,124374,6678,37745,168797
2008-05-06,ISE (I),52184900,1148200,6362800,59695900,0.0,0.0,0.0,0.0,330675,1711,18394,350780
2008-05-06,CHX (M),24399062,2185465,9370084,35954611,0.0,0.0,0.0,0.0,30612,1260,8435,40307
2008-05-06,NYSE (N),1233596711,0,100,1233596811,0.0,0.0,0.0,0.0,4104565,0,1,4104566
2008-05-06,NYSE Arca (P),528156281,236051170,381494453,1145701904,0.0,0.0,0.0,0.0,3148461,694592,1704112,5547165
2008-05-06,Nasdaq (Q),845906694,289164034,887371611,2022442339,0.0,0.0,0.0,0.0,4699062,821068,3588408,9108538
2008-05-06,CBOE (W),1149300,3592200,3611700,8353200,0.0,0.0,0.0,0.0,627,1835,10252,12714
2008-05-06,PHLX (X),2918300,101000,1364968,4384268,0.0,0.0,0.0,0.0,2861,106,1542,4509
2008-05-07,AMEX (A),0,28374310,121700,28496010,0.0,0.0,0.0,0.0,0,52651,333,52984
2008-05-07,NSX (C),50745105,22369958,54682757,127797820,0.0,0.0,0.0,0.0,218783,53344,220693,492820
2008-05-07,NSX (DC),99822781,22276288,102420700,224519769,0.0,0.0,0.0,0.0,344561,47258,301300,693119
2008-05-07,NYSE (DN),249988258,119445239,218005676,587439173,0.0,0.0,0.0,0.0,1506851,417653,1123153,3047657
2008-05-07,Nasdaq (DQ),801624479,163203411,540434308,1505262198,0.0,0.0,0.0,0.0,1349463,146427,779242,2275132
2008-05-07,ADF (D),29539304,2650532,11893304,44083140,0.0,0.0,0.0,0.0,122522,7043,37108,166673
2008-05-07,ISE (I),59252100,1522300,9329700,70104100,0.0,0.0,0.0,0.0,373232,2176,32482,407890
2008-05-07,CHX (M),20932883,2689355,7770899,31393137,0.0,0.0,0.0,0.0,42070,1457,10800,54327
2008-05-07,NYSE (N),1277912046,0,0,1277912046,0.0,0.0,0.0,0.0,4360176,0,0,4360176
2008-05-07,NYSE Arca (P),574833206,271686466,404129028,1250648700,0.0,0.0,0.0,0.0,3382005,770009,1815893,5967907
2008-05-07,Nasdaq (Q),878618439,317653080,942076188,2138347707,0.0,0.0,0.0,0.0,4859214,898301,3816315,9573830
2008-05-07,CBOE (W),1326100,2963300,4256300,8545700,0.0,0.0,0.0,0.0,788,1646,11270,13704
2008-05-07,PHLX (X),2189300,1788300,1123184,5100784,0.0,0.0,0.0,0.0,2526,432,2042,5000
2008-05-08,AMEX (A),0,30556368,141100,30697468,0.0,0.0,0.0,0.0,0,57009,269,57278
2008-05-08,NSX (C),50470418,26912294,52069221,129451933,0.0,0.0,0.0,0.0,217547,56489,210383,484419
2008-05-08,NSX (DC),89822071,21521840,91816120,203160031,0.0,0.0,0.0,0.0,319864,45164,275188,640216
2008-05-08,NYSE (DN),238315829,125413712,198991920,562721461,0.0,0.0,0.0,0.0,1485719,454126,1076129,3015974
2008-05-08,Nasdaq (DQ),729534450,156193617,488261750,1373989817,0.0,0.0,0.0,0.0,1245667,129283,671029,2045979
2008-05-08,ADF (D),27453546,3072606,10281276,40807428,0.0,0.0,0.0,0.0,118662,8156,34969,161787
2008-05-08,ISE (I),56899800,1648500,8618600,67166900,0.0,0.0,0.0,0.0,374056,2851,32141,409048
2008-05-08,CHX (M),21583432,2431120,5941093,29955645,0.0,0.0,0.0,0.0,35698,1754,12265,49717
2008-05-08,NYSE (N),1211469562,0,0,1211469562,0.0,0.0,0.0,0.0,4233687,0,0,4233687
2008-05-08,NYSE Arca (P),542249147,255970637,367843244,1166063028,0.0,0.0,0.0,0.0,3227144,761257,1716371,5704772
2008-05-08,Nasdaq (Q),824818889,303485617,877020103,2005324609,0.0,0.0,0.0,0.0,4608407,887307,3695215,9190929
2008-05-08,CBOE (W),3082500,3218500,5216800,11517800,0.0,0.0,0.0,0.0,757,1389,9942,12088
2008-05-08,PHLX (X),5369500,1739600,1873671,8982771,0.0,0.0,0.0,0.0,2858,532,2188,5578
2008-05-09,AMEX (A),0,29140258,87400,29227658,0.0,0.0,0.0,0.0,0,50606,249,50855
2008-05-09,NSX (C),44397315,19984146,43306888,107688349,0.0,0.0,0.0,0.0,190886,47101,180823,418810
2008-05-09,NSX (DC),83963144,23389463,79311444,186664051,0.0,0.0,0.0,0.0,286882,46124,246502,579508
2008-05-09,NYSE (DN),212230223,105129451,163441897,480801571,0.0,0.0,0.0,0.0,1286546,374250,878187,2538983
2008-05-09,Nasdaq (DQ),694198779,178013866,407193037,1279405682,0.0,0.0,0.0,0.0,1148818,133085,568568,1850471
2008-05-09,ADF (D),23482515,2094808,9022937,34600260,0.0,0.0,0.0,0.0,97390,5117,31550,134057
2008-05-09,ISE (I),42853500,1070300,4269500,48193300,0.0,0.0,0.0,0.0,259768,1874,11534,273176
2008-05-09,CHX (M),16737334,1554611,4945289,23237234,0.0,0.0,0.0,0.0,28904,1259,9086,39249
2008-05-09,NYSE (N),1099091674,0,0,1099091674,0.0,0.0,0.0,0.0,3805301,0,0,3805301
2008-05-09,NYSE Arca (P),523536231,235168620,310602647,1069307498,0.0,0.0,0.0,0.0,3060326,679752,1494757,5234835
2008-05-09,Nasdaq (Q),744225171,260447659,684122394,1688795224,0.0,0.0,0.0,0.0,4097160,750655,3049981,7897796
2008-05-09,CBOE (W),4221300,4550500,7132900,15904700,0.0,0.0,0.0,0.0,630,512,7859,9001
2008-05-09,PHLX (X),5480100,458700,1682286,7621086,0.0,0.0,0.0,0.0,2638,101,1650,4389
2008-05-12,AMEX (A),0,26898942,59900,26958842,0.0,0.0,0.0,0.0,0,51544,170,51714
2008-05-12,NSX (C),42286574,16838516,43086354,102211444,0.0,0.0,0.0,0.0,174868,40505,179053,394426
2008-05-12,NSX (DC),84870631,18403696,83066599,186340926,0.0,0.0,0.0,0.0,279328,38327,250562,568217
2008-05-12,NYSE (DN),201997365,84938841,173488010,460424216,0.0,0.0,0.0,0.0,1245749,324388,924668,2494805
2008-05-12,Nasdaq (DQ),656022527,127688545,425583576,1209294648,0.0,0.0,0.0,0.0,1205293,127443,654723,1987459
2008-05-12,ADF (D),23862213,1446437,10385229,35693879,0.0,0.0,0.0,0.0,100823,4343,36259,141425
2008-05-12,ISE (I),39011500,693300,3390600,43095400,0.0,0.0,0.0,0.0,246542,1226,9023,256791
2008-05-12,CHX (M),22255434,2250247,5078841,29584522,0.0,0.0,0.0,0.0,35709,1507,11780,48996
2008-05-12,NYSE (N),1050189063,0,0,1050189063,0.0,0.0,0.0,0.0,3693827,0,0,3693827
2008-05-12,NYSE Arca (P),499443852,199495560,319613295,1018552707,0.0,0.0,0.0,0.0,2962339,593509,1563153,5119001
2008-05-12,Nasdaq (Q),728521854,239735533,721189726,1689447113,0.0,0.0,0.0,0.0,4064005,716159,3180260,7960424
2008-05-12,CBOE (W),809400,706600,3446600,4962600,0.0,0.0,0.0,0.0,427,438,8823,9688
2008-05-12,PHLX (X),3354100,238700,1376364,4969164,0.0,0.0,0.0,0.0,2817,84,1629,4530
2008-05-13,AMEX (A),0,27408960,30700,27439660,0.0,0.0,0.0,0.0,0,47471,107,47578
2008-05-13,NSX (C),41436826,16934039,44965964,103336829,0.0,0.0,0.0,0.0,171887,40775,201242,413904
2008-05-13,NSX (DC),89132862,17099724,87850297,194082883,0.0,0.0,0.0,0.0,299658,36142,279633,615433
2008-05-13,NYSE (DN),233881368,97539686,180118312,511539366,0.0,0.0,0.0,0.0,1379614,358633,973644,2711891
2008-05-13,Nasdaq (DQ),870538286,160003934,437170032,1467712252,0.0,0.0,0.0,0.0,1281542,129130,657436,2068108
2008-05-13,ADF (D),27407389,2103650,11958248,41469287,0.0,0.0,0.0,0.0,112733,6681,40532,159946
2008-05-13,ISE (I),47568100,1330100,4647600,53545800,0.0,0.0,0.0,0.0,279176,2272,12391,293839
2008-05-13,CHX (M),26029060,1942566,5998436,33970062,0.0,0.0,0.0,0.0,36261,1581,9735,47577
2008-05-13,NYSE (N),1207766903,0,0,1207766903,0.0,0.0,0.0,0.0,3877851,0,0,3877851
2008-05-13,NYSE Arca (P),604932369,217069559,341331944,1163333872,0.0,0.0,0.0,0.0,3318375,617725,1645636,5581736
2008-05-13,Nasdaq (Q),851985300,251564466,785603996,1889153762,0.0,0.0,0.0,0.0,4488271,765765,3401352,8655388
2008-05-13,CBOE (W),2222900,1049900,6101500,9374300,0.0,0.0,0.0,0.0,631,1072,9185,10888
2008-05-13,PHLX (X),4218800,230700,1196217,5645717,0.0,0.0,0.0,0.0,2537,122,1798,4457
2008-05-14,AMEX (A),0,26295699,47900,26343599,0.0,0.0,0.0,0.0,0,47002,154,47156
2008-05-14,NSX (C),47476595,22546896,48295569,118319060,0.0,0.0,0.0,0.0,187559,44672,199220,431451
2008-05-14,NSX (DC),94213420,17308684,101640639,213162743,0.0,0.0,0.0,0.0,308891,36270,297872,643033
2008-05-14,NYSE (DN),240874348,98769295,202173327,541816970,0.0,0.0,0.0,0.0,1367276,330138,1022071,2719485
2008-05-14,Nasdaq (DQ),839966708,162269658,538298710,1540535076,0.0,0.0,0.0,0.0,1314902,133348,744275,2192525
2008-05-14,ADF (D),37929816,2308625,18079421,58317862,0.0,0.0,0.0,0.0,163812,6859,58607,229278
2008-05-14,ISE (I),49740000,1264100,5611400,56615500,0.0,0.0,0.0,0.0,285757,1825,13858,301440
2008-05-14,CHX (M),24798902,5902342,8848278,39549522,0.0,0.0,0.0,0.0,38260,1216,10004,49480
2008-05-14,NYSE (N),1188543481,0,0,1188543481,0.0,0.0,0.0,0.0,3886504,0,0,3886504
2008-05-14,NYSE Arca (P),577201628,226131157,373355984,1176688769,0.0,0.0,0.0,0.0,3201462,591316,1700281,5493059
2008-05-14,Nasdaq (Q),848444361,270239565,835988422,1954672348,0.0,0.0,0.0,0.0,4478079,723177,3435335,8636591
2008-05-14,CBOE (W),2226300,2511500,3934300,8672100,0.0,0.0,0.0,0.0,648,839,8806,10293
2008-05-14,PHLX (X),6233700,683600,2001690,8918990,0.0,0.0,0.0,0.0,4035,75,1718,5828
2008-05-15,AMEX (A),0,32466786,72700,32539486,0.0,0.0,0.0,0.0,0,51621,175,51796
2008-05-15,NSX (C),44510302,21950452,55579266,122040020,0.0,0.0,0.0,0.0,175587,49706,194958,420251
2008-05-15,NSX (DC),88853384,19930791,106038106,214822281,0.0,0.0,0.0,0.0,302966,41671,281445,626082
2008-05-15,NYSE (DN),237103753,112059953,207388170,556551876,0.0,0.0,0.0,0.0,1426955,390039,1035805,2852799
2008-05-15,Nasdaq (DQ),737775675,138550299,518279296,1394605270,0.0,0.0,0.0,0.0,1210314,139870,669619,2019803
2008-05-15,ADF (D),29322786,2190129,17259484,48772399,0.0,0.0,0.0,0.0,128378,6102,50994,185474
2008-05-15,ISE (I),49267300,1592900,4793600,55653800,0.0,0.0,0.0,0.0,287744,2466,11258,301468
2008-05-15,CHX (M),19960080,3117609,6981314,30059003,0.0,0.0,0.0,0.0,33212,1434,10169,44815
2008-05-15,NYSE (N),1195250455,0,0,1195250455,0.0,0.0,0.0,0.0,3867522,0,0,3867522
2008-05-15,NYSE Arca (P),555992532,228661665,404261840,1188916037,0.0,0.0,0.0,0.0,3250699,660938,1711155,5622792
2008-05-15,Nasdaq (Q),843037443,286281145,899786924,2029105512,0.0,0.0,0.0,0.0,4629433,823632,3479166,8932231
2008-05-15,CBOE (W),2417700,2132900,5536700,10087300,0.0,0.0,0.0,0.0,615,1030,8820,10465
2008-05-15,PHLX (X),7813400,653500,823943,9290843,0.0,0.0,0.0,0.0,3333,110,1498,4941
2008-05-16,AMEX (A),0,36097095,60000,36157095,0.0,0.0,0.0,0.0,0,53368,193,53561
2008-05-16,NSX (C),41986173,21618878,51587623,115192674,0.0,0.0,0.0,0.0,178408,51672,197286,427366
2008-05-16,NSX (DC),78020337,17426012,91216931,186663280,0.0,0.0,0.0,0.0,264762,39779,247855,552396
2008-05-16,NYSE (DN),221884452,109019920,206628119,537532491,0.0,0.0,0.0,0.0,1336009,389094,1014367,2739470
2008-05-16,Nasdaq (DQ),728143126,159627924,521820751,1409591801,0.0,0.0,0.0,0.0,1228375,141767,694024,2064166
2008-05-16,ADF (D),25914601,2073251,14214644,42202496,0.0,0.0,0.0,0.0,100577,6335,45386,152298
2008-05-16,ISE (I),44864800,1049900,4864600,50779300,0.0,0.0,0.0,0.0,259370,1743,11523,272636
2008-05-16,CHX (M),25916474,3887396,5388342,35192212,0.0,0.0,0.0,0.0,29666,1599,7729,38994
2008-05-16,NYSE (N),1314794673,0,0,1314794673,0.0,0.0,0.0,0.0,3839129,0,0,3839129
2008-05-16,NYSE Arca (P),536429163,239687563,416356874,1192473600,0.0,0.0,0.0,0.0,3134313,672290,1770666,5577269
2008-05-16,Nasdaq (Q),792007698,286168216,988149383,2066325297,0.0,0.0,0.0,0.0,4306062,816306,3499019,8621387
2008-05-16,CBOE (W),2390600,5200900,4458500,12050000,0.0,0.0,0.0,0.0,638,862,8462,9962
2008-05-16,PHLX (X),4828600,454500,2634658,7917758,0.0,0.0,0.0,0.0,2466,78,1884,4428
2008-05-19,AMEX (A),0,34295434,112400,34407834,0.0,0.0,0.0,0.0,0,55518,332,55850
2008-05-19,NSX (C),39984989,20312421,55536323,115833733,0.0,0.0,0.0,0.0,172691,50180,223014,445885
2008-05-19,NSX (DC),88561154,20877777,121787336,231226267,0.0,0.0,0.0,0.0,305357,50114,328734,684205
2008-05-19,NYSE (DN),217566227,114854025,198238310,530658562,0.0,0.0,0.0,0.0,1355552,420970,1001706,2778228
2008-05-19,Nasdaq (DQ),730633684,171708405,538661208,1441003297,0.0,0.0,0.0,0.0,1247426,162900,732793,2143119
2008-05-19,ADF (D),28199948,2849464,15601581,46650993,0.0,0.0,0.0,0.0,112499,8257,47518,168274
2008-05-19,ISE (I),43901000,1242300,5614000,50757300,0.0,0.0,0.0,0.0,273052,1773,12242,287067
2008-05-19,CHX (M),22251116,3210425,7755778,33217319,0.0,0.0,0.0,0.0,37580,1222,11200,50002
2008-05-19,NYSE (N),1150130524,0,0,1150130524,0.0,0.0,0.0,0.0,3926865,0,0,3926865
2008-05-19,NYSE Arca (P),528453228,253151165,396444679,1178049072,0.0,0.0,0.0,0.0,3194809,686557,1830001,5711367
2008-05-19,Nasdaq (Q),829017426,292050549,934029764,2055097739,0.0,0.0,0.0,0.0,4604020,868131,3760312,9232463
2008-05-19,CBOE (W),4085800,4864200,6416000,15366000,0.0,0.0,0.0,0.0,858,1476,11238,13572
2008-05-19,PHLX (X),2346500,1145300,857510,4349310,0.0,0.0,0.0,0.0,1864,106,1129,3099
2008-05-20,AMEX (A),0,44040874,385600,44426474,0.0,0.0,0.0,0.0,0,55883,312,56195
2008-05-20,NSX (C),46462747,23743715,47241385,117447847,0.0,0.0,0.0,0.0,201162,57440,203136,461738
2008-05-20,NSX (DC),94935497,23724882,100398032,219058411,0.0,0.0,0.0,0.0,331253,53799,294453,679505
2008-05-20,NYSE (DN),233553012,117702378,191248560,542503950,0.0,0.0,0.0,0.0,1417743,428757,1016911,2863411
2008-05-20,Nasdaq (DQ),738682624,179427966,459800473,1377911063,0.0,0.0,0.0,0.0,1293654,164892,652626,2111172
2008-05-20,ADF (D),31625400,1942653,16501206,50069259,0.0,0.0,0.0,0.0,140396,5410,53772,199578
2008-05-20,ISE (I),45811500,1505000,4143200,51459700,0.0,0.0,0.0,0.0,268694,2451,9536,280681
2008-05-20,CHX (M),19497948,2163223,6846429,28507600,0.0,0.0,0.0,0.0,35431,1345,8495,45271
2008-05-20,NYSE (N),1238117934,0,0,1238117934,0.0,0.0,0.0,0.0,4115827,0,0,4115827
2008-05-20,NYSE Arca (P),560482855,269193643,367334867,1197011365,0.0,0.0,0.0,0.0,3330438,749597,1768406,5848441
2008-05-20,Nasdaq (Q),842021828,299744694,847282321,1989048843,0.0,0.0,0.0,0.0,4633945,885938,3587018,9106901
2008-05-20,CBOE (W),3228900,3224100,3976700,10429700,0.0,0.0,0.0,0.0,758,2021,9630,12409
2008-05-20,PHLX (X),4026900,1850600,580317,6457817,0.0,0.0,0.0,0.0,2353,77,1082,3512
2008-05-21,AMEX (A),0,41034944,253900,41288844,0.0,0.0,0.0,0.0,0,67226,416,67642
2008-05-21,NSX (C),54297269,27558165,52175054,134030488,0.0,0.0,0.0,0.0,236516,63724,218093,518333
2008-05-21,NSX (DC),121773208,25968736,107556353,255298297,0.0,0.0,0.0,0.0,416665,59781,318723,795169
2008-05-21,NYSE (DN),290232757,159684811,207358847,657276415,0.0,0.0,0.0,0.0,1766329,555011,1136475,3457815
2008-05-21,Nasdaq (DQ),865914505,217911687,492153264,1575979456,0.0,0.0,0.0,0.0,1492638,202062,714462,2409162
2008-05-21,ADF (D),33203037,2302310,12120839,47626186,0.0,0.0,0.0,0.0,134413,7470,39075,180958
2008-05-21,ISE (I),62479100,3266200,5303400,71048700,0.0,0.0,0.0,0.0,362153,4084,12397,378634
2008-05-21,CHX (M),25512991,4648364,5551390,35712745,0.0,0.0,0.0,0.0,43815,2597,10298,56710
2008-05-21,NYSE (N),1389453965,0,0,1389453965,0.0,0.0,0.0,0.0,4653802,0,0,4653802
2008-05-21,NYSE Arca (P),643693973,356146530,404843475,1404683978,0.0,0.0,0.0,0.0,3804568,963510,1942151,6710229
2008-05-21,Nasdaq (Q),1024025868,415286922,927487321,2366800111,0.0,0.0,0.0,0.0,5702875,1191188,3959729,10853792
2008-05-21,CBOE (W),1510600,5100200,4781700,11392500,0.0,0.0,0.0,0.0,705,3349,12063,16117
2008-05-21,PHLX (X),11072300,730700,1471455,13274455,0.0,0.0,0.0,0.0,2733,130,1000,3863
2008-05-22,AMEX (A),0,40420771,82700,40503471,0.0,0.0,0.0,0.0,0,54035,151,54186
2008-05-22,NSX (C),48970446,21884521,45366999,116221966,0.0,0.0,0.0,0.0,226168,54974,207827,488969
2008-05-22,NSX (DC),103289565,21966532,90662507,215918604,0.0,0.0,0.0,0.0,368955,50219,266940,686114
2008-05-22,NYSE (DN),238322057,113642285,173771765,525736107,0.0,0.0,0.0,0.0,1453220,422250,980519,2855989
2008-05-22,Nasdaq (DQ),813391445,170716825,447815764,1431924034,0.0,0.0,0.0,0.0,1344960,158265,647605,2150830
2008-05-22,ADF (D),26084295,1582851,11199536,38866682,0.0,0.0,0.0,0.0,111586,4814,37261,153661
2008-05-22,ISE (I),54043000,3717300,4088200,61848500,0.0,0.0,0.0,0.0,322352,3474,10099,335925
2008-05-22,CHX (M),21978873,2887630,8089140,32955643,0.0,0.0,0.0,0.0,26914,1444,6925,35283
2008-05-22,NYSE (N),1207372996,0,0,1207372996,0.0,0.0,0.0,0.0,4097073,0,0,4097073
2008-05-22,NYSE Arca (P),551451183,245039715,341173718,1137664616,0.0,0.0,0.0,0.0,3176581,722981,1695840,5595402
2008-05-22,Nasdaq (Q),886755349,304350303,813712399,2004818051,0.0,0.0,0.0,0.0,4837804,926443,3581176,9345423
2008-05-22,CBOE (W),2784600,1735200,2754100,7273900,0.0,0.0,0.0,0.0,495,1297,8688,10480
2008-05-22,PHLX (X),3610900,452000,2467619,6530519,0.0,0.0,0.0,0.0,2506,70,1025,3601
2008-05-23,AMEX (A),0,28117647,65800,28183447,0.0,0.0,0.0,0.0,0,47922,147,48069
2008-05-23,NSX (C),44162220,19672979,36200537,100035736,0.0,0.0,0.0,0.0,196982,49434,166636,413052
2008-05-23,NSX (DC),86693713,20294603,80789431,187777747,0.0,0.0,0.0,0.0,304553,49229,250763,604545
2008-05-23,NYSE (DN),217664134,106840499,160355658,484860291,0.0,0.0,0.0,0.0,1355028,384623,897005,2636656
2008-05-23,Nasdaq (DQ),698531685,160177984,399186932,1257896601,0.0,0.0,0.0,0.0,1214574,162539,587945,1965058
2008-05-23,ADF (D),23961728,2614704,10540246,37116678,0.0,0.0,0.0,0.0,98788,6043,31898,136729
2008-05-23,ISE (I),52868800,1533600,6889800,61292200,0.0,0.0,0.0,0.0,331072,2415,28910,362397
2008-05-23,CHX (M),23468598,2427446,9028464,34924508,0.0,0.0,0.0,0.0,25619,1108,7699,34426
2008-05-23,NYSE (N),1105574007,0,0,1105574007,0.0,0.0,0.0,0.0,3817827,0,0,3817827
2008-05-23,NYSE Arca (P),478520535,234141021,291172590,1003834146,0.0,0.0,0.0,0.0,2811701,665202,1419598,4896501
2008-05-23,Nasdaq (Q),788739515,284143422,738738202,1811621139,0.0,0.0,0.0,0.0,4446479,861444,3283430,8591353
2008-05-23,CBOE (W),4321600,2395200,3144300,9861100,0.0,0.0,0.0,0.0,427,907,9285,10619
2008-05-23,PHLX (X),1451100,339500,856877,2647477,0.0,0.0,0.0,0.0,2107,47,1041,3195
2008-05-27,AMEX (A),0,33202710,232600,33435310,0.0,0.0,0.0,0.0,0,44158,236,44394
2008-05-27,NSX (C),41562294,17035244,37220536,95818074,0.0,0.0,0.0,0.0,190733,43162,165095,398990
2008-05-27,NSX (DC),86368569,19814657,85464777,191648003,0.0,0.0,0.0,0.0,311211,46444,245302,602957
2008-05-27,NYSE (DN),217381343,96664052,153120970,467166365,0.0,0.0,0.0,0.0,1349514,351280,857846,2558640
2008-05-27,Nasdaq (DQ),738960811,150815531,404355164,1294131506,0.0,0.0,0.0,0.0,1223172,136994,589652,1949818
2008-05-27,ADF (D),29522148,1315330,11528976,42366454,0.0,0.0,0.0,0.0,111854,3308,37262,152424
2008-05-27,ISE (I),44788350,1488600,4249900,50526850,0.0,0.0,0.0,0.0,271264,1642,12096,285002
2008-05-27,CHX (M),27800266,2790808,7763817,38354891,0.0,0.0,0.0,0.0,28629,1191,8031,37851
2008-05-27,NYSE (N),1129476995,0,0,1129476995,0.0,0.0,0.0,0.0,3649317,0,0,3649317
2008-05-27,NYSE Arca (P),470516691,217239309,294194193,981950193,0.0,0.0,0.0,0.0,2810260,620207,1430703,4861170
2008-05-27,Nasdaq (Q),769533242,259918344,761371276,1790822862,0.0,0.0,0.0,0.0,4295647,755116,3155698,8206461
2008-05-27,CBOE (W),2400100,1998800,2259600,6658500,0.0,0.0,0.0,0.0,457,851,9035,10343
2008-05-27,PHLX (X),2866700,493200,609273,3969173,0.0,0.0,0.0,0.0,3047,60,1046,4153
2008-05-28,AMEX (A),0,29483866,57300,29541166,0.0,0.0,0.0,0.0,0,46183,123,46306
2008-05-28,NSX (C),49185255,16708974,41649224,107543453,0.0,0.0,0.0,0.0,223100,46820,201140,471060
2008-05-28,NSX (DC),84929381,16239786,71689542,172858709,0.0,0.0,0.0,0.0,312253,38632,232695,583580
2008-05-28,NYSE (DN),238894418,109236577,166053971,514184966,0.0,0.0,0.0,0.0,1463216,378957,921558,2763731
2008-05-28,Nasdaq (DQ),785546680,162359771,421562573,1369469024,0.0,0.0,0.0,0.0,1332984,132634,615570,2081188
2008-05-28,ADF (D),26006837,957769,12475426,39440032,0.0,0.0,0.0,0.0,106874,3384,39494,149752
2008-05-28,ISE (I),53705400,1049100,6898500,61653000,0.0,0.0,0.0,0.0,313825,1529,26876,342230
2008-05-28,CHX (M),22043525,3101003,5661174,30805702,0.0,0.0,0.0,0.0,27397,1284,10517,39198
2008-05-28,NYSE (N),1205609691,0,0,1205609691,0.0,0.0,0.0,0.0,3987030,0,0,3987030
2008-05-28,NYSE Arca (P),536927526,247087669,316591448,1100606643,0.0,0.0,0.0,0.0,3181342,677270,1505935,5364547
2008-05-28,Nasdaq (Q),892718694,289558510,804531861,1986809065,0.0,0.0,0.0,0.0,4897245,818540,3353222,9069007
2008-05-28,CBOE (W),2764700,1992600,2575800,7333100,0.0,0.0,0.0,0.0,529,1205,9665,11399
2008-05-28,PHLX (X),3461300,715400,590963,4767663,0.0,0.0,0.0,0.0,2413,166,1418,3997
2008-05-29,AMEX (A),0,32712883,88900,32801783,0.0,0.0,0.0,0.0,0,48501,184,48685
2008-05-29,NSX (C),98466048,18748846,44590606,161805500,0.0,0.0,0.0,0.0,563157,49364,213026,825547
2008-05-29,NSX (DC),96370588,21441510,92488221,210300319,0.0,0.0,0.0,0.0,366201,51694,285271,703166
2008-05-29,NYSE (DN),236265522,108728480,186155462,531149464,0.0,0.0,0.0,0.0,1468795,396596,1013501,2878892
2008-05-29,Nasdaq (DQ),741582905,152847622,432558807,1326989334,0.0,0.0,0.0,0.0,1297590,149722,648486,2095798
2008-05-29,ADF (D),26980675,1813234,11652995,40446904,0.0,0.0,0.0,0.0,112783,5601,34876,153260
2008-05-29,ISE (I),3733700,216700,5234900,9185300,0.0,0.0,0.0,0.0,20242,441,26574,47257
2008-05-29,CHX (M),22742510,4148373,9043568,35934451,0.0,0.0,0.0,0.0,29423,1878,8240,39541
2008-05-29,NYSE (N),1229394967,0,0,1229394967,0.0,0.0,0.0,0.0,4187320,0,0,4187320
2008-05-29,NYSE Arca (P),518002546,257800267,339731771,1115534584,0.0,0.0,0.0,0.0,3082645,732208,1533737,5348590
2008-05-29,Nasdaq (Q),889668155,320723262,845926078,2056317495,0.0,0.0,0.0,0.0,4949097,907033,3534474,9390604
2008-05-29,CBOE (W),1764600,2696400,4540600,9001600,0.0,0.0,0.0,0.0,451,996,10247,11694
2008-05-29,PHLX (X),2512900,1025100,579664,4117664,0.0,0.0,0.0,0.0,2090,75,1103,3268
2008-05-30,AMEX (A),0,33704407,108300,33812707,0.0,0.0,0.0,0.0,0,42076,218,42294
2008-05-30,NSX (C),45000095,14495622,43950293,103446010,0.0,0.0,0.0,0.0,229852,38918,213125,481895
2008-05-30,NSX (DC),84810938,16312636,92980313,194103887,0.0,0.0,0.0,0.0,323587,36757,285717,646061
2008-05-30,NYSE (DN),209105146,82276116,190173074,481554336,0.0,0.0,0.0,0.0,1329526,298776,1014025,2642327
2008-05-30,Nasdaq (DQ),755109614,128005326,566597379,1449712319,0.0,0.0,0.0,0.0,1363644,116455,711252,2191351
2008-05-30,ADF (D),30999973,1201368,12763146,44964487,0.0,0.0,0.0,0.0,131679,3740,40323,175742
2008-05-30,ISE (I),41573600,1321400,7246700,50141700,0.0,0.0,0.0,0.0,254319,2081,32053,288453
2008-05-30,CHX (M),19647282,3030965,7223258,29901505,0.0,0.0,0.0,0.0,22320,964,6921,30205
2008-05-30,NYSE (N),1425508237,0,0,1425508237,0.0,0.0,0.0,0.0,3694025,0,0,3694025
2008-05-30,NYSE Arca (P),460618622,191483048,330673836,982775506,0.0,0.0,0.0,0.0,2747807,526895,1442203,4716905
2008-05-30,Nasdaq (Q),751181832,213895649,958542593,1923620074,0.0,0.0,0.0,0.0,4210267,620011,3191992,8022270
2008-05-30,CBOE (W),955800,1409100,2918000,5282900,0.0,0.0,0.0,0.0,363,1034,9126,10523
2008-05-30,PHLX (X),3141700,419700,1148251,4709651,0.0,0.0,0.0,0.0,2409,105,1859,4373
2008-06-02,AMEX (A),0,32354554,70900,32425454,0.0,0.0,0.0,0.0,0,46828,170,46998
2008-06-02,NSX (C),49150982,17065365,47947302,114163649,0.0,0.0,0.0,0.0,241294,45590,238002,524886
2008-06-02,NSX (DC),92131150,20939729,96993084,210063963,0.0,0.0,0.0,0.0,353915,49777,333651,737343
2008-06-02,NYSE (DN),239153912,102808466,204719059,546681437,0.0,0.0,0.0,0.0,1523500,386135,1088282,2997917
2008-06-02,Nasdaq (DQ),691145132,148541784,438493345,1278180261,0.0,0.0,0.0,0.0,1379062,140179,698187,2217428
2008-06-02,ADF (D),30078800,1385438,14455993,45920231,0.0,0.0,0.0,0.0,136143,4032,53454,193629
2008-06-02,ISE (I),47620800,1377200,8312600,57310600,0.0,0.0,0.0,0.0,297663,2661,38477,338801
2008-06-02,CHX (M),20183374,4552845,9238131,33974350,0.0,0.0,0.0,0.0,31601,1439,12796,45836
2008-06-02,NYSE (N),1165937284,0,0,1165937284,0.0,0.0,0.0,0.0,4177934,0,0,4177934
2008-06-02,NYSE Arca (P),509542006,233233208,335202753,1077977967,0.0,0.0,0.0,0.0,3121928,688319,1515148,5325395
2008-06-02,Nasdaq (Q),844730645,295124949,832781326,1972636920,0.0,0.0,0.0,0.0,4773552,848909,3467515,9089976
2008-06-02,CBOE (W),656200,3904700,4594700,9155600,0.0,0.0,0.0,0.0,654,2144,9311,12109
2008-06-02,PHLX (X),2770900,247400,941945,3960245,0.0,0.0,0.0,0.0,1827,29,1397,3253
2008-06-03,AMEX (A),0,35124930,94900,35219830,0.0,0.0,0.0,0.0,0,49850,221,50071
2008-06-03,NSX (C),79991119,22916944,54309953,157218016,0.0,0.0,0.0,0.0,403608,57393,250048,711049
2008-06-03,NSX (DC),108988593,21503911,100405396,230897900,0.0,0.0,0.0,0.0,399948,53204,356156,809308
2008-06-03,NYSE (DN),284028123,140217814,217916292,642162229,0.0,0.0,0.0,0.0,1776870,489118,1124618,3390606
2008-06-03,Nasdaq (DQ),847577806,201732402,513341521,1562651729,0.0,0.0,0.0,0.0,1483602,156453,697181,2337236
2008-06-03,ADF (D),34051053,1640415,14227302,49918770,0.0,0.0,0.0,0.0,142109,5351,47046,194506
2008-06-03,ISE (I),34161400,596800,1062700,35820900,0.0,0.0,0.0,0.0,227389,1050,3014,231453
2008-06-03,CHX (M),17821566,3268483,4327377,25417426,0.0,0.0,0.0,0.0,23312,900,5631,29843
2008-06-03,NYSE (N),1317868275,0,0,1317868275,0.0,0.0,0.0,0.0,4606609,0,0,4606609
2008-06-03,NYSE Arca (P),603004777,322566543,391048289,1316619609,0.0,0.0,0.0,0.0,3631996,875434,1741377,6248807
2008-06-03,Nasdaq (Q),1042324283,400232130,947425724,2389982137,0.0,0.0,0.0,0.0,5883780,1105090,3878203,10867073
2008-06-03,CBOE (W),1820900,5251900,3511500,10584300,0.0,0.0,0.0,0.0,920,3812,11698,16430
2008-06-03,PHLX (X),4635500,315200,1460312,6411012,0.0,0.0,0.0,0.0,3143,99,1606,4848
2008-06-04,AMEX (A),0,34228886,142200,34371086,0.0,0.0,0.0,0.0,0,49190,433,49623
2008-06-04,NSX (C),56973707,23579639,53703339,134256685,0.0,0.0,0.0,0.0,248445,61182,262354,571981
2008-06-04,NSX (DC),96087130,19674255,93098412,208859797,0.0,0.0,0.0,0.0,347757,48797,332218,728772
2008-06-04,NYSE (DN),274333048,140304750,225187718,639825516,0.0,0.0,0.0,0.0,1704877,505526,1155607,3366010
2008-06-04,Nasdaq (DQ),807353406,170204082,477939800,1455497288,0.0,0.0,0.0,0.0,1447143,152258,713954,2313355
2008-06-04,ADF (D),36711711,2519585,14227909,53459205,0.0,0.0,0.0,0.0,163248,7841,50007,221096
2008-06-04,ISE (I),49461770,1706700,2487400,53655870,0.0,0.0,0.0,0.0,316583,3048,9071,328702
2008-06-04,CHX (M),30289770,3205468,7145818,40641056,0.0,0.0,0.0,0.0,36211,1469,8918,46598
2008-06-04,NYSE (N),1326891394,0,0,1326891394,0.0,0.0,0.0,0.0,4574132,0,0,4574132
2008-06-04,NYSE Arca (P),624000159,319042056,391310263,1334352478,0.0,0.0,0.0,0.0,3692050,880575,1696542,6269167
2008-06-04,Nasdaq (Q),1027102648,404112400,948295388,2379510436,0.0,0.0,0.0,0.0,5676890,1104343,3889054,10670287
2008-06-04,CBOE (W),2113000,2315900,3165600,7594500,0.0,0.0,0.0,0.0,1270,2133,11374,14777
2008-06-04,PHLX (X),3431900,889100,934920,5255920,0.0,0.0,0.0,0.0,3741,55,2024,5820
2008-06-05,AMEX (A),0,34496031,227100,34723131,0.0,0.0,0.0,0.0,0,48368,554,48922
2008-06-05,NSX (C),62299394,22064543,58232148,142596085,0.0,0.0,0.0,0.0,258730,55160,254489,568379
2008-06-05,NSX (DC),104031187,22250674,116338604,242620465,0.0,0.0,0.0,0.0,374230,53108,370619,797957
2008-06-05,NYSE (DN),283681920,132033087,216793068,632508075,0.0,0.0,0.0,0.0,1760504,462626,1122156,3345286
2008-06-05,Nasdaq (DQ),855638872,189151738,559427790,1604218400,0.0,0.0,0.0,0.0,1437613,154208,730055,2321876
2008-06-05,ADF (D),31709174,2155419,12503988,46368581,0.0,0.0,0.0,0.0,136285,4720,41151,182156
2008-06-05,ISE (I),55929400,867800,3748500,60545700,0.0,0.0,0.0,0.0,334686,1382,11364,347432
2008-06-05,CHX (M),26115662,3577418,6356475,36049555,0.0,0.0,0.0,0.0,31730,1078,8116,40924
2008-06-05,NYSE (N),1315941434,0,0,1315941434,0.0,0.0,0.0,0.0,4233231,0,0,4233231
2008-06-05,NYSE Arca (P),607471046,323921914,378797661,1310190621,0.0,0.0,0.0,0.0,3571921,829459,1644849,6046229
2008-06-05,Nasdaq (Q),995009698,361636921,904313650,2260960269,0.0,0.0,0.0,0.0,5323940,978932,3609847,9912719
2008-06-05,CBOE (W),2928600,3625500,5853200,12407300,0.0,0.0,0.0,0.0,593,999,7397,8989
2008-06-05,PHLX (X),2750700,1290400,1087279,5128379,0.0,0.0,0.0,0.0,3227,102,1904,5233
2008-06-06,AMEX (A),0,46364076,327000,46691076,0.0,0.0,0.0,0.0,0,56638,533,57171
2008-06-06,NSX (C),68203731,32059132,52397546,152660409,0.0,0.0,0.0,0.0,284016,72680,240142,596838
2008-06-06,NSX (DC),115227738,34366802,113811561,263406101,0.0,0.0,0.0,0.0,403199,81604,393699,878502
2008-06-06,NYSE (DN),343868180,188281615,236098379,768248174,0.0,0.0,0.0,0.0,2209280,648532,1271601,4129413
2008-06-06,Nasdaq (DQ),824521403,226439167,432744916,1483705486,0.0,0.0,0.0,0.0,1536585,189402,702423,2428410
2008-06-06,ADF (D),37372111,4005050,14869268,56246429,0.0,0.0,0.0,0.0,167676,8345,55368,231389
2008-06-06,ISE (I),62459200,1066100,3608800,67134100,0.0,0.0,0.0,0.0,390078,1957,11762,403797
2008-06-06,CHX (M),22916932,4033062,5552022,32502016,0.0,0.0,0.0,0.0,44961,2476,10345,57782
2008-06-06,NYSE (N),1484260435,0,0,1484260435,0.0,0.0,0.0,0.0,5111851,0,0,5111851
2008-06-06,NYSE Arca (P),671484806,390042857,389270355,1450798018,0.0,0.0,0.0,0.0,4080110,1072372,1763502,6915984
2008-06-06,Nasdaq (Q),1132140278,544110547,950817580,2627068405,0.0,0.0,0.0,0.0,6441758,1423540,3993947,11859245
2008-06-06,CBOE (W),4053500,4096800,5558100,13708400,0.0,0.0,0.0,0.0,645,1454,12134,14233
2008-06-06,PHLX (X),6708800,2512000,1131671,10352471,0.0,0.0,0.0,0.0,3944,82,2086,6112
2008-06-09,AMEX (A),0,31576474,327700,31904174,0.0,0.0,0.0,0.0,0,49235,402,49637
2008-06-09,NSX (C),70401919,31889205,68073718,170364842,0.0,0.0,0.0,0.0,289478,72101,314942,676521
2008-06-09,NSX (DC),209512352,87772940,172650325,469935617,0.0,0.0,0.0,0.0,1079881,252819,724165,2056865
2008-06-09,NYSE (DN),159981046,75468440,120685775,356135261,0.0,0.0,0.0,0.0,967857,254719,640036,1862612
2008-06-09,Nasdaq (DQ),812845780,170003715,444127560,1426977055,0.0,0.0,0.0,0.0,1425791,161232,701056,2288079
2008-06-09,ADF (D),30584337,3125392,11928531,45638260,0.0,0.0,0.0,0.0,126127,6151,40470,172748
2008-06-09,ISE (I),63435700,1321500,3523000,68280200,0.0,0.0,0.0,0.0,382992,1823,13450,398265
2008-06-09,CHX (M),24983531,3651427,4580025,33214983,0.0,0.0,0.0,0.0,35663,1384,9971,47018
2008-06-09,NYSE (N),1348807063,0,0,1348807063,0.0,0.0,0.0,0.0,4586330,0,0,4586330
2008-06-09,NYSE Arca (P),636408242,327153835,368802311,1332364388,0.0,0.0,0.0,0.0,3628980,851949,1660192,6141121
2008-06-09,Nasdaq (Q),1014458984,397609396,925955271,2338023651,0.0,0.0,0.0,0.0,5417983,1031869,3846119,10295971
2008-06-09,CBOE (W),6590000,3260900,13272100,23123000,0.0,0.0,0.0,0.0,767,1381,10951,13099
2008-06-09,PHLX (X),3462500,340700,950413,4753613,0.0,0.0,0.0,0.0,5074,367,2696,8137
2008-06-10,AMEX (A),0,35630390,194700,35825090,0.0,0.0,0.0,0.0,0,56412,356,56768
2008-06-10,NSX (C),56709748,25474137,51334663,133518548,0.0,0.0,0.0,0.0,250605,64771,241474,556850
2008-06-10,NSX (DC),109620673,27866305,96366200,233853178,0.0,0.0,0.0,0.0,408482,64138,350382,823002
2008-06-10,NYSE (DN),308676620,147587831,204533710,660798161,0.0,0.0,0.0,0.0,1962896,545564,1128568,3637028
2008-06-10,Nasdaq (DQ),843177886,200526448,447798221,1491502555,0.0,0.0,0.0,0.0,1493699,173121,706679,2373499
2008-06-10,ADF (D),33852816,4932144,11760198,50545158,0.0,0.0,0.0,0.0,136634,11112,40476,188222
2008-06-10,ISE (I),58921600,1022900,3111600,63056100,0.0,0.0,0.0,0.0,370447,1600,10508,382555
2008-06-10,CHX (M),20699899,3085116,6822676,30607691,0.0,0.0,0.0,0.0,33417,959,8594,42970
2008-06-10,NYSE (N),1387580371,0,0,1387580371,0.0,0.0,0.0,0.0,4653718,0,0,4653718
2008-06-10,NYSE Arca (P),657998805,360778524,364962988,1383740317,0.0,0.0,0.0,0.0,3968862,978537,1689961,6637360
2008-06-10,Nasdaq (Q),1114633171,459332831,896540401,2470506403,0.0,0.0,0.0,0.0,6342003,1254971,3892602,11489576
2008-06-10,CBOE (W),1876600,1614900,5201300,8692800,0.0,0.0,0.0,0.0,561,1399,10151,12111
2008-06-10,PHLX (X),3048300,590600,1131349,4770249,0.0,0.0,0.0,0.0,3299,78,1605,4982
2008-06-11,AMEX (A),0,43332414,177100,43509514,0.0,0.0,0.0,0.0,0,52549,294,52843
2008-06-11,NSX (C),59432615,25282922,49026674,133742211,0.0,0.0,0.0,0.0,263199,60968,236754,560921
2008-06-11,NSX (DC),122319506,28123104,101735766,252178376,0.0,0.0,0.0,0.0,442576,64944,362471,869991
2008-06-11,NYSE (DN),331707827,160818677,217541210,710067714,0.0,0.0,0.0,0.0,2060932,579709,1163837,3804478
2008-06-11,Nasdaq (DQ),886624865,243388919,446088430,1576102214,0.0,0.0,0.0,0.0,1552661,172993,693964,2419618
2008-06-11,ADF (D),36630661,2954145,15065407,54650213,0.0,0.0,0.0,0.0,171450,7550,55339,234339
2008-06-11,ISE (I),66015800,1128600,5308300,72452700,0.0,0.0,0.0,0.0,390136,1385,14977,406498
2008-06-11,CHX (M),19063003,2905473,6157651,28126127,0.0,0.0,0.0,0.0,35567,1299,9242,46108
2008-06-11,NYSE (N),1386373332,0,0,1386373332,0.0,0.0,0.0,0.0,4721815,0,0,4721815
2008-06-11,NYSE Arca (P),660288046,326046450,354024211,1340358707,0.0,0.0,0.0,0.0,3900295,928433,1604073,6432801
2008-06-11,Nasdaq (Q),1170845535,465081890,920489539,2556416964,0.0,0.0,0.0,0.0,6518627,1314734,3954269,11787630
2008-06-11,CBOE (W),3128900,6875700,5832900,15837500,0.0,0.0,0.0,0.0,685,881,11419,12985
2008-06-11,PHLX (X),4003900,2990100,1154601,8148601,0.0,0.0,0.0,0.0,3184,100,1622,4906
2008-06-12,AMEX (A),0,41857460,166400,42023860,0.0,0.0,0.0,0.0,0,52840,306,53146
2008-06-12,NSX (C),60492336,24648928,53206658,138347922,0.0,0.0,0.0,0.0,268928,63293,248163,580384
2008-06-12,NSX (DC),121906560,26997031,103061565,251965156,0.0,0.0,0.0,0.0,434286,61477,361837,857600
2008-06-12,NYSE (DN),300096397,143164938,220558944,663820279,0.0,0.0,0.0,0.0,1905886,539006,1173970,3618862
2008-06-12,Nasdaq (DQ),929050403,219884140,488041970,1636976513,0.0,0.0,0.0,0.0,1528113,171852,713330,2413295
2008-06-12,ADF (D),37560661,3236094,16432173,57228928,0.0,0.0,0.0,0.0,151473,9123,54721,215317
2008-06-12,ISE (I),64435400,1147700,4724800,70307900,0.0,0.0,0.0,0.0,384189,1493,13961,399643
2008-06-12,CHX (M),29635626,10753235,5805055,46193916,0.0,0.0,0.0,0.0,22514,805,4797,28116
2008-06-12,NYSE (N),1333336956,0,0,1333336956,0.0,0.0,0.0,0.0,4462194,0,0,4462194
2008-06-12,NYSE Arca (P),688676739,342287253,406985987,1437949979,0.0,0.0,0.0,0.0,3927356,878935,1780704,6586995
2008-06-12,Nasdaq (Q),1129020981,430977528,976412142,2536410651,0.0,0.0,0.0,0.0,6166879,1163069,4059361,11389309
2008-06-12,CBOE (W),1407800,1318300,4937700,7663800,0.0,0.0,0.0,0.0,1014,1009,5297,7320
2008-06-12,PHLX (X),7212400,206100,1592242,9010742,0.0,0.0,0.0,0.0,3398,54,1807,5259
2008-06-13,AMEX (A),0,25537970,153200,25691170,0.0,0.0,0.0,0.0,0,47255,286,47541
2008-06-13,NSX (C),59100107,19951322,53673093,132724522,0.0,0.0,0.0,0.0,278859,55228,246172,580259
2008-06-13,NSX (DC),118238746,28632499,105346556,252217801,0.0,0.0,0.0,0.0,447198,65273,368450,880921
2008-06-13,NYSE (DN),271361452,130953269,207919548,610234269,0.0,0.0,0.0,0.0,1730646,495301,1099907,3325854
2008-06-13,Nasdaq (DQ),740228595,161938904,443472444,1345639943,0.0,0.0,0.0,0.0,1299642,139792,661442,2100876
2008-06-13,ADF (D),26728011,1343194,11787728,39858933,0.0,0.0,0.0,0.0,111897,4772,38122,154791
2008-06-13,ISE (I),56051700,1009700,5206800,62268200,0.0,0.0,0.0,0.0,334948,1613,14181,350742
2008-06-13,CHX (M),18272261,3342320,6781481,28396062,0.0,0.0,0.0,0.0,28438,1066,8398,37902
2008-06-13,NYSE (N),1224935225,0,0,1224935225,0.0,0.0,0.0,0.0,4193972,0,0,4193972
2008-06-13,NYSE Arca (P),570266206,279963068,368276974,1218506248,0.0,0.0,0.0,0.0,3340772,771539,1617154,5729465
2008-06-13,Nasdaq (Q),957091044,387028918,906326755,2250446717,0.0,0.0,0.0,0.0,5346801,1062041,3740497,10149339
2008-06-13,CBOE (W),2100000,3946900,3607900,9654800,0.0,0.0,0.0,0.0,1279,1098,8511,10888
2008-06-13,PHLX (X),5841400,171800,1026422,7039622,0.0,0.0,0.0,0.0,3894,78,2677,6649
2008-06-16,AMEX (A),0,31496441,169300,31665741,0.0,0.0,0.0,0.0,0,49234,348,49582
2008-06-16,NSX (C),52629781,21271469,48165891,122067141,0.0,0.0,0.0,0.0,245456,52816,226842,525114
2008-06-16,NSX (DC),109351246,25828161,102783700,237963107,0.0,0.0,0.0,0.0,417139,58748,352986,828873
2008-06-16,NYSE (DN),233613147,109272101,179157585,522042833,0.0,0.0,0.0,0.0,1533363,416348,965732,2915443
2008-06-16,Nasdaq (DQ),658209395,133300095,402500028,1194009518,0.0,0.0,0.0,0.0,1233191,120430,636149,1989770
2008-06-16,ADF (D),25887610,1920716,11310150,39118476,0.0,0.0,0.0,0.0,114176,5754,41685,161615
2008-06-16,ISE (I),49430500,904500,4246600,54581600,0.0,0.0,0.0,0.0,305565,1682,12071,319318
2008-06-16,CHX (M),23942052,6409663,7898236,38249951,0.0,0.0,0.0,0.0,30640,1092,9911,41643
2008-06-16,NYSE (N),1163797754,0,0,1163797754,0.0,0.0,0.0,0.0,3997495,0,0,3997495
2008-06-16,NYSE Arca (P),501528904,239585894,315905624,1057020422,0.0,0.0,0.0,0.0,3073029,667073,1467371,5207473
2008-06-16,Nasdaq (Q),884314609,311132238,806817885,2002264732,0.0,0.0,0.0,0.0,5081572,889535,3492976,9464083
2008-06-16,CBOE (W),3057600,1976200,3683700,8717500,0.0,0.0,0.0,0.0,648,1118,9782,11548
2008-06-16,PHLX (X),3310300,453600,986658,4750558,0.0,0.0,0.0,0.0,2855,103,1892,4850
2008-06-17,AMEX (A),0,28667068,112800,28779868,0.0,0.0,0.0,0.0,0,46767,272,47039
2008-06-17,NSX (C),65379838,20407303,55142729,140929870,0.0,0.0,0.0,0.0,309143,55601,263013,627757
2008-06-17,NSX (DC),108751054,25006038,81892300,215649392,0.0,0.0,0.0,0.0,421153,57415,288329,766897
2008-06-17,NYSE (DN),254816953,115825536,188755304,559397793,0.0,0.0,0.0,0.0,1605550,434642,1026808,3067000
2008-06-17,Nasdaq (DQ),759802244,146726196,418370744,1324899184,0.0,0.0,0.0,0.0,1445843,138624,691239,2275706
2008-06-17,ADF (D),35354278,2816111,11923235,50093624,0.0,0.0,0.0,0.0,165378,6034,45129,216541
2008-06-17,ISE (I),50096700,915500,4701100,55713300,0.0,0.0,0.0,0.0,304934,1800,13176,319910
2008-06-17,CHX (M),19373382,3205537,5206503,27785422,0.0,0.0,0.0,0.0,31390,1258,11292,43940
2008-06-17,NYSE (N),1093399016,0,0,1093399016,0.0,0.0,0.0,0.0,3914026,0,0,3914026
2008-06-17,NYSE Arca (P),534356803,238954102,320987330,1094298235,0.0,0.0,0.0,0.0,3216943,694216,1451971,5363130
2008-06-17,Nasdaq (Q),873713933,314296643,751503871,1939514447,0.0,0.0,0.0,0.0,4906818,912427,3275106,9094351
2008-06-17,CBOE (W),1501200,1827600,5413600,8742400,0.0,0.0,0.0,0.0,986,1599,9201,11786
2008-06-17,PHLX (X),5570100,143400,1807039,7520539,0.0,0.0,0.0,0.0,3612,76,2206,5894
2008-06-18,AMEX (A),0,32732177,110700,32842877,0.0,0.0,0.0,0.0,0,53549,308,53857
2008-06-18,NSX (C),71199939,26821977,60249111,158271027,0.0,0.0,0.0,0.0,303786,62996,267374,634156
2008-06-18,NSX (DC),136106246,33150074,102268944,271525264,0.0,0.0,0.0,0.0,494343,68610,353790,916743
2008-06-18,NYSE (DN),309452379,152502998,208733840,670689217,0.0,0.0,0.0,0.0,1899778,548063,1103427,3551268
2008-06-18,Nasdaq (DQ),910226411,209422113,445176888,1564825412,0.0,0.0,0.0,0.0,1585425,168828,736207,2490460
2008-06-18,ADF (D),33500351,1922226,11615777,47038354,0.0,0.0,0.0,0.0,148868,6217,37675,192760
2008-06-18,ISE (I),67093000,1300600,4909100,73302700,0.0,0.0,0.0,0.0,387936,2173,14131,404240
2008-06-18,CHX (M),22403552,4518995,7149774,34072321,0.0,0.0,0.0,0.0,36312,1423,10038,47773
2008-06-18,NYSE (N),1283376493,0,0,1283376493,0.0,0.0,0.0,0.0,4308344,0,0,4308344
2008-06-18,NYSE Arca (P),673359307,316424271,351610779,1341394357,0.0,0.0,0.0,0.0,3914138,845647,1584826,6344611
2008-06-18,Nasdaq (Q),1054829783,409433749,872364909,2336628441,0.0,0.0,0.0,0.0,5732936,1093608,3624451,10450995
2008-06-18,CBOE (W),2162900,3928500,7957800,14049200,0.0,0.0,0.0,0.0,922,2034,11489,14445
2008-06-18,PHLX (X),10472500,1221800,1524231,13218531,0.0,0.0,0.0,0.0,5151,97,2202,7450
2008-06-19,AMEX (A),0,33496368,186400,33682768,0.0,0.0,0.0,0.0,0,52325,254,52579
2008-06-19,NSX (C),79882818,29010104,60146109,169039031,0.0,0.0,0.0,0.0,356147,70688,284234,711069
2008-06-19,NSX (DC),162733690,36027848,123216426,321977964,0.0,0.0,0.0,0.0,584816,80050,426148,1091014
2008-06-19,NYSE (DN),328418064,165274331,231999080,725691475,0.0,0.0,0.0,0.0,2055382,606397,1204349,3866128
2008-06-19,Nasdaq (DQ),966404121,225067000,516413895,1707885016,0.0,0.0,0.0,0.0,1704237,181520,791331,2677088
2008-06-19,ADF (D),32731055,3199998,14184732,50115785,0.0,0.0,0.0,0.0,136511,7203,45223,188937
2008-06-19,ISE (I),70226600,1710200,6512600,78449400,0.0,0.0,0.0,0.0,416987,2286,16937,436210
2008-06-19,CHX (M),27425834,7214102,8290177,42930113,0.0,0.0,0.0,0.0,43616,1667,11720,57003
2008-06-19,NYSE (N),1292920436,0,0,1292920436,0.0,0.0,0.0,0.0,4469157,0,0,4469157
2008-06-19,NYSE Arca (P),728318599,349610353,369292246,1447221198,0.0,0.0,0.0,0.0,4217005,958807,1702681,6878493
2008-06-19,Nasdaq (Q),1116394667,468982528,958204038,2543581233,0.0,0.0,0.0,0.0,6084673,1256106,3998655,11339434
2008-06-19,CBOE (W),1463100,4083100,6227800,11774000,0.0,0.0,0.0,0.0,1167,1893,12114,15174
2008-06-19,PHLX (X),5841300,369900,820851,7032051,0.0,0.0,0.0,0.0,4324,46,2115,6485
2008-06-20,AMEX (A),0,44672637,216700,44889337,0.0,0.0,0.0,0.0,0,53866,465,54331
2008-06-20,NSX (C),72271514,34002951,57724803,163999268,0.0,0.0,0.0,0.0,315356,78966,272214,666536
2008-06-20,NSX (DC),142614530,37541099,110130705,290286334,0.0,0.0,0.0,0.0,538025,89835,391045,1018905
2008-06-20,NYSE (DN),309032150,176991124,225913371,711936645,0.0,0.0,0.0,0.0,1942697,658176,1191320,3792193
2008-06-20,Nasdaq (DQ),886028505,217135039,617921423,1721084967,0.0,0.0,0.0,0.0,1590679,190320,816588,2597587
2008-06-20,ADF (D),36177118,2811885,14829618,53818621,0.0,0.0,0.0,0.0,154629,8359,54084,217072
2008-06-20,ISE (I),68096700,1268800,5882800,75248300,0.0,0.0,0.0,0.0,395165,2042,18115,415322
2008-06-20,CHX (M),19700812,3424396,5824590,28949798,0.0,0.0,0.0,0.0,35095,1557,14809,51461
2008-06-20,NYSE (N),2044964902,0,0,2044964902,0.0,0.0,0.0,0.0,4601213,0,0,4601213
2008-06-20,NYSE Arca (P),683251594,377549978,373698689,1434500261,0.0,0.0,0.0,0.0,4089617,1014917,1734833,6839367
2008-06-20,Nasdaq (Q),1055582672,470257792,1284339018,2810179482,0.0,0.0,0.0,0.0,5870161,1292376,4007900,11170437
2008-06-20,CBOE (W),1793600,3918300,5816000,11527900,0.0,0.0,0.0,0.0,1014,1884,12767,15665
2008-06-20,PHLX (X),5413700,730000,700025,6843725,0.0,0.0,0.0,0.0,5131,62,2411,7604
2008-06-23,AMEX (A),0,28934924,190300,29125224,0.0,0.0,0.0,0.0,0,48687,322,49009
2008-06-23,NSX (C),65156093,24175108,52740020,142071221,0.0,0.0,0.0,0.0,298442,57986,267492,623920
2008-06-23,NSX (DC),140159110,31579699,100272637,272011446,0.0,0.0,0.0,0.0,541093,75555,375146,991794
2008-06-23,NYSE (DN),297850603,126514964,192677463,617043030,0.0,0.0,0.0,0.0,1914648,495104,1063549,3473301
2008-06-23,Nasdaq (DQ),868805637,165489388,452465494,1486760519,0.0,0.0,0.0,0.0,1545187,162631,719957,2427775
2008-06-23,ADF (D),25435782,2009470,10392871,37838123,0.0,0.0,0.0,0.0,100161,6147,36152,142460
2008-06-23,ISE (I),61392800,1357800,5158500,67909100,0.0,0.0,0.0,0.0,336020,1896,14899,352815
2008-06-23,CHX (M),29454715,4061454,4754234,38270403,0.0,0.0,0.0,0.0,40223,1328,13315,54866
2008-06-23,NYSE (N),1086532499,0,0,1086532499,0.0,0.0,0.0,0.0,3723682,0,0,3723682
2008-06-23,NYSE Arca (P),618398077,256823068,315869007,1191090152,0.0,0.0,0.0,0.0,3754376,773264,1529916,6057556
2008-06-23,Nasdaq (Q),985884967,336334563,787742166,2109961696,0.0,0.0,0.0,0.0,5486188,976592,3469231,9932011
2008-06-23,CBOE (W),1377400,3281300,5331300,9990000,0.0,0.0,0.0,0.0,1011,1558,10258,12827
2008-06-23,PHLX (X),5875300,409100,907738,7192138,0.0,0.0,0.0,0.0,4722,22,2761,7505
2008-06-24,AMEX (A),0,31925267,347600,32272867,0.0,0.0,0.0,0.0,0,50206,443,50649
2008-06-24,NSX (C),65070026,31804549,57223861,154098436,0.0,0.0,0.0,0.0,299256,67753,273060,640069
2008-06-24,NSX (DC),142956177,40523233,104465179,287944589,0.0,0.0,0.0,0.0,549849,94025,373386,1017260
2008-06-24,NYSE (DN),335302884,176181991,223572642,735057517,0.0,0.0,0.0,0.0,2133873,635174,1230611,3999658
2008-06-24,Nasdaq (DQ),897820358,230846597,500306052,1628973007,0.0,0.0,0.0,0.0,1772561,191299,812711,2776571
2008-06-24,ADF (D),32010113,2970918,12573746,47554777,0.0,0.0,0.0,0.0,135228,6797,45558,187583
2008-06-24,ISE (I),69620700,951800,5150000,75722500,0.0,0.0,0.0,0.0,403884,1355,17359,422598
2008-06-24,CHX (M),26448708,6395017,5838319,38682044,0.0,0.0,0.0,0.0,47307,1345,11016,59668
2008-06-24,NYSE (N),1339726480,0,0,1339726480,0.0,0.0,0.0,0.0,4559657,0,0,4559657
2008-06-24,NYSE Arca (P),674475497,346377006,371286815,1392139318,0.0,0.0,0.0,0.0,4042258,944869,1781783,6768910
2008-06-24,Nasdaq (Q),1088058619,469978284,915647443,2473684346,0.0,0.0,0.0,0.0,6243041,1280635,4035183,11558859
2008-06-24,CBOE (W),2845000,2253900,3681200,8780100,0.0,0.0,0.0,0.0,1024,1215,10038,12277
2008-06-24,PHLX (X),4294700,445300,1594733,6334733,0.0,0.0,0.0,0.0,3691,72,3021,6784
2008-06-25,AMEX (A),0,39169385,212600,39381985,0.0,0.0,0.0,0.0,0,54723,392,55115
2008-06-25,NSX (C),60637312,34801589,52382599,147821500,0.0,0.0,0.0,0.0,266040,68459,257786,592285
2008-06-25,NSX (DC),147595138,51227932,107126652,305949722,0.0,0.0,0.0,0.0,552169,99291,407914,1059374
2008-06-25,NYSE (DN),341473325,182497499,227446730,751417554,0.0,0.0,0.0,0.0,2159709,654551,1212297,4026557
2008-06-25,Nasdaq (DQ),908456329,236532345,483618587,1628607261,0.0,0.0,0.0,0.0,1668484,191639,748253,2608376
2008-06-25,ADF (D),32267207,3031459,11984178,47282844,0.0,0.0,0.0,0.0,134384,6731,44161,185276
2008-06-25,ISE (I),74794600,1532900,4486100,80813600,0.0,0.0,0.0,0.0,424781,1535,14091,440407
2008-06-25,CHX (M),21848212,3890613,7306867,33045692,0.0,0.0,0.0,0.0,34744,1629,9786,46159
2008-06-25,NYSE (N),1399663112,0,100,1399663212,0.0,0.0,0.0,0.0,4851549,0,1,4851550
2008-06-25,NYSE Arca (P),695498203,398327586,362536452,1456362241,0.0,0.0,0.0,0.0,4247230,1052307,1706191,7005728
2008-06-25,Nasdaq (Q),1136511476,531786332,910217361,2578515169,0.0,0.0,0.0,0.0,6569355,1370076,3972902,11912333
2008-06-25,CBOE (W),6561700,4925900,5917800,17405400,0.0,0.0,0.0,0.0,1156,2331,12520,16007
2008-06-25,PHLX (X),5456600,853200,1680482,7990282,0.0,0.0,0.0,0.0,3298,45,2262,5605
2008-06-26,AMEX (A),0,37394196,285000,37679196,0.0,0.0,0.0,0.0,0,60107,386,60493
2008-06-26,NSX (C),32106368,13883169,29922878,75912415,0.0,0.0,0.0,0.0,128677,36248,142905,307830
2008-06-26,NSX (DC),135488653,31479499,95104123,262072275,0.0,0.0,0.0,0.0,510974,86171,385403,982548
2008-06-26,NYSE (DN),347607300,179841574,239217035,766665909,0.0,0.0,0.0,0.0,2178733,718604,1333957,4231294
2008-06-26,Nasdaq (DQ),995342010,236153266,511019058,1742514334,0.0,0.0,0.0,0.0,1788883,216035,812835,2817753
2008-06-26,ADF (D),37303346,2365431,13394192,53062969,0.0,0.0,0.0,0.0,158398,6983,46514,211895
2008-06-26,ISE (I),90117600,9061800,17446900,116626300,0.0,0.0,0.0,0.0,496788,28669,79083,604540
2008-06-26,CHX (M),26102995,2585938,5682308,34371241,0.0,0.0,0.0,0.0,37860,2315,13339,53514
2008-06-26,NYSE (N),1535457213,0,0,1535457213,0.0,0.0,0.0,0.0,4899374,0,0,4899374
2008-06-26,NYSE Arca (P),741893488,369530774,394352368,1505776630,0.0,0.0,0.0,0.0,4365767,1102819,1869154,7337740
2008-06-26,Nasdaq (Q),1271846478,551243817,999573666,2822663961,0.0,0.0,0.0,0.0,6902565,1547069,4240904,12690538
2008-06-26,CBOE (W),2510700,3089300,6730800,12330800,0.0,0.0,0.0,0.0,1183,1705,11897,14785
2008-06-26,PHLX (X),16022500,914800,6917070,23854370,0.0,0.0,0.0,0.0,6545,94,3325,9964
2008-06-27,AMEX (A),0,139488780,197300,139686080,0.0,0.0,0.0,0.0,0,73990,330,74320
2008-06-27,NSX (C),63357185,23463567,53316349,140137101,0.0,0.0,0.0,0.0,272144,65621,274404,612169
2008-06-27,NSX (DC),159108564,41859106,118984761,319952431,0.0,0.0,0.0,0.0,583725,107550,454560,1145835
2008-06-27,NYSE (DN),341685612,176873990,235124152,753683754,0.0,0.0,0.0,0.0,2184384,677799,1292778,4154961
2008-06-27,Nasdaq (DQ),1285359164,247950393,1562560552,3095870109,0.0,0.0,0.0,0.0,1739623,202468,824861,2766952
2008-06-27,ADF (D),38678215,5754229,12897184,57329628,0.0,0.0,0.0,0.0,174985,11340,51169,237494
2008-06-27,ISE (I),71998700,1028100,4194900,77221700,0.0,0.0,0.0,0.0,421242,1668,11362,434272
2008-06-27,CHX (M),22984887,4130555,7653193,34768635,0.0,0.0,0.0,0.0,32000,2694,16005,50699
2008-06-27,NYSE (N),2294266402,0,100,2294266502,0.0,0.0,0.0,0.0,4995841,0,1,4995842
2008-06-27,NYSE Arca (P),747492510,356583092,381760553,1485836155,0.0,0.0,0.0,0.0,4400659,1033613,1852602,7286874
2008-06-27,Nasdaq (Q),1181704783,509615756,1898601586,3589922125,0.0,0.0,0.0,0.0,6695824,1428523,4406070,12530417
2008-06-27,CBOE (W),4593000,5045600,4810700,14449300,0.0,0.0,0.0,0.0,937,2148,12853,15938
2008-06-27,PHLX (X),6223500,880200,465182,7568882,0.0,0.0,0.0,0.0,5772,54,2493,8319
2008-06-30,AMEX (A),0,42898295,177400,43075695,0.0,0.0,0.0,0.0,0,61352,263,61615
2008-06-30,NSX (C),64450491,22487887,55381832,142320210,0.0,0.0,0.0,0.0,289291,62524,303753,655568
2008-06-30,NSX (DC),156609767,34811319,106739902,298160988,0.0,0.0,0.0,0.0,547774,91843,410475,1050092
2008-06-30,NYSE (DN),341798738,158597631,216818464,717214833,0.0,0.0,0.0,0.0,2194130,631622,1223232,4048984
2008-06-30,Nasdaq (DQ),899083787,213477969,469224261,1581786017,0.0,0.0,0.0,0.0,1815437,189972,819077,2824486
2008-06-30,ADF (D),37764644,2701070,14163472,54629186,0.0,0.0,0.0,0.0,163902,8596,51819,224317
2008-06-30,ISE (I),75812100,1189300,5636800,82638200,0.0,0.0,0.0,0.0,424116,2213,15669,441998
2008-06-30,CHX (M),21046921,2797610,5361768,29206299,0.0,0.0,0.0,0.0,33010,1402,12708,47120
2008-06-30,NYSE (N),1608535303,0,0,1608535303,0.0,0.0,0.0,0.0,4786426,0,0,4786426
2008-06-30,NYSE Arca (P),686612017,317968640,343645131,1348225788,0.0,0.0,0.0,0.0,4144074,902742,1674874,6721690
2008-06-30,Nasdaq (Q),1138559589,429853675,892557630,2460970894,0.0,0.0,0.0,0.0,6398634,1224912,3872588,11496134
2008-06-30,CBOE (W),1991100,3767900,5991000,11750000,0.0,0.0,0.0,0.0,1012,1500,11147,13659
2008-06-30,PHLX (X),4854600,769300,1113281,6737181,0.0,0.0,0.0,0.0,6694,141,2735,9570
2008-07-01,AMEX (A),0,52092092,189500,52281592,0.0,0.0,0.0,0.0,0,64944,283,65227
2008-07-01,NSX (C),68101038,29293399,63008765,160403202,0.0,0.0,0.0,0.0,307636,77603,323401,708640
2008-07-01,NSX (DC),179179905,48201561,130075765,357457231,0.0,0.0,0.0,0.0,670398,125555,525181,1321134
2008-07-01,NYSE (DN),415721144,219011740,273236828,907969712,0.0,0.0,0.0,0.0,2676078,855646,1525238,5056962
2008-07-01,Nasdaq (DQ),1047980234,309350721,578310773,1935641728,0.0,0.0,0.0,0.0,2117082,246379,961455,3324916
2008-07-01,ADF (D),43971749,3082339,17595699,64649787,0.0,0.0,0.0,0.0,185052,8851,59217,253120
2008-07-01,ISE (I),88794400,2706400,5199200,96700000,0.0,0.0,0.0,0.0,504661,5151,16606,526418
2008-07-01,CHX (M),27345359,6010068,6413496,39768923,0.0,0.0,0.0,0.0,44762,1393,13578,59733
2008-07-01,NYSE (N),1640708366,0,0,1640708366,0.0,0.0,0.0,0.0,5745277,0,0,5745277
2008-07-01,NYSE Arca (P),883617940,451796504,451637928,1787052372,0.0,0.0,0.0,0.0,5442230,1311869,2236664,8990763
2008-07-01,Nasdaq (Q),1443615551,626725500,1142193977,3212535028,0.0,0.0,0.0,0.0,8491652,1722952,5141960,15356564
2008-07-01,CBOE (W),3835300,5286500,6431900,15553700,0.0,0.0,0.0,0.0,818,2236,11833,14887
2008-07-01,PHLX (X),4065300,212800,1837179,6115279,0.0,0.0,0.0,0.0,6352,42,2490,8884
2008-07-02,AMEX (A),0,46847787,166800,47014587,0.0,0.0,0.0,0.0,0,68584,391,68975
2008-07-02,NSX (C),78109659,23909779,63865550,165884988,0.0,0.0,0.0,0.0,379865,69212,354251,803328
2008-07-02,NSX (DC),170420600,40343308,123489931,334253839,0.0,0.0,0.0,0.0,651498,106928,487012,1245438
2008-07-02,NYSE (DN),380041384,186661226,253849078,820551688,0.0,0.0,0.0,0.0,2509504,751581,1440164,4701249
2008-07-02,Nasdaq (DQ),901020892,219405791,511039012,1631465695,0.0,0.0,0.0,0.0,1692463,192575,815879,2700917
2008-07-02,ADF (D),39968260,2824405,15830241,58622906,0.0,0.0,0.0,0.0,176356,9105,57340,242801
2008-07-02,ISE (I),79847800,2098400,5249100,87195300,0.0,0.0,0.0,0.0,468879,3367,16715,488961
2008-07-02,CHX (M),23428054,3891132,14353257,41672443,0.0,0.0,0.0,0.0,50845,1884,14576,67305
2008-07-02,NYSE (N),1518739107,0,100,1518739207,0.0,0.0,0.0,0.0,5468910,0,1,5468911
2008-07-02,NYSE Arca (P),802566562,389664996,420100524,1612332082,0.0,0.0,0.0,0.0,5027149,1125898,2006469,8159516
2008-07-02,Nasdaq (Q),1277082032,509394157,1048036421,2834512610,0.0,0.0,0.0,0.0,7670753,1498633,4728188,13897574
2008-07-02,CBOE (W),1332900,4523300,8182000,14038200,0.0,0.0,0.0,0.0,1076,1401,11703,14180
2008-07-02,PHLX (X),4473600,554300,1438311,6466211,0.0,0.0,0.0,0.0,6565,23,3096,9684
2008-07-03,AMEX (A),0,28611547,202300,28813847,0.0,0.0,0.0,0.0,0,44150,246,44396
2008-07-03,NSX (C),43994292,18450616,35451385,97896293,0.0,0.0,0.0,0.0,205072,52031,182035,439138
2008-07-03,NSX (DC),114388925,28009686,74323914,216722525,0.0,0.0,0.0,0.0,444740,76832,294084,815656
2008-07-03,NYSE (DN),236628602,131258376,149684857,517571835,0.0,0.0,0.0,0.0,1570809,542897,836485,2950191
2008-07-03,Nasdaq (DQ),514839056,143227471,305848892,963915419,0.0,0.0,0.0,0.0,1149290,150696,517608,1817594
2008-07-03,ADF (D),32379194,3517780,11774441,47671415,0.0,0.0,0.0,0.0,153604,8896,43743,206243
2008-07-03,ISE (I),50228800,2062500,3469000,55760300,0.0,0.0,0.0,0.0,296341,2663,10011,309015
2008-07-03,CHX (M),11903601,1081614,3271337,16256552,0.0,0.0,0.0,0.0,24341,992,6047,31380
2008-07-03,NYSE (N),931941228,0,0,931941228,0.0,0.0,0.0,0.0,3378119,0,0,3378119
2008-07-03,NYSE Arca (P),504831384,274595187,239729701,1019156272,0.0,0.0,0.0,0.0,3141518,833539,1156206,5131263
2008-07-03,Nasdaq (Q),802528838,371566343,607736108,1781831289,0.0,0.0,0.0,0.0,4838190,1089493,2715120,8642803
2008-07-03,CBOE (W),1015000,2227400,1145600,4388000,0.0,0.0,0.0,0.0,470,1732,4940,7142
2008-07-03,PHLX (X),2718600,68700,398539,3185839,0.0,0.0,0.0,0.0,3848,91,1405,5344
2008-07-07,AMEX (A),0,49554982,90300,49645282,0.0,0.0,0.0,0.0,0,73518,243,73761
2008-07-07,NSX (C),73852418,28285329,54773295,156911042,0.0,0.0,0.0,0.0,342502,77678,277774,697954
2008-07-07,NSX (DC),185436762,41130752,119467844,346035358,0.0,0.0,0.0,0.0,697526,116452,469759,1283737
2008-07-07,NYSE (DN),397352954,208345089,264252655,869950698,0.0,0.0,0.0,0.0,2581369,838401,1448470,4868240
2008-07-07,Nasdaq (DQ),855128834,234635424,488243235,1578007493,0.0,0.0,0.0,0.0,1864005,229126,834006,2927137
2008-07-07,ADF (D),39654508,3568062,16418950,59641520,0.0,0.0,0.0,0.0,179547,11013,63307,253867
2008-07-07,ISE (I),82094900,2826000,6447900,91368800,0.0,0.0,0.0,0.0,465388,4187,20815,490390
2008-07-07,CHX (M),23273098,3683481,7285806,34242385,0.0,0.0,0.0,0.0,28265,986,7081,36332
2008-07-07,NYSE (N),1521646477,0,0,1521646477,0.0,0.0,0.0,0.0,5349579,0,0,5349579
2008-07-07,NYSE Arca (P),811842135,425965717,405231789,1643039641,0.0,0.0,0.0,0.0,5026884,1269385,2008092,8304361
2008-07-07,Nasdaq (Q),1270530790,578277367,1014367803,2863175960,0.0,0.0,0.0,0.0,7514961,1671353,4584896,13771210
2008-07-07,CBOE (W),964500,9143200,4788200,14895900,0.0,0.0,0.0,0.0,716,3062,11742,15520
2008-07-07,PHLX (X),3835500,156100,731724,4723324,0.0,0.0,0.0,0.0,6336,85,2838,9259
2008-07-08,AMEX (A),0,43935850,103800,44039650,0.0,0.0,0.0,0.0,0,72156,288,72444
2008-07-08,NSX (C),68834413,25608496,62342968,156785877,0.0,0.0,0.0,0.0,323002,63970,284054,671026
2008-07-08,NSX (DC),209392558,46377679,140148675,395918912,0.0,0.0,0.0,0.0,821415,131584,525790,1478789
2008-07-08,NYSE (DN),446178014,232852588,266316997,945347599,0.0,0.0,0.0,0.0,2929250,898724,1488554,5316528
2008-07-08,Nasdaq (DQ),1062290855,250417222,526836444,1839544521,0.0,0.0,0.0,0.0,2063669,239550,878206,3181425
2008-07-08,ADF (D),44460130,3417161,15898972,63776263,0.0,0.0,0.0,0.0,192751,10221,59133,262105
2008-07-08,ISE (I),92990500,12397900,14747400,120135800,0.0,0.0,0.0,0.0,526231,35878,61111,623220
2008-07-08,CHX (M),22431349,5299387,4489942,32220678,0.0,0.0,0.0,0.0,19785,1274,5292,26351
2008-07-08,NYSE (N),1726878680,0,0,1726878680,0.0,0.0,0.0,0.0,5886264,0,0,5886264
2008-07-08,NYSE Arca (P),906566474,475591277,419054024,1801211775,0.0,0.0,0.0,0.0,5560284,1361466,2052354,8974104
2008-07-08,Nasdaq (Q),1454710937,649762742,1077912160,3182385839,0.0,0.0,0.0,0.0,8391090,1773045,4806012,14970147
2008-07-08,CBOE (W),2624200,4910100,4361900,11896200,0.0,0.0,0.0,0.0,1232,5970,12013,19215
2008-07-08,PHLX (X),5574300,3147300,957733,9679333,0.0,0.0,0.0,0.0,6140,112,1914,8166
2008-07-09,AMEX (A),0,34210259,154500,34364759,0.0,0.0,0.0,0.0,0,60755,441,61196
2008-07-09,NSX (C),67118689,22348641,55812999,145280329,0.0,0.0,0.0,0.0,293511,63070,283688,640269
2008-07-09,NSX (DC),181302330,39193661,123306045,343802036,0.0,0.0,0.0,0.0,701035,108060,461939,1271034
2008-07-09,NYSE (DN),385767248,199242460,247006459,832016167,0.0,0.0,0.0,0.0,2501687,751465,1352232,4605384
2008-07-09,Nasdaq (DQ),942164794,244573941,513899962,1700638697,0.0,0.0,0.0,0.0,1777220,194535,788069,2759824
2008-07-09,ADF (D),33853494,4544300,18487828,56885622,0.0,0.0,0.0,0.0,144463,11664,60915,217042
2008-07-09,ISE (I),77898600,1722500,5976200,85597300,0.0,0.0,0.0,0.0,444100,3070,19038,466208
2008-07-09,CHX (M),18393262,3684313,5769959,27847534,0.0,0.0,0.0,0.0,22449,1095,5717,29261
2008-07-09,NYSE (N),1490914580,0,0,1490914580,0.0,0.0,0.0,0.0,5043509,0,0,5043509
2008-07-09,NYSE Arca (P),752012294,406835417,373275382,1532123093,0.0,0.0,0.0,0.0,4576665,1129628,1801301,7507594
2008-07-09,Nasdaq (Q),1224502702,546187365,969929722,2740619789,0.0,0.0,0.0,0.0,7054166,1502661,4243877,12800704
2008-07-09,CBOE (W),2779800,4278700,5419600,12478100,0.0,0.0,0.0,0.0,1040,2234,10538,13812
2008-07-09,PHLX (X),4819300,1428400,1600690,7848390,0.0,0.0,0.0,0.0,5407,35,2299,7741
2008-07-10,AMEX (A),0,44828504,260600,45089104,0.0,0.0,0.0,0.0,0,60218,463,60681
2008-07-10,NSX (C),88210858,24627117,52264226,165102201,0.0,0.0,0.0,0.0,390950,72296,255664,718910
2008-07-10,NSX (DC),218012324,44880900,119145847,382039071,0.0,0.0,0.0,0.0,852422,133150,484834,1470406
2008-07-10,NYSE (DN),452642504,230430918,254556808,937630230,0.0,0.0,0.0,0.0,3073456,922016,1459146,5454618
2008-07-10,Nasdaq (DQ),1058639305,201430929,474905764,1734975998,0.0,0.0,0.0,0.0,1955722,207095,782885,2945702
2008-07-10,ADF (D),42462166,2548699,14486326,59497191,0.0,0.0,0.0,0.0,170501,7587,55800,233888
2008-07-10,ISE (I),79008700,1836600,5783400,86628700,0.0,0.0,0.0,0.0,457292,3671,17803,478766
2008-07-10,CHX (M),27025563,3581787,7274227,37881577,0.0,0.0,0.0,0.0,28772,1279,7808,37859
2008-07-10,NYSE (N),1529670835,0,0,1529670835,0.0,0.0,0.0,0.0,5517088,0,0,5517088
2008-07-10,NYSE Arca (P),917962381,472430613,412413831,1802806825,0.0,0.0,0.0,0.0,5661024,1351497,1983094,8995615
2008-07-10,Nasdaq (Q),1427469619,661705122,975529325,3064704066,0.0,0.0,0.0,0.0,8336531,1854295,4540574,14731400
2008-07-10,CBOE (W),3388500,4142500,4697800,12228800,0.0,0.0,0.0,0.0,1486,2043,11533,15062
2008-07-10,PHLX (X),5847000,1563800,1984216,9395016,0.0,0.0,0.0,0.0,6844,147,1837,8828
2008-07-11,AMEX (A),0,48128219,150600,48278819,0.0,0.0,0.0,0.0,0,67939,334,68273
2008-07-11,NSX (C),93984287,33188342,55219605,182392234,0.0,0.0,0.0,0.0,374031,86277,289373,749681
2008-07-11,NSX (DC),244624019,45125336,112033024,401782379,0.0,0.0,0.0,0.0,951166,136024,500517,1587707
2008-07-11,NYSE (DN),489409077,251864425,250219627,991493129,0.0,0.0,0.0,0.0,3220763,969242,1411386,5601391
2008-07-11,Nasdaq (DQ),1173282811,232248963,431676797,1837208571,0.0,0.0,0.0,0.0,1989898,221306,769083,2980287
2008-07-11,ADF (D),54431905,3699206,16228704,74359815,0.0,0.0,0.0,0.0,197017,11019,60772,268808
2008-07-11,ISE (I),103263800,2266600,6576200,112106600,0.0,0.0,0.0,0.0,578057,4494,22488,605039
2008-07-11,CHX (M),24365533,4075979,5958951,34400463,0.0,0.0,0.0,0.0,41407,2235,11192,54834
2008-07-11,NYSE (N),1726994877,0,0,1726994877,0.0,0.0,0.0,0.0,6057927,0,0,6057927
2008-07-11,NYSE Arca (P),1093196844,526610619,424323891,2044131354,0.0,0.0,0.0,0.0,6306105,1514222,2001281,9821608
2008-07-11,Nasdaq (Q),1730208678,766331388,1084705992,3581246058,0.0,0.0,0.0,0.0,9572908,2139415,4939343,16651666
2008-07-11,CBOE (W),4790200,3416700,5056900,13263800,0.0,0.0,0.0,0.0,1696,2530,13241,17467
2008-07-11,PHLX (X),4488500,696400,2296876,7481776,0.0,0.0,0.0,0.0,7615,24,2695,10334
2008-07-14,AMEX (A),0,42434091,241400,42675491,0.0,0.0,0.0,0.0,0,58306,434,58740
2008-07-14,NSX (C),79189963,28495668,46681616,154367247,0.0,0.0,0.0,0.0,308605,75934,243128,627667
2008-07-14,NSX (DC),208159149,38087344,105622299,351868792,0.0,0.0,0.0,0.0,776103,116518,449059,1341680
2008-07-14,NYSE (DN),395293639,194524117,221256595,811074351,0.0,0.0,0.0,0.0,2559194,756249,1254588,4570031
2008-07-14,Nasdaq (DQ),1017175461,176869475,408784114,1602829050,0.0,0.0,0.0,0.0,1738199,187343,692069,2617611
2008-07-14,ADF (D),35516295,2000798,12342998,49860091,0.0,0.0,0.0,0.0,136917,5880,45120,187917
2008-07-14,ISE (I),84165100,1613600,5785900,91564600,0.0,0.0,0.0,0.0,450679,3194,18192,472065
2008-07-14,CHX (M),35002764,5450880,4163049,44616693,0.0,0.0,0.0,0.0,34925,1781,8592,45298
2008-07-14,NYSE (N),1414442456,0,0,1414442456,0.0,0.0,0.0,0.0,4937648,0,0,4937648
2008-07-14,NYSE Arca (P),859044457,403919508,362694415,1625658380,0.0,0.0,0.0,0.0,5092746,1155230,1789902,8037878
2008-07-14,Nasdaq (Q),1297031419,571783910,889282707,2758098036,0.0,0.0,0.0,0.0,7321788,1602449,4091695,13015932
2008-07-14,CBOE (W),5272600,5210600,9067800,19551000,0.0,0.0,0.0,0.0,1340,3043,10790,15173
2008-07-14,PHLX (X),5660700,293500,1848708,7802908,0.0,0.0,0.0,0.0,6704,48,1581,8333
2008-07-15,AMEX (A),0,47598015,255900,47853915,0.0,0.0,0.0,0.0,0,77694,511,78205
2008-07-15,NSX (C),98521801,48435425,75923242,222880468,0.0,0.0,0.0,0.0,384151,118489,377753,880393
2008-07-15,NSX (DC),275900386,55462382,137181719,468544487,0.0,0.0,0.0,0.0,1030047,152080,579770,1761897
2008-07-15,NYSE (DN),538894327,282892875,286447398,1108234600,0.0,0.0,0.0,0.0,3405228,1032842,1594107,6032177
2008-07-15,Nasdaq (DQ),1310571361,312621436,515622703,2138815500,0.0,0.0,0.0,0.0,2228461,252530,876177,3357168
2008-07-15,ADF (D),56267740,4711970,20301108,81280818,0.0,0.0,0.0,0.0,206797,11611,68892,287300
2008-07-15,ISE (I),136156000,3162000,6918800,146236800,0.0,0.0,0.0,0.0,737891,5611,22112,765614
2008-07-15,CHX (M),24279821,5681455,7205424,37166700,0.0,0.0,0.0,0.0,41400,2993,10196,54589
2008-07-15,NYSE (N),1857312294,0,0,1857312294,0.0,0.0,0.0,0.0,6134630,0,0,6134630
2008-07-15,NYSE Arca (P),1203463677,657772783,506245108,2367481568,0.0,0.0,0.0,0.0,6995552,1774308,2413420,11183280
2008-07-15,Nasdaq (Q),1860405550,867373274,1248077776,3975856600,0.0,0.0,0.0,0.0,10127253,2315911,5553034,17996198
2008-07-15,CBOE (W),3512000,4941300,5633500,14086800,0.0,0.0,0.0,0.0,1032,3859,13126,18017
2008-07-15,PHLX (X),6216400,1581500,1323401,9121301,0.0,0.0,0.0,0.0,7664,211,2700,10575
2008-07-16,AMEX (A),0,55386199,173300,55559499,0.0,0.0,0.0,0.0,0,67336,304,67640
2008-07-16,NSX (C),90657389,38744762,64459778,193861929,0.0,0.0,0.0,0.0,352712,98210,309814,760736
2008-07-16,NSX (DC),247284739,50030249,128306248,425621236,0.0,0.0,0.0,0.0,907467,131747,536185,1575399
2008-07-16,NYSE (DN),506067267,239975986,265723319,1011766572,0.0,0.0,0.0,0.0,3118041,868948,1470149,5457138
2008-07-16,Nasdaq (DQ),1274829321,286902922,537090300,2098822543,0.0,0.0,0.0,0.0,2201913,247897,832498,3282308
2008-07-16,ADF (D),47348026,4606961,18509752,70464739,0.0,0.0,0.0,0.0,183065,9978,64310,257353
2008-07-16,ISE (I),106154900,2776600,6149300,115080800,0.0,0.0,0.0,0.0,576522,4907,20438,601867
2008-07-16,CHX (M),34232259,7447158,12395826,54075243,0.0,0.0,0.0,0.0,37896,3095,11738,52729
2008-07-16,NYSE (N),1728716592,0,0,1728716592,0.0,0.0,0.0,0.0,5439651,0,0,5439651
2008-07-16,NYSE Arca (P),1103821909,503959030,431530672,2039311611,0.0,0.0,0.0,0.0,6232345,1394297,2096423,9723065
2008-07-16,Nasdaq (Q),1591058591,662072283,1055358970,3308489844,0.0,0.0,0.0,0.0,8612829,1770371,4701475,15084675
2008-07-16,CBOE (W),2223500,3908400,5963400,12095300,0.0,0.0,0.0,0.0,995,3769,12748,17512
2008-07-16,PHLX (X),6931400,1541100,670011,9142511,0.0,0.0,0.0,0.0,7553,194,1579,9326
2008-07-17,AMEX (A),0,43269331,267200,43536531,0.0,0.0,0.0,0.0,0,66420,513,66933
2008-07-17,NSX (C),94575297,56509678,65507441,216592416,0.0,0.0,0.0,0.0,359873,116858,306417,783148
2008-07-17,NSX (DC),257129262,63504088,128477208,449110558,0.0,0.0,0.0,0.0,961263,150774,502408,1614445
2008-07-17,NYSE (DN),541119991,286937276,276915084,1104972351,0.0,0.0,0.0,0.0,3498252,1006062,1569167,6073481
2008-07-17,Nasdaq (DQ),1349584911,328807371,537519783,2215912065,0.0,0.0,0.0,0.0,2389994,280834,878361,3549189
2008-07-17,ADF (D),62530788,5362490,25109841,93003119,0.0,0.0,0.0,0.0,278950,13504,96034,388488
2008-07-17,ISE (I),117957800,5894600,7676400,131528800,0.0,0.0,0.0,0.0,655495,7012,24530,687037
2008-07-17,CHX (M),31456378,9128305,8596767,49181450,0.0,0.0,0.0,0.0,45979,2828,11265,60072
2008-07-17,NYSE (N),1963677662,0,0,1963677662,0.0,0.0,0.0,0.0,6154798,0,0,6154798
2008-07-17,NYSE Arca (P),1232977082,604342494,468698231,2306017807,0.0,0.0,0.0,0.0,7137775,1604775,2276951,11019501
2008-07-17,Nasdaq (Q),1714088812,801768374,1134498652,3650355838,0.0,0.0,0.0,0.0,9366604,2076736,5002933,16446273
2008-07-17,CBOE (W),1786400,6164400,6834100,14784900,0.0,0.0,0.0,0.0,1072,5102,12553,18727
2008-07-17,PHLX (X),6324000,1273700,1132492,8730192,0.0,0.0,0.0,0.0,8464,449,1794,10707
2008-07-18,AMEX (A),0,30981907,113100,31095007,0.0,0.0,0.0,0.0,0,52471,238,52709
2008-07-18,NSX (C),75337141,29230861,56483273,161051275,0.0,0.0,0.0,0.0,295945,68165,275875,639985
2008-07-18,NSX (DC),209367925,38561611,115098840,363028376,0.0,0.0,0.0,0.0,793778,105179,481172,1380129
2008-07-18,NYSE (DN),375191526,186730320,228121845,790043691,0.0,0.0,0.0,0.0,2455350,696988,1286891,4439229
2008-07-18,Nasdaq (DQ),1027245500,242252238,470035663,1739533401,0.0,0.0,0.0,0.0,1899013,195137,793025,2887175
2008-07-18,ADF (D),38083676,2915442,16323468,57322586,0.0,0.0,0.0,0.0,156783,7201,58400,222384
2008-07-18,ISE (I),76607900,1998800,6449500,85056200,0.0,0.0,0.0,0.0,431271,3138,19336,453745
2008-07-18,CHX (M),35909434,7999684,7373537,51282655,0.0,0.0,0.0,0.0,27658,1643,8212,37513
2008-07-18,NYSE (N),1710396150,0,0,1710396150,0.0,0.0,0.0,0.0,4658878,0,0,4658878
2008-07-18,NYSE Arca (P),845869409,375745133,363991695,1585606237,0.0,0.0,0.0,0.0,5067139,1093088,1774686,7934913
2008-07-18,Nasdaq (Q),1249764598,479595464,1019163610,2748523672,0.0,0.0,0.0,0.0,7031822,1363870,4013585,12409277
2008-07-18,CBOE (W),4069500,5315600,5382400,14767500,0.0,0.0,0.0,0.0,1088,4014,8721,13823
2008-07-18,PHLX (X),5803400,673000,2364358,8840758,0.0,0.0,0.0,0.0,5562,145,1942,7649
2008-07-21,AMEX (A),0,32708373,91400,32799773,0.0,0.0,0.0,0.0,0,50832,237,51069
2008-07-21,NSX (C),64349626,25917093,45285878,135552597,0.0,0.0,0.0,0.0,255198,64711,227978,547887
2008-07-21,NSX (DC),188234720,34876359,113307795,336418874,0.0,0.0,0.0,0.0,711329,108070,462650,1282049
2008-07-21,NYSE (DN),312211705,167851385,208962643,689025733,0.0,0.0,0.0,0.0,2075738,684208,1201425,3961371
2008-07-21,Nasdaq (DQ),910433508,179702224,424033981,1514169713,0.0,0.0,0.0,0.0,1757874,173927,703438,2635239
2008-07-21,ADF (D),31643525,2594481,12430187,46668193,0.0,0.0,0.0,0.0,130167,6997,47497,184661
2008-07-21,ISE (I),64338800,1711700,4545700,70596200,0.0,0.0,0.0,0.0,364783,2771,15776,383330
2008-07-21,CHX (M),18204120,5332144,6358906,29895170,0.0,0.0,0.0,0.0,25363,2703,7717,35783
2008-07-21,NYSE (N),1204477792,0,0,1204477792,0.0,0.0,0.0,0.0,4082357,0,0,4082357
2008-07-21,NYSE Arca (P),754183777,324366036,308783750,1387333563,0.0,0.0,0.0,0.0,4547278,1025663,1614003,7186944
2008-07-21,Nasdaq (Q),1077121982,419918345,767289998,2264330325,0.0,0.0,0.0,0.0,6169610,1284685,3587157,11041452
2008-07-21,CBOE (W),2455100,3316600,5343300,11115000,0.0,0.0,0.0,0.0,1104,4014,7983,13101
2008-07-21,PHLX (X),4006900,212000,698104,4917004,0.0,0.0,0.0,0.0,4464,138,1364,5966
2008-07-22,AMEX (A),0,39744794,94100,39838894,0.0,0.0,0.0,0.0,0,58376,265,58641
2008-07-22,NSX (C),73518458,36108779,68571258,178198495,0.0,0.0,0.0,0.0,303425,85683,327963,717071
2008-07-22,NSX (DC),243447677,43681860,142838658,429968195,0.0,0.0,0.0,0.0,907951,112697,565701,1586349
2008-07-22,NYSE (DN),460287327,219121894,289748062,969157283,0.0,0.0,0.0,0.0,2965990,790779,1572680,5329449
2008-07-22,Nasdaq (DQ),1167546285,223893989,593753742,1985194016,0.0,0.0,0.0,0.0,2073615,209808,863544,3146967
2008-07-22,ADF (D),42538293,2959486,13276358,58774137,0.0,0.0,0.0,0.0,158496,7405,44765,210666
2008-07-22,ISE (I),100643600,2519400,6945400,110108400,0.0,0.0,0.0,0.0,550661,3903,22994,577558
2008-07-22,CHX (M),23973394,18452057,6294230,48719681,0.0,0.0,0.0,0.0,34659,4948,9703,49310
2008-07-22,NYSE (N),1565411175,100,100,1565411375,0.0,0.0,0.0,0.0,5245236,1,1,5245238
2008-07-22,NYSE Arca (P),1035147456,463707972,443249243,1942104671,0.0,0.0,0.0,0.0,6047305,1259399,2198923,9505627
2008-07-22,Nasdaq (Q),1462878001,583021062,1046006740,3091905803,0.0,0.0,0.0,0.0,8099257,1599743,4661998,14360998
2008-07-22,CBOE (W),3414200,6704600,4415800,14534600,0.0,0.0,0.0,0.0,1795,3523,10585,15903
2008-07-22,PHLX (X),7100900,973500,829977,8904377,0.0,0.0,0.0,0.0,8257,191,1905,10353
2008-07-23,AMEX (A),0,43343243,121500,43464743,0.0,0.0,0.0,0.0,0,69555,269,69824
2008-07-23,NSX (C),86306124,40350474,69509269,196165867,0.0,0.0,0.0,0.0,330584,93841,326428,750853
2008-07-23,NSX (DC),280638127,54499113,156672571,491809811,0.0,0.0,0.0,0.0,1041300,147398,631204,1819902
2008-07-23,NYSE (DN),481178057,251640836,289249946,1022068839,0.0,0.0,0.0,0.0,3062143,904661,1552955,5519759
2008-07-23,Nasdaq (DQ),1321020464,262772287,627426958,2211219709,0.0,0.0,0.0,0.0,2411838,272655,962548,3647041
2008-07-23,ADF (D),53476219,5667649,20132114,79275982,0.0,0.0,0.0,0.0,211254,18075,70565,299894
2008-07-23,ISE (I),101747102,2227900,8209800,112184802,0.0,0.0,0.0,0.0,560588,3826,23761,588175
2008-07-23,CHX (M),33753119,8557222,7675900,49986241,0.0,0.0,0.0,0.0,40926,4727,9204,54857
2008-07-23,NYSE (N),1722916977,0,0,1722916977,0.0,0.0,0.0,0.0,5831531,0,0,5831531
2008-07-23,NYSE Arca (P),1076043551,514923598,476963802,2067930951,0.0,0.0,0.0,0.0,6322982,1446971,2269771,10039724
2008-07-23,Nasdaq (Q),1545550995,657818463,1097564343,3300933801,0.0,0.0,0.0,0.0,8655366,1861340,4970160,15486866
2008-07-23,CBOE (W),3453100,3840400,4481000,11774500,0.0,0.0,0.0,0.0,2089,3895,11321,17305
2008-07-23,PHLX (X),5669000,609300,1657347,7935647,0.0,0.0,0.0,0.0,8085,140,2457,10682
2008-07-24,AMEX (A),0,38876610,69700,38946310,0.0,0.0,0.0,0.0,0,60338,173,60511
2008-07-24,NSX (C),72781080,34939245,62436600,170156925,0.0,0.0,0.0,0.0,310445,90034,305060,705539
2008-07-24,NSX (DC),233707073,48671481,144742326,427120880,0.0,0.0,0.0,0.0,883991,127302,581107,1592400
2008-07-24,NYSE (DN),411382284,207964191,252918717,872265192,0.0,0.0,0.0,0.0,2672665,775573,1416381,4864619
2008-07-24,Nasdaq (DQ),1183400460,224252714,587726459,1995379633,0.0,0.0,0.0,0.0,2074461,238611,871553,3184625
2008-07-24,ADF (D),49453970,3425512,18338217,71217699,0.0,0.0,0.0,0.0,193383,9999,60664,264046
2008-07-24,ISE (I),88188200,2514400,5725000,96427600,0.0,0.0,0.0,0.0,493057,4476,16048,513581
2008-07-24,CHX (M),24843862,4127707,6731164,35702733,0.0,0.0,0.0,0.0,39710,4139,9988,53837
2008-07-24,NYSE (N),1645425354,0,100,1645425454,0.0,0.0,0.0,0.0,5405086,0,1,5405087
2008-07-24,NYSE Arca (P),988593096,450615192,432167277,1871375565,0.0,0.0,0.0,0.0,5898091,1271021,2085733,9254845
2008-07-24,Nasdaq (Q),1425732036,561537845,1061531415,3048801296,0.0,0.0,0.0,0.0,8005779,1620839,4619116,14245734
2008-07-24,CBOE (W),2726600,5148700,3967500,11842800,0.0,0.0,0.0,0.0,2227,5142,9896,17265
2008-07-24,PHLX (X),7950800,214000,850809,9015609,0.0,0.0,0.0,0.0,5317,46,545,5908
2008-07-25,AMEX (A),0,44251156,71200,44322356,0.0,0.0,0.0,0.0,0,53596,142,53738
2008-07-25,NSX (C),55811329,27163878,52889167,135864374,0.0,0.0,0.0,0.0,247386,76666,270242,594294
2008-07-25,NSX (DC),179036417,39335438,112811469,331183324,0.0,0.0,0.0,0.0,690214,110703,465373,1266290
2008-07-25,NYSE (DN),339070055,181259440,214158787,734488282,0.0,0.0,0.0,0.0,2233110,700477,1215312,4148899
2008-07-25,Nasdaq (DQ),868718538,176898522,463838916,1509455976,0.0,0.0,0.0,0.0,1646091,193282,714946,2554319
2008-07-25,ADF (D),33153023,2579491,15140278,50872792,0.0,0.0,0.0,0.0,139893,7247,48962,196102
2008-07-25,ISE (I),63675200,1467600,5074100,70216900,0.0,0.0,0.0,0.0,375821,3131,15784,394736
2008-07-25,CHX (M),19188122,4476684,5757004,29421810,0.0,0.0,0.0,0.0,28497,2814,7578,38889
2008-07-25,NYSE (N),1286861436,0,0,1286861436,0.0,0.0,0.0,0.0,4578476,0,0,4578476
2008-07-25,NYSE Arca (P),733046200,342904077,332430278,1408380555,0.0,0.0,0.0,0.0,4472810,1035455,1678517,7186782
2008-07-25,Nasdaq (Q),1087367704,456672749,848935361,2392975814,0.0,0.0,0.0,0.0,6331239,1366598,3960752,11658589
2008-07-25,CBOE (W),4759600,8232700,2970100,15962400,0.0,0.0,0.0,0.0,730,3711,8030,12471
2008-07-25,PHLX (X),4909400,348900,1365115,6623415,0.0,0.0,0.0,0.0,5255,163,961,6379
2008-07-28,AMEX (A),0,32662037,66500,32728537,0.0,0.0,0.0,0.0,0,46540,215,46755
2008-07-28,NSX (C),47682601,23170087,50671194,121523882,0.0,0.0,0.0,0.0,202778,61874,250388,515040
2008-07-28,NSX (DC),157665828,36005333,116111356,309782517,0.0,0.0,0.0,0.0,622828,97456,460099,1180383
2008-07-28,NYSE (DN),313488609,159817072,210381233,683686914,0.0,0.0,0.0,0.0,2055906,637898,1187987,3881791
2008-07-28,Nasdaq (DQ),797005706,165833018,429899796,1392738520,0.0,0.0,0.0,0.0,1615444,184345,704359,2504148
2008-07-28,ADF (D),31027651,1659253,18093715,50780619,0.0,0.0,0.0,0.0,129497,4976,57707,192180
2008-07-28,ISE (I),61091000,866100,5288600,67245700,0.0,0.0,0.0,0.0,352147,1861,17221,371229
2008-07-28,CHX (M),18489661,4060700,4800758,27351119,0.0,0.0,0.0,0.0,27094,3548,5617,36259
2008-07-28,NYSE (N),1172556948,0,0,1172556948,0.0,0.0,0.0,0.0,4059964,0,0,4059964
2008-07-28,NYSE Arca (P),709418423,306161638,328595212,1344175273,0.0,0.0,0.0,0.0,4376887,908208,1634067,6919162
2008-07-28,Nasdaq (Q),969346968,401614485,817684095,2188645548,0.0,0.0,0.0,0.0,5646481,1177037,3606365,10429883
2008-07-28,CBOE (W),2333300,1796000,4639900,8769200,0.0,0.0,0.0,0.0,1625,998,7564,10187
2008-07-28,PHLX (X),3708000,901200,627553,5236753,0.0,0.0,0.0,0.0,4272,138,861,5271
2008-07-29,AMEX (A),0,35949008,73900,36022908,0.0,0.0,0.0,0.0,0,56412,216,56628
2008-07-29,NSX (C),67849808,29208210,63039599,160097617,0.0,0.0,0.0,0.0,269419,69520,282240,621179
2008-07-29,NSX (DC),188608236,42992797,132783474,364384507,0.0,0.0,0.0,0.0,731055,110300,516231,1357586
2008-07-29,NYSE (DN),388276607,198228047,262201506,848706160,0.0,0.0,0.0,0.0,2572275,744375,1363422,4680072
2008-07-29,Nasdaq (DQ),1068936825,216915963,519073812,1804926600,0.0,0.0,0.0,0.0,1912442,219912,805221,2937575
2008-07-29,ADF (D),38974400,3749325,16847416,59571141,0.0,0.0,0.0,0.0,155340,9840,57753,222933
2008-07-29,ISE (I),71582357,1336000,5366200,78284557,0.0,0.0,0.0,0.0,387275,2261,16321,405857
2008-07-29,CHX (M),39709978,6235591,6847426,52792995,0.0,0.0,0.0,0.0,30449,4570,6190,41209
2008-07-29,NYSE (N),1398977940,0,0,1398977940,0.0,0.0,0.0,0.0,4627647,0,0,4627647
2008-07-29,NYSE Arca (P),912323356,373753890,405836507,1691913753,0.0,0.0,0.0,0.0,5453096,1064700,1837619,8355415
2008-07-29,Nasdaq (Q),1234569635,502665240,938158113,2675392988,0.0,0.0,0.0,0.0,6887327,1421602,4027320,12336249
2008-07-29,CBOE (W),2221100,7382900,4135700,13739700,0.0,0.0,0.0,0.0,1738,1912,7857,11507
2008-07-29,PHLX (X),4003500,342400,1065275,5411175,0.0,0.0,0.0,0.0,5051,148,1387,6586
2008-07-30,AMEX (A),0,35590156,75300,35665456,0.0,0.0,0.0,0.0,0,55576,246,55822
2008-07-30,NSX (C),73582349,33009960,58194206,164786515,0.0,0.0,0.0,0.0,292885,76583,273251,642719
2008-07-30,NSX (DC),212633655,50931237,133094456,396659348,0.0,0.0,0.0,0.0,825066,131618,528741,1485425
2008-07-30,NYSE (DN),425306308,247886753,259075275,932268336,0.0,0.0,0.0,0.0,2834220,922554,1403149,5159923
2008-07-30,Nasdaq (DQ),1071809886,260961366,507233975,1840005227,0.0,0.0,0.0,0.0,2006992,252467,811285,3070744
2008-07-30,ADF (D),44488138,4886275,13742359,63116772,0.0,0.0,0.0,0.0,168796,11622,51246,231664
2008-07-30,ISE (I),77655900,1789000,5961800,85406700,0.0,0.0,0.0,0.0,430384,3025,17638,451047
2008-07-30,CHX (M),27313074,5669057,6955830,39937961,0.0,0.0,0.0,0.0,39579,4725,10567,54871
2008-07-30,NYSE (N),1471562789,0,0,1471562789,0.0,0.0,0.0,0.0,5012361,0,0,5012361
2008-07-30,NYSE Arca (P),910902051,482215575,381566793,1774684419,0.0,0.0,0.0,0.0,5623590,1333530,1882110,8839230
2008-07-30,Nasdaq (Q),1298410467,591164062,925919475,2815494004,0.0,0.0,0.0,0.0,7508173,1676381,4179176,13363730
2008-07-30,CBOE (W),20336900,5430100,3491200,29258200,0.0,0.0,0.0,0.0,2173,2977,8628,13778
2008-07-30,PHLX (X),5048800,935700,975545,6960045,0.0,0.0,0.0,0.0,6174,75,2428,8677
2008-07-31,AMEX (A),0,31860165,71700,31931865,0.0,0.0,0.0,0.0,0,49141,264,49405
2008-07-31,NSX (C),70034673,25165153,55244612,150444438,0.0,0.0,0.0,0.0,271441,66295,270055,607791
2008-07-31,NSX (DC),191977029,37759849,131008849,360745727,0.0,0.0,0.0,0.0,722188,102483,533380,1358051
2008-07-31,NYSE (DN),367807095,202870398,261801718,832479211,0.0,0.0,0.0,0.0,2368147,791185,1357721,4517053
2008-07-31,Nasdaq (DQ),1032386240,193435147,553758809,1779580196,0.0,0.0,0.0,0.0,1875757,193561,832585,2901903
2008-07-31,ADF (D),41519322,2726596,13755234,58001152,0.0,0.0,0.0,0.0,172663,8103,47619,228385
2008-07-31,ISE (I),67429700,1769800,6184100,75383600,0.0,0.0,0.0,0.0,369230,2564,16829,388623
2008-07-31,CHX (M),35478009,5161938,7981135,48621082,0.0,0.0,0.0,0.0,32784,2575,8819,44178
2008-07-31,NYSE (N),1454397192,0,0,1454397192,0.0,0.0,0.0,0.0,4669522,0,0,4669522
2008-07-31,NYSE Arca (P),847427525,374057768,397693424,1619178717,0.0,0.0,0.0,0.0,5161652,1082756,1912518,8156926
2008-07-31,Nasdaq (Q),1213580161,510155151,973834045,2697569357,0.0,0.0,0.0,0.0,6930102,1490752,4152703,12573557
2008-07-31,CBOE (W),24448900,4095000,5222600,33766500,0.0,0.0,0.0,0.0,1389,3276,9148,13813
2008-07-31,PHLX (X),2466000,133000,926701,3525701,0.0,0.0,0.0,0.0,2609,89,2353,5051
2008-08-01,AMEX (A),0,32995985,75300,33071285,0.0,0.0,0.0,0.0,0,45632,251,45883
2008-08-01,NSX (C),64249482,23158970,52492278,139900730,0.0,0.0,0.0,0.0,235532,60817,258744,555093
2008-08-01,NSX (DC),171415397,33639283,120609138,325663818,0.0,0.0,0.0,0.0,615207,91521,496370,1203098
2008-08-01,NYSE (DN),334592644,177173031,241271755,753037430,0.0,0.0,0.0,0.0,2266162,692600,1254073,4212835
2008-08-01,Nasdaq (DQ),878723823,184709491,490884215,1554317529,0.0,0.0,0.0,0.0,1749090,184663,769391,2703144
2008-08-01,ADF (D),43510761,2696440,16954845,63162046,0.0,0.0,0.0,0.0,167621,6987,56693,231301
2008-08-01,ISE (I),61823100,1316300,5965700,69105100,0.0,0.0,0.0,0.0,345162,2378,15728,363268
2008-08-01,CHX (M),41037779,4669083,4038631,49745493,0.0,0.0,0.0,0.0,28738,2351,7923,39012
2008-08-01,NYSE (N),1223087803,0,0,1223087803,0.0,0.0,0.0,0.0,4368804,0,0,4368804
2008-08-01,NYSE Arca (P),747278845,338977205,369618106,1455874156,0.0,0.0,0.0,0.0,4707579,1009807,1782203,7499589
2008-08-01,Nasdaq (Q),1075773069,488564324,885080133,2449417526,0.0,0.0,0.0,0.0,6350933,1420152,4051465,11822550
2008-08-01,CBOE (W),40930400,5109800,4165200,50205400,0.0,0.0,0.0,0.0,1062,3752,7402,12216
2008-08-01,PHLX (X),3664400,907800,2601401,7173601,0.0,0.0,0.0,0.0,3829,107,1046,4982
2008-08-04,AMEX (A),0,29678435,71700,29750135,0.0,0.0,0.0,0.0,0,51006,201,51207
2008-08-04,NSX (C),61986924,24166537,54844753,140998214,0.0,0.0,0.0,0.0,255584,64116,267745,587445
2008-08-04,NSX (DC),174285515,36734560,116180486,327200561,0.0,0.0,0.0,0.0,675931,96652,464037,1236620
2008-08-04,NYSE (DN),304687028,160760965,233090867,698538860,0.0,0.0,0.0,0.0,2050726,603079,1195621,3849426
2008-08-04,Nasdaq (DQ),858577962,202098480,487684608,1548361050,0.0,0.0,0.0,0.0,1840242,217006,772046,2829294
2008-08-04,ADF (D),28374683,2126391,8454009,38955083,0.0,0.0,0.0,0.0,126344,4826,30681,161851
2008-08-04,ISE (I),64072600,1228600,6195900,71497100,0.0,0.0,0.0,0.0,367937,2273,16137,386347
2008-08-04,CHX (M),16844443,2910909,4090467,23845819,0.0,0.0,0.0,0.0,27843,2200,7757,37800
2008-08-04,NYSE (N),1227124563,0,0,1227124563,0.0,0.0,0.0,0.0,4562111,0,0,4562111
2008-08-04,NYSE Arca (P),728459535,342114449,344471241,1415045225,0.0,0.0,0.0,0.0,4655404,954569,1668935,7278908
2008-08-04,Nasdaq (Q),1034876901,417535484,784538469,2236950854,0.0,0.0,0.0,0.0,6011403,1228516,3551318,10791237
2008-08-04,CBOE (W),1744400,3019500,5161900,9925800,0.0,0.0,0.0,0.0,1531,1945,6708,10184
2008-08-04,PHLX (X),3392600,662600,595611,4650811,0.0,0.0,0.0,0.0,5226,208,715,6149
2008-08-05,AMEX (A),0,34642365,68600,34710965,0.0,0.0,0.0,0.0,0,57984,201,58185
2008-08-05,NSX (C),71863383,26123350,63260548,161247281,0.0,0.0,0.0,0.0,286738,65469,303477,655684
2008-08-05,NSX (DC),212441538,42994258,140945231,396381027,0.0,0.0,0.0,0.0,795429,108209,536017,1439655
2008-08-05,NYSE (DN),419139972,198894658,285233235,903267865,0.0,0.0,0.0,0.0,2706847,731409,1409626,4847882
2008-08-05,Nasdaq (DQ),1044433419,209151119,550203274,1803787812,0.0,0.0,0.0,0.0,2242212,228433,942638,3413283
2008-08-05,ADF (D),43943377,6602811,13428353,63974541,0.0,0.0,0.0,0.0,175995,16520,43461,235976
2008-08-05,ISE (I),84394900,1300900,9213700,94909500,0.0,0.0,0.0,0.0,461573,1896,24020,487489
2008-08-05,CHX (M),38490400,5681119,9272384,53443903,0.0,0.0,0.0,0.0,24417,2394,6112,32923
2008-08-05,NYSE (N),1416417013,0,0,1416417013,0.0,0.0,0.0,0.0,4942400,0,0,4942400
2008-08-05,NYSE Arca (P),870202087,374368385,403779464,1648349936,0.0,0.0,0.0,0.0,5405988,1053586,1875795,8335369
2008-08-05,Nasdaq (Q),1247285361,493410638,943010631,2683706630,0.0,0.0,0.0,0.0,7079990,1443493,4056928,12580411
2008-08-05,CBOE (W),10117700,2619600,4010100,16747400,0.0,0.0,0.0,0.0,1277,1453,3895,6625
2008-08-05,PHLX (X),3486300,666400,613858,4766558,0.0,0.0,0.0,0.0,4052,56,750,4858
2008-08-06,AMEX (A),0,30752655,65400,30818055,0.0,0.0,0.0,0.0,0,52345,197,52542
2008-08-06,NSX (C),63972145,22310460,58412895,144695500,0.0,0.0,0.0,0.0,238989,57278,275082,571349
2008-08-06,NSX (DC),187676458,35191284,129954068,352821810,0.0,0.0,0.0,0.0,688985,87911,506114,1283010
2008-08-06,NYSE (DN),356549424,166527830,256487138,779564392,0.0,0.0,0.0,0.0,2265704,628548,1347068,4241320
2008-08-06,Nasdaq (DQ),1024015185,183809767,529150107,1736975059,0.0,0.0,0.0,0.0,1984779,201925,874537,3061241
2008-08-06,ADF (D),32465918,3356585,13016017,48838520,0.0,0.0,0.0,0.0,129703,8798,46480,184981
2008-08-06,ISE (I),66775300,1047500,7737300,75560100,0.0,0.0,0.0,0.0,370810,1712,17808,390330
2008-08-06,CHX (M),35986820,3739446,5489159,45215425,0.0,0.0,0.0,0.0,17447,2072,4326,23845
2008-08-06,NYSE (N),1200521130,0,0,1200521130,0.0,0.0,0.0,0.0,4230839,0,0,4230839
2008-08-06,NYSE Arca (P),820500940,305632238,384706986,1510840164,0.0,0.0,0.0,0.0,4943868,892796,1863355,7700019
2008-08-06,Nasdaq (Q),1110349381,406852984,903018268,2420220633,0.0,0.0,0.0,0.0,6236195,1183219,3990382,11409796
2008-08-06,CBOE (W),1733900,2104300,4236800,8075000,0.0,0.0,0.0,0.0,919,1010,8163,10092
2008-08-06,PHLX (X),6058700,74000,1442844,7575544,0.0,0.0,0.0,0.0,3110,49,684,3843
2008-08-07,AMEX (A),0,36825358,124100,36949458,0.0,0.0,0.0,0.0,0,55740,353,56093
2008-08-07,NSX (C),69240383,23440394,59053285,151734062,0.0,0.0,0.0,0.0,263547,55383,279487,598417
2008-08-07,NSX (DC),212172673,38225335,128711485,379109493,0.0,0.0,0.0,0.0,774047,96133,510619,1380799
2008-08-07,NYSE (DN),398067659,180693919,252053599,830815177,0.0,0.0,0.0,0.0,2450867,648053,1364643,4463563
2008-08-07,Nasdaq (DQ),1077179437,200887444,513589334,1791656215,0.0,0.0,0.0,0.0,2029872,205417,893697,3128986
2008-08-07,ADF (D),42871223,2669530,14271480,59812233,0.0,0.0,0.0,0.0,166117,6452,53009,225578
2008-08-07,ISE (I),76759500,1486700,8476900,86723100,0.0,0.0,0.0,0.0,396639,2501,17387,416527
2008-08-07,CHX (M),18411076,4215537,3815854,26442467,0.0,0.0,0.0,0.0,33342,2229,8835,44406
2008-08-07,NYSE (N),1283472379,0,0,1283472379,0.0,0.0,0.0,0.0,4369019,0,0,4369019
2008-08-07,NYSE Arca (P),865936218,346001192,383529910,1595467320,0.0,0.0,0.0,0.0,5093231,946544,1875384,7915159
2008-08-07,Nasdaq (Q),1212566980,447660978,912400709,2572628667,0.0,0.0,0.0,0.0,6489676,1231265,4033493,11754434
2008-08-07,CBOE (W),2261200,3199500,8176600,13637300,0.0,0.0,0.0,0.0,849,1414,7686,9949
2008-08-07,PHLX (X),3239500,158900,765988,4164388,0.0,0.0,0.0,0.0,339,58,259,656
2008-08-08,AMEX (A),0,36160989,83800,36244789,0.0,0.0,0.0,0.0,0,57513,249,57762
2008-08-08,NSX (C),66757784,25102635,59877884,151738303,0.0,0.0,0.0,0.0,244781,59402,277016,581199
2008-08-08,NSX (DC),203743654,40794846,143507592,388046092,0.0,0.0,0.0,0.0,737298,97419,526607,1361324
2008-08-08,NYSE (DN),365963639,191309233,244088873,801361745,0.0,0.0,0.0,0.0,2351511,693075,1292461,4337047
2008-08-08,Nasdaq (DQ),986234193,214675112,521087754,1721997059,0.0,0.0,0.0,0.0,1975840,237439,881258,3094537
2008-08-08,ADF (D),50536653,2910312,17334827,70781792,0.0,0.0,0.0,0.0,216337,9319,67881,293537
2008-08-08,ISE (I),70093600,1682130,8817400,80593130,0.0,0.0,0.0,0.0,364421,2669,20451,387541
2008-08-08,CHX (M),15176172,2717763,4039651,21933586,0.0,0.0,0.0,0.0,28849,1896,6936,37681
2008-08-08,NYSE (N),1246574077,0,0,1246574077,0.0,0.0,0.0,0.0,4231159,0,0,4231159
2008-08-08,NYSE Arca (P),793464073,373080764,372926564,1539471401,0.0,0.0,0.0,0.0,4874201,981789,1810399,7666389
2008-08-08,Nasdaq (Q),1121261839,488349823,876279959,2485891621,0.0,0.0,0.0,0.0,6249524,1331497,3843889,11424910
2008-08-08,CBOE (W),4019200,3100000,7571400,14690600,0.0,0.0,0.0,0.0,1233,2115,7563,10911
2008-08-08,PHLX (X),1668000,307200,269377,2244577,0.0,0.0,0.0,0.0,43,4,292,339
2008-08-11,AMEX (A),0,42029255,52400,42081655,0.0,0.0,0.0,0.0,0,65985,154,66139
2008-08-11,NSX (C),67494666,30659256,56713837,154867759,0.0,0.0,0.0,0.0,246998,66798,271347,585143
2008-08-11,NSX (DC),209145941,44409050,150811478,404366469,0.0,0.0,0.0,0.0,808844,105523,582943,1497310
2008-08-11,NYSE (DN),386692506,220972225,271532739,879197470,0.0,0.0,0.0,0.0,2501781,748658,1459084,4709523
2008-08-11,Nasdaq (DQ),1004366906,248523612,521500821,1774391339,0.0,0.0,0.0,0.0,2209004,258092,1008233,3475329
2008-08-11,ADF (D),37124411,4211344,15205731,56541486,0.0,0.0,0.0,0.0,141948,9628,56152,207728
2008-08-11,ISE (I),74035700,2346500,8694600,85076800,0.0,0.0,0.0,0.0,402012,3439,22980,428431
2008-08-11,CHX (M),33116709,3379016,5138958,41634683,0.0,0.0,0.0,0.0,32594,2884,9080,44558
2008-08-11,NYSE (N),1263483118,0,0,1263483118,0.0,0.0,0.0,0.0,4584801,0,0,4584801
2008-08-11,NYSE Arca (P),839541990,378713221,399766796,1618022007,0.0,0.0,0.0,0.0,5170964,1028273,1991661,8190898
2008-08-11,Nasdaq (Q),1146761691,491982530,897125473,2535869694,0.0,0.0,0.0,0.0,6445906,1363300,4103100,11912306
2008-08-11,CBOE (W),2332300,3414400,2680100,8426800,0.0,0.0,0.0,0.0,1561,2406,9542,13509
2008-08-11,PHLX (X),3638400,411800,510089,4560289,0.0,0.0,0.0,0.0,59,9,86,154
2008-08-12,AMEX (A),0,36782286,85100,36867386,0.0,0.0,0.0,0.0,0,55937,162,56099
2008-08-12,NSX (C),64021151,26137546,56300317,146459014,0.0,0.0,0.0,0.0,235303,60777,268474,564554
2008-08-12,NSX (DC),195344016,41384614,128602530,365331160,0.0,0.0,0.0,0.0,779879,103990,504534,1388403
2008-08-12,NYSE (DN),357081875,191629713,242666967,791378555,0.0,0.0,0.0,0.0,2413606,681826,1363640,4459072
2008-08-12,Nasdaq (DQ),889541700,202577978,442532675,1534652353,0.0,0.0,0.0,0.0,1827663,205282,830691,2863636
2008-08-12,ADF (D),30133115,2279489,11769601,44182205,0.0,0.0,0.0,0.0,118737,6724,41768,167229
2008-08-12,ISE (I),65653800,1936900,7459400,75050100,0.0,0.0,0.0,0.0,371294,3160,20389,394843
2008-08-12,CHX (M),26245532,4779036,5726681,36751249,0.0,0.0,0.0,0.0,26293,1879,6973,35145
2008-08-12,NYSE (N),1126632027,0,0,1126632027,0.0,0.0,0.0,0.0,4147417,0,0,4147417
2008-08-12,NYSE Arca (P),791323876,338346827,359523527,1489194230,0.0,0.0,0.0,0.0,5050227,965997,1878219,7894443
2008-08-12,Nasdaq (Q),1091144065,475237606,843905542,2410287213,0.0,0.0,0.0,0.0,6361344,1314624,3901802,11577770
2008-08-12,CBOE (W),4367300,4206700,4176700,12750700,0.0,0.0,0.0,0.0,1166,2543,7151,10860
2008-08-12,PHLX (X),6144900,530700,772061,7447661,0.0,0.0,0.0,0.0,88,2,180,270
2008-08-13,AMEX (A),0,42332322,105500,42437822,0.0,0.0,0.0,0.0,0,61663,200,61863
2008-08-13,NSX (C),67679188,32381680,48517677,148578545,0.0,0.0,0.0,0.0,248163,74617,235912,558692
2008-08-13,NSX (DC),198527275,48508167,129128035,376163477,0.0,0.0,0.0,0.0,778032,124809,501003,1403844
2008-08-13,NYSE (DN),340931892,218286920,225258499,784477311,0.0,0.0,0.0,0.0,2256519,770703,1230003,4257225
2008-08-13,Nasdaq (DQ),913128096,223241197,461420238,1597789531,0.0,0.0,0.0,0.0,1851830,243129,802058,2897017
2008-08-13,ADF (D),42206562,3727847,15329465,61263874,0.0,0.0,0.0,0.0,176260,11065,59257,246582
2008-08-13,ISE (I),69766300,2386600,7189100,79342000,0.0,0.0,0.0,0.0,402674,3557,18222,424453
2008-08-13,CHX (M),22350486,4017648,5843342,32211476,0.0,0.0,0.0,0.0,23784,2096,8441,34321
2008-08-13,NYSE (N),1210564469,0,0,1210564469,0.0,0.0,0.0,0.0,4378893,0,0,4378893
2008-08-13,NYSE Arca (P),808666560,424533803,351261866,1584462229,0.0,0.0,0.0,0.0,5138413,1151490,1793947,8083850
2008-08-13,Nasdaq (Q),1110599466,583559803,824038891,2518198160,0.0,0.0,0.0,0.0,6486816,1548472,3858985,11894273
2008-08-13,CBOE (W),3192500,6755900,3882100,13830500,0.0,0.0,0.0,0.0,1524,2467,7698,11689
2008-08-13,PHLX (X),3704700,434600,335541,4474841,0.0,0.0,0.0,0.0,63,8,405,476
2008-08-14,AMEX (A),0,28413140,40000,28453140,0.0,0.0,0.0,0.0,0,49691,92,49783
2008-08-14,NSX (C),58390926,25339644,45664320,129394890,0.0,0.0,0.0,0.0,214800,62685,217499,494984
2008-08-14,NSX (DC),181182194,39668475,116329080,337179749,0.0,0.0,0.0,0.0,705295,104118,468564,1277977
2008-08-14,NYSE (DN),323954031,203821889,214555840,742331760,0.0,0.0,0.0,0.0,2181004,745186,1167557,4093747
2008-08-14,Nasdaq (DQ),771342217,206588573,419236089,1397166879,0.0,0.0,0.0,0.0,1708602,213662,749986,2672250
2008-08-14,ADF (D),29727588,4456573,13847409,48031570,0.0,0.0,0.0,0.0,127378,10294,53036,190708
2008-08-14,ISE (I),57180800,1445500,6111021,64737321,0.0,0.0,0.0,0.0,319867,2303,17774,339944
2008-08-14,CHX (M),16054134,4155734,10498019,30707887,0.0,0.0,0.0,0.0,17588,1627,4046,23261
2008-08-14,NYSE (N),1008457638,0,0,1008457638,0.0,0.0,0.0,0.0,3745115,0,0,3745115
2008-08-14,NYSE Arca (P),678205542,329039004,313266768,1320511314,0.0,0.0,0.0,0.0,4373350,950044,1620406,6943800
2008-08-14,Nasdaq (Q),936881581,454687726,743680932,2135250239,0.0,0.0,0.0,0.0,5519325,1347251,3410771,10277347
2008-08-14,CBOE (W),2531800,4719300,6496600,13747700,0.0,0.0,0.0,0.0,1255,2320,6769,10344
2008-08-14,PHLX (X),1788400,142900,1341714,3273014,0.0,0.0,0.0,0.0,42,5,173,220
2008-08-15,AMEX (A),0,32445765,26700,32472465,0.0,0.0,0.0,0.0,0,46114,85,46199
2008-08-15,NSX (C),56277423,24734640,40867504,121879567,0.0,0.0,0.0,0.0,209265,56650,213519,479434
2008-08-15,NSX (DC),176885870,35773191,110790051,323449112,0.0,0.0,0.0,0.0,688292,94959,458459,1241710
2008-08-15,NYSE (DN),304315114,158755550,189319195,652389859,0.0,0.0,0.0,0.0,2037188,593434,1064550,3695172
2008-08-15,Nasdaq (DQ),718438495,180827621,395306237,1294572353,0.0,0.0,0.0,0.0,1561479,204169,676156,2441804
2008-08-15,ADF (D),26970564,3761763,9310639,40042966,0.0,0.0,0.0,0.0,108803,8786,34877,152466
2008-08-15,ISE (I),53328415,1196300,6006300,60531015,0.0,0.0,0.0,0.0,292709,2056,17004,311769
2008-08-15,CHX (M),20256797,5752987,5450053,31459837,0.0,0.0,0.0,0.0,19585,1871,5187,26643
2008-08-15,NYSE (N),1175985040,0,0,1175985040,0.0,0.0,0.0,0.0,3474211,0,0,3474211
2008-08-15,NYSE Arca (P),636987095,286700415,283679553,1207367063,0.0,0.0,0.0,0.0,4028903,857797,1458295,6344995
2008-08-15,Nasdaq (Q),862785924,393944204,772334213,2029064341,0.0,0.0,0.0,0.0,4995590,1148753,3135864,9280207
2008-08-15,CBOE (W),3193900,7099300,1676800,11970000,0.0,0.0,0.0,0.0,1222,1274,1393,3889
2008-08-15,PHLX (X),3779100,254200,1905962,5939262,0.0,0.0,0.0,0.0,41,8,148,197
2008-08-18,AMEX (A),0,37573224,46900,37620124,0.0,0.0,0.0,0.0,0,43645,105,43750
2008-08-18,NSX (C),55197074,25275246,39071780,119544100,0.0,0.0,0.0,0.0,183533,59204,192906,435643
2008-08-18,NSX (DC),181566227,36423722,112280353,330270302,0.0,0.0,0.0,0.0,674988,97856,431709,1204553
2008-08-18,NYSE (DN),295088739,168280838,183945962,647315539,0.0,0.0,0.0,0.0,1936051,613921,1010547,3560519
2008-08-18,Nasdaq (DQ),735228952,188753986,396951124,1320934062,0.0,0.0,0.0,0.0,1540021,209116,671663,2420800
2008-08-18,ADF (D),29791325,2274017,11382252,43447594,0.0,0.0,0.0,0.0,128323,6569,42024,176916
2008-08-18,ISE (I),51806026,1749700,5816033,59371759,0.0,0.0,0.0,0.0,276165,2394,16180,294739
2008-08-18,CHX (M),16846884,5305258,5063251,27215393,0.0,0.0,0.0,0.0,20346,2024,5259,27629
2008-08-18,NYSE (N),986120407,0,0,986120407,0.0,0.0,0.0,0.0,3453012,0,0,3453012
2008-08-18,NYSE Arca (P),609909419,286747586,277895039,1174552044,0.0,0.0,0.0,0.0,3850629,833313,1395842,6079784
2008-08-18,Nasdaq (Q),869203060,386902358,662377677,1918483095,0.0,0.0,0.0,0.0,4961574,1143122,3048414,9153110
2008-08-18,CBOE (W),2837900,3893700,4361400,11093000,0.0,0.0,0.0,0.0,1281,2063,6502,9846
2008-08-18,PHLX (X),1452100,524000,655921,2632021,0.0,0.0,0.0,0.0,52,6,256,314
2008-08-19,AMEX (A),0,25899969,70200,25970169,0.0,0.0,0.0,0.0,0,38556,202,38758
2008-08-19,NSX (C),55691575,27260480,40989368,123941423,0.0,0.0,0.0,0.0,188364,64221,188004,440589
2008-08-19,NSX (DC),188407924,38611532,107564442,334583898,0.0,0.0,0.0,0.0,725800,105912,418845,1250557
2008-08-19,NYSE (DN),333608331,181806188,199573933,714988452,0.0,0.0,0.0,0.0,2234921,665384,1079424,3979729
2008-08-19,Nasdaq (DQ),823061772,210824796,399996186,1433882754,0.0,0.0,0.0,0.0,1666337,230284,664298,2560919
2008-08-19,ADF (D),31843581,3813588,11882002,47539171,0.0,0.0,0.0,0.0,124943,10240,46124,181307
2008-08-19,ISE (I),54413850,2685800,5841700,62941350,0.0,0.0,0.0,0.0,301508,2926,17495,321929
2008-08-19,CHX (M),19674375,3659659,4177146,27511180,0.0,0.0,0.0,0.0,27299,2389,4986,34674
2008-08-19,NYSE (N),1013567082,0,0,1013567082,0.0,0.0,0.0,0.0,3534622,0,0,3534622
2008-08-19,NYSE Arca (P),684453416,335638231,301723327,1321814974,0.0,0.0,0.0,0.0,4257212,961431,1456634,6675277
2008-08-19,Nasdaq (Q),950805019,444487000,713315804,2108607823,0.0,0.0,0.0,0.0,5430137,1316917,3164336,9911390
2008-08-19,CBOE (W),2945200,4769100,2701000,10415300,0.0,0.0,0.0,0.0,815,1968,5901,8684
2008-08-19,PHLX (X),2901300,459500,381534,3742334,0.0,0.0,0.0,0.0,47,5,119,171
2008-08-20,AMEX (A),0,27472055,139700,27611755,0.0,0.0,0.0,0.0,0,47068,261,47329
2008-08-20,NSX (C),65852217,27056470,42812253,135720940,0.0,0.0,0.0,0.0,212480,64922,195362,472764
2008-08-20,NSX (DC),221620001,41760189,105303664,368683854,0.0,0.0,0.0,0.0,797307,109032,413729,1320068
2008-08-20,NYSE (DN),360265085,189846948,204177326,754289359,0.0,0.0,0.0,0.0,2306129,685787,1119306,4111222
2008-08-20,Nasdaq (DQ),893397385,189804035,410681641,1493883061,0.0,0.0,0.0,0.0,1742300,231524,687486,2661310
2008-08-20,ADF (D),31611437,3499291,10382503,45493231,0.0,0.0,0.0,0.0,122677,9871,39466,172014
2008-08-20,ISE (I),60055505,1556100,7110371,68721976,0.0,0.0,0.0,0.0,318758,2606,21204,342568
2008-08-20,CHX (M),17164426,5164272,4028856,26357554,0.0,0.0,0.0,0.0,25905,1936,6017,33858
2008-08-20,NYSE (N),1068542979,0,0,1068542979,0.0,0.0,0.0,0.0,3751024,0,0,3751024
2008-08-20,NYSE Arca (P),738242032,338327273,303309867,1379879172,0.0,0.0,0.0,0.0,4458507,969453,1530646,6958606
2008-08-20,Nasdaq (Q),1094576872,474542314,711654195,2280773381,0.0,0.0,0.0,0.0,6109374,1397645,3294151,10801170
2008-08-20,CBOE (W),3888100,5532600,2981600,12402300,0.0,0.0,0.0,0.0,928,3115,6638,10681
2008-08-20,PHLX (X),1794700,1000,667453,2463153,0.0,0.0,0.0,0.0,57,1,335,393
2008-08-21,AMEX (A),0,24892265,92700,24984965,0.0,0.0,0.0,0.0,0,42007,174,42181
2008-08-21,NSX (C),60124488,24077099,40590297,124791884,0.0,0.0,0.0,0.0,189974,56398,174989,421361
2008-08-21,NSX (DC),193370378,37535536,94825331,325731245,0.0,0.0,0.0,0.0,684198,99986,365736,1149920
2008-08-21,NYSE (DN),333042710,161076828,175693271,669812809,0.0,0.0,0.0,0.0,2163576,605851,981418,3750845
2008-08-21,Nasdaq (DQ),820691754,155304000,349012203,1325007957,0.0,0.0,0.0,0.0,1570374,202771,624025,2397170
2008-08-21,ADF (D),28626438,3527206,11196819,43350463,0.0,0.0,0.0,0.0,120588,8325,43052,171965
2008-08-21,ISE (I),54042750,1752300,6482886,62277936,0.0,0.0,0.0,0.0,291791,2900,15505,310196
2008-08-21,CHX (M),20903365,4012081,5227510,30142956,0.0,0.0,0.0,0.0,28156,2070,5632,35858
2008-08-21,NYSE (N),912403441,0,0,912403441,0.0,0.0,0.0,0.0,3262946,0,0,3262946
2008-08-21,NYSE Arca (P),669721202,277015434,269458394,1216195030,0.0,0.0,0.0,0.0,4105797,830095,1377296,6313188
2008-08-21,Nasdaq (Q),935078313,387849221,615794159,1938721693,0.0,0.0,0.0,0.0,5345013,1180939,2902450,9428402
2008-08-21,CBOE (W),3563100,3842600,4004400,11410100,0.0,0.0,0.0,0.0,717,2682,5745,9144
2008-08-21,PHLX (X),1295300,43000,259860,1598160,0.0,0.0,0.0,0.0,42,2,289,333
2008-08-22,AMEX (A),0,23270119,44700,23314819,0.0,0.0,0.0,0.0,0,36593,103,36696
2008-08-22,NSX (C),58568831,21116447,32777441,112462719,0.0,0.0,0.0,0.0,181018,47967,154738,383723
2008-08-22,NSX (DC),194658999,33789579,89652687,318101265,0.0,0.0,0.0,0.0,649314,86823,346538,1082675
2008-08-22,NYSE (DN),275145714,151244666,153300740,579691120,0.0,0.0,0.0,0.0,1810875,544704,881075,3236654
2008-08-22,Nasdaq (DQ),798274160,183051575,329028855,1310354590,0.0,0.0,0.0,0.0,1493404,185220,568766,2247390
2008-08-22,ADF (D),32494920,1773382,10952777,45221079,0.0,0.0,0.0,0.0,144240,4871,43579,192690
2008-08-22,ISE (I),46876503,1335500,5199900,53411903,0.0,0.0,0.0,0.0,242601,1636,15427,259664
2008-08-22,CHX (M),14154434,3373039,5086030,22613503,0.0,0.0,0.0,0.0,19630,1437,4876,25943
2008-08-22,NYSE (N),888788899,0,0,888788899,0.0,0.0,0.0,0.0,3059299,0,0,3059299
2008-08-22,NYSE Arca (P),598917807,250869771,217722055,1067509633,0.0,0.0,0.0,0.0,3635290,711576,1164485,5511351
2008-08-22,Nasdaq (Q),828310249,332268392,550915807,1711494448,0.0,0.0,0.0,0.0,4641856,989655,2578178,8209689
2008-08-22,CBOE (W),4230200,2331000,2525600,9086800,0.0,0.0,0.0,0.0,638,1135,4532,6305
2008-08-22,PHLX (X),1122000,372000,244142,1738142,0.0,0.0,0.0,0.0,34,3,316,353
2008-08-25,AMEX (A),0,23435886,98200,23534086,0.0,0.0,0.0,0.0,0,36152,169,36321
2008-08-25,NSX (C),51235629,19295171,34541624,105072424,0.0,0.0,0.0,0.0,162553,47667,160886,371106
2008-08-25,NSX (DC),172898313,33175376,91180131,297253820,0.0,0.0,0.0,0.0,595209,86490,360354,1042053
2008-08-25,NYSE (DN),245537958,140158400,161934284,547630642,0.0,0.0,0.0,0.0,1614606,519954,892882,3027442
2008-08-25,Nasdaq (DQ),650812112,156259320,304208502,1111279934,0.0,0.0,0.0,0.0,1385176,166746,579359,2131281
2008-08-25,ADF (D),21770150,3505910,9277905,34553965,0.0,0.0,0.0,0.0,84707,8124,34726,127557
2008-08-25,ISE (I),45743450,1210700,4947700,51901850,0.0,0.0,0.0,0.0,217349,2913,15645,235907
2008-08-25,CHX (M),13234192,2500487,5156166,20890845,0.0,0.0,0.0,0.0,16754,1759,5573,24086
2008-08-25,NYSE (N),865203419,0,5700,865209119,0.0,0.0,0.0,0.0,3046721,0,1,3046722
2008-08-25,NYSE Arca (P),550873579,247989508,246341264,1045204351,0.0,0.0,0.0,0.0,3413298,742728,1262496,5418522
2008-08-25,Nasdaq (Q),802475603,346314098,593997254,1742786955,0.0,0.0,0.0,0.0,4493548,1003022,2720021,8216591
2008-08-25,CBOE (W),1552600,4591900,1539400,7683900,0.0,0.0,0.0,0.0,816,1966,5176,7958
2008-08-25,PHLX (X),490900,798500,91739,1381139,0.0,0.0,0.0,0.0,26,7,168,201
2008-08-26,AMEX (A),0,28140354,104600,28244954,0.0,0.0,0.0,0.0,0,37974,260,38234
2008-08-26,NSX (C),44487201,12234783,21642928,78364912,0.0,0.0,0.0,0.0,132848,28874,106656,268378
2008-08-26,NSX (DC),186178957,31896100,91358501,309433558,0.0,0.0,0.0,0.0,625392,83050,373927,1082369
2008-08-26,NYSE (DN),246733143,127501801,156687674,530922618,0.0,0.0,0.0,0.0,1593688,464877,905192,2963757
2008-08-26,Nasdaq (DQ),810148561,135551960,375760054,1321460575,0.0,0.0,0.0,0.0,1464191,168372,597044,2229607
2008-08-26,ADF (D),24403391,2684451,9860932,36948774,0.0,0.0,0.0,0.0,99253,6475,39735,145463
2008-08-26,ISE (I),44075200,6256000,10413200,60744400,0.0,0.0,0.0,0.0,220020,16612,46344,282976
2008-08-26,CHX (M),15597679,5409711,3408151,24415541,0.0,0.0,0.0,0.0,23340,1713,7198,32251
2008-08-26,NYSE (N),856432886,0,0,856432886,0.0,0.0,0.0,0.0,3021753,0,0,3021753
2008-08-26,NYSE Arca (P),567710061,232038373,251699760,1051448194,0.0,0.0,0.0,0.0,3474858,702305,1323512,5500675
2008-08-26,Nasdaq (Q),800326070,317068487,593185417,1710579974,0.0,0.0,0.0,0.0,4454239,986186,2801067,8241492
2008-08-26,CBOE (W),1923900,2700000,3108800,7732700,0.0,0.0,0.0,0.0,1107,1594,5644,8345
2008-08-26,PHLX (X),2572100,251800,658010,3481910,0.0,0.0,0.0,0.0,54,2,244,300
2008-08-27,AMEX (A),0,21348218,73500,21421718,0.0,0.0,0.0,0.0,0,35577,190,35767
2008-08-27,NSX (C),47064349,17305159,40595096,104964604,0.0,0.0,0.0,0.0,142590,41882,176978,361450
2008-08-27,NSX (DC),171467234,30790900,103687031,305945165,0.0,0.0,0.0,0.0,567855,79225,389746,1036826
2008-08-27,NYSE (DN),246514224,133503966,167018896,547037086,0.0,0.0,0.0,0.0,1603055,494454,936041,3033550
2008-08-27,Nasdaq (DQ),726137601,133418450,364535334,1224091385,0.0,0.0,0.0,0.0,1441604,170242,642060,2253906
2008-08-27,ADF (D),22049080,4412515,9495903,35957498,0.0,0.0,0.0,0.0,87077,9065,38653,134795
2008-08-27,ISE (I),41707819,961900,7493100,50162819,0.0,0.0,0.0,0.0,211610,1782,20123,233515
2008-08-27,CHX (M),18534306,3679113,2538860,24752279,0.0,0.0,0.0,0.0,19530,2321,6444,28295
2008-08-27,NYSE (N),820633582,0,5700,820639282,0.0,0.0,0.0,0.0,2930111,0,1,2930112
2008-08-27,NYSE Arca (P),591569857,228728241,278618153,1098916251,0.0,0.0,0.0,0.0,3523185,683824,1422169,5629178
2008-08-27,Nasdaq (Q),810586128,310862048,611629336,1733077512,0.0,0.0,0.0,0.0,4430911,966237,2809069,8206217
2008-08-27,CBOE (W),2415500,3333600,2916600,8665700,0.0,0.0,0.0,0.0,943,1296,5433,7672
2008-08-27,PHLX (X),5117800,2148000,937366,8203166,0.0,0.0,0.0,0.0,41,6,126,173
2008-08-28,AMEX (A),0,27692779,82700,27775479,0.0,0.0,0.0,0.0,0,40315,153,40468
2008-08-28,NSX (C),56206720,20419604,38523417,115149741,0.0,0.0,0.0,0.0,178346,47315,170130,395791
2008-08-28,NSX (DC),180608276,34111505,109190834,323910615,0.0,0.0,0.0,0.0,632177,90154,395304,1117635
2008-08-28,NYSE (DN),249656180,151438842,169076549,570171571,0.0,0.0,0.0,0.0,1600243,505990,876142,2982375
2008-08-28,Nasdaq (DQ),839446191,156114241,378016596,1373577028,0.0,0.0,0.0,0.0,1614288,184639,650548,2449475
2008-08-28,ADF (D),28264130,2584357,10801829,41650316,0.0,0.0,0.0,0.0,116582,6322,43290,166194
2008-08-28,ISE (I),48739500,1259500,7641700,57640700,0.0,0.0,0.0,0.0,245165,2440,23584,271189
2008-08-28,CHX (M),14778787,3704594,3761018,22244399,0.0,0.0,0.0,0.0,22408,1708,6276,30392
2008-08-28,NYSE (N),956326776,0,0,956326776,0.0,0.0,0.0,0.0,3248055,0,0,3248055
2008-08-28,NYSE Arca (P),624279773,274276520,293721291,1192277584,0.0,0.0,0.0,0.0,3691427,760832,1406826,5859085
2008-08-28,Nasdaq (Q),854961685,349375923,621182690,1825520298,0.0,0.0,0.0,0.0,4749164,1003673,2748837,8501674
2008-08-28,CBOE (W),959000,5123800,4301100,10383900,0.0,0.0,0.0,0.0,1968,1700,5820,9488
2008-08-28,PHLX (X),3138200,6500,812745,3957445,0.0,0.0,0.0,0.0,54,1,168,223
2008-08-29,AMEX (A),0,25316678,63700,25380378,0.0,0.0,0.0,0.0,0,35306,92,35398
2008-08-29,NSX (C),46046732,15734779,34942657,96724168,0.0,0.0,0.0,0.0,146592,37927,154768,339287
2008-08-29,NSX (DC),150273663,29967285,96454928,276695876,0.0,0.0,0.0,0.0,507073,77120,348438,932631
2008-08-29,NYSE (DN),204161449,134660667,159394522,498216638,0.0,0.0,0.0,0.0,1396042,464642,865245,2725929
2008-08-29,Nasdaq (DQ),702459154,167416597,374951161,1244826912,0.0,0.0,0.0,0.0,1337793,167016,585274,2090083
2008-08-29,ADF (D),17723048,1549542,9332139,28604729,0.0,0.0,0.0,0.0,77289,4261,32940,114490
2008-08-29,ISE (I),34460541,1624800,6011500,42096841,0.0,0.0,0.0,0.0,168840,2950,18750,190540
2008-08-29,CHX (M),12672878,2722994,4685505,20081377,0.0,0.0,0.0,0.0,25599,1849,5831,33279
2008-08-29,NYSE (N),959304830,0,0,959304830,0.0,0.0,0.0,0.0,2861350,0,0,2861350
2008-08-29,NYSE Arca (P),479407009,243000638,270900544,993308191,0.0,0.0,0.0,0.0,3051245,655479,1294753,5001477
2008-08-29,Nasdaq (Q),678975066,319676588,654173257,1652824911,0.0,0.0,0.0,0.0,3973155,923816,2546886,7443857
2008-08-29,CBOE (W),1106400,4493900,2228800,7829100,0.0,0.0,0.0,0.0,1400,2261,5720,9381
2008-08-29,PHLX (X),1732800,0,150375,1883175,0.0,0.0,0.0,0.0,16,0,308,324
2008-09-02,AMEX (A),0,32889769,79300,32969069,0.0,0.0,0.0,0.0,0,48502,201,48703
2008-09-02,NSX (C),60779804,26689475,49998606,137467885,0.0,0.0,0.0,0.0,211914,61238,210659,483811
2008-09-02,NSX (DC),228176642,44902092,128187335,401266069,0.0,0.0,0.0,0.0,865310,117227,478113,1460650
2008-09-02,NYSE (DN),378134037,210704597,231930970,820769604,0.0,0.0,0.0,0.0,2394441,740084,1249148,4383673
2008-09-02,Nasdaq (DQ),932067024,212743221,458142545,1602952790,0.0,0.0,0.0,0.0,2080568,259176,863335,3203079
2008-09-02,ADF (D),35858192,4974595,13660992,54493779,0.0,0.0,0.0,0.0,147906,12236,53699,213841
2008-09-02,ISE (I),58318100,1552400,7067400,66937900,0.0,0.0,0.0,0.0,311809,2923,21679,336411
2008-09-02,CHX (M),17432017,4276891,4529476,26238384,0.0,0.0,0.0,0.0,42078,2559,8727,53364
2008-09-02,NYSE (N),1146420588,0,0,1146420588,0.0,0.0,0.0,0.0,4127560,0,0,4127560
2008-09-02,NYSE Arca (P),809391052,369873424,368695533,1547960009,0.0,0.0,0.0,0.0,4953123,1037091,1826443,7816657
2008-09-02,Nasdaq (Q),1121575260,475146672,792483949,2389205881,0.0,0.0,0.0,0.0,6325287,1348589,3562061,11235937
2008-09-02,CBOE (W),2874700,7509500,3390300,13774500,0.0,0.0,0.0,0.0,1890,3106,7610,12606
2008-09-02,PHLX (X),1709100,54900,401755,2165755,0.0,0.0,0.0,0.0,30,2,4,36
2008-09-03,AMEX (A),0,27074544,84200,27158744,0.0,0.0,0.0,0.0,0,47643,213,47856
2008-09-03,NSX (C),59798332,23226303,47727958,130752593,0.0,0.0,0.0,0.0,208450,57445,217228,483123
2008-09-03,NSX (DC),223748122,44736701,126025899,394510722,0.0,0.0,0.0,0.0,823874,115415,482098,1421387
2008-09-03,NYSE (DN),403292688,211621928,235478609,850393225,0.0,0.0,0.0,0.0,2556094,802691,1308446,4667231
2008-09-03,Nasdaq (DQ),1008821772,192958584,478958025,1680738381,0.0,0.0,0.0,0.0,2048792,243498,838318,3130608
2008-09-03,ADF (D),37420644,3755554,15447402,56623600,0.0,0.0,0.0,0.0,159239,10119,60811,230169
2008-09-03,ISE (I),67468400,1149712,7943000,76561112,0.0,0.0,0.0,0.0,349576,2433,25660,377669
2008-09-03,CHX (M),19384238,6198700,5079618,30662556,0.0,0.0,0.0,0.0,37227,2499,7438,47164
2008-09-03,NYSE (N),1209546495,0,0,1209546495,0.0,0.0,0.0,0.0,4233556,0,0,4233556
2008-09-03,NYSE Arca (P),828993382,358308438,365972443,1553274263,0.0,0.0,0.0,0.0,5033145,1062310,1856429,7951884
2008-09-03,Nasdaq (Q),1194693425,474043755,877252960,2545990140,0.0,0.0,0.0,0.0,6806952,1397920,3984937,12189809
2008-09-03,CBOE (W),5312000,2812500,4184300,12308800,0.0,0.0,0.0,0.0,1234,2624,7245,11103
2008-09-03,PHLX (X),1516500,83700,520400,2120600,0.0,0.0,0.0,0.0,39,4,6,49
2008-09-04,AMEX (A),0,32698885,57300,32756185,0.0,0.0,0.0,0.0,0,54322,145,54467
2008-09-04,NSX (C),61090178,32075714,51862762,145028654,0.0,0.0,0.0,0.0,230349,72851,232788,535988
2008-09-04,NSX (DC),194036234,43883147,124455139,362374520,0.0,0.0,0.0,0.0,713488,120982,468760,1303230
2008-09-04,NYSE (DN),425649649,267735844,276246308,969631801,0.0,0.0,0.0,0.0,2694587,968730,1455488,5118805
2008-09-04,Nasdaq (DQ),991058964,249367357,512989919,1753416240,0.0,0.0,0.0,0.0,1962975,285015,852527,3100517
2008-09-04,ADF (D),32819562,4670154,15743360,53233076,0.0,0.0,0.0,0.0,138322,10854,57958,207134
2008-09-04,ISE (I),66496473,2367801,8185600,77049874,0.0,0.0,0.0,0.0,363761,3350,24875,391986
2008-09-04,CHX (M),21305929,7255819,9310203,37871951,0.0,0.0,0.0,0.0,41390,2789,13553,57732
2008-09-04,NYSE (N),1302155976,0,0,1302155976,0.0,0.0,0.0,0.0,4552434,0,0,4552434
2008-09-04,NYSE Arca (P),881437500,455086769,422867331,1759391600,0.0,0.0,0.0,0.0,5439014,1296171,2041204,8776389
2008-09-04,Nasdaq (Q),1253208969,594134123,963416507,2810759599,0.0,0.0,0.0,0.0,7107109,1684647,4067593,12859349
2008-09-04,CBOE (W),5470000,7065200,5521700,18056900,0.0,0.0,0.0,0.0,1401,2781,6949,11131
2008-09-04,PHLX (X),4483100,1177300,470850,6131250,0.0,0.0,0.0,0.0,72,8,9,89
2008-09-05,AMEX (A),0,34879534,99200,34978734,0.0,0.0,0.0,0.0,0,56546,187,56733
2008-09-05,NSX (C),58682367,32168967,45329464,136180798,0.0,0.0,0.0,0.0,218020,79278,213848,511146
2008-09-05,NSX (DC),214311753,50709320,134999763,400020836,0.0,0.0,0.0,0.0,827295,136945,520241,1484481
2008-09-05,NYSE (DN),410470943,277834367,262725759,951031069,0.0,0.0,0.0,0.0,2705582,1024700,1472415,5202697
2008-09-05,Nasdaq (DQ),871091193,225802101,455523140,1552416434,0.0,0.0,0.0,0.0,1912144,285540,824401,3022085
2008-09-05,ADF (D),39999778,4845889,14994548,59840215,0.0,0.0,0.0,0.0,166362,12873,58436,237671
2008-09-05,ISE (I),64454900,2014000,7493600,73962500,0.0,0.0,0.0,0.0,354205,3961,21218,379384
2008-09-05,CHX (M),22615203,5097109,4205867,31918179,0.0,0.0,0.0,0.0,29803,3205,8181,41189
2008-09-05,NYSE (N),1199613912,0,0,1199613912,0.0,0.0,0.0,0.0,4446700,0,0,4446700
2008-09-05,NYSE Arca (P),879621469,472149296,412143929,1763914694,0.0,0.0,0.0,0.0,5461666,1340156,2023869,8825691
2008-09-05,Nasdaq (Q),1261887923,617032589,929979856,2808900368,0.0,0.0,0.0,0.0,7403560,1863565,4140022,13407147
2008-09-05,CBOE (W),2776400,5374500,3743900,11894800,0.0,0.0,0.0,0.0,1662,3414,6968,12044
2008-09-05,PHLX (X),2116900,525900,392900,3035700,0.0,0.0,0.0,0.0,56,4,9,69
2008-09-08,AMEX (A),0,45719343,113800,45833143,0.0,0.0,0.0,0.0,0,63987,193,64180
2008-09-08,NSX (C),138749654,44106803,55850327,238706784,0.0,0.0,0.0,0.0,371627,97523,247663,716813
2008-09-08,NSX (DC),384745867,58251937,155900171,598897975,0.0,0.0,0.0,0.0,1173404,154411,598313,1926128
2008-09-08,NYSE (DN),577060029,336664619,297396449,1211121097,0.0,0.0,0.0,0.0,3558067,1187906,1642211,6388184
2008-09-08,Nasdaq (DQ),1318079898,263720061,494983397,2076783356,0.0,0.0,0.0,0.0,2369772,289388,885293,3544453
2008-09-08,ADF (D),52232844,7917018,17959126,78108988,0.0,0.0,0.0,0.0,189050,18520,67555,275125
2008-09-08,ISE (I),67772302,1559100,4031600,73363002,0.0,0.0,0.0,0.0,361666,2599,12115,376380
2008-09-08,CHX (M),24075931,9751952,4361463,38189346,0.0,0.0,0.0,0.0,38829,4701,9073,52603
2008-09-08,NYSE (N),1695916654,0,0,1695916654,0.0,0.0,0.0,0.0,5392170,0,0,5392170
2008-09-08,NYSE Arca (P),1277145967,590467746,473628499,2341242212,0.0,0.0,0.0,0.0,7109090,1623235,2292079,11024404
2008-09-08,Nasdaq (Q),1815971584,793804420,1100028318,3709804322,0.0,0.0,0.0,0.0,9676442,2277981,4862202,16816625
2008-09-08,CBOE (W),5026600,4701400,8397600,18125600,0.0,0.0,0.0,0.0,1408,4085,8172,13665
2008-09-08,PHLX (X),1082100,607000,456450,2145550,0.0,0.0,0.0,0.0,24,5,9,38
2008-09-09,AMEX (A),0,40752271,131900,40884171,0.0,0.0,0.0,0.0,0,68554,183,68737
2008-09-09,NSX (C),119433763,40094540,62755559,222283862,0.0,0.0,0.0,0.0,344033,96344,268543,708920
2008-09-09,NSX (DC),356204558,59681698,158795037,574681293,0.0,0.0,0.0,0.0,1155627,157410,608496,1921533
2008-09-09,NYSE (DN),611911563,324110409,305012771,1241034743,0.0,0.0,0.0,0.0,3951485,1183422,1613970,6748877
2008-09-09,Nasdaq (DQ),1465819235,281636961,557497269,2304953465,0.0,0.0,0.0,0.0,2740656,323679,980469,4044804
2008-09-09,ADF (D),49829575,8187778,19716135,77733488,0.0,0.0,0.0,0.0,207735,18141,67612,293488
2008-09-09,ISE (I),104317800,2405600,9391014,116114414,0.0,0.0,0.0,0.0,551106,3758,29444,584308
2008-09-09,CHX (M),26937306,11959998,3912160,42809464,0.0,0.0,0.0,0.0,42801,4327,8460,55588
2008-09-09,NYSE (N),1690245513,0,100,1690245613,0.0,0.0,0.0,0.0,5538561,0,1,5538562
2008-09-09,NYSE Arca (P),1240219627,567143453,452290895,2259653975,0.0,0.0,0.0,0.0,7326112,1591052,2198045,11115209
2008-09-09,Nasdaq (Q),1716864951,705245314,1067113101,3489223366,0.0,0.0,0.0,0.0,9747169,2098070,4700545,16545784
2008-09-09,CBOE (W),4657100,4728000,6663500,16048600,0.0,0.0,0.0,0.0,1806,3801,8205,13812
2008-09-09,PHLX (X),5177800,1466500,2020050,8664350,0.0,0.0,0.0,0.0,60,5,25,90
2008-09-10,AMEX (A),0,41825539,77900,41903439,0.0,0.0,0.0,0.0,0,60948,156,61104
2008-09-10,NSX (C),93555853,35419952,59320591,188296396,0.0,0.0,0.0,0.0,278746,85636,258991,623373
2008-09-10,NSX (DC),299264079,51631428,140712514,491608021,0.0,0.0,0.0,0.0,1005960,132755,535170,1673885
2008-09-10,NYSE (DN),549473250,282180077,272424269,1104077596,0.0,0.0,0.0,0.0,3500077,1088909,1486335,6075321
2008-09-10,Nasdaq (DQ),1253362875,256222676,518012128,2027597679,0.0,0.0,0.0,0.0,2200529,297614,820397,3318540
2008-09-10,ADF (D),43980511,5682985,17440882,67104378,0.0,0.0,0.0,0.0,178668,14867,60427,253962
2008-09-10,ISE (I),94714900,1999100,8738500,105452500,0.0,0.0,0.0,0.0,477111,3543,23956,504610
2008-09-10,CHX (M),23179294,7176893,5707998,36064185,0.0,0.0,0.0,0.0,36861,3286,9789,49936
2008-09-10,NYSE (N),1549327646,0,0,1549327646,0.0,0.0,0.0,0.0,4842363,0,0,4842363
2008-09-10,NYSE Arca (P),1097547370,502806722,395699996,1996054088,0.0,0.0,0.0,0.0,6444922,1462021,2065984,9972927
2008-09-10,Nasdaq (Q),1533520904,618246723,905556137,3057323764,0.0,0.0,0.0,0.0,8517298,1911376,4178947,14607621
2008-09-10,CBOE (W),9230700,5272400,2538500,17041600,0.0,0.0,0.0,0.0,1863,3639,7473,12975
2008-09-10,PHLX (X),2400400,269500,300145,2970045,0.0,0.0,0.0,0.0,57,8,41,106
2008-09-11,AMEX (A),0,37516108,181600,37697708,0.0,0.0,0.0,0.0,0,61873,191,62064
2008-09-11,NSX (C),99130144,38936419,60712504,198779067,0.0,0.0,0.0,0.0,294551,95445,257437,647433
2008-09-11,NSX (DC),319514835,52621743,135280888,507417466,0.0,0.0,0.0,0.0,1080573,148103,551805,1780481
2008-09-11,NYSE (DN),581081146,323242485,267820482,1172144113,0.0,0.0,0.0,0.0,3736086,1244397,1480734,6461217
2008-09-11,Nasdaq (DQ),1236032368,264645500,529463042,2030140910,0.0,0.0,0.0,0.0,2263832,301224,845161,3410217
2008-09-11,ADF (D),52354648,6452904,16014372,74821924,0.0,0.0,0.0,0.0,196146,15978,62984,275108
2008-09-11,ISE (I),100119445,1903100,6737500,108760045,0.0,0.0,0.0,0.0,526820,4536,21296,552652
2008-09-11,CHX (M),31636369,9228510,3366999,44231878,0.0,0.0,0.0,0.0,35939,3943,10508,50390
2008-09-11,NYSE (N),1452376162,0,0,1452376162,0.0,0.0,0.0,0.0,5072622,0,0,5072622
2008-09-11,NYSE Arca (P),1285029874,590158526,409091779,2284280179,0.0,0.0,0.0,0.0,7106843,1712631,2076587,10896061
2008-09-11,Nasdaq (Q),1694669625,735744391,937248689,3367662705,0.0,0.0,0.0,0.0,9364400,2258238,4279299,15901937
2008-09-11,CBOE (W),20275900,5814500,4348700,30439100,0.0,0.0,0.0,0.0,2067,3906,7756,13729
2008-09-11,PHLX (X),3246700,529300,721100,4497100,0.0,0.0,0.0,0.0,39,5,13,57
2008-09-12,AMEX (A),0,37484858,126400,37611258,0.0,1405609747.05,3463687.0,1409073434.05,0,53038,212,53250
2008-09-12,NSX (C),101129020,37097949,54104505,192331474,1758690551.6,1786675141.7,1251960197.99,4797325891.29,268616,103768,234178,606562
2008-09-12,NSX (DC),310935372,45902236,116975535,473813143,5941209456.73,2042135831.91,3209318075.58,11192663364.2,1004608,132551,477147,1614306
2008-09-12,NYSE (DN),542875743,257568573,235391423,1035835739,15709645146.1,15821707179.8,6481213220.93,38012565546.9,3424649,1034683,1347145,5806477
2008-09-12,Nasdaq (DQ),1170882139,232201214,410998058,1814081411,27318560761.3,13417942743.3,10433153495.4,51169657000.0,2167645,284370,737927,3189942
2008-09-12,ADF (D),46890509,3141915,13578619,63611043,1426119474.85,140213790.71,384739630.962,1951072896.53,191003,9971,53446,254420
2008-09-12,ISE (I),90366300,1701501,6087800,98155601,2563191766.27,70733667.0,155451248.41,2789376681.68,457420,3445,21058,481923
2008-09-12,CHX (M),24025189,9371061,4124174,37520424,776920612.834,776542065.43,134095225.465,1687557903.73,43754,3472,6526,53752
2008-09-12,NYSE (N),1309430773,0,0,1309430773,41668215831.8,0.0,0.0,41668215831.8,4607453,0,0,4607453
2008-09-12,NYSE Arca (P),1163669005,460066519,354030717,1977766241,30042392146.1,26749164667.7,10581405892.1,67372962705.9,6398516,1435354,1887934,9721804
2008-09-12,Nasdaq (Q),1516511176,592819817,824709054,2934040047,41759769167.8,39946893188.0,23675849338.7,105382511694.0,8314644,1932045,3839082,14085771
2008-09-12,CBOE (W),8500500,6185300,5023100,19708900,376853306.92,517805053.6,161830704.8,1056489065.32,1343,3354,7054,11751
2008-09-12,PHLX (X),2275800,583700,664250,3523750,76121612.0,34728730.0,22400800.0,133251142.0,46,4,8,58
2008-09-15,AMEX (A),0,58477276,740000,59217276,0.0,2648654523.71,30930139.0,2679584662.71,0,74774,378,75152
2008-09-15,NSX (C),34520820,16760919,12975531,64257270,504150905.982,843342080.482,315148252.911,1662641239.38,85907,39141,58739,183787
2008-09-15,NSX (DC),323842429,57127143,105187586,486157158,5757246528.07,2332806537.24,2485106553.0,10575159618.3,1175487,170811,446189,1792487
2008-09-15,NYSE (DN),616552180,350577478,265516565,1232646223,16784381810.2,20599642398.4,21325009701.2,58709033909.7,3906111,1316281,1902086,7124478
2008-09-15,Nasdaq (DQ),1240217298,325034151,422386821,1987638270,27412967124.2,19711039991.3,10156461977.8,57280469093.3,2330232,316289,749324,3395845
2008-09-15,ADF (D),73909156,10494489,16465457,100869102,1941579171.95,465290979.717,441675582.883,2848545734.55,255379,22395,65884,343658
2008-09-15,ISE (I),146144900,35294500,32845800,214285200,3953944316.42,2152948149.87,818773362.83,6925665829.12,730821,117616,159957,1008394
2008-09-15,CHX (M),26929598,13747146,6997970,47674714,744509172.061,1377247141.08,252574925.742,2374331238.88,48116,6408,9480,64004
2008-09-15,NYSE (N),1840995827,0,0,1840995827,56640950717.1,0.0,0.0,56640950717.1,5853591,0,0,5853591
2008-09-15,NYSE Arca (P),1707742730,760087239,456842038,2924672007,42080546350.1,43300264333.6,13839257032.7,99220067716.4,8857698,2185472,2316271,13359441
2008-09-15,Nasdaq (Q),2342811231,934800323,1107168375,4384779929,55194320981.3,60928430832.4,31206976235.6,147329728049.0,11154564,2838081,4601106,18593751
2008-09-15,CBOE (W),1895800,7355800,4403200,13654800,55501178.0,583983516.5,136836345.66,776321040.16,2608,5044,10142,17794
2008-09-15,PHLX (X),3650600,326000,44200,4020800,90542984.0,21314600.0,2984699.0,114842283.0,39,3,2,44
2008-09-16,AMEX (A),0,64181342,217000,64398342,0.0,2459256015.42,8495699.0,2467751714.42,0,98665,183,98848
2008-09-16,NSX (C),151661336,63669560,89244497,304575393,2718132265.71,3512016120.22,1915068386.59,8145216772.52,448696,180868,395696,1025260
2008-09-16,NSX (DC),423374366,62714464,160229935,646318765,7118488418.16,2809320681.61,3819341732.51,13747150832.3,1305485,187448,645958,2138891
2008-09-16,NYSE (DN),743593924,410897905,360909106,1515400935,20053695466.6,23997361080.5,9409580801.84,53460637348.9,4734127,1576340,2061864,8372331
2008-09-16,Nasdaq (DQ),1545135572,364042735,601082154,2510260461,35209111457.1,21908344430.4,13303945582.7,70421401470.2,2998739,374444,1048795,4421978
2008-09-16,ADF (D),81021024,7794852,19137506,107953382,2225599235.31,517479769.545,508616904.142,3251695909.0,284688,21569,69400,375657
2008-09-16,ISE (I),165323600,1962200,9539500,176825300,4406868570.51,87555391.5,206742052.66,4701166014.67,853543,3514,30911,887968
2008-09-16,CHX (M),26921650,16731373,9599179,53252202,806449073.676,1777049521.38,296810753.35,2880309348.41,49420,7830,12602,69852
2008-09-16,NYSE (N),2170610826,0,0,2170610826,67689773659.7,0.0,0.0,67689773659.7,7335052,0,0,7335052
2008-09-16,NYSE Arca (P),1890070624,898436490,620054998,3408562112,47355717092.6,52755703124.8,17708814860.5,117820235078.0,10472148,2747493,3132581,16352222
2008-09-16,Nasdaq (Q),2355722543,1123946701,1404290203,4883959447,57804682151.2,70912121930.8,38506029027.1,167222833109.0,12261279,3540238,5983209,21784726
2008-09-16,CBOE (W),3854800,3922100,6286000,14062900,110080585.0,300615506.0,198361168.5,609057259.5,3104,2768,26333,32205
2008-09-16,PHLX (X),2289000,2096700,218550,4604250,78086510.0,69924945.0,8178927.5,156190382.5,49,1,4,54
2008-09-17,AMEX (A),0,55965370,43000,56008370,0.0,2084416711.7,846392.0,2085263103.7,0,89780,133,89913
2008-09-17,NSX (C),155932774,67605329,77169650,300707753,2881320113.66,3659162967.88,1625307263.02,8165790344.56,445680,185480,341441,972601
2008-09-17,NSX (DC),431887037,76649938,169892720,678429695,8046877554.43,3267335405.13,4224860999.76,15539073959.3,1376753,217675,680974,2275402
2008-09-17,NYSE (DN),754235776,462584562,356724189,1573544527,21264481002.3,26464682317.5,9206779966.53,56935943286.3,4780177,1688073,1998564,8466814
2008-09-17,Nasdaq (DQ),1694516031,448351776,689217140,2832084947,38936607105.3,26327859118.9,13945914098.9,79210380323.1,2822786,411757,1018329,4252872
2008-09-17,ADF (D),93533326,12522618,25380668,131436612,2704782224.98,592605122.925,705040300.71,4002427648.62,341628,31076,89371,462075
2008-09-17,ISE (I),143709171,2556200,9293900,155559271,4181712469.35,98615908.0,197794340.89,4478122718.24,762398,3986,32761,799145
2008-09-17,CHX (M),28037000,18917937,11414944,58369881,1010932206.98,2033069325.95,413734593.391,3457736126.33,42823,8747,14413,65983
2008-09-17,NYSE (N),2140736152,0,0,2140736152,67315931562.2,0.0,0.0,67315931562.2,7252453,0,0,7252453
2008-09-17,NYSE Arca (P),1764791119,953038249,555813339,3273642707,47423978107.2,54466317213.3,15882474752.3,117772770073.0,9766427,2765238,2822835,15354500
2008-09-17,Nasdaq (Q),2330691258,1170518817,1341135998,4842346073,60997121934.5,73551993671.9,37420534054.5,171969649661.0,12173715,3585601,5724916,21484232
2008-09-17,CBOE (W),3308400,19817200,6369600,29495200,228342699.3,1263278183.0,209607141.0,1701228023.3,2424,4906,22002,29332
2008-09-17,PHLX (X),2157200,611500,260650,3029350,80820347.0,19334000.0,25099686.5,125254033.5,33,5,8,46
2008-09-18,AMEX (A),0,79234558,592000,79826558,0.0,3583587427.35,22080801.0,3605668228.35,0,113101,471,113572
2008-09-18,NSX (C),153424716,101218179,102929526,357572421,3346027325.06,4964612350.98,2196459994.54,10507099670.6,503923,249533,482981,1236437
2008-09-18,NSX (DC),464408391,126388381,228251375,819048147,10544309751.8,5866240079.68,5823948719.58,22234498551.0,1819679,380968,956251,3156898
2008-09-18,NYSE (DN),799678806,544301913,412856824,1756837543,22927044061.2,29793752265.5,10513078869.6,63233875196.3,5301724,1816276,2329113,9447113
2008-09-18,Nasdaq (DQ),1675393383,580884558,740404222,2996682163,42048362889.0,32389941260.0,16669347147.7,91107651296.7,3274169,463454,1247931,4985554
2008-09-18,ADF (D),99732608,22836085,26740831,149309524,2732706616.1,902549236.4,706534063.565,4341789916.06,372756,41405,97953,512114
2008-09-18,ISE (I),195205129,3920200,13484900,212610229,5593163107.37,178983993.0,301603588.83,6073750689.2,1076536,6913,45021,1128470
2008-09-18,CHX (M),26516455,15067878,9337466,50921799,865045870.646,1563176457.34,313994291.493,2742216619.47,48297,7884,15538,71719
2008-09-18,NYSE (N),2449695048,0,0,2449695048,76708513331.0,0.0,0.0,76708513331.0,8102035,0,0,8102035
2008-09-18,NYSE Arca (P),2058409557,1190028523,745899037,3994337117,59541887504.1,65799341785.2,20732814889.8,146074044179.0,11972377,3176796,3732403,18881576
2008-09-18,Nasdaq (Q),2600165738,1500164106,1716111123,5816440967,72514034184.6,89521393928.2,45510137618.6,207545565731.0,14335778,4181894,7525339,26043011
2008-09-18,CBOE (W),3267700,11830700,6175700,21274100,114069624.5,1067807282.5,172150142.5,1354027049.5,4122,9763,32350,46235
2008-09-18,PHLX (X),2936100,10000,532430,3478530,91885865.0,175500.0,20463433.5,112524798.5,41,1,9,51
2008-09-19,AMEX (A),0,117469966,73600,117543566,0.0,4334158756.51,878558.0,4335037314.51,0,93463,225,93688
2008-09-19,NSX (C),151700363,52053589,85273452,289027404,3100350175.29,2327220840.34,1837631457.28,7265202472.9,410896,125732,389398,926026
2008-09-19,NSX (DC),324418913,46999332,158085108,529503353,6894112990.22,2159336348.54,4122068566.16,13175517904.9,920164,122050,576384,1618598
2008-09-19,NYSE (DN),564956192,245588892,325777949,1136323033,17635053926.3,13678517838.4,8759286078.15,40072857842.8,3538919,885946,1831175,6256040
2008-09-19,Nasdaq (DQ),1576801842,390011440,773748648,2740561930,40870429207.4,26735157570.3,18149597112.2,85755183890.0,2581905,328112,1035979,3945996
2008-09-19,ADF (D),78412139,11821004,28845845,119078988,2438565553.84,627061274.565,737263333.808,3802890162.21,298518,27046,100475,426039
2008-09-19,ISE (I),137488910,2682119,12896400,153067429,3992130924.95,135384266.925,274675961.48,4402191153.35,699964,5000,37028,741992
2008-09-19,CHX (M),24950293,9258959,5428567,39637819,832439506.154,1061029789.34,175803430.775,2069272726.27,45766,6059,15421,67246
2008-09-19,NYSE (N),2998753645,0,0,2998753645,96164187532.8,0.0,0.0,96164187532.8,5942943,0,0,5942943
2008-09-19,NYSE Arca (P),1658176146,754006285,618784885,3030967316,48857366527.4,43471195677.3,18529267987.3,110857830192.0,8446001,1901246,2957113,13304360
2008-09-19,Nasdaq (Q),1901135553,756329315,2051284494,4708749362,57017283472.1,46373129641.9,53297814243.0,156688227357.0,10083449,2103743,5923038,18110230
2008-09-19,CBOE (W),7038700,11719900,4421800,23180400,373386120.0,738485693.49,125898394.0,1237770207.49,2334,2134,20357,24825
2008-09-19,PHLX (X),2645600,3510800,237100,6393500,55728362.0,138285950.0,20355920.0,214370232.0,29,11,8,48
2008-09-22,AMEX (A),0,51205347,32800,51238147,0.0,2392082548.18,412241.0,2392494789.18,0,66703,133,66836
2008-09-22,NSX (C),102793340,38428196,53086304,194307840,2052775715.9,1906408150.91,1206789195.82,5165973062.64,297127,96846,249541,643514
2008-09-22,NSX (DC),252585682,39753624,101199427,393538733,4788363117.98,1820163036.72,2632471782.58,9240997937.29,731251,118971,392233,1242455
2008-09-22,NYSE (DN),378944236,191951964,201792434,772688634,11891112539.6,11220561221.8,5495114496.72,28606788258.1,2447202,740609,1163519,4351330
2008-09-22,Nasdaq (DQ),1043349147,238218330,441482947,1723050424,26575275591.6,12454044943.4,10287234060.8,49316554595.9,2056824,298944,755421,3111189
2008-09-22,ADF (D),48882805,6531593,15141399,70555797,1524866457.64,342262275.188,425504574.832,2292633307.66,201885,18067,56867,276819
2008-09-22,ISE (I),85975294,2325300,7836500,96137094,2604831244.39,111471155.0,174686318.52,2890988717.91,444872,4612,23422,472906
2008-09-22,CHX (M),22766549,11347953,4825522,38940024,875186718.609,1170977476.61,140356967.634,2186521162.85,34332,5293,9921,49546
2008-09-22,NYSE (N),1271260809,0,0,1271260809,42171471045.6,0.0,0.0,42171471045.6,4352132,0,0,4352132
2008-09-22,NYSE Arca (P),948506813,475948668,335393459,1759848940,28027522872.4,27434484128.6,9815326126.86,65277333127.8,5411956,1366492,1730210,8508658
2008-09-22,Nasdaq (Q),1181604858,488504991,787055247,2457165096,34963260631.7,30609798409.9,21308412158.2,86881471199.7,6561940,1564764,3564902,11691606
2008-09-22,CBOE (W),2963400,5379900,2786900,11130200,86328134.1,487317911.0,94697467.0,668343512.1,1511,4229,14088,19828
2008-09-22,PHLX (X),4487300,1320300,177100,5984700,131465083.0,75396230.0,3421635.0,210282948.0,39,8,7,54
2008-09-23,AMEX (A),0,39337958,289100,39627058,0.0,1645284923.37,10365482.0,1655650405.37,0,64552,300,64852
2008-09-23,NSX (C),85303906,36762928,53229695,175296529,1703174968.29,1937379097.21,1185749550.44,4826303615.95,259216,106584,250255,616055
2008-09-23,NSX (DC),272586692,37374533,106831807,416793032,4461200382.12,1719245583.17,2782853893.43,8963299858.72,748586,113475,401266,1263327
2008-09-23,NYSE (DN),383281778,201552708,226511185,811345671,11603774117.0,12355802747.6,6257397883.89,30216974748.5,2508445,807683,1262475,4578603
2008-09-23,Nasdaq (DQ),999059055,265483855,431522040,1696064950,23355785383.7,13946686873.0,10819675512.1,48122147768.8,1793365,270164,726526,2790055
2008-09-23,ADF (D),37749590,5219777,15043235,58012602,1147980280.53,274992721.44,402843804.69,1825816806.66,159156,17774,57278,234208
2008-09-23,ISE (I),86870230,1952800,6837800,95660830,2535162498.12,103607158.5,166054188.07,2804823844.69,462398,4005,22071,488474
2008-09-23,CHX (M),23056701,10046531,4623789,37727021,762372997.352,1097014966.23,185643025.965,2045030989.55,39329,5021,8928,53278
2008-09-23,NYSE (N),1153304087,0,0,1153304087,37757577402.6,0.0,0.0,37757577402.6,4384657,0,0,4384657
2008-09-23,NYSE Arca (P),942322148,447738399,346872998,1736933545,25952738768.9,27745635642.5,10484251710.1,64182626121.6,5358209,1406631,1837000,8601840
2008-09-23,Nasdaq (Q),1200863015,554616795,830967834,2586447644,34383720885.5,36443130561.4,23326031150.4,94152882597.4,6789137,1846760,3844424,12480321
2008-09-23,CBOE (W),2768900,9805200,4613700,17187800,119530159.0,758131590.32,150095131.0,1027756880.32,1748,8559,15513,25820
2008-09-23,PHLX (X),3195600,929500,463291,4588391,107838960.0,25307658.0,9014792.17,142161410.17,38,6,9,53
2008-09-24,AMEX (A),0,34700914,78600,34779514,0.0,1443248137.11,2652431.0,1445900568.11,0,48247,99,48346
2008-09-24,NSX (C),85886991,34211286,49318014,169416291,1544868212.93,1626737835.6,1058930525.62,4230536574.16,240576,92132,229256,561964
2008-09-24,NSX (DC),299143050,33428702,104816712,437388464,4240340952.8,1544206901.83,2689025439.98,8473573294.61,718354,105587,402573,1226514
2008-09-24,NYSE (DN),340750011,177938907,192986257,711675175,10054085455.5,10411465840.5,5245770234.3,25711321530.3,2140747,694504,1099787,3935038
2008-09-24,Nasdaq (DQ),1045026672,233274763,443827448,1722128883,22786192725.8,14021284311.9,11107418582.0,47914895619.7,1737733,233645,683381,2654759
2008-09-24,ADF (D),39806301,3317614,11491606,54615521,1175718270.9,137794786.735,301101226.58,1614614284.22,167435,10921,50266,228622
2008-09-24,ISE (I),76420600,1700900,6279500,84401000,2122394612.81,59899760.0,131892642.67,2314187015.48,378476,3627,20729,402832
2008-09-24,CHX (M),17825376,15826150,4220434,37871960,595772562.18,1764507837.65,166750648.92,2527031048.75,34179,5946,7714,47839
2008-09-24,NYSE (N),1082611783,0,0,1082611783,35162391827.4,0.0,0.0,35162391827.4,3787631,0,0,3787631
2008-09-24,NYSE Arca (P),829665811,371541151,296602058,1497809020,22195281515.9,23974201541.2,8840140411.89,55009623468.9,4494638,1138302,1573034,7205974
2008-09-24,Nasdaq (Q),1003841125,429378909,727643191,2160863225,27340234478.7,28481344715.8,19885980966.1,75707560160.6,5417816,1421860,3308040,10147716
2008-09-24,CBOE (W),1940000,13380900,3748400,19069300,73766501.3,1068819501.64,116042729.0,1258628731.94,1911,6649,14528,23088
2008-09-24,PHLX (X),1983800,2972900,294500,5251200,105323404.0,132039985.0,3473694.0,240837083.0,34,8,5,47
2008-09-25,AMEX (A),0,51488709,84800,51573509,0.0,1788704649.3,2947997.0,1791652646.3,0,50268,111,50379
2008-09-25,NSX (C),108930616,36156990,51322831,196410437,1808499269.99,1673777282.91,1091556792.48,4573833345.38,285633,93963,241426,621022
2008-09-25,NSX (DC),377777779,39050715,110031423,526859917,4924698926.2,1785606372.26,2742998480.19,9453303778.64,853017,116525,400352,1369894
2008-09-25,NYSE (DN),414247763,210787141,212646368,837681272,11652801386.5,11904276208.0,5615883323.93,29172960918.5,2503452,805292,1173027,4481771
2008-09-25,Nasdaq (DQ),1400682174,254439305,428141655,2083263134,25828007633.9,15774666942.1,10202666002.7,51805340578.7,2038463,266574,675583,2980620
2008-09-25,ADF (D),58740995,3847456,15843074,78431525,1537807255.81,169401812.88,383252742.975,2090461811.67,232795,11220,61250,305265
2008-09-25,ISE (I),97802600,2258700,7739900,107801200,2501528172.86,92455707.0,175989898.85,2769973778.71,447058,4116,25450,476624
2008-09-25,CHX (M),26461483,10147874,4678458,41287815,829754503.122,978301971.29,154342655.042,1962399129.45,46892,4460,9020,60372
2008-09-25,NYSE (N),1207589552,0,0,1207589552,37046563707.5,0.0,0.0,37046563707.5,4175862,0,0,4175862
2008-09-25,NYSE Arca (P),989233600,446588690,319541013,1755363303,24774656944.2,26301104270.9,9611768619.02,60687529834.1,5193126,1323187,1639241,8155554
2008-09-25,Nasdaq (Q),1232533804,501204026,748414347,2482152177,31177839401.9,33245701836.2,21193279488.6,85616820726.6,6231396,1612710,3357617,11201723
2008-09-25,CBOE (W),1786100,10196600,2945100,14927800,39620894.0,1040434222.36,87729686.0,1167784802.36,1125,5844,13906,20875
2008-09-25,PHLX (X),921500,337000,1076200,2334700,23196497.0,38692085.0,63662030.0,125550612.0,28,4,8,40
2008-09-26,AMEX (A),0,39020648,63300,39083948,0.0,1588066625.39,1559011.0,1589625636.39,0,48022,174,48196
2008-09-26,NSX (C),101194822,39562302,57193773,197950897,2024672130.76,1784783776.07,1298212594.24,5107668501.07,318520,94745,266727,679992
2008-09-26,NSX (DC),248540199,36367057,113807432,398714688,4130460963.62,1616537597.7,2943583312.88,8690581874.21,706923,106202,409282,1222407
2008-09-26,NYSE (DN),387757851,201285727,219716751,808760329,11235097091.9,11501161515.4,6095490388.34,28831748995.7,2435303,774849,1191980,4402132
2008-09-26,Nasdaq (DQ),1144140427,233415238,439375790,1816931455,24758721057.2,12306978475.3,11672653687.7,48738353220.2,2028834,289986,760808,3079628
2008-09-26,ADF (D),45931743,5025533,12483459,63440735,1298034036.13,260863803.62,379574787.695,1938472627.44,172502,13633,51989,238124
2008-09-26,ISE (I),73592200,2529900,6218500,82340600,2172441973.83,92531667.0,160682071.03,2425655711.86,391995,3766,18667,414428
2008-09-26,CHX (M),20142304,8935091,3936831,33014226,651991761.664,911371293.75,117899576.583,1681262632.0,50678,4659,8841,64178
2008-09-26,NYSE (N),1188952366,0,0,1188952366,36137427569.5,0.0,0.0,36137427569.5,3917176,0,0,3917176
2008-09-26,NYSE Arca (P),971208743,387790631,337581373,1696580747,24239863750.2,23170903243.6,10537631224.9,57948398218.7,5016669,1199770,1679775,7896214
2008-09-26,Nasdaq (Q),1199789077,478874938,809753857,2488417872,30944307389.1,31221165136.6,23188708606.6,85354181132.4,6230933,1542684,3550761,11324378
2008-09-26,CBOE (W),1075700,3851200,2686700,7613600,30358126.0,220100508.0,82929344.0,333387978.0,1824,3520,13339,18683
2008-09-26,PHLX (X),5110600,380000,54500,5545100,154391472.0,14123550.0,3749939.0,172264961.0,37,5,5,47
2008-09-29,AMEX (A),0,68097515,113900,68211415,0.0,2635458241.03,2786115.0,2638244356.03,0,85260,290,85550
2008-09-29,NSX (C),147533635,76532255,100885151,324951041,2782407018.05,3638653864.03,2200866177.21,8621927059.29,471306,202261,453939,1127506
2008-09-29,NSX (DC),285520871,54582352,140551070,480654293,5427290771.16,2405801241.86,3543902791.23,11376994804.2,924123,168212,502246,1594581
2008-09-29,NYSE (DN),535301949,321362171,326733829,1183397949,15252917983.7,17248602390.0,8497430565.61,40998950939.4,3514912,1236434,1777604,6528950
2008-09-29,Nasdaq (DQ),1291333019,294703185,510908760,2096944964,28777184474.6,15564454165.5,12701871979.3,57043510619.4,2311581,396486,900601,3608668
2008-09-29,ADF (D),30718243,3294222,12276589,46289054,875846473.35,183106892.56,295435383.853,1354388749.76,133619,8292,50926,192837
2008-09-29,ISE (I),163697600,2967200,12020700,178685500,4336575602.25,131678827.0,249913205.92,4718167635.17,870241,7873,33497,911611
2008-09-29,CHX (M),23304944,10053987,7307517,40666448,624779792.453,957730777.1,236757163.64,1819267733.19,67482,7923,18537,93942
2008-09-29,NYSE (N),2034940160,0,0,2034940160,58648829495.9,0.0,0.0,58648829495.9,6043210,0,0,6043210
2008-09-29,NYSE Arca (P),1514451272,801256840,628903386,2944611498,38836480746.4,46977151027.3,18916468035.7,104730099809.0,8282494,2360097,3127470,13770061
2008-09-29,Nasdaq (Q),1438359777,726243350,1145142379,3309745506,39370294863.1,44181675733.4,31579976631.0,115131947228.0,8210598,2448882,4809729,15469209
2008-09-29,CBOE (W),1027000,6598000,3664200,11289200,41073771.0,495904699.37,117422584.0,654401054.37,3127,7574,15614,26315
2008-09-29,PHLX (X),1121600,275000,483373,1879973,29898395.0,8580000.0,46964154.55,85442549.55,19,1,11,31
2008-09-30,AMEX (A),0,44850360,188400,45038760,0.0,2221403977.07,6174706.0,2227578683.07,0,54777,243,55020
2008-09-30,NSX (C),118699793,33781086,75396194,227877073,2198957370.13,1556735599.71,1570971755.93,5326664725.77,385300,92608,341714,819622
2008-09-30,NSX (DC),261109737,45036143,150829093,456974973,4791335812.76,1950117120.45,3461770838.76,10203223772.0,812593,131604,489458,1433655
2008-09-30,NYSE (DN),443945204,211257560,258264744,913467508,12231117310.7,12004033659.3,6722324674.08,30957475644.1,2791519,861332,1457708,5110559
2008-09-30,Nasdaq (DQ),1210044854,276748381,543902324,2030695559,26938174231.0,15556609898.5,12950288931.8,55445073061.2,1973628,281481,826171,3081280
2008-09-30,ADF (D),57731563,4311161,22216108,84258832,1654113319.0,254876814.15,567538585.434,2476528718.59,252780,14631,97701,365112
2008-09-30,ISE (I),96897710,1591400,9066700,107555810,2624833149.21,90321532.0,184036346.79,2899191028.0,488506,3456,28125,520087
2008-09-30,CHX (M),18725268,6696050,9283646,34704964,579870074.355,677792112.725,418777711.26,1676439898.34,58514,5263,14696,78473
2008-09-30,NYSE (N),1621544801,0,0,1621544801,49047465042.3,0.0,0.0,49047465042.3,4572035,0,0,4572035
2008-09-30,NYSE Arca (P),1063333453,468226783,398278923,1929839159,27450615183.2,26050581759.7,11517304162.9,65018501105.8,6024831,1483578,2085917,9594326
2008-09-30,Nasdaq (Q),1169540950,457392977,963263484,2590197411,31162616377.9,29624155906.5,25135361741.0,85922134025.3,6524488,1532523,3978595,12035606
2008-09-30,CBOE (W),1749300,6762600,2996700,11508600,48459727.0,507719832.0,80707872.0,636887431.0,1351,3956,14724,20031
2008-09-30,PHLX (X),2877500,318000,488920,3684420,99039241.0,11291200.0,25340957.0,135671398.0,36,3,8,47
2008-10-01,AMEX (A),0,35046941,91900,35138841,0.0,1303516508.92,2878766.0,1306395274.92,0,46585,106,46691
2008-10-01,NSX (C),106401711,37242794,59781785,203426290,2158451388.96,1848800265.43,1195923125.0,5203174779.4,341292,95399,272308,708999
2008-10-01,NSX (DC),270244887,48453682,119406598,438105167,5248105900.63,2205710983.34,2905833368.48,10359650252.5,833005,144785,401303,1379093
2008-10-01,NYSE (DN),469252307,243945474,218999603,932197384,13382174790.1,13650453169.4,5649448621.86,32682076581.4,2969929,928429,1268994,5167352
2008-10-01,Nasdaq (DQ),1129103365,266178949,400011865,1795294179,23853443090.9,14425586498.1,9345001551.93,47624031141.0,1933621,269259,693392,2896272
2008-10-01,ADF (D),44077054,4240675,13907606,62225335,1325527119.68,208492724.205,316243315.788,1850263159.67,185853,13455,62278,261586
2008-10-01,ISE (I),96333600,2125900,6182900,104642400,2583854785.01,126918273.5,122406640.85,2833179699.36,477265,4695,17911,499871
2008-10-01,CHX (M),24595166,10286111,4976790,39858067,719326775.587,981187510.405,209835881.071,1910350167.06,59222,7099,13094,79415
2008-10-01,NYSE (N),1370047381,0,0,1370047381,38024643904.4,0.0,0.0,38024643904.4,4281461,0,0,4281461
2008-10-01,NYSE Arca (P),997684708,445430296,328449753,1771564757,25935892658.1,25768990586.0,9313348437.65,61018231681.8,5524371,1375294,1752556,8652221
2008-10-01,Nasdaq (Q),1273538972,489475559,794842090,2557856621,34542106324.7,31500052963.9,20972831226.5,87014990515.2,7110923,1652650,3719150,12482723
2008-10-01,CBOE (W),1164800,6762500,4100500,12027800,43508920.0,517824582.58,127072353.44,688405856.02,834,8343,16650,25827
2008-10-01,PHLX (X),3346300,566000,411350,4323650,85685385.0,11540880.0,29422130.0,126648395.0,51,2,11,64
2008-10-02,AMEX (A),0,41725971,93500,41819471,0.0,1330715291.45,2795011.0,1333510302.45,0,54606,146,54752
2008-10-02,NSX (C),112911881,40505766,62654508,216072155,2630556919.0,1918833197.49,1246961498.67,5796351615.16,417177,106236,310491,833904
2008-10-02,NSX (DC),304846593,53855876,138826982,497529451,6407970423.52,2400106108.13,3333920332.01,12141996863.7,989104,161104,488564,1638772
2008-10-02,NYSE (DN),497371006,251385309,245683498,994439813,14718798977.1,13930321515.3,6123002960.97,34772123453.4,3251197,985910,1372933,5610040
2008-10-02,Nasdaq (DQ),1174998227,268638589,474952744,1918589560,28488791482.8,16312381905.3,10478239761.4,55279413149.5,2213102,320317,818983,3352402
2008-10-02,ADF (D),49032903,5492011,17320448,71845362,1508784329.02,265283629.37,371112009.417,2145179967.81,204755,14545,67947,287247
2008-10-02,ISE (I),94528000,2151600,6592400,103272000,2784367288.5,89414073.5,125780001.6,2999561363.6,517691,5052,18220,540963
2008-10-02,CHX (M),29014402,10382465,5789029,45185896,890443302.209,935203320.885,181973899.865,2007620522.96,70448,11120,12106,93674
2008-10-02,NYSE (N),1508020078,0,0,1508020078,45572087005.6,0.0,0.0,45572087005.6,4870283,0,0,4870283
2008-10-02,NYSE Arca (P),1154053902,449932078,382909465,1986895445,33477376281.3,25169506222.8,9981863505.19,68628746009.3,6660831,1464987,1994730,10120548
2008-10-02,Nasdaq (Q),1351908521,538878134,885423503,2776210158,38673270609.2,34626723477.4,22603904338.2,95903898424.8,7645964,1813593,3902008,13361565
2008-10-02,CBOE (W),1377900,4761200,3307900,9447000,51513026.0,323947632.0,92996535.6,468457193.6,1271,6015,15626,22912
2008-10-02,PHLX (X),9164700,225600,1752100,11142400,204218740.0,11568200.0,47834471.0,263621411.0,57,5,23,85
2008-10-03,AMEX (A),0,46190012,60000,46250012,0.0,1817985886.67,1053486.0,1819039372.67,0,72008,129,72137
2008-10-03,NSX (C),106091144,52734635,64943492,223769271,2107384102.88,2631472802.84,1398756248.77,6137613154.49,344917,141757,315268,801942
2008-10-03,NSX (DC),364907398,67605851,147487992,580001241,6530402010.59,3012382362.9,3812890004.08,13355674377.6,1106604,198155,539963,1844722
2008-10-03,NYSE (DN),597892099,350427024,304881340,1253200463,16809448562.0,19236227971.2,7771204898.8,43816881432.0,3964375,1395652,1799639,7159666
2008-10-03,Nasdaq (DQ),1327920789,288601940,516983030,2133505759,30098744822.9,16544050600.3,12218650387.0,58861445810.2,2333118,375206,884695,3593019
2008-10-03,ADF (D),55471642,5477220,20428258,81377120,1663937383.52,384444975.55,495084588.06,2543466947.13,236218,14247,81828,332293
2008-10-03,ISE (I),121598400,2013600,7722100,131334100,3108767696.33,86415324.0,145433999.6,3340617019.93,616855,4699,21857,643411
2008-10-03,CHX (M),30337887,12647309,5363003,48348199,914618623.234,1154015582.59,190403636.985,2259037842.81,68157,12728,11521,92406
2008-10-03,NYSE (N),1420234544,0,0,1420234544,41574557374.2,0.0,0.0,41574557374.2,5076274,0,0,5076274
2008-10-03,NYSE Arca (P),1140818721,511615503,417078337,2069512561,29502380421.9,28247534724.0,11749161014.9,69499076160.9,6470465,1642454,2197239,10310158
2008-10-03,Nasdaq (Q),1564260304,741778294,1071010397,3377048995,41809142652.5,47793425299.2,28339250275.7,117941818227.0,8937264,2516945,4854376,16308585
2008-10-03,CBOE (W),1530600,6992200,5431900,13954700,51221485.0,463150451.0,163665501.8,678037437.8,1529,5336,21090,27955
2008-10-03,PHLX (X),3914000,100000,1178600,5192600,157497972.0,11360000.0,50600950.0,219458922.0,34,1,8,43
2008-10-06,AMEX (A),0,66166654,238400,66405054,0.0,2314603799.08,7273611.0,2321877410.08,0,96002,353,96355
2008-10-06,NSX (C),120395224,76139084,87779681,284313989,2544403986.65,3480780252.47,1627618099.88,7652802339.0,486918,195422,404781,1087121
2008-10-06,NSX (DC),351018683,88116733,188346172,627481588,6304583696.65,3682608298.5,3800519878.04,13787711873.2,1207730,267662,656866,2132258
2008-10-06,NYSE (DN),695415421,440211555,381883210,1517510186,18583913265.9,23158205990.9,8819824586.5,50561943843.2,4811366,1787368,2167868,8766602
2008-10-06,Nasdaq (DQ),1318581483,384831642,672958772,2376371897,28822126445.1,20368197794.9,13698178827.7,62888503067.7,2821941,532841,1261343,4616125
2008-10-06,ADF (D),71542188,9106514,35822601,116471303,1991373233.76,346313335.425,781238882.657,3118925451.84,299675,24288,136848,460811
2008-10-06,ISE (I),144464800,3189000,12029600,159683400,3805171906.53,97629992.5,224630948.49,4127432847.52,831817,5610,35101,872528
2008-10-06,CHX (M),31947313,14980920,10040450,56968683,994563397.079,1265217321.64,248455637.643,2508236356.36,71461,10139,14825,96425
2008-10-06,NYSE (N),1947787226,0,0,1947787226,54476027578.6,0.0,0.0,54476027578.6,6511453,0,0,6511453
2008-10-06,NYSE Arca (P),1386537902,786856171,597622640,2771016713,35892925767.9,40647244869.8,14892558257.7,91432728895.4,8651995,2562840,3075147,14289982
2008-10-06,Nasdaq (Q),1884782736,1052970352,1545147890,4482900978,47716359602.6,62948325283.1,36744808933.6,147409493819.0,11172961,3523732,6611285,21307978
2008-10-06,CBOE (W),3557100,8591700,5113000,17261800,85280065.0,636194496.0,124893806.8,846368367.8,2968,7124,23051,33143
2008-10-06,PHLX (X),1215400,255000,785400,2255800,33617634.0,19893000.0,26261630.0,79772264.0,23,2,6,31
2008-10-07,AMEX (A),0,60124874,550400,60675274,0.0,1998790566.51,20605685.0,2019396251.51,0,70074,568,70642
2008-10-07,NSX (C),99311487,54572120,64780556,218664163,1908906260.13,2361104254.72,1206191763.75,5476202278.6,358779,140785,300512,800076
2008-10-07,NSX (DC),327521589,76007096,148328356,551857041,6033517515.66,3359904085.07,3345638879.12,12739060479.9,1172532,248148,556088,1976768
2008-10-07,NYSE (DN),553844967,320029379,287676103,1161550449,14886217064.1,15502353065.9,6714595998.54,37103166128.4,3699958,1165452,1658346,6523756
2008-10-07,Nasdaq (DQ),1209860878,316988731,566129836,2092979445,26973463015.6,15457903739.9,12263956820.1,54695323575.6,2239285,398285,976592,3614162
2008-10-07,ADF (D),61865179,8085273,20557443,90507895,1694048085.29,402845539.402,460572067.456,2557465692.15,270505,22116,85043,377664
2008-10-07,ISE (I),112020200,1717300,9742700,123480200,2889680805.91,62894583.5,180455904.42,3133031293.83,640653,4198,30400,675251
2008-10-07,CHX (M),28133102,18515186,9049254,55697542,767636925.298,1702843316.81,325347051.69,2795827293.8,64818,13569,14051,92438
2008-10-07,NYSE (N),1728187261,0,0,1728187261,47251893543.4,0.0,0.0,47251893543.4,5968100,0,0,5968100
2008-10-07,NYSE Arca (P),1237859565,703094379,504558257,2445512201,31490214586.1,36846286418.5,13096718931.7,81433219936.3,7762875,2172424,2629293,12564592
2008-10-07,Nasdaq (Q),1710094698,939798581,1290651013,3940544292,43340773098.6,56139504411.9,31606700771.2,131086978282.0,10384931,3222749,5887509,19495189
2008-10-07,CBOE (W),1431000,6258200,4759300,12448500,44503835.4,361016393.7,119074387.0,524594616.1,2627,5920,26794,35341
2008-10-07,PHLX (X),1112000,317000,629300,2058300,28024883.0,11406135.0,21588842.0,61019860.0,29,3,6,38
2008-10-08,AMEX (A),0,73970844,119600,74090444,0.0,2818241535.88,2895424.0,2821136959.88,0,90883,215,91098
2008-10-08,NSX (C),101621659,80588986,100652445,282863090,2136185847.69,3751314564.74,1956427005.41,7843927417.84,414260,234036,457094,1105390
2008-10-08,NSX (DC),104098247,25871768,12369125,142339140,2110013673.63,1097213076.35,218180149.269,3425406899.25,377149,73968,45216,496333
2008-10-08,NYSE (DN),780907740,427173858,370396973,1578478571,20642957274.6,21519611395.9,8515647308.68,50678215979.2,5291496,1719400,2160061,9170957
2008-10-08,Nasdaq (DQ),1451743853,408651656,657892959,2518288468,30579212524.9,20997789624.6,13106512688.3,64683514837.7,2715523,484111,1242901,4442535
2008-10-08,ADF (D),106256253,10957273,36813089,154026615,2857577670.67,541113194.043,839772015.121,4238462879.83,476826,29972,151533,658331
2008-10-08,ISE (I),206853700,2024000,13152400,222030100,5394319789.99,83454000.5,225050409.66,5702824200.15,1213128,6098,39408,1258634
2008-10-08,CHX (M),39648150,20722525,8949205,69319880,1093716089.69,1771856503.5,273578105.512,3139150698.71,99323,14847,17953,132123
2008-10-08,NYSE (N),2128161944,0,0,2128161944,56606743726.2,0.0,0.0,56606743726.2,7438519,0,0,7438519
2008-10-08,NYSE Arca (P),1684775927,927741097,665557806,3278074830,41903445250.4,48057759177.0,16404084737.6,106365289165.0,10364801,2889995,3388515,16643311
2008-10-08,Nasdaq (Q),2201019290,1189589357,1699259717,5089868364,53761916732.7,67938771157.5,40121608628.4,161822296519.0,12889454,4025019,7594976,24509449
2008-10-08,CBOE (W),5036400,8777000,5308700,19122100,188979620.2,545557193.04,153781725.2,888318538.44,2962,6550,21129,30641
2008-10-08,PHLX (X),3178500,580000,180000,3938500,85644943.0,27171000.0,4354800.0,117170743.0,27,6,2,35
2008-10-09,AMEX (A),0,56581273,26700,56607973,0.0,2092586966.56,179606.0,2092766572.56,0,65955,93,66048
2008-10-09,NSX (C),129868234,69092776,79044642,278005652,2206691800.07,3117558401.77,1410475729.73,6734725931.56,474450,179615,364880,1018945
2008-10-09,NSX (DC),440569535,112136175,54535962,607241672,8011571385.22,4910867490.89,1061615682.91,13984054559.0,1679736,331146,264218,2275100
2008-10-09,NYSE (DN),662696998,387785698,300739902,1351222598,16851948008.1,18963527364.5,6958829722.17,42774305094.8,4536776,1512759,1786307,7835842
2008-10-09,Nasdaq (DQ),1346371476,320523806,682228250,2349123532,26011776374.0,14788204261.7,13130288724.7,53930269360.3,2574159,382559,1444183,4400901
2008-10-09,ADF (D),73885651,11049337,28395394,113330382,1862112339.41,468320108.648,611173186.457,2941605634.52,298046,26260,106302,430608
2008-10-09,ISE (I),169292670,1935200,10379191,181607061,4163577967.12,60475277.0,170339399.36,4394392643.48,989509,4607,30838,1024954
2008-10-09,CHX (M),27428342,18887979,10491553,56807874,758242735.745,1600901623.32,276950963.068,2636095322.13,81562,16050,15536,113148
2008-10-09,NYSE (N),2041343447,0,0,2041343447,50958011525.2,0.0,0.0,50958011525.2,6376039,0,0,6376039
2008-10-09,NYSE Arca (P),1467337854,753607699,492356090,2713301643,34283813715.4,35546786876.2,11456749049.2,81287349640.8,8979462,2236856,2617955,13834273
2008-10-09,Nasdaq (Q),1926357653,959937291,1358470889,4244765833,44296516626.8,53283489550.0,30508158069.4,128088164246.0,11279475,3110659,5901654,20291788
2008-10-09,CBOE (W),2447200,7515100,9097800,19060100,55638486.4,522223636.96,149751598.0,727613721.36,1680,4359,26145,32184
2008-10-09,PHLX (X),3156500,263800,453500,3873800,37654129.0,16861860.0,2478200.0,56994189.0,36,5,3,44
2008-10-10,AMEX (A),0,82973972,41300,83015272,0.0,2707557075.17,253486.0,2707810561.17,0,105764,145,105909
2008-10-10,NSX (C),150200102,106258418,101754231,358212751,2415253807.69,4395315412.67,1751513243.73,8562082464.09,533504,291735,500548,1325787
2008-10-10,NSX (DC),539756643,157340493,88013303,785110439,10066044639.2,6368318025.72,1739359979.72,18173722644.6,2384517,527989,489863,3402369
2008-10-10,NYSE (DN),824548039,459194450,329291503,1613033992,18942099674.9,19435329549.4,7037990253.74,45415419478.0,5649293,1759426,1953866,9362585
2008-10-10,Nasdaq (DQ),1638189589,462368892,852773575,2953332056,30396470111.5,21743162698.8,14768996652.8,66908629463.1,3045521,486293,1684126,5215940
2008-10-10,ADF (D),95066279,11519254,41751457,148336990,2083009733.42,475282970.196,847166794.642,3405459498.26,403385,32379,152154,587918
2008-10-10,ISE (I),264728818,2991400,17760965,285481183,6044154345.03,109592623.81,297595268.08,6451342236.92,1645852,9129,56914,1711895
2008-10-10,CHX (M),26116954,29364071,20052777,75533802,602683295.711,2175769074.87,447910481.62,3226362852.2,50764,27850,20474,99088
2008-10-10,NYSE (N),2950700666,0,2800,2950703466,69721638042.8,0.0,95890.0,69721733932.8,9303562,0,8,9303570
2008-10-10,NYSE Arca (P),2297582571,1177684791,798696934,4273964296,51053920848.4,54697360011.6,17573933750.4,123325214610.0,14535737,3705374,4315355,22556466
2008-10-10,Nasdaq (Q),2669392835,1518165666,2016060068,6203618569,55679380051.2,74156498330.0,42609160135.4,172445038517.0,15496346,4784731,8842368,29123445
2008-10-10,CBOE (W),3641300,18167000,6357000,28165300,65650363.0,1204131831.85,147855231.0,1417637425.85,4241,14149,35929,54319
2008-10-10,PHLX (X),1441900,571000,860100,2873000,29425466.0,18566600.0,17615875.0,65607941.0,26,7,5,38
2008-10-13,AMEX (A),0,59780427,41600,59822027,0.0,1845505081.65,263576.0,1845768657.65,0,71260,120,71380
2008-10-13,NSX (C),109863788,63811655,81814203,255489646,2057091271.79,2778804243.37,1531833189.09,6367728704.25,451555,172257,386279,1010091
2008-10-13,NSX (DC),344493223,68534547,905688,413933458,6191368916.16,2627982979.76,10202586.4555,8829554482.38,1210839,196747,2551,1410137
2008-10-13,NYSE (DN),523996348,271637363,256006307,1051640018,13845137942.0,13597764598.4,6128371456.81,33571273997.2,3552034,1083638,1418299,6053971
2008-10-13,Nasdaq (DQ),1293618928,374491697,658564895,2326675520,26918762653.3,16296760396.1,13563415215.6,56778938265.0,2417422,406977,1409470,4233869
2008-10-13,ADF (D),73804800,7316314,31152404,112273518,1773924787.96,338109951.435,658369713.803,2770404453.2,296294,21993,124411,442698
2008-10-13,ISE (I),154811954,3943570,10150212,168905736,3978576614.5,117940898.49,179760122.24,4276277635.23,915515,6612,31572,953699
2008-10-13,CHX (M),21779308,12358446,7874785,42012539,655836423.753,1050548303.15,195259598.927,1901644325.83,50100,13738,14469,78307
2008-10-13,NYSE (N),1819928995,0,0,1819928995,46969236412.7,0.0,0.0,46969236412.7,5505605,0,0,5505605
2008-10-13,NYSE Arca (P),1341488188,669131709,451170537,2461790434,32302956464.2,31369336350.5,11290323168.5,74962615983.2,8151943,1936791,2300105,12388839
2008-10-13,Nasdaq (Q),1579599818,746059543,1177904095,3503563456,36614711361.0,42441320395.9,27589576757.2,106645608514.0,8726503,2319324,4765202,15811029
2008-10-13,CBOE (W),1686000,4205600,3493300,9384900,44516196.0,303289973.0,82138149.0,429944318.0,2160,4512,20230,26902
2008-10-13,PHLX (X),1574600,196000,315000,2085600,45733030.0,12188320.0,7378500.0,65299850.0,30,3,2,35
2008-10-14,AMEX (A),0,55260580,38100,55298680,0.0,2089556047.28,156648.0,2089712695.28,0,72363,134,72497
2008-10-14,NSX (C),114432463,81624348,93450916,289507727,2340253259.63,3831692715.29,1796569312.78,7968515287.7,470218,234282,423847,1128347
2008-10-14,NSX (DC),259957387,64437299,902548,325297234,4753577980.53,2406762251.73,9089118.9855,7169429351.24,988474,189021,1875,1179370
2008-10-14,NYSE (DN),672038854,378950260,301569115,1352558229,18586303988.8,17904561962.8,7493203378.32,43984069329.9,4789881,1568752,1838287,8196920
2008-10-14,Nasdaq (DQ),1371435221,356033726,655055250,2382524197,29313633158.7,17593629806.9,13971525572.2,60878788537.8,2604711,454482,1297994,4357187
2008-10-14,ADF (D),82526411,7297612,30321958,120145981,2123596458.24,417785177.025,632080174.755,3173461810.02,348367,20200,120500,489067
2008-10-14,ISE (I),190716903,3240491,13615565,207572959,5067083049.57,121866046.65,242088939.584,5431038035.8,1151965,7412,41000,1200377
2008-10-14,CHX (M),23475848,18332315,9650684,51458847,3215202007.75,1528840665.81,307694319.59,5051736993.15,57930,14847,18646,91423
2008-10-14,NYSE (N),1878569451,0,0,1878569451,50453216678.2,0.0,0.0,50453216678.2,6465802,0,0,6465802
2008-10-14,NYSE Arca (P),1598336186,796258699,526036708,2920631593,41678509600.8,39276306217.5,13518817507.7,94473633326.1,10113142,2612811,2886315,15612268
2008-10-14,Nasdaq (Q),1969010709,1010016559,1345555791,4324583059,48277724277.2,54352210651.7,32676048799.8,135305983729.0,11459288,3313385,6152455,20925128
2008-10-14,CBOE (W),2159400,8157300,4540900,14857600,68402176.22,432639177.0,150702472.51,651743825.73,2304,5796,22655,30755
2008-10-14,PHLX (X),957100,88900,386500,1432500,33004795.0,3863070.0,16784180.0,53652045.0,24,4,4,32
2008-10-15,AMEX (A),0,45835967,29300,45865267,0.0,1613067021.17,186151.0,1613253172.17,0,55788,112,55900
2008-10-15,NSX (C),94085221,53848420,71939974,219873615,1981251013.46,2431852555.44,1213762808.78,5626866377.68,404101,160403,328753,893257
2008-10-15,NSX (DC),218027551,57239330,614339,275881220,4033719134.88,2431199822.56,9208709.1718,6474127666.61,842280,173453,1885,1017618
2008-10-15,NYSE (DN),532230083,329374677,271097418,1132702178,13755827432.4,15815773405.5,6523154235.44,36094755073.3,3738348,1408812,1571582,6718742
2008-10-15,Nasdaq (DQ),1091631332,272332025,581917139,1945880496,23421313288.8,12524215522.5,11429751960.7,47375280771.9,2250909,365192,1265866,3881967
2008-10-15,ADF (D),54556462,6821412,26719609,88097483,1398869614.11,366830924.435,544891741.852,2310592280.4,246723,20100,109897,376720
2008-10-15,ISE (I),140005918,2258892,10538844,152803654,3582541963.94,69706152.68,182909915.0,3835158031.62,857233,6369,34336,897938
2008-10-15,CHX (M),24810318,15044274,10283090,50137682,649490369.573,1254923849.73,332413137.147,2236827356.45,61151,13070,13220,87441
2008-10-15,NYSE (N),1683255429,0,0,1683255429,43336242939.1,0.0,0.0,43336242939.1,5529196,0,0,5529196
2008-10-15,NYSE Arca (P),1239768184,656047053,466084594,2361899831,30648807619.8,31964575973.0,11211666542.2,73825050135.0,7937873,2016187,2400683,12354743
2008-10-15,Nasdaq (Q),1461782881,763256080,1173435000,3398473961,34229912615.6,42810493795.8,26589864156.5,103630270568.0,8671161,2596183,4898722,16166066
2008-10-15,CBOE (W),3038000,11522100,4687700,19247800,102571716.1,963529588.5,124708122.0,1190809426.6,1617,6171,18798,26586
2008-10-15,PHLX (X),777600,109500,0,887100,18042421.0,3960000.0,0.0,22002421.0,11,2,0,13
2008-10-16,AMEX (A),0,45749352,27000,45776352,0.0,1739290621.11,179671.0,1739470292.11,0,71661,84,71745
2008-10-16,NSX (C),103576719,86545513,78392388,268514620,2013132917.62,3910888811.02,1406084508.15,7330106236.78,451694,266257,378847,1096798
2008-10-16,NSX (DC),170051238,48342619,811474,219205331,3087468379.82,1579340441.25,7837030.0209,4674645851.09,682857,155486,2159,840502
2008-10-16,NYSE (DN),729933230,446162047,347105451,1523200728,17932662260.2,20919501791.5,7720072862.08,46572236913.9,5295727,1928808,2086607,9311142
2008-10-16,Nasdaq (DQ),1250148353,406334126,704183647,2360666126,25295785724.0,19143602639.0,13714589537.1,58153977900.1,2787396,566022,1515522,4868940
2008-10-16,ADF (D),82478970,8814185,33246737,124539892,1883773233.1,380034555.672,678914298.472,2942722087.25,366697,24190,139512,530399
2008-10-16,ISE (I),193509407,2492216,14954472,210956095,4748288641.78,83606461.08,256544713.76,5088439816.62,1218409,7036,45645,1271090
2008-10-16,CHX (M),27061679,21006737,16533597,64602013,635712893.688,1644019864.27,459662135.945,2739394893.9,70722,16507,16517,103746
2008-10-16,NYSE (N),1999558862,0,0,1999558862,49520490198.3,0.0,0.0,49520490198.3,7153936,0,0,7153936
2008-10-16,NYSE Arca (P),1553154636,909533584,621479089,3084167309,36003901893.8,44077569472.6,15017204601.8,95098675968.2,10283848,3027253,3289183,16600284
2008-10-16,Nasdaq (Q),1874957128,1145944974,1595307940,4616210042,42146113410.3,62209335876.8,35985319218.8,140340768506.0,11530535,4009949,6960909,22501393
2008-10-16,CBOE (W),4176100,10670700,9802800,24649600,46458350.67,813714638.4,265311151.9,1125484140.97,2864,8743,32113,43720
2008-10-16,PHLX (X),95000,419000,100,514100,1639100.0,12099940.0,2719.0,13741759.0,5,6,1,12
2008-10-17,AMEX (A),0,39270963,63300,39334263,0.0,1275927389.96,565510.0,1276492899.96,0,55596,197,55793
2008-10-17,NSX (C),97221935,55059420,75592969,227874324,1797306524.7,2336117799.5,1427211356.63,5560635680.84,399812,165970,373275,939057
2008-10-17,NSX (DC),875110,1374129,2974582,5223821,22148735.035,94210452.2,31309026.6011,147668213.836,4681,4050,5458,14189
2008-10-17,NYSE (DN),594924942,350788927,285609358,1231323227,15530387212.1,16602142532.0,7131338874.49,39263868618.6,4291973,1614030,1737118,7643121
2008-10-17,Nasdaq (DQ),1304127814,394156412,610231313,2308515539,25752484540.0,17602219620.6,12890224763.2,56244928923.8,3126037,590656,1385825,5102518
2008-10-17,ADF (D),56167112,4875193,27970472,89012777,1324295413.59,219782738.62,544118590.54,2088196742.75,243638,14613,110831,369082
2008-10-17,ISE (I),146364129,3184958,10831302,160380389,3632186392.79,160169922.43,202840808.94,3995197124.16,880612,9084,35711,925407
2008-10-17,CHX (M),24763853,14135048,11916079,50814980,629005875.16,1226443109.96,370371350.342,2225820335.46,44061,11910,16026,71997
2008-10-17,NYSE (N),1740184790,0,0,1740184790,43538422645.0,0.0,0.0,43538422645.0,5402883,0,0,5402883
2008-10-17,NYSE Arca (P),1138022369,628772966,446973696,2213769031,26906638461.2,30604186491.1,11628468509.3,69139293461.6,7182181,2093873,2353991,11630045
2008-10-17,Nasdaq (Q),1472372743,794699689,1303795745,3570868177,34136060472.7,43915550823.2,30267519540.2,108319130836.0,8876074,2734452,5188923,16799449
2008-10-17,CBOE (W),2412200,14843100,6705200,23960500,54518461.0,982137605.2,186176212.0,1222832278.2,2286,13374,27643,43303
2008-10-17,PHLX (X),256600,150000,750000,1156600,3086019.0,5508000.0,31170000.0,39764019.0,9,2,1,12
2008-10-20,AMEX (A),0,39985650,15600,40001250,0.0,1552417244.64,82476.0,1552499720.64,0,46377,52,46429
2008-10-20,NSX (C),62250712,33500314,51615839,147366865,1184008337.09,1403345028.42,938532949.88,3525886315.39,257677,108202,271119,636998
2008-10-20,NSX (DC),409902,62818,897449,1370169,11665888.535,1501138.8451,5345048.6745,18512076.0546,1329,162,2067,3558
2008-10-20,NYSE (DN),436493759,254383585,221464271,912341615,11632315976.9,12301875219.5,5480925725.09,29415116921.5,3096770,1209460,1334605,5640835
2008-10-20,Nasdaq (DQ),1095619692,282785095,508078215,1886483002,21920820764.6,12251192979.5,10672803671.2,44844817415.3,2665873,466707,1118402,4250982
2008-10-20,ADF (D),53725740,3453164,23058236,80237140,1364506562.51,148527730.225,477870383.453,1990904676.19,241561,11429,99732,352722
2008-10-20,ISE (I),116772283,7346838,11495757,135614878,2888765295.23,258110980.469,193828244.96,3340704520.66,659270,18687,40705,718662
2008-10-20,CHX (M),24209210,9444356,10988738,44642304,772269028.953,814953515.25,364499427.85,1951721972.05,58552,8520,13895,80967
2008-10-20,NYSE (N),1227554135,0,0,1227554135,31314671420.2,0.0,0.0,31314671420.2,4200704,0,0,4200704
2008-10-20,NYSE Arca (P),974206839,452574603,369267637,1796049079,23872015088.3,21631380194.9,9155013519.48,54658408802.7,6113603,1502060,1966992,9582655
2008-10-20,Nasdaq (Q),1182761565,559722695,873226596,2615710856,28116116047.0,31503297689.9,20708548891.3,80327962628.3,7016012,1963740,3979267,12959019
2008-10-20,CBOE (W),2358200,8771800,4488700,15618700,80702132.0,632027947.0,122275527.9,835005606.9,2274,6144,19026,27444
2008-10-20,PHLX (X),387300,333000,0,720300,3655904.0,13188450.0,0.0,16844354.0,5,3,0,8
2008-10-21,AMEX (A),0,26233725,27100,26260825,0.0,851543606.51,122424.0,851666030.51,0,41127,78,41205
2008-10-21,NSX (C),53678171,22320189,41219824,117218184,1007370016.07,899373705.166,680045560.548,2586789281.78,211554,66621,199241,477416
2008-10-21,NSX (DC),377983,61670,689043,1128696,7792370.6158,2630199.278,3646362.7636,14068932.6574,1170,125,1540,2835
2008-10-21,NYSE (DN),483702269,246950956,232488108,963141333,12921541638.0,12386801809.5,5580708315.71,30889051763.1,3384439,1148824,1366446,5899709
2008-10-21,Nasdaq (DQ),1141873447,294592181,549512646,1985978274,22445204033.1,13284095197.5,11608773475.4,47338072706.0,2611224,481657,1163083,4255964
2008-10-21,ADF (D),44879130,4281006,22211734,71371870,1065090558.42,163008506.34,438065356.682,1666164421.44,193254,13618,92265,299137
2008-10-21,ISE (I),119482266,18172278,24568003,162222547,2982452650.35,880646818.88,533174268.303,4396273737.53,661500,66706,113691,841897
2008-10-21,CHX (M),22578887,13461557,13292220,49332664,628223353.462,1092827339.48,398316687.49,2119367380.43,45782,9862,11101,66745
2008-10-21,NYSE (N),1161697880,0,0,1161697880,29309285983.0,0.0,0.0,29309285983.0,4225783,0,0,4225783
2008-10-21,NYSE Arca (P),956703712,457694800,394096341,1808494853,23099887923.9,22159701609.3,10151716962.9,55411306496.1,6009208,1513093,2035454,9557755
2008-10-21,Nasdaq (Q),1131229052,579640807,919692427,2630562286,26822952484.9,33578096729.1,22230004056.6,82631053270.6,6680847,2058481,4089925,12829253
2008-10-21,CBOE (W),6633000,9165300,3554300,19352600,203917546.0,718718353.88,81047977.2,1003683877.08,1619,6032,18096,25747
2008-10-21,PHLX (X),526800,378100,0,904900,5977225.0,11584162.0,0.0,17561387.0,13,6,0,19
2008-10-22,AMEX (A),0,43059327,20600,43079927,0.0,1792466822.08,125142.0,1792591964.08,0,47341,62,47403
2008-10-22,NSX (C),32812665,18774622,40402605,91989892,611798704.901,906480418.344,703108563.649,2221387686.89,149078,55122,192715,396915
2008-10-22,NSX (DC),491640,97553,493059,1082252,9496706.6453,4549137.6879,6177652.2767,20223496.6099,1546,174,2088,3808
2008-10-22,NYSE (DN),561608554,320912172,280347375,1162868101,13873750421.7,15468234388.9,6600966250.12,35942951060.8,3870210,1406243,1605316,6881769
2008-10-22,Nasdaq (DQ),1177919522,351679602,604419126,2134018250,23011645373.0,17228507593.5,11479826839.4,51719979806.0,2822290,516629,1238427,4577346
2008-10-22,ADF (D),55801635,4791872,26976741,87570248,1317387466.14,250406988.7,542264161.561,2110058616.4,241776,16348,105170,363294
2008-10-22,ISE (I),152351364,20187931,26367612,198906907,3557361495.88,896529248.23,513382275.42,4967273019.53,836357,74428,111339,1022124
2008-10-22,CHX (M),22365273,12707825,8563661,43636759,619309098.675,1061648193.66,203988959.738,1884946252.07,60847,10109,11689,82645
2008-10-22,NYSE (N),1556933836,0,0,1556933836,38113257267.3,0.0,0.0,38113257267.3,4963538,0,0,4963538
2008-10-22,NYSE Arca (P),1135283229,626111752,477204928,2238599909,26161045029.7,28754941203.6,11692936180.1,66608922413.5,7114231,1929149,2448970,11492350
2008-10-22,Nasdaq (Q),1446885199,808903836,1163134865,3418923900,32077614798.7,42686786731.8,27021558618.6,101785960149.0,8324081,2631001,4808343,15763425
2008-10-22,CBOE (W),5751800,15745900,4414900,25912600,304075775.0,1340465574.2,118650055.0,1763191404.2,1493,10560,19445,31498
2008-10-22,PHLX (X),1255500,2413400,1300,3670200,13842036.0,56272360.0,22156.0,70136552.0,52,10,5,67
2008-10-23,AMEX (A),0,40564369,15500,40579869,0.0,1638234941.12,89586.0,1638324527.12,0,58535,60,58595
2008-10-23,NSX (C),44465257,57791120,77233689,179490066,807677797.457,2722245777.64,1347902963.1,4877826538.2,222052,181544,362719,766315
2008-10-23,NSX (DC),1096136,47474,2389243,3532853,19366111.7438,1633062.785,9595186.148,30594360.6768,2741,125,3530,6396
2008-10-23,NYSE (DN),689710803,414774106,324202236,1428687145,16909141309.0,21054532425.0,7115143878.58,45078817612.6,4920384,1866464,1927191,8714039
2008-10-23,Nasdaq (DQ),1421378772,403484413,767881109,2592744294,26733649587.0,19530318798.6,12798612498.9,59062580884.5,3443421,649471,1566517,5659409
2008-10-23,ADF (D),68208683,6172172,32309720,106690575,1521402174.74,262734875.355,579139035.996,2363276086.09,300221,19381,132074,451676
2008-10-23,ISE (I),203724672,9839031,24949952,238513655,4382818939.96,310154401.75,331909604.22,5024882945.93,1110160,22599,73348,1206107
2008-10-23,CHX (M),35262229,10127733,11355571,56745533,826181628.613,787214422.86,267449143.697,1880845195.17,74197,8187,15827,98211
2008-10-23,NYSE (N),1689826483,0,0,1689826483,40395435393.8,0.0,0.0,40395435393.8,6192480,0,0,6192480
2008-10-23,NYSE Arca (P),1343579634,766619534,563291141,2673490309,29962902311.0,37088888193.9,12645836290.1,79697626795.1,8623801,2557794,2881608,14063203
2008-10-23,Nasdaq (Q),1682440030,982694866,1393937364,4059072260,36558384717.4,53914079057.5,28896468382.8,119368932158.0,9993341,3281654,6005122,19280117
2008-10-23,CBOE (W),4783100,15981800,4590000,25354900,213745290.0,1112443490.86,107398045.0,1433586825.86,2542,15635,26505,44682
2008-10-23,PHLX (X),355000,810000,0,1165000,4828150.0,17394600.0,0.0,22222750.0,10,5,0,15
2008-10-24,AMEX (A),0,40695674,24200,40719874,0.0,1674262325.19,108539.0,1674370864.19,0,49630,63,49693
2008-10-24,NSX (C),42846158,59505271,66751988,169103417,775011485.909,2616672429.67,1309669611.66,4701353527.24,191477,194352,361583,747412
2008-10-24,NSX (DC),595173,84196,2957385,3636754,10403536.6717,4069442.4228,6568131.3796,21041110.4741,1699,207,2240,4146
2008-10-24,NYSE (DN),587339903,364368240,265680153,1217388296,13641371673.3,18090986328.2,5763412503.11,37495770504.6,4250020,1698878,1601125,7550023
2008-10-24,Nasdaq (DQ),1323360046,337880070,591200817,2252440933,21231729291.7,14617826002.0,10401171756.5,46250727050.1,2903511,614409,1323276,4841196
2008-10-24,ADF (D),57461973,4774330,26676531,88912834,1223012731.49,288119727.125,454020452.795,1965152911.41,244648,14369,108402,367419
2008-10-24,ISE (I),213729163,10815646,34691374,259236183,4029101407.46,436840336.8,525721830.684,4991663574.94,1088019,33657,127222,1248898
2008-10-24,CHX (M),22447874,13193375,4963314,40604563,665827884.776,1079491686.01,118920986.547,1864240557.33,46929,10280,14655,71864
2008-10-24,NYSE (N),1582639841,0,0,1582639841,35525213175.1,0.0,0.0,35525213175.1,5355490,0,0,5355490
2008-10-24,NYSE Arca (P),1232980231,719094109,476058796,2428133136,24874542468.3,33891279401.0,10381234088.3,69147055957.7,7521884,2411531,2485876,12419291
2008-10-24,Nasdaq (Q),1479261033,859668638,1223455168,3562384839,29763568392.8,44508621358.8,25354735479.1,99626925230.8,8690633,3059226,5266960,17016819
2008-10-24,CBOE (W),7512700,9002100,3418100,19932900,339987693.0,704330050.0,69225329.0,1113543072.0,2196,5715,21746,29657
2008-10-24,PHLX (X),314100,29200,500,343800,7340225.0,473146.0,11951.0,7825322.0,4,2,4,10
2008-10-24,BATS (Z),286186,0,143685,429871,5992523.41,0.0,419483.71,6412007.12,2493,0,854,3347
2008-10-27,AMEX (A),0,37732766,5300,37738066,0.0,1337888519.34,19084.0,1337907603.34,0,45641,27,45668
2008-10-27,NSX (C),35484664,34769626,45364301,115618591,640971902.845,1469137371.64,784212859.985,2894322134.47,150429,112102,248732,511263
2008-10-27,NSX (DC),518363,37484,942525,1498372,10113870.2321,763229.7531,5617961.8851,16495061.8703,1296,85,2110,3491
2008-10-27,NYSE (DN),501131595,272473950,237730950,1011336495,11595769692.4,13068946498.9,5080741155.63,29745457346.9,3533356,1248115,1383411,6164882
2008-10-27,Nasdaq (DQ),1154903113,288901543,545928823,1989733479,19679871218.8,12152580697.4,8878659157.74,40711111073.9,2631731,479577,1174701,4286009
2008-10-27,ADF (D),53918621,3406336,24617318,81942275,1136412872.59,173416619.005,412039899.793,1721869391.39,230640,12152,96877,339669
2008-10-27,ISE (I),162045602,11571344,34853488,208470434,2929670992.48,420258182.579,473933135.294,3823862310.35,763273,30051,113822,907146
2008-10-27,CHX (M),21103334,16451092,7512136,45066562,509435219.67,1285015374.89,184963586.54,1979414181.1,37449,11635,11323,60407
2008-10-27,NYSE (N),1339073608,0,0,1339073608,29958082720.2,0.0,0.0,29958082720.2,4580002,0,0,4580002
2008-10-27,NYSE Arca (P),1053292515,567335619,400246306,2020874440,22247334642.8,24313823544.5,8451789775.15,55012947962.4,6542900,1849287,2106654,10498841
2008-10-27,Nasdaq (Q),1234922914,667275317,974707346,2876905577,25611169894.1,33700696726.9,19553461302.4,78865327923.4,7236635,2341384,4231517,13809536
2008-10-27,CBOE (W),2392900,12776500,7501100,22670500,111575037.0,911531563.33,89272286.0,1112378886.33,1212,11085,17975,30272
2008-10-27,BATS (Z),322779,0,251308,574087,6904747.275,0.0,751268.31,7656015.585,2674,0,1432,4106
2008-10-28,AMEX (A),0,40949868,8100,40957968,0.0,1477341014.35,49837.0,1477390851.35,0,52661,35,52696
2008-10-28,NSX (C),43744021,45373733,53122505,142240259,814837381.648,1951326648.46,991325263.582,3757489293.69,173072,139994,299738,612804
2008-10-28,NSX (DC),672459,106949,927647,1707055,11516194.6508,5291620.1452,7780532.9489,24588347.7449,1825,135,2295,4255
2008-10-28,NYSE (DN),586565904,335977237,279341421,1201884562,13778932471.6,15741492652.4,6221292459.44,35741717583.4,4140981,1483314,1590150,7214445
2008-10-28,Nasdaq (DQ),1538637671,452779656,691908849,2683326176,27394716043.5,21079190373.7,11993311693.2,60467218110.4,3314544,597129,1370109,5281782
2008-10-28,ADF (D),68778496,4341754,30331380,103451630,1546609313.68,218598046.47,648478977.853,2413686338.01,302705,13010,126430,442145
2008-10-28,ISE (I),213491152,16851033,42300736,272642921,4256758378.04,575250969.189,624701319.123,5456710666.36,1060814,39176,152088,1252078
2008-10-28,CHX (M),25226883,47202589,9105366,81534838,590435024.836,3824713889.5,205882767.62,4621031681.96,61451,10938,15371,87760
2008-10-28,NYSE (N),1733497326,0,0,1733497326,40459342669.7,0.0,0.0,40459342669.7,5511810,0,0,5511810
2008-10-28,NYSE Arca (P),1286619843,741917669,471035307,2499572819,27323343818.4,31564058530.3,10345360525.0,69232762873.7,7908620,2213323,2474068,12596011
2008-10-28,Nasdaq (Q),1611468099,940038167,1271573417,3823079683,33414571565.0,48608873814.0,26747747319.3,108771192698.0,9183980,3225424,5297093,17706497
2008-10-28,CBOE (W),8830500,15334900,4344500,28509900,456214257.0,1048326157.0,95124080.0,1599664494.0,1904,11819,21036,34759
2008-10-28,BATS (Z),2604397,0,3610420,6214817,25953932.0,0.0,40720232.435,66674164.435,14611,0,19459,34070
2008-10-29,AMEX (A),0,36091916,23700,36115616,0.0,1136351274.06,68990.0,1136420264.06,0,53457,60,53517
2008-10-29,NSX (C),42060396,47751901,54623392,144435689,819324406.423,2168214381.56,1132491757.49,4120030545.48,176006,159538,294816,630360
2008-10-29,NSX (DC),723095,129237,712701,1565033,15299859.6049,3064399.429,9792845.6459,28157104.6798,2199,181,2382,4762
2008-10-29,NYSE (DN),580568339,329467913,265316325,1175352577,14256770369.5,15993275403.2,6248175099.52,36498220872.1,4031844,1451416,1537122,7020382
2008-10-29,Nasdaq (DQ),1532511319,391048136,652432395,2575991850,27904839217.0,16290861117.6,12880427921.0,57076128255.6,3415120,613577,1334795,5363492
2008-10-29,ADF (D),66351480,4668063,27216280,98235823,1520919350.89,219721424.135,513022741.44,2253663516.46,278401,13521,110501,402423
2008-10-29,ISE (I),226938348,14163755,45095872,286197975,4613323661.77,546448754.73,788551643.722,5948324060.22,1062474,35248,157124,1254846
2008-10-29,CHX (M),23261856,16461793,8933980,48657629,562446964.429,1385873140.36,255358386.11,2203678490.9,56544,11718,14046,82308
2008-10-29,NYSE (N),1620310466,0,0,1620310466,39852997950.7,0.0,0.0,39852997950.7,5629750,0,0,5629750
2008-10-29,NYSE Arca (P),1315366266,706207037,488202019,2509775322,29113480809.6,33007665159.2,12089446865.6,74210592834.4,7938042,2299721,2531274,12769037
2008-10-29,Nasdaq (Q),1691146022,892630956,1243747352,3827524330,37704748358.8,47103025132.7,28531777878.1,113339551370.0,9742338,3123250,5397442,18263030
2008-10-29,CBOE (W),7050100,8876400,3044900,18971400,388006479.0,642297073.0,81766743.0,1112070295.0,2370,8959,17401,28730
2008-10-29,BATS (Z),2586427,0,2898577,5485004,26853291.305,0.0,34219404.275,61072695.58,14029,0,16066,30095
2008-10-30,AMEX (A),0,41105832,18200,41124032,0.0,1792470533.66,73953.0,1792544486.66,0,43294,60,43354
2008-10-30,NSX (C),40790712,43152311,45462307,129405330,885156810.56,1886325346.42,853591950.143,3625074107.13,189976,143230,248629,581835
2008-10-30,NSX (DC),653360,86222,491571,1231153,11039772.8985,1468124.6317,6858285.8188,19366183.349,2169,193,1988,4350
2008-10-30,NYSE (DN),444912364,281289392,216158174,942359930,11200080089.8,13712967213.2,4422588908.45,29335636211.4,3121570,1290714,1210907,5623191
2008-10-30,Nasdaq (DQ),1368944967,324031451,654398812,2347375230,25432407051.8,13534403464.6,11907050044.3,50873860560.7,3045389,531582,1323493,4900464
2008-10-30,ADF (D),70580789,4575868,27151684,102308341,1607582666.64,158040299.895,551859216.228,2317482182.76,318063,12132,119729,449924
2008-10-30,ISE (I),184092233,14533619,41884353,240510205,3910952649.41,538431186.14,671965103.052,5121348938.6,886226,39725,134354,1060305
2008-10-30,CHX (M),24723338,14911234,6758621,46393193,850816371.726,1299343867.46,171915059.895,2322075299.08,49463,12342,10489,72294
2008-10-30,NYSE (N),1375885083,0,0,1375885083,33663051829.5,0.0,0.0,33663051829.5,4834806,0,0,4834806
2008-10-30,NYSE Arca (P),1118050512,584729284,434781191,2137560987,25571798883.0,26695728165.2,10175913700.0,62443440748.1,6870717,1925496,2270354,11066567
2008-10-30,Nasdaq (Q),1487631609,735042371,1098702084,3321376064,33698119214.1,38212123777.4,25101954007.6,97012196999.1,8739456,2633696,4876528,16249680
2008-10-30,CBOE (W),12278500,10482800,3344600,26105900,613546702.0,677081081.0,78658718.0,1369286501.0,2174,11077,16222,29473
2008-10-30,BATS (Z),48785622,85771,28719766,77591159,1039466054.13,1712452.14,1412276291.75,2453454798.01,349653,273,223635,573561
2008-10-31,AMEX (A),0,33526554,17200,33543754,0.0,975025717.59,98658.0,975124375.59,0,43405,70,43475
2008-10-31,NSX (C),42526735,38894566,46410497,127831798,897128566.389,1739228207.56,861619559.922,3497976333.87,181092,127882,261332,570306
2008-10-31,NSX (DC),845159,90107,780723,1715989,14861174.2816,4295471.8745,6651007.4364,25807653.5925,2722,202,2239,5163
2008-10-31,NYSE (DN),445453130,261249565,205584838,912287533,11145974807.3,13168376469.9,4218897269.13,28533248546.3,3103132,1200717,1177695,5481544
2008-10-31,Nasdaq (DQ),1420174286,333481230,659745995,2413401511,25791298635.7,15275043013.1,12290021423.1,53356363071.9,2972006,500608,1277889,4750503
2008-10-31,ADF (D),54818414,4949570,29725556,89493540,1211179646.96,239141716.78,539441244.761,1989762608.5,242128,14505,119360,375993
2008-10-31,ISE (I),193403505,14051029,41441615,248896149,3864350395.76,526344921.099,659279647.781,5049974964.64,907040,34941,150917,1092898
2008-10-31,CHX (M),27818953,12108865,5263040,45190858,675186073.717,1020790300.47,151394826.995,1847371201.19,52513,9746,11733,73992
2008-10-31,NYSE (N),1573311108,0,0,1573311108,38364331017.5,0.0,0.0,38364331017.5,4658002,0,0,4658002
2008-10-31,NYSE Arca (P),1112094758,563779079,401586080,2077459917,24738395190.9,25991892743.7,9575763704.93,60306051639.5,6785583,1793151,2155724,10734458
2008-10-31,Nasdaq (Q),1461238921,725173284,1097697696,3284109901,33023100833.8,39804776021.4,24397177993.6,97225054848.8,8581781,2607766,4601400,15790947
2008-10-31,CBOE (W),18698500,12502300,4391100,35591900,1055986188.8,739823562.0,106681533.0,1902491283.8,1812,11246,17345,30403
2008-10-31,BATS (Z),46365335,165038,29477982,76008355,974051562.95,3377188.05,1342164169.82,2319592920.82,336263,335,226818,563416
2008-11-03,AMEX (A),0,21659073,17600,21676673,0.0,581830218.35,108961.0,581939179.35,0,30961,75,31036
2008-11-03,NSX (C),34057589,23042407,43491635,100591631,733904364.391,958936086.281,801304530.103,2494144980.78,149880,79217,241058,470155
2008-11-03,NSX (DC),445170,76205,516389,1037764,7779259.9682,1735585.4192,4267931.3792,13782776.7666,2068,194,1781,4043
2008-11-03,NYSE (DN),274159005,158061879,139560906,571781790,7077190866.81,7693245521.55,2908236222.0,17678672610.4,1919411,748246,779119,3446776
2008-11-03,Nasdaq (DQ),1127818743,257100793,536471962,1921391498,20326648345.0,10537893388.2,9833720642.21,40698262375.3,2494765,390274,1141544,4026583
2008-11-03,ADF (D),49309840,2006987,21143291,72460118,1167190561.52,75624335.865,396328130.688,1639143028.08,230603,8033,94599,333235
2008-11-03,ISE (I),127237134,8935661,26649094,162821889,2632779626.31,291977000.21,387602399.274,3312359025.79,613213,24982,88601,726796
2008-11-03,CHX (M),36852729,7193132,6062015,50107876,1431703923.61,619889734.705,226530548.06,2278124206.38,41769,7369,9269,58407
2008-11-03,NYSE (N),1017846324,0,0,1017846324,24784900346.8,0.0,0.0,24784900346.8,3562985,0,0,3562985
2008-11-03,NYSE Arca (P),791482757,320428932,305821588,1417733277,18059799655.2,14164068713.4,7256478841.48,39480347210.2,4800889,1104363,1640813,7546065
2008-11-03,Nasdaq (Q),988808005,402708453,737800647,2129317105,22630960321.5,21075888129.2,16391488436.7,60098336887.4,5683174,1537959,3306837,10527970
2008-11-03,CBOE (W),15916500,8254100,3680000,27850600,882306775.19,517021933.6,109792704.0,1509121412.79,1009,6743,11496,19248
2008-11-03,BATS (Z),34903161,135508,20717134,55755803,669335294.7,3230200.6524,969107455.277,1641672950.63,222431,407,158375,381213
2008-11-04,AMEX (A),0,33213543,26500,33240043,0.0,1152565652.3,113367.0,1152679019.3,0,42935,97,43032
2008-11-04,NSX (C),36149644,35872293,48305347,120327284,856068499.493,1556956504.36,927977324.295,3341002328.15,158050,116017,257576,531643
2008-11-04,NSX (DC),543863,139955,757511,1441329,9873458.4859,3737783.1376,8979444.208,22590685.8315,2220,387,2144,4751
2008-11-04,NYSE (DN),293057305,241036747,159145134,693239186,7910119770.88,11977456912.0,3417636024.06,23305212706.9,1991056,1045332,848232,3884620
2008-11-04,Nasdaq (DQ),1374263516,359943217,685212443,2419419176,27464935618.1,15005040218.4,12611076953.6,55081052790.1,3041814,536747,1387250,4965811
2008-11-04,ADF (D),62354775,3015434,33702118,99072327,1552717849.92,142987610.855,525563827.611,2221269288.38,286724,9238,109017,404979
2008-11-04,ISE (I),145183311,13414555,35418233,194016099,3198881249.1,423871768.035,562779665.922,4185532683.06,673782,34505,120257,828544
2008-11-04,CHX (M),31823711,10546928,5428191,47798830,1169140794.06,948928488.55,154536385.43,2272605668.04,64559,8955,12140,85654
2008-11-04,NYSE (N),1309383268,0,0,1309383268,33928792928.1,0.0,0.0,33928792928.1,4459358,0,0,4459358
2008-11-04,NYSE Arca (P),930942403,492276369,386897291,1810116063,22767185686.1,22828717665.5,9355349681.39,54951253033.0,5592745,1588916,1993294,9174955
2008-11-04,Nasdaq (Q),1222994849,599579994,939838435,2762413278,30017549022.9,33208353994.9,21659741242.3,84885644260.1,6977596,2157355,4024792,13159743
2008-11-04,CBOE (W),18076200,10491000,3289000,31856200,977642171.0,779587677.2,92320607.12,1849550455.32,8823,10149,15928,34900
2008-11-04,BATS (Z),117902392,586761,63034160,181523313,2940707895.81,9367144.4862,1995747585.95,4945822626.25,795193,2108,418763,1216064
2008-11-05,AMEX (A),0,25711703,47500,25759203,0.0,672651945.54,368290.0,673020235.54,0,37254,160,37414
2008-11-05,NSX (C),32523093,34459205,42191748,109174046,733122487.56,1561795391.6,863798080.916,3158715960.08,145235,112164,228068,485467
2008-11-05,NSX (DC),479988,130529,607173,1217690,9171647.6825,4964441.5951,7887849.5005,22023938.7781,1720,236,1801,3757
2008-11-05,NYSE (DN),297151008,268237576,158046728,723435312,7720385125.94,13587747569.1,3490866273.6,24798998968.7,2048342,1176164,857724,4082230
2008-11-05,Nasdaq (DQ),1289331675,310253114,600539744,2200124533,24847633776.5,13796771887.2,11417047049.2,50061452712.9,2884802,500179,1297751,4682732
2008-11-05,ADF (D),47665512,5886212,28955488,82507212,1123869665.93,363109622.835,462771824.082,1949751112.85,214475,15068,101828,331371
2008-11-05,ISE (I),141888067,12741740,30930222,185560029,3012133860.69,452052089.09,479041466.296,3943227416.07,671423,31375,103527,806325
2008-11-05,CHX (M),34859479,10402226,9559147,54820852,1163788824.44,882935162.68,225633249.98,2272357237.1,58309,9613,10412,78334
2008-11-05,NYSE (N),1309477914,0,0,1309477914,33571261638.3,0.0,0.0,33571261638.3,4448350,0,0,4448350
2008-11-05,NYSE Arca (P),934085784,558495221,369460010,1862041015,21962073177.7,25838338973.1,8868534967.72,56668947118.4,5735806,1781970,1950855,9468631
2008-11-05,Nasdaq (Q),1194402021,662069152,910671088,2767142261,27966764824.5,36661385804.5,20785088773.7,85413239402.7,6922408,2384697,3991580,13298685
2008-11-05,CBOE (W),32844200,11446500,3109900,47400600,2082788834.0,648338751.0,84897106.94,2816024691.94,3395,10331,15018,28744
2008-11-05,BATS (Z),113868233,422217,55620404,169910854,2906400880.43,12035708.9778,1779476721.76,4697913311.17,811363,1740,385747,1198850
2008-11-06,AMEX (A),0,26911381,33000,26944381,0.0,889389902.95,244410.0,889634312.95,0,41319,115,41434
2008-11-06,NSX (C),32719311,13033328,11722984,57475623,627103207.54,397376084.609,268220524.841,1292699816.99,130503,27726,53249,211478
2008-11-06,NSX (DC),546102,123983,459660,1129745,11662429.6475,5376175.9625,5133795.5296,22172401.1396,2014,212,1892,4118
2008-11-06,NYSE (DN),18846007,2291436,13041955,34179398,357149055.499,92585949.3697,206101023.433,655836028.302,48662,4431,31517,84610
2008-11-06,Nasdaq (DQ),1422715480,359112755,628208986,2410037221,26287808630.9,15487329002.6,11358997203.8,53134134837.3,3247045,604850,1354437,5206332
2008-11-06,ADF (D),58880400,4989031,26526439,90395870,1338515436.09,269777755.795,497481407.372,2105774599.25,274364,15675,112018,402057
2008-11-06,ISE (I),84478534,15491030,32477254,132446818,1434333986.95,548250753.412,484111992.717,2466696733.08,301364,38876,113810,454050
2008-11-06,CHX (M),34125377,12278268,5533102,51936747,1150079139.85,886545981.02,166321610.901,2202946731.77,67890,11933,13705,93528
2008-11-06,NYSE (N),1527066979,0,0,1527066979,36843022938.8,0.0,0.0,36843022938.8,5265272,0,0,5265272
2008-11-06,NYSE Arca (P),1073440843,650192595,419386170,2143019608,23892804504.3,29987095009.4,9467506543.41,63347406057.1,6526343,2149681,2190527,10866551
2008-11-06,Nasdaq (Q),1369244822,831006191,1046293752,3246544765,30920758451.0,44766942107.6,22810212518.6,98497913077.3,8057229,2947975,4451643,15456847
2008-11-06,CBOE (W),11431700,12322900,3012300,26766900,600057037.2,745380599.7,85670112.5,1431107749.4,2127,11960,14711,28798
2008-11-06,BATS (Z),497293913,337764481,253002284,1088060678,12000367531.4,16637396210.5,5620755696.33,34258519438.3,3546531,1530445,1518181,6595157
2008-11-07,AMEX (A),0,17175434,17300,17192734,0.0,599282677.06,112329.0,599395006.06,0,30231,69,30300
2008-11-07,NSX (C),31358225,10422299,11423644,53204168,617847228.678,293303812.764,253561148.833,1164712190.27,122084,22095,54017,198196
2008-11-07,NSX (DC),563331,174976,541762,1280069,9608248.4658,10641302.9797,4714925.6364,24964477.0819,1950,272,2018,4240
2008-11-07,NYSE (DN),16748573,2101778,10731563,29581914,287978700.84,96067876.7232,155868320.703,539914898.266,38755,4022,23241,66018
2008-11-07,Nasdaq (DQ),1129867993,301286575,525180457,1956335025,20653295000.2,13280481227.9,9217739714.4,43151515942.5,2557563,482081,1126711,4166355
2008-11-07,ADF (D),44884736,5035436,26555351,76475523,969399205.585,248033721.475,382157199.276,1599590126.34,204462,13790,97884,316136
2008-11-07,ISE (I),63501262,12896225,25562564,101960051,981388703.852,426508480.184,376251225.939,1784148409.97,208254,31663,91516,331433
2008-11-07,CHX (M),22422511,11471728,6835322,40729561,599933937.007,925884810.63,176975468.988,1702794216.62,46765,10411,8567,65743
2008-11-07,NYSE (N),1263072208,0,0,1263072208,30199345106.1,0.0,0.0,30199345106.1,4280485,0,0,4280485
2008-11-07,NYSE Arca (P),855675260,535237874,316165581,1707078715,19225767147.0,24259572712.9,7036866910.21,50522206770.1,5181423,1778153,1680417,8639993
2008-11-07,Nasdaq (Q),1103948149,621800245,805585801,2531334195,24396877724.4,33413112598.0,16971747434.1,74781737756.5,6368795,2305548,3639564,12313907
2008-11-07,CBOE (W),662000,8677700,3202700,12542400,26153090.0,571199301.0,70984303.0,668336694.0,1609,7827,11738,21174
2008-11-07,BATS (Z),401649003,273406216,203034727,878089946,9772518361.75,13631310133.4,4448565458.78,27852393954.0,2889094,1262080,1238497,5389671
2008-11-10,AMEX (A),0,19504983,26100,19531083,0.0,739471914.26,97435.0,739569349.26,0,28148,40,28188
2008-11-10,NSX (C),32322101,10355547,10583506,53261154,586262679.942,287521287.526,245713087.534,1119497055.0,124132,21321,53437,198890
2008-11-10,NSX (DC),443595,79801,384957,908353,8657417.7579,5204582.55,4179371.0553,18041371.3632,1990,154,1835,3979
2008-11-10,NYSE (DN),13148014,1533738,11656631,26338383,261222019.094,48997970.2112,170019758.281,480239747.586,36460,3183,25280,64923
2008-11-10,Nasdaq (DQ),1120995901,268960870,503110230,1893067001,19345073144.0,11989289498.8,8737460617.86,40071823260.7,2542681,484084,1067915,4094680
2008-11-10,ADF (D),41404588,4451041,17394480,63250109,989951357.504,247264240.28,329103927.552,1566319525.34,201933,14988,80943,297864
2008-11-10,ISE (I),63067817,8875985,24747969,96691771,931339620.953,299422426.839,333140239.746,1563902287.54,200330,24889,85699,310918
2008-11-10,CHX (M),24448907,9867777,4164508,38481192,664537997.644,755795330.399,110682344.069,1531015672.11,39787,10705,7727,58219
2008-11-10,NYSE (N),1143127759,0,0,1143127759,26999674760.0,0.0,0.0,26999674760.0,3974435,0,0,3974435
2008-11-10,NYSE Arca (P),817484116,450307085,279560250,1547351451,17381884510.8,20106040583.4,6331947607.7,43819872701.9,4777910,1549511,1514492,7841913
2008-11-10,Nasdaq (Q),987956248,538733360,709577449,2236267057,21100054771.4,28728021745.5,15343879787.1,65171956304.0,5620120,2010499,3162263,10792882
2008-11-10,CBOE (W),2587300,8235700,2471400,13294400,114424157.0,473942957.0,68491412.0,656858526.0,2439,11333,11528,25300
2008-11-10,BATS (Z),350872261,233213895,173724240,757810396,8445393379.73,12069939853.9,3884820338.38,24400153572.0,2508177,1108534,1072280,4688991
2008-11-11,AMEX (A),0,21885906,10100,21896006,0.0,846039572.27,70000.0,846109572.27,0,31883,58,31941
2008-11-11,NSX (C),37573343,12988425,13504805,64066573,727392237.595,430004173.63,295628424.161,1453024835.39,149298,25867,69370,244535
2008-11-11,NSX (DC),517383,131018,350881,999282,8744684.7002,7716842.2427,3621748.666,20083275.6089,2465,248,1702,4415
2008-11-11,NYSE (DN),16527659,1986975,12441547,30956181,310765216.927,86122468.2713,192806728.431,589694413.629,41853,4093,27967,73913
2008-11-11,Nasdaq (DQ),1174619536,316425461,518936065,2009981062,20047671465.4,13668784955.3,9249329825.56,42965786246.2,2712642,529126,1175303,4417071
2008-11-11,ADF (D),57879383,6571134,22537494,86988011,1329277155.92,360042535.647,449624977.427,2138944668.99,287827,20243,103883,411953
2008-11-11,ISE (I),72104568,12487244,28356622,112948434,1110449155.46,433360533.67,437559135.021,1981368824.15,235917,30643,105135,371695
2008-11-11,CHX (M),21203031,11050521,5418632,37672184,502239672.764,862583847.46,173328103.375,1538151623.6,36920,10923,7509,55352
2008-11-11,NYSE (N),1226777463,0,0,1226777463,27977303228.9,0.0,0.0,27977303228.9,4552150,0,0,4552150
2008-11-11,NYSE Arca (P),865070685,577122209,327307257,1769500151,18444883033.9,25507036928.5,7389164605.71,51341084568.2,5293687,1861174,1766116,8920977
2008-11-11,Nasdaq (Q),1125035455,717095229,810661811,2652792495,23526903331.7,38488936904.5,17503310958.5,79519151194.6,6548716,2593297,3636661,12778674
2008-11-11,CBOE (W),1627800,15574600,2214700,19417100,46309245.5,839559239.0,59116845.0,944985329.5,1799,12795,11943,26537
2008-11-11,BATS (Z),402488256,307985411,205861929,916335596,9409993788.18,15637462772.7,4573206787.37,29620663348.3,2887662,1374594,1248358,5510614
2008-11-12,AMEX (A),0,15070361,24400,15094761,0.0,230731819.14,59321.0,230791140.14,0,23469,95,23564
2008-11-12,NSX (C),46361944,14775968,17024010,78161922,857025616.652,404689780.523,319469264.66,1581184661.83,182149,28041,75594,285784
2008-11-12,NSX (DC),696436,129692,735140,1561268,9105448.8219,6790836.4886,6210930.1791,22107215.4896,2846,194,2290,5330
2008-11-12,NYSE (DN),17756703,2183169,13521634,33461506,315679730.024,83343725.9961,187503622.718,586527078.738,43978,4662,29689,78329
2008-11-12,Nasdaq (DQ),1334346404,392379821,598695406,2325421631,21571336153.0,16991413317.0,9736253005.69,48299002475.7,3027878,538371,1270113,4836362
2008-11-12,ADF (D),82825921,5110661,34894328,122830910,1765785867.74,184976206.042,648828794.586,2599590868.37,423427,14834,167694,605955
2008-11-12,ISE (I),87485447,13007611,32974685,133467743,1287185182.82,397845083.272,464377755.032,2149408021.13,291554,28951,120348,440853
2008-11-12,CHX (M),17803468,12457430,4758382,35019280,407939112.406,854011971.765,107201019.89,1369152104.06,43210,11069,10718,64997
2008-11-12,NYSE (N),1455604003,0,0,1455604003,32283628252.1,0.0,0.0,32283628252.1,4836023,0,0,4836023
2008-11-12,NYSE Arca (P),983820103,634534043,354573238,1972927384,19559796940.8,26822140011.2,7510819170.21,53892756122.2,5761433,1995666,1875271,9632370
2008-11-12,Nasdaq (Q),1292134338,758444663,937898575,2988477576,25827866384.3,39595299117.5,19161957481.0,84585122982.8,7248414,2641222,3923871,13813507
2008-11-12,CBOE (W),2615300,13001700,1859800,17476800,122995564.0,848620814.64,47178207.0,1018794585.64,1534,8742,10518,20794
2008-11-12,BATS (Z),444097370,311456408,227111898,982665676,9687719790.99,15169761122.5,4793501938.31,29650982851.8,3111157,1354994,1364648,5830799
2008-11-13,AMEX (A),0,20603219,32400,20635619,0.0,449596785.4,167507.0,449764292.4,0,31863,97,31960
2008-11-13,NSX (C),48590573,20568217,17309795,86468585,902586198.719,636957987.72,395165590.227,1934709776.67,198217,38603,87155,323975
2008-11-13,NSX (DC),1038381,193923,488947,1721251,16313553.6718,8407726.92,6724732.2281,31446012.8199,4278,552,2381,7211
2008-11-13,NYSE (DN),24506036,3756735,19664249,47927020,449245532.246,144094989.665,287286374.088,880626895.999,65088,7300,44505,116893
2008-11-13,Nasdaq (DQ),1647358644,491140763,744300420,2882799827,27976172775.4,21486975165.6,13558002878.7,63021150819.7,3833705,759223,1631122,6224050
2008-11-13,ADF (D),80712826,11042003,36175623,127930452,1650461648.04,514576852.392,650257501.433,2815296001.86,383179,29540,156781,569500
2008-11-13,ISE (I),101059581,16009732,38408474,155477787,1552305564.69,567640010.466,597536022.095,2717481597.25,341726,35603,138209,515538
2008-11-13,CHX (M),28650915,17091070,9184696,54926681,592175973.387,1236094628.15,202406334.48,2030676936.02,72523,14785,19415,106723
2008-11-13,NYSE (N),1993286403,0,0,1993286403,46034597078.1,0.0,0.0,46034597078.1,6795652,0,0,6795652
2008-11-13,NYSE Arca (P),1370918027,955705334,522457093,2849080454,28117681263.9,42366310218.5,11348306624.9,81832298107.3,8326937,3024692,2768070,14119699
2008-11-13,Nasdaq (Q),1884206676,1291392480,1369934263,4545533419,37911439404.0,68837516610.4,28599018790.8,135347974805.0,10916125,4544308,5941680,21402113
2008-11-13,CBOE (W),1522700,18859600,3503400,23885700,41497311.0,1149996634.0,86061807.0,1277555752.0,2326,17622,20807,40755
2008-11-13,BATS (Z),669190819,492273096,328606942,1490070857,14612014801.5,23843296959.3,6819990531.03,45275302291.8,4843354,2117611,1983607,8944572
2008-11-14,AMEX (A),0,16151332,23700,16175032,0.0,568263537.66,85342.0,568348879.66,0,22882,69,22951
2008-11-14,NSX (C),40015183,13534267,13364709,66914159,776544965.825,409262860.248,299793435.736,1485601261.81,168339,26278,71426,266043
2008-11-14,NSX (DC),765920,276084,382298,1424302,12144163.1346,17177637.3,5695657.7884,35017458.223,3765,198,2237,6200
2008-11-14,NYSE (DN),20859225,2735865,13679560,37274650,402422749.058,110655151.185,202240689.138,715318589.381,54593,5873,33654,94120
2008-11-14,Nasdaq (DQ),1272111213,391004516,600259648,2263375377,21465720493.3,16375759958.8,10469467944.0,48310948396.1,3062930,645272,1292998,5001200
2008-11-14,ADF (D),57942591,8202777,24330100,90475468,1292336099.88,330335962.595,453573281.297,2076245343.77,291821,25008,116959,433788
2008-11-14,ISE (I),73160947,10714301,25087282,108962530,1049584867.53,372454673.088,380296948.482,1802336489.1,234504,28468,94556,357528
2008-11-14,CHX (M),28593321,14748945,8892113,52234379,677107418.971,1160283477.75,258555855.648,2095946752.37,58681,14801,12909,86391
2008-11-14,NYSE (N),1450419242,0,0,1450419242,34183763500.3,0.0,0.0,34183763500.3,5470318,0,0,5470318
2008-11-14,NYSE Arca (P),1034540830,697989822,389879630,2122410282,21504060786.6,31022998554.2,8724728062.18,61251787403.0,6378806,2361405,2163057,10903268
2008-11-14,Nasdaq (Q),1352951688,936584717,979877280,3269413685,28109274725.9,49496052906.8,21143001349.6,98748328982.3,7988038,3356104,4479600,15823742
2008-11-14,CBOE (W),1582500,8355000,1992400,11929900,38647279.0,627971780.0,51308732.0,717927791.0,2718,7986,13741,24445
2008-11-14,BATS (Z),551217115,362292716,257590899,1171100730,12603849892.5,17197132606.2,5480307314.52,35281289813.2,4039822,1655463,1607156,7302441
2008-11-17,AMEX (A),0,20929228,29400,20958628,0.0,241376539.31,143953.0,241520492.31,0,25290,112,25402
2008-11-17,NSX (C),32044184,11960149,13119540,57123873,616926736.823,350983240.335,332083553.358,1299993530.52,141042,22366,68659,232067
2008-11-17,NSX (DC),541287,50602,299671,891560,8398979.3426,2792960.5292,5268346.5359,16460286.4077,2979,143,1125,4247
2008-11-17,NYSE (DN),17185805,2291876,12253810,31731491,318224668.958,95620688.5117,187728600.42,601573957.889,46951,5322,30391,82664
2008-11-17,Nasdaq (DQ),1015526972,314131988,456137146,1785796106,16762112568.2,13153044138.6,8364734827.81,38279891534.6,2587250,508588,1123694,4219532
2008-11-17,ADF (D),55238598,12022409,23890126,91151133,1237735673.58,748513971.33,438018799.25,2424268444.16,281656,26142,118514,426312
2008-11-17,ISE (I),58272461,10660001,24404471,93336933,863925759.365,335176911.126,348916623.261,1548019293.75,216698,26932,92694,336324
2008-11-17,CHX (M),25732553,17441003,4814807,47988363,572764325.651,1212061796.46,116822140.371,1901648262.48,68772,14518,18679,101969
2008-11-17,NYSE (N),1311284659,0,0,1311284659,29351301535.7,0.0,0.0,29351301535.7,4996057,0,0,4996057
2008-11-17,NYSE Arca (P),847240640,553177522,316877179,1717295341,18110687741.4,24071447826.2,7261023664.05,49443159231.7,5428794,1924001,1742927,9095722
2008-11-17,Nasdaq (Q),1117644296,745925866,829943425,2693513587,23320150787.3,37873574571.2,18101845771.1,79295571129.6,6809253,2707943,3792715,13309911
2008-11-17,CBOE (W),921500,9283500,2082700,12287700,36948475.0,661492396.0,52164360.0,750605231.0,2859,9765,12241,24865
2008-11-17,BATS (Z),446434460,295143879,207348754,948927093,10112911556.5,13696134909.4,4495246528.04,28304292993.9,3263702,1340664,1277281,5881647
2008-11-18,AMEX (A),0,16906293,27300,16933593,0.0,324817056.41,173875.0,324990931.41,0,23675,92,23767
2008-11-18,NSX (C),44499027,15049527,16552184,76100738,825794425.421,476105725.566,322619178.325,1624519329.31,188518,26586,76536,291640
2008-11-18,NSX (DC),647099,148859,542895,1338853,10027433.8044,8333024.2984,6212607.946,24573066.0488,3139,164,1616,4919
2008-11-18,NYSE (DN),17149282,2429975,12886850,32466107,314245953.741,96509701.2032,185712674.781,596468329.725,44393,5602,29021,79016
2008-11-18,Nasdaq (DQ),1348529891,354894940,639946971,2343371802,22130809213.0,14900266180.0,10866177694.7,47897253087.8,3150721,550876,1320927,5022524
2008-11-18,ADF (D),65812802,8583483,27346056,101742341,1348627272.43,333400671.21,480694132.183,2162722075.82,310376,22319,117424,450119
2008-11-18,ISE (I),69658056,12382914,32967826,115008796,1038378006.6,390173915.129,449400312.69,1877952234.42,248314,28225,109516,386055
2008-11-18,CHX (M),23594381,17978346,7354218,48926945,564844388.316,1298602058.11,150627776.746,2014074223.17,67044,15021,14496,96561
2008-11-18,NYSE (N),1597840483,0,0,1597840483,35342287556.2,0.0,0.0,35342287556.2,5492823,0,0,5492823
2008-11-18,NYSE Arca (P),978628174,639647146,389563686,2007839006,20282281246.4,28096946204.0,8336972627.71,56716200078.1,6049997,2159729,1999106,10208832
2008-11-18,Nasdaq (Q),1367077284,918593333,1050474428,3336145045,28032818720.3,47633967181.0,21341275384.9,97008061286.1,8050654,3301263,4344316,15696233
2008-11-18,CBOE (W),1704400,10860600,2997300,15562300,60044986.3,697078450.8,73610954.96,830734392.06,2519,8222,13844,24585
2008-11-18,BATS (Z),562900988,375840321,265137118,1203878427,12365005178.6,17695104504.6,5545564494.48,35605674177.7,4005775,1628599,1525114,7159488
2008-11-19,AMEX (A),0,21421834,19300,21441134,0.0,303865356.3,88239.0,303953595.3,0,25472,56,25528
2008-11-19,NSX (C),46189645,18806354,14122691,79118690,800322720.332,533135980.282,263120441.119,1596579141.73,183116,33673,64056,280845
2008-11-19,NSX (DC),647822,139337,915722,1702881,12198210.8962,7157452.75,8178171.1432,27533834.7894,3353,138,2698,6189
2008-11-19,NYSE (DN),20201528,2722328,14689392,37613248,327667691.307,118534948.96,207395025.302,653597665.569,46816,5829,31489,84134
2008-11-19,Nasdaq (DQ),1459173570,405236157,610437258,2474846985,22384385559.1,16508225374.6,9352931674.48,48245542608.2,3393840,624141,1319463,5337444
2008-11-19,ADF (D),71496884,10320786,24983240,106800910,1446234090.57,369158944.605,419162059.078,2234555094.25,348427,26125,117487,492039
2008-11-19,ISE (I),85097151,13693646,33077627,131868424,1214710069.08,436197887.954,385629297.492,2036537254.53,285142,29546,105816,420504
2008-11-19,CHX (M),20965434,23309322,7329094,51603850,491789602.356,1683790324.51,172474011.228,2348053938.09,66960,10469,17009,94438
2008-11-19,NYSE (N),1634888077,0,100,1634888177,34109884807.0,0.0,28891.0,34109913698.0,5545912,0,1,5545913
2008-11-19,NYSE Arca (P),1108451336,718362834,398757384,2225571554,21877654341.3,31489776489.4,8277048248.94,61644479079.7,6671726,2368609,2090927,11131262
2008-11-19,Nasdaq (Q),1504251939,968701915,1058916111,3531869965,28944306671.7,48397941911.6,20290362948.6,97632611531.8,8527216,3396136,4535624,16458976
2008-11-19,CBOE (W),1258100,18356100,2617900,22232100,45655613.0,1288201941.4,58806969.0,1392664523.4,2417,14207,12677,29301
2008-11-19,BATS (Z),598533584,387071521,258543978,1244149083,12404850799.1,18240375413.3,5211312575.34,35856538787.8,4200824,1741951,1525978,7468753
2008-11-20,AMEX (A),0,30457655,19800,30477455,0.0,572280101.36,147914.0,572428015.36,0,30814,77,30891
2008-11-20,NSX (C),67359105,22545341,17851481,107755927,976521645.861,696554830.073,329030111.389,2002106587.32,223488,41189,84619,349296
2008-11-20,NSX (DC),1254537,389285,1035455,2679277,20063440.3215,17101668.5585,7450624.7927,44615733.6727,4566,291,3045,7902
2008-11-20,NYSE (DN),26250157,3497734,18142323,47890214,438006276.683,151319177.368,241371196.894,830696650.944,60678,7328,38807,106813
2008-11-20,Nasdaq (DQ),1957677907,613142187,794510956,3365331050,27133283423.7,23203740331.5,10981651550.6,61318675305.8,4460547,846518,1666194,6973259
2008-11-20,ADF (D),84296807,13563147,31323706,129183660,1477691517.51,572971925.355,505191615.785,2555855058.65,377704,34508,142821,555033
2008-11-20,ISE (I),115918819,18981369,42374113,177274301,1430197628.43,581638646.007,515103552.123,2526939826.56,357921,39646,139518,537085
2008-11-20,CHX (M),27895338,21711624,7284250,56891212,563869533.603,1475233476.45,162167838.16,2201270848.21,67589,20510,11913,100012
2008-11-20,NYSE (N),2233171608,0,0,2233171608,43232606630.6,0.0,0.0,43232606630.6,7493686,0,0,7493686
2008-11-20,NYSE Arca (P),1572462257,1046358746,532732577,3151553580,27571955361.5,42563069805.6,10283706152.8,80418731319.9,9059605,3276942,2743480,15080027
2008-11-20,Nasdaq (Q),2147312611,1434495636,1405889903,4987698150,37399560762.4,66937460228.3,25653342009.2,129990363000.0,12014402,4817847,6050807,22883056
2008-11-20,CBOE (W),1421200,17156100,4316900,22894200,24330971.5,1133917049.1,101523593.6,1259771614.2,2404,18495,16761,37660
2008-11-20,BATS (Z),860930353,568805287,346706727,1776442367,15754997764.8,25200420575.3,6676284494.8,47631702834.9,5942657,2379642,2035330,10357629
2008-11-21,AMEX (A),0,24774623,36500,24811123,0.0,389218149.81,318626.0,389536775.81,0,29065,98,29163
2008-11-21,NSX (C),76456148,27131411,19836761,123424320,990604943.03,796521946.853,347464794.516,2134591684.4,258275,46299,105527,410101
2008-11-21,NSX (DC),1307094,165088,965954,2438136,19274935.7136,9585246.6725,11681801.4553,40541983.8414,4960,236,3329,8525
2008-11-21,NYSE (DN),33758306,3906267,18701254,56365827,428045681.682,145422895.507,249186319.224,822654896.413,67103,9182,39647,115932
2008-11-21,Nasdaq (DQ),2139078764,579188283,786448425,3504715472,29127446011.4,21669452708.5,11603605954.9,62400504674.7,4766654,803463,1821897,7392014
2008-11-21,ADF (D),87068193,23327573,29636115,140031881,1600157250.17,795332227.925,458748679.066,2854238157.16,403422,47483,136428,587333
2008-11-21,ISE (I),111192220,18957409,41423731,171573360,1287689287.98,607898741.172,499241353.594,2394829382.74,347430,40801,142828,531059
2008-11-21,CHX (M),29425161,22772489,9222967,61420617,495802145.447,1500961473.59,164524213.57,2161287832.61,70298,21944,16772,109014
2008-11-21,NYSE (N),2373716663,0,0,2373716663,44961268780.3,0.0,0.0,44961268780.3,7157900,0,0,7157900
2008-11-21,NYSE Arca (P),1676659282,1090061349,529612935,3296333566,28204448191.7,44265226285.2,10034945110.8,82504619587.7,9456992,3330889,2783885,15571766
2008-11-21,Nasdaq (Q),2107050013,1348272001,1413049541,4868371555,35031686481.6,59652140365.3,25205509942.9,119889336790.0,11423227,4552293,5832063,21807583
2008-11-21,CBOE (W),2648200,25749600,3679400,32077200,44120868.0,1627881100.6,90747167.0,1762749135.6,2530,31260,17604,51394
2008-11-21,BATS (Z),859194558,528602871,325309551,1713106980,15286322916.9,22154751608.5,6189642278.13,43630716803.5,5777803,2137162,1984399,9899364
2008-11-24,AMEX (A),0,25003720,20400,25024120,0.0,916101331.67,68762.0,916170093.67,0,29014,59,29073
2008-11-24,NSX (C),67235868,22113108,17756290,107105266,1051198632.65,651105253.724,360660529.357,2062964415.73,234678,37883,89755,362316
2008-11-24,NSX (DC),851681,185882,649434,1686997,15915108.3005,10027321.62,9253607.2025,35196037.123,3862,322,2708,6892
2008-11-24,NYSE (DN),24159847,2883189,15789831,42832867,387362626.641,100580257.428,208219232.592,696162116.661,56601,5571,35983,98155
2008-11-24,Nasdaq (DQ),1810384935,525380549,692961296,3028726780,27216118240.7,18618301828.4,11119715069.6,56954135138.7,3968985,700362,1536817,6206164
2008-11-24,ADF (D),74814896,10565052,30508069,115888017,1525325476.79,411376261.715,512165285.511,2448867024.02,334559,27222,131102,492883
2008-11-24,ISE (I),91460189,20592963,32410613,144463765,1207957312.13,647516014.246,441427532.546,2296900858.92,284650,39304,118328,442282
2008-11-24,CHX (M),25941451,19930564,9051276,54923291,511254910.239,1288542197.25,192802704.694,1992599812.18,69654,16261,12186,98101
2008-11-24,NYSE (N),2041474144,0,0,2041474144,42436339242.7,0.0,0.0,42436339242.7,6186850,0,0,6186850
2008-11-24,NYSE Arca (P),1375605996,861272070,433176722,2670054788,26018938625.5,33790318220.7,8879462200.67,68688719046.9,7961619,2620872,2351270,12933761
2008-11-24,Nasdaq (Q),1686368858,1000167066,1130717626,3817253550,31084189499.3,45599525625.1,21891023353.1,98574738477.4,9172754,3249302,4849598,17271654
2008-11-24,CBOE (W),1190300,21589900,4033800,26814000,22143362.0,1265283622.0,105015073.0,1392442057.0,2537,25549,15390,43476
2008-11-24,BATS (Z),682062157,432522840,278172163,1392757160,13796670490.5,18018356158.7,5481453945.58,37296480594.8,4767540,1746016,1660689,8174245
2008-11-25,AMEX (A),0,14170480,10200,14180680,0.0,238441154.04,22834.0,238463988.04,0,21657,35,21692
2008-11-25,NSX (C),56163578,21286478,18114679,95564735,927970991.042,735022977.215,339296477.095,2002290445.35,215544,37958,95775,349277
2008-11-25,NSX (DC),326683,251953,499379,1078015,7297076.1593,10387695.08,5594088.442,23278859.6813,916,213,1460,2589
2008-11-25,NYSE (DN),19493981,2601644,13922028,36017653,330640922.043,92565336.8884,179368617.352,602574876.283,51045,5510,31593,88148
2008-11-25,Nasdaq (DQ),1647464284,499955077,703682330,2851101691,26663017416.6,19007611566.8,11051104256.3,56721733239.7,3674512,693332,1436298,5804142
2008-11-25,ADF (D),60979131,11488938,23801581,96269650,1211258918.22,458908252.405,421472351.163,2091639521.79,295958,29291,115807,441056
2008-11-25,ISE (I),82591806,20303219,31413034,134308059,1050639853.79,678482362.907,429680215.286,2158802431.98,256739,40128,107377,404244
2008-11-25,CHX (M),32246688,18938370,6777980,57963038,623053730.225,1362915661.89,125921372.275,2111890764.39,75704,17327,17301,110332
2008-11-25,NYSE (N),1877786452,0,0,1877786452,39457008050.0,0.0,0.0,39457008050.0,5842220,0,0,5842220
2008-11-25,NYSE Arca (P),1150148396,696994309,397339777,2244482482,23259256834.1,30108154466.1,8247445177.19,61614856477.4,7143956,2357819,2172409,11674184
2008-11-25,Nasdaq (Q),1445942647,858838590,1072870741,3377651978,27751909095.3,38896749781.5,20635115685.5,87283774562.2,8377185,3044140,4371476,15792801
2008-11-25,CBOE (W),2362000,23682200,4939600,30983800,53276150.0,1476040979.54,116398958.0,1645716087.54,1972,26466,14680,43118
2008-11-25,BATS (Z),581934157,409020329,251077609,1242032095,12011390954.7,17662829890.4,5021010186.63,34695231031.6,4161588,1732828,1547237,7441653
2008-11-26,AMEX (A),0,12947724,11600,12959324,0.0,283280523.05,21440.0,283301963.05,0,20278,31,20309
2008-11-26,NSX (C),50763580,16655153,13322204,80740937,802293825.844,514113278.638,291556948.525,1607964053.01,169848,30475,66684,267007
2008-11-26,NSX (DC),665365,182414,759269,1607048,11619092.6265,13650681.51,4690374.9465,29960149.083,2996,255,2022,5273
2008-11-26,NYSE (DN),15494250,2281719,12398252,30174221,241939853.151,75067097.2957,154709873.072,471716823.518,36924,4043,28220,69187
2008-11-26,Nasdaq (DQ),1482434052,393889008,587900286,2464223346,21785983234.7,15977892358.9,9573028458.29,47336904051.9,3266834,588405,1280294,5135533
2008-11-26,ADF (D),53197278,8572886,18760458,80530622,1071974192.43,314317917.875,322667589.967,1708959700.28,240389,24809,85706,350904
2008-11-26,ISE (I),98448936,16740962,29952203,145142101,1171117479.37,605557415.382,405437677.563,2182112572.31,273028,37359,111126,421513
2008-11-26,CHX (M),28735716,15773082,5768849,50277647,653929747.707,1092557718.11,159940539.17,1906428004.99,90467,11874,22105,124446
2008-11-26,NYSE (N),1424173403,0,0,1424173403,30071871542.2,0.0,0.0,30071871542.2,4927182,0,0,4927182
2008-11-26,NYSE Arca (P),941877207,576897000,322944540,1841718747,18380561523.8,24958036851.8,6520827389.81,49859425765.4,5603230,1858768,1745223,9207221
2008-11-26,Nasdaq (Q),1222937852,647020846,798908427,2668867125,23417751268.0,30461313759.1,15394742432.5,69273807459.6,6838526,2333698,3546404,12718628
2008-11-26,CBOE (W),1952700,18748100,2606600,23307400,31193556.0,1228187772.73,60038064.0,1319419392.73,2040,16914,12067,31021
2008-11-26,BATS (Z),473896395,295239212,208957111,978092718,9896732964.97,13309696396.5,4057244974.6,27263674336.1,3295451,1291188,1287995,5874634
2008-11-28,AMEX (A),0,7382686,2200,7384886,0.0,151655756.66,7935.0,151663691.66,0,9760,9,9769
2008-11-28,NSX (C),28266035,6119321,5736255,40121611,406110447.167,191614961.236,124873315.918,722598724.321,73397,11458,24366,109221
2008-11-28,NSX (DC),147272,37606,161988,346866,3836948.72,2806809.02,1639176.69,8282934.43,954,58,757,1769
2008-11-28,NYSE (DN),5808370,886612,4717070,11412052,99580611.583,31063087.48,60965967.8224,191609666.885,13754,1444,11755,26953
2008-11-28,Nasdaq (DQ),724849479,158376546,252307478,1135533503,9964459372.21,6155374113.67,3729130846.66,19848964332.5,1419287,228356,522880,2170523
2008-11-28,ADF (D),30384315,3878859,9730446,43993620,514226290.347,169470017.252,164774545.69,848470853.289,127027,10164,46081,183272
2008-11-28,ISE (I),52045011,7141882,17207863,76394756,527341959.36,229675552.37,185678576.855,942696088.585,124021,15252,49284,188557
2008-11-28,CHX (M),6790885,5208843,965589,12965317,157465603.927,378088406.742,17072724.85,552626735.519,16469,4307,1991,22767
2008-11-28,NYSE (N),787017540,0,0,787017540,16440660046.3,0.0,0.0,16440660046.3,2138262,0,0,2138262
2008-11-28,NYSE Arca (P),425467963,198784035,121191173,745443171,7988259049.01,8604387815.48,2311231462.84,18903878327.3,2363727,627263,654776,3645766
2008-11-28,Nasdaq (Q),528336382,206491159,325231821,1060059362,9381933658.23,9764880110.45,5948984265.64,25095798034.3,2607080,720577,1286157,4613814
2008-11-28,CBOE (W),378900,6479600,738300,7596800,7845814.0,364018207.0,16956744.0,388820765.0,934,7207,3328,11469
2008-11-28,BATS (Z),152173987,76112688,53036842,281323517,3144364391.7,3559459947.61,1001600126.96,7705424466.27,1046860,378668,336660,1762188
2008-12-01,AMEX (A),0,12151132,0,12151132,0.0,72800590.86,0.0,72800590.86,0,21871,0,21871
2008-12-01,NSX (C),55486865,14666996,12784772,82938633,920581024.577,455070230.209,259689667.947,1635340922.73,216653,29394,64178,310225
2008-12-01,NSX (DC),847379,70143,402218,1319740,21689167.0,3930769.3,5821816.362,31441752.662,5629,94,1951,7674
2008-12-01,NYSE (DN),13295799,2045048,10863157,26204004,208697315.729,72123222.47,130250423.4,411070961.598,35378,4107,26304,65789
2008-12-01,Nasdaq (DQ),1507253026,373552002,531557761,2412362789,22030124961.3,14088987095.6,8386644815.07,44505756872.0,3140447,560487,1225001,4925935
2008-12-01,ADF (D),56093610,8563617,21022828,85680055,1061486887.99,359503451.155,350025117.848,1771015457.0,258615,26077,98105,382797
2008-12-01,ISE (I),89830875,15183996,26861458,131876329,948607011.863,540638898.159,338337636.144,1827583546.17,241666,35454,98444,375564
2008-12-01,CHX (M),26684056,22095545,5216397,53995998,643117969.734,1714504281.49,121445748.26,2479067999.48,61983,11646,11825,85454
2008-12-01,NYSE (N),1635012304,0,0,1635012304,33604698782.1,0.0,0.0,33604698782.1,5213699,0,0,5213699
2008-12-01,NYSE Arca (P),972508938,610135212,315609228,1898253378,19135753481.4,25292356502.4,6347716957.09,50775826940.9,5850826,1894573,1737773,9483172
2008-12-01,Nasdaq (Q),1227524735,686678598,861571493,2775774826,22905906667.9,31718701554.6,15841364374.1,70465972596.7,6735756,2403800,3726179,12865735
2008-12-01,CBOE (W),1058600,14084100,2584100,17726800,22110966.0,977055666.5,56011871.0,1055178503.5,1728,17783,12807,32318
2008-12-01,BATS (Z),472016432,320245095,204669546,996931073,9860089835.41,14430016012.5,3790021884.16,28080127732.1,3311741,1377885,1204511,5894137
2008-12-02,AMEX (A),0,15855138,0,15855138,0.0,70766721.84,0.0,70766721.84,0,27080,0,27080
2008-12-02,NSX (C),56092838,14210143,14857366,85160347,835870565.109,382128676.657,287340125.533,1505339367.3,191513,26658,74889,293060
2008-12-02,NSX (DC),525257,11462,310679,847398,7524054.0832,132657.12,4872335.88,12529047.0832,2728,31,1492,4251
2008-12-02,NYSE (DN),16167222,2701881,11789000,30658103,262507197.136,103646706.853,149669752.021,515823656.009,42480,5526,30380,78386
2008-12-02,Nasdaq (DQ),1457278596,452870671,582011824,2492161091,22073843159.7,17890643383.0,9165498119.06,49129984661.7,3373470,673836,1291032,5338338
2008-12-02,ADF (D),62476644,9341850,23963245,95781739,1183886825.34,351690462.88,398684401.002,1934261689.22,299374,26519,121238,447131
2008-12-02,ISE (I),81421768,16220958,25367555,123010281,948415672.419,539732969.548,349554767.996,1837703409.96,234109,35020,94354,363483
2008-12-02,CHX (M),22901685,15215121,4424654,42541460,483409907.39,1059902725.47,100548985.34,1643861618.2,63816,14329,10636,88781
2008-12-02,NYSE (N),1616917739,0,0,1616917739,33574947986.6,0.0,0.0,33574947986.6,5730309,0,0,5730309
2008-12-02,NYSE Arca (P),1012172642,631299538,348142897,1991615077,20057629439.7,27644411458.4,6839514968.65,54541555866.7,6218308,2049245,1925613,10193166
2008-12-02,Nasdaq (Q),1317057275,822178562,912936006,3052171843,24482447263.3,38500173416.1,17031557636.7,80014178316.1,7426233,3033672,4046634,14506539
2008-12-02,CBOE (W),845700,12413800,2926700,16186200,19107103.5,798362364.0,65082243.0,882551710.5,1332,15119,13862,30313
2008-12-02,BATS (Z),528005150,359867423,230269311,1118141884,10778260862.0,16519244467.2,4353557518.19,31651062847.3,3703045,1668144,1364236,6735425
2008-12-03,AMEX (A),0,11977649,0,11977649,0.0,54355479.32,0.0,54355479.32,0,23202,0,23202
2008-12-03,NSX (C),52773862,14048191,13965570,80787623,778005705.787,387377125.769,288612152.638,1453994984.19,183613,26332,74881,284826
2008-12-03,NSX (DC),508157,72954,417959,999070,10072154.999,1639197.26,9098396.314,20809748.573,3080,86,1662,4828
2008-12-03,NYSE (DN),16269592,3149171,11576305,30995068,246332546.92,127970488.232,157213551.099,531516586.251,43191,6548,28332,78071
2008-12-03,Nasdaq (DQ),1404658664,485555949,576882382,2467096995,21768119945.2,19685476592.0,10196866592.9,51650463130.2,3312374,643402,1313844,5269620
2008-12-03,ADF (D),57131340,10217292,20757641,88106273,1086266839.95,412785682.12,391620342.358,1890672864.43,253051,30201,93541,376793
2008-12-03,ISE (I),88450891,15757996,32458789,136667676,1141503494.79,559601554.6,474150394.924,2175255444.31,280704,39846,126057,446607
2008-12-03,CHX (M),30200903,16349977,4669536,51220416,595698626.003,1185348632.07,121355153.98,1902402412.05,64595,15446,9930,89971
2008-12-03,NYSE (N),1551682247,0,0,1551682247,32597762168.4,0.0,0.0,32597762168.4,5851621,0,0,5851621
2008-12-03,NYSE Arca (P),1039638365,689402851,383449393,2112490609,20439542496.6,29763293664.6,8064922256.91,58267758418.1,6332664,2259246,2108159,10700069
2008-12-03,Nasdaq (Q),1415458155,942561278,1001579539,3359598972,26702068583.6,43943977183.6,19427533962.0,90073579729.2,7812660,3313685,4586991,15713336
2008-12-03,CBOE (W),1441200,12284100,2489600,16214900,32507927.4,740903509.46,51892802.0,825304238.86,1874,12982,14015,28871
2008-12-03,BATS (Z),578947215,406728012,257829124,1243504351,11877926846.5,18110194445.4,5046673222.93,35034794514.9,4056892,1838045,1535713,7430650
2008-12-04,AMEX (A),0,14363399,0,14363399,0.0,44499620.07,0.0,44499620.07,0,23371,0,23371
2008-12-04,NSX (C),49545772,16355240,13602122,79503134,775920007.502,455857695.559,278495674.6,1510273377.66,177031,30219,71123,278373
2008-12-04,NSX (DC),276698,16949,397362,691009,5409179.86,573880.12,5381987.1689,11365047.1489,1410,93,1263,2766
2008-12-04,NYSE (DN),13655150,2586733,10557283,26799166,253265229.499,96890073.3227,137678271.522,487833574.344,38693,5367,26003,70063
2008-12-04,Nasdaq (DQ),1402384537,432910822,534617967,2369913326,23093374116.9,17805776404.7,9049816211.54,49948966733.1,3385589,624658,1280142,5290389
2008-12-04,ADF (D),50211636,12480359,20219820,82911815,986937994.931,467565544.31,353666515.572,1808170054.81,226826,38080,92151,357057
2008-12-04,ISE (I),86611200,16247454,26489796,129348450,1179697539.38,571336735.255,391597294.671,2142631569.31,286218,38613,102434,427265
2008-12-04,CHX (M),27369434,14171365,13946005,55486804,554781003.922,1015025523.5,215272149.72,1785078677.14,62144,12789,12340,87273
2008-12-04,NYSE (N),1469444486,0,0,1469444486,31262861504.5,0.0,0.0,31262861504.5,5325423,0,0,5325423
2008-12-04,NYSE Arca (P),949018183,644093947,345958067,1939070197,19510427217.7,28197288798.3,7023028142.93,54730744158.9,6011914,2152591,1923067,10087572
2008-12-04,Nasdaq (Q),1282244367,807423821,900456741,2990124929,25606922077.6,36946950075.7,17367123176.4,79920995329.6,7358431,2865182,4090610,14314223
2008-12-04,CBOE (W),2582800,11835000,2574300,16992100,32364618.9,731623238.0,55254221.0,819242077.9,1974,14909,11476,28359
2008-12-04,BATS (Z),527943790,393929635,231007632,1152881057,11240137497.4,18074232180.8,4408140405.81,33722510084.0,3768620,1810338,1366924,6945882
2008-12-05,AMEX (A),0,14631700,0,14631700,0.0,59794875.75,0.0,59794875.75,0,23894,0,23894
2008-12-05,NSX (C),42336077,16226821,12845427,71408325,694369472.031,526482374.838,244723504.338,1465575351.21,159103,29035,65024,253162
2008-12-05,NSX (DC),441938,43361,410456,895755,8621334.34,1523892.33,5868534.6362,16013761.3062,2373,64,1366,3803
2008-12-05,NYSE (DN),15996999,3165780,11757269,30920048,288138964.743,128739790.842,157577585.898,574456341.483,40141,7316,28243,75700
2008-12-05,Nasdaq (DQ),1468893359,484297642,583084413,2536275414,24192038429.1,17802714727.8,9560862189.5,51555615346.4,3747925,704469,1416179,5868573
2008-12-05,ADF (D),51449536,17931535,14342315,83723386,983448446.528,643637703.415,268606693.055,1895692843.0,218910,44167,57929,321006
2008-12-05,ISE (I),81616384,17933760,28707367,128257511,1235343238.13,575523895.333,410413296.948,2221280430.41,304607,36725,103775,445107
2008-12-05,CHX (M),22169578,15887649,5141584,43198811,477604500.246,1193916643.77,118163929.75,1789685073.77,73902,13569,12442,99913
2008-12-05,NYSE (N),1623349495,0,0,1623349495,35304353215.8,0.0,0.0,35304353215.8,5691086,0,0,5691086
2008-12-05,NYSE Arca (P),959365055,715338985,361785007,2036489047,19459483891.3,31100823004.8,7156934952.4,57717241848.5,6055140,2301304,1990354,10346798
2008-12-05,Nasdaq (Q),1313909545,888162123,980861351,3182933019,25833757407.5,40068502487.6,18419853080.8,84322112975.8,7512597,3055895,4299231,14867723
2008-12-05,CBOE (W),1562900,13831500,2202400,17596800,30982865.0,947475690.88,56093053.8,1034551609.68,1855,14036,11975,27866
2008-12-05,BATS (Z),587626756,413497893,248484636,1249609285,12105220066.3,18899486084.9,4672522069.04,35677228220.2,4125407,1871954,1464573,7461934
2008-12-08,AMEX (A),0,16470596,0,16470596,0.0,69577136.88,0.0,69577136.88,0,27458,0,27458
2008-12-08,NSX (C),56585257,15944767,15730656,88260680,976271304.617,428334777.276,319882245.385,1724488327.28,203517,29320,75445,308282
2008-12-08,NSX (DC),405682,116238,464909,986829,13585095.224,6491977.06,4706969.4929,24784041.7769,2265,153,1674,4092
2008-12-08,NYSE (DN),15058613,1981102,11825554,28865269,317765002.678,61983176.7974,169129013.307,548877192.782,39390,3346,28627,71363
2008-12-08,Nasdaq (DQ),1657119806,484776808,641979015,2783875629,28254893808.2,16844826661.7,11249781066.4,56349501536.4,4006839,701418,1543982,6252239
2008-12-08,ADF (D),57086669,14751111,15569543,87407323,1224219706.89,490051691.363,280573880.824,1994845279.07,240146,37390,59159,336695
2008-12-08,ISE (I),88068982,16239689,30533779,134842450,1301585664.81,461599698.542,442099189.283,2205284552.63,294277,33952,115668,443897
2008-12-08,CHX (M),28606990,15867843,10285817,54760650,716531938.403,1154355980.3,288906084.061,2159794002.76,85576,16077,13662,115315
2008-12-08,NYSE (N),1741216181,0,0,1741216181,38603553052.4,0.0,0.0,38603553052.4,5770956,0,0,5770956
2008-12-08,NYSE Arca (P),1048628972,669890682,393390726,2111910380,22818094829.0,27925004742.2,8513709927.98,59256809499.2,6394438,2111046,2134568,10640052
2008-12-08,Nasdaq (Q),1276385499,782736384,977626737,3036748620,26450639543.5,37376731015.7,19908618905.5,83735989464.7,7028652,2633309,4244802,13906763
2008-12-08,CBOE (W),1520600,7551600,2250700,11322900,36744530.22,453633283.0,53810095.0,544187908.22,2371,7820,11051,21242
2008-12-08,BATS (Z),588024107,389516127,249474503,1227014737,13142433206.4,17587205665.5,5065932095.25,35795570967.1,4055691,1806544,1469150,7331385
2008-12-09,AMEX (A),0,13745888,0,13745888,0.0,56198259.75,0.0,56198259.75,0,24688,0,24688
2008-12-09,NSX (C),45471124,14630169,17264967,77366260,877188385.309,428124125.868,356757773.0,1662070284.18,188948,25250,74845,289043
2008-12-09,NSX (DC),414633,81918,697870,1194421,8485169.2885,6853332.2095,6492453.61,21830955.108,2301,93,2477,4871
2008-12-09,NYSE (DN),13691418,2697578,12214884,28603880,253432764.415,106628839.759,164441951.007,524503555.181,36590,5234,29754,71578
2008-12-09,Nasdaq (DQ),1437104811,474295787,675087991,2586488589,25493571975.3,17834966789.0,11740168260.1,55068707024.5,3645494,724042,1546130,5915666
2008-12-09,ADF (D),49223302,13453676,14412598,77089576,1019026290.42,473296299.027,266402186.15,1758724775.6,226026,39767,58429,324222
2008-12-09,ISE (I),73791912,14684760,30519844,118996516,1141294461.05,411033634.807,437113631.585,1989441727.45,255915,30509,105398,391822
2008-12-09,CHX (M),20940012,14231872,7734116,42906000,539439107.221,952961285.07,200587880.27,1692988272.56,52600,14656,13275,80531
2008-12-09,NYSE (N),1441310605,0,0,1441310605,32239457579.5,0.0,0.0,32239457579.5,5188165,0,0,5188165
2008-12-09,NYSE Arca (P),916295673,581867440,373070679,1871233792,20264517297.7,25222846797.1,7886273728.81,53373637823.7,5842593,2008156,2067911,9918660
2008-12-09,Nasdaq (Q),1174084899,741352071,957374268,2872811238,25105710832.7,34234888594.0,19206983560.7,78547582987.4,6931891,2640117,4275435,13847443
2008-12-09,CBOE (W),2484400,8530700,2185400,13200500,38902165.0,565823694.8,54828465.0,659554324.8,2100,8630,11979,22709
2008-12-09,BATS (Z),523120113,383180196,241440413,1147740722,11500596631.9,16757673593.6,4675489992.21,32933760217.7,3664868,1803830,1438922,6907620
2008-12-10,AMEX (A),0,14982229,0,14982229,0.0,54877004.77,0.0,54877004.77,0,26395,0,26395
2008-12-10,NSX (C),47992719,14659330,16276959,78929008,894778932.37,410815799.428,322313168.774,1627907900.57,187762,27018,71572,286352
2008-12-10,NSX (DC),474807,286635,674148,1435590,10245945.216,10156708.05,8340620.964,28743274.23,2806,224,1863,4893
2008-12-10,NYSE (DN),12212220,2734597,9496896,24443713,233589502.463,91167718.9631,135172052.664,459929274.09,31258,5175,21617,58050
2008-12-10,Nasdaq (DQ),1347113269,463380400,612001592,2422495261,22684929700.3,18868199305.7,10270860994.5,51823990000.5,3251249,616576,1368583,5236408
2008-12-10,ADF (D),48557944,10989624,13564696,73112264,1023682509.85,355063762.9,248833371.631,1627579644.38,211932,28327,53917,294176
2008-12-10,ISE (I),83337811,16018772,30611389,129967972,1154032322.73,535095552.792,415420064.303,2104547939.82,260745,36126,107933,404804
2008-12-10,CHX (M),16903500,15498436,6013752,38415688,441177550.46,1014610953.23,215383341.12,1671171844.81,33741,12397,9317,55455
2008-12-10,NYSE (N),1306540805,0,0,1306540805,28473216730.5,0.0,0.0,28473216730.5,4796148,0,0,4796148
2008-12-10,NYSE Arca (P),823048852,566858535,324857847,1714765234,17879476762.8,24778297898.0,6505363564.69,49163138225.5,5072967,1811336,1721579,8605882
2008-12-10,Nasdaq (Q),1071455151,679248012,775050815,2525753978,22195058327.9,31517459195.1,15262891191.2,68975408714.3,6144210,2396160,3496582,12036952
2008-12-10,CBOE (W),1576000,8654100,3729000,13959100,33496465.0,556142165.0,87561825.0,677200455.0,2595,9301,9259,21155
2008-12-10,BATS (Z),461309446,325196455,216919847,1003425748,10171783504.7,14153227023.4,4138099009.84,28463109537.9,3211013,1482533,1297325,5990871
2008-12-11,AMEX (A),0,23961867,0,23961867,0.0,70369775.22,0.0,70369775.22,0,33418,0,33418
2008-12-11,NSX (C),47024278,17354100,16456758,80835136,869074817.798,360662593.322,308966125.325,1538703536.45,188847,28175,70089,287111
2008-12-11,NSX (DC),436483,122504,429864,988851,9977281.67,7757048.27,5857296.1091,23591626.0491,2434,188,1845,4467
2008-12-11,NYSE (DN),15974792,2589409,10358051,28922252,278957423.984,77600424.6874,148243783.285,504801631.956,36879,4346,24195,65420
2008-12-11,Nasdaq (DQ),1435075796,482014209,655743251,2572833256,24550032570.2,17109407511.5,10750327172.4,52409767254.1,3509140,661767,1437318,5608225
2008-12-11,ADF (D),44793265,8958699,14410672,68162636,938185080.467,309997435.66,239683012.439,1487865528.57,194686,27474,56593,278753
2008-12-11,ISE (I),80480257,18988849,31277934,130747040,1311157326.88,507433499.433,423064137.377,2241654963.69,299974,36742,115257,451973
2008-12-11,CHX (M),19196195,13781610,5593906,38571711,499847591.03,1030177549.39,136062387.313,1666087527.74,49777,12611,9077,71465
2008-12-11,NYSE (N),1471956488,0,0,1471956488,32394401399.6,0.0,0.0,32394401399.6,4870063,0,0,4870063
2008-12-11,NYSE Arca (P),815374022,589775373,315610006,1720759401,18146425122.5,24975925633.0,6612964729.47,49735315485.0,5117829,1767432,1611230,8496491
2008-12-11,Nasdaq (Q),1095294339,644170620,814675338,2554140297,23677956902.7,29537541955.0,16359729777.5,69575228635.2,6314490,2190973,3474312,11979775
2008-12-11,CBOE (W),1805400,9252800,1925800,12984000,42636829.65,641619532.72,48914446.0,733170808.37,2674,6740,8901,18315
2008-12-11,BATS (Z),498016750,320041671,216377366,1034435787,11216083113.1,14335515900.3,4220358944.78,29771957958.2,3486268,1462102,1238944,6187314
2008-12-12,AMEX (A),0,14398051,0,14398051,0.0,52792291.6,0.0,52792291.6,0,23485,0,23485
2008-12-12,NSX (C),41461799,13686606,16525282,71673687,685656312.364,420595529.719,285940010.585,1392191852.67,160724,26005,73711,260440
2008-12-12,NSX (DC),202847,187487,391489,781823,5860840.23,14276783.5,6193716.715,26331340.445,1027,279,1133,2439
2008-12-12,NYSE (DN),11768866,2961839,8244611,22975316,214991395.27,118117841.197,117679954.664,450789191.132,30445,5889,20537,56871
2008-12-12,Nasdaq (DQ),1264152450,468735020,565680418,2298567888,20202579989.4,18302617897.0,9321102124.56,47826300010.9,3302422,721439,1385474,5409335
2008-12-12,ADF (D),47197537,5449210,17579025,70225772,963920234.92,190777050.59,312361100.116,1467058385.63,221026,17621,64629,303276
2008-12-12,ISE (I),72744807,17345047,24222830,114312684,1015203080.78,522454697.771,341576099.064,1879233877.62,251944,37395,95117,384456
2008-12-12,CHX (M),18406106,15209763,6307638,39923507,429254130.905,1131274641.4,116315527.122,1676844299.43,56976,16631,11503,85110
2008-12-12,NYSE (N),1436142328,0,0,1436142328,30230723562.2,0.0,0.0,30230723562.2,5086030,0,0,5086030
2008-12-12,NYSE Arca (P),807249883,610692590,299189601,1717132074,16995196127.1,27060874242.6,6125190976.83,50181261346.5,5112313,2036568,1626517,8775398
2008-12-12,Nasdaq (Q),1061905306,708963474,774736101,2545604881,21907743046.5,32793608058.6,15385751859.2,70087102964.3,6257985,2574666,3592368,12425019
2008-12-12,CBOE (W),982500,7515600,1873900,10372000,25512775.0,446184311.0,50065584.0,521762670.0,2120,8961,9531,20612
2008-12-12,BATS (Z),450250966,335858668,204078584,990188218,9467696079.17,14817912531.3,3843641503.26,28129250113.8,3220596,1574925,1235722,6031243
2008-12-15,AMEX (A),0,15206843,0,15206843,0.0,51858860.69,0.0,51858860.69,0,25959,0,25959
2008-12-15,NSX (C),34688089,12410465,16094241,63192795,633414773.7,294620110.54,266782350.289,1194817234.53,148431,23190,68236,239857
2008-12-15,NSX (DC),323673,39172,550700,913545,6745639.255,2777769.97,4296384.88,13819794.105,2183,90,1559,3832
2008-12-15,NYSE (DN),10764792,1843941,7678857,20287590,198836424.649,58642919.0429,106245911.302,363725254.994,30530,3232,18997,52759
2008-12-15,Nasdaq (DQ),1052264799,341717583,521677419,1915659801,18049782887.4,12168628691.7,8162215254.45,38380626833.5,2931293,552560,1279259,4763112
2008-12-15,ADF (D),36025068,3427740,12420845,51873653,812609026.051,145020516.595,238553134.685,1196182677.33,168290,11363,53996,233649
2008-12-15,ISE (I),65641373,13239267,22865758,101746398,959990502.632,373403165.693,309155353.79,1642549022.11,239531,28871,93178,361580
2008-12-15,CHX (M),16273749,11793457,3427563,31494769,388350575.717,864725874.34,65257713.441,1318334163.5,57199,10554,12213,79966
2008-12-15,NYSE (N),1215125118,0,0,1215125118,26452553612.3,0.0,0.0,26452553612.3,4279662,0,0,4279662
2008-12-15,NYSE Arca (P),711888398,464465142,266449196,1442802736,15465729544.1,19689661502.2,5407373004.05,40562764050.4,4513438,1560801,1415487,7489726
2008-12-15,Nasdaq (Q),898208578,508570478,668953883,2075732939,18733416359.0,22701738783.9,13336352336.0,54771507479.0,5276120,1835096,3010597,10121813
2008-12-15,CBOE (W),1076000,8134800,1976300,11187100,25493097.0,560730523.0,42466039.0,628689659.0,1958,6571,6486,15015
2008-12-15,BATS (Z),390615979,269806697,175559520,835982196,8678018977.21,12126064489.2,3319485278.9,24123568745.3,2770923,1296297,1059806,5127026
2008-12-16,AMEX (A),0,19648124,0,19648124,0.0,78107988.0,0.0,78107988.0,0,32446,0,32446
2008-12-16,NSX (C),40158566,15705770,15446047,71310383,775086467.701,364885998.868,295272572.541,1435245039.11,160973,27651,70982,259606
2008-12-16,NSX (DC),438472,108762,462371,1009605,7937287.275,5049495.82,5889851.98,18876635.075,1510,128,1628,3266
2008-12-16,NYSE (DN),12388225,2245338,8871752,23505315,255375497.134,84106753.2488,134889509.609,474371759.993,34080,4410,23825,62315
2008-12-16,Nasdaq (DQ),1461116396,478633349,645854871,2585604616,26316445120.0,16980993211.9,11025094672.4,54322533004.3,3494406,705661,1474848,5674915
2008-12-16,ADF (D),48613427,4819811,15617943,69051181,1047536427.79,170316250.645,281340567.065,1499193245.5,203977,13775,59604,277356
2008-12-16,ISE (I),84940642,19163557,31192680,135296879,1377974355.24,552819666.234,416965850.629,2347759872.1,308460,43853,120188,472501
2008-12-16,CHX (M),18329746,12084265,4611199,35025210,431573786.213,946527973.91,103062891.58,1481164651.7,35188,8592,4792,48572
2008-12-16,NYSE (N),1541017786,0,0,1541017786,34905228042.2,0.0,0.0,34905228042.2,4986969,0,0,4986969
2008-12-16,NYSE Arca (P),1013678677,647263387,374367859,2035309923,23173008252.4,27183330776.0,7883855931.26,58240194959.7,6294669,2007187,1958540,10260396
2008-12-16,Nasdaq (Q),1199105183,746743401,905445715,2851294299,25806047199.8,32055072302.4,18644020938.0,76505140440.3,6813364,2507082,3869810,13190256
2008-12-16,CBOE (W),1220800,11154000,4073200,16448000,28025513.0,845961118.1,117514567.65,991501198.75,1785,5873,5620,13278
2008-12-16,BATS (Z),590862382,374645981,273105196,1238613559,13352487731.8,16116508747.4,5386614642.01,34855611121.2,3997482,1638477,1556570,7192529
2008-12-17,AMEX (A),0,25776621,0,25776621,0.0,76331686.59,0.0,76331686.59,0,36025,0,36025
2008-12-17,NSX (C),41904805,17828898,15855976,75589679,876581061.205,388134650.477,375478440.51,1640194152.19,171820,30537,74832,277189
2008-12-17,NSX (DC),248386,130581,491944,870911,10690410.4953,2402225.29,6761339.0382,19853974.8235,802,120,1691,2613
2008-12-17,NYSE (DN),12560869,1890978,8669286,23121133,271768730.871,62488286.1059,139727323.225,473984340.201,32775,3441,21514,57730
2008-12-17,Nasdaq (DQ),1337783269,470919820,621869789,2430572878,24495084972.7,16412216998.2,10541104505.8,51448406476.7,3424293,694291,1449533,5568117
2008-12-17,ADF (D),40059936,4644780,16338770,61043486,894806343.32,177605143.835,311252622.33,1383664109.49,173429,16485,65046,254960
2008-12-17,ISE (I),87025768,19347300,41336459,147709527,1447648297.65,500659468.473,604939049.543,2553246815.67,315238,47039,151495,513772
2008-12-17,CHX (M),26878160,15607454,8222855,50708469,734020239.28,1080899527.12,225888842.941,2040808609.34,57213,12841,14560,84614
2008-12-17,NYSE (N),1340667428,0,0,1340667428,30139078848.7,0.0,0.0,30139078848.7,4971913,0,0,4971913
2008-12-17,NYSE Arca (P),907723013,554950621,343258999,1805932633,19846849746.1,22861824064.5,7255906761.97,49964580572.6,5493189,1850909,1768898,9112996
2008-12-17,Nasdaq (Q),1076845727,677115671,879635496,2633596894,23728219440.9,28032143560.8,17494082762.3,69254445764.0,6262742,2392950,3907316,12563008
2008-12-17,CBOE (W),975200,9811800,2058300,12845300,33784459.0,610390986.0,52019609.0,696195054.0,2639,8291,9031,19961
2008-12-17,BATS (Z),497104675,301020775,239672943,1037798393,11180140907.5,12677517001.9,4505278703.73,28362936613.1,3400527,1384724,1351870,6137121
2008-12-18,AMEX (A),0,24330614,0,24330614,0.0,73434097.5,0.0,73434097.5,0,31404,0,31404
2008-12-18,NSX (C),44285250,17073858,16474943,77834051,885864443.257,380277720.543,352919570.146,1619061733.95,194656,29048,88827,312531
2008-12-18,NSX (DC),386192,994681,471620,1852493,4966147.04,4284533.95,5558471.845,14809152.835,489,185,1556,2230
2008-12-18,NYSE (DN),12318514,1385529,8745382,22449425,251308259.9,36945912.9234,126515709.126,414769881.949,33636,2538,22916,59090
2008-12-18,Nasdaq (DQ),1522666262,496994813,649292040,2668953115,29005106514.2,19259899754.2,10087751086.1,58352757354.4,3645066,691387,1439430,5775883
2008-12-18,ADF (D),45281851,4726687,12769006,62777544,1000950155.33,181388333.818,252690546.975,1435029036.12,186671,12707,49972,249350
2008-12-18,ISE (I),82990211,17403796,34105145,134499152,1358422196.76,438342785.879,415378800.3,2212143782.94,296272,38396,118446,453114
2008-12-18,CHX (M),22251211,10247898,5248146,37747255,573448149.887,744900895.595,116679104.052,1435028149.53,49032,9940,10412,69384
2008-12-18,NYSE (N),1417390318,0,0,1417390318,33064024652.5,0.0,0.0,33064024652.5,4849518,0,0,4849518
2008-12-18,NYSE Arca (P),870867666,550756167,318222333,1739846166,19520328000.3,23263350763.6,6355912786.26,49139591550.2,5321524,1730081,1647204,8698809
2008-12-18,Nasdaq (Q),1170098724,726380724,859392677,2755872125,25540049394.2,32058429026.9,16737161646.1,74335640067.2,6774827,2474612,3643671,12893110
2008-12-18,CBOE (W),1016800,11015600,1768400,13800800,24912430.92,871544539.0,38101796.0,934558765.92,1746,6688,8775,17209
2008-12-18,BATS (Z),488071781,294234978,208576011,990882770,10916711568.2,12607197385.8,4021030174.43,27544939128.5,3294848,1278576,1211794,5785218
2008-12-19,AMEX (A),0,41402559,0,41402559,0.0,141150176.24,0.0,141150176.24,0,28959,0,28959
2008-12-19,NSX (C),38891601,13834612,14052485,66778698,701192679.581,288832273.502,283785159.872,1273810112.95,154848,22757,79724,257329
2008-12-19,NSX (DC),168991,45260,496453,710704,2478362.51,2463694.49,6572481.88,11514538.88,301,102,1672,2075
2008-12-19,NYSE (DN),10984151,1314494,9401429,21700074,212586857.416,32381008.694,131616586.6,376584452.71,28401,2347,24289,55037
2008-12-19,Nasdaq (DQ),1436078691,401540104,913734314,2751353109,25206188594.8,14157372699.6,13450788815.9,52814350110.3,3304812,600280,1444111,5349203
2008-12-19,ADF (D),36436484,3520858,15579547,55536889,874787437.381,149610107.728,307653059.098,1332050604.21,158189,10949,56316,225454
2008-12-19,ISE (I),75340654,17301448,34977278,127619380,1123286992.72,421691892.093,437833681.218,1982812566.03,260978,34223,136595,431796
2008-12-19,CHX (M),17940990,9948168,4210785,32099943,449421807.717,630547450.239,107305057.328,1187274315.28,58157,10488,11167,79812
2008-12-19,NYSE (N),2423615627,0,0,2423615627,53762802561.3,0.0,0.0,53762802561.3,4653150,0,0,4653150
2008-12-19,NYSE Arca (P),807483143,501760984,328891727,1638135854,17568918755.4,20479433758.4,6330365388.3,44378717902.1,4875973,1569712,1710266,8155951
2008-12-19,Nasdaq (Q),1048545994,601915085,1346497867,2996958946,21973306445.3,26415825198.3,23339139240.9,71728270884.5,5874704,2154753,3519156,11548613
2008-12-19,CBOE (W),1265300,13017200,3198600,17481100,25748935.0,965509683.1,72193636.5,1063452254.6,1791,5013,10092,16896
2008-12-19,BATS (Z),422565057,248751471,208453730,879770258,9212175803.12,10825764705.1,3910111591.77,23948052100.0,2869187,1160648,1225125,5254960
2008-12-22,AMEX (A),0,21249765,0,21249765,0.0,60421650.3,0.0,60421650.3,0,27868,0,27868
2008-12-22,NSX (C),32442764,14719613,11751080,58913457,622480267.908,302372367.705,237708425.879,1162561061.49,149636,25526,64556,239718
2008-12-22,NSX (DC),109762,52970,375710,538442,2878937.14,3128233.69,6554382.2735,12561553.1035,266,111,1649,2026
2008-12-22,NYSE (DN),8679892,1322507,7450311,17452710,167400058.715,43004218.962,101244439.096,311648716.773,26371,2473,19516,48360
2008-12-22,Nasdaq (DQ),1142668638,388418457,507275109,2038362204,19992433891.5,13116231695.1,7735842653.66,40844508240.2,3005001,580373,1208410,4793784
2008-12-22,ADF (D),29336976,4001447,8490831,41829254,683564023.01,146139317.04,175043056.501,1004746396.55,136995,11725,39351,188071
2008-12-22,ISE (I),64017101,13254061,25322114,102593276,1015269244.22,351125950.675,336220194.403,1702615389.3,240861,31559,95884,368304
2008-12-22,CHX (M),17897381,8325447,4269432,30492260,401648292.32,575326608.296,76448554.4882,1053423455.1,47816,9084,8538,65438
2008-12-22,NYSE (N),1220652289,0,0,1220652289,25702616069.6,0.0,0.0,25702616069.6,4012260,0,0,4012260
2008-12-22,NYSE Arca (P),669823610,467402983,265025342,1402251935,13907072179.3,18745132081.4,4955374101.98,37607578362.7,4016879,1393595,1341626,6752100
2008-12-22,Nasdaq (Q),861134560,510619493,667201721,2038955774,17742895085.5,21775576472.5,12539638287.0,52058109845.1,4960242,1822912,2817196,9600350
2008-12-22,CBOE (W),3922800,5117300,2090800,11130900,44970388.0,320183504.0,56592411.0,421746303.0,1839,6549,7668,16056
2008-12-22,BATS (Z),359404960,221381852,177883499,758670311,7619734928.4,9431595179.52,3324627132.11,20375957240.0,2386595,1036094,999903,4422592
2008-12-23,AMEX (A),0,16097946,0,16097946,0.0,60502853.87,0.0,60502853.87,0,22326,0,22326
2008-12-23,NSX (C),28119031,10273109,9196705,47588845,474673342.035,234229805.671,210271429.375,919174577.08,112954,18672,53781,185407
2008-12-23,NSX (DC),145644,93908,209766,449318,3310999.8,3366798.1,2696827.746,9374625.646,333,99,810,1242
2008-12-23,NYSE (DN),6832915,1081398,6434125,14348438,121638761.53,35057176.792,81600957.0331,238296895.355,19891,1947,14952,36790
2008-12-23,Nasdaq (DQ),989993767,324888071,414867945,1729749783,16212044612.9,11849020877.1,6386418746.79,34447484236.8,2611485,519082,1019888,4150455
2008-12-23,ADF (D),29409340,4389994,7829872,41629206,676071587.205,158908373.69,144766996.806,979746957.701,140294,14269,37810,192373
2008-12-23,ISE (I),52548694,9173236,20426192,82148122,749254953.473,256673351.793,250741443.353,1256669748.62,185770,25358,75409,286537
2008-12-23,CHX (M),15485995,6992133,10249400,32727528,364949366.594,478168698.87,144449081.159,987567146.623,39042,6371,8465,53878
2008-12-23,NYSE (N),984636546,0,300,984636846,20192736313.8,0.0,5809.5,20192742123.3,3598800,0,1,3598801
2008-12-23,NYSE Arca (P),551833191,366596534,211466402,1129896127,11049849698.4,14692210680.1,3936031931.63,29678092310.1,3353466,1228610,1108915,5690991
2008-12-23,Nasdaq (Q),714856946,418839175,500781512,1634477633,14579587573.0,18099235821.8,9200631179.44,41879454574.2,4148325,1557939,2265318,7971582
2008-12-23,CBOE (W),1509000,4679900,1183900,7372800,44609748.8,300125550.0,29617773.0,374353071.8,1855,5225,6602,13682
2008-12-23,BATS (Z),314308821,181045017,152755321,648109159,6507070292.56,7793252904.18,2852200962.37,17152524159.1,2070321,860515,871389,3802225
2008-12-24,AMEX (A),0,8354697,0,8354697,0.0,22205715.8,0.0,22205715.8,0,11395,0,11395
2008-12-24,NSX (C),10427980,4470193,2717214,17615387,140911551.271,83349214.2012,53101869.1444,277362634.617,34251,7087,13890,55228
2008-12-24,NSX (DC),51317,18503,60445,130265,1036770.7,732251.48,837390.608,2606412.788,137,79,295,511
2008-12-24,NYSE (DN),2940502,504771,2500711,5945984,50693766.4844,17847310.9465,28288822.6347,96829900.0656,7685,836,6382,14903
2008-12-24,Nasdaq (DQ),407350037,130933728,175664075,713947840,6264244894.85,4038105741.18,2554491397.32,12856842033.4,1012580,199258,381899,1593737
2008-12-24,ADF (D),6887886,1162623,1564582,9615091,159819831.9,38600809.91,33420883.27,231841525.08,27961,3395,6898,38254
2008-12-24,ISE (I),23455049,3110134,8708750,35273933,323740035.114,81759896.14,94840555.5552,500340486.809,78774,8852,27492,115118
2008-12-24,CHX (M),4945575,1452225,840296,7238096,106162273.132,72482557.295,17719094.75,196363925.177,10809,1370,2828,15007
2008-12-24,NYSE (N),403769691,0,0,403769691,7827103962.3,0.0,0.0,7827103962.3,1440527,0,0,1440527
2008-12-24,NYSE Arca (P),211370726,138214358,82231350,431816434,4075080587.6,4916631502.37,1501105535.74,10492817625.7,1263276,435180,422687,2121143
2008-12-24,Nasdaq (Q),251620885,133637142,190299520,575557547,4952160819.43,5320997938.62,3401744427.09,13674903185.1,1422100,439159,817147,2678406
2008-12-24,CBOE (W),336200,1311000,460700,2107900,9935034.0,85434236.0,10519706.0,105888976.0,542,1007,1675,3224
2008-12-24,BATS (Z),98941710,59007747,52204804,210154261,1980580049.57,2378858995.05,909752506.882,5269191551.51,666754,257167,292833,1216754
2008-12-26,AMEX (A),0,10459352,0,10459352,0.0,28045312.0,0.0,28045312.0,0,17631,0,17631
2008-12-26,NSX (C),13214442,4581371,3736193,21532006,173323610.303,91705531.991,69936992.0544,334966134.348,48873,8983,21209,79065
2008-12-26,NSX (DC),71230,56334,27937,155501,1111034.28,330273.26,402595.19,1843902.73,139,54,173,366
2008-12-26,NYSE (DN),2814104,541924,2504204,5860232,43868888.9802,16972500.0975,30900007.7847,91741396.8624,7617,832,7145,15594
2008-12-26,Nasdaq (DQ),530135291,158770905,209831029,898737225,8180672268.97,4593483084.68,3064003419.03,15838158772.7,1300633,244876,507201,2052710
2008-12-26,ADF (D),7747251,1744380,2162171,11653802,222336649.527,57162500.1695,34697334.4278,314196484.124,36982,6028,11085,54095
2008-12-26,ISE (I),26153419,4654774,8895975,39704168,330126578.738,115539999.62,101022540.073,546689118.43,83970,10785,32932,127687
2008-12-26,CHX (M),5284643,3063541,834070,9182254,126466589.673,190244301.151,14850045.95,331560936.774,13059,3535,3253,19847
2008-12-26,NYSE (N),516792663,0,0,516792663,10304339554.7,0.0,0.0,10304339554.7,1882837,0,0,1882837
2008-12-26,NYSE Arca (P),241932790,146759104,94401920,483093814,4559309461.07,5759936274.81,1649404193.68,11968649929.6,1417308,489840,481084,2388232
2008-12-26,Nasdaq (Q),291973875,153451539,218414110,663839524,5829597958.68,6356508100.95,3802450126.45,15988556186.1,1658518,522926,943887,3125331
2008-12-26,CBOE (W),428100,681400,512100,1621600,13193170.0,32273288.0,10083643.0,55550101.0,1004,1082,3417,5503
2008-12-26,BATS (Z),115016600,69663045,60277918,244957563,2204260321.97,2802185394.01,1002583081.1,6009028797.08,759859,305940,366591,1432390
2008-12-29,AMEX (A),0,14776843,0,14776843,0.0,46687378.86,0.0,46687378.86,0,25490,0,25490
2008-12-29,NSX (C),20394725,8774452,8742207,37911384,351061907.973,176253367.869,148717029.698,676032305.54,86761,15523,44390,146674
2008-12-29,NSX (DC),92530,32980,222487,347997,1554200.2401,858032.18,1890092.58,4302325.0001,316,103,1056,1475
2008-12-29,NYSE (DN),6263296,790830,4866071,11920197,119026156.649,21429749.5208,60366129.3748,200822035.545,17470,1415,12911,31796
2008-12-29,Nasdaq (DQ),864179197,266364966,413515799,1544059962,14739393680.6,8449009274.11,5969916673.72,29158319628.4,2237403,427102,914121,3578626
2008-12-29,ADF (D),19589715,2635822,6829881,29055418,466232957.635,101878180.68,89583840.1997,657694978.515,83760,8985,27167,119912
2008-12-29,ISE (I),42385545,7985882,19606661,69978088,609716337.618,208459875.697,217521342.289,1035697555.6,147418,19097,68732,235247
2008-12-29,CHX (M),10445539,6616147,2460226,19521912,280769873.145,425379539.277,49044165.893,755193578.315,26272,5370,6203,37845
2008-12-29,NYSE (N),877313899,0,0,877313899,18055159438.4,0.0,0.0,18055159438.4,2980398,0,0,2980398
2008-12-29,NYSE Arca (P),447601479,247990766,187069409,882661654,9347167251.73,9600863678.74,3270293816.18,22218324746.7,2661171,837747,926416,4425334
2008-12-29,Nasdaq (Q),536750625,268557795,447594040,1252902460,11318905039.1,10990345812.0,8202380935.14,30511631786.2,3092559,951420,1850175,5894154
2008-12-29,CBOE (W),563600,2617900,3179300,6360800,14646030.0,154572102.0,62418684.04,231636816.04,1073,3885,5155,10113
2008-12-29,BATS (Z),230481174,134076441,123471004,488028619,4910158453.99,5654383320.16,2212270078.11,12776811852.3,1550580,602721,714846,2868147
2008-12-30,AMEX (A),0,18450244,0,18450244,0.0,61307705.31,0.0,61307705.31,0,27649,0,27649
2008-12-30,NSX (C),22440043,10220199,9220741,41880983,376565747.991,216411809.74,179453509.465,772431067.196,90250,18280,44122,152652
2008-12-30,NSX (DC),85848,29410,178810,294068,1669360.11,1187158.84,3017260.97,5873779.92,203,104,907,1214
2008-12-30,NYSE (DN),6961492,753160,6310370,14025022,138162116.975,17636020.1184,74094465.2645,229892602.358,18668,1252,15736,35656
2008-12-30,Nasdaq (DQ),959459321,289112524,518326913,1766898758,16301425813.5,9763349163.61,6940363308.22,33005138285.4,2538856,457809,1090401,4087066
2008-12-30,ADF (D),23058331,3031715,9618612,35708658,570193734.903,117021965.835,151854535.581,839070236.319,102549,9803,38841,151193
2008-12-30,ISE (I),52220115,8482306,26711562,87413983,767563657.115,218419414.49,270987708.402,1256970780.01,190613,23187,88345,302145
2008-12-30,CHX (M),16181642,5528909,5450603,27161154,311360731.113,295642889.58,120679950.698,727683571.391,38721,6255,8970,53946
2008-12-30,NYSE (N),953952457,0,0,953952457,19956166829.2,0.0,0.0,19956166829.2,3087291,0,0,3087291
2008-12-30,NYSE Arca (P),454314773,276614780,234904432,965833985,9915027234.38,11284534617.1,4228882596.73,25428444448.3,2761570,928291,1080424,4770285
2008-12-30,Nasdaq (Q),590908396,312839801,507949421,1411697618,12862395833.6,13740259952.2,9325894570.46,35928550356.3,3389060,1086360,2000327,6475747
2008-12-30,CBOE (W),592400,5655600,1352400,7600400,12953671.64,381353662.6,24855730.0,419163064.24,1094,4074,6035,11203
2008-12-30,BATS (Z),250802722,149385811,144473798,544662331,5697336057.55,6735986138.97,2697531195.1,15130853391.6,1687894,677382,828568,3193844
2008-12-31,AMEX (A),0,21769901,0,21769901,0.0,102813405.6,0.0,102813405.6,0,30862,0,30862
2008-12-31,NSX (C),28470003,12715363,12051675,53237041,487366622.459,278447856.374,210622314.749,976436793.582,125685,20621,62133,208439
2008-12-31,NSX (DC),31900,8968,48236,89104,81713.94,437731.24,311427.99,830873.17,39,16,286,341
2008-12-31,NYSE (DN),7242690,1092015,8242876,16577581,137268739.633,29873874.3235,89031628.8123,256174242.769,19160,1670,20255,41085
2008-12-31,Nasdaq (DQ),1031152062,344742527,527770804,1903665393,17549533964.4,11383735248.6,7366722872.02,36299992085.0,2566847,515877,1106128,4188852
2008-12-31,ADF (D),35675776,4169976,9407894,49253646,813593381.44,169502717.95,178893611.709,1161989711.1,131711,12129,39395,183235
2008-12-31,ISE (I),53630378,9723920,26930892,90285190,786654949.382,239939748.037,269279770.042,1295874467.46,186153,23853,87428,297434
2008-12-31,CHX (M),13165002,6067668,6079689,25312359,330458044.426,394089186.03,198577451.27,923124681.726,34976,4421,8982,48379
2008-12-31,NYSE (N),1312587766,0,0,1312587766,27010380577.5,0.0,0.0,27010380577.5,3431416,0,0,3431416
2008-12-31,NYSE Arca (P),502335885,347078259,256958499,1106372643,10485406696.4,13812724602.4,4479134262.81,28777265561.6,2948534,1075298,1233630,5257462
2008-12-31,Nasdaq (Q),641184924,393625282,606518055,1641328261,13856185154.2,17453158286.0,11041980146.6,42351323586.7,3680045,1299373,2221488,7200906
2008-12-31,CBOE (W),916800,6463100,2322800,9702700,24203704.0,316002840.0,61708025.0,401914569.0,1232,4043,7134,12409
2008-12-31,BATS (Z),288829552,184321355,157269410,630420317,6699302633.93,7810066460.76,2905692341.06,17415061435.7,1984216,778683,940356,3703255
