Day,Market Participant,Tape A Shares,Tape B Shares,Tape C Shares,Total Shares,Tape A Notional,Tape B Notional,Tape C Notional,Total Notional,Tape A Trade Count,Tape B Trade Count,Tape C Trade Count,Total Trade Count
2019-12-31,NYSE American (A),4395582,16097652,2550895,23044129,164965230.556000,211130821.189500,126088962.997200,502185014.742700,44654,49606,26360,120620
2019-12-31,NASDAQ BX (B),31764877,16493501,17356203,65614581,1079999889.153400,892017187.498700,884266877.273100,2856283953.925200,314949,128111,210422,653482
2019-12-31,NYSE National (C),61757948,23536759,26077694,111372401,1204856108.146500,828534313.953600,637662050.861000,2671052472.961100,533553,114648,262446,910647
2019-12-31,FINRA / Nasdaq TRF Chicago (DB),3524780,1188419,3362382,8075581,83876547.969900,50582272.305100,222347012.187500,356805832.462500,10769,3472,15053,29294
2019-12-31,FINRA / NYSE TRF (DN),275415819,94133968,369619234,739169021,4855927617.143501,3121550519.557901,9351796946.705606,17329275083.407008,637458,225957,756055,1619470
2019-12-31,FINRA / Nasdaq TRF Carteret (DQ),764534784,295753718,581436673,1641725175,25673058627.787701,20117152930.167198,22028599936.789294,67818811494.744193,2815177,789639,1925164,5529980
2019-12-31,EDGA Equities (J),67980579,15982464,40881770,124844813,2507027717.492200,961266545.669100,1613746614.406600,5082040877.567900,800333,95467,449992,1345792
2019-12-31,EDGX Equities (K),149348727,60624196,167754599,377727522,3965206252.746101,3585643119.778597,4543538640.443600,12094388012.968298,1067006,247514,877253,2191773
2019-12-31,NYSE Chicago (M),6413557,5700372,2649879,14763808,274103883.212200,770847647.820000,370061290.657500,1415012821.689700,6094,2452,5650,14196
2019-12-31,NYSE (N),815459390,31682220,32287046,879428656,34534446169.809700,2147932251.283300,1537108278.076100,38219486699.169100,2358168,91495,207402,2657065
2019-12-31,NYSE Arca (P),128107991,186269188,128007052,442384231,4351075825.961699,12376908844.754200,6004906950.184501,22732891620.900400,1115451,491959,1036120,2643530
2019-12-31,NASDAQ (Q),272141552,113820693,589424807,975387052,11004117260.172500,7007119745.476599,28554068276.031301,46565305281.680400,2801236,460856,3343187,6605279
2019-12-31,IEX (V),74027968,13753130,41431238,129212336,2884356345.923100,967282252.603500,1977634256.194900,5829272854.721500,637085,75534,390467,1103086
2019-12-31,NASDAQ PSX (X),12591429,12689564,10084702,35365695,407925612.972300,825556428.583900,633119251.882000,1866601293.438200,101946,51305,81058,234309
2019-12-31,BYX Equities (Y),73685602,37374010,55477533,166537145,2150784826.796800,1949729047.737600,1682202123.604900,5782715998.139300,749326,182962,461707,1393995
2019-12-31,BZX Equities (Z),153616634,62806288,118433301,334856223,6139123811.841200,4202997066.963002,5988190535.994901,16330311414.799103,1386059,251576,1005007,2642642
2019-12-30,NYSE American (A),5239330,16422162,2312783,23974275,195029090.076800,257910862.950600,141098121.032600,594038074.060000,52978,56307,26999,136284
2019-12-30,NASDAQ BX (B),35311644,20353274,18855694,74520612,1125624290.233500,1014224829.069000,1041684676.597800,3181533795.900300,337985,144234,233678,715897
2019-12-30,NYSE National (C),62325541,26913065,23356389,112594995,1139075644.593700,968889599.038200,616980052.896100,2724945296.528000,524648,123229,242428,890305
2019-12-30,FINRA / Nasdaq TRF Chicago (DB),5223789,1263111,3746304,10233204,114104747.586100,60188522.060000,297705550.322100,471998819.968200,14414,4196,18706,37316
2019-12-30,FINRA / NYSE TRF (DN),333854926,99863289,324448975,758167190,5606999748.171201,3606781476.280800,11857218395.394802,21070999619.846803,720215,250036,818926,1789177
2019-12-30,FINRA / Nasdaq TRF Carteret (DQ),849454656,340516048,606069900,1796040604,26286820503.609003,19715455261.628102,27051325698.341596,73053601463.578701,3100265,949229,2145577,6195071
2019-12-30,EDGA Equities (J),73610072,18119547,36681189,128410808,2382086610.538400,993036166.596000,1551729069.048500,4926851846.182900,832685,102238,447744,1382667
2019-12-30,EDGX Equities (K),167330132,61880668,143697037,372907837,3863317745.385701,3535591161.744600,4697596386.483800,12096505293.614101,1083967,250439,876107,2210513
2019-12-30,NYSE Chicago (M),6419965,3512522,4106880,14039367,436341709.584500,368415644.677000,731269221.778400,1536026576.039900,7229,2699,7416,17344
2019-12-30,NYSE (N),690993067,36502046,29120534,756615647,25969132767.444999,2463858356.761400,1439118742.057400,29872109866.263799,2283369,98356,200556,2582281
2019-12-30,NYSE Arca (P),152903552,223257682,130660978,506822212,4594297755.068800,13835728271.010804,6765273076.881894,25195299102.961498,1165200,561404,1091191,2817795
2019-12-30,NASDAQ (Q),306078706,146751029,517041913,969871648,11169197910.722999,8935447223.973998,26567755608.469607,46672400743.166604,2884305,584846,3565483,7034634
2019-12-30,IEX (V),72114937,15880427,42799234,130794598,2797312763.068100,1076170116.067100,2198177900.128400,6071660779.263600,681441,92192,425163,1198796
2019-12-30,NASDAQ PSX (X),13548814,14316022,9629306,37494142,460478935.646500,984354455.417700,668718322.131400,2113551713.195600,105595,60905,81341,247841
2019-12-30,BYX Equities (Y),79918140,45529507,49785445,175233092,2065328176.971600,2179575381.885100,1604385319.687800,5849288878.544500,756369,204968,440212,1401549
2019-12-30,BZX Equities (Z),167396661,65546221,109012770,341955652,6088966937.229699,4271948463.020500,6437072369.507200,16797987769.757399,1406070,273918,1005580,2685568
2019-12-27,NYSE American (A),3580724,15608258,2245368,21434350,123467891.321600,161295983.277900,120333086.659800,405096961.259300,36444,51159,24898,112501
2019-12-27,NASDAQ BX (B),27418214,19489664,15169886,62077764,896313817.877800,893992134.003000,805025156.389100,2595331108.269900,262089,129919,179310,571318
2019-12-27,NYSE National (C),56099898,24581711,21912060,102593669,1007900543.032000,807396450.791500,564799441.264100,2380096435.087600,479022,109826,232466,821314
2019-12-27,FINRA / Nasdaq TRF Chicago (DB),2759969,922868,3070836,6753673,90702871.580000,40023632.094100,304032957.174700,434759460.848800,10254,3100,15619,28973
2019-12-27,FINRA / NYSE TRF (DN),232032490,88064732,285965148,606062370,5028588167.808700,3197898617.657500,12366790135.407392,20593276920.873592,589464,219038,768345,1576847
2019-12-27,FINRA / Nasdaq TRF Carteret (DQ),675291462,268649103,539648500,1483589065,25408544620.318599,17014397409.054397,26203109632.449294,68626051661.822290,2709232,695827,1994728,5399787
2019-12-27,EDGA Equities (J),62963810,17471701,32525884,112961395,2065588196.233900,870174254.334300,1457461357.157200,4393223807.725400,677121,100697,389902,1167720
2019-12-27,EDGX Equities (K),120695477,52566720,129621786,302883983,3449989629.048100,2895101682.538801,4991759847.698599,11336851159.285500,909778,222803,809576,1942157
2019-12-27,NYSE Chicago (M),4882132,27338005,5081415,37301552,364759614.821000,2334778703.750000,652945341.474000,3352483660.045000,8238,1875,5594,15707
2019-12-27,NYSE (N),617008859,30039257,25815882,672863998,25974132801.036001,1988867020.436100,1428458468.455600,29391458289.927701,1959423,85365,188113,2232901
2019-12-27,NYSE Arca (P),114450534,191722331,114522932,420695797,4055011464.289901,11269656657.168402,6527097833.718698,21851765955.177001,998601,477170,973435,2449206
2019-12-27,NASDAQ (Q),244444663,123123850,469989828,837558341,9775196983.483901,7093260055.756296,26646558390.821402,43515015430.061599,2490434,502421,3201970,6194825
2019-12-27,IEX (V),61968712,14790098,37887895,114646705,2404830961.369800,910531090.665400,2046800068.150700,5362162120.185900,513770,80306,329335,923411
2019-12-27,NASDAQ PSX (X),11901493,12312137,8993472,33207102,380107982.028700,707225608.908000,761792055.646300,1849125646.583000,92652,46252,76479,215383
2019-12-27,BYX Equities (Y),63581978,39427102,41548457,144557537,1792417578.459900,1787665689.912200,1479902134.114200,5059985402.486300,619826,179875,403560,1203261
2019-12-27,BZX Equities (Z),130073410,56755787,99745121,286574318,5383567071.234199,3500387891.146600,6709040507.592901,15592995469.973700,1192285,236516,904611,2333412
2019-12-26,NYSE American (A),3443697,12512324,2194890,18150911,128381644.603000,112602696.596700,102632025.101100,343616366.300800,39256,44281,26157,109694
2019-12-26,NASDAQ BX (B),23406229,12841640,14505933,50753802,793749028.232900,569667754.237900,742109689.696400,2105526472.167200,223169,81196,153541,457906
2019-12-26,NYSE National (C),47108687,18579015,20742687,86430389,922004287.841100,620876997.130600,539454684.174300,2082335969.146000,420844,83731,218340,722915
2019-12-26,FINRA / Nasdaq TRF Chicago (DB),2771217,1133264,3059358,6963839,87853104.939700,46639516.721800,263861364.228600,398353985.890100,10144,3279,15006,28429
2019-12-26,FINRA / NYSE TRF (DN),221178513,86538028,278016333,585732874,5062064209.487901,2662793135.203900,11052717674.312694,18777575019.004495,579880,205745,723706,1509331
2019-12-26,FINRA / Nasdaq TRF Carteret (DQ),630701551,246560275,473642396,1350904222,23561703636.327193,14045282842.734197,23750524093.731897,61357510572.793287,2367517,668384,1753290,4789191
2019-12-26,EDGA Equities (J),47203559,12117039,28415613,87736211,1755957316.511400,623234593.332900,1300156336.374200,3679348246.218500,527635,69837,327925,925397
2019-12-26,EDGX Equities (K),111732781,44314794,122718020,278765595,3123797292.508800,2253439816.082600,4748325945.092901,10125563053.684301,723036,178264,682643,1583943
2019-12-26,NYSE Chicago (M),7240121,18958809,5426982,31625912,491197462.128400,1425091208.236800,1146773307.883200,3063061978.248400,8349,1489,6246,16084
2019-12-26,NYSE (N),542120045,20865984,22451424,585437453,23072033820.097199,1309178620.274800,1023929311.282000,25405141751.653999,1730421,57740,156485,1944646
2019-12-26,NYSE Arca (P),93469094,150227760,94201806,337898660,3508266610.705700,8763146194.698997,5073492090.647196,17344904896.051893,824212,374670,795849,1994731
2019-12-26,NASDAQ (Q),211314283,84172271,412486330,707972884,8475952359.131999,4738791375.317199,23137334501.401678,36352078235.850876,2041068,357250,2760887,5159205
2019-12-26,IEX (V),53710245,11145453,34129417,98985115,2125923094.131500,718377702.826300,1731275738.747700,4575576535.705500,657909,72152,440312,1170373
2019-12-26,NASDAQ PSX (X),12361351,9514184,8713783,30589318,372643433.112600,525086315.591900,612966136.519500,1510695885.224000,88068,38933,72097,199098
2019-12-26,BYX Equities (Y),52008781,28727565,36664268,117400614,1586886315.337800,1371344992.339700,1317054299.897700,4275285607.575200,509504,143204,340138,992846
2019-12-26,BZX Equities (Z),104775212,45194723,82594354,232564289,4152813460.438101,2575174483.273200,5576544038.100202,12304531981.811503,948612,181537,736293,1866442
2019-12-24,NYSE American (A),2117862,9539242,1371621,13028725,86026438.588500,87134996.470800,63848928.804300,237010363.863600,22613,29601,14033,66247
2019-12-24,NASDAQ BX (B),16071750,9114755,9461730,34648235,542421232.363400,398359220.139300,438378455.702400,1379158908.205100,155294,73461,106889,335644
2019-12-24,NYSE National (C),26624682,12543788,10815232,49983702,503375054.905700,404225126.402800,294243156.602000,1201843337.910500,252127,64284,126862,443273
2019-12-24,FINRA / Nasdaq TRF Chicago (DB),2223178,783145,2236633,5242956,59628415.577200,29151516.072700,129413923.150300,218193854.800200,6841,2337,11208,20386
2019-12-24,FINRA / NYSE TRF (DN),137625440,55947726,159453539,353026705,3121843062.321800,1734671740.904800,5962214115.509603,10818728918.736203,340632,127637,456092,924361
2019-12-24,FINRA / Nasdaq TRF Carteret (DQ),355532129,176882284,298121180,830535593,12781734034.156000,9545750363.388600,13391232948.428894,35718717345.973494,1514983,451305,1110010,3076298
2019-12-24,EDGA Equities (J),33159934,7957404,17747935,58865273,1089580120.507500,389021592.674000,668715769.872800,2147317483.054300,357634,46753,200547,604934
2019-12-24,EDGX Equities (K),70030900,31514366,75797949,177343215,2020502992.161100,1528400825.370000,2658859302.706799,6207763120.237899,486126,129212,460386,1075724
2019-12-24,NYSE Chicago (M),2170617,8241346,3081591,13493554,133692811.606000,727212867.008000,623813639.650800,1484719318.264800,5029,1195,4202,10426
2019-12-24,NYSE (N),314228918,13635105,13112207,340976230,12829781957.439999,862737202.831700,573172535.413300,14265691695.684999,1134551,42184,98483,1275218
2019-12-24,NYSE Arca (P),61467479,113988299,60514629,235970407,2287013813.865700,6057614620.276701,2723895435.114201,11068523869.256602,564155,267746,532875,1364776
2019-12-24,NASDAQ (Q),127354093,58988241,262851988,449194322,5282647306.551900,3164858871.835900,12416095822.774195,20863602001.161995,1365950,254658,1819597,3440205
2019-12-24,IEX (V),37994990,8476227,22876633,69347850,1476820715.574700,477187261.513500,1105340939.632900,3059348916.721100,314155,44681,201312,560148
2019-12-24,NASDAQ PSX (X),6191060,6952739,5090632,18234431,232827627.304300,403889215.150000,294823356.591900,931540199.046200,50248,26865,41834,118947
2019-12-24,BYX Equities (Y),31298546,20138766,20172613,71609925,906245050.590800,921826357.516000,724661894.043000,2552733302.149800,323347,98237,208971,630555
2019-12-24,BZX Equities (Z),72445076,31439915,51830038,155715029,2941041161.975900,1714779510.932700,2808877933.723399,7464698606.631999,678288,135434,481718,1295440
2019-12-23,NYSE American (A),4939197,14705862,2568866,22213925,177682321.107600,154412269.084900,125461117.112500,457555707.305000,49667,49392,29447,128506
2019-12-23,NASDAQ BX (B),35479113,20776943,19327407,75583463,1160450602.282300,1193660036.356500,920410336.076400,3274520974.715200,330343,127182,221932,679457
2019-12-23,NYSE National (C),62961443,26130175,24405938,113497556,1264137313.510000,868323124.428000,648693227.358200,2781153665.296200,537913,105620,261044,904577
2019-12-23,FINRA / Nasdaq TRF Chicago (DB),3435508,858588,3884152,8178248,127798411.029800,37921412.305500,261327055.458900,427046878.794200,13664,3349,20981,37994
2019-12-23,FINRA / NYSE TRF (DN),250883435,81764618,264028076,596676129,6376381292.572199,3034790733.233200,10069088843.934000,19480260869.739399,658305,206637,782049,1646991
2019-12-23,FINRA / Nasdaq TRF Carteret (DQ),934917284,347630140,648236574,1930783998,39730959123.618904,23504674308.796096,33081764122.039197,96317397554.454197,3200008,818884,2227775,6246667
2019-12-23,EDGA Equities (J),73879052,14913922,36831083,125624057,2707914387.858900,816379750.681000,1702203866.778400,5226498005.318300,819415,90321,474806,1384542
2019-12-23,EDGX Equities (K),142239955,51344673,130096629,323681257,4383183983.056999,2901200217.216599,5289740576.673403,12574124776.947001,1002522,217290,884633,2104445
2019-12-23,NYSE Chicago (M),8687764,15570072,10009979,34267815,455057593.762600,1499494680.245601,1814087160.171100,3768639434.179301,9173,1738,7137,18048
2019-12-23,NYSE (N),784305491,24065941,28390189,836761621,34807737263.133598,1626788760.873400,1390277887.017000,37824803911.023998,2408126,72247,216788,2697161
2019-12-23,NYSE Arca (P),131335447,195776211,112544320,439655978,5212076589.311999,11576301248.434801,5835478801.149802,22623856638.896602,1205741,445307,1082970,2734018
2019-12-23,NASDAQ (Q),297510688,116319787,533699812,947530287,12995765855.622799,6940500526.131599,29634094844.751091,49570361226.505489,2958891,481716,3743026,7183633
2019-12-23,IEX (V),79600813,17118306,53439146,150158265,3340421745.739600,1004461694.644200,2627624469.306500,6972507909.690300,754678,102037,533447,1390162
2019-12-23,NASDAQ PSX (X),14064579,11647369,9857494,35569442,482871848.301600,703872927.924700,605166746.205600,1791911522.431900,109934,50371,87760,248065
2019-12-23,BYX Equities (Y),76165086,38575216,42207209,156947511,2239082625.241100,1894886136.446200,1589189030.156100,5723157791.843400,769889,173415,468498,1411802
2019-12-23,BZX Equities (Z),164129304,59079659,109143445,332352408,7142269175.242301,3591057415.244000,6375420737.271397,17108747327.757698,1467608,242167,1038783,2748558
2019-12-20,NYSE American (A),6890669,58030437,4024987,68946093,283691433.572700,474035440.469100,235754506.177000,993481380.218800,70784,52892,42143,165819
2019-12-20,NASDAQ BX (B),51301605,30386946,26716367,108404918,1722174508.556100,1657264513.703500,1455430475.900700,4834869498.160300,475182,160578,292700,928460
2019-12-20,NYSE National (C),90535183,38941407,35725172,165201762,1943753690.453600,1409505043.396400,958073471.011500,4311332204.861500,748635,143374,352044,1244053
2019-12-20,FINRA / Nasdaq TRF Chicago (DB),3663812,959245,3235696,7858753,137984686.570800,50265116.329600,260185498.538500,448435301.438900,13798,3266,16632,33696
2019-12-20,FINRA / NYSE TRF (DN),257715364,97998649,255589840,611303853,6423552384.440299,4111445106.445799,10689398390.628598,21224395881.514696,651238,205733,700149,1557120
2019-12-20,FINRA / Nasdaq TRF Carteret (DQ),1853467249,580138854,1201053254,3634659357,76414893059.430089,50834955740.835206,69871392243.247046,197121241043.512341,4077238,849975,2569271,7496484
2019-12-20,EDGA Equities (J),104534486,23036086,50891449,178462021,4004115306.340400,1512407037.345200,2479312584.375300,7995834928.060900,1146987,120333,644206,1911526
2019-12-20,EDGX Equities (K),181221824,69455977,143763984,394441785,5943909578.352999,4458675208.451499,6541917353.832199,16944502140.636697,1368670,250393,1062339,2681402
2019-12-20,NYSE Chicago (M),12077845,23231817,8425798,43735460,596828717.998800,2388654347.488000,1142174073.204100,4127657138.690900,9755,2439,7651,19845
2019-12-20,NYSE (N),2813908224,36245456,38596936,2888750616,127428306388.319006,2632261200.833200,1988462168.391600,132049029757.543806,3073255,91361,268122,3432738
2019-12-20,NYSE Arca (P),190581104,264185932,142386052,597153088,7893640218.121999,20724389349.483202,8221106603.320601,36839136170.925802,1725546,533018,1405995,3664559
2019-12-20,NASDAQ (Q),415965553,156390885,1639774591,2212131029,18841367319.245395,10415305002.039898,95617053409.664750,124873725730.950043,4121394,556769,4632667,9310830
2019-12-20,IEX (V),117588869,24035819,66761285,208385973,4968165117.097100,1555555293.445100,3456279259.856999,9979999670.399199,980572,107147,585582,1673301
2019-12-20,NASDAQ PSX (X),21224923,16598103,14153390,51976416,769309145.746500,1167656001.335701,1052108175.951700,2989073323.033901,163111,64147,118057,345315
2019-12-20,BYX Equities (Y),107604815,54135901,57879264,219619980,3460501749.186900,2903096366.705900,2401651975.949200,8765250091.842000,1074149,220488,625801,1920438
2019-12-20,BZX Equities (Z),229204930,81082264,141224911,451512105,10558120098.659701,5992610145.163102,9339955984.637802,25890686228.460605,2032045,296372,1342245,3670662
2019-12-19,NYSE American (A),6316949,13839261,3391232,23547442,292019797.317400,165597622.332900,166895412.751900,624512832.402200,69505,47404,36372,153281
2019-12-19,NASDAQ BX (B),45475790,22574807,28709617,96760214,1574540668.046800,1091529512.520500,1160726323.783800,3826796504.351100,431729,156772,259701,848202
2019-12-19,NYSE National (C),79975635,26856342,30415550,137247527,1633724006.511300,981129699.991300,822237317.542400,3437091024.045000,675941,113900,314807,1104648
2019-12-19,FINRA / Nasdaq TRF Chicago (DB),2910958,1006344,3325127,7242429,102498974.947500,45877942.977000,262681583.207600,411058501.132100,11411,3035,16876,31322
2019-12-19,FINRA / NYSE TRF (DN),265433625,97071374,309925862,672430861,6120201827.098101,4674643372.621999,11414142775.028392,22208987974.748492,645384,194080,719835,1559299
2019-12-19,FINRA / Nasdaq TRF Carteret (DQ),1201327011,397253073,753129283,2351709367,49409130468.713791,30509301626.518791,38701037911.174294,118619470006.406876,3790614,745171,2460585,6996370
2019-12-19,EDGA Equities (J),92414090,19002715,47418616,158835421,3586195127.065500,1113727823.038500,2147976803.706200,6847899753.810200,1030348,109566,573678,1713592
2019-12-19,EDGX Equities (K),166158265,58897468,162996914,388052647,5267053950.356500,3509153270.951999,6064072054.735503,14840279276.044002,1269748,220691,988305,2478744
2019-12-19,NYSE Chicago (M),12850468,20693500,8071352,41615320,642118282.525100,3082193217.773600,1465511251.199100,5189822751.497800,12620,1968,7516,22104
2019-12-19,NYSE (N),972222037,31885040,35750526,1039857603,44522425466.282899,2056904176.445500,1659354828.739900,48238684471.468299,2656418,77209,246116,2979743
2019-12-19,NYSE Arca (P),162642975,190886709,144561561,498091245,6626471735.988599,12278132288.541203,6806035912.156501,25710639936.686303,1548642,465538,1254629,3268809
2019-12-19,NASDAQ (Q),357712170,132576813,653208675,1143497658,16036891834.915001,7911310607.521800,35549191736.950995,59497394179.387796,3621374,478400,4089540,8189314
2019-12-19,IEX (V),113045532,17704371,67105995,197855898,5052205051.022300,1062806084.918600,3438248357.398001,9553259493.338901,909437,79684,539309,1528430
2019-12-19,NASDAQ PSX (X),18060870,16395015,12696090,47151975,631823918.370300,954101342.642900,766109441.330100,2352034702.343300,140419,52944,105657,299020
2019-12-19,BYX Equities (Y),94188407,43208722,51852357,189249486,3015326221.372900,2206642556.255000,1925174397.732600,7147143175.360500,982066,195582,545801,1723449
2019-12-19,BZX Equities (Z),193628968,61801186,134339623,389769777,8778030605.664499,4042164927.228499,7743929503.421202,20564125036.314200,1808353,237661,1213633,3259647
2019-12-18,NYSE American (A),6339436,13743321,3492444,23575201,250366848.040900,177742182.146300,165932656.117400,594041686.304600,63835,48746,34824,147405
2019-12-18,NASDAQ BX (B),45862620,23587352,23015819,92465791,1721134592.003500,1254052560.945300,1208866281.725500,4184053434.674300,439745,161049,258037,858831
2019-12-18,NYSE National (C),82459060,28352376,30166015,140977451,1681168888.690300,1000681028.801900,795083565.792800,3476933483.285000,654079,116532,300419,1071030
2019-12-18,FINRA / Nasdaq TRF Chicago (DB),3337787,881664,2949487,7168938,128799413.815300,39943367.875500,227749090.667900,396491872.358700,11966,2972,15359,30297
2019-12-18,FINRA / NYSE TRF (DN),281881775,89154335,381807172,752843282,7255425410.426201,3155687789.668100,10340560052.287705,20751673252.382006,645389,198204,692844,1536437
2019-12-18,FINRA / Nasdaq TRF Carteret (DQ),1326834626,388580652,868044431,2583459709,55791662578.334624,23521706490.538505,40845995087.363403,120159364156.236532,3918302,897946,2369337,7185585
2019-12-18,EDGA Equities (J),98847464,19661108,53625091,172133663,3758317722.983100,1033315238.769500,2202891247.256800,6994524209.009400,1061789,109066,570155,1741010
2019-12-18,EDGX Equities (K),176603977,62411784,182520767,421536528,5595969898.016600,3223016735.999899,5700878229.469100,14519864863.485599,1306009,229707,983932,2519648
2019-12-18,NYSE Chicago (M),13548290,18375166,8692830,40616286,854999129.906900,1936734456.729700,1922223207.834501,4713956794.471101,31057,1978,8753,41788
2019-12-18,NYSE (N),984390337,33451123,33992942,1051834402,44773900683.599602,1867193171.119100,1553910696.342500,48195004551.061202,2719695,81996,236194,3037885
2019-12-18,NYSE Arca (P),178620521,210913020,168927186,558460727,7200079645.776400,12380330661.076301,6505226666.028498,26085636972.881199,1639785,470240,1239249,3349274
2019-12-18,NASDAQ (Q),385692252,132261602,707118838,1225072692,17517100931.934000,7441474479.125298,35656720991.511496,60615296402.570794,3771609,510467,4100667,8382743
2019-12-18,IEX (V),119487347,17486005,63529088,200502440,5308895848.082301,1045296204.928600,3402579837.099700,9756771890.110601,840650,92932,496044,1429626
2019-12-18,NASDAQ PSX (X),19908861,14815942,12566175,47290978,692723704.954300,879460581.751300,734210999.055200,2306395285.760800,152660,55839,105554,314053
2019-12-18,BYX Equities (Y),100637240,43558838,59428685,203624763,3073902811.311600,2037755749.693500,1826383914.858300,6938042475.863400,963626,196642,516732,1677000
2019-12-18,BZX Equities (Z),205506429,64575555,142458931,412540915,9225901198.995000,3960175846.321200,7520376530.175400,20706453575.491600,1884223,253757,1210670,3348650
2019-12-17,NYSE American (A),6206156,16113019,3243827,25563002,260171696.982000,210033454.061400,145956952.702400,616162103.745800,67155,49490,35382,152027
2019-12-17,NASDAQ BX (B),47707095,25410216,22787359,95904670,1767769330.235600,1210171525.075400,1230581200.971000,4208522056.282000,475117,167230,272451,914798
2019-12-17,NYSE National (C),86359094,32693408,30539500,149592002,1810722031.944900,1182968164.608000,798862114.124700,3792552310.677600,695620,127319,309186,1132125
2019-12-17,FINRA / Nasdaq TRF Chicago (DB),2843547,1113453,3147308,7104308,116550410.005500,46344541.064100,208764215.088300,371659166.157900,12153,3157,15990,31300
2019-12-17,FINRA / NYSE TRF (DN),258583082,96354368,274487499,629424949,7287100258.549696,3197512511.996700,9708287055.262600,20192899825.808996,641187,205383,682078,1528648
2019-12-17,FINRA / Nasdaq TRF Carteret (DQ),1183523668,466914765,768762234,2419200667,49391452335.128402,30560656268.630996,36462547099.983403,116414655703.742801,4056929,845206,2508467,7410602
2019-12-17,EDGA Equities (J),99911408,21758250,48597187,170266845,3876082210.244400,1116673353.365400,2175055591.776200,7167811155.386000,1116385,115016,592722,1824123
2019-12-17,EDGX Equities (K),178599518,66582020,164179593,409361131,5950377450.363200,3382113956.446699,5802908949.615402,15135400356.425301,1365890,239059,1036120,2641069
2019-12-17,NYSE Chicago (M),22735872,16657193,10336094,49729159,2485075381.946200,1988759638.099800,1950527894.391701,6424362914.437701,23806,1960,8030,33796
2019-12-17,NYSE (N),935922273,33215833,34341637,1003479743,42171957088.094498,1910162308.756600,1652560368.404500,45734679765.255598,2871458,82243,246738,3200439
2019-12-17,NYSE Arca (P),183471621,208599465,146197208,538268294,7512013119.794100,12110540510.986799,6777118362.136198,26399671992.917097,1661950,503073,1302689,3467712
2019-12-17,NASDAQ (Q),389569093,142744035,620898933,1153212061,17636300007.590200,8108811836.621800,34397398493.835405,60142510338.047405,3969116,505501,4194924,8669541
2019-12-17,IEX (V),113227178,20280790,65220754,198728722,4970394521.806501,1213533782.065600,3503378474.516000,9687306778.388101,898611,93616,535374,1527601
2019-12-17,NASDAQ PSX (X),22245348,15847174,12582270,50674792,767061382.483600,898042823.098300,727974564.354400,2393078769.936300,151514,54084,105982,311580
2019-12-17,BYX Equities (Y),106420449,50755328,51670906,208846683,3276594952.871400,2494329835.846999,1896376356.955000,7667301145.673399,1073547,220414,566382,1860343
2019-12-17,BZX Equities (Z),205619701,70006370,125465170,401091241,9389543685.803498,4340854763.174802,7408613220.579001,21139011669.557301,1924568,257130,1224002,3405700
2019-12-16,NYSE American (A),6426643,17591317,3439587,27457547,264461427.358000,206399195.458000,168244238.644600,639104861.460600,69063,54657,38433,162153
2019-12-16,NASDAQ BX (B),44340860,24241309,23057641,91639810,1692478414.186300,1402610221.342500,1300674015.534400,4395762651.063200,449979,169913,276100,895992
2019-12-16,NYSE National (C),84618034,30589974,31338283,146546291,1671494246.124000,1123558213.445600,850426498.981200,3645478958.550800,714265,126234,345877,1186376
2019-12-16,FINRA / Nasdaq TRF Chicago (DB),3368530,1310284,3631350,8310164,135378392.744100,65532117.502300,290720880.972400,491631391.218800,13278,4281,20027,37586
2019-12-16,FINRA / NYSE TRF (DN),339239525,95633600,261673074,696546199,17492618399.522091,4052179912.536000,11404187334.970801,32948985647.028892,682495,219745,766163,1668403
2019-12-16,FINRA / Nasdaq TRF Carteret (DQ),1201895299,417353887,746769572,2366018758,49091953622.240506,28805626470.726499,38213044902.949491,116110624995.916496,4024881,821746,2580631,7427258
2019-12-16,EDGA Equities (J),100700190,19972976,46878085,167551251,3656545150.980800,1181165928.501200,2223238136.396900,7060949215.878900,1137903,116402,616381,1870686
2019-12-16,EDGX Equities (K),173768602,72154983,142608899,388532484,5847011472.836801,4165251469.649398,6616090280.208501,16628353222.694700,1377048,276174,1103311,2756533
2019-12-16,NYSE Chicago (M),25175970,15863041,11884695,52923706,2591062134.801100,2247676181.223000,2226289956.444800,7065028272.468900,27509,2978,10093,40580
2019-12-16,NYSE (N),1071325673,32612485,35938681,1139876839,48298288133.006295,2025198100.818500,1694139998.549500,52017626232.374295,2927237,88702,264968,3280907
2019-12-16,NYSE Arca (P),178860806,249428887,138550963,566840656,7275165014.067199,16840058355.309295,7649978379.247597,31765201748.624091,1681002,576860,1398001,3655863
2019-12-16,NASDAQ (Q),397130021,148164237,665296041,1210590299,17882135188.384794,9010697151.874899,39278296627.893208,66171128968.152901,4017168,578226,4498932,9094326
2019-12-16,IEX (V),117963089,19867102,68102689,205932880,5162702428.928400,1193851218.169000,3905751126.578197,10262304773.675597,955979,95338,582511,1633828
2019-12-16,NASDAQ PSX (X),18913686,16627600,12850772,48392058,683933495.490600,1086003051.401300,764078580.651900,2534015127.543800,152415,62010,110225,324650
2019-12-16,BYX Equities (Y),102201606,52042733,48883349,203127688,3186336876.439300,2553586185.700400,2024413785.946800,7764336848.086500,1054210,236799,567110,1858119
2019-12-16,BZX Equities (Z),204275673,68710394,127150624,400136691,9131454776.883599,4766383035.481399,8063270273.320000,21961108085.684998,1906415,278604,1301900,3486919
2019-12-13,NYSE American (A),6573433,16340150,3452078,26365661,264338280.454900,247605631.068700,184726853.398300,696670764.921900,68541,52949,36743,158233
2019-12-13,NASDAQ BX (B),46801190,33822402,24025515,104649107,1693604213.339700,1958832681.518898,1431140996.755300,5083577891.613898,446326,265629,295315,1007270
2019-12-13,NYSE National (C),87929136,39774842,31268258,158972236,1788773767.240500,1493126249.875300,892043304.633000,4173943321.748800,720863,166839,323780,1211482
2019-12-13,FINRA / Nasdaq TRF Chicago (DB),2880216,1670578,2932968,7483762,101644126.765600,84978712.997000,235153036.206600,421775875.969200,11957,4489,17157,33603
2019-12-13,FINRA / NYSE TRF (DN),286973010,117709620,245382945,650065575,8482128236.625503,4105637411.165400,11836058838.217596,24423824486.008499,634634,209096,695653,1539383
2019-12-13,FINRA / Nasdaq TRF Carteret (DQ),1106432858,397523740,674892889,2178849487,43531386221.988312,23914890935.563995,35682613044.128895,103128890201.681202,3861632,823811,2455288,7140731
2019-12-13,EDGA Equities (J),111470272,26195368,47520342,185185982,3824591095.461200,1456619998.478800,2350317046.252700,7631528140.192700,1101740,157717,562693,1822150
2019-12-13,EDGX Equities (K),181666594,99296733,143864486,424827813,5599149118.731999,5837207311.624802,7452987227.470103,18889343657.826904,1350872,389760,1081586,2822218
2019-12-13,NYSE Chicago (M),19595918,24063805,4500256,48159979,2388223317.998400,1833502580.472500,617353738.929900,4839079637.400800,40400,2561,7082,50043
2019-12-13,NYSE (N),844464364,61222268,38995017,944681649,36453446739.663599,3559432258.537100,2262580592.436000,42275459590.636699,2938872,145840,279279,3363991
2019-12-13,NYSE Arca (P),183504379,317512690,146817185,647834254,7249382045.224202,20557979075.302406,8751905324.721095,36559266445.247703,1666383,862866,1391053,3920302
2019-12-13,NASDAQ (Q),419709360,234702189,591284625,1245696174,18446279535.559589,14477096007.915709,35958300106.135595,68881675649.610893,4245000,901433,4512553,9658986
2019-12-13,IEX (V),112083593,23144959,61481287,196709839,4781802155.997099,1364091246.067000,3567712397.231301,9713605799.295400,845166,102220,502679,1450065
2019-12-13,NASDAQ PSX (X),20408961,26699227,14261933,61370121,693285034.893200,1737667090.440600,988659464.333500,3419611589.667300,157378,103185,128418,388981
2019-12-13,BYX Equities (Y),108290800,68961279,52552461,229804540,3284389844.865900,3414736107.789200,2228334827.512200,8927460780.167300,1077170,319852,580517,1977539
2019-12-13,BZX Equities (Z),218871621,104459941,136398891,459730453,9837562750.642899,7763448680.417103,9761386972.990602,27362398404.050604,1966700,441401,1344248,3752349
2019-12-12,NYSE American (A),6911960,15250872,3518522,25681354,281694616.021900,254012005.872600,200418656.443500,736125278.338000,78702,56079,44993,179774
2019-12-12,NASDAQ BX (B),51879118,42428969,27405277,121713364,1933685348.636500,2286782798.674600,1585981183.249700,5806449330.560800,509208,296058,344004,1149270
2019-12-12,NYSE National (C),98086554,44747722,35287135,178121411,1981277572.941200,1603812868.388600,972731603.035400,4557822044.365200,791302,187567,365227,1344096
2019-12-12,FINRA / Nasdaq TRF Chicago (DB),3418139,1478614,3446716,8343469,122316021.866800,61816896.196400,278182257.816100,462315175.879300,12708,4763,18379,35850
2019-12-12,FINRA / NYSE TRF (DN),317393008,130926198,281346679,729665885,10475395633.558600,4508276136.404001,12692410078.239595,27676081848.202196,682766,238710,748536,1670012
2019-12-12,FINRA / Nasdaq TRF Carteret (DQ),1164182160,409509831,697112821,2270804812,46184960135.882500,25541377114.171186,35265644083.458088,106991981333.511774,4123288,882885,2643478,7649651
2019-12-12,EDGA Equities (J),115837541,30426693,51799381,198063615,3956929965.606100,1657451277.713500,2509762744.523600,8124143987.843200,1182469,171992,617464,1971925
2019-12-12,EDGX Equities (K),192799205,111810760,159919097,464529062,6179307485.764500,6733026628.684203,7845468743.081400,20757802857.530103,1474062,439320,1182164,3095546
2019-12-12,NYSE Chicago (M),26761193,17732339,5072797,49566329,3469296002.447704,1515990797.720000,452788426.025000,5438075226.192704,21492,3303,8596,33391
2019-12-12,NYSE (N),892715024,67130936,40887075,1000733035,39346350329.313903,4155865539.746000,2168966239.578101,45671182108.638004,3286642,160031,305871,3752544
2019-12-12,NYSE Arca (P),196333057,369345757,164263667,729942481,7942191818.434601,24474318165.517302,9498670204.888704,41915180188.840607,1835954,976663,1552085,4364702
2019-12-12,NASDAQ (Q),445761759,248190917,634979871,1328932547,19631380982.844007,15366249422.815899,38073645144.643703,73071275550.303609,4592678,983054,4966721,10542453
2019-12-12,IEX (V),115065112,24643468,66419383,206127963,5035538704.154700,1383505042.530500,3679842314.164499,10098886060.849699,899744,105544,534913,1540201
2019-12-12,NASDAQ PSX (X),22254573,27770079,16203705,66228357,785608927.362000,1827554515.281500,1118802734.488400,3731966177.131900,170832,107728,142242,420802
2019-12-12,BYX Equities (Y),117452230,73314131,58431953,249198314,3609258128.928200,3742738987.687502,2564727055.855300,9916724172.471002,1173242,339001,650504,2162747
2019-12-12,BZX Equities (Z),236354384,116732254,150310003,503396641,10660599896.374898,8393467201.830902,10085860286.985199,29139927385.190999,2145915,470301,1452776,4068992
2019-12-11,NYSE American (A),5936656,20302591,2929781,29169028,251099225.706400,184045189.539100,143994222.465300,579138637.710800,62452,65820,31846,160118
2019-12-11,NASDAQ BX (B),40483033,27241177,22086872,89811082,1546199638.524700,1308864220.061400,1094369267.265400,3949433125.851500,400151,175710,239812,815673
2019-12-11,NYSE National (C),74145318,31667678,27802875,133615871,1498779113.376600,1084587061.494700,677620924.307900,3260987099.179200,613522,133369,287108,1033999
2019-12-11,FINRA / Nasdaq TRF Chicago (DB),2359099,1265231,2593962,6218292,90190396.485300,47390813.632000,169594496.313700,307175706.431000,10103,3875,13614,27592
2019-12-11,FINRA / NYSE TRF (DN),236743748,115923873,222481645,575149266,7521761994.978599,3256032164.959600,8339877694.840501,19117671854.778700,565653,217054,616818,1399525
2019-12-11,FINRA / Nasdaq TRF Carteret (DQ),992157017,375898882,614313984,1982369883,41079809418.458599,21067033912.570598,28875761992.072795,91022605323.101992,3518139,732684,2204024,6454847
2019-12-11,EDGA Equities (J),84614006,19038009,39317588,142969603,3153888592.125300,956847035.348400,1754175654.119000,5864911281.592700,923748,106380,477405,1507533
2019-12-11,EDGX Equities (K),151890476,73446448,129120455,354457379,4830276248.878599,3411694795.585498,5157300457.580701,13399271502.044798,1177398,267117,907611,2352126
2019-12-11,NYSE Chicago (M),18859596,11252216,6029452,36141264,1768481510.935600,1658030550.727500,651767069.157100,4078279130.820200,19962,2457,6045,28464
2019-12-11,NYSE (N),753216703,35400257,30870635,819487595,34219767623.469598,2075067213.844600,1459972778.634300,37754807615.948498,2561150,87450,219222,2867822
2019-12-11,NYSE Arca (P),155063845,227527864,127448655,510040364,6326394255.620899,12872846601.042996,6279631841.812900,25478872698.476795,1466882,549395,1217035,3233312
2019-12-11,NASDAQ (Q),354642718,150136348,533295234,1038074300,15673773865.952902,7911673555.900097,29031107920.541992,52616555342.394991,3521102,580963,3826093,7928158
2019-12-11,IEX (V),100293618,18636743,58519830,177450191,4577801067.220900,1007509788.523900,3053560378.231401,8638871233.976201,742405,85838,444192,1272435
2019-12-11,NASDAQ PSX (X),17578320,14827995,11723785,44130100,613483373.909900,848393077.055000,673794064.012800,2135670514.977700,138077,51971,100088,290136
2019-12-11,BYX Equities (Y),91943455,48670493,47100881,187714829,3015885168.223400,2142747051.715000,1831060056.609200,6989692276.547600,945623,214227,504600,1664450
2019-12-11,BZX Equities (Z),177727734,64485715,106449026,348662475,7630132516.706802,3893529091.904000,6110702542.283600,17634364150.894402,1628577,267352,1060672,2956601
2019-12-10,NYSE American (A),5192005,13923353,2690543,21805901,210760209.961100,140982258.697700,129469971.745200,481212440.404000,55019,45392,30694,131105
2019-12-10,NASDAQ BX (B),41717186,25272367,20443628,87433181,1406787063.351000,1132472501.826400,1043894930.011200,3583154495.188600,404000,161583,245623,811206
2019-12-10,NYSE National (C),75450033,24928491,27033005,127411529,1516532316.560000,857550498.191400,705343085.729700,3079425900.481100,643680,104866,302890,1051436
2019-12-10,FINRA / Nasdaq TRF Chicago (DB),2460278,919745,3043449,6423472,73265216.450700,38855465.536600,224712880.289300,336833562.276600,9965,3213,15872,29050
2019-12-10,FINRA / NYSE TRF (DN),248033475,97742980,239649225,585425680,6189382422.222900,3048555379.553699,8891493270.075099,18129431071.851698,562990,180651,638741,1382382
2019-12-10,FINRA / Nasdaq TRF Carteret (DQ),1031600710,337859907,647617746,2017078363,39331048291.050005,19663069347.813503,30034392241.318685,89028509880.182193,3653790,654983,2283138,6591911
2019-12-10,EDGA Equities (J),91410596,18085692,41883152,151379440,3317389184.174800,886407149.434200,1826487782.145000,6030284115.754000,1070312,103134,558063,1731509
2019-12-10,EDGX Equities (K),153798930,63790103,136757550,354346583,4681394742.388400,3292785747.180399,5501643404.860602,13475823894.429401,1283522,232817,1026434,2542773
2019-12-10,NYSE Chicago (M),21267969,13025108,6053445,40346522,2114214528.983801,1551072327.339900,552827709.391500,4218114565.715201,13619,1732,6796,22147
2019-12-10,NYSE (N),779950591,31070066,30642215,841662872,34012974117.889498,1912345156.003500,1492056751.906800,37417376025.799798,2737287,81470,228060,3046817
2019-12-10,NYSE Arca (P),156781431,184099918,134591447,475472796,6297643110.588402,10877867182.573603,6520820120.395701,23696330413.557706,1597846,495348,1318886,3412080
2019-12-10,NASDAQ (Q),353922970,138166471,538932359,1031021800,15240741876.163300,7621749787.238702,28255635428.388705,51118127091.790707,3720465,536392,4005294,8262151
2019-12-10,IEX (V),96767662,18395117,56483387,171646166,4145956498.074500,898014306.074300,3033083253.036400,8077054057.185200,748315,76819,440766,1265900
2019-12-10,NASDAQ PSX (X),17212449,13930649,11746662,42889760,603970649.157200,898803684.741500,716361425.387800,2219135759.286500,137263,58595,99273,295131
2019-12-10,BYX Equities (Y),93631037,40924493,50814779,185370309,2899017914.757900,1923077384.357300,1825864527.638200,6647959826.753400,1042011,189345,565827,1797183
2019-12-10,BZX Equities (Z),177120061,61517316,110381954,349019331,7778339672.863200,3954317807.276799,6618132322.201999,18350789802.341998,1722924,250615,1150263,3123802
2019-12-09,NYSE American (A),5864233,14542524,3240504,23647261,196090926.918100,161191957.776500,127559214.775800,484842099.470400,62075,45439,35459,142973
2019-12-09,NASDAQ BX (B),39779239,20875550,19962464,80617253,1289031665.454100,927151266.958200,1048239649.460100,3264422581.872400,370604,134060,221824,726488
2019-12-09,NYSE National (C),70656268,22149122,24614906,117420296,1349712920.867700,762822624.077800,636961892.528100,2749497437.473600,592850,101239,272876,966965
2019-12-09,FINRA / Nasdaq TRF Chicago (DB),2729444,1183378,2921187,6834009,91841758.603600,43370620.782400,207349676.795500,342562056.181500,11514,3271,15441,30226
2019-12-09,FINRA / NYSE TRF (DN),243656586,90319768,239878582,573854936,6095497939.164300,2942461542.702400,8990572346.177300,18028531828.044000,607681,192984,651916,1452581
2019-12-09,FINRA / Nasdaq TRF Carteret (DQ),1058502559,353001970,683803160,2095307689,41858148397.034802,17847756601.879098,31925037865.530293,91630942864.444193,3555208,685919,2309132,6550259
2019-12-09,EDGA Equities (J),84067443,16135771,41858619,142061833,3015822889.281400,759501594.010800,1784308549.710900,5559633033.003100,972475,94703,528593,1595771
2019-12-09,EDGX Equities (K),149675442,58408228,134799387,342883057,4257531025.292800,2679679663.365301,5175555952.481801,12112766641.139902,1193917,205103,971709,2370729
2019-12-09,NYSE Chicago (M),17517545,11184446,4689780,33391771,1366210244.705600,1429882003.631500,713223204.640600,3509315452.977700,9228,1509,7049,17786
2019-12-09,NYSE (N),860565751,22998605,30303789,913868145,36019395553.756304,1381976130.395600,1374153338.845100,38775525022.997004,2603019,67069,230453,2900541
2019-12-09,NYSE Arca (P),153298064,178702393,135692133,467692590,5860114095.165199,9941866454.387299,6527423211.360098,22329403760.912596,1534397,454498,1327893,3316788
2019-12-09,NASDAQ (Q),333116107,118514421,571994983,1023625511,13788076128.322704,6300117401.342398,30120686828.017906,50208880357.683008,3428966,467733,3976538,7873237
2019-12-09,IEX (V),99126063,13093378,57191194,169410635,3941597009.668900,802239311.124200,3139720432.756900,7883556753.550000,737690,68450,448891,1255031
2019-12-09,NASDAQ PSX (X),16674190,11484295,11727557,39886042,630594525.248800,632299128.486100,663413282.296400,1926306936.031300,127619,47663,94181,269463
2019-12-09,BYX Equities (Y),91006755,38577404,51882224,181466383,2691805663.621200,1670006269.594300,1716502880.619200,6078314813.834700,962530,176171,545363,1684064
2019-12-09,BZX Equities (Z),174241916,52939140,109311184,336492240,7328551759.069001,3177093525.900001,6268062193.787801,16773707478.756803,1634260,208213,1099685,2942158
2019-12-06,NYSE American (A),5488303,16620954,2832509,24941766,210529460.646800,215023084.976200,162779938.807800,588332484.430800,61911,50596,36718,149225
2019-12-06,NASDAQ BX (B),44534562,27149966,22816817,94501345,1540602445.929200,1216304988.942100,1220948852.176200,3977856287.047500,439695,167319,264374,871388
2019-12-06,NYSE National (C),77072673,34792085,27565570,139430328,1519797283.079600,1149199858.376000,721917432.433500,3390914573.889100,647275,134668,298399,1080342
2019-12-06,FINRA / Nasdaq TRF Chicago (DB),2845880,1405592,2720063,6971535,100002254.392600,56761362.839200,207045882.300500,363809499.532300,11457,3816,14122,29395
2019-12-06,FINRA / NYSE TRF (DN),257685169,109896251,226422423,594003843,6969258434.997198,3291806874.769401,9320613487.413800,19581678797.180399,599156,215414,643286,1457856
2019-12-06,FINRA / Nasdaq TRF Carteret (DQ),1043722997,359039910,654781247,2057544154,40787210356.764405,19254820115.127199,30658281475.248393,90700311947.139997,3675603,789055,2286516,6751174
2019-12-06,EDGA Equities (J),95744047,24061674,44880424,164686145,3717628439.550200,1205164190.816200,2241108735.769400,7163901366.135800,1108886,128334,583089,1820309
2019-12-06,EDGX Equities (K),163029441,82702620,126836150,372568211,4878389387.870200,4181030373.693700,5808402030.903701,14867821792.467601,1268149,286124,979719,2533992
2019-12-06,NYSE Chicago (M),8190328,9011910,2508116,19710354,744118264.054600,1730863923.919200,292104391.351900,2767086579.325700,18028,2304,7631,27963
2019-12-06,NYSE (N),850417340,40089062,30801442,921307844,37409572672.689500,2205163668.373600,1479732706.029300,41094469047.092400,2786123,99853,236543,3122519
2019-12-06,NYSE Arca (P),161075231,261119927,126867397,549062555,6211638397.616399,14208377092.424594,6266285766.472900,26686301256.513893,1539917,596926,1233803,3370646
2019-12-06,NASDAQ (Q),360642301,160730216,554867395,1076239912,15434656707.046607,8605427302.419401,31865583780.168912,55905667789.634920,3677459,589419,4013385,8280263
2019-12-06,IEX (V),103381522,18166240,57243663,178791425,4512077427.549800,1003154286.113400,3161249423.646500,8676481137.309700,807598,87498,475107,1370203
2019-12-06,NASDAQ PSX (X),16907465,18137984,11388508,46433957,568617406.885500,1001752274.075700,767303772.570600,2337673453.531800,131967,67757,93250,292974
2019-12-06,BYX Equities (Y),98994243,53247528,50491765,202733536,3012655758.557000,2462992906.289600,1938080466.622200,7413729131.468800,1027738,232168,544430,1804336
2019-12-06,BZX Equities (Z),193581295,74999787,114003620,382584702,8495592110.115397,4442358849.300100,7513487649.157598,20451438608.573095,1815736,277076,1170304,3263116
2019-12-05,NYSE American (A),4997503,14934174,2799770,22731447,202413538.397700,167856006.977600,130218935.227400,500488480.602700,51735,48023,30014,129772
2019-12-05,NASDAQ BX (B),40416155,33340695,21040269,94797119,1382489847.228500,1303185351.416700,1107534951.405400,3793210150.050600,393643,176593,265071,835307
2019-12-05,NYSE National (C),70803705,29840876,25382934,126027515,1390424036.408300,1003308762.278900,675006855.491200,3068739654.178400,579925,122077,270396,972398
2019-12-05,FINRA / Nasdaq TRF Chicago (DB),2754312,1250333,2940344,6944989,112976273.087500,53562311.625500,190657404.111300,357195988.824300,10558,3809,15312,29679
2019-12-05,FINRA / NYSE TRF (DN),262904974,102570742,239171681,604647397,6426067200.069401,3099121346.532800,8154824357.067394,17680012903.669595,553276,189112,624962,1367350
2019-12-05,FINRA / Nasdaq TRF Carteret (DQ),1025357142,304057895,703687340,2033102377,39884407055.070297,15499393869.614802,30198273704.821105,85582074629.506204,3531712,676595,2314747,6523054
2019-12-05,EDGA Equities (J),91439616,20407879,43601887,155449382,3444188018.196600,1009931661.248900,2192684375.346700,6646804054.792200,1035924,111325,576646,1723895
2019-12-05,EDGX Equities (K),161003158,76850437,126403216,364256811,4816911113.601801,3516966059.793199,5143303547.138399,13477180720.533399,1236101,246032,970137,2452270
2019-12-05,NYSE Chicago (M),12095229,9882218,3205170,25182617,796840824.157500,1171919942.303400,313451400.931200,2282212167.392100,25785,2082,7736,35603
2019-12-05,NYSE (N),786936328,38442324,32208611,857587263,34476697603.127004,2129186692.707400,1520588730.952600,38126473026.787004,2732737,90051,240960,3063748
2019-12-05,NYSE Arca (P),155819813,230253629,130656658,516730100,6215337668.684302,12592954959.983797,6224563522.753501,25032856151.421600,1476686,537663,1270267,3284616
2019-12-05,NASDAQ (Q),351436263,162985598,566315725,1080737586,15293994858.263301,8599793414.776900,29232743497.079888,53126531770.120089,3564845,592120,4093812,8250777
2019-12-05,IEX (V),98353185,16612102,57316614,172281901,4258525577.243500,929707894.846700,2825209655.035501,8013443127.125701,740984,74072,455654,1270710
2019-12-05,NASDAQ PSX (X),16231224,17990984,10823197,45045405,555707768.044700,960980369.912900,696023581.069900,2212711719.027500,126769,64439,92127,283335
2019-12-05,BYX Equities (Y),94888299,48344655,51218096,194451050,2967168800.624501,2155508110.472700,1787532419.003400,6910209330.100601,991851,207543,537867,1737261
2019-12-05,BZX Equities (Z),185050251,68951489,116615953,370617693,8128622958.159501,4125201238.635699,6616164713.871298,18869988910.666498,1713339,259058,1170103,3142500
2019-12-04,NYSE American (A),5779319,20298227,3010536,29088082,209820837.802400,195253911.715400,146408726.254400,551483475.772200,61003,51542,32830,145375
2019-12-04,NASDAQ BX (B),50643486,34875487,24230425,109749398,1835466610.133100,1445644056.949600,1318515749.367000,4599626416.449700,526509,173442,302093,1002044
2019-12-04,NYSE National (C),79713299,34529302,26994575,141237176,1518735990.506300,1147433015.512700,693134466.089600,3359303472.108600,646294,147516,278997,1072807
2019-12-04,FINRA / Nasdaq TRF Chicago (DB),2299668,1149451,2602398,6051517,100376179.419500,56385202.324500,195560519.513000,352321901.257000,10156,3887,14627,28670
2019-12-04,FINRA / NYSE TRF (DN),282591874,123043569,245104227,650739670,6581637107.822898,3772038266.284299,9068448259.155703,19422123633.262900,586861,209051,633055,1428967
2019-12-04,FINRA / Nasdaq TRF Carteret (DQ),1064169097,343051489,664817113,2072037699,41202512179.819391,16878077048.550198,29031001769.739004,87111590998.108593,3876501,742563,2379408,6998472
2019-12-04,EDGA Equities (J),100868490,22315070,46109102,169292662,3688114014.047200,1100296759.672200,2040931599.887000,6829342373.606400,1135960,124094,594198,1854252
2019-12-04,EDGX Equities (K),171115923,86415663,128805299,386336885,4927525331.356999,3832033052.580299,5513424142.297101,14272982526.234399,1296280,277884,1018093,2592257
2019-12-04,NYSE Chicago (M),14160023,8672497,4805751,27638271,1047851761.611400,976102970.225000,380194946.396500,2404149678.232900,17598,2032,6945,26575
2019-12-04,NYSE (N),934384464,33752131,30684802,998821397,39801665165.578801,1854868952.611900,1420741261.351900,43077275379.542601,2931301,90497,237942,3259740
2019-12-04,NYSE Arca (P),165535271,274919413,134725733,575180417,6401842416.531201,14991485370.810998,6602843696.174105,27996171483.516304,1585060,578080,1341178,3504318
2019-12-04,NASDAQ (Q),388111320,169274782,606332658,1163718760,16641516960.030095,8673885471.230206,32271848517.718416,57587250948.978717,3876079,610567,4306850,8793496
2019-12-04,IEX (V),116442616,22506203,58644771,197593590,4870487039.963200,1148350152.429300,2951661067.947900,8970498260.340400,855044,91167,481195,1427406
2019-12-04,NASDAQ PSX (X),15598529,18078892,10298501,43975922,525830395.510600,987299848.716100,644140039.974500,2157270284.201200,126075,67976,90035,284086
2019-12-04,BYX Equities (Y),112048670,55983064,57114706,225146440,3236723830.167500,2383733720.295100,1936315881.317500,7556773431.780100,1118736,227826,591295,1937857
2019-12-04,BZX Equities (Z),199525437,73133350,114596873,387255660,8413816771.603302,4417890408.639199,6522313749.764400,19354020930.006901,1853921,281442,1196895,3332258
2019-12-03,NYSE American (A),5517395,17350287,3218048,26085730,221988055.065200,223189286.219500,180462768.931800,625640110.216500,58344,56518,35598,150460
2019-12-03,NASDAQ BX (B),46755554,47529564,27249301,121534419,1641792006.462400,1878083940.081000,1527766404.524000,5047642351.067400,473729,271572,333553,1078854
2019-12-03,NYSE National (C),79741367,38193766,30268884,148204017,1603685945.400100,1337253193.967200,805724294.963700,3746663434.331000,672240,163988,318751,1154979
2019-12-03,FINRA / Nasdaq TRF Chicago (DB),2816522,1700025,3405814,7922361,112075821.589100,70888012.831800,268813470.710000,451777305.130900,14968,7350,19495,41813
2019-12-03,FINRA / NYSE TRF (DN),268702991,130357052,260632583,659692626,6446938129.678304,4364484606.434799,10318597380.905604,21130020117.018707,624803,271889,702385,1599077
2019-12-03,FINRA / Nasdaq TRF Carteret (DQ),1097473129,429630415,683703461,2210807005,42993675678.993504,23431299483.404092,34380343958.233597,100805319120.631193,4000125,1146018,2597522,7743665
2019-12-03,EDGA Equities (J),106924188,27562263,52494728,186981179,3750395302.651800,1444425510.041000,2346478844.026400,7541299656.719200,1214080,168571,648784,2031435
2019-12-03,EDGX Equities (K),170646914,99791413,145574165,416012492,5438268461.181902,5050604583.134206,6786575177.891699,17275448222.207807,1378607,377607,1098129,2854343
2019-12-03,NYSE Chicago (M),13323705,10148840,5755788,29228333,764342369.998600,1157798507.545000,721113293.572500,2643254171.116100,15541,2892,7653,26086
2019-12-03,NYSE (N),859431988,47482563,36673521,943588072,38255143103.677999,2940870812.123900,1893092835.268900,43089106751.070799,3194685,130923,280121,3605729
2019-12-03,NYSE Arca (P),171024920,328753170,154725795,654503885,6786101798.741101,19287123372.809705,8326734758.679600,34399959930.230406,1646066,861757,1476073,3983896
2019-12-03,NASDAQ (Q),403483721,230689467,640523459,1274696647,17700957107.070502,12826516362.056004,35644814128.035892,66172287597.162398,4026177,874899,4717657,9618733
2019-12-03,IEX (V),105165559,21780729,61975834,188922122,4258259880.683800,1416041535.703900,3100327868.765501,8774629285.153201,801451,106240,494620,1402311
2019-12-03,NASDAQ PSX (X),16179408,25632535,13206386,55018329,603112060.464800,1503680526.940000,900593969.864100,3007386557.268900,140667,104909,112264,357840
2019-12-03,BYX Equities (Y),112563586,71273331,62347528,246184445,3331754532.545700,3321999835.273700,2320279956.899801,8974034324.719201,1186693,334639,653042,2174374
2019-12-03,BZX Equities (Z),211834232,99377774,137006175,448218181,9475103988.595602,6386318595.935800,8308488621.624798,24169911206.156200,1999037,409420,1372430,3780887
2019-12-02,NYSE American (A),5026382,16489053,2879629,24395064,203913872.690200,196831802.913600,158972906.733900,559718582.337700,55789,64355,32715,152859
2019-12-02,NASDAQ BX (B),40936145,37770260,22167307,100873712,1526021848.549600,1716398618.493800,1288018537.659300,4530439004.702700,399093,208066,265053,872212
2019-12-02,NYSE National (C),78419861,34680778,29769419,142870058,1572866431.115300,1400175883.828700,790523987.875400,3763566302.819400,639402,169442,288431,1097275
2019-12-02,FINRA / Nasdaq TRF Chicago (DB),2479767,1558074,3254468,7292309,110710222.889300,71949909.800000,250999889.107100,433660021.796400,12770,5495,18929,37194
2019-12-02,FINRA / NYSE TRF (DN),223109550,103518383,261106900,587734833,5825116227.126899,3617012144.211403,10817903233.974000,20260031605.312302,576312,235886,719798,1531996
2019-12-02,FINRA / Nasdaq TRF Carteret (DQ),952234152,400452557,676394312,2029081021,38392535157.651404,24660267455.092510,34719489669.466292,97772292282.210206,3638661,864407,2449949,6953017
2019-12-02,EDGA Equities (J),95869714,27922024,44652363,168444101,3501869470.573400,1599114503.282100,2065787703.806599,7166771677.662099,1070290,167293,564595,1802178
2019-12-02,EDGX Equities (K),154756553,84299768,142746801,381803122,5196992985.048603,4931236503.465000,6640844494.061101,16769073982.574704,1302736,325663,1072924,2701323
2019-12-02,NYSE Chicago (M),10827421,11116506,5089284,27033211,831525850.116800,1563601751.393300,586771949.194500,2981899550.704600,10001,2599,8796,21396
2019-12-02,NYSE (N),784812036,41229173,33818431,859859640,35514474817.705102,2823138703.582398,1749517023.656200,40087130544.943700,2978646,116025,271228,3365899
2019-12-02,NYSE Arca (P),152744387,325615198,147718759,626078344,6123886995.218399,20359468954.268110,8082248675.901198,34565604625.387707,1533464,771893,1430021,3735378
2019-12-02,NASDAQ (Q),365845594,197073095,611111181,1174029870,16364599936.816303,12407545599.560800,35839543885.107582,64611689421.484685,3784331,775983,4495785,9056099
2019-12-02,IEX (V),106024612,21556173,60948766,188529551,4468377289.844299,1489648482.855800,3247062430.174400,9205088202.874499,949841,112776,542200,1604817
2019-12-02,NASDAQ PSX (X),15025385,22234628,12996254,50256267,574127984.785800,1492240310.063399,1016637223.643600,3083005518.492799,131763,88691,110676,331130
2019-12-02,BYX Equities (Y),101440359,61963952,58901201,222305512,3212869938.728400,3201008625.236200,2260548788.591000,8674427352.555600,1061381,279020,588794,1929195
2019-12-02,BZX Equities (Z),196201127,90426275,126754802,413382204,9038812090.886298,6430934724.965797,8209643630.226804,23679390446.078899,1921420,373235,1310095,3604750
2019-11-29,NYSE American (A),2757954,9372341,1487225,13617520,108090124.103100,104007395.880800,80823472.287500,292920992.271400,28949,29719,15872,74540
2019-11-29,NASDAQ BX (B),20761018,17944594,12386262,51091874,782295622.943600,712885561.351500,632350331.057600,2127531515.352700,202491,107188,120407,430086
2019-11-29,NYSE National (C),31948022,18663383,12706315,63317720,706196177.510800,634908021.175400,344638527.393800,1685742726.080000,278460,73868,129581,481909
2019-11-29,FINRA / Nasdaq TRF Chicago (DB),1483892,905453,1605853,3995198,60405625.029300,39713516.303100,104282182.535100,204401323.867500,6643,2780,8618,18041
2019-11-29,FINRA / NYSE TRF (DN),129327787,67958770,138556656,335843213,3040147921.256500,1562860166.161700,4645808845.109200,9248816932.527400,296889,120484,354387,771760
2019-11-29,FINRA / Nasdaq TRF Carteret (DQ),466249488,229459717,312539293,1008248498,18443229874.790598,13231630061.839692,14567133291.208101,46241993227.838391,1780155,453422,1121465,3355042
2019-11-29,EDGA Equities (J),51370817,14765491,21685322,87821630,1740678581.627400,685042716.179700,987478853.466300,3413200151.273400,529676,76340,260918,866934
2019-11-29,EDGX Equities (K),82366138,55605808,68764803,206736749,2710901062.159300,2339073964.469900,2806967223.403600,7856942250.032800,611717,174374,467146,1253237
2019-11-29,NYSE Chicago (M),2075147,4963097,1942303,8980547,226526233.133800,979932348.431701,299791986.883100,1506250568.448601,5294,1252,4622,11168
2019-11-29,NYSE (N),497266607,20283157,14742631,532292395,22177318358.860003,1069514896.465100,683914314.260700,23930747569.585803,1527702,52225,111659,1691586
2019-11-29,NYSE Arca (P),77835312,176673805,69899713,324408830,3134869616.299700,9728087641.986207,3405089067.146000,16268046325.431907,708565,384429,624726,1717720
2019-11-29,NASDAQ (Q),182964559,99509436,328224936,610698931,7946157575.136698,5235409092.764701,18196538303.458598,31378104971.359997,1788328,364223,2073790,4226341
2019-11-29,IEX (V),46272028,13723457,24460751,84456236,1898243645.884000,748268899.140200,1299874203.284300,3946386748.308500,391090,62791,224684,678565
2019-11-29,NASDAQ PSX (X),7728779,10563078,6103193,24395050,278971476.757200,576191588.991400,417369095.945800,1272532161.694400,61643,39145,47335,148123
2019-11-29,BYX Equities (Y),47514408,34117840,26022382,107654630,1426943013.861600,1486112885.249900,938558930.781600,3851614829.893100,473969,139085,249101,862155
2019-11-29,BZX Equities (Z),95500732,45988490,57967713,199456935,4304298150.767600,2694389591.726700,3733702478.693200,10732390221.187500,869321,165408,559787,1594516
2019-11-27,NYSE American (A),4179608,10746017,2269362,17194987,175991481.691500,139256732.645600,114031119.688500,429279334.025600,43951,40501,24334,108786
2019-11-27,NASDAQ BX (B),33331594,20594662,19998409,73924665,1286743929.389000,908705875.654400,915786060.246400,3111235865.289800,324291,133836,195023,653150
2019-11-27,NYSE National (C),54531876,20702708,23364931,98599515,1114081702.273700,728433387.929800,601613092.933200,2444128183.136700,442470,89261,228713,760444
2019-11-27,FINRA / Nasdaq TRF Chicago (DB),2872938,781311,2428562,6082811,129532980.184600,37369918.087000,181532070.056400,348434968.328000,12476,2896,13321,28693
2019-11-27,FINRA / NYSE TRF (DN),243187860,86247395,204586041,534021296,6370208102.302899,2974472346.131400,8398800635.955496,17743481084.389795,569565,169893,581323,1320781
2019-11-27,FINRA / Nasdaq TRF Carteret (DQ),922293341,265844274,524356750,1712494365,36051731635.501099,16830312639.545698,24526339482.358306,77408383757.405103,3362086,620896,2069146,6052128
2019-11-27,EDGA Equities (J),86819667,17428874,39832750,144081291,3131763596.328100,912601208.969300,1868356199.649600,5912721004.947000,910441,99728,469518,1479687
2019-11-27,EDGX Equities (K),147196234,57990715,122769594,327956543,5007229687.609098,2883434088.957000,5001673126.642200,12892336903.208298,1129772,209882,843365,2183019
2019-11-27,NYSE Chicago (M),9155649,10568212,4727475,24451336,1000057003.686300,1581516364.920400,743953243.481100,3325526612.087800,5794,1413,5753,12960
2019-11-27,NYSE (N),724463685,23119306,26549942,774132933,32902307883.492398,1428087872.114800,1264586592.208300,35594982347.815498,2494872,67540,195630,2758042
2019-11-27,NYSE Arca (P),140913507,182505363,115855723,439274593,5975235075.121598,11210429452.015300,5568845221.400900,22754509748.537798,1309515,449484,1065504,2824503
2019-11-27,NASDAQ (Q),314798946,113593778,460455641,888848365,14079539044.293497,6686454858.446600,25085015343.631498,45851009246.371595,3001252,456662,3279928,6737842
2019-11-27,IEX (V),85177128,13001711,45328510,143507349,3766041019.086101,783127303.908800,2435392764.507800,6984561087.502701,762029,74206,423837,1260072
2019-11-27,NASDAQ PSX (X),13771458,14230921,9621796,37624175,497506246.026600,899020641.248400,571337485.677000,1967864372.952000,110172,52481,78743,241396
2019-11-27,BYX Equities (Y),86232554,38299596,44158927,168691077,2690010629.966100,1765744720.182900,1631651436.333000,6087406786.482000,853037,180276,445717,1479030
2019-11-27,BZX Equities (Z),166553358,53432685,102216276,322202319,7813628335.595301,3409283959.174402,6409853273.795199,17632765568.564902,1529150,216326,993648,2739124
2019-11-26,NYSE American (A),5597718,18010691,3977602,27586011,237003992.601600,288948461.546900,134456369.114900,660408823.263400,57460,46715,30903,135078
2019-11-26,NASDAQ BX (B),50357458,28329987,28423093,107110538,1982894408.186300,1184862884.696900,1268852591.282300,4436609884.165500,494193,163943,275115,933251
2019-11-26,NYSE National (C),71252340,28775842,29550549,129578731,1448725411.777600,1061272861.420100,696806986.371100,3206805259.568800,564120,120239,268929,953288
2019-11-26,FINRA / Nasdaq TRF Chicago (DB),3098377,1149248,2818325,7065950,113117829.992700,54084370.552800,182375898.612800,349578099.158300,12130,3584,14909,30623
2019-11-26,FINRA / NYSE TRF (DN),275686184,92902222,231345695,599934101,7163989176.820301,3084601334.274600,8601960964.835503,18850551475.930404,616544,196874,636397,1449815
2019-11-26,FINRA / Nasdaq TRF Carteret (DQ),1290808296,345176073,757674258,2393658627,54137287396.811803,17882061233.305900,37816162761.867093,109835511391.984796,3845764,769076,2339273,6954113
2019-11-26,EDGA Equities (J),110701244,23096110,49420739,183218093,3939720845.250100,1214052389.479600,2203761119.372900,7357534354.102600,1184142,131547,591126,1906815
2019-11-26,EDGX Equities (K),173992567,69172457,136748608,379913632,5679894393.470200,3466027160.817300,5598671590.348301,14744593144.635801,1315974,252345,969331,2537650
2019-11-26,NYSE Chicago (M),9229932,9340923,5732668,24303523,639058619.811500,1271638499.592500,457134876.347700,2367831995.751700,11018,2696,6850,20564
2019-11-26,NYSE (N),1560484859,32029027,33295081,1625808967,77116977318.641405,1848789940.942100,1449056792.076500,80414824051.660005,2931096,84306,229980,3245382
2019-11-26,NYSE Arca (P),173375222,219176595,137359999,529911816,6926729223.708900,12669404182.665797,6632366922.409199,26228500328.783896,1514213,548978,1259762,3322953
2019-11-26,NASDAQ (Q),408533424,146459458,769030759,1324023641,17931456665.166495,8209231695.104899,45964011467.975721,72104699828.247115,3795875,555613,4035943,8387431
2019-11-26,IEX (V),116927529,17493171,64031998,198452698,5189795792.910400,1133301401.475800,3230223337.791399,9553320532.177599,874404,93553,493238,1461195
2019-11-26,NASDAQ PSX (X),18891757,15799397,11888338,46579492,593801195.743100,838587473.712500,647392787.785300,2079781457.240900,128523,59873,89071,277467
2019-11-26,BYX Equities (Y),122199743,52758957,56845944,231804644,3637765313.611100,2484998356.603300,2032127355.948300,8154891026.162700,1164092,241887,575074,1981053
2019-11-26,BZX Equities (Z),209319871,67970551,121232521,398522943,9541304841.069000,4438912234.172001,7317609659.369500,21297826734.610501,1877918,267306,1190107,3335331
2019-11-25,NYSE American (A),5334352,12884282,3121330,21339964,222527412.727700,159629250.066500,153203282.532600,535359945.326800,58067,44884,33540,136491
2019-11-25,NASDAQ BX (B),39172206,28682451,24464813,92319470,1560695888.603800,1323075243.472200,1146512354.062600,4030283486.138600,393399,170599,240371,804369
2019-11-25,NYSE National (C),68980306,25317300,30984451,125282057,1536918835.018600,961910100.468000,761588427.110200,3260417362.596800,618936,106481,317411,1042828
2019-11-25,FINRA / Nasdaq TRF Chicago (DB),2444745,994613,3054523,6493881,82197330.375800,42542830.908800,236890480.323000,361630641.607600,10479,3397,16869,30745
2019-11-25,FINRA / NYSE TRF (DN),268290881,101947940,251345145,621583966,6702000918.940204,3737114570.368700,10129088921.076400,20568204410.385304,676489,224022,731601,1632112
2019-11-25,FINRA / Nasdaq TRF Carteret (DQ),1083321158,353466128,719578437,2156365723,45693447844.912710,21787132988.587103,35250020466.991819,102730601300.491632,3679839,747333,2477898,6905070
2019-11-25,EDGA Equities (J),100314221,22731825,51225277,174271323,3764264401.578500,1184860519.641900,2235519372.881500,7184644294.101900,1117159,130399,618647,1866205
2019-11-25,EDGX Equities (K),159239485,71924493,139652451,370816429,5357294411.037200,3716580091.238199,6429421433.875898,15503295936.151297,1261898,257213,1031194,2550305
2019-11-25,NYSE Chicago (M),7684100,7405101,5895399,20984600,488427426.487300,1206581731.375100,790700413.496600,2485709571.359000,7786,2176,7192,17154
2019-11-25,NYSE (N),823001338,29091193,32138771,884231302,36264136696.845202,1808724611.200400,1419666003.533000,39492527311.578602,2666233,78866,229571,2974670
2019-11-25,NYSE Arca (P),155120407,225405921,143576072,524102400,6538012499.024099,13557457895.661602,7271116344.496794,27366586739.182495,1464263,565717,1347806,3377786
2019-11-25,NASDAQ (Q),376734122,143390899,603917799,1124042820,17038296147.991099,8574164672.751301,34326549745.070806,59939010565.813206,3632140,541786,4266720,8440646
2019-11-25,IEX (V),109261689,15783902,64432912,189478503,4927851849.227199,1053910684.090900,3379095838.222699,9360858371.540798,823624,80864,516199,1420687
2019-11-25,NASDAQ PSX (X),15604438,15664965,12406361,43675764,561721253.308900,893412044.637500,730654057.670900,2185787355.617300,129948,62590,96899,289437
2019-11-25,BYX Equities (Y),106682208,52186695,53321538,212190441,3365707768.199400,2474596876.447901,1994087590.181100,7834392234.828401,1081553,232168,582577,1896298
2019-11-25,BZX Equities (Z),193132050,64035778,123637895,380805723,8829220045.484499,4171976467.013099,7378143363.407201,20379339875.904799,1801327,259025,1238673,3299025
2019-11-22,NYSE American (A),5064936,10527616,2628592,18221144,187855343.316000,140009752.950400,140034733.406300,467899829.672700,51658,39356,27334,118348
2019-11-22,NASDAQ BX (B),37107814,22540534,24409378,84057726,1404434141.954900,970884013.371000,1128784237.382600,3504102392.708500,367844,153884,227445,749173
2019-11-22,NYSE National (C),59907193,21466592,22641476,104015261,1206356122.837600,729968597.321600,570606922.213800,2506931642.373000,503252,88422,216182,807856
2019-11-22,FINRA / Nasdaq TRF Chicago (DB),2353055,968214,2704305,6025574,88225539.615300,41712662.797300,233315820.370600,363254022.783200,10231,3024,14374,27629
2019-11-22,FINRA / NYSE TRF (DN),260393536,88062673,210981661,559437870,5758263743.792100,2864986695.533201,8811109186.504201,17434359625.829502,584686,178899,572974,1336559
2019-11-22,FINRA / Nasdaq TRF Carteret (DQ),983244893,285178234,593980176,1862403303,36378187376.625497,16841205950.871297,27735091348.622981,80954484676.119775,3604097,635733,2183692,6423522
2019-11-22,EDGA Equities (J),97882729,18642823,43148273,159673825,3411413287.270400,967853053.069000,1919490032.681400,6298756373.020800,1064320,112634,517133,1694087
2019-11-22,EDGX Equities (K),152624745,58256053,119941842,330822640,4589551264.889601,2960391203.498901,5400954313.969502,12950896782.358004,1177597,213794,874286,2265677
2019-11-22,NYSE Chicago (M),12716899,13411820,5281573,31410292,659056421.097500,1822994437.489401,586432015.514500,3068482874.101401,7403,1506,5893,14802
2019-11-22,NYSE (N),717697307,25650623,29673786,773021716,29782312870.014195,1486333894.110000,1359140876.848500,32627787640.972695,2611364,72477,215094,2898935
2019-11-22,NYSE Arca (P),142883276,158625846,121375186,422884308,5521560911.578500,9652156989.484301,6171793309.835197,21345511210.897998,1355506,471361,1167864,2994731
2019-11-22,NASDAQ (Q),356659903,113799411,488627497,959086811,15103662356.986700,6506614807.963699,27588972208.771195,49199249373.721594,3462737,473376,3741852,7677965
2019-11-22,IEX (V),109391184,13322891,55244692,177958767,4340169015.395400,818501131.870000,2809174733.486801,7967844880.752201,845499,68761,464852,1379112
2019-11-22,NASDAQ PSX (X),15403404,12976535,12745391,41125330,521396834.532900,750975559.602500,734826915.362400,2007199309.497800,115313,53938,84904,254155
2019-11-22,BYX Equities (Y),104983058,40858847,47881544,193723449,3209913896.178800,1879891726.613901,1833085984.776300,6922891607.569001,1083132,195353,519294,1797779
2019-11-22,BZX Equities (Z),176962186,52557951,104468386,333988523,7784161761.464201,3417632643.586399,6679105187.813199,17880899592.863799,1715430,217662,1073462,3006554
2019-11-21,NYSE American (A),5324879,10700729,2587636,18613244,207743779.038300,159004677.307000,148357609.799900,515106066.145200,54506,43910,29281,127697
2019-11-21,NASDAQ BX (B),41445959,28717939,29219173,99383071,1591731765.297000,1178253105.646700,1209468852.135400,3979453723.079100,405069,206276,255947,867292
2019-11-21,NYSE National (C),74393087,25839360,25892699,126125146,1478615191.216700,900398955.912600,680627366.444000,3059641513.573300,600134,104412,261181,965727
2019-11-21,FINRA / Nasdaq TRF Chicago (DB),3191113,1016895,2906945,7114953,91727759.430800,52086279.824500,205133736.338900,348947775.594200,12531,3280,15172,30983
2019-11-21,FINRA / NYSE TRF (DN),301272586,94359794,231495783,627128163,6169114087.035200,2800362321.368701,10043102998.737798,19012579407.141699,642517,187010,620705,1450232
2019-11-21,FINRA / Nasdaq TRF Carteret (DQ),1144099163,319531945,620958489,2084589597,39363662477.722311,18176257816.053703,29276174775.675696,86816095069.451710,3793399,702679,2330910,6826988
2019-11-21,EDGA Equities (J),106983635,23787187,49622900,180393722,3728709002.863000,1136953385.144500,2131788395.128400,6997450783.135900,1173571,128290,601034,1902895
2019-11-21,EDGX Equities (K),179605936,70527434,127826444,377959814,5010825640.630502,3374637910.089200,5570379285.451101,13955842836.170803,1302338,250150,976565,2529053
2019-11-21,NYSE Chicago (M),13114984,7810979,12989772,33915735,749911135.584700,1208718443.969900,2422873760.896700,4381503340.451300,8621,2126,6012,16759
2019-11-21,NYSE (N),827822211,31556056,34180274,893558541,33099373693.239897,2010836878.848900,1619972626.036600,36730183198.125397,2993378,85731,246359,3325468
2019-11-21,NYSE Arca (P),182146787,224734267,140131864,547012918,6790279041.311500,13432491436.706900,7150040078.268505,27372810556.286905,1605098,582465,1359759,3547322
2019-11-21,NASDAQ (Q),408828815,145261370,552954554,1107044739,17106340348.215803,8852391461.635002,30876196937.509889,56834928747.360694,3999134,593328,4381673,8974135
2019-11-21,IEX (V),118255955,16818190,60007249,195081394,4679921669.883700,937919389.086200,3017758529.471400,8635599588.441300,894790,76766,505871,1477427
2019-11-21,NASDAQ PSX (X),16226759,14346737,11036664,41610160,497482417.016600,874803551.458800,641244250.014900,2013530218.490300,120062,60924,88647,269633
2019-11-21,BYX Equities (Y),116620435,50179038,56889890,223689363,3406207526.325600,2342586973.881200,1999807314.188700,7748601814.395500,1168208,233177,593476,1994861
2019-11-21,BZX Equities (Z),204680609,64581406,115027336,384289351,8664700780.464299,4161038753.142700,6911494134.868802,19737233668.475801,1932103,267753,1203982,3403838
2019-11-20,NYSE American (A),5487330,15523133,3493781,24504244,243842047.648300,228983024.080200,175753409.714500,648578481.443000,58512,51780,35626,145918
2019-11-20,NASDAQ BX (B),43424967,33369755,33672499,110467221,1693657047.520400,1518564228.117100,1493362407.877800,4705583683.515300,416843,197847,305416,920106
2019-11-20,NYSE National (C),79449398,31082538,30845453,141377389,1585035496.395600,1096809043.421700,785783982.122700,3467628521.940000,639463,124339,297612,1061414
2019-11-20,FINRA / Nasdaq TRF Chicago (DB),3229973,1553354,3686027,8469354,116169456.488800,69019071.893800,273735643.949000,458924172.331600,13522,4311,18121,35954
2019-11-20,FINRA / NYSE TRF (DN),304227694,109064159,254438486,667730339,7563491938.353697,3327806507.248200,10633978733.179501,21525277178.781398,675234,206254,669816,1551304
2019-11-20,FINRA / Nasdaq TRF Carteret (DQ),1216379618,348917093,754098783,2319395494,52391192361.778906,22465542419.748597,41201518314.137020,116058253095.664523,4052536,790016,2596050,7438602
2019-11-20,EDGA Equities (J),104218086,25090100,55588710,184896896,3851424344.308300,1384684594.775400,2455969102.872900,7692078041.956600,1156406,146324,642757,1945487
2019-11-20,EDGX Equities (K),179022633,89432893,152790783,421246309,5924671570.310599,5141295009.029200,6839877338.591603,17905843917.931402,1381185,325029,1118327,2824541
2019-11-20,NYSE Chicago (M),9719571,13225310,5336929,28281810,631511186.206400,1617791019.134000,754844420.723300,3004146626.063700,8603,1662,8449,18714
2019-11-20,NYSE (N),1024814904,42305442,40665626,1107785972,49403407341.178707,2714762810.563900,1864792888.692000,53982963040.434607,3170212,119680,290299,3580191
2019-11-20,NYSE Arca (P),179072666,262745687,171498910,613317263,7610765900.983400,16588517558.873405,9033025106.665097,33232308566.521902,1663041,731056,1557545,3951642
2019-11-20,NASDAQ (Q),421522647,188272913,816802294,1426597854,19070528968.719301,11782925681.114199,49148025768.182797,80001480418.016297,4207402,751674,4837518,9796594
2019-11-20,IEX (V),123558844,20518236,70439200,214516280,5319198303.979300,1360930172.689600,3516570042.033200,10196698518.702100,932743,99840,577039,1609622
2019-11-20,NASDAQ PSX (X),16508823,19552230,15505538,51566591,604511793.376700,1182369945.020200,914230316.360400,2701112054.757300,135880,71674,121708,329262
2019-11-20,BYX Equities (Y),123622084,59346207,63903172,246871463,3678577855.852000,2932768703.421799,2527806266.962700,9139152826.236499,1236701,278108,674546,2189355
2019-11-20,BZX Equities (Z),206758782,82109720,136019342,424887844,9633459396.586203,5899729057.163403,8433258199.211604,23966446652.961210,2008708,349151,1362063,3719922
2019-11-19,NYSE American (A),4832365,11643545,3034758,19510668,207480976.021800,152584240.710600,157640687.462800,517705904.195200,51629,44248,31988,127865
2019-11-19,NASDAQ BX (B),42044818,26857999,27038164,95940981,1637207753.236400,1171189696.024600,1276281796.969700,4084679246.230700,408329,163661,268868,840858
2019-11-19,NYSE National (C),68264653,24215385,24118350,116598388,1388268827.347900,805144922.563800,654556794.344700,2847970544.256400,569599,100446,242924,912969
2019-11-19,FINRA / Nasdaq TRF Chicago (DB),2977580,1268515,3024476,7270571,111122817.751300,46668309.690600,231783240.033000,389574367.474900,12644,3491,16930,33065
2019-11-19,FINRA / NYSE TRF (DN),294350738,95402535,231729113,621482386,6949085554.285399,2953627061.730300,10233511425.470998,20136224041.486697,708015,194128,650240,1552383
2019-11-19,FINRA / Nasdaq TRF Carteret (DQ),1100674388,338376155,640149295,2079199838,43552074198.756589,21750354025.156207,33344430027.608593,98646858251.521389,3803094,733822,2346570,6883486
2019-11-19,EDGA Equities (J),96565509,19148297,47037519,162751325,3603080488.082200,1000549821.967600,2121667589.282500,6725297899.332300,1061766,111383,571117,1744266
2019-11-19,EDGX Equities (K),171727179,73315700,130869794,375912673,5497067508.809702,3691309140.846601,5890180411.183498,15078557060.839801,1283693,254312,951617,2489622
2019-11-19,NYSE Chicago (M),13331960,16858749,7202867,37393576,965510832.421300,2582722025.420000,1119308993.124200,4667541850.965500,7280,1378,5226,13884
2019-11-19,NYSE (N),841575479,31228914,34413626,907218019,36323001128.015200,1864463126.931600,1555788850.332300,39743253105.279100,2807360,82831,239217,3129408
2019-11-19,NYSE Arca (P),159396528,206165449,135674942,501236919,6600256755.939299,12514223571.867797,7233443738.411103,26347924066.218199,1469786,545499,1291911,3307196
2019-11-19,NASDAQ (Q),388677923,139182667,565255396,1093115986,16963598723.670693,8255184507.160501,32608626678.282193,57827409909.113387,3686568,526617,4150918,8364103
2019-11-19,IEX (V),114820571,15912377,60728936,191461884,4946965565.696999,1036653080.049100,3288528757.718500,9272147403.464599,831073,81368,493831,1406272
2019-11-19,NASDAQ PSX (X),15164498,13596214,11768958,40529670,545061587.124800,719484492.439000,747559648.919300,2012105728.483100,120307,51772,92553,264632
2019-11-19,BYX Equities (Y),107939441,47566546,54322826,209828813,3295296543.078600,2196566105.533000,2075854944.225700,7567717592.837300,1097124,225785,587507,1910416
2019-11-19,BZX Equities (Z),191334154,65178086,117665214,374177454,8584811635.727801,4481091664.052901,7337127446.907699,20403030746.688401,1799520,264249,1180719,3244488
2019-11-18,NYSE American (A),5048310,14365478,3139366,22553154,216625818.134800,169776982.409200,170669121.446600,557071921.990600,55687,47770,34136,137593
2019-11-18,NASDAQ BX (B),39616607,23630041,29592989,92839637,1539882007.963300,1099025159.364300,1307577388.953000,3946484556.280600,402166,151063,286930,840159
2019-11-18,NYSE National (C),67481903,22359948,24405312,114247163,1379699807.458100,796515149.192100,657758966.103600,2833973922.753800,574124,98882,249405,922411
2019-11-18,FINRA / Nasdaq TRF Chicago (DB),2791318,970936,2806289,6568543,97362626.639500,41397841.799000,236079830.798400,374840299.236900,11776,3316,17630,32722
2019-11-18,FINRA / NYSE TRF (DN),284339233,100736237,230252558,615328028,6542072315.531903,3167882037.474701,10748355338.858100,20458309691.864704,719680,206031,711293,1637004
2019-11-18,FINRA / Nasdaq TRF Carteret (DQ),1038115056,387819334,636158928,2062093318,40074007902.424506,22411557496.339897,33147789965.490801,95633355364.255204,3724245,781393,2349897,6855535
2019-11-18,EDGA Equities (J),90673834,20383457,44838445,155895736,3284589217.127100,998482091.133700,2097302644.879300,6380373953.140100,1024914,111118,560368,1696400
2019-11-18,EDGX Equities (K),159001064,73490541,123086920,355578525,4999030845.492700,3435143375.309701,6156966203.742200,14591140424.544601,1237286,245849,958095,2441230
2019-11-18,NYSE Chicago (M),13434351,8961817,5419753,27815921,934146884.931400,1243409029.612200,641307937.703000,2818863852.246600,7013,1509,5426,13948
2019-11-18,NYSE (N),829339288,28965285,34060076,892364649,35669462084.626703,1708819527.092900,1746818408.117600,39125100019.837203,2729839,77542,255353,3062734
2019-11-18,NYSE Arca (P),148799361,204449205,129706247,482954813,6228594556.375997,11905487820.918500,7239197893.257397,25373280270.551894,1444148,510689,1268790,3223627
2019-11-18,NASDAQ (Q),355814039,128325688,550676153,1034815880,15598160951.208101,7255864249.503499,31838051204.043519,54692076404.755119,3536081,500222,4007522,8043825
2019-11-18,IEX (V),105835883,15695400,59356340,180887623,4536947393.439600,904628062.534600,3118525483.237399,8560100939.211599,804273,76385,474747,1355405
2019-11-18,NASDAQ PSX (X),15872340,13077200,12309385,41258925,703368213.483700,775685192.151800,800946438.578200,2279999844.213700,149343,53953,110972,314268
2019-11-18,BYX Equities (Y),104304109,47017245,54223531,205544885,3162798183.334200,2273737331.653401,2078525652.153400,7515061167.141001,1084412,214926,578805,1878143
2019-11-18,BZX Equities (Z),179674196,59302738,113228427,352205361,7961434394.197700,3887163768.756399,7267733181.111898,19116331344.065997,1746259,248123,1161562,3155944
2019-11-15,NYSE American (A),4993673,11021454,3408941,19424068,225160580.449500,151372099.707400,153433581.561200,529966261.718100,54892,37959,33905,126756
2019-11-15,NASDAQ BX (B),37831154,22473967,26791428,87096549,1501917524.560500,1035217593.325900,1199115069.877800,3736250187.764200,370868,128177,249332,748377
2019-11-15,NYSE National (C),64574067,23838906,23849141,112262114,1373214892.270700,850378178.425300,640675703.506000,2864268774.202000,545100,97625,236345,879070
2019-11-15,FINRA / Nasdaq TRF Chicago (DB),2571290,978084,3046729,6596103,96192453.256200,39749898.786500,251748257.508900,387690609.551600,10503,3486,16341,30330
2019-11-15,FINRA / NYSE TRF (DN),235448799,95009125,252297288,582755212,5699721743.428499,3414986454.310700,10708824730.771092,19823532928.510291,586746,191675,672776,1451197
2019-11-15,FINRA / Nasdaq TRF Carteret (DQ),991847837,335832485,650245315,1977925637,39990734272.587494,23403700254.547492,32276331883.472606,95670766410.607592,3557518,680907,2357673,6596098
2019-11-15,EDGA Equities (J),88019169,19771304,46176624,153967097,3450101130.948800,1055266232.799200,2050216279.289400,6555583643.037400,983975,100926,538031,1622932
2019-11-15,EDGX Equities (K),152060605,63279130,137484346,352824081,5098194386.511100,3347136622.084800,6203926587.382396,14649257595.978296,1168446,219820,939000,2327266
2019-11-15,NYSE Chicago (M),16450364,22023435,8147523,46621322,1544230371.671000,1797796873.961400,885296006.285600,4227323251.918000,6287,1414,6706,14407
2019-11-15,NYSE (N),859043666,28578639,33480879,921103184,39110459024.891390,1782607018.546300,1535822946.614300,42428888990.051990,2580098,72314,242267,2894679
2019-11-15,NYSE Arca (P),150164711,201074793,143893759,495133263,6179296852.175403,11455549926.529306,7444343137.819401,25079189916.524110,1368299,499531,1258217,3126047
2019-11-15,NASDAQ (Q),345867081,123143587,615402486,1084413154,15571129884.667099,7477256197.223801,36066538659.592141,59114924741.483041,3353922,454191,3958491,7766604
2019-11-15,IEX (V),108195024,15591320,61235831,185022175,4789721030.407800,990854427.423800,3261487454.463000,9042062912.294600,824759,69362,479667,1373788
2019-11-15,NASDAQ PSX (X),14492773,14032096,11834217,40359086,585364085.868300,813914017.984200,787197072.074400,2186475175.926900,124629,51844,96089,272562
2019-11-15,BYX Equities (Y),105445155,50267253,57042678,212755086,3281432795.459400,2510347727.579200,2152634430.937000,7944414953.975600,1054533,204869,575534,1834936
2019-11-15,BZX Equities (Z),182801457,59117639,125151697,367070793,8439535750.177302,3954072436.113799,8093055278.826901,20486663465.118002,1710617,231673,1192204,3134494
2019-11-14,NYSE American (A),4215347,10597990,2916057,17729394,164159263.030100,132658926.319400,125829836.628700,422648025.978200,46207,39600,31571,117378
2019-11-14,NASDAQ BX (B),36914981,19182672,23323176,79420829,1382581256.158600,1012096238.739200,1063826014.070400,3458503508.968200,358558,92975,225793,677326
2019-11-14,NYSE National (C),70208611,24655671,24228237,119092519,1374152967.573700,872801349.263700,628491100.132100,2875445416.969500,576268,97344,237351,910963
2019-11-14,FINRA / Nasdaq TRF Chicago (DB),2812179,997971,2988911,6799061,106737031.608900,41401068.790000,211978124.431100,360116224.830000,11440,3244,14618,29302
2019-11-14,FINRA / NYSE TRF (DN),279676900,91844758,257452330,628973988,6468673843.405402,2980060132.921100,9468621999.528899,18917355975.855401,625236,177175,632292,1434703
2019-11-14,FINRA / Nasdaq TRF Carteret (DQ),1000918503,355810909,651438402,2008167814,36856589975.007400,21329944073.664497,29751072136.809605,87937606185.481502,3512911,650210,2276098,6439219
2019-11-14,EDGA Equities (J),92106233,19408075,44753108,156267416,3154889323.407200,1150628423.470900,1892738440.815900,6198256187.694000,977190,99561,519408,1596159
2019-11-14,EDGX Equities (K),154743021,67604305,143222647,365569973,4638003658.289001,3458978454.198303,5622931825.576000,13719913938.063304,1182188,224173,940462,2346823
2019-11-14,NYSE Chicago (M),8194010,18418667,8346512,34959189,396828528.864300,1319225537.429200,793247409.408200,2509301475.701700,6002,1620,5571,13193
2019-11-14,NYSE (N),718965877,30822376,33146730,782934983,29095419241.437305,1738201158.993100,1489041737.297000,32322662137.727405,2652359,74670,229558,2956587
2019-11-14,NYSE Arca (P),151708987,199444123,147908492,499061602,5885082472.676299,11753184147.668301,6832286766.462701,24470553386.807301,1409576,501589,1274252,3185417
2019-11-14,NASDAQ (Q),348818297,133254401,529369328,1011442026,14907395226.316304,7866986466.378002,27501906137.544194,50276287830.238500,3478961,499226,3990675,7968862
2019-11-14,IEX (V),108313109,14823079,58018322,181154510,4451010772.600300,878075554.755800,2780113298.504501,8109199625.860601,800957,66638,457883,1325478
2019-11-14,NASDAQ PSX (X),14107609,15258323,11734647,41100579,466112008.737300,881178437.196400,698000234.355300,2045290680.289000,106787,50232,88807,245826
2019-11-14,BYX Equities (Y),103410977,46153131,57113740,206677848,3047654638.002700,2293246686.372599,1959356043.961100,7300257368.336399,1054060,204757,563944,1822761
2019-11-14,BZX Equities (Z),186981914,60706375,117886477,365574766,8080246943.825401,4155364744.247500,6982113445.261502,19217725133.334403,1712588,238091,1141045,3091724
2019-11-13,NYSE American (A),4396273,11469054,2705016,18570343,165088670.086200,143376805.388500,123959221.958600,432424697.433300,44392,42567,29168,116127
2019-11-13,NASDAQ BX (B),39714060,26548798,26042036,92304894,1429851760.341300,1204974371.096200,1057598811.773700,3692424943.211200,377394,150570,237794,765758
2019-11-13,NYSE National (C),71729923,28159869,24799411,124689203,1391373531.135800,941552463.746800,606222726.478300,2939148721.360900,588183,106690,241586,936459
2019-11-13,FINRA / Nasdaq TRF Chicago (DB),3153089,1131000,3072380,7356469,122997152.425600,47003652.298000,239866999.435200,409867804.158800,12377,3717,16206,32300
2019-11-13,FINRA / NYSE TRF (DN),282218415,96950200,265208203,644376818,6915727992.142702,3231863568.529601,10104797104.560396,20252388665.232699,649964,190531,659294,1499789
2019-11-13,FINRA / Nasdaq TRF Carteret (DQ),1081982700,316374131,682585017,2080941848,40701910020.339408,18074613893.846103,28145143523.733806,86921667437.919317,3755225,738876,2366754,6860855
2019-11-13,EDGA Equities (J),92630056,21525454,44517301,158672811,3331736199.976500,1181203904.650800,1868692576.255700,6381632680.883000,1027579,117093,540552,1685224
2019-11-13,EDGX Equities (K),165412830,72525548,140697077,378635455,5028972039.439802,3816757781.110599,5755752806.559900,14601482627.110301,1257280,262460,963151,2482891
2019-11-13,NYSE Chicago (M),9683835,12303227,6775587,28762649,471003805.985700,1482661012.203400,764379708.217000,2718044526.406100,7025,1413,6584,15022
2019-11-13,NYSE (N),798669446,36699297,33720732,869089475,32931046451.681705,2088211221.742999,1428347487.621200,36447605161.045904,2785152,90079,229554,3104785
2019-11-13,NYSE Arca (P),164780507,227767488,151266217,543814212,6363649106.348403,13551422887.765498,7087907417.558203,27002979411.672104,1507435,616795,1336558,3460788
2019-11-13,NASDAQ (Q),374244708,160916698,549864001,1085025407,15889008711.357302,9565484350.241505,28692774640.831703,54147267702.430510,3615578,593366,4067217,8276161
2019-11-13,IEX (V),114988995,17988202,61471660,194448857,4612261257.217500,1018509110.447900,3038245151.007100,8669015518.672500,874750,81346,504349,1460445
2019-11-13,NASDAQ PSX (X),14513325,17991734,11433562,43938621,514461511.776200,1068981253.772900,701054512.043400,2284497277.592500,115406,64556,93376,273338
2019-11-13,BYX Equities (Y),110627961,53762671,60716248,225106880,3186984799.959600,2498992141.620701,2028439535.655600,7714416477.235901,1101858,239012,593755,1934625
2019-11-13,BZX Equities (Z),184983713,71796037,115140283,371920033,8073853526.042700,4720986923.536001,6701101438.537499,19495941888.116200,1741969,289544,1129182,3160695
2019-11-12,NYSE American (A),4314021,12150426,2379207,18843654,171784113.208200,147920366.951500,115259500.551900,434963980.711600,47150,44017,25903,117070
2019-11-12,NASDAQ BX (B),42506520,22387154,22009063,86902737,1497533355.597700,1027688551.293900,1024092911.853100,3549314818.744700,387593,100437,222770,710800
2019-11-12,NYSE National (C),74757847,27347703,25384340,127489890,1470322675.708900,924743055.824800,641917163.704300,3036982895.238000,606672,110206,253404,970282
2019-11-12,FINRA / Nasdaq TRF Chicago (DB),3275598,1068858,2784824,7129280,120672676.805700,50075125.965300,197519408.077800,368267210.848800,13558,3545,14994,32097
2019-11-12,FINRA / NYSE TRF (DN),279309725,98249353,230422706,607981784,6571372191.232897,3333351301.693701,9421702607.622899,19326426100.549497,624571,184274,631368,1440213
2019-11-12,FINRA / Nasdaq TRF Carteret (DQ),1051251491,376172225,607038671,2034462387,39210460246.018992,20468759959.934303,29127470327.945410,88806690533.898705,3847594,700927,2342597,6891118
2019-11-12,EDGA Equities (J),94704758,20389850,44808381,159902989,3300778617.491200,1017210417.355700,1908499812.571900,6226488847.418800,1040172,103766,551119,1695057
2019-11-12,EDGX Equities (K),167429716,71622062,129652087,368703865,5051325030.146798,3477924441.175401,5590777209.669598,14120026680.991797,1271010,242171,946182,2459363
2019-11-12,NYSE Chicago (M),10427017,8626307,7318214,26371538,512352135.321800,988627514.356200,1648016569.653300,3148996219.331300,6266,1336,6382,13984
2019-11-12,NYSE (N),790575268,35006653,31707539,857289460,31742462318.334495,1905096450.173100,1402078386.098000,35049637154.605595,2853639,80138,226868,3160645
2019-11-12,NYSE Arca (P),163484606,219102707,139690328,522277641,6227813467.624200,12480265814.612306,7021744456.353699,25729823738.590205,1533102,547248,1314203,3394553
2019-11-12,NASDAQ (Q),383397416,141720485,520826614,1045944515,15871542241.585605,7870107678.785199,27820714538.267402,51562364458.638206,3706890,517253,4032349,8256492
2019-11-12,IEX (V),117021777,17105881,60215105,194342763,4767729032.883799,990360270.413400,3034360551.181500,8792449854.478699,870683,84491,490598,1445772
2019-11-12,NASDAQ PSX (X),14364752,17355846,11316830,43037428,486685436.723700,993798528.852800,638875869.214500,2119359834.791000,114415,56940,90627,261982
2019-11-12,BYX Equities (Y),112554374,53663912,54077917,220296203,3290176270.568900,2474191534.930100,1986720597.723900,7751088403.222900,1113894,223055,581883,1918832
2019-11-12,BZX Equities (Z),186186613,68746645,111817074,366750332,7805452777.206899,4198489268.474699,6470816996.847098,18474759042.528696,1764515,264777,1128123,3157415
2019-11-11,NYSE American (A),4190422,12226822,2260970,18678214,168277561.674700,96242926.347800,103611922.482400,368132410.504900,44076,36846,26136,107058
2019-11-11,NASDAQ BX (B),37983005,12457826,19119074,69559905,1309544397.205100,675576120.186000,921086206.050700,2906206723.441800,353744,67348,201734,622826
2019-11-11,NYSE National (C),65748451,22308579,21727251,109784281,1222985898.294100,686136389.966000,545633775.096000,2454756063.356100,532236,87925,225254,845415
2019-11-11,FINRA / Nasdaq TRF Chicago (DB),2440087,974625,2986354,6401066,121062634.437400,40857564.635000,199338934.106000,361259133.178400,11362,3458,15270,30090
2019-11-11,FINRA / NYSE TRF (DN),231608925,82626191,197016602,511251718,5951534840.637199,2786829235.330599,8305466057.120702,17043830133.088500,559145,167270,565693,1292108
2019-11-11,FINRA / Nasdaq TRF Carteret (DQ),848089746,248705824,512830240,1609625810,32322182684.051697,14562677127.733599,23337927827.972202,70222787639.757498,3528362,578758,2201282,6308402
2019-11-11,EDGA Equities (J),88005555,15195454,40512351,143713360,2957271725.941600,716682587.064000,1683484903.089000,5357439216.094600,928023,82665,497814,1508502
2019-11-11,EDGX Equities (K),144217644,52725397,107426893,304369934,4484985183.209501,2412896668.851600,4689320208.113302,11587202060.174403,1088620,183605,820157,2092382
2019-11-11,NYSE Chicago (M),7324571,10100671,6187611,23612853,457656077.095300,1090938618.930000,971352290.754900,2519946986.780200,5212,1795,5881,12888
2019-11-11,NYSE (N),760272699,23957483,27715063,811945245,27703837564.432394,1226088357.745200,1168440368.966400,30098366291.143994,2441635,62992,201040,2705667
2019-11-11,NYSE Arca (P),140629673,157917915,117691781,416239369,5363662385.693100,8729037402.531100,5648050876.965699,19740750665.189899,1283573,425707,1123004,2832284
2019-11-11,NASDAQ (Q),334884183,107948672,456455142,899287997,13666977032.543996,5815066085.711001,23571617879.417896,43053660997.672893,3132454,409572,3569629,7111655
2019-11-11,IEX (V),96157430,12696614,49964485,158818529,3637281241.857000,681831971.066300,2513942905.029200,6833056117.952500,722019,66825,416410,1205254
2019-11-11,NASDAQ PSX (X),13724590,11738638,9990567,35453795,465905420.064200,622988960.133700,497421891.988200,1586316272.186100,101427,44193,74657,220277
2019-11-11,BYX Equities (Y),97958933,39436057,46291750,183686740,2810856996.661800,1820092097.703100,1666028669.712000,6296977764.076900,976865,183269,515507,1675641
2019-11-11,BZX Equities (Z),167888494,46675298,101124557,315688349,7115248287.955700,2707527897.583200,5589792527.046902,15412568712.585802,1549626,194084,1028517,2772227
2019-11-08,NYSE American (A),4784349,11700147,2815877,19300373,190311628.589300,136127010.442600,123148718.641800,449587357.673700,50475,43109,29225,122809
2019-11-08,NASDAQ BX (B),41647543,25590143,24513833,91751519,1542691934.321000,1170601518.147900,1120504233.610600,3833797686.079500,405281,143550,258230,807061
2019-11-08,NYSE National (C),77598778,30658406,25006835,133264019,1511715366.852900,1020220254.323000,624189510.210300,3156125131.386200,611795,112814,250225,974834
2019-11-08,FINRA / Nasdaq TRF Chicago (DB),3360462,1206066,3390888,7957416,111173802.612400,48361589.925000,238813001.189900,398348393.727300,14470,3943,17449,35862
2019-11-08,FINRA / NYSE TRF (DN),252704953,92329862,210478285,555513100,6032371274.513701,2903624750.599300,8265173712.137596,17201169737.250597,615963,183427,592820,1392210
2019-11-08,FINRA / Nasdaq TRF Carteret (DQ),993061549,282980752,593232980,1869275281,35047114872.203710,16352202914.005603,26032725948.943196,77432043735.152509,3945404,742685,2425146,7113235
2019-11-08,EDGA Equities (J),109134273,21930577,48239579,179304429,3717271699.153800,1092524882.010000,2071410187.948300,6881206769.112100,1143727,111865,578348,1833940
2019-11-08,EDGX Equities (K),168989801,70303364,116986868,356280033,5129297588.551402,3527832907.388599,4983590808.120001,13640721304.060002,1312135,249585,937520,2499240
2019-11-08,NYSE Chicago (M),9678748,20767348,5810867,36256963,656098113.404900,1767378947.353400,807553224.291900,3231030285.050200,6502,2217,6190,14909
2019-11-08,NYSE (N),824031149,34301657,31386267,889719073,32588186889.919300,1710452761.657200,1370676601.632700,35669316253.209200,2862209,83610,231062,3176881
2019-11-08,NYSE Arca (P),178554278,233844177,133370459,545768914,6590406742.259601,12685020400.289898,6741955965.235799,26017383107.785298,1528820,578762,1277786,3385368
2019-11-08,NASDAQ (Q),399384592,150515938,540547906,1090448436,16410561860.894002,8390683877.138103,29261371691.402989,54062617429.435094,3777646,576390,4147190,8501226
2019-11-08,IEX (V),117977821,17385475,64467597,199830893,4592592486.567500,978359896.734400,3061226173.852399,8632178557.154299,847144,77857,505681,1430682
2019-11-08,NASDAQ PSX (X),15765878,15873804,10630317,42269999,531579516.178300,872007553.555700,659700001.279900,2063287071.013900,120729,59326,90130,270185
2019-11-08,BYX Equities (Y),115292220,57242237,55681488,228215945,3268678795.819800,2503339135.506700,1957714216.648300,7729732147.974800,1145844,240222,590044,1976110
2019-11-08,BZX Equities (Z),196197673,67081534,115587530,378866737,8345344538.758801,4241084018.794601,6921398922.118099,19507827479.671501,1827811,270364,1181098,3279273
2019-11-07,NYSE American (A),5785566,13616495,3134647,22536708,225504146.143800,194450777.176600,169164370.980300,589119294.300700,61046,50303,35139,146488
2019-11-07,NASDAQ BX (B),51115452,25294753,27851804,104262009,1745403460.470000,1237622629.151100,1430179540.517400,4413205630.138500,448575,128508,270774,847857
2019-11-07,NYSE National (C),83015813,36444429,26337016,145797258,1665220186.940000,1205082929.053600,716453876.257200,3586756992.250800,643923,130383,253041,1027347
2019-11-07,FINRA / Nasdaq TRF Chicago (DB),3240006,1389839,3797960,8427805,111962369.165300,62579734.525300,298119910.113700,472662013.804300,13885,4412,20424,38721
2019-11-07,FINRA / NYSE TRF (DN),280295019,120153347,254573090,655021456,6554231587.478300,4206006018.010601,11871920576.733701,22632158182.222602,639301,222722,679833,1541856
2019-11-07,FINRA / Nasdaq TRF Carteret (DQ),1257672189,397450764,725790805,2380913758,47595106080.730792,21876937363.620001,37067746598.591778,106539790042.942571,4205373,846177,2667511,7719061
2019-11-07,EDGA Equities (J),126135303,28053960,54681131,208870394,4292213363.064500,1442406305.680400,2524896133.154600,8259515801.899500,1285820,139336,635580,2060736
2019-11-07,EDGX Equities (K),200377156,100256071,150407834,451041061,6295228644.877000,4710681857.490800,7258782898.443196,18264693400.810996,1496664,326057,1139347,2962068
2019-11-07,NYSE Chicago (M),8395318,11710475,6826798,26932591,567517727.382200,1192307325.080300,423512642.853000,2183337695.315500,8949,3015,8224,20188
2019-11-07,NYSE (N),962717866,47737760,37573791,1048029417,38521339100.937401,2402399660.913400,1830433128.484700,42754171890.335501,3308941,106127,276360,3691428
2019-11-07,NYSE Arca (P),200292038,322104106,161837955,684234099,7704580525.041499,17323387455.544598,9203207505.937004,34231175486.523101,1792213,776358,1500497,4069068
2019-11-07,NASDAQ (Q),453349834,205905248,661064381,1320319463,19100967716.357105,11292933786.901401,38042703375.005298,68436604878.263804,4281330,730501,4836649,9848480
2019-11-07,IEX (V),137580456,22610121,73365271,233555848,5607890604.693500,1315278875.940700,4391721627.808800,11314891108.443000,948861,104261,571523,1624645
2019-11-07,NASDAQ PSX (X),16813544,24089855,12150293,53053692,556982736.955300,1259009473.558500,796590953.366800,2612583163.880600,126888,76814,98329,302031
2019-11-07,BYX Equities (Y),131668211,70542184,62592690,264803085,3644047798.491700,3148652927.189902,2358457108.439600,9151157834.121202,1258203,281955,621956,2162114
2019-11-07,BZX Equities (Z),233543506,94346500,141703553,469593559,10250254644.350401,5658419999.991400,9402162856.779799,25310837501.121600,2127572,349992,1400059,3877623
2019-11-06,NYSE American (A),6117510,12474182,3207751,21799443,241835643.294500,146582512.157600,157184150.708400,545602306.160500,62499,45405,34435,142339
2019-11-06,NASDAQ BX (B),54544177,18324437,26745616,99614230,1692510928.749600,897615670.152500,1151888858.109400,3742015457.011500,471124,84548,250687,806359
2019-11-06,NYSE National (C),91284710,30314117,27007022,148605849,1645101002.878100,988050572.620900,672337649.073700,3305489224.572700,683507,121310,262658,1067475
2019-11-06,FINRA / Nasdaq TRF Chicago (DB),3751976,1033079,2936790,7721845,104718551.501300,43510385.134800,203937520.967100,352166457.603200,13189,3469,15100,31758
2019-11-06,FINRA / NYSE TRF (DN),343574505,103491449,280270207,727336161,6455983815.235002,3550209367.269204,8310619201.905401,18316812384.409607,667374,183742,601410,1452526
2019-11-06,FINRA / Nasdaq TRF Carteret (DQ),1354920506,341982853,691417874,2388321233,44970154685.622115,18952745855.975698,30271506978.292882,94194407519.890695,4304726,707171,2456155,7468052
2019-11-06,EDGA Equities (J),136102038,21837619,54675487,212615144,4238622184.816200,1179138932.726500,2095496608.130200,7513257725.672900,1372175,116788,628017,2116980
2019-11-06,EDGX Equities (K),223448586,76540253,156589922,456578761,5990105540.501401,3741245970.575200,5614871947.521501,15346223458.598102,1529447,267276,1037501,2834224
2019-11-06,NYSE Chicago (M),10315478,10910614,9686405,30912497,372202340.644800,781788687.499000,792471971.757700,1946462999.901500,6599,1848,5459,13906
2019-11-06,NYSE (N),988137170,38373274,34707330,1061217774,38000425291.421096,1946954664.816700,1525885604.401500,41473265560.639296,3333309,93147,263985,3690441
2019-11-06,NYSE Arca (P),222863406,251620509,164064388,638548303,7814496457.223201,14449167421.245401,7191094894.282100,29454758772.750702,1794237,640393,1421445,3856075
2019-11-06,NASDAQ (Q),492828876,159134081,618394780,1270357737,18937311848.039301,8784174748.080601,30272458361.780301,57993944957.900203,4346414,608722,4387265,9342401
2019-11-06,IEX (V),137803549,17519992,64933940,220257481,5248679716.833002,1077972437.507100,3173295797.736700,9499947952.076802,952463,85174,516645,1554282
2019-11-06,NASDAQ PSX (X),18180219,17017206,10983508,46180933,508767749.485800,940407122.482500,633572433.295600,2082747305.263900,122825,56264,85460,264549
2019-11-06,BYX Equities (Y),146106591,51289709,67408509,264804809,3757557294.676100,2438005367.174898,2040079866.930100,8235642528.781098,1371895,235847,628549,2236291
2019-11-06,BZX Equities (Z),235532223,75488284,129543953,440564460,9418200303.064498,4651271552.694500,7120088236.608700,21189560092.367698,2103857,305955,1267963,3677775
2019-11-05,NYSE American (A),7077105,12442577,3150727,22670409,299430486.755000,173134340.578400,165229641.679200,637794469.012600,72334,45859,34685,152878
2019-11-05,NASDAQ BX (B),51265461,19550856,26205346,97021663,1942426008.820200,1018690213.794500,1280455573.200300,4241571795.815000,476151,97290,257027,830468
2019-11-05,NYSE National (C),94646817,32391632,29301990,156340439,1809069910.984600,1145395191.478800,737241906.134600,3691707008.598000,713259,129778,288112,1131149
2019-11-05,FINRA / Nasdaq TRF Chicago (DB),4465686,1337709,3112741,8916136,139905651.666200,61608278.041900,190126662.013600,391640591.721700,15550,4051,15451,35052
2019-11-05,FINRA / NYSE TRF (DN),327619994,105625673,254794844,688040511,7908012128.389600,3630547791.122199,9059362818.837294,20597922738.349093,789784,208761,611706,1610251
2019-11-05,FINRA / Nasdaq TRF Carteret (DQ),1375343688,364530187,753137961,2493011836,52095094522.139684,21042060532.217100,34126511496.759398,107263666551.116182,4676456,826065,2577816,8080337
2019-11-05,EDGA Equities (J),131719055,24996169,54554428,211269652,4527884794.168600,1314184814.659700,2385206501.776500,8227276110.604800,1320289,129015,607808,2057112
2019-11-05,EDGX Equities (K),221571887,80655151,140014360,442241398,6676743692.720400,4200594353.160000,5701623893.542004,16578961939.422404,1566489,294944,995085,2856518
2019-11-05,NYSE Chicago (M),7955637,7135611,4881727,19972975,352458950.979000,699203349.871500,450146332.433600,1501808633.284100,7096,1928,5826,14850
2019-11-05,NYSE (N),988807817,39096291,37943835,1065847943,42623989628.611199,2093964408.344301,1672322786.588600,46390276823.544100,3494226,102392,270313,3866931
2019-11-05,NYSE Arca (P),214332531,270528340,153061018,637921889,8314921297.921100,15524212694.043097,7457525980.482899,31296659972.447096,1839265,679951,1415604,3934820
2019-11-05,NASDAQ (Q),500152794,172430288,594362297,1266945379,21426035228.193700,9676752189.704603,32148347244.445596,63251134662.343899,4660587,660013,4437090,9757690
2019-11-05,IEX (V),142663242,19127246,65122579,226913067,6044795873.662402,1089214019.194300,3335908474.199800,10469918367.056502,1046408,95801,526467,1668676
2019-11-05,NASDAQ PSX (X),18404056,18578359,10638236,47620651,598002143.448900,1039226349.306700,616924582.092100,2254153074.847700,129996,65002,82791,277789
2019-11-05,BYX Equities (Y),149474181,59132990,63270895,271878066,4069987697.015800,2774397205.401400,2205273215.021300,9049658117.438500,1379787,268723,612841,2261351
2019-11-05,BZX Equities (Z),255096793,80823816,133874292,469794901,10966741890.453601,4870503255.395700,7335580098.003601,23172825243.852902,2233600,320414,1283677,3837691
2019-11-04,NYSE American (A),6054838,14601394,2989530,23645762,287983952.910000,173027064.996000,160738225.667400,621749243.573400,64520,51708,31773,148001
2019-11-04,NASDAQ BX (B),51919785,20995630,25298868,98214283,2194910386.618000,1045681694.503100,1337908985.604200,4578501066.725300,477951,101368,259055,838374
2019-11-04,NYSE National (C),90898508,33571034,30076130,154545672,1748049418.030500,1175092450.851700,777205834.731800,3700347703.614000,684524,126956,295483,1106963
2019-11-04,FINRA / Nasdaq TRF Chicago (DB),3191636,1249894,2974967,7416497,136798135.660000,52300545.695500,234222754.171500,423321435.527000,14554,4063,16617,35234
2019-11-04,FINRA / NYSE TRF (DN),299943977,105575561,224103547,629623085,8168391370.309003,3784975136.022600,10893524236.264696,22846890742.596299,746115,229139,630532,1605786
2019-11-04,FINRA / Nasdaq TRF Carteret (DQ),1242569295,437026652,664577583,2344173530,48265620894.985887,26717234717.801909,32665199339.198387,107648054951.986183,4463134,899283,2529582,7891999
2019-11-04,EDGA Equities (J),119662820,25231398,49687088,194581306,4376443805.371500,1322801457.133600,2295108381.942100,7994353644.447200,1248072,134219,591518,1973809
2019-11-04,EDGX Equities (K),202110609,76540639,128925404,407576652,6897586465.054103,3960246872.520198,6048036767.187500,16905870104.761801,1493323,285079,964713,2743115
2019-11-04,NYSE Chicago (M),9771969,12141057,5304766,27217792,452220880.848900,1042184912.590000,631294558.255800,2125700351.694700,5729,1769,4608,12106
2019-11-04,NYSE (N),951747678,35517000,35808624,1023073302,39751608883.865007,1880321240.999600,1613495760.969200,43245425885.833807,3176887,94373,251650,3522910
2019-11-04,NYSE Arca (P),194052262,247187123,144806628,586046013,7941786757.154900,14053646519.066299,7650678791.792602,29646112068.013801,1687030,610174,1322165,3619369
2019-11-04,NASDAQ (Q),478646217,161001043,587883189,1227530449,21193619248.636112,9144776619.578097,31899921408.827919,62238317277.042128,4285609,621351,4159213,9066173
2019-11-04,IEX (V),141526239,19853900,70350166,231730305,6251477000.157099,1175439462.652600,3593845417.821300,11020761880.630999,986194,98290,533843,1618327
2019-11-04,NASDAQ PSX (X),16775326,17702177,10537403,45014906,576848085.630900,1068486953.315200,631257017.199900,2276592056.146000,121247,65886,83044,270177
2019-11-04,BYX Equities (Y),136990780,58812378,56617200,252420358,3933218897.353000,2651874616.111800,2088441603.819000,8673535117.283800,1289800,257818,605040,2152658
2019-11-04,BZX Equities (Z),232186134,70443831,126895886,429525851,10557840498.551103,4415822332.458500,7694303823.752303,22667966654.761906,2084998,286578,1256781,3628357
2019-11-01,NYSE American (A),6058085,11493225,2646781,20198091,238397298.961600,215753310.219300,149874881.550600,604025490.731500,55340,46161,29100,130601
2019-11-01,NASDAQ BX (B),51615010,25766611,24151613,101533234,1749090549.251600,1384018868.172700,1351477412.794500,4484586830.218800,443510,114423,242648,800581
2019-11-01,NYSE National (C),87894892,37212196,28853407,153960495,1569440626.001400,1403832839.234700,709565226.226500,3682838691.462600,617463,128803,265337,1011603
2019-11-01,FINRA / Nasdaq TRF Chicago (DB),3048128,1387364,2511600,6947092,135898910.141400,55836154.385000,192904907.099700,384639971.626100,13673,4271,14103,32047
2019-11-01,FINRA / NYSE TRF (DN),281961511,103878801,200184271,586024583,6877492907.522701,3455931709.069500,9784098273.270102,20117522889.862303,716096,210499,589218,1515813
2019-11-01,FINRA / Nasdaq TRF Carteret (DQ),1173429743,404062790,641763323,2219255856,43060106842.651102,24775581592.642997,33374452253.722803,101210140689.016902,4255356,814959,2451989,7522304
2019-11-01,EDGA Equities (J),123709526,29322568,49903278,202935372,4086645717.393700,1938012681.846300,2320405881.502400,8345064280.742400,1204220,140503,585408,1930131
2019-11-01,EDGX Equities (K),193146398,85440894,119582288,398169580,6002041375.605800,4743356625.325097,5717838226.739297,16463236227.670194,1359437,300509,911226,2571172
2019-11-01,NYSE Chicago (M),8091493,16920782,7555497,32567772,465843678.634500,1815715069.375000,972027889.778700,3253586637.788200,5491,1104,5263,11858
2019-11-01,NYSE (N),854921930,40430975,38632462,933985367,35188166196.532304,2358535383.524800,1729772837.862200,39276474417.919304,3082880,104462,252504,3439846
2019-11-01,NYSE Arca (P),191465945,300474801,141948056,633888802,7146826957.208399,18015268674.496794,7930860372.320199,33092956004.025392,1550070,688259,1285954,3524283
2019-11-01,NASDAQ (Q),458082222,169242500,558382660,1185707382,19123601798.453697,10748766640.910797,33650327649.687388,63522696089.051882,4063438,650371,4097144,8810953
2019-11-01,IEX (V),131477394,22498116,62710313,216685823,5163732283.837300,1440923269.977400,3406601037.709201,10011256591.523901,911981,95783,504501,1512265
2019-11-01,NASDAQ PSX (X),15505273,15712383,9689377,40907033,513660546.907600,1037862207.514500,656730601.365900,2208253355.788000,109699,58629,78011,246339
2019-11-01,BYX Equities (Y),137558699,64594009,53001465,255154173,3641065341.233700,3360539671.938500,2133108292.711800,9134713305.884000,1234896,273697,586667,2095260
2019-11-01,BZX Equities (Z),238324112,83714406,129835733,451874251,10056294370.605502,5654885445.197701,8668005996.608198,24379185812.411401,2028143,332741,1274362,3635246
2019-10-31,NYSE American (A),5354435,14624620,3117800,23096855,221953039.732800,180915243.585400,169338205.459700,572206488.777900,55436,46476,31871,133783
2019-10-31,NASDAQ BX (B),46106790,23397174,25441218,94945182,1838381801.265600,1233446717.564800,1416438693.564600,4488267212.395000,440324,112503,250277,803104
2019-10-31,NYSE National (C),82286324,31920758,25878316,140085398,1502637735.667200,1100646849.562400,717934054.102900,3321218639.332500,604984,126914,243545,975443
2019-10-31,FINRA / Nasdaq TRF Chicago (DB),3032960,1528018,3023344,7584322,112015518.122000,70113401.759600,244188996.679300,426317916.560900,13031,4445,16982,34458
2019-10-31,FINRA / NYSE TRF (DN),193205804,78739979,181788599,453734382,4674132036.310001,2781429385.865800,8227174812.859295,15682736235.035096,511178,183870,504789,1199837
2019-10-31,FINRA / Nasdaq TRF Carteret (DQ),1219266344,441354790,721928776,2382549910,46864538012.127002,25040403309.855402,38680833071.981997,110585774393.964401,4325051,807699,2555562,7688312
2019-10-31,EDGA Equities (J),110613510,23860886,50862909,185337305,3834571419.105000,1535685132.864300,2309558226.897500,7679814778.866800,1149749,123423,566558,1839730
2019-10-31,EDGX Equities (K),189240513,83644537,131820896,404705946,6096435811.724900,4686571053.164203,6051478455.684203,16834485320.573306,1500330,320797,1031577,2852704
2019-10-31,NYSE Chicago (M),5381106,11391474,7976902,24749482,313895056.457600,1097625675.743000,900461561.804500,2311982294.005100,6076,1255,4649,11980
2019-10-31,NYSE (N),1156785582,40388200,38817066,1235990848,47072716375.257600,2516246561.257900,1848906501.069700,51437869437.585200,3251774,109911,270121,3631806
2019-10-31,NYSE Arca (P),187979545,293333900,156978751,638292196,7132507673.047199,17840611198.005296,8526600229.881901,33499719100.934396,1633982,755291,1417782,3807055
2019-10-31,NASDAQ (Q),450863173,180447803,656316990,1287627966,18700545043.732393,11141654862.475294,36977389558.687498,66819589464.895185,4173587,718951,4311634,9204172
2019-10-31,IEX (V),124810298,18916038,65319961,209046297,5059995082.912701,1250320701.731300,3419100128.382001,9729415913.026002,928710,89741,520246,1538697
2019-10-31,NASDAQ PSX (X),13738549,15842414,11394268,40975231,489750427.708700,987793873.953400,673171733.663500,2150716035.325600,110290,65577,89359,265226
2019-10-31,BYX Equities (Y),129173853,62958877,56919344,249052074,3562814115.047900,2992068032.803700,2309793132.668500,8864675280.520100,1204315,282334,591298,2077947
2019-10-31,BZX Equities (Z),231478750,85831687,138564397,455874834,9928290552.412103,5815025520.202100,8904010877.626101,24647326950.240304,2069777,348686,1320460,3738923
2019-10-30,NYSE American (A),5570053,13128075,2546477,21244605,232312611.477200,151828866.291300,149824396.977200,533965874.745700,57570,43350,27879,128799
2019-10-30,NASDAQ BX (B),45480829,21152573,22700542,89333944,1763702674.878300,1092633972.653400,1243307634.094600,4099644281.626300,452683,106082,242820,801585
2019-10-30,NYSE National (C),77644715,31194025,23419155,132257895,1464669756.047100,1040800622.861800,652031548.892600,3157501927.801500,604133,121245,238654,964032
2019-10-30,FINRA / Nasdaq TRF Chicago (DB),2869873,1252200,3091213,7213286,96418903.423000,53862048.794000,238380869.423200,388661821.640200,12159,4163,15467,31789
2019-10-30,FINRA / NYSE TRF (DN),219778163,82932299,170374308,473084770,5096295439.334100,2576383933.948800,7853688466.563999,15526367839.846899,552003,168608,511855,1232466
2019-10-30,FINRA / Nasdaq TRF Carteret (DQ),1146879036,318419038,594950727,2060248801,41694403354.780603,16809963161.262201,30613843302.477884,89118209818.520688,4283852,724480,2499123,7507455
2019-10-30,EDGA Equities (J),104815265,20944020,44271260,170030545,3712489517.768800,1156496481.781000,2162145025.750300,7031131025.300100,1127698,116981,547369,1792048
2019-10-30,EDGX Equities (K),200092732,84764310,130505579,415362621,6203652203.003600,4508349718.834103,6937108867.795199,17649110789.632902,1510526,320117,1014789,2845432
2019-10-30,NYSE Chicago (M),7768855,7238012,3926294,18933161,336416767.235400,850760400.410000,513417612.495100,1700594780.140500,5912,944,4323,11179
2019-10-30,NYSE (N),836957757,41582974,36033905,914574636,32774765900.945400,2268792092.999501,1741038886.289500,36784596880.234401,3205010,109683,252391,3567084
2019-10-30,NYSE Arca (P),194428083,263093674,142642450,600164207,7203961949.197400,15106795104.183202,8068955752.407601,30379712805.788203,1653394,717704,1358846,3729944
2019-10-30,NASDAQ (Q),457249184,175414893,521148768,1153812845,18660960929.483098,9865211814.671501,30248519378.903201,58774692123.057800,4145477,701194,4110033,8956704
2019-10-30,IEX (V),117254736,16859736,58479842,192594314,4948362677.382600,1098645560.702300,3087485318.229500,9134493556.314400,893824,83909,478848,1456581
2019-10-30,NASDAQ PSX (X),15297016,15869749,11011953,42178718,487234538.210500,920752050.519000,715846223.153800,2123832811.883300,115221,59015,84293,258529
2019-10-30,BYX Equities (Y),124647477,56064285,51988689,232700451,3471186087.500900,2606758376.361501,2187821268.287000,8265765732.149401,1212325,260038,577404,2049767
2019-10-30,BZX Equities (Z),222927354,86888308,118969727,428785389,9141808172.459800,5563386747.569399,7575970071.025500,22281164991.054699,1962397,358771,1183034,3504202
2019-10-29,NYSE American (A),4859185,12474238,2547592,19881015,222819000.615400,133267246.095600,141885689.215800,497971935.926800,51232,42542,26684,120458
2019-10-29,NASDAQ BX (B),44343916,17892153,25815597,88051666,1760175359.752000,878513856.857500,1262692209.132900,3901381425.742400,433810,85464,237222,756496
2019-10-29,NYSE National (C),76177459,27154379,23716788,127048626,1444339313.163900,880710323.492200,649803320.267900,2974852956.924000,576628,100536,229054,906218
2019-10-29,FINRA / Nasdaq TRF Chicago (DB),2669815,1037262,2840237,6547314,111953941.725000,40495446.005600,218965436.673000,371414824.403600,12195,3352,14976,30523
2019-10-29,FINRA / NYSE TRF (DN),200860439,85368971,153581751,439811161,5291551810.551101,2618746208.264600,7822735176.810399,15733033195.626100,539073,181003,485650,1205726
2019-10-29,FINRA / Nasdaq TRF Carteret (DQ),1097963296,317648345,581135292,1996746933,42027302629.705994,17476244405.367699,31910585877.554298,91414132912.627991,4091428,717325,2292335,7101088
2019-10-29,EDGA Equities (J),102377384,18606666,43108392,164092442,3817746256.311200,994442439.441300,2081300661.472000,6893489357.224500,1098988,100729,519524,1719241
2019-10-29,EDGX Equities (K),181256945,72345497,120868877,374471319,6215336482.930803,3471516084.650399,6152217066.218796,15839069633.799998,1764595,277439,1078893,3120927
2019-10-29,NYSE Chicago (M),10792599,8044764,4575601,23412964,512662592.926700,826579756.897100,509610487.303000,1848852837.126800,5001,1000,4062,10063
2019-10-29,NYSE (N),808080078,34436085,33764758,876280921,32952833280.641495,1981133860.376600,1693225090.666300,36627192231.684395,2904453,88907,238574,3231934
2019-10-29,NYSE Arca (P),174205278,208063279,129367622,511636179,7038761283.776001,11855128722.232403,7309899496.014299,26203789502.022703,1563515,573563,1236805,3373883
2019-10-29,NASDAQ (Q),427152313,138626895,494665445,1060444653,18758998546.565999,7709296963.873795,28832069364.572184,55300364875.011978,4013814,569095,3869906,8452815
2019-10-29,IEX (V),116064678,14998456,54487767,185550901,5033383534.764600,925815244.151000,3093885390.456300,9053084169.371900,869047,78618,458361,1406026
2019-10-29,NASDAQ PSX (X),13833199,13222272,9570542,36626013,503130891.372600,793864031.829600,604832172.181200,1901827095.383400,113782,57334,78099,249215
2019-10-29,BYX Equities (Y),121962991,49035966,51855236,222854193,3545264129.752600,2141616575.340100,2063004694.087900,7749885399.180600,1193941,214289,560672,1968902
2019-10-29,BZX Equities (Z),211839222,67118888,110822879,389780989,9344449044.628901,4125038501.097000,7222223434.188798,20691710979.914699,1926818,282827,1123878,3333523
2019-10-28,NYSE American (A),4508163,13519641,2507652,20535456,209783503.914000,138962731.541000,140549376.494700,489295611.949700,48354,41640,25997,115991
2019-10-28,NASDAQ BX (B),41075284,19433605,22531510,83040399,1641237508.212300,936878715.139900,1277718953.312200,3855835176.664400,390951,86791,224957,702699
2019-10-28,NYSE National (C),70209397,27146182,22718080,120073659,1378039821.934000,945436380.142200,607479530.942100,2930955733.018300,553204,105933,223144,882281
2019-10-28,FINRA / Nasdaq TRF Chicago (DB),2951984,1147703,3528326,7628013,105943575.187900,43839379.623000,300209320.118400,449992274.929300,12819,3960,18136,34915
2019-10-28,FINRA / NYSE TRF (DN),215154376,81051495,174037552,470243423,5702710028.032201,2713382171.166500,9470393466.070400,17886485665.269101,606277,184294,556857,1347428
2019-10-28,FINRA / Nasdaq TRF Carteret (DQ),1108184626,347950829,644172657,2100308112,45100394751.957096,19085303942.720703,36075098190.567200,100260796885.244999,4045311,720318,2401513,7167142
2019-10-28,EDGA Equities (J),94633222,21359042,42325478,158317742,3641081349.783300,1087485966.896400,2106317169.554700,6834884486.234400,1054307,110935,520148,1685390
2019-10-28,EDGX Equities (K),177139780,71698044,118899024,367736848,5989097439.017898,3720099166.613398,6463067540.166803,16172264145.798099,1424114,265799,955141,2645054
2019-10-28,NYSE Chicago (M),7655261,8977926,5215700,21848887,357003705.175500,983097766.690000,722493226.811000,2062594698.676500,4840,883,4396,10119
2019-10-28,NYSE (N),776698606,34729327,32000682,843428615,33446576650.503804,1973674278.810800,1588023139.703200,37008274069.017804,2793434,87650,232644,3113728
2019-10-28,NYSE Arca (P),172881937,222088717,137268011,532238665,6883561246.310999,12331571705.702603,7779297811.817092,26994430763.830694,1475987,569802,1249751,3295540
2019-10-28,NASDAQ (Q),411495358,139232109,522343030,1073070497,17662680264.240399,7835118521.538901,31924141817.134595,57421940602.913895,3739263,546329,3844838,8130430
2019-10-28,IEX (V),110995232,17493074,58023613,186511919,5029610062.244401,937571802.075700,3420020105.565000,9387201969.885101,825195,80950,457749,1363894
2019-10-28,NASDAQ PSX (X),12480197,12977924,9412172,34870293,434151929.994500,771718882.084800,682271921.703400,1888142733.782700,100604,57559,81489,239652
2019-10-28,BYX Equities (Y),117220769,53187748,51412249,221820766,3521133934.698500,2336069973.745500,2118615530.950100,7975819439.394100,1156958,230920,553450,1941328
2019-10-28,BZX Equities (Z),201692853,68174636,113528781,383396270,8987662954.725097,4104695948.561200,7615993745.241403,20708352648.527700,1823823,268795,1142755,3235373
2019-10-25,NYSE American (A),4331637,15307794,2487006,22126437,190701923.613000,114350617.530400,152999537.964000,458052079.107400,45516,43861,26013,115390
2019-10-25,NASDAQ BX (B),39232593,17452931,22339280,79024804,1420288931.612700,836256396.748600,1429816850.155600,3686362178.516900,366361,83899,232790,683050
2019-10-25,NYSE National (C),71258741,27634370,22156517,121049628,1290728964.530200,858549610.700600,605082359.831100,2754360935.061900,524751,100019,215307,840077
2019-10-25,FINRA / Nasdaq TRF Chicago (DB),2554538,1100601,3479802,7134941,98415534.673900,39751603.613500,393072033.082300,531239171.369700,11348,3738,20270,35356
2019-10-25,FINRA / NYSE TRF (DN),194733390,82197279,173725387,450656056,4711607582.131398,2453872998.617599,9830454909.506601,16995935490.255598,507468,166555,538874,1212897
2019-10-25,FINRA / Nasdaq TRF Carteret (DQ),1061089089,313649693,617068581,1991807363,38301907256.494198,16580321333.581001,34323059659.585292,89205288249.660491,3729443,687960,2404132,6821535
2019-10-25,EDGA Equities (J),83948982,18532425,37288189,139769596,3124345178.500000,942818872.390100,1956781806.090900,6023945856.981000,915377,96762,458178,1470317
2019-10-25,EDGX Equities (K),163734294,70576296,120402158,354712748,5215809470.246899,3394293358.709001,6927528052.196897,15537630881.152797,1240521,252845,924532,2417898
2019-10-25,NYSE Chicago (M),7197968,9972701,3571878,20742547,424495390.130200,1220337105.974500,497279411.044200,2142111907.148900,4939,901,4983,10823
2019-10-25,NYSE (N),778781396,35803181,33038444,847623021,30515050654.965601,2050663723.091500,1694144916.421500,34259859294.478601,2716558,89700,234050,3040308
2019-10-25,NYSE Arca (P),157707700,229765970,133336069,520809739,5928929996.000798,12256765783.976401,8408616398.795496,26594312178.772695,1359121,571454,1246670,3177245
2019-10-25,NASDAQ (Q),389915297,141165329,508837765,1039918391,16186689991.624003,7749833391.621995,32838077891.725302,56774601274.971300,3539906,546714,3855752,7942372
2019-10-25,IEX (V),103205947,16041337,53809614,173056898,4147964787.257500,884776360.946300,3251695373.552099,8284436521.755899,752222,83409,428285,1263916
2019-10-25,NASDAQ PSX (X),12140545,13746768,10353639,36240952,405239234.339000,895779307.439600,811121672.617800,2112140214.396400,92776,59282,88635,240693
2019-10-25,BYX Equities (Y),116898532,50751642,52284963,219935137,3168228785.509500,2177077819.434601,2183575843.561000,7528882448.505101,1074409,219071,545538,1839018
2019-10-25,BZX Equities (Z),192339103,63713586,117405111,373457800,8393358140.912201,3837257496.048200,8650972353.494900,20881587990.455301,1711691,255633,1151766,3119090
2019-10-24,NYSE American (A),4961155,11406333,2363476,18730964,210432667.252400,109934095.728000,150340854.546000,470707617.526400,52620,37885,27056,117561
2019-10-24,NASDAQ BX (B),44289196,18452495,21976152,84717843,1549387097.168400,848304070.654200,1312717668.386100,3710408836.208700,376120,86077,227837,690034
2019-10-24,NYSE National (C),70489702,22525463,21385311,114400476,1312690080.097200,753847140.396900,674932990.258200,2741470210.752300,515710,89640,216931,822281
2019-10-24,FINRA / Nasdaq TRF Chicago (DB),3050059,1123768,2981448,7155275,115575819.463100,39610677.987300,294774434.724600,449960932.175000,12749,3428,17484,33661
2019-10-24,FINRA / NYSE TRF (DN),207339818,74339954,158878162,440557934,5317313371.003701,2218130460.443000,7653772082.262803,15189215913.709504,522236,153423,471643,1147302
2019-10-24,FINRA / Nasdaq TRF Carteret (DQ),1236173485,298192443,637952976,2172318904,43528658697.096899,14065553806.585396,33211916205.387230,90806128709.069525,3892750,645072,2319877,6857699
2019-10-24,EDGA Equities (J),88299912,19589633,36325406,144214951,3120995469.071800,935681719.896800,1876405189.806100,5933082378.774700,911942,96719,455590,1464251
2019-10-24,EDGX Equities (K),177519624,67899614,112531656,357950894,5429840908.105000,3179259974.367601,6625806887.565999,15234907770.038600,1220927,240459,882785,2344171
2019-10-24,NYSE Chicago (M),7756123,10223188,4148285,22127596,399005688.076000,1052414905.575000,469155535.740400,1920576129.391400,5996,772,4866,11634
2019-10-24,NYSE (N),805764723,34619906,35279837,875664466,31152597207.640497,1895209933.259900,1713459916.675200,34761267057.575597,2692285,84845,237923,3015053
2019-10-24,NYSE Arca (P),179378123,223270522,129799111,532447756,6703755568.727801,12219504798.539897,9012317720.960300,27935578088.227998,1401252,581754,1258371,3241377
2019-10-24,NASDAQ (Q),420581534,143627454,500570153,1064779141,16950279251.358304,7647457953.756898,31399197597.611597,55996934802.726799,3578964,557395,3837625,7973984
2019-10-24,IEX (V),111652382,14723455,58638188,185014025,4821636283.670301,903347255.813100,3659488573.199001,9384472112.682402,807035,73841,477579,1358455
2019-10-24,NASDAQ PSX (X),15024699,12792313,10337329,38154341,451973542.167400,707067410.621300,687144588.468400,1846185541.257100,108855,52277,88352,249484
2019-10-24,BYX Equities (Y),123001056,48934850,49591083,221526989,3160594514.908600,2102315571.935400,2021979972.735800,7284890059.579800,1060762,222935,528649,1812346
2019-10-24,BZX Equities (Z),201229512,62833580,110867618,374930710,8255154006.473202,3797200528.689002,7366971794.783401,19419326329.945605,1697909,253174,1087570,3038653
2019-10-23,NYSE American (A),4083909,9699185,2197855,15980949,186905198.945000,112683582.733400,123161103.564800,422749885.243200,44339,34451,23648,102438
2019-10-23,NASDAQ BX (B),39801825,18327329,21711302,79840456,1571702581.343200,806259710.841100,1115064220.441600,3493026512.625900,375684,85071,213885,674640
2019-10-23,NYSE National (C),66941271,24556427,21796602,113294300,1338288075.812000,747475751.815300,676609932.977700,2762373760.605000,528022,89651,218024,835697
2019-10-23,FINRA / Nasdaq TRF Chicago (DB),3117432,1129787,2683056,6930275,152788387.949900,46724282.865000,205664999.475300,405177670.290200,14077,3499,14988,32564
2019-10-23,FINRA / NYSE TRF (DN),181483721,71614287,160128595,413226603,5208722803.718397,2094422586.631801,6308258886.263900,13611404276.614098,471382,147056,438739,1057177
2019-10-23,FINRA / Nasdaq TRF Carteret (DQ),1101091038,284212991,610150728,1995454757,43502185558.073201,14107125422.335096,29871796574.283288,87481107554.691585,3909768,604270,2227732,6741770
2019-10-23,EDGA Equities (J),83557845,15406093,36574700,135538638,3276208003.899600,769698095.408700,1770384217.646800,5816290316.955100,943813,86784,455836,1486433
2019-10-23,EDGX Equities (K),161842460,61177271,107172085,330191816,5537765538.147801,2854046412.211600,5366726123.888101,13758538074.247502,1260153,221872,851903,2333928
2019-10-23,NYSE Chicago (M),7858581,7573793,5748393,21180767,374033752.695300,602051862.686100,636002885.676200,1612088501.057600,5892,723,4969,11584
2019-10-23,NYSE (N),772897868,29771938,31149783,833819589,33090820423.704299,1547789741.673400,1504697613.557500,36143307778.935199,2729238,78970,222511,3030719
2019-10-23,NYSE Arca (P),167434039,190546780,124612804,482593623,6927174093.343202,10102410417.901499,7192515351.986402,24222099863.231103,1475751,518830,1223601,3218182
2019-10-23,NASDAQ (Q),402360614,129901682,484518176,1016780472,17632911044.129100,7172195805.576505,27925774699.255215,52730881548.960820,3797650,523787,3755922,8077359
2019-10-23,IEX (V),109168702,13684295,55649930,178502927,4749267873.191500,806770906.081100,3186269863.706300,8742308642.978900,835438,68228,465172,1368838
2019-10-23,NASDAQ PSX (X),13828745,11183392,8733916,33746053,494181194.284500,658960679.215100,508548719.454900,1661690592.954500,107058,52492,75783,235333
2019-10-23,BYX Equities (Y),108118725,43280227,44434119,195833071,3065009464.565800,1878854941.517600,1836091138.120900,6779955544.204300,1059334,198186,507291,1764811
2019-10-23,BZX Equities (Z),190020538,54529761,104920782,349471081,8555502265.525897,3289047494.977299,6179460498.311100,18024010258.814296,1756324,237581,1038098,3032003
2019-10-22,NYSE American (A),4654113,10440011,2222341,17316465,220740787.910600,111802868.436500,125539770.997800,458083427.344900,48064,36209,24377,108650
2019-10-22,NASDAQ BX (B),41541097,20278686,22190908,84010691,1699411459.865200,953198197.475600,1166252740.361200,3818862397.702000,401730,87257,221793,710780
2019-10-22,NYSE National (C),70317577,25520073,22003969,117841619,1413407631.963600,869756415.005700,670734308.270800,2953898355.240100,536051,96552,220082,852685
2019-10-22,FINRA / Nasdaq TRF Chicago (DB),2831017,1065555,2827626,6724198,137330889.370000,56960193.410000,268503505.963300,462794588.743300,13747,3312,16489,33548
2019-10-22,FINRA / NYSE TRF (DN),189880052,77660492,164635233,432175777,5622851416.627100,2557530442.608201,7825024397.390995,16005406256.626296,520334,160766,480733,1161833
2019-10-22,FINRA / Nasdaq TRF Carteret (DQ),1114254420,333993702,596395336,2044643458,44567101969.138500,19123171125.918701,31174365278.721707,94864638373.778908,3981960,693082,2262894,6937936
2019-10-22,EDGA Equities (J),87521894,18416494,38446184,144384572,3444241836.563200,949522765.637400,1823776910.255700,6217541512.456300,943269,95049,462578,1500896
2019-10-22,EDGX Equities (K),173798126,66818219,111785979,352402324,6057889970.751500,3584150157.762900,5524064065.986403,15166104194.500803,1354226,255878,915057,2525161
2019-10-22,NYSE Chicago (M),12778854,11488607,5793008,30060469,555000928.896300,1769756796.088701,699468956.926900,3024226681.911901,5885,879,5361,12125
2019-10-22,NYSE (N),752353495,35351965,33288297,820993757,31439318626.185901,1887155017.842200,1717702248.465199,35044175892.493300,2857133,91624,242109,3190866
2019-10-22,NYSE Arca (P),175865771,214391305,132802888,523059964,7548705349.100400,12069686772.565101,7786475851.609895,27404867973.275396,1590253,615693,1299981,3505927
2019-10-22,NASDAQ (Q),444966997,156641661,494256234,1095864892,19508541068.464301,8820234293.099002,29344370326.105188,57673145687.668491,4117218,610429,4034415,8762062
2019-10-22,IEX (V),115775074,14895699,55936956,186607729,5191998044.755900,828095613.651900,3276404218.690601,9296497877.098401,845455,71962,452143,1369560
2019-10-22,NASDAQ PSX (X),15135319,14626291,10088229,39849839,550327609.225800,806994638.866200,669143208.679000,2026465456.771000,116825,62062,91064,269951
2019-10-22,BYX Equities (Y),121606686,51018211,46225318,218850215,3453067001.220300,2260838085.170100,1951771694.352800,7665676780.743200,1200222,232949,551799,1984970
2019-10-22,BZX Equities (Z),204261222,68050070,111975574,384286866,9355027921.687904,4245134527.204200,6991477389.748101,20591639838.640205,1880986,281956,1131463,3294405
2019-10-21,NYSE American (A),4562961,10859879,2203297,17626137,178536404.857700,128724150.624200,115789985.889300,423050541.371200,43480,36460,22586,102526
2019-10-21,NASDAQ BX (B),36247848,20596385,21642752,78486985,1434841323.351500,981730827.567500,976123570.785500,3392695721.704500,358276,77448,204146,639870
2019-10-21,NYSE National (C),61524730,22920603,22427980,106873313,1195197869.398800,750472426.526400,589749671.192300,2535419967.117500,503247,81946,227574,812767
2019-10-21,FINRA / Nasdaq TRF Chicago (DB),2567529,977235,2443457,5988221,110663494.392000,43352471.650000,184596926.905000,338612892.947000,11773,3312,13726,28811
2019-10-21,FINRA / NYSE TRF (DN),186707300,69332264,148831303,404870867,4903483433.926101,2157751490.340899,6198879865.334794,13260114789.601794,476757,157261,431875,1065893
2019-10-21,FINRA / Nasdaq TRF Carteret (DQ),1038620464,351740309,561970481,1952331254,39363745832.222091,18266425472.889404,26770559935.761108,84400731240.872603,3660707,663572,2116381,6440660
2019-10-21,EDGA Equities (J),78017611,17112795,36193110,131323516,3121827200.983200,954191385.855900,1714912266.206700,5790930853.045800,910356,96347,469796,1476499
2019-10-21,EDGX Equities (K),152003137,58277138,104454711,314734986,4903832366.011899,3018945211.882801,4508388159.828100,12431165737.722800,1164871,228730,796009,2189610
2019-10-21,NYSE Chicago (M),8039976,9206480,3800143,21046599,462534330.632900,795891463.626500,498578694.592200,1757004488.851600,5658,788,4293,10739
2019-10-21,NYSE (N),778171981,29647994,31155151,838975126,32926188654.157701,1686210896.718800,1294910152.824400,35907309703.700901,2583806,82803,214896,2881505
2019-10-21,NYSE Arca (P),149626240,202787137,114652283,467065660,5801361858.040402,11213169690.496298,5824801577.491799,22839333126.028499,1324468,520050,1126476,2970994
2019-10-21,NASDAQ (Q),381954638,132249131,507537909,1021741678,16004113837.861101,7698801676.348505,26990343065.471894,50693258579.681500,3515671,521044,3582676,7619391
2019-10-21,IEX (V),103513813,14275758,49996166,167785737,4283729155.894100,796420077.679500,2514596402.859001,7594745636.432601,744663,75118,406772,1226553
2019-10-21,NASDAQ PSX (X),12696824,11113354,8581355,32391533,417859220.942600,645820591.895600,482057978.231500,1545737791.069700,96053,46722,72722,215497
2019-10-21,BYX Equities (Y),103998415,45968819,41719132,191686366,2919827412.725900,2062832187.416700,1607907872.001100,6590567472.143700,1033331,198360,498099,1729790
2019-10-21,BZX Equities (Z),173710680,57393776,99035101,330139557,7458437350.103401,3624314454.442899,5399187933.199101,16481939737.745401,1597927,245871,998377,2842175
2019-10-18,NYSE American (A),4414755,11183709,2439451,18037915,221195987.680800,132344264.088400,143987178.557000,497527430.326200,48673,35514,27116,111303
2019-10-18,NASDAQ BX (B),37858381,26229541,26537342,90625264,1538321087.074900,1310980062.692000,1331558689.444500,4180859839.211400,372024,121011,251291,744326
2019-10-18,NYSE National (C),66463636,24770118,24645774,115879528,1337355715.408800,823401953.680500,727432539.780900,2888190208.870200,530119,94828,246654,871601
2019-10-18,FINRA / Nasdaq TRF Chicago (DB),2473332,1011254,3012299,6496885,117291187.770000,58495624.070000,258790566.992000,434577378.832000,11384,3455,16419,31258
2019-10-18,FINRA / NYSE TRF (DN),151393164,70568639,164472030,386433833,4693752715.611700,2445553996.065600,7820615941.574198,14959922653.251498,430085,147115,469987,1047187
2019-10-18,FINRA / Nasdaq TRF Carteret (DQ),972768837,300365503,637182185,1910316525,40003733337.802902,18660253786.054992,31676070855.989599,90340057979.847493,3496772,639292,2196366,6332430
2019-10-18,EDGA Equities (J),80511771,20607713,41906707,143026191,3303685652.198700,1135601530.080400,2094505939.376000,6533793121.655100,937457,112623,528420,1578500
2019-10-18,EDGX Equities (K),145202387,64180456,113940002,323322845,5431500311.793499,3612817383.291800,5828176677.868197,14872494372.953496,1215010,253111,924219,2392340
2019-10-18,NYSE Chicago (M),14898060,27243017,8581178,50722255,767683536.043100,1948111316.761600,1532232898.377400,4248027751.182100,4898,1092,4257,10247
2019-10-18,NYSE (N),864144173,32577379,36805615,933527167,40816280148.844799,1971567339.999800,1663922247.696600,44451769736.541199,2639219,91930,247930,2979079
2019-10-18,NYSE Arca (P),151038904,213180168,135706444,499925516,6644685259.367000,12938833585.671495,7616334608.858898,27199853453.897393,1412075,598748,1285958,3296781
2019-10-18,NASDAQ (Q),384204037,146249304,593674680,1124128021,18286940885.432898,9000366742.933096,36181912828.434190,63469220456.800184,3786074,589934,4119188,8495196
2019-10-18,IEX (V),95482528,15076120,53684428,164243076,4452387868.697100,926374850.596000,3086069194.240699,8464831913.533799,749714,75905,438986,1264605
2019-10-18,NASDAQ PSX (X),12948707,13931301,11430525,38310533,558940452.444700,1017460085.070000,774333226.174000,2350733763.688700,111029,61996,100482,273507
2019-10-18,BYX Equities (Y),110147854,51701689,48651608,210501151,3213780868.201600,2481088978.614100,2053193755.246700,7748063602.062400,1095354,232001,564204,1891559
2019-10-18,BZX Equities (Z),175028851,65358822,117358738,357746411,8429812862.174299,4540422151.839202,7806456917.770501,20776691931.784002,1661919,284448,1156041,3102408
2019-10-17,NYSE American (A),4043132,12655143,2247676,18945951,181826609.685000,140928707.361500,124797703.718500,447553020.765000,47190,41650,26368,115208
2019-10-17,NASDAQ BX (B),37384520,25941819,25754895,89081234,1394906272.005000,1258830610.939300,1316237134.529900,3969974017.474200,370247,117675,252331,740253
2019-10-17,NYSE National (C),63120598,25316603,22849000,111286201,1203874190.577500,848374011.742500,631143124.022400,2683391326.342400,503619,92852,228750,825221
2019-10-17,FINRA / Nasdaq TRF Chicago (DB),2040445,1165652,2651392,5857489,80714490.490000,47876583.104300,263880365.196800,392471438.791100,9924,3534,16675,30133
2019-10-17,FINRA / NYSE TRF (DN),163099691,81107559,164996785,409204035,4208689539.523000,2462524011.966201,7835983827.542197,14507197379.031398,419650,166078,470422,1056150
2019-10-17,FINRA / Nasdaq TRF Carteret (DQ),979122798,326840170,598087821,1904050789,37557046802.245503,16887719943.380703,28620577396.527999,83065344142.154205,3439158,666709,2138188,6244055
2019-10-17,EDGA Equities (J),77364711,22344726,39927773,139637210,3009343453.232800,1224694399.657000,1900620371.972500,6134658224.862300,902794,121461,491575,1515830
2019-10-17,EDGX Equities (K),139843767,65886832,110844180,316574779,4575360188.700099,3574241387.277400,5248023258.637604,13397624834.615103,1167614,257522,864606,2289742
2019-10-17,NYSE Chicago (M),8059470,17709424,8074698,33843592,540396965.850300,1737171602.013800,721551033.558400,2999119601.422500,4708,1043,4556,10307
2019-10-17,NYSE (N),729487976,32008111,31794610,793290697,29328332545.738098,1895252696.919500,1461877335.529500,32685462578.187098,2510661,93220,220577,2824458
2019-10-17,NYSE Arca (P),143884001,218697564,125165398,487746963,5693785556.092999,12011687010.247096,6578302679.159501,24283775245.499596,1327665,597684,1181468,3106817
2019-10-17,NASDAQ (Q),375057543,149107997,520539014,1044704554,16035052767.104599,8233394272.027500,28441968607.807510,52710415646.939609,3533937,586953,3694122,7815012
2019-10-17,IEX (V),92164360,15497328,52209056,159870744,3942014049.730200,912838157.651200,2855187370.402300,7710039577.783700,711336,68839,419099,1199274
2019-10-17,NASDAQ PSX (X),14006439,13119882,10472867,37599188,477581434.909100,830429265.953900,708870239.959600,2016880940.822600,119710,60184,101880,281774
2019-10-17,BYX Equities (Y),105666090,53105083,44395099,203166272,2913955619.398000,2345188910.656400,1746747118.300600,7005891648.355000,1060453,227161,519570,1807184
2019-10-17,BZX Equities (Z),169129037,65271591,104013965,338414593,7299484305.151000,4135689146.750602,6466546956.531301,17901720408.432903,1549829,273494,1027391,2850714
2019-10-16,NYSE American (A),4230496,9594739,2736999,16562234,193094445.915500,131407088.718700,180291446.200100,504792980.834300,48175,36940,29317,114432
2019-10-16,NASDAQ BX (B),40330835,25412473,27257637,93000945,1546535629.063200,1296937947.900500,1403954880.561200,4247428457.524900,403648,117828,269189,790665
2019-10-16,NYSE National (C),67704970,24315338,23073845,115094153,1298952892.543800,814411860.019100,656961286.757700,2770326039.320600,529244,93686,229367,852297
2019-10-16,FINRA / Nasdaq TRF Chicago (DB),2189053,1073849,2754149,6017051,88198071.475900,51394125.129000,216595163.616300,356187360.221200,9810,3315,14944,28069
2019-10-16,FINRA / NYSE TRF (DN),168770396,74492438,167346681,410609515,4320106919.548700,2531163220.316599,6990410554.779298,13841680694.644597,428360,167301,455708,1051369
2019-10-16,FINRA / Nasdaq TRF Carteret (DQ),1013769195,324204320,614838022,1952811537,37998719254.943290,17845805905.375904,29193508879.658697,85038034039.977891,3495903,693875,2178144,6367922
2019-10-16,EDGA Equities (J),80528837,21783402,41222457,143534696,3117029506.787800,1188541338.631500,2024066860.835100,6329637706.254400,924621,118661,497933,1541215
2019-10-16,EDGX Equities (K),149343588,64167102,118603723,332114413,4962196530.485500,3462952846.784098,5782262204.620497,14207411581.890095,1303668,255704,1011172,2570544
2019-10-16,NYSE Chicago (M),6078951,17417235,5821320,29317506,383496890.841000,2191311020.572200,846996955.103100,3421804866.516300,5107,1111,4329,10547
2019-10-16,NYSE (N),752976505,36163948,34086974,823227427,31874973251.673202,2068400954.876000,1614402956.227600,35557777162.776802,2678132,95863,259669,3033664
2019-10-16,NYSE Arca (P),151048655,224961316,133972075,509982046,6068394088.649299,12541615231.384399,7221931743.861198,25831941063.894896,1412324,570137,1261121,3243582
2019-10-16,NASDAQ (Q),388883191,152191956,506604830,1047679977,16348418715.641005,8836378681.556499,28447415660.338589,53632213057.536093,3654909,588128,3766182,8009219
2019-10-16,IEX (V),100619107,15034287,53419562,169072956,4496320733.265700,909959415.863100,2890873936.027400,8297154085.156200,779173,68788,441365,1289326
2019-10-16,NASDAQ PSX (X),14656621,15517146,11829468,42003235,545005712.317900,946632829.153600,691357435.625500,2182995977.097000,124712,66073,103892,294677
2019-10-16,BYX Equities (Y),115550558,51334857,51213415,218098830,3197114746.240200,2366533183.693099,1882471164.424000,7446119094.357299,1122294,227842,553337,1903473
2019-10-16,BZX Equities (Z),173641715,63724449,105233287,342599451,7529887340.646100,4161778831.370200,6443142343.227501,18134808515.243801,1637130,276967,1080687,2994784
2019-10-15,NYSE American (A),4432921,12382581,2451947,19267449,197278794.242900,154528220.950200,146092023.762500,497899038.955600,48387,42447,27150,117984
2019-10-15,NASDAQ BX (B),40740214,29422504,27764618,97927336,1470604072.585600,1541469956.641900,1384622471.567500,4396696500.795000,404115,130133,269724,803972
2019-10-15,NYSE National (C),70878849,27952845,23512892,122344586,1379295894.801500,987402490.039600,677974572.287200,3044672957.128300,564212,107609,238612,910433
2019-10-15,FINRA / Nasdaq TRF Chicago (DB),2781141,1258944,2870016,6910101,124794005.283900,67908964.539000,223640737.066000,416343706.888900,12194,4396,15788,32378
2019-10-15,FINRA / NYSE TRF (DN),177370266,83094262,158902518,419367046,4825882556.237098,2663058690.407299,7421492915.017002,14910434161.661399,451856,177785,469643,1099284
2019-10-15,FINRA / Nasdaq TRF Carteret (DQ),1058028254,360809350,600905530,2019743134,39899470020.258197,19464831683.383297,29564838265.843198,88929139969.484692,3640734,743867,2166660,6551261
2019-10-15,EDGA Equities (J),86004324,24729232,40669011,151402567,3316136652.173600,1353574619.285400,2021704809.335700,6691416080.794700,1001299,141488,519520,1662307
2019-10-15,EDGX Equities (K),158708375,73403201,115776762,347888338,5341748492.486099,3975042344.514100,5609899820.052798,14926690657.052997,1264274,283880,900112,2448266
2019-10-15,NYSE Chicago (M),7155160,10954783,4330911,22440854,412010083.026500,1217649880.516100,504978690.297800,2134638653.840400,5623,1566,4944,12133
2019-10-15,NYSE (N),733742274,42898730,35544033,812185037,29528299415.371097,2391066439.261500,1709051117.702200,33628416972.334797,2776884,111541,240315,3128740
2019-10-15,NYSE Arca (P),163831005,258691695,126427309,548950009,6395636826.468599,13749757267.572500,7356176247.107895,27501570341.148994,1418850,646373,1360427,3425650
2019-10-15,NASDAQ (Q),417591955,178829367,488945601,1085366923,17525734003.773899,9956598673.179703,27741099789.597010,55223432466.550612,3848962,661955,3877091,8388008
2019-10-15,IEX (V),103716517,17883799,50663184,172263500,4410238996.389600,1041753931.818900,2694472786.876600,8146465715.085100,780953,84028,416773,1281754
2019-10-15,NASDAQ PSX (X),14287566,18444162,11611921,44343649,574221613.616800,1095064780.307900,767516127.352700,2436802521.277400,124628,76955,105831,307414
2019-10-15,BYX Equities (Y),122347302,60225439,50103639,232676380,3336318291.716600,2823973503.322101,2092663635.476000,8252955430.514701,1207293,270002,576562,2053857
2019-10-15,BZX Equities (Z),183476889,73038834,101187442,357703165,7986431207.559101,4680729091.088601,6260261975.110401,18927422273.758103,1665713,302142,1038748,3006603
2019-10-14,NYSE American (A),3195605,10285081,1877611,15358297,130900419.179000,106340093.007600,108186966.399900,345427478.586500,34281,35896,20159,90336
2019-10-14,NASDAQ BX (B),31378280,18035969,19346757,68761006,1070209120.536300,896039641.353400,911505880.904800,2877754642.794500,305216,83579,202607,591402
2019-10-14,NYSE National (C),53810874,18048731,18013162,89872767,1008586115.092700,567791924.705500,495482795.779100,2071860835.577300,454043,79953,192282,726278
2019-10-14,FINRA / Nasdaq TRF Chicago (DB),2046037,898077,2163922,5108036,67861437.865000,38756434.525000,144506207.201800,251124079.591800,8281,3330,11798,23409
2019-10-14,FINRA / NYSE TRF (DN),141281923,72199635,131818768,345300326,3172403796.157601,2190019850.965299,5519524963.819001,10881948610.941901,369060,149730,382737,901527
2019-10-14,FINRA / Nasdaq TRF Carteret (DQ),775475009,241402787,437820059,1454697855,27887607674.806298,12889615794.926901,21538188245.869497,62315411715.602696,3044594,568363,1842358,5455315
2019-10-14,EDGA Equities (J),65001275,15827461,31395929,112224665,2331253207.341000,856944503.009700,1496504290.161300,4684702000.512000,769432,93693,408900,1272025
2019-10-14,EDGX Equities (K),117757481,52173345,89126373,259057199,3623533170.811199,2509464380.662299,3948948926.536499,10081946478.009997,981187,212345,716211,1909743
2019-10-14,NYSE Chicago (M),10032265,5009253,4506651,19548169,314588076.054900,709096054.015000,586609859.062800,1610293989.132700,4675,1148,3803,9626
2019-10-14,NYSE (N),631486291,25701988,25042926,682231205,25422110095.094294,1427262306.781300,1171631350.240600,28021003752.116194,2186686,82013,188698,2457397
2019-10-14,NYSE Arca (P),113053933,165210643,93944585,372209161,4203345162.569301,8759008681.506602,4771217373.054700,17733571217.130603,1076184,460341,953923,2490448
2019-10-14,NASDAQ (Q),305233014,111950699,408366795,825550508,12151845879.450500,5982182845.954999,21884857827.680199,40018886553.085698,2995710,464151,3056851,6516712
2019-10-14,IEX (V),78082573,12193159,38839360,129115092,2954162853.684800,725228559.679500,2003742566.188200,5683133979.552500,619651,65772,340467,1025890
2019-10-14,NASDAQ PSX (X),10012626,9238238,7833340,27084204,378882045.757200,506151987.480200,531054248.652400,1416088281.889800,88333,43232,79364,210929
2019-10-14,BYX Equities (Y),93621758,40964429,37472142,172058329,2540914262.130400,1737442804.378700,1413814204.254600,5692171270.763700,951149,185138,448741,1585028
2019-10-14,BZX Equities (Z),127809021,47032643,76137199,250978863,5121281277.202700,2998322352.591099,4458528813.044900,12578132442.838699,1243876,211147,786661,2241684
2019-10-11,NYSE American (A),5035969,13466889,2656826,21159684,219451140.880500,185102463.604800,135329378.097600,539882982.582900,53538,52191,28535,134264
2019-10-11,NASDAQ BX (B),43732670,42552648,33633408,119918726,1532894817.283300,2268027612.081200,1786869807.602000,5587792236.966500,403849,191455,306475,901779
2019-10-11,NYSE National (C),83751833,41996127,28138681,153886641,1595623269.379600,1408158815.303900,844684397.195000,3848466481.878500,638944,158827,283660,1081431
2019-10-11,FINRA / Nasdaq TRF Chicago (DB),2819176,1810596,3312305,7942077,107883951.176900,88893620.883900,240498508.762100,437276080.822900,12014,5223,17019,34256
2019-10-11,FINRA / NYSE TRF (DN),183733982,88822884,187669535,460226401,4396230439.548399,3256218252.315000,7759395251.267102,15411843943.130501,425529,183716,463252,1072497
2019-10-11,FINRA / Nasdaq TRF Carteret (DQ),1032777229,413991405,652243017,2099011651,38057979180.164797,24468583112.054188,32376506434.024996,94903068726.243981,3766260,928690,2385688,7080638
2019-10-11,EDGA Equities (J),85388625,44237873,48735690,178362188,3188603655.322100,2519566768.342600,2567305141.875900,8275475565.540600,995718,260816,594011,1850545
2019-10-11,EDGX Equities (K),177207029,123258854,136063799,436529682,5817223676.878500,7107470362.847897,7010686450.051700,19935380489.778097,1387800,545977,1068265,3002042
2019-10-11,NYSE Chicago (M),7551662,13552803,4852453,25956918,389318946.659400,1878502624.202600,454599360.067200,2722420930.929200,5886,2009,4818,12713
2019-10-11,NYSE (N),864435611,68981889,42674008,976091508,35020770347.867196,4033121337.919999,2186846184.989200,41240737870.776395,3365586,189316,297587,3852489
2019-10-11,NYSE Arca (P),177985599,393280797,156738986,728005382,6785074874.760400,22645112044.002002,9084060860.877199,38514247779.639601,1585510,1140269,1518628,4244407
2019-10-11,NASDAQ (Q),462978866,294095468,619305974,1376380308,19317021912.257300,17014726644.624001,36475705595.674713,72807454152.556014,4486959,1219490,4871226,10577675
2019-10-11,IEX (V),104174101,24915437,59349139,188438677,4468451888.252200,1579643982.933600,3321103113.333699,9369198984.519499,849562,124322,492229,1466113
2019-10-11,NASDAQ PSX (X),15877924,32556923,15550596,63985443,643594143.453600,1870486980.279500,1102261625.701500,3616342749.434600,135405,137042,140296,412743
2019-10-11,BYX Equities (Y),131340599,93708968,60541569,285591136,3571855329.210500,4514672837.440501,2814528901.829000,10901057068.480001,1271067,462120,680934,2414121
2019-10-11,BZX Equities (Z),202534148,136392938,133334010,472261096,8814110557.861599,9720174551.677702,8756766927.241498,27291052036.780799,1873977,577450,1298357,3749784
2019-10-10,NYSE American (A),4683522,11082427,2329563,18095512,178391021.204500,160284943.254000,127420675.912900,466096640.371400,45264,40077,25676,111017
2019-10-10,NASDAQ BX (B),40277047,29545715,25271258,95094020,1334634339.088100,1383392002.368000,1280918118.453300,3998944459.909400,366424,142438,248662,757524
2019-10-10,NYSE National (C),71829432,26606036,23246359,121681827,1294251140.806900,898991183.030300,618800635.248500,2812042959.085700,553736,112352,233218,899306
2019-10-10,FINRA / Nasdaq TRF Chicago (DB),2605356,1587718,2673990,6867064,84621624.660000,70395143.005000,190302680.773600,345319448.438600,10091,4423,14466,28980
2019-10-10,FINRA / NYSE TRF (DN),160682230,81551424,153436256,395669910,3745647233.824798,2728788793.709300,6342991423.965606,12817427451.499704,410082,164776,396537,971395
2019-10-10,FINRA / Nasdaq TRF Carteret (DQ),975311442,304882125,563039019,1843232586,34314827398.673506,16032626793.421801,26641321725.305498,76988775917.400805,3275174,719004,2001410,5995588
2019-10-10,EDGA Equities (J),84755514,30402488,40430927,155588929,2807788156.736800,1567792719.177400,1997577265.954200,6373158141.868400,917395,192430,497090,1606915
2019-10-10,EDGX Equities (K),149546299,79119513,108720524,337386336,4617407971.063900,4299593538.949700,5162458171.817000,14079459681.830600,1206513,405511,876983,2489007
2019-10-10,NYSE Chicago (M),7466397,14633077,4855728,26955202,380201159.645400,1197688714.597400,598668929.721900,2176558803.964700,6274,1226,7579,15079
2019-10-10,NYSE (N),800398598,41667304,33794487,875860389,29874028572.305103,2318759965.513800,1499618430.802500,33692406968.621403,2752547,124589,233446,3110582
2019-10-10,NYSE Arca (P),152686617,248107624,125532308,526326549,5342494344.827300,14229937296.711104,6641869557.665696,26214301199.204100,1348504,762069,1241017,3351590
2019-10-10,NASDAQ (Q),386810399,184496628,494615024,1065922051,15271655331.709902,10740724669.897599,26791109494.238106,52803489495.845607,3738816,851764,3834045,8424625
2019-10-10,IEX (V),90428571,18238748,49559715,158227034,3405971291.286900,1060244021.665400,2408331964.164500,6874547277.116800,746535,85145,419850,1251530
2019-10-10,NASDAQ PSX (X),13362575,17806189,11712900,42881664,464854797.536300,1009456641.801800,812091068.348100,2286402507.686200,108014,84788,112754,305556
2019-10-10,BYX Equities (Y),116295187,61325859,46720279,224341325,3032155743.337500,2861690397.835101,1876486886.009700,7770333027.182301,1132385,338604,560124,2031113
2019-10-10,BZX Equities (Z),177270433,84249752,107535983,369056168,6933783759.759001,6064543998.937298,6439134327.943702,19437462086.640001,1622519,378323,1077063,3077905
2019-10-09,NYSE American (A),3930359,9178325,1908921,15017605,177757954.085000,121643958.282900,111718863.959300,411120776.327200,42506,34550,21625,98681
2019-10-09,NASDAQ BX (B),38739434,27045408,25283329,91068171,1379321250.402800,1318989038.810200,1244330559.774200,3942640848.987200,393396,125353,264558,783307
2019-10-09,NYSE National (C),64253278,26678369,21067244,111998891,1237241391.206900,873054178.510800,599060474.599900,2709356044.317600,525410,100110,219271,844791
2019-10-09,FINRA / Nasdaq TRF Chicago (DB),2321347,1262315,2544993,6128655,80314060.086900,70356308.517000,169455045.230900,320125413.834800,9552,4169,13861,27582
2019-10-09,FINRA / NYSE TRF (DN),153497988,79529434,146407984,379435406,3330679919.893500,2554816279.340401,5885640301.405603,11771136500.639504,374616,161165,372167,907948
2019-10-09,FINRA / Nasdaq TRF Carteret (DQ),767169529,304136322,473746678,1545052529,28490877200.965306,17427578839.271101,20986618234.130898,66905074274.367305,3023077,657865,1819224,5500166
2019-10-09,EDGA Equities (J),75863503,27710788,37915011,141489302,2664704530.144800,1449575073.307300,1874799955.265900,5989079558.718000,897232,163772,498008,1559012
2019-10-09,EDGX Equities (K),131864359,69303070,97126328,298293757,4190600454.818799,3886807908.649198,4687771548.902402,12765179912.370399,1106025,330521,798432,2234978
2019-10-09,NYSE Chicago (M),6406420,9014605,2151238,17572263,260483176.945000,934992815.501000,219983430.613900,1415459423.059900,7079,1337,7568,15984
2019-10-09,NYSE (N),658886334,34702463,28618994,722207791,25899126410.869403,1999723641.010199,1355545103.823500,29254395155.703102,2652171,106344,210399,2968914
2019-10-09,NYSE Arca (P),131170594,217630409,107435874,456236877,4956920518.211700,13688844137.139503,5644135893.078698,24289900548.429901,1257773,630143,1102280,2990196
2019-10-09,NASDAQ (Q),346359868,156536463,428046122,930942453,14290863433.148902,9202621103.065902,23678457559.213092,47171942095.427896,3561391,734482,3620052,7915925
2019-10-09,IEX (V),82377160,14819418,43337195,140533773,3414758846.377900,899448750.917400,2117430389.098500,6431637986.393800,746896,68734,404609,1220239
2019-10-09,NASDAQ PSX (X),11487343,15025417,9731510,36244270,462512662.880000,877149801.201800,735697355.898200,2075359819.980000,102519,69049,103961,275529
2019-10-09,BYX Equities (Y),107205785,53973230,44497267,205676282,2945398535.741300,2479604024.155400,1725614444.792600,7150617004.689300,1147431,283297,557436,1988164
2019-10-09,BZX Equities (Z),153819583,74593186,93685013,322097782,6394715477.365900,5374605525.334198,5479757831.438799,17249078834.138897,1536379,329648,975179,2841206
2019-10-08,NYSE American (A),4825897,11063286,2357291,18246474,192652906.438000,165836029.291800,127706634.929900,486195570.659700,47782,41753,26533,116068
2019-10-08,NASDAQ BX (B),45150928,39042701,32892476,117086105,1481821114.810000,2007243308.827700,1589718639.132600,5078783062.770300,431771,188522,332206,952499
2019-10-08,NYSE National (C),77835968,31763182,24944466,134543616,1440927753.965500,1058871185.744000,757285861.551900,3257084801.261400,640111,126447,264947,1031505
2019-10-08,FINRA / Nasdaq TRF Chicago (DB),2666107,1450972,2583173,6700252,102766696.617800,87071554.231000,177789390.563500,367627641.412300,10476,4711,12867,28054
2019-10-08,FINRA / NYSE TRF (DN),185997379,87526159,160667013,434190551,4288500893.710200,3169402060.661799,6777652114.418398,14235555068.790397,415954,183071,393359,992384
2019-10-08,FINRA / Nasdaq TRF Carteret (DQ),978813302,410910948,597128017,1986852267,37981936837.819612,24338420465.346709,28274439383.695901,90594796686.862222,3564625,917610,2118084,6600319
2019-10-08,EDGA Equities (J),88114473,37394607,47031790,172540870,3075111427.926100,2119652124.410900,2330378774.022600,7525142326.359600,1111762,233693,643487,1988942
2019-10-08,EDGX Equities (K),156794498,93693704,116614656,367102858,5236540806.722100,5809927778.404201,5671181467.632502,16717650052.758803,1421455,497521,1053583,2972559
2019-10-08,NYSE Chicago (M),9144258,10411438,4738378,24294074,345259072.962600,1405572515.124000,505759247.405300,2256590835.491900,7002,1231,8610,16843
2019-10-08,NYSE (N),805667192,50177048,37973927,893818167,30709598348.327105,3071019044.820400,1809923207.503000,35590540600.650505,3494605,155844,281018,3931467
2019-10-08,NYSE Arca (P),167449554,312499274,137758553,617707381,6585317314.225398,18735576626.002098,7550340569.513900,32871234509.741396,1648801,957396,1399447,4005644
2019-10-08,NASDAQ (Q),422826665,222412446,534274710,1179513821,18830752084.505895,14099369494.984705,30232729365.759491,63162850945.250091,4661754,1037585,4742563,10441902
2019-10-08,IEX (V),97734648,18733857,53697609,170166114,4036442111.842600,1160231526.041800,2543542723.974999,7740216361.859399,922332,95518,514723,1532573
2019-10-08,NASDAQ PSX (X),13284209,22630454,13927992,49842655,589526331.012600,1482245604.148600,919577112.595500,2991349047.756700,127078,104072,145005,376155
2019-10-08,BYX Equities (Y),127437583,70244607,57352867,255035057,3446023811.856200,3437733922.949700,2177815736.431000,9061573471.236900,1362349,402289,687812,2452450
2019-10-08,BZX Equities (Z),186960579,106860889,119765819,413587287,7925318120.354399,8113769173.111406,7332337798.279397,23371425091.745202,1946611,513746,1322626,3782983
2019-10-07,NYSE American (A),4049058,10704459,2205422,16958939,171518153.245000,138438655.397400,134413827.779600,444370636.422000,43420,40950,24817,109187
2019-10-07,NASDAQ BX (B),32736461,26700023,22940386,82376870,1191421203.497500,1392626685.340900,1176779977.187400,3760827866.025800,352252,115593,257001,724846
2019-10-07,NYSE National (C),61826078,23549974,20305670,105681722,1158682882.850000,813259790.056200,616694672.978000,2588637345.884200,518811,95381,223174,837366
2019-10-07,FINRA / Nasdaq TRF Chicago (DB),1899928,1047711,2514315,5461954,82808256.985000,52975092.310000,187556179.497000,323339528.792000,8167,3095,12550,23812
2019-10-07,FINRA / NYSE TRF (DN),146833142,76849215,159046383,382728740,3669579648.900600,2599690298.790700,6769524263.845796,13038794211.537096,381213,172133,381709,935055
2019-10-07,FINRA / Nasdaq TRF Carteret (DQ),855309616,302535733,542630752,1700476101,31539918824.553505,17548641151.183994,25162447256.124293,74251007231.861792,3133077,760215,1920611,5813903
2019-10-07,EDGA Equities (J),73159442,25321720,37438393,135919555,2599057091.867700,1380656828.243900,1781781220.455200,5761495140.566800,920288,164624,522126,1607038
2019-10-07,EDGX Equities (K),125773768,69537123,101633690,296944581,3921462354.694399,3919014711.813699,4565245428.747799,12405722495.255897,1115405,345404,839649,2300458
2019-10-07,NYSE Chicago (M),5996126,13259369,4497269,23752764,250315986.820500,984166658.363600,523393787.360000,1757876432.544100,5872,1031,7984,14887
2019-10-07,NYSE (N),841516179,34808372,29893332,906217883,32870615831.454496,2067579278.725400,1436496471.816800,36374691581.996696,3082296,101193,232506,3415995
2019-10-07,NYSE Arca (P),131688851,243405427,119439072,494533350,4924068417.331100,13956578131.255995,6351011437.113304,25231657985.700399,1336024,721236,1356027,3413287
2019-10-07,NASDAQ (Q),330009294,162309666,515014544,1007333504,13654899270.888200,10002568902.652299,27669731737.060509,51327199910.601008,3762878,744318,3963777,8470973
2019-10-07,IEX (V),80336336,13813784,44554039,138704159,3243580295.970399,859547856.406500,2211518123.846800,6314646276.223699,746293,76681,434738,1257712
2019-10-07,NASDAQ PSX (X),9941495,15233441,10204346,35379282,404677083.090600,1016194857.607400,703780507.128400,2124652447.826400,97446,71436,116652,285534
2019-10-07,BYX Equities (Y),103808346,51105847,48162879,203077072,2789045158.744000,2454254631.321200,1673313145.741000,6916612935.806200,1108648,292116,561325,1962089
2019-10-07,BZX Equities (Z),154171957,74869480,99104858,328146295,6434057879.254200,5496782930.165199,5728217871.285401,17659058680.704800,1715616,340016,1116488,3172120
2019-10-04,NYSE American (A),4332348,10995737,2346042,17674127,170454541.681200,154453660.744700,144101182.443200,469009384.869100,45637,39744,26513,111894
2019-10-04,NASDAQ BX (B),37776586,29246240,25382157,92404983,1329097248.054700,1491997981.838400,1406443384.884300,4227538614.777400,388575,128661,271973,789209
2019-10-04,NYSE National (C),66433487,28736038,22405420,117574945,1250912593.863000,970115049.251500,687539919.422300,2908567562.536800,536376,113731,238766,888873
2019-10-04,FINRA / Nasdaq TRF Chicago (DB),2585755,1275428,2649595,6510778,93510942.319000,65053329.710000,210227993.481600,368792265.510600,10705,4547,13875,29127
2019-10-04,FINRA / NYSE TRF (DN),154185457,85847065,151008149,391040671,3737949980.309100,2892646029.351899,6966795849.826899,13597391859.487898,374395,163742,379714,917851
2019-10-04,FINRA / Nasdaq TRF Carteret (DQ),908281927,366174978,539873504,1814330409,33426214334.292694,22355562193.565203,26141397772.959998,81923174300.817895,3309274,760349,2026237,6095860
2019-10-04,EDGA Equities (J),78326688,27965818,39122031,145414537,2833753464.765900,1513624352.384400,1963242338.125300,6310620155.275600,911705,178337,511249,1601291
2019-10-04,EDGX Equities (K),134648112,75199825,104030067,313878004,4248594284.730299,4237010110.441202,5284399528.296099,13770003923.467600,1146416,349337,865351,2361104
2019-10-04,NYSE Chicago (M),7606642,11365846,5531485,24503973,468535075.013900,713118646.396000,661126712.179400,1842780433.589300,5698,792,7145,13635
2019-10-04,NYSE (N),720259731,38996406,30403727,789659864,29514958027.660500,2217829160.816500,1536791198.524400,33269578387.001400,2584176,106633,227629,2918438
2019-10-04,NYSE Arca (P),144451847,250903921,123666827,519022595,5378000690.435400,14053594478.792803,7175514170.407600,26607109339.635803,1310702,785233,1287876,3383811
2019-10-04,NASDAQ (Q),358476934,178855727,485787074,1023119735,15124897888.100204,10954152639.551500,28913652764.137600,54992703291.789304,3552064,774698,3793102,8119864
2019-10-04,IEX (V),95130169,17112100,50580443,162822712,3780962982.033800,1053003369.327500,2550383419.475000,7384349770.836300,857008,87649,493323,1437980
2019-10-04,NASDAQ PSX (X),10219545,16782870,10747926,37750341,415693926.952600,1156576486.857200,896671717.692700,2468942131.502500,90285,82701,110039,283025
2019-10-04,BYX Equities (Y),113413078,57830752,48777413,220021243,3023340245.554800,2781847297.179700,1979921610.805300,7785109153.539800,1136317,335936,586090,2058343
2019-10-04,BZX Equities (Z),169476326,78660538,105690104,353826968,7092444054.823301,5581452788.579497,6974754528.971499,19648651372.374297,1613838,351931,1107522,3073291
2019-10-03,NYSE American (A),5301296,11341789,2738331,19381416,218158788.971700,252309509.772600,152787773.728400,623256072.472700,53845,47457,30197,131499
2019-10-03,NASDAQ BX (B),43885384,43565604,31912090,119363078,1592623525.495800,2323401758.168400,1739345958.669700,5655371242.333900,461853,196326,350235,1008414
2019-10-03,NYSE National (C),82875802,35311411,26498785,144685998,1545537913.760400,1272423285.380000,736135236.336900,3554096435.477300,652972,143515,270904,1067391
2019-10-03,FINRA / Nasdaq TRF Chicago (DB),2955563,1860489,3324839,8140891,107688174.850000,114918494.296500,268645834.316400,491252503.462900,11947,5971,18816,36734
2019-10-03,FINRA / NYSE TRF (DN),177702129,100222827,190501053,468426009,4264202766.010401,3499881404.939699,8117834513.465699,15881918684.415799,408765,201199,435231,1045195
2019-10-03,FINRA / Nasdaq TRF Carteret (DQ),1104275251,442189323,691862155,2238326729,41500257502.311103,24353570905.211394,33170038658.843588,99023867066.366085,3711285,988510,2358808,7058603
2019-10-03,EDGA Equities (J),91149278,38280013,47403244,176832535,3037012890.944900,2100545228.458100,2228003159.663000,7365561279.066000,1005595,234787,569541,1809923
2019-10-03,EDGX Equities (K),155154597,104625845,123475830,383256272,4912843294.888300,6338516892.353997,6074164194.037596,17325524381.279893,1297738,507337,999428,2804503
2019-10-03,NYSE Chicago (M),7734724,14796848,5533537,28065109,375540299.926000,956200225.710000,475599656.669400,1807340182.305400,7419,1479,8174,17072
2019-10-03,NYSE (N),801417783,60733280,39600541,901751604,31392780930.384893,3582897228.960900,2007634948.360400,36983313107.706193,3068240,182256,289145,3539641
2019-10-03,NYSE Arca (P),161653450,376131027,148138442,685922919,6063480841.231300,22444404835.889602,8472683095.141096,36980568772.261998,1501111,1199121,1534282,4234514
2019-10-03,NASDAQ (Q),426684627,269348609,582244577,1278277813,17624112877.614202,16415495624.648201,32938395713.740703,66978004216.003106,4197852,1179707,4660234,10037793
2019-10-03,IEX (V),113284006,21684129,61692208,196660343,4393519528.842299,1345266057.938300,3339647857.544701,9078433444.325300,924339,105271,529010,1558620
2019-10-03,NASDAQ PSX (X),12669542,28285983,14658987,55614512,500115562.218500,1905618976.106499,1142594737.445200,3548329275.770199,109983,136859,166623,413465
2019-10-03,BYX Equities (Y),132279803,80746343,59074873,272101019,3412542501.996800,4017564347.247400,2323757249.619099,9753864098.863299,1290359,450308,675336,2416003
2019-10-03,BZX Equities (Z),196109795,119540697,128562729,444213221,8027685407.502899,8399844748.654698,8027015838.964801,24454545995.122398,1816508,536278,1281873,3634659
2019-10-02,NYSE American (A),5695246,14228359,3769896,23693501,254889191.250800,321214062.655700,194225910.913900,770329164.820400,61391,59453,39285,160129
2019-10-02,NASDAQ BX (B),49187087,42269017,35624398,127080502,1712821451.819800,2233819752.081000,1831876845.574300,5778518049.475100,480739,193963,376298,1051000
2019-10-02,NYSE National (C),82428141,38960187,28493369,149881697,1583348131.941700,1286514156.529500,860789173.802000,3730651462.273200,657695,145615,300977,1104287
2019-10-02,FINRA / Nasdaq TRF Chicago (DB),3714541,2235548,3543401,9493490,131153077.978500,125672476.904500,214248568.078800,471074122.961800,15211,7469,17897,40577
2019-10-02,FINRA / NYSE TRF (DN),188397954,95870450,216654614,500923018,4720164051.340698,3825332862.293100,7138253997.246801,15683750910.880599,466134,212900,440766,1119800
2019-10-02,FINRA / Nasdaq TRF Carteret (DQ),1205364144,488531937,760835266,2454731347,44059588569.256703,30318549731.387090,33551990885.797793,107930129186.441586,4132163,1262994,2611402,8006559
2019-10-02,EDGA Equities (J),98230983,43352495,58165814,199749292,3442530199.682800,2475897648.501600,2505395213.510600,8423823061.695000,1117706,274962,664235,2056903
2019-10-02,EDGX Equities (K),173682046,102760625,147113772,423556443,5711349148.430601,6685589126.050299,6180325398.977403,18577263673.458303,1416237,549758,1093090,3059085
2019-10-02,NYSE Chicago (M),7956966,23450119,6034675,37441760,411452733.926400,2656884891.993900,741973708.389300,3810311334.309600,9019,1115,8599,18733
2019-10-02,NYSE (N),939975185,59369569,43762715,1043107469,39071135684.033303,3629013687.250801,2047370918.888801,44747520290.172905,3451899,185747,316931,3954577
2019-10-02,NYSE Arca (P),177210994,360268122,179796632,717275748,6854515652.866400,22108501047.567091,9181118153.978395,38144134854.411886,1602772,1217859,1741977,4562608
2019-10-02,NASDAQ (Q),483897843,263628015,710885062,1458410920,21071731792.905004,17284695571.923302,37089582410.259510,75446009775.087816,4736097,1205129,5287448,11228674
2019-10-02,IEX (V),117936948,21755573,66467958,206160479,4842068719.416400,1496555128.792399,3211669847.590601,9550293695.799400,903945,115456,524950,1544351
2019-10-02,NASDAQ PSX (X),15156394,25721944,17251698,58130036,631405004.762600,1860823631.282400,1234945005.680300,3727173641.725300,129968,133606,184640,448214
2019-10-02,BYX Equities (Y),146138921,83839848,78713290,308692059,3779384111.738900,4233176723.086701,2481972923.305500,10494533758.131101,1441815,486446,766015,2694276
2019-10-02,BZX Equities (Z),219215058,121302014,146526555,487043627,9651191143.204300,9515679725.958401,8359585814.607202,27526456683.769903,2052096,568964,1409151,4030211
2019-10-01,NYSE American (A),5533844,12891693,2906742,21332279,227922286.391800,208707377.063300,160501242.520400,597130905.975500,57816,52907,32176,142899
2019-10-01,NASDAQ BX (B),48066298,44697422,29406192,122169912,1619459337.541000,2222483272.305200,1564113916.262100,5406056526.108300,465787,188448,326935,981170
2019-10-01,NYSE National (C),79679441,33576158,26452646,139708245,1493702131.021200,1202641279.017900,829711604.810200,3526055014.849300,622395,138947,276213,1037555
2019-10-01,FINRA / Nasdaq TRF Chicago (DB),3767957,2028119,3081766,8877842,112562025.206000,85552779.885000,202998050.198400,401112855.289400,13637,6068,15739,35444
2019-10-01,FINRA / NYSE TRF (DN),200814168,92159816,217172212,510146196,4828592951.473999,3434627608.766100,7333640428.059702,15596860988.299801,452531,211331,433234,1097096
2019-10-01,FINRA / Nasdaq TRF Carteret (DQ),1066917699,493227891,703174552,2263320142,38703155141.264205,29562749074.993303,33383508130.519703,101649412346.777211,3799170,1098906,2413616,7311692
2019-10-01,EDGA Equities (J),96472998,38721546,50831455,186025999,3362177656.959800,2172854190.540200,2329654749.023900,7864686596.523900,1084332,239568,623006,1946906
2019-10-01,EDGX Equities (K),164492662,97340824,129578305,391411791,5466426354.774901,5709558292.737998,5952977903.083900,17128962550.596799,1461793,489683,1075816,3027292
2019-10-01,NYSE Chicago (M),8528622,18983333,5232157,32744112,369328261.194500,2357136224.490000,761202218.076900,3487666703.761400,7506,1478,8527,17511
2019-10-01,NYSE (N),792954962,54510306,38176093,885641361,32205906133.715405,3165591255.228400,1744941042.128500,37116438431.072305,3295976,157256,289052,3742284
2019-10-01,NYSE Arca (P),171032020,354667456,158754041,684453517,6364583733.620800,20720021531.276196,8224263592.832599,35308868857.729595,1541997,1100958,1623041,4265996
2019-10-01,NASDAQ (Q),444624182,244556855,606408192,1295589229,18656820781.429997,15808103737.564908,32524239688.201798,66989164207.196703,4394806,1080854,4931427,10407087
2019-10-01,IEX (V),116810904,22981307,64318816,204111027,4741870888.769700,1460781206.800100,3308601073.157199,9511253168.726999,869987,114687,513615,1498289
2019-10-01,NASDAQ PSX (X),14617479,25306461,13466824,53390764,532013436.866100,1688824127.019900,1099335099.745200,3320172663.631200,117929,112715,151855,382499
2019-10-01,BYX Equities (Y),138345520,77071974,72662080,288079574,3624053625.610200,3705668094.577398,2325445368.065100,9655167088.252698,1359900,441158,697637,2498695
2019-10-01,BZX Equities (Z),208094239,111875175,128884058,448853472,8932290743.336498,8034278851.433897,7673432232.787501,24640001827.557896,1965517,504286,1337674,3807477
2019-09-30,NYSE American (A),4556342,16779072,2583994,23919408,196314074.020200,202136824.334300,137648910.668400,536099809.022900,48399,48516,28595,125510
2019-09-30,NASDAQ BX (B),39860233,28883070,22038302,90781605,1456651665.806100,1519763410.761500,1210509463.442800,4186924540.010400,401719,118340,255363,775422
2019-09-30,NYSE National (C),68376189,33002213,23693738,125072140,1298336492.632700,1064104265.158500,709681320.689200,3072122078.480400,527676,121015,239373,888064
2019-09-30,FINRA / Nasdaq TRF Chicago (DB),2538812,1331735,2406680,6277227,83291365.375000,51540164.010000,162181328.324900,297012857.709900,10585,4455,12909,27949
2019-09-30,FINRA / NYSE TRF (DN),164635045,75985955,145690527,386311527,4622329535.785500,2454617993.688799,5820071996.949203,12897019526.423502,416298,167452,373020,956770
2019-09-30,FINRA / Nasdaq TRF Carteret (DQ),950618250,366384018,568165404,1885167672,37873309212.230598,19791947083.007694,27945618564.023893,85610874859.262185,3368273,895720,2080921,6344914
2019-09-30,EDGA Equities (J),82474804,30326883,40111729,152913416,3089208528.275400,1604187328.426200,1997452919.878500,6690848776.580100,963872,173497,528518,1665887
2019-09-30,EDGX Equities (K),128083601,73179807,91200719,292464127,4354440235.979901,3957405365.582900,4325911652.490098,12637757254.052899,1062254,327773,772502,2162529
2019-09-30,NYSE Chicago (M),7217157,10840241,4374290,22431688,339702840.339800,901935920.770000,660314749.471300,1901953510.581100,6428,1419,6639,14486
2019-09-30,NYSE (N),900385834,36819709,28378893,965584436,37902340760.886002,2003452070.762200,1383432164.365700,41289224996.013902,2700613,100947,217003,3018563
2019-09-30,NYSE Arca (P),136482770,231504515,108455997,476443282,5482255026.966300,13494593655.437101,5907109805.803002,24883958488.206403,1260323,666889,1223550,3150762
2019-09-30,NASDAQ (Q),358955373,185375905,553459987,1097791265,15741834647.642201,10520178826.741602,30003972237.418185,56265985711.801988,3577719,767645,3940265,8285629
2019-09-30,IEX (V),96650195,20310494,50753568,167714257,3903320567.617300,1118476255.944400,2550959007.727200,7572755831.288900,777898,93538,436226,1307662
2019-09-30,NASDAQ PSX (X),12072515,20013966,10304986,42391467,498844349.954400,1315442268.307900,870213212.326700,2684499830.589000,105576,86136,112923,304635
2019-09-30,BYX Equities (Y),119706267,64606076,53506903,237819246,3363984801.974700,2987322859.155400,1940034721.927400,8291342383.057500,1190315,326374,591169,2107858
2019-09-30,BZX Equities (Z),176522713,81196683,103930383,361649779,7929845586.934300,5397952388.353301,6206689285.353298,19534487260.640899,1730821,349772,1140768,3221361
2019-09-27,NYSE American (A),5351845,13655929,3058237,22066011,221753697.644000,223004061.024700,171962148.140300,616719906.809000,55699,54314,33672,143685
2019-09-27,NASDAQ BX (B),41172087,38171421,28761411,108104919,1595044723.795100,1988573509.090000,1600421882.114100,5184040114.999200,428775,188260,332012,949047
2019-09-27,NYSE National (C),68673037,32847462,24801164,126321663,1374541919.682500,1094993588.250800,772874189.004400,3242409696.937700,554977,124255,256810,936042
2019-09-27,FINRA / Nasdaq TRF Chicago (DB),3317213,1701478,3672921,8691612,131498631.635000,97571151.339400,254765012.212400,483834795.186800,13692,5343,18084,37119
2019-09-27,FINRA / NYSE TRF (DN),180013887,76137473,182535264,438686624,5399746562.920799,2619435877.684300,7828650368.882101,15847832809.487200,423458,159609,435363,1018430
2019-09-27,FINRA / Nasdaq TRF Carteret (DQ),945438401,344671382,606496403,1896606186,37279548960.087190,20601652096.315901,31176337172.892306,89057538229.295397,3364503,804374,2255564,6424441
2019-09-27,EDGA Equities (J),64909661,30946646,39066758,134923065,2733191817.151000,1759262873.000600,2009668952.955900,6502123643.107500,859778,210865,541481,1612124
2019-09-27,EDGX Equities (K),147487425,94820793,113779381,356087599,5088668670.967800,5339070301.752701,5622533667.979697,16050272640.700198,1186452,470128,941148,2597728
2019-09-27,NYSE Chicago (M),11220553,6592631,5898111,23711295,543384464.566000,712966640.697000,692489903.891100,1948841009.154100,6950,1721,7841,16512
2019-09-27,NYSE (N),779883159,57061535,36231692,873176386,31382075345.757001,3102543393.299400,1756229561.174600,36240848300.231001,2860005,150207,266397,3276609
2019-09-27,NYSE Arca (P),160779278,305872759,152497103,619149140,6681639070.170199,17874408339.337106,8743143639.648706,33299191049.156011,1549800,1067601,1667365,4284766
2019-09-27,NASDAQ (Q),407863017,247706517,582574437,1238143971,17978054505.593602,14550486319.261401,32372837268.871892,64901378093.726895,3971840,1086488,4747633,9805961
2019-09-27,IEX (V),104947727,20145830,63072129,188165686,4477975447.104301,1168572187.362800,3354444087.234500,9000991721.701601,787755,93524,492441,1373720
2019-09-27,NASDAQ PSX (X),13024358,26544252,13857742,53426352,600511039.733500,1847603411.676600,1183747268.534600,3631861719.944700,116681,117172,163884,397737
2019-09-27,BYX Equities (Y),123889304,83372542,58018089,265279935,3390327929.387600,3834024890.167201,2283922618.487800,9508275438.042601,1232846,456531,672940,2362317
2019-09-27,BZX Equities (Z),188513869,115566208,126937047,431017124,8260079559.413500,7751439032.588101,8414493255.161400,24426011847.163001,1781910,535525,1299387,3616822
2019-09-26,NYSE American (A),4886031,11089563,2872663,18848257,210417526.479000,163371940.252100,157795999.528000,531585466.259100,50202,43849,29326,123377
2019-09-26,NASDAQ BX (B),43339255,26635703,25422322,95397280,1632889561.762600,1349740168.208300,1395429867.143400,4378059597.114300,453774,119251,294737,867762
2019-09-26,NYSE National (C),68545728,30304254,22328678,121178660,1307471939.079400,1006493550.790800,648709042.424100,2962674532.294300,541214,116526,231364,889104
2019-09-26,FINRA / Nasdaq TRF Chicago (DB),2974327,1256304,3207591,7438222,100773812.641000,62777514.950000,235886358.319800,399437685.910800,11841,4314,16084,32239
2019-09-26,FINRA / NYSE TRF (DN),176419933,82835206,177266456,436521595,5228666155.198601,2810343847.975601,6812526007.259102,14851536010.433304,399194,150206,392727,942127
2019-09-26,FINRA / Nasdaq TRF Carteret (DQ),879208021,326508395,560832213,1766548629,34081931580.166192,17955121526.817093,27688192169.411211,79725245276.394496,3273113,714055,2114665,6101833
2019-09-26,EDGA Equities (J),81833308,32399199,42823100,157055607,3025901248.466200,1811663504.558100,2134166420.834300,6971731173.858600,949241,184749,532711,1666701
2019-09-26,EDGX Equities (K),139414776,75149537,113848416,328412729,4471110471.980401,4151820666.646899,5091280064.135899,13714211202.763199,1096816,360060,861479,2318355
2019-09-26,NYSE Chicago (M),14833531,11962178,5839412,32635121,653868793.942900,1187431571.703000,631931302.351200,2473231667.997100,6051,1482,7266,14799
2019-09-26,NYSE (N),755415709,40172809,32690076,828278594,31374339772.455703,2368519549.110599,1658604179.280700,35401463500.847002,2682552,112452,228872,3023876
2019-09-26,NYSE Arca (P),146073968,228115436,136883943,511073347,5793117044.706099,13408902940.734098,7350226515.146603,26552246500.586800,1353999,740935,1361060,3455994
2019-09-26,NASDAQ (Q),382682602,189580832,533443812,1105707246,16257250582.273005,11178285448.609100,30681341158.327008,58116877189.209113,3677885,838816,4146390,8663091
2019-09-26,IEX (V),98479187,16415391,58513545,173408123,4158176312.872000,967732542.503300,2919898085.326899,8045806940.702199,747398,82416,463240,1293054
2019-09-26,NASDAQ PSX (X),11954574,17864698,11231638,41050910,504897237.732200,1262896649.826500,900886346.736000,2668680234.294700,98491,83015,123970,305476
2019-09-26,BYX Equities (Y),116844820,60321600,53624219,230790639,3128113746.296600,2832824887.645899,2032726763.499900,7993665397.442399,1156382,326914,595966,2079262
2019-09-26,BZX Equities (Z),162008759,79277629,105488633,346775021,7329067665.615500,5504851889.169598,6890355779.407599,19724275334.192697,1615016,384076,1106745,3105837
2019-09-25,NYSE American (A),5190847,13923664,2840970,21955481,230242959.538100,225722753.282500,170871170.626000,626836883.446600,55974,50848,31053,137875
2019-09-25,NASDAQ BX (B),46385362,28803994,28757528,103946884,1846842820.924000,1545633522.441500,1683280077.060500,5075756420.426000,517808,140007,336259,994074
2019-09-25,NYSE National (C),67403671,29075168,24279012,120757851,1413115099.077500,1006548695.367000,712306625.491600,3131970419.936100,587083,123764,257594,968441
2019-09-25,FINRA / Nasdaq TRF Chicago (DB),2988436,1629037,3309672,7927145,118790892.510000,79225640.707400,251134893.934800,449151427.152200,12778,4896,16906,34580
2019-09-25,FINRA / NYSE TRF (DN),183595086,82394155,182499758,448488999,5585979649.452199,2784490405.010299,7938505067.642099,16308975122.104597,420281,168648,416940,1005869
2019-09-25,FINRA / Nasdaq TRF Carteret (DQ),1000639644,406675962,627279819,2034595425,39340574444.526411,23925151539.116994,32139210977.379408,95404936961.022813,3475448,825034,2244143,6544625
2019-09-25,EDGA Equities (J),85647823,33586004,45603200,164837027,3228700669.324400,1864187969.239600,2359325966.554801,7452214605.118801,1019993,200806,592219,1813018
2019-09-25,EDGX Equities (K),142324953,85813566,110076376,338214895,4985042540.166799,4829720856.113400,5377699588.750700,15192462985.030899,1162496,395167,898697,2456360
2019-09-25,NYSE Chicago (M),12327211,11484021,6799442,30610674,536097758.493000,940684780.848000,980373461.945500,2457156001.286500,6219,1366,6875,14460
2019-09-25,NYSE (N),839683203,43553516,32684859,915921578,35017251645.699200,2598103973.024100,1756560771.869001,39371916390.592301,2774721,125991,244738,3145450
2019-09-25,NYSE Arca (P),154648859,267882697,133645620,556177176,6469250856.578497,16027926890.787999,8066527849.145998,30563705596.512494,1517872,786851,1481040,3785763
2019-09-25,NASDAQ (Q),389736331,213026842,584158207,1186921380,17190697608.958497,12791174025.862296,33254921872.326486,63236793507.147279,3868087,940748,4394113,9202948
2019-09-25,IEX (V),110764407,19798379,62217788,192780574,4866611944.275000,1279320339.035600,3288190135.421001,9434122418.731601,888576,102262,504595,1495433
2019-09-25,NASDAQ PSX (X),12397636,20074917,12291483,44764036,549647857.081400,1485932023.099900,1024261147.999300,3059841028.180600,110132,96761,141993,348886
2019-09-25,BYX Equities (Y),112713324,66953789,52531894,232199007,3269980655.346100,3195475681.126899,2350409480.658200,8815865817.131199,1185503,366546,642291,2194340
2019-09-25,BZX Equities (Z),164754972,91259020,113107845,369121837,7425411276.897400,6179267142.297400,7252176475.910702,20856854895.105502,1653832,428919,1177744,3260495
2019-09-24,NYSE American (A),5852999,15611125,3334227,24798351,255850504.899400,275544949.789100,195177705.351300,726573160.039800,61737,56039,35335,153111
2019-09-24,NASDAQ BX (B),53912483,37944138,30878688,122735309,1906303504.567800,2142147868.245600,1941674266.206700,5990125639.020100,541460,175745,367346,1084551
2019-09-24,NYSE National (C),78520808,35263762,26338867,140123437,1600956694.772000,1221443624.541100,834589700.067300,3656990019.380400,636875,139236,277203,1053314
2019-09-24,FINRA / Nasdaq TRF Chicago (DB),4619695,2042965,4639667,11302327,156642721.595000,92300544.392300,356995591.271000,605938857.258300,15413,5932,23159,44504
2019-09-24,FINRA / NYSE TRF (DN),230718481,92479455,195686713,518884649,6116978361.587397,3353864150.850900,9369556801.520899,18840399313.959196,498698,185543,495248,1179489
2019-09-24,FINRA / Nasdaq TRF Carteret (DQ),1081423806,424594393,720671358,2226689557,40998725299.952494,24997772725.383204,37527268693.976516,103523766719.312214,3873437,930745,2510396,7314578
2019-09-24,EDGA Equities (J),102600290,41654295,50871417,195126002,3550172453.116999,2576818355.108400,2641837473.570301,8768828281.795700,1157192,245278,653789,2056259
2019-09-24,EDGX Equities (K),181621951,110075380,133190967,424888298,5839137200.235899,6567803475.635102,6782604005.265405,19189544681.136406,1377959,537235,1079871,2995065
2019-09-24,NYSE Chicago (M),9712466,12000608,7542228,29255302,590747738.289900,1462405280.341100,978205459.276700,3031358477.907700,7467,2114,9974,19555
2019-09-24,NYSE (N),952219229,56196632,39749881,1048165742,39716444811.945099,3549228836.588700,2089230651.905700,45354904300.439499,3225982,163333,275408,3664723
2019-09-24,NYSE Arca (P),203071876,299318278,151325955,653716109,7416072733.313600,19117874470.545399,9136840436.279905,35670787640.138904,1722658,1051775,1649017,4423450
2019-09-24,NASDAQ (Q),483038489,261250021,672062371,1416350881,20572189753.821497,16496742091.212102,40094327352.750884,77163259197.784483,4586580,1215177,5195721,10997478
2019-09-24,IEX (V),124463976,23862276,70843481,219169733,5237875075.546500,1445125747.787200,3730951025.329202,10413951848.662902,938654,102413,546889,1587956
2019-09-24,NASDAQ PSX (X),17624701,27487531,14790061,59902293,732090566.711000,2056420706.988100,1304028606.966100,4092539880.665200,140875,130938,177428,449241
2019-09-24,BYX Equities (Y),143813164,82104705,57678471,283596340,3759447101.582900,4193141449.628000,2770010115.178300,10722598666.389200,1401137,450600,728375,2580112
2019-09-24,BZX Equities (Z),199587059,118180297,131340054,449107410,8779762173.401600,8631680587.035202,8880744859.168202,26292187619.605004,1941149,581449,1379923,3902521
2019-09-23,NYSE American (A),4722906,14676550,2894607,22294063,209518607.022000,232980416.722300,146423573.841800,588922597.586100,51679,51233,31229,134141
2019-09-23,NASDAQ BX (B),41325349,21473933,23993834,86793116,1541432736.139300,1083223952.850700,1372125699.405100,3996782388.395100,450713,104636,280274,835623
2019-09-23,NYSE National (C),62214427,22610023,20915935,105740385,1234219334.971700,730919480.955900,606898998.259400,2572037814.187000,533208,96678,224278,854164
2019-09-23,FINRA / Nasdaq TRF Chicago (DB),2830742,978221,2760067,6569030,90005345.919500,39570314.048500,209889388.833400,339465048.801400,11629,3750,15464,30843
2019-09-23,FINRA / NYSE TRF (DN),179929463,69216507,151309415,400455385,4724098189.535501,2251632048.254501,6736253998.548697,13711984236.338699,425153,149818,402426,977397
2019-09-23,FINRA / Nasdaq TRF Carteret (DQ),970329922,335993294,585088858,1891412074,37802673356.433605,19257925356.813702,31523633952.618504,88584232665.865811,3332734,696028,2043978,6072740
2019-09-23,EDGA Equities (J),79382296,24178414,39523260,143083970,2910519735.693100,1376359213.890300,2084540571.055700,6371419520.639100,962346,147021,532359,1641726
2019-09-23,EDGX Equities (K),138005306,63123150,97436131,298564587,4376037376.999299,3373418867.717900,4752724385.189897,12502180629.907096,1122796,298382,813930,2235108
2019-09-23,NYSE Chicago (M),8209663,10070782,8435121,26715566,498576068.815100,971991213.913900,1262911203.594899,2733478486.323899,5676,1209,5487,12372
2019-09-23,NYSE (N),821155030,30514321,26533245,878202596,33599708317.505201,1672653299.704600,1381453309.783100,36653814926.992901,2559238,87177,197103,2843518
2019-09-23,NYSE Arca (P),140267442,188237067,107269569,435774078,5177196207.505699,10367900465.034200,6211388483.278199,21756485155.818098,1248623,551563,1174243,2974429
2019-09-23,NASDAQ (Q),357468688,146017375,510851073,1014337136,14874505950.772904,8228220207.464802,28991677915.997505,52094404074.235211,3537566,666651,3784315,7988532
2019-09-23,IEX (V),102641834,19429474,52955190,175026498,4099570134.033600,984495486.068600,2640636593.064200,7724702213.166400,817782,89508,447846,1355136
2019-09-23,NASDAQ PSX (X),11342131,12510025,9532415,33384571,435820172.049000,843437493.509800,738438685.132500,2017696350.691300,102680,60885,109502,273067
2019-09-23,BYX Equities (Y),115531292,50349380,45988272,211868944,3128772092.691300,2361950942.834400,2144899533.044100,7635622568.569800,1171766,275241,578844,2025851
2019-09-23,BZX Equities (Z),151899698,62754368,96263010,310917076,6576245315.570400,4034238385.035998,5820881968.158299,16431365668.764697,1523494,297492,1023742,2844728
2019-09-20,NYSE American (A),7205882,95282717,3489572,105978171,287728273.055800,532253333.792900,194898123.737200,1014879730.585900,71605,59293,36883,167781
2019-09-20,NASDAQ BX (B),54636601,37389904,31285239,123311744,1869241522.387300,2127717889.207900,1856992390.834600,5853951802.429800,534108,148630,335185,1017923
2019-09-20,NYSE National (C),78742149,35125482,26028302,139895933,1629267025.746100,1218805052.857300,771298415.282400,3619370493.885800,650536,135023,267329,1052888
2019-09-20,FINRA / Nasdaq TRF Chicago (DB),2713009,1262940,3103654,7079603,93554700.040000,58291677.184700,255025157.531600,406871534.756300,10870,3880,17579,32329
2019-09-20,FINRA / NYSE TRF (DN),221242604,76654654,170597879,468495137,5139138822.677799,2650881325.546100,8510174730.284100,16300194878.507999,490337,160807,458753,1109897
2019-09-20,FINRA / Nasdaq TRF Carteret (DQ),1486073739,422012570,949512433,2857598742,56289303528.347904,27403281867.318008,48331297590.512999,132023882986.178911,3839272,835629,2337152,7012053
2019-09-20,EDGA Equities (J),106269947,35371745,48910480,190552172,3903516112.105500,2169441144.065901,2762892552.671700,8835849808.843101,1237554,219666,654490,2111710
2019-09-20,EDGX Equities (K),187426765,87635897,120367953,395430615,5929019915.240200,5217002491.431801,6553917298.993496,17699939705.665497,1482298,432415,1052140,2966853
2019-09-20,NYSE Chicago (M),11351721,20914478,8212556,40478755,540066082.148600,2231995400.995101,1404769886.019800,4176831369.163501,8339,2236,7717,18292
2019-09-20,NYSE (N),2754524473,50581836,33436631,2838542940,119749352403.846103,2897249628.498601,1660982479.710900,124307584512.055604,3268037,128320,241948,3638305
2019-09-20,NYSE Arca (P),197744203,277598042,136940572,612282817,7396813906.418198,16639845675.140098,8589116957.633597,32625776539.191893,1653779,835633,1520040,4009452
2019-09-20,NASDAQ (Q),498070377,224330487,1568778345,2291179209,20465138494.595097,13964131346.458190,82134823589.025770,116564093430.079057,4635937,993315,4885464,10514716
2019-09-20,IEX (V),122009985,23318449,64746196,210074630,4854656966.363600,1323527838.178100,3400730247.102401,9578915051.644101,971381,114845,536095,1622321
2019-09-20,NASDAQ PSX (X),19164843,22012156,13662509,54839508,768567865.975600,1673948740.451700,1182841097.069500,3625357703.496800,151894,99634,146446,397974
2019-09-20,BYX Equities (Y),148363519,78009801,56995904,283369224,4085900460.242600,3851353240.071300,2705563538.056800,10642817238.370700,1461886,402774,697873,2562533
2019-09-20,BZX Equities (Z),207909771,102723040,127164893,437797704,9348144983.267199,6985754396.966197,8663381371.142402,24997280751.375798,2018948,471110,1336888,3826946
2019-09-19,NYSE American (A),6105981,14228397,3460270,23794648,239516115.785600,316779823.097700,180996281.444000,737292220.327300,61754,60160,37384,159298
2019-09-19,NASDAQ BX (B),45230046,25874269,24739001,95843316,1565956469.363900,1434072569.499700,1333893384.672700,4333922423.536300,476124,128856,280267,885247
2019-09-19,NYSE National (C),65539485,28456875,24607276,118603636,1306917076.402700,930714030.225700,683359790.475900,2920990897.104300,570014,111630,262493,944137
2019-09-19,FINRA / Nasdaq TRF Chicago (DB),2568421,1057413,2382248,6008082,91930117.851400,43867199.223000,166216337.094300,302013654.168700,10916,3556,13045,27517
2019-09-19,FINRA / NYSE TRF (DN),207918430,79807592,161489186,449215208,5276877123.611000,2593741993.086100,6924514756.121099,14795133872.818199,465433,162901,425331,1053665
2019-09-19,FINRA / Nasdaq TRF Carteret (DQ),921400875,323455517,540129454,1784985846,32062194430.634393,23011607816.973197,27001566120.852993,82075368368.460583,3472132,701954,2100159,6274245
2019-09-19,EDGA Equities (J),85746479,29182564,40900355,155829398,3095104043.002400,1687238938.407800,2046717955.219100,6829060936.629300,1045861,182786,562778,1791425
2019-09-19,EDGX Equities (K),157936596,73730134,111805179,343471909,5001074892.345200,4312870049.484403,5208494469.006299,14522439410.835902,1379780,353080,924907,2657767
2019-09-19,NYSE Chicago (M),7199239,19086385,7906928,34192552,411672151.459000,1641712962.615000,934520978.222900,2987906092.296900,7111,1378,6579,15068
2019-09-19,NYSE (N),814846733,34725987,28688370,878261090,33437083318.315899,2013777059.137100,1423763015.914900,36874623393.367899,2726899,99662,208618,3035179
2019-09-19,NYSE Arca (P),150597152,209431036,118956593,478984781,5533362393.421701,12387843073.254298,6562806851.829500,24484012318.505499,1424675,630674,1338415,3393764
2019-09-19,NASDAQ (Q),392913017,179716065,542955723,1115584805,16004642462.854500,10578555141.756095,29786962989.621808,56370160594.232403,3903402,793700,4077628,8774730
2019-09-19,IEX (V),107299347,18835485,52205178,178340010,3912478878.445500,1123410907.441000,2507405189.237900,7543294975.124400,800477,85410,439254,1325141
2019-09-19,NASDAQ PSX (X),14554310,18184537,11358673,44097520,570175996.689700,1278248517.715200,887007022.285500,2735431536.690400,125866,83242,109664,318772
2019-09-19,BYX Equities (Y),120918333,61538294,47664231,230120858,3259860161.840700,2897058451.983700,2101206800.395500,8258125414.219900,1269206,340911,617122,2227239
2019-09-19,BZX Equities (Z),164891601,72615753,99186673,336694027,7118785925.137098,5053343129.250100,6224149698.612799,18396278752.999997,1695200,353162,1074874,3123236
2019-09-18,NYSE American (A),6286753,14891679,3618529,24796961,242820518.199500,200530039.591500,167490433.489300,610840991.280300,62270,54811,37460,154541
2019-09-18,NASDAQ BX (B),49379691,35782255,26489077,111651023,1723782079.409800,1778754009.389200,1433647201.001700,4936183289.800700,497490,210615,313089,1021194
2019-09-18,NYSE National (C),69506820,33293639,24150845,126951304,1390193133.668100,1015675094.791900,695503842.079100,3101372070.539100,568154,124040,248260,940454
2019-09-18,FINRA / Nasdaq TRF Chicago (DB),2469702,1303961,2931904,6705567,96293374.880400,63245700.818000,216644366.520300,376183442.218700,10369,4751,15518,30638
2019-09-18,FINRA / NYSE TRF (DN),197241294,92036943,192433022,481711259,5617685630.946000,2851143241.679800,7281397441.827701,15750226314.453501,436864,172437,460755,1070056
2019-09-18,FINRA / Nasdaq TRF Carteret (DQ),970312631,337354763,644004771,1951672165,34844556024.034493,18074601516.363299,28538622181.733500,81457779722.131292,3385073,748001,2103161,6236235
2019-09-18,EDGA Equities (J),84988507,34989109,41584981,161562597,3104597184.926600,1872217006.179000,2006692834.543200,6983507025.648800,982513,207728,534668,1724909
2019-09-18,EDGX Equities (K),159089704,93395339,125662586,378147629,5243526879.135701,5124213848.546201,5418668454.137704,15786409181.819606,1298236,423077,932202,2653515
2019-09-18,NYSE Chicago (M),11874386,13395445,5017115,30286946,556938321.916700,1674617923.016900,600623020.318800,2832179265.252400,5981,1279,7609,14869
2019-09-18,NYSE (N),872643120,48111663,32099994,952854777,35122629688.746398,2690670882.159301,1547257091.662500,39360557662.568199,2873836,142138,216473,3232447
2019-09-18,NYSE Arca (P),161510852,264983339,129807304,556301495,6001112060.223400,14868714081.093989,6807407980.720899,27677234122.038288,1406763,812354,1324474,3543591
2019-09-18,NASDAQ (Q),435569835,227930707,586842665,1250343207,17922952046.334601,12947406071.551106,31677955939.182897,62548314057.068604,4179668,1044157,4246574,9470399
2019-09-18,IEX (V),108694622,19777085,56057002,184528709,4172728690.278999,1099489249.974200,2642866343.153200,7915084283.406399,784141,85674,443706,1313521
2019-09-18,NASDAQ PSX (X),17128062,22162937,12530037,51821036,654347955.483700,1544797686.118800,948149866.408700,3147295508.011200,137155,109424,129583,376162
2019-09-18,BYX Equities (Y),132892240,75163130,52252696,260308066,3563037575.658900,3469154457.630600,2141376007.286500,9173568040.576000,1331620,406949,634460,2373029
2019-09-18,BZX Equities (Z),179221376,99848600,110117155,389187131,7560452445.072200,6407787638.040098,6638548281.184498,20606788364.296796,1750529,479492,1127542,3357563
2019-09-17,NYSE American (A),6277478,13101781,3226440,22605699,271856550.903200,156753479.620200,154094839.900400,582704870.423800,67180,50608,35224,153012
2019-09-17,NASDAQ BX (B),55171026,37562084,26668774,119401884,1926927366.391700,1390692210.738700,1273661424.074800,4591281001.205200,557848,142637,307257,1007742
2019-09-17,NYSE National (C),74736052,36830129,24331711,135897892,1521381468.435200,1083143474.143800,627666659.972100,3232191602.551100,623273,135054,247505,1005832
2019-09-17,FINRA / Nasdaq TRF Chicago (DB),2726280,1447593,2416808,6590681,103531924.896400,41713206.624000,151318423.106700,296563554.627100,12057,4333,12046,28436
2019-09-17,FINRA / NYSE TRF (DN),221174373,107308007,170115424,498597804,5711657891.336899,2621680128.716000,5683987554.351603,14017325574.404502,480428,183610,412929,1076967
2019-09-17,FINRA / Nasdaq TRF Carteret (DQ),1088382138,410890389,591840851,2091113378,41236339610.404393,19660057265.570103,27482002709.704999,88378399585.679495,3737878,832223,2038359,6608460
2019-09-17,EDGA Equities (J),99271470,41946803,40622374,181840647,3438669930.666700,1801776851.508400,1832058932.963400,7072505715.138500,1101734,209449,533567,1844750
2019-09-17,EDGX Equities (K),176523727,94990920,113939726,385454373,5790849785.359598,4105673012.494601,4505750873.029502,14402273670.883701,1494075,406708,878221,2779004
2019-09-17,NYSE Chicago (M),7977529,14511972,6772842,29262343,354574320.257000,1719008967.682201,671061148.079700,2744644436.018901,4785,1663,4895,11343
2019-09-17,NYSE (N),836800382,47383213,29751948,913935543,34174213981.076100,2089430298.741700,1305105633.247200,37568749913.065000,3008088,121360,201193,3330641
2019-09-17,NYSE Arca (P),165478242,268812434,118053154,552343830,6472782528.166300,12717963668.918599,5756004021.433901,24946750218.518800,1493523,705470,1203044,3402037
2019-09-17,NASDAQ (Q),464053824,228986695,507754231,1200794750,18906979875.862897,10463134716.522999,26411441554.105802,55781556146.491698,4400727,928099,3979256,9308082
2019-09-17,IEX (V),122353035,22925862,58646096,203924993,4898719399.020500,1115767916.302600,2724132195.719599,8738619511.042699,938208,97801,478144,1514153
2019-09-17,NASDAQ PSX (X),16115900,22461516,10926033,49503449,594454374.486300,1100068380.554800,735350080.337500,2429872835.378600,133921,88531,112074,334526
2019-09-17,BYX Equities (Y),141365464,75312155,50614218,267291837,3820959022.043700,3078180093.226900,1965844425.131300,8864983540.401900,1414074,391304,636020,2441398
2019-09-17,BZX Equities (Z),194852625,89986315,101672362,386511302,8290993962.094300,4978530038.229100,5727690052.554298,18997214052.877698,1938204,433066,1073466,3444736
2019-09-16,NYSE American (A),7113571,19838668,3277289,30229528,259850536.815300,212435143.769900,159432325.298300,631718005.883500,73041,70047,34888,177976
2019-09-16,NASDAQ BX (B),59537577,40418823,28414153,128370553,1884942121.075200,1544053190.225900,1405952506.531400,4834947817.832500,557221,165167,321585,1043973
2019-09-16,NYSE National (C),94497238,37398649,26012288,157908175,1677188504.874900,1032159257.584300,657124348.822900,3366472111.282100,708487,143360,260715,1112562
2019-09-16,FINRA / Nasdaq TRF Chicago (DB),3434617,1852614,2587567,7874798,118223273.611200,58261554.969600,177146080.769400,353630909.350200,14066,5505,13112,32683
2019-09-16,FINRA / NYSE TRF (DN),282326450,123873225,162856899,569056574,6385851502.757301,2924465666.894799,6081636125.770303,15391953295.422403,556695,216857,416202,1189754
2019-09-16,FINRA / Nasdaq TRF Carteret (DQ),1319308812,444573509,591921733,2355804054,42150419856.050391,21491609061.081299,26414200250.231797,90056229167.363487,4145885,934216,2086111,7166212
2019-09-16,EDGA Equities (J),112372073,44639288,43729454,200740815,3579107189.277100,1995173058.617900,1935248791.573200,7509529039.468200,1192775,228170,559347,1980292
2019-09-16,EDGX Equities (K),208682719,110171367,106091174,424945260,5672658514.947901,4773799218.426502,4503862217.635898,14950319951.010301,1453284,438782,854586,2746652
2019-09-16,NYSE Chicago (M),11348584,24312143,5558960,41219687,398860347.375000,2219429757.473100,551338655.929300,3169628760.777400,6524,1848,6537,14909
2019-09-16,NYSE (N),909576462,47421088,29886788,986884338,34457220244.903805,2192999577.950100,1291821139.002100,37942040961.856005,3171149,119313,207120,3497582
2019-09-16,NYSE Arca (P),195666217,301185408,116805416,613657041,6568767985.054001,14186831630.669898,6003754267.255600,26759353882.979499,1579705,784321,1232575,3596601
2019-09-16,NASDAQ (Q),528178932,248077678,530706868,1306963478,18961162383.767103,11594106181.856801,29068585162.401197,59623853728.025101,4669413,983414,4210582,9863409
2019-09-16,IEX (V),147128721,24711041,61764336,233604098,5241688436.683800,1089454825.509200,2744162668.894499,9075305931.087499,1015644,107764,489194,1612602
2019-09-16,NASDAQ PSX (X),19696048,23644698,11580916,54921662,632175285.869200,1275531862.919501,868555124.525100,2776262273.313801,142321,95702,131077,369100
2019-09-16,BYX Equities (Y),163682777,80352756,51279634,295315167,3975605848.516800,3176302909.478499,2005563277.935700,9157472035.930999,1517417,410604,655529,2583550
2019-09-16,BZX Equities (Z),223309618,99768476,104073249,427151343,8466981971.912800,5495716181.988701,5882518808.412798,19845216962.314299,2043926,436833,1104246,3585005
2019-09-13,NYSE American (A),6203153,13204322,3351043,22758518,272281050.196700,222627990.185100,169490909.054500,664399949.436300,66674,50309,35958,152941
2019-09-13,NASDAQ BX (B),48947429,30712335,27750283,107410047,1825559293.632700,1586019528.962100,1545781716.898700,4957360539.493500,510387,148909,318377,977673
2019-09-13,NYSE National (C),79478037,31975591,26252423,137706051,1683346154.098700,1070825583.129900,809250680.453600,3563422417.682200,659307,119214,264405,1042926
2019-09-13,FINRA / Nasdaq TRF Chicago (DB),2838293,1163358,2747438,6749089,105757807.042800,53478593.285000,195494294.110000,354730694.437800,12409,4377,14126,30912
2019-09-13,FINRA / NYSE TRF (DN),217805772,87789263,180039803,485634838,6027620242.899300,2701344789.393799,7248752393.304800,15977717425.597899,504804,167929,460144,1132877
2019-09-13,FINRA / Nasdaq TRF Carteret (DQ),1022519919,472690896,622706280,2117917095,40174776327.058285,28455664951.459195,31541796355.356791,100172237633.874271,3759266,825743,2229204,6814213
2019-09-13,EDGA Equities (J),99877441,33751869,44234873,177864183,3569174294.411800,1902274038.313500,2098831766.688600,7570280099.413900,1135586,188510,570281,1894377
2019-09-13,EDGX Equities (K),163933189,83430525,118044818,365408532,5500842008.468503,4963705167.742599,5356457312.529000,15821004488.740102,1360539,405221,935965,2701725
2019-09-13,NYSE Chicago (M),6876532,19452374,5990164,32319070,375433899.409000,2949881652.585000,803879066.022100,4129194618.016100,4965,1272,4319,10556
2019-09-13,NYSE (N),818751738,45268558,33300092,897320388,34439664330.502803,2516885263.073900,1707018134.740200,38663567728.316903,3256202,122169,239913,3618284
2019-09-13,NYSE Arca (P),164471080,243334146,126621591,534426817,6457529410.219401,13944483392.581804,7225356888.203399,27627369691.004604,1522671,723773,1377983,3624427
2019-09-13,NASDAQ (Q),446963245,206902925,547335799,1201201969,18836473367.395998,11828694529.038201,30454353685.542799,61119521581.976998,4417293,892220,4545343,9854856
2019-09-13,IEX (V),118126700,18876623,59811552,196814875,5037082693.708600,1102368406.924800,2960346301.337400,9099797401.970800,898462,87803,475743,1462008
2019-09-13,NASDAQ PSX (X),15460616,22122817,12251333,49834766,545759917.212200,1434385775.032501,1011640479.177100,2991786171.421801,124874,104048,143359,372281
2019-09-13,BYX Equities (Y),140667723,70258779,56345518,267272020,4104398939.343900,3328842010.856800,2405647478.308900,9838888428.509600,1441413,360289,691656,2493358
2019-09-13,BZX Equities (Z),204097493,91573189,117791063,413461745,9403143169.638500,6170094409.867101,7652945311.795899,23226182891.301500,2171078,412334,1338917,3922329
2019-09-12,NYSE American (A),6699488,14644661,3350418,24694567,278491898.596200,191293593.876400,180180573.813000,649966066.285600,70623,57161,36918,164702
2019-09-12,NASDAQ BX (B),53157809,38602636,30054153,121814598,1975551072.626800,1913668677.802899,1651356977.801500,5540576728.231199,552693,138707,322971,1014371
2019-09-12,NYSE National (C),82235831,34524254,27758957,144519042,1687167558.046700,1086423228.348300,817441630.085100,3591032416.480100,677886,129835,283724,1091445
2019-09-12,FINRA / Nasdaq TRF Chicago (DB),3215543,1642022,3244837,8102402,129118505.220000,86939609.755000,233335809.269400,449393924.244400,14063,5305,16429,35797
2019-09-12,FINRA / NYSE TRF (DN),226394034,96953172,204612306,527959512,6640164423.719703,3012690140.814300,8162113643.960802,17814968208.494805,538214,184758,516683,1239655
2019-09-12,FINRA / Nasdaq TRF Carteret (DQ),1053809576,407637604,650903037,2112350217,39657569531.538798,23497614738.035998,31063050941.973482,94218235211.548278,3955112,846263,2470841,7272216
2019-09-12,EDGA Equities (J),112889670,42896724,50341459,206127853,3831858745.238700,2197244950.739499,2345973399.057700,8375077095.035899,1180093,219643,613469,2013205
2019-09-12,EDGX Equities (K),182843256,102389993,133377382,418610631,5877913408.043798,5634430400.788796,6055812948.830902,17568156757.663496,1398900,456593,1019687,2875180
2019-09-12,NYSE Chicago (M),8539388,21787324,7980111,38306823,481968103.608500,2853326487.526000,787948294.597300,4123242885.731800,5776,1057,6648,13481
2019-09-12,NYSE (N),853232606,58770602,37246528,949249736,35130390142.910996,3157391009.745900,1903942046.337099,40191723198.993995,3364869,147058,261091,3773018
2019-09-12,NYSE Arca (P),190731112,308126900,154272143,653130155,7442737649.833700,17607663322.566195,8580340720.919405,33630741693.319300,1618779,896103,1526208,4041090
2019-09-12,NASDAQ (Q),509904095,262011818,649644422,1421560335,21055259863.181399,15038058070.473406,36718236561.668987,72811554495.323792,4725168,1070165,4953342,10748675
2019-09-12,IEX (V),128255516,19171248,67337954,214764718,5509421065.663900,1094499252.191200,3469012266.546199,10072932584.401299,944992,95390,526424,1566806
2019-09-12,NASDAQ PSX (X),17988123,28712570,14208092,60908785,656857517.627100,1974596591.405699,1017416831.916600,3648870940.949399,143384,107259,133852,384495
2019-09-12,BYX Equities (Y),148108324,72289009,59966184,280363517,4089881423.390000,3470192921.914799,2578653355.132200,10138727700.436999,1447560,370760,711311,2529631
2019-09-12,BZX Equities (Z),218985914,107401893,133806954,460194761,9892588843.461801,7071541217.605300,8430523910.965398,25394653972.032499,2177956,481938,1413754,4073648
2019-09-11,NYSE American (A),6649005,15677060,3537568,25863633,295298380.710000,197750493.020700,198395854.024000,691444727.754700,71224,58652,39187,169063
2019-09-11,NASDAQ BX (B),58630697,39127884,33654013,131412594,2204326521.197600,1716542085.357000,1704331586.471500,5625200193.026100,607940,162846,374600,1145386
2019-09-11,NYSE National (C),80561079,30735981,29135069,140432129,1699485630.241400,959520506.289400,813672748.559800,3472678885.090600,687701,132578,291176,1111455
2019-09-11,FINRA / Nasdaq TRF Chicago (DB),3654433,1316429,3481404,8452266,141582062.886000,73550300.249000,218491291.129000,433623654.264000,14957,4710,18093,37760
2019-09-11,FINRA / NYSE TRF (DN),254745543,96676061,211649118,563070722,6797214953.748697,2774569725.067400,8508221850.233995,18080006529.050092,567653,190476,553629,1311758
2019-09-11,FINRA / Nasdaq TRF Carteret (DQ),1117374436,426318184,713894105,2257586725,42601972030.679903,24730613744.196091,33252701514.125715,100585287289.001709,4281077,843246,2702535,7826858
2019-09-11,EDGA Equities (J),112643473,36987882,51398373,201029728,3746808009.821300,1889252951.943700,2329414194.942800,7965475156.707800,1198786,207903,643583,2050272
2019-09-11,EDGX Equities (K),193196080,88326631,139925949,421448660,6267073749.862401,4833145878.022501,6290608500.334101,17390828128.219003,1543524,417138,1099393,3060055
2019-09-11,NYSE Chicago (M),7602861,18716498,6195880,32515239,350831326.169000,2617106601.492601,619629454.186100,3587567381.847701,4050,1056,4172,9278
2019-09-11,NYSE (N),849051390,46199789,38796617,934047796,34676944022.382596,2562323071.704599,1893549054.044700,39132816148.131895,3601821,132577,292722,4027120
2019-09-11,NYSE Arca (P),187736507,255349310,151365196,594451013,7295950700.489702,14549611716.939901,8204017227.973598,30049579645.403201,1692829,782972,1562169,4037970
2019-09-11,NASDAQ (Q),533481676,226601170,650426753,1410509599,21763420769.969005,12376081514.360103,36199554578.387607,70339056862.716715,5160201,1000086,5270071,11430358
2019-09-11,IEX (V),126123621,20199108,70243280,216566009,5464273332.065900,1147329773.526400,3563342922.264800,10174946027.857100,948634,97182,548109,1593925
2019-09-11,NASDAQ PSX (X),17174795,24336783,15595760,57107338,608118005.659700,1642034519.476400,1009840078.916700,3259992604.052800,144416,106796,141840,393052
2019-09-11,BYX Equities (Y),156214908,70159419,61200127,287574454,4141228098.385700,3179954874.323901,2574732782.131200,9895915754.840801,1506311,387081,735842,2629234
2019-09-11,BZX Equities (Z),229538440,90931894,142118674,462589008,10331850336.436701,5744586133.916599,8578729995.878298,24655166466.231598,2375541,417673,1555895,4349109
2019-09-10,NYSE American (A),7811432,13829232,3937225,25577889,339986322.674600,191899720.296500,205136838.745800,737022881.716900,87829,57326,44610,189765
2019-09-10,NASDAQ BX (B),61951465,40760503,32234929,134946897,2342064967.478000,1766834206.670300,1715654391.769600,5824553565.917900,617137,195099,362362,1174598
2019-09-10,NYSE National (C),93161713,33562674,31722971,158447358,1947336612.473500,1077626245.614400,911005052.641400,3935967910.729300,775777,135752,328081,1239610
2019-09-10,FINRA / Nasdaq TRF Chicago (DB),4208503,1427658,3703908,9340069,173616758.605400,61372806.880000,274564490.912700,509554056.398100,17076,4811,19481,41368
2019-09-10,FINRA / NYSE TRF (DN),270689462,93707715,217997758,582394935,7634525179.500001,2781637755.217399,8687563255.372200,19103726190.089600,600226,186066,545171,1331463
2019-09-10,FINRA / Nasdaq TRF Carteret (DQ),1278566106,381240008,735191514,2394997628,49561729802.765197,20635010425.381807,35438194425.116515,105634934653.263519,4988016,867405,2843607,8699028
2019-09-10,EDGA Equities (J),97402236,29899568,46349061,173650865,3920566899.920300,1662562271.864600,2328189429.673300,7911318601.458200,1244019,185792,641193,2071004
2019-09-10,EDGX Equities (K),209737831,88291720,139960049,437989600,6990779066.065601,4570880943.020300,6399529016.291201,17961189025.377102,1714898,426922,1124583,3266403
2019-09-10,NYSE Chicago (M),10332582,13870055,7825927,32028564,626540284.029000,1595009514.884100,655647481.643600,2877197280.556700,5099,1121,5975,12195
2019-09-10,NYSE (N),938223713,49264262,39049779,1026537754,39051800067.155700,2687077481.863600,1954603981.201800,43693481530.221100,3810776,144867,292766,4248409
2019-09-10,NYSE Arca (P),205614598,255116719,152932195,613663512,8346489825.526103,14296364190.452203,8452938552.732400,31095792568.710706,1820587,804712,1586269,4211568
2019-09-10,NASDAQ (Q),589654379,218981679,652035032,1460671090,25238298543.999594,11998603565.527193,36687644043.392606,73924546152.919393,5615630,999023,5428918,12043571
2019-09-10,IEX (V),156654508,21138479,76571506,254364493,6710248155.663399,1147840934.601399,4039691795.877400,11897780886.142198,1153062,101829,601617,1856508
2019-09-10,NASDAQ PSX (X),19235354,23059081,14676473,56970908,731909138.413600,1433654395.608001,1141099944.684100,3306663478.705701,156020,104436,169231,429687
2019-09-10,BYX Equities (Y),182059213,72574645,65033216,319667074,4906026399.621699,3441091001.380400,2568066768.968100,10915184169.970199,1795960,405233,791711,2992904
2019-09-10,BZX Equities (Z),267743337,97120137,146860979,511724453,11969082689.502396,6378692036.895999,8753479589.023701,27101254315.422096,2538893,447870,1491316,4478079
2019-09-09,NYSE American (A),7187545,14730235,3717845,25635625,296800167.742600,226503622.048400,210868601.057400,734172390.848400,79325,54749,44331,178405
2019-09-09,NASDAQ BX (B),53289040,39588753,29011230,121889023,1940865707.529700,1669863238.147600,1551299811.285100,5162028756.962400,529229,179911,317914,1027054
2019-09-09,NYSE National (C),79550265,31523089,25896899,136970253,1550468839.353200,1048191359.887900,679798903.444500,3278459102.685600,608333,125387,251314,985034
2019-09-09,FINRA / Nasdaq TRF Chicago (DB),3408589,1542141,3810737,8761467,155613066.255000,60971059.880500,306434321.440800,523018447.576300,14890,4839,19769,39498
2019-09-09,FINRA / NYSE TRF (DN),239160779,86933581,201994242,528088602,7027773075.203600,2655110609.464101,8740535958.697798,18423419643.365499,584352,185941,541121,1311414
2019-09-09,FINRA / Nasdaq TRF Carteret (DQ),1213238545,400139105,677828925,2291206575,45059706209.635109,21313449149.031103,33843123264.418493,100216278623.084705,4541210,866786,2607374,8015370
2019-09-09,EDGA Equities (J),86417470,27874090,41823320,156114880,3430663948.061700,1457724479.412700,2160594791.385700,7048983218.860100,1098096,167381,586690,1852167
2019-09-09,EDGX Equities (K),189314946,78551786,126087351,393954083,6303908245.349098,4170375365.771699,6441485378.389001,16915768989.509798,1515607,373524,1038670,2927801
2019-09-09,NYSE Chicago (M),9242713,12923876,6319112,28485701,381149180.987300,1604262921.561200,522669091.343500,2508081193.892000,7072,831,8371,16274
2019-09-09,NYSE (N),890546542,40987110,33443818,964977470,36413435773.573802,2183204468.830400,1714454449.626700,40311094692.030902,3254494,119369,247873,3621736
2019-09-09,NYSE Arca (P),188418153,243593471,136253102,568264726,7503139455.023298,13011781271.083000,7918823692.792702,28433744418.899000,1604978,687100,1445952,3738030
2019-09-09,NASDAQ (Q),513494471,196663212,625820449,1335978132,21778974308.322297,10615479509.435904,36236027332.959506,68630481150.717707,4852559,852560,4889766,10594885
2019-09-09,IEX (V),144830902,20877715,70874525,236583142,5875632781.707500,1152828860.893900,3809511949.504700,10837973592.106100,1022649,97905,555105,1675659
2019-09-09,NASDAQ PSX (X),17874348,21197811,13803022,52875181,678275534.936200,1329419250.129000,1063099794.329900,3070794579.395100,144822,96885,152034,393741
2019-09-09,BYX Equities (Y),162505989,73935343,58373928,294815260,4086606445.101300,3393974824.194600,2342398905.876100,9822980175.172000,1530162,378009,677029,2585200
2019-09-09,BZX Equities (Z),232645805,83862629,131607885,448116319,10214157194.354399,5409544475.427097,8116243880.102800,23739945549.884296,2172637,371441,1325837,3869915
2019-09-06,NYSE American (A),5244225,11750100,2720467,19714792,220690483.101400,164323468.281700,143587059.864300,528601011.247400,59900,43455,31175,134530
2019-09-06,NASDAQ BX (B),48122230,27300567,25000378,100423175,1646543816.258200,1214469250.017300,1277613695.920400,4138626762.195900,487849,133557,285154,906560
2019-09-06,NYSE National (C),62084516,29368832,23739845,115193193,1209279282.163600,822375291.143400,648677459.775000,2680332033.082000,501959,89759,224772,816490
2019-09-06,FINRA / Nasdaq TRF Chicago (DB),2988818,1220917,2995065,7204800,109772285.363600,52725418.279000,231937761.690000,394435465.332600,12082,4170,15621,31873
2019-09-06,FINRA / NYSE TRF (DN),197274950,87624334,175034045,459933329,5281746174.564103,2603813327.552400,7208263996.140598,15093823498.257101,467564,168174,459357,1095095
2019-09-06,FINRA / Nasdaq TRF Carteret (DQ),956561958,351816590,592341495,1900720043,34854310520.021895,18691099123.834100,27716887811.253101,81262297455.109096,3688579,781891,2217253,6687723
2019-09-06,EDGA Equities (J),66841260,23033695,34615709,124490664,2862812288.249700,1201218274.662300,1776152926.701100,5840183489.613100,894250,143980,482809,1521039
2019-09-06,EDGX Equities (K),139129418,74734588,106856004,320720010,4626725025.113100,3825714647.856300,5231888659.865901,13684328332.835301,1148632,337573,829438,2315643
2019-09-06,NYSE Chicago (M),5166733,8160217,13588705,26915655,277802772.346900,857188788.416500,1241942173.142900,2376933733.906300,4606,485,4571,9662
2019-09-06,NYSE (N),735109905,42331761,30304940,807746606,30012160136.087600,1981457841.866900,1422211664.208500,33415829642.163000,2617002,91772,190124,2898898
2019-09-06,NYSE Arca (P),150615580,230412698,118626673,499654951,5958277130.837301,12903722126.544293,6643329799.009604,25505329056.391198,1424730,637698,1230103,3292531
2019-09-06,NASDAQ (Q),401993287,192364469,524018281,1118376037,16936491566.333699,10730993438.183796,29196903603.996885,56864388608.514380,3896362,814339,3931543,8642244
2019-09-06,IEX (V),109165434,16710583,55400591,181276608,4451663721.776400,974628603.608600,2773916167.063300,8200208492.448300,805504,74604,440588,1320696
2019-09-06,NASDAQ PSX (X),12177270,18862035,11570274,42609579,412620378.899700,1173795225.615000,852874162.965200,2439289767.479900,98066,85496,126089,309651
2019-09-06,BYX Equities (Y),137092145,64079868,50613559,251785572,3585189312.399700,2859875460.133900,1989389280.753400,8434454053.287000,1345250,340438,612671,2298359
2019-09-06,BZX Equities (Z),179773331,82485739,111311618,373570688,7758871570.774999,5245678127.412999,6976629536.532400,19981179234.720398,1706314,351789,1063988,3122091
2019-09-05,NYSE American (A),6105242,15317850,3395412,24818504,256209623.358600,280201317.948500,202734690.390000,739145631.697100,67806,58493,38649,164948
2019-09-05,NASDAQ BX (B),56121512,35071506,29836873,121029891,1917449707.129700,1669368740.817000,1736618838.364600,5323437286.311300,554303,137191,331316,1022810
2019-09-05,NYSE National (C),70565813,33886458,24524488,128976759,1373044890.012000,1080959397.895100,702614378.813200,3156618666.720300,577207,121652,251756,950615
2019-09-05,FINRA / Nasdaq TRF Chicago (DB),4175628,1984782,3925459,10085869,160237989.904400,88962671.281200,299101716.643000,548302377.828600,17233,6855,20129,44217
2019-09-05,FINRA / NYSE TRF (DN),251689988,108062324,182068175,541820487,6575115766.974801,3467460811.557198,8955660632.907705,18998237211.439704,552194,215884,519045,1287123
2019-09-05,FINRA / Nasdaq TRF Carteret (DQ),1136205583,507887291,655134180,2299227054,40339539179.463002,27925148981.784303,33485397171.903116,101750085333.150421,4122755,1045029,2512086,7679870
2019-09-05,EDGA Equities (J),82315850,32792812,40956772,156065434,3222302784.520400,1897178992.399400,2141370392.404600,7260852169.324400,1027910,192963,556268,1777141
2019-09-05,EDGX Equities (K),179202014,101788727,124266258,405256999,5685822381.967199,5650551045.434301,6788550963.097397,18124924390.498897,1349133,457610,985202,2791945
2019-09-05,NYSE Chicago (M),9181112,13229511,6136730,28547353,389441199.063100,1556764459.919800,515648916.385000,2461854575.367900,5686,722,5206,11614
2019-09-05,NYSE (N),878432278,52410772,34299655,965142705,34832438371.820806,2881678587.803700,1830797421.163400,39544914380.787906,3153387,118226,235651,3507264
2019-09-05,NYSE Arca (P),190610460,328274354,139944043,658828857,7256199144.314599,18366929430.308803,8781100586.431299,34404229161.054701,1674684,857608,1474114,4006406
2019-09-05,NASDAQ (Q),508521796,244081979,592419275,1345023050,20572036940.950398,14824387132.203897,35737979431.811298,71134403504.965593,4653176,993848,4650060,10297084
2019-09-05,IEX (V),131603183,23133719,62833854,217570756,5220852903.079801,1362269345.486900,3503189601.483801,10086311850.050502,953351,104982,507572,1565905
2019-09-05,NASDAQ PSX (X),16007567,23888865,13115803,53012235,554028411.953000,1525572399.561300,1119439570.961800,3199040382.476100,121087,89754,126176,337017
2019-09-05,BYX Equities (Y),152577458,81207123,60465537,294250118,3981239041.033400,3937983018.930600,2760578063.125700,10679800123.089700,1454746,429501,737455,2621702
2019-09-05,BZX Equities (Z),229291444,109047562,135385788,473724794,9567571515.380802,7627353692.399500,8943402269.952900,26138327477.733202,2034685,450055,1294673,3779413
2019-09-04,NYSE American (A),5665660,12353836,3053051,21072547,212141812.529200,195605883.596900,157633587.986400,565381284.112500,61560,42255,36365,140180
2019-09-04,NASDAQ BX (B),42509419,26517223,24876180,93902822,1476131950.848100,1213961435.832600,1339632350.731300,4029725737.412000,447116,97041,286446,830603
2019-09-04,NYSE National (C),59713974,26936596,22949014,109599584,1146961522.942100,853435567.959500,618828734.608100,2619225825.509700,508548,93210,237788,839546
2019-09-04,FINRA / Nasdaq TRF Chicago (DB),2705449,1422117,3240006,7367572,104375952.875000,59424920.510600,238842430.352800,402643303.738400,11685,4935,16976,33596
2019-09-04,FINRA / NYSE TRF (DN),190652948,83480701,170943001,445076650,4917991727.291100,2768234503.923200,7152366858.688200,14838593089.902500,454695,170765,460745,1086205
2019-09-04,FINRA / Nasdaq TRF Carteret (DQ),929578138,344600348,586934949,1861113435,33013031145.979794,16743438889.192407,27845285887.753408,77601755922.925609,3548054,897401,2273217,6718672
2019-09-04,EDGA Equities (J),68360583,25731832,37052649,131145064,2740424154.239600,1310534514.975500,1825230847.930400,5876189517.145500,941478,142327,539659,1623464
2019-09-04,EDGX Equities (K),143338460,77669242,104541695,325549397,4476924268.036698,3886567113.569600,5014445596.631099,13377936978.237397,1147105,335207,840581,2322893
2019-09-04,NYSE Chicago (M),9679959,9861583,7942966,27484508,358443343.846300,799469588.800000,835151543.594100,1993064476.240400,4920,702,5144,10766
2019-09-04,NYSE (N),749125553,39057999,30762696,818946248,29255674594.946203,1987638070.267000,1443142298.786500,32686454963.999703,2611996,86786,213095,2911877
2019-09-04,NYSE Arca (P),146398381,230069892,122340648,498808921,5633908823.027200,12510807725.151603,6637798362.172101,24782514910.350904,1376932,609226,1321624,3307782
2019-09-04,NASDAQ (Q),409555346,180679102,552851835,1143086283,16374909275.134799,9893844420.934701,29989051596.856910,56257805292.926410,3952821,731518,4107349,8791688
2019-09-04,IEX (V),102790379,19028097,56596223,178414699,4043527616.909700,1082927709.045300,2917430342.958400,8043885668.913400,778100,90222,462895,1331217
2019-09-04,NASDAQ PSX (X),11982846,16642783,11261575,39887204,427904961.669500,1036896033.821300,898169651.032500,2362970646.523300,97155,66202,104834,268191
2019-09-04,BYX Equities (Y),125140343,65195219,51458652,241794214,3237148446.649900,2906623575.749801,2032421170.501300,8176193192.901001,1263035,312535,650941,2226511
2019-09-04,BZX Equities (Z),170707870,76126737,106936101,353770708,7062452279.992800,4904653754.514603,6229889041.394000,18196995075.901403,1637309,312120,1070524,3019953
2019-09-03,NYSE American (A),6184510,15583348,2896834,24664692,245304603.159200,329781851.547500,158728618.696400,733815073.403100,67912,61632,34471,164015
2019-09-03,NASDAQ BX (B),46770720,27539959,25250309,99560988,1617249220.418400,1447084609.665900,1300215932.218200,4364549762.302500,493208,112725,278186,884119
2019-09-03,NYSE National (C),62195745,27019512,23341328,112556585,1184611046.516400,865806975.121700,632854576.227500,2683272597.865600,510583,108508,260220,879311
2019-09-03,FINRA / Nasdaq TRF Chicago (DB),2980676,1423784,3237372,7641832,111227661.499500,66719282.275700,215094485.686600,393041429.461800,13007,5348,16628,34983
2019-09-03,FINRA / NYSE TRF (DN),193528963,93153788,164514913,451197664,5198253037.090800,3211477683.712601,6974971323.330701,15384702044.134102,464247,198559,440210,1103016
2019-09-03,FINRA / Nasdaq TRF Carteret (DQ),972847270,480566360,597746763,2051160393,34393165914.579700,26372855360.990600,29135998502.263501,89902019777.833801,3716722,990127,2300894,7007743
2019-09-03,EDGA Equities (J),69904416,28989704,36394620,135288740,2733005466.190700,1591394771.894100,1801439294.450800,6125839532.535600,941113,172280,514978,1628371
2019-09-03,EDGX Equities (K),150854419,91128393,108968841,350951653,4615349179.381600,5044568848.921700,5237409214.359100,14897327242.662400,1230366,443871,906396,2580633
2019-09-03,NYSE Chicago (M),4890009,10697730,4407290,19995029,252474365.564300,1090950805.376001,412106921.133600,1755532092.073901,6011,708,4545,11264
2019-09-03,NYSE (N),849485531,47395299,33409104,930289934,32847732454.890802,2633971069.368100,1659138676.860900,37140842201.119802,2987651,119732,224494,3331877
2019-09-03,NYSE Arca (P),158712478,271876762,129603105,560192345,5916920462.521600,16133984026.003800,7138927933.625704,29189832422.151104,1536691,802545,1439141,3778377
2019-09-03,NASDAQ (Q),446572818,222866596,569953702,1239393116,18395591641.224397,12957367402.572901,31721717698.781402,63074676742.578700,4512765,1001417,4490899,10005081
2019-09-03,IEX (V),122575891,21427463,61078813,205082167,4650681156.686900,1257083543.286000,2999599104.206902,8907363804.179802,927242,98360,493632,1519234
2019-09-03,NASDAQ PSX (X),15037849,20399407,11333326,46770582,554576215.332300,1404798158.997200,814724142.642500,2774098516.972000,124919,87264,103220,315403
2019-09-03,BYX Equities (Y),139763465,68622805,54271928,262658198,3444643810.176900,3196288920.274999,2158784748.799500,8799717479.251399,1391746,387478,677257,2456481
2019-09-03,BZX Equities (Z),185527711,97744572,112376333,395648616,7686279661.676300,6747952902.908299,6728991985.265102,21163224549.849701,1821054,421241,1146707,3389002
2019-08-30,NYSE American (A),4709956,11487019,2112761,18309736,194518072.441800,156901002.935500,126335671.352000,477754746.729300,51542,40536,27123,119201
2019-08-30,NASDAQ BX (B),37809121,20981029,19190175,77980325,1497028089.389200,1152655856.731200,1224687437.552200,3874371383.672600,398956,85094,215141,699191
2019-08-30,NYSE National (C),54299136,34025257,20420849,108745242,1060799499.632800,1086906408.205300,595613276.535600,2743319184.373700,447964,190278,213562,851804
2019-08-30,FINRA / Nasdaq TRF Chicago (DB),2725206,1191276,2981451,6897933,111208997.416400,57705719.975000,220076449.556000,388991166.947400,12389,4530,16110,33029
2019-08-30,FINRA / NYSE TRF (DN),168426808,84104069,157139415,409670292,4716179303.150600,2946345723.267701,7096788704.260701,14759313730.679002,410112,157442,400808,968362
2019-08-30,FINRA / Nasdaq TRF Carteret (DQ),793654481,323039941,491956110,1608650532,29755992468.084903,19128041634.643497,25272190158.386396,74156224261.114796,3147914,712057,1912835,5772806
2019-08-30,EDGA Equities (J),61870493,25448388,29767419,117086300,2556864695.137200,1332091979.216900,1606477694.989300,5495434369.343400,814295,146958,420476,1381729
2019-08-30,EDGX Equities (K),129508652,72981540,93293078,295783270,4223755077.987399,4173999690.218799,5019872250.086400,13417627018.292598,1061278,334741,742641,2138660
2019-08-30,NYSE Chicago (M),5578879,7056237,4474540,17109656,208567511.536000,824605973.860000,480092063.254900,1513265548.650900,4761,404,3838,9003
2019-08-30,NYSE (N),863654257,38144320,26634872,928433449,36093435248.649398,2207793927.824801,1416481616.414000,39717710792.888199,2562138,94266,177143,2833547
2019-08-30,NYSE Arca (P),129919684,213730370,108596337,452246391,5246008426.167101,13003403996.598599,6746419974.514699,24995832397.280399,1258088,638545,1141731,3038364
2019-08-30,NASDAQ (Q),372131558,179750564,515454804,1067336926,15545794557.596702,10739955883.736495,31446253762.588293,57732004203.921490,3681663,800410,3675025,8157098
2019-08-30,IEX (V),95169225,17253687,45968786,158391698,3975815279.549500,1018329132.103200,2548303291.151700,7542447702.804400,741665,81179,399258,1222102
2019-08-30,NASDAQ PSX (X),14025847,18181742,9692488,41900077,475600856.141900,1336976520.646100,837825537.581200,2650402914.369200,103865,70967,89975,264807
2019-08-30,BYX Equities (Y),116590199,69861682,46228889,232680770,3122571676.813200,3194308054.131901,2024796867.761600,8341676598.706701,1176893,401928,572959,2151780
2019-08-30,BZX Equities (Z),159840130,77937258,94200266,331977654,7109110316.177799,5702979180.072600,6452175715.648499,19264265211.898898,1533103,328251,933384,2794738
2019-08-29,NYSE American (A),5215923,14383058,2339030,21938011,218695551.084700,161876258.670900,119452310.862000,500024120.617600,59499,45006,28158,132663
2019-08-29,NASDAQ BX (B),43455977,18215128,20705075,82376180,1608398853.255500,994911232.847400,1086436598.725600,3689746684.828500,452569,79431,240107,772107
2019-08-29,NYSE National (C),58318861,27080997,19521956,104921814,1132264686.893900,792766561.127000,576557556.236300,2501588804.257200,474503,91253,202024,767780
2019-08-29,FINRA / Nasdaq TRF Chicago (DB),3159271,1527842,3244521,7931634,123673366.507000,66459842.479400,217388908.419600,407522117.406000,13709,4882,16805,35396
2019-08-29,FINRA / NYSE TRF (DN),216527066,95756264,168700545,480983875,6026719162.666899,3115476680.405600,7608499771.514800,16750695614.587299,464000,184537,429004,1077541
2019-08-29,FINRA / Nasdaq TRF Carteret (DQ),907973239,358119739,511749992,1777842970,32949869095.505809,18802258964.755099,24643431633.605994,76395559693.866902,3478532,778508,2035263,6292303
2019-08-29,EDGA Equities (J),66907132,24208846,32390336,123506314,2642029586.016700,1309095793.843700,1675032924.310900,5626158304.171300,873519,143615,464329,1481463
2019-08-29,EDGX Equities (K),146372086,84255445,101660983,332288514,4701430626.272900,4416539520.565300,5023560978.613402,14141531125.451602,1166853,373092,792191,2332136
2019-08-29,NYSE Chicago (M),8001179,10168398,5794264,23963841,331505413.295000,999400693.732700,581686075.721200,1912592182.748900,5046,544,4404,9994
2019-08-29,NYSE (N),712551601,43622964,28894928,785069493,27221175745.161999,2276770691.350900,1393166681.215600,30891113117.728499,2672215,96483,192188,2960886
2019-08-29,NYSE Arca (P),151046571,235381238,111685992,498113801,5718911145.340899,13102648834.249305,6552281448.726000,25373841428.316204,1393219,660444,1189124,3242787
2019-08-29,NASDAQ (Q),417938440,199087520,478798888,1095824848,17114063935.756805,10981993603.874602,26817197330.476997,54913254870.108404,4003493,848347,3808917,8660757
2019-08-29,IEX (V),113885949,19323340,53338379,186547668,4515355276.343499,1110007868.053300,2733628722.160700,8358991866.557499,837555,85619,430281,1353455
2019-08-29,NASDAQ PSX (X),15806834,21761960,11209300,48778094,503597472.579200,1296599017.064600,725476889.022900,2525673378.666700,111612,77148,95346,284106
2019-08-29,BYX Equities (Y),125744203,58373478,48619998,232737679,3295798388.930600,2652752756.691499,2004513737.938700,7953064883.560799,1251513,316582,599159,2167254
2019-08-29,BZX Equities (Z),184254705,85677910,105115304,375047919,7898693266.906702,6037959828.575602,6535852636.799100,20472505732.281404,1703281,358915,1016957,3079153
2019-08-28,NYSE American (A),5106606,13087132,2220684,20414422,206426660.368600,208299400.465200,123565347.079200,538291407.913000,57408,45634,27473,130515
2019-08-28,NASDAQ BX (B),44518519,18963648,21988231,85470398,1563492226.314000,990978556.965000,1173060092.258000,3727530875.537000,456463,83113,237957,777533
2019-08-28,NYSE National (C),55816761,24936118,19255824,100008703,1090180306.153900,735529894.236500,511758586.056900,2337468786.447300,466052,85156,197145,748353
2019-08-28,FINRA / Nasdaq TRF Chicago (DB),2878435,1672966,2911865,7463266,118939059.390000,70810810.319000,208522721.660000,398272591.369000,12837,4993,14459,32289
2019-08-28,FINRA / NYSE TRF (DN),188223925,89420348,153917302,431561575,5163413829.012300,2780979215.501501,6444860742.941597,14389253787.455398,434958,168678,389849,993485
2019-08-28,FINRA / Nasdaq TRF Carteret (DQ),928661906,335244811,520275827,1784182544,32368736982.193189,17479771941.787097,23342568123.415094,73191077047.395380,3383283,725988,1914287,6023558
2019-08-28,EDGA Equities (J),65499872,22046252,30912155,118458279,2553795894.716100,1163528096.828600,1587543976.134900,5304867967.679600,851481,126224,423598,1401303
2019-08-28,EDGX Equities (K),140609374,81296753,96615120,318521247,4695160028.260800,4494991365.054501,4529816540.918600,13719967934.233901,1198903,367820,775209,2341932
2019-08-28,NYSE Chicago (M),7624283,11177196,4786626,23588105,328310209.764200,1002921081.652000,870835249.432300,2202066540.848500,5319,514,4395,10228
2019-08-28,NYSE (N),706896393,40490752,28545056,775932201,27620789161.437101,2330577459.389000,1369297889.172600,31320664509.998701,2592925,101594,186415,2880934
2019-08-28,NYSE Arca (P),143980236,220364981,108013628,472358845,5423708854.872801,12764799318.310904,5961537769.033700,24150045942.217405,1352907,662388,1115939,3131234
2019-08-28,NASDAQ (Q),400851994,188756071,468663426,1058271491,16224296695.119800,11063381187.162502,25257315358.286599,52544993240.568901,3924406,850786,3677724,8452916
2019-08-28,IEX (V),108863774,18215333,50700384,177779491,4489839112.947799,1044194244.460000,2750394808.196000,8284428165.603799,806025,79221,419337,1304583
2019-08-28,NASDAQ PSX (X),14506599,18063263,10471599,43041461,501574793.174800,1250665025.317300,712930509.191200,2465170327.683300,111498,74396,92831,278725
2019-08-28,BYX Equities (Y),121010333,55908385,46950193,223868911,3185168606.749400,2556107957.296200,1835038858.941100,7576315422.986700,1199809,296162,559545,2055516
2019-08-28,BZX Equities (Z),167431287,84733987,97229726,349395000,7015663199.889499,6045762617.352299,5642205652.598999,18703631469.840797,1567465,359682,939125,2866272
2019-08-27,NYSE American (A),5642991,15927821,2632484,24203296,228623844.652000,240390448.086000,145047197.239500,614061489.977500,63567,54480,32376,150423
2019-08-27,NASDAQ BX (B),47297771,23446929,22997731,93742431,1694033577.477200,1206832313.062500,1222874853.621900,4123740744.161600,484284,104021,242311,830616
2019-08-27,NYSE National (C),62371929,28068364,22138724,112579017,1176476484.920100,914415053.669700,611234403.630700,2702125942.220500,498985,116608,220677,836270
2019-08-27,FINRA / Nasdaq TRF Chicago (DB),3663163,1728474,3468146,8859783,144807893.086900,97225578.787200,233685234.410400,475718706.284500,15165,5978,18512,39655
2019-08-27,FINRA / NYSE TRF (DN),214057464,98190237,186589977,498837678,6085811284.785000,3174534839.598302,7612736084.322899,16873082208.706201,489254,185818,459324,1134396
2019-08-27,FINRA / Nasdaq TRF Carteret (DQ),1012900184,394468974,567151528,1974520686,37724976359.708200,20374727912.880305,29144484642.241103,87244188914.829608,3524885,844667,2038250,6407802
2019-08-27,EDGA Equities (J),71907632,25879009,34724291,132510932,2786537233.092400,1391635221.471400,1679737948.627100,5857910403.190900,913910,166665,462813,1543388
2019-08-27,EDGX Equities (K),157770912,86440164,111236212,355447288,5000316167.684299,4786603663.942901,5024110460.221302,14811030291.848502,1281345,408451,851530,2541326
2019-08-27,NYSE Chicago (M),11792239,17620174,3938817,33351230,608265667.244500,2214948142.586400,477549205.506500,3300763015.337400,5465,697,4573,10735
2019-08-27,NYSE (N),890303498,46914640,29923342,967141480,35955474171.505501,2527603612.900900,1408577947.373500,39891655731.779901,2805534,108265,196364,3110163
2019-08-27,NYSE Arca (P),161616843,253192780,123411825,538221448,6255950200.244200,14533906087.330800,6659475958.786000,27449332246.361000,1519396,757457,1270415,3547268
2019-08-27,NASDAQ (Q),444156972,210440089,582496619,1237093680,17859651798.952499,12044012187.831999,31771357715.809987,61675021702.594485,4198524,941639,3952219,9092382
2019-08-27,IEX (V),110148513,21004548,52031861,183184922,4482234876.808000,1139762697.654500,2641309709.500599,8263307283.963099,827804,95571,432292,1355667
2019-08-27,NASDAQ PSX (X),16531152,20992377,11483713,49007242,562543565.258200,1394474354.895300,815333938.543300,2772351858.696800,117911,88279,101695,307885
2019-08-27,BYX Equities (Y),136734480,66228357,52336549,255299386,3453862799.219800,2975960178.098101,2021830017.412000,8451652994.729901,1328703,359730,619548,2307981
2019-08-27,BZX Equities (Z),190597154,89039685,108374778,388011617,8131402773.542299,6174096411.709201,6341651980.918799,20647151166.170299,1761313,383042,1040778,3185133
2019-08-26,NYSE American (A),4340060,12402103,2174966,18917129,185777537.702400,158464664.963900,133811898.247600,478054100.913900,49754,45424,27323,122501
2019-08-26,NASDAQ BX (B),39869283,18735999,20613812,79219094,1439351603.055900,979145260.517300,1109964496.681200,3528461360.254400,420013,88937,228303,737253
2019-08-26,NYSE National (C),52549125,21790391,18888619,93228135,986195824.117800,722299525.393500,501655086.726200,2210150436.237500,432722,98549,193161,724432
2019-08-26,FINRA / Nasdaq TRF Chicago (DB),2591265,1450472,3448896,7490633,122802223.881000,78716661.481000,209449729.519700,410968614.881700,11869,5288,16968,34125
2019-08-26,FINRA / NYSE TRF (DN),169240662,90402608,166003637,425646907,4790046103.676399,2912510455.645400,7055958885.431597,14758515444.753396,413382,172993,421215,1007590
2019-08-26,FINRA / Nasdaq TRF Carteret (DQ),800800829,351953378,499641251,1652395458,28887002681.853300,18516192329.247703,23614144015.411600,71017339026.512603,3253344,808221,1994331,6055896
2019-08-26,EDGA Equities (J),62080119,23652007,31496793,117228919,2403392000.497300,1330976496.112701,1756829797.108200,5491198293.718201,818154,148072,436540,1402766
2019-08-26,EDGX Equities (K),131839675,81128633,103054330,316022638,4339159852.553500,4655301973.684097,4918039987.135900,13912501813.373497,1114043,384819,804925,2303787
2019-08-26,NYSE Chicago (M),6591321,11852442,4737486,23181249,283954743.903600,1669779580.333800,625945962.548600,2579680286.786000,5391,763,4977,11131
2019-08-26,NYSE (N),706351587,40703850,28255133,775310570,28442732583.546003,2326953350.976300,1444166786.253800,32213852720.776103,2498386,107162,192812,2798360
2019-08-26,NYSE Arca (P),128267650,237208112,113329771,478805533,5102768054.859600,14836326963.121099,6431693791.530299,26370788809.510998,1255876,750030,1165728,3171634
2019-08-26,NASDAQ (Q),366856975,194042616,494495752,1055395343,15333273373.959099,11520070965.085099,27502498847.789001,54355843186.833199,3707208,881778,3629416,8218402
2019-08-26,IEX (V),96234980,16447519,48393211,161075710,3815420474.257600,892819327.733900,2531338692.714900,7239578494.706400,755858,80230,419050,1255138
2019-08-26,NASDAQ PSX (X),13863974,17981058,10971202,42816234,469300989.932200,1170979200.071900,801756657.431900,2442036847.436000,101631,75142,98628,275401
2019-08-26,BYX Equities (Y),118612650,58346695,47392651,224351996,3042175608.832300,2922373793.800601,1832188941.838800,7796738344.471701,1175355,341520,568275,2085150
2019-08-26,BZX Equities (Z),159700414,89198762,99093500,347992676,6795516147.665401,6489107399.759404,5973028328.396598,19257651875.821403,1529152,399560,960622,2889334
2019-08-23,NYSE American (A),5738991,16025751,3271869,25036611,265240652.200000,289118105.964500,209473749.122200,763832507.286700,65363,61956,39236,166555
2019-08-23,NASDAQ BX (B),51044481,31600188,30863583,113508252,1954949205.565600,1936389851.681100,1755819872.464100,5647158929.710800,509183,147078,301670,957931
2019-08-23,NYSE National (C),63426230,29430675,25258092,118114997,1311510622.486700,1038547634.808800,858816918.316400,3208875175.611900,510768,120446,248809,880023
2019-08-23,FINRA / Nasdaq TRF Chicago (DB),3954996,2240056,4145777,10340829,206303172.533600,129889268.832100,291288469.150400,627480910.516100,18283,7708,20996,46987
2019-08-23,FINRA / NYSE TRF (DN),237467418,115285847,194919032,547672297,7307291918.231204,4099481759.986401,9637152418.034797,21043926096.252402,554180,225431,525621,1305232
2019-08-23,FINRA / Nasdaq TRF Carteret (DQ),1056110161,501863138,600003453,2157976752,38911058124.201599,31955216851.704790,31576853238.025593,102443128213.931982,3960264,1095334,2407174,7462772
2019-08-23,EDGA Equities (J),79867602,38583786,40928952,159380340,3036696265.908700,2428762951.833601,2227478883.061400,7692938100.803701,988380,206895,519677,1714952
2019-08-23,EDGX Equities (K),183679860,144294606,140716844,468691310,6470419936.866601,9581617634.522801,7797798527.895600,23849836099.285002,1452854,677891,1076127,3206872
2019-08-23,NYSE Chicago (M),7123644,5446759,4202926,16773329,398827926.461600,530981448.198000,596208802.745800,1526018177.405400,7876,1278,7167,16321
2019-08-23,NYSE (N),971405847,75625094,40412636,1087443577,40930400500.149702,4681014073.894901,2364625470.972600,47976040045.017203,3566094,205561,271129,4042784
2019-08-23,NYSE Arca (P),201867222,404894637,160775118,767536977,7822197390.633901,25402943639.409487,10312977642.009297,43538118672.052685,1711411,1276909,1612556,4600876
2019-08-23,NASDAQ (Q),540967486,350919117,686429178,1578315781,23185141963.232597,22879921265.471509,42034337021.225988,88099400249.930094,5240752,1585754,5226416,12052922
2019-08-23,IEX (V),128850974,26646364,59172859,214670197,5335507878.856799,1905236081.545200,3364906955.882900,10605650916.284899,917755,126703,476624,1521082
2019-08-23,NASDAQ PSX (X),24663790,39057103,18193207,81914100,773894431.886300,2925083302.355300,1536509915.293000,5235487649.534600,141671,183209,168991,493871
2019-08-23,BYX Equities (Y),160779632,93672860,64436519,318889011,4043552885.083100,4949334798.598199,2804792849.542001,11797680533.223300,1508752,476123,729095,2713970
2019-08-23,BZX Equities (Z),225579743,164685662,140647871,530913276,10259304181.467399,12827526390.713404,10117724034.768800,33204554606.949603,2103078,759154,1382825,4245057
2019-08-22,NYSE American (A),4579549,11745370,2298027,18622946,190621180.118200,169429702.217900,121221851.990000,481272734.326100,52241,39088,26990,118319
2019-08-22,NASDAQ BX (B),40438264,17352496,22558846,80349606,1514749570.654500,898795386.343100,1162321613.065500,3575866570.063100,416529,75074,244177,735780
2019-08-22,NYSE National (C),47409693,20197109,19270282,86877084,948856262.399400,697847832.888400,520615355.653200,2167319450.941000,404921,84962,192861,682744
2019-08-22,FINRA / Nasdaq TRF Chicago (DB),2942596,1044693,3168024,7155313,138561318.782200,56108814.536600,206694647.362800,401364780.681600,14200,4451,16020,34671
2019-08-22,FINRA / NYSE TRF (DN),191461006,73215209,190305580,454981795,5922219498.948201,2500665709.162200,7369958745.195800,15792843953.306201,457003,148396,432402,1037801
2019-08-22,FINRA / Nasdaq TRF Carteret (DQ),831125341,305072053,534216053,1670413447,31009751338.980693,15900023720.500404,24589018718.987002,71498793778.468099,3259592,679242,1992797,5931631
2019-08-22,EDGA Equities (J),63042750,21206793,33260238,117509781,2495529604.978300,1153185741.893700,1608931322.588700,5257646669.460700,819436,132328,445732,1397496
2019-08-22,EDGX Equities (K),131748595,63659391,108104998,303512984,4704142638.966400,3719128891.583400,4746597907.520200,13169869438.070000,1102041,308133,772820,2182994
2019-08-22,NYSE Chicago (M),6859464,9010135,6029291,21898890,332194314.950800,1057045424.976000,664639722.349700,2053879462.276500,5623,745,4962,11330
2019-08-22,NYSE (N),683348115,34212696,27583171,745143982,28019260257.686102,2044149543.532400,1344727177.345400,31408136978.563902,2453542,90917,182700,2727159
2019-08-22,NYSE Arca (P),134298540,197473550,116874621,448646711,5388628452.573600,11918813896.542897,6231368156.586401,23538810505.702898,1252453,587644,1144977,2985074
2019-08-22,NASDAQ (Q),371880022,154581068,500469306,1026930396,15751525791.152499,8986992808.147699,26725694008.792114,51464212608.092312,3642876,704698,3582943,7930517
2019-08-22,IEX (V),101477994,15340071,53003228,169821293,4457966763.298300,899322818.520100,2671426864.991400,8028716446.809800,768384,73924,416627,1258935
2019-08-22,NASDAQ PSX (X),13487058,14427433,10346874,38261365,445807462.805100,964769447.757800,665968917.142200,2076545827.705100,93843,61735,87412,242990
2019-08-22,BYX Equities (Y),110500630,48984642,48581667,208066939,2941042522.676900,2382991319.781800,1968786734.116600,7292820576.575300,1131853,275281,576997,1984131
2019-08-22,BZX Equities (Z),159062743,69198680,104691955,332953378,7103312408.155900,5250148065.032101,5924636860.270302,18278097333.458303,1500096,319310,936570,2755976
2019-08-21,NYSE American (A),4576605,12744813,2203835,19525253,191776752.042200,139835470.843100,130033829.902600,461646052.787900,51079,41917,27268,120264
2019-08-21,NASDAQ BX (B),45984393,20470499,24525528,90980420,1778666143.504700,985768133.338200,1230716636.766500,3995150913.609400,497498,81517,272281,851296
2019-08-21,NYSE National (C),45130458,19059512,17149466,81339436,920224576.169700,664289617.015000,509967015.585100,2094481208.769800,382437,86633,179927,648997
2019-08-21,FINRA / Nasdaq TRF Chicago (DB),2950109,1024787,3178524,7153420,136346158.265000,44168777.499400,209950237.068700,390465172.833100,13542,4318,17033,34893
2019-08-21,FINRA / NYSE TRF (DN),192184179,76060832,172336557,440581568,5769102885.182201,2379286255.251501,6694052510.541999,14842441650.975701,461521,157370,427295,1046186
2019-08-21,FINRA / Nasdaq TRF Carteret (DQ),918971453,341119522,556007951,1816098926,34927909544.258503,17320582660.707001,24054845219.411393,76303337424.376897,3404589,690725,2028151,6123465
2019-08-21,EDGA Equities (J),66903261,22389518,31660143,120952922,2610819985.681800,1178694582.187400,1524095151.168300,5313609719.037500,893651,135476,444619,1473746
2019-08-21,EDGX Equities (K),133571720,63607376,99832031,297011127,4399250432.018399,3266711943.403601,4550184251.196301,12216146626.618301,1060601,290816,737812,2089229
2019-08-21,NYSE Chicago (M),8062101,11787585,6364552,26214238,393200553.797800,1298078963.375600,589076236.750500,2280355753.923900,5539,810,4218,10567
2019-08-21,NYSE (N),669384064,34900310,26654658,730939032,26685522791.233002,1970198189.287500,1257833529.603000,29913554510.123502,2458742,86243,179532,2724517
2019-08-21,NYSE Arca (P),139995810,191338220,110204937,441538967,5746677465.226699,11056556480.739199,5784778464.454100,22588012410.419998,1288398,585775,1126148,3000321
2019-08-21,NASDAQ (Q),382688933,160028618,468409754,1011127305,16095151632.713803,8894510600.391396,24353028012.408897,49342690245.514096,3689337,700217,3453039,7842593
2019-08-21,IEX (V),106843301,16019481,50697353,173560135,4403095263.996500,844542395.601400,2487261136.335799,7734898795.933699,787588,69495,404574,1261657
2019-08-21,NASDAQ PSX (X),14267774,13223204,9090242,36581220,435632995.751700,875838992.134400,592039750.049600,1903511737.935700,97760,55114,76783,229657
2019-08-21,BYX Equities (Y),118590222,50697356,48065002,217352580,3256498674.464400,2403657273.744300,1968959863.773900,7629115811.982600,1218751,291000,582276,2092027
2019-08-21,BZX Equities (Z),166437432,64572089,95038621,326048142,7200495172.168700,4368732813.390297,5322840181.500003,16892068167.059000,1577937,295476,896355,2769768
2019-08-20,NYSE American (A),4666385,13413620,2537611,20617616,195139114.936000,151024407.195400,142501422.260100,488664944.391500,51447,41985,29617,123049
2019-08-20,NASDAQ BX (B),45216170,19576625,22914273,87707068,1745410275.315100,919691716.837600,1184984367.698200,3850086359.850900,476990,74175,260558,811723
2019-08-20,NYSE National (C),48367162,25603141,18238931,92209234,936527336.881700,809174469.702100,477078214.143100,2222780020.726900,393554,84775,181652,659981
2019-08-20,FINRA / Nasdaq TRF Chicago (DB),2771351,1062762,2927764,6761877,113695127.800000,54478924.892200,199479077.710000,367653130.402200,12818,4050,15573,32441
2019-08-20,FINRA / NYSE TRF (DN),189960533,83006408,168201955,441168896,5151172279.497501,2657065935.642800,6848618059.027803,14656856274.168104,441231,169765,424190,1035186
2019-08-20,FINRA / Nasdaq TRF Carteret (DQ),924360292,301798216,566622202,1792780710,33865238533.589101,15694191714.317492,25667286081.364694,75226716329.271287,3322030,704794,2003307,6030131
2019-08-20,EDGA Equities (J),66590439,19383128,32239159,118212726,2593103171.116200,1071026410.275100,1507599812.647600,5171729394.038900,855318,117853,434981,1408152
2019-08-20,EDGX Equities (K),129076079,65668198,99446576,294190853,4067736191.921400,3365868186.860401,4341687193.235902,11775291572.017703,1044938,297196,722685,2064819
2019-08-20,NYSE Chicago (M),9995349,6750503,5598432,22344284,527435887.545800,614670906.860400,831201950.928700,1973308745.334900,5524,976,4206,10706
2019-08-20,NYSE (N),703004790,33456777,26976833,763438400,28549614537.296504,1961195560.097200,1201227793.696500,31712037891.090204,2523069,83780,175593,2782442
2019-08-20,NYSE Arca (P),140440262,212927403,110793408,464161073,5472723202.123299,11996575956.879500,5776942399.763101,23246241558.765900,1318891,574612,1139468,3032971
2019-08-20,NASDAQ (Q),394541688,160638111,489790491,1044970290,16543641170.158903,8956204556.680506,25949264255.102503,51449109981.941912,3788962,705643,3474592,7969197
2019-08-20,IEX (V),106774849,15318167,50727969,172820985,4360826847.234400,887091256.289000,2561532160.129400,7809450263.652800,758185,66265,402148,1226598
2019-08-20,NASDAQ PSX (X),14490383,15090304,9839057,39419744,414438495.174700,935767882.239700,630403192.624800,1980609570.039200,96410,60542,79624,236576
2019-08-20,BYX Equities (Y),126294474,50007997,48558242,224860713,3426886932.812300,2397309131.889700,1851428533.609200,7675624598.311200,1261131,283613,579171,2123915
2019-08-20,BZX Equities (Z),161165801,67459637,95325764,323951202,6996136832.030701,4689480478.705599,5422531566.999700,17108148877.736000,1499741,297347,894193,2691281
2019-08-19,NYSE American (A),5286597,17284469,2511412,25082478,212925779.963400,258663057.755700,142274119.849400,613862957.568500,58182,59614,30306,148102
2019-08-19,NASDAQ BX (B),43676495,18860538,23377129,85914162,1554152085.755600,923678840.026700,1237907277.729900,3715738203.512200,447769,84650,258987,791406
2019-08-19,NYSE National (C),49713689,26410983,19495184,95619856,874869901.366100,767473097.425900,477600607.054400,2119943605.846400,395655,90168,179204,665027
2019-08-19,FINRA / Nasdaq TRF Chicago (DB),3045481,1488473,3432451,7966405,112606273.253400,67845450.413800,231295772.678800,411747496.346000,13599,5457,19422,38478
2019-08-19,FINRA / NYSE TRF (DN),202140080,84751591,188092781,474984452,5498353578.541101,2685512132.413700,7929335728.092903,16113201439.047704,484380,193547,489840,1167767
2019-08-19,FINRA / Nasdaq TRF Carteret (DQ),952864094,366403302,628162645,1947430041,35077135515.641785,18748594572.911198,29110093893.173518,82935823981.726501,3466744,807505,2216417,6490666
2019-08-19,EDGA Equities (J),66636992,20552284,35647256,122836532,2615219673.125300,1083565626.315300,1808720242.542200,5507505541.982800,866174,129720,482905,1478799
2019-08-19,EDGX Equities (K),140400760,69053034,112437140,321890934,4340778469.263500,3368096469.416500,5140729607.116501,12849604545.796501,1114404,321586,823404,2259394
2019-08-19,NYSE Chicago (M),11069422,8429257,6624605,26123284,560364006.367300,1020259514.080000,934384135.332200,2515007655.779500,6977,1142,5455,13574
2019-08-19,NYSE (N),768618697,34754249,29443181,832816127,30394904109.235799,1979135237.926201,1385858051.217400,33759897398.379400,2577168,90460,194405,2862033
2019-08-19,NYSE Arca (P),147396463,221456637,124424216,493277316,5532762934.292701,12447398506.873498,6770527120.740201,24750688561.906400,1347512,632145,1283810,3263467
2019-08-19,NASDAQ (Q),400956064,177733696,544354790,1123044550,16291184401.536399,9599348613.486002,29650475654.452901,55541008669.475302,3780795,757956,3786747,8325498
2019-08-19,IEX (V),111016309,17713951,57356652,186086912,4508819038.414400,992832191.527800,3170006157.324100,8671657387.266300,842906,81408,466159,1390473
2019-08-19,NASDAQ PSX (X),15556915,16134094,10372998,42064007,446554901.474000,1007660716.230500,708690423.657600,2162906041.362100,103946,63580,85631,253157
2019-08-19,BYX Equities (Y),130331705,53214925,52419735,235966365,3436419591.248600,2408895808.905499,2081655213.517800,7926970613.671899,1308388,309499,634797,2252684
2019-08-19,BZX Equities (Z),172344030,75507614,108292391,356144035,7137674016.411599,4906740951.167901,6256416376.652499,18300831344.231999,1581357,333684,1022225,2937266
2019-08-16,NYSE American (A),6136427,12636107,2590475,21363009,245666117.422600,186920164.912400,155989961.913500,588576244.248500,63359,46071,31333,140763
2019-08-16,NASDAQ BX (B),47396525,21545804,25171150,94113479,1709746386.585600,1214427793.119500,1364641708.325100,4288815888.030200,466103,96935,262965,826003
2019-08-16,NYSE National (C),52238217,30713097,19538952,102490266,948970195.254600,958598306.071100,500071447.107300,2407639948.433000,425101,108492,191363,724956
2019-08-16,FINRA / Nasdaq TRF Chicago (DB),2819907,1084800,3366935,7271642,117905885.935000,51897167.691000,237149268.534700,406952322.160700,12504,3889,18155,34548
2019-08-16,FINRA / NYSE TRF (DN),198679991,81264189,194236782,474180962,5261347560.315700,2752362665.769598,7800356551.550900,15814066777.636198,468356,168220,464598,1101174
2019-08-16,FINRA / Nasdaq TRF Carteret (DQ),1041693241,375665893,624483213,2041842347,37325869392.264694,23678866582.000710,29658336317.021393,90663072291.286797,3587464,841782,2190929,6620175
2019-08-16,EDGA Equities (J),78176217,23767812,36849909,138793938,2995270350.512400,1445940334.692300,1732664132.330100,6173874817.534800,946284,143577,480871,1570732
2019-08-16,EDGX Equities (K),148863168,70111227,110868935,329843330,4674198619.003599,4402747361.050401,5173217955.037103,14250163935.091103,1141111,324586,809757,2275454
2019-08-16,NYSE Chicago (M),13690070,13015468,8906233,35611771,612920730.724800,2407311357.976799,1104667029.154199,4124899117.855798,6969,1005,5102,13076
2019-08-16,NYSE (N),860899160,41427765,30742069,933068994,35343291988.032191,2608613070.283400,1433828910.761700,39385733969.077291,2629291,108018,201236,2938545
2019-08-16,NYSE Arca (P),163867202,235124210,129583423,528574835,6088272770.479500,14312457773.970595,7152230242.449400,27552960786.899495,1424563,700125,1310436,3435124
2019-08-16,NASDAQ (Q),437814933,185377698,593232113,1216424744,17287450154.484999,11819799738.290399,32764161344.966900,61871411237.742298,3997449,796369,3900710,8694528
2019-08-16,IEX (V),122852707,20535033,57086236,200473976,4660206734.704500,1265471418.479500,2956520573.376800,8882198726.560800,846799,94331,448062,1389192
2019-08-16,NASDAQ PSX (X),18257274,18451338,11470267,48178879,539544744.403000,1272752105.265000,917809282.819400,2730106132.487400,123642,74302,100084,298028
2019-08-16,BYX Equities (Y),139170352,62024695,53541526,254736573,3638890112.583100,3297474746.306900,2235722065.186200,9172086924.076200,1332574,337636,625201,2295411
2019-08-16,BZX Equities (Z),191527149,86231687,117050515,394809351,7898018218.345302,6635432624.681101,7073137239.811298,21606588082.837701,1691952,380882,1053942,3126776
2019-08-15,NYSE American (A),7267743,12502863,3230247,23000853,274356403.011500,216206092.632600,184202175.871500,674764671.515600,88264,49784,45366,183414
2019-08-15,NASDAQ BX (B),59803475,28691417,29314572,117809464,2068927994.618300,1581066358.320100,1541734517.845300,5191728870.783700,563091,118170,305484,986745
2019-08-15,NYSE National (C),64732113,40644748,23709151,129086012,1173166293.356000,1211833259.045000,608789086.625600,2993788639.026600,530152,133102,232339,895593
2019-08-15,FINRA / Nasdaq TRF Chicago (DB),3422767,1210349,3415223,8048339,145713591.147000,72131218.637900,226120784.148400,443965593.933300,14808,4495,17243,36546
2019-08-15,FINRA / NYSE TRF (DN),262893519,104234576,224934241,592062336,6679858555.181399,3713526267.926301,8389846101.765804,18783230924.873504,581595,198901,524808,1305304
2019-08-15,FINRA / Nasdaq TRF Carteret (DQ),1163470662,397108242,646900951,2207479855,38372706344.987084,22837524521.073094,28828153681.797183,90038384547.857361,4186643,920148,2376477,7483268
2019-08-15,EDGA Equities (J),86822313,29938390,40264652,157025355,3005665138.571800,1689922141.186200,1817726778.121200,6513314057.879200,1084551,167117,530261,1781929
2019-08-15,EDGX Equities (K),179557272,94043812,132878669,406479753,5362397949.956200,5690870246.151901,6140269002.066799,17193537198.174900,1366026,454869,934582,2755477
2019-08-15,NYSE Chicago (M),11856070,18219998,6782762,36858830,546900014.770000,1688740892.177800,674731205.263500,2910372112.211300,8364,1246,6851,16461
2019-08-15,NYSE (N),875644207,58397692,38710081,972751980,32823900973.659098,3697538281.820598,2018147220.884700,38539586476.364396,3323338,159132,250554,3733024
2019-08-15,NYSE Arca (P),213814081,319141581,158268410,691224072,7914097760.536098,19956267050.706700,8818219562.493299,36688584373.736097,1856367,995341,1525856,4377564
2019-08-15,NASDAQ (Q),548498663,258853109,605481985,1412833757,20973760362.700502,17439452651.249006,32597207809.826796,71010420823.776304,5011467,1172002,4685223,10868692
2019-08-15,IEX (V),147403774,21027671,66811455,235242900,5702476830.440402,1317612382.304300,3534703232.493800,10554792445.238502,1034991,99180,510596,1644767
2019-08-15,NASDAQ PSX (X),22713205,25016482,14327506,62057193,623234331.123000,1769800945.145000,994658438.544800,3387693714.812800,137240,111445,126399,375084
2019-08-15,BYX Equities (Y),164829504,74446967,62137091,301413562,4091315284.944400,3671921620.965500,2393211106.033300,10156448011.943200,1517436,386929,706119,2610484
2019-08-15,BZX Equities (Z),228998986,120058808,133644862,482702656,9114553217.699202,8877005223.122299,7764267850.934601,25755826291.756102,1987271,543840,1186234,3717345
2019-08-14,NYSE American (A),8499508,14691583,4224748,27415839,362504918.500100,313518400.426800,251433769.003800,927457087.930700,104954,62366,55986,223306
2019-08-14,NASDAQ BX (B),60335700,34505160,33650405,128491265,2137678535.974200,1817989109.979800,1743190804.985500,5698858450.939500,586535,134636,341163,1062334
2019-08-14,NYSE National (C),69014109,48037588,24258218,141309915,1309257999.505800,1457927008.302800,637655685.250300,3404840693.058900,546410,158591,234743,939744
2019-08-14,FINRA / Nasdaq TRF Chicago (DB),3210490,1772282,4352132,9334904,145356088.989100,92540802.195700,286371521.016300,524268412.201100,15610,6180,22089,43879
2019-08-14,FINRA / NYSE TRF (DN),256495074,117138120,255480349,629113543,6820505922.014802,4532302897.927297,10152151589.021205,21504960408.963304,608730,237335,618787,1464852
2019-08-14,FINRA / Nasdaq TRF Carteret (DQ),1244431929,518923048,755873158,2519228135,43178423498.736882,29702594014.489599,35544752573.298696,108425770086.525177,4509303,1149422,2669988,8328713
2019-08-14,EDGA Equities (J),99516861,38263667,46487973,184268501,3478874343.273900,2117416262.125900,2113118346.820200,7709408952.220000,1183700,216260,594223,1994183
2019-08-14,EDGX Equities (K),192128879,128367758,157933438,478430075,6257674694.038499,8200080081.133096,7155265429.138001,21613020204.309596,1529106,589177,1092558,3210841
2019-08-14,NYSE Chicago (M),17005611,10386840,7430638,34823089,701972086.820100,1078370162.031000,807380246.311900,2587722495.163000,7798,1645,7000,16443
2019-08-14,NYSE (N),988348125,76356439,43887169,1108591733,39047060676.739096,4946506417.854400,2127645163.488400,46121212258.081896,3502550,184576,278901,3966027
2019-08-14,NYSE Arca (P),219882635,377298554,183728161,780909350,8657776878.380400,24058259041.683795,9845681736.477003,42561717656.541198,2053047,1167634,1737233,4957914
2019-08-14,NASDAQ (Q),571195082,311024547,714048319,1596267948,23259913202.459901,20709694778.335913,39864217217.050400,83833825197.846214,5465340,1344784,5154871,11964995
2019-08-14,IEX (V),147007729,27985833,73066481,248060043,6026677564.437100,1943541950.649800,3782568618.354300,11752788133.441200,1069815,133517,557651,1760983
2019-08-14,NASDAQ PSX (X),22721585,30672623,16939137,70333345,695452213.213000,2237260154.737001,1201457033.728800,4134169401.678801,156917,125855,148349,431121
2019-08-14,BYX Equities (Y),174516609,95873413,71065235,341455257,4555134662.785601,4767931104.383799,2815119195.022100,12138184962.191500,1671098,491653,801486,2964237
2019-08-14,BZX Equities (Z),250842937,151761271,151252766,553856974,10427100001.028501,11519826858.600205,8818785513.666601,30765712373.295307,2199769,652687,1348727,4201183
2019-08-13,NYSE American (A),7425188,15629214,3395907,26450309,297109270.649700,270870176.899900,207518322.401800,775497769.951400,84072,63212,44169,191453
2019-08-13,NASDAQ BX (B),58709500,37836978,32632591,129179069,2265339615.321400,1834084248.745300,1858684611.848800,5958108475.915500,585274,144383,353502,1083159
2019-08-13,NYSE National (C),60940727,43490074,21078052,125508853,1172873927.692300,1297158471.581700,617943109.613100,3087975508.887100,480434,147796,210975,839205
2019-08-13,FINRA / Nasdaq TRF Chicago (DB),3125603,1801689,3988383,8915675,139715923.762600,80934914.500200,274319065.770600,494969904.033400,13890,5841,19787,39518
2019-08-13,FINRA / NYSE TRF (DN),228877843,104027004,238144725,571049572,5803106352.141301,3395261707.809999,10211305302.276503,19409673362.227803,503142,195450,560781,1259373
2019-08-13,FINRA / Nasdaq TRF Carteret (DQ),1122387854,446931098,693739294,2263058246,38239871890.035797,23864024187.312799,32302422368.242402,94406318445.590998,3970004,965721,2474224,7409949
2019-08-13,EDGA Equities (J),87728200,37336832,43278012,168343044,3191999345.068900,2063633282.351899,2088449203.772200,7344081831.192999,1047883,204451,537987,1790321
2019-08-13,EDGX Equities (K),165869623,120246080,138964706,425080409,5307978993.944104,6693668069.434401,6785856601.391203,18787503664.769708,1329286,529369,1009962,2868617
2019-08-13,NYSE Chicago (M),16724610,11327957,8990992,37043559,454957808.533000,1332677505.299300,913749111.361000,2701384425.193300,6677,1565,7031,15273
2019-08-13,NYSE (N),856150822,69497508,39202500,964850830,33477632536.797099,4002976290.615602,2165649249.136000,39646258076.548701,3084127,172497,259114,3515738
2019-08-13,NYSE Arca (P),188211794,361500258,168836345,718548397,7455606402.053500,20518248982.900502,9450023850.371600,37423879235.325602,1727885,1064311,1568034,4360230
2019-08-13,NASDAQ (Q),517738826,299224018,666340416,1483303260,21672717026.802389,18056458171.213404,37671864460.278106,77401039658.293899,4978835,1291798,4869229,11139862
2019-08-13,IEX (V),142039527,28398432,72902998,243340957,5748510189.445598,1787204522.169400,3891278541.560800,11426993253.175798,988113,120871,544554,1653538
2019-08-13,NASDAQ PSX (X),20292620,32880561,14030100,67203281,626924422.320200,1984962378.824300,926114093.012100,3538000894.156600,138680,122994,131343,393017
2019-08-13,BYX Equities (Y),155871255,87826423,64488084,308185762,4094560921.251400,4209980845.505400,2927136130.694000,11231677897.450800,1501359,464429,738162,2703950
2019-08-13,BZX Equities (Z),225104631,147058740,143560044,515723415,8940729920.460901,10060233747.830495,8201001908.760299,27201965577.051695,1973956,632703,1271881,3878540
2019-08-12,NYSE American (A),6387189,14740394,3607735,24735318,257155798.9,203622890.7,173168861.692500,633947551.292500,74583,54236,45101,173920
2019-08-12,NASDAQ BX (B),51908546,23734716,29051830,104695092,1927880453.8030,1172538530.5314,1414497980.976400,4514916965.310800,522006,97777,303461,923244
2019-08-12,NYSE National (C),53683443,29480518,19171314,102335275,996974507.9,914207958.9,507060434.168600,2418242900.968600,444161,107931,197003,749095
2019-08-12,FINRA / Nasdaq TRF Chicago (DB),2599622,1068352,3578698,7246672,101336348.3300,50293304.8394,232052630.615500,383682283.784900,12226,4231,18473,34930
2019-08-12,FINRA / NYSE TRF (DN),195903337,83387867,211506953,490798157,5180559439,2838884453,8315871320.129804,16335315212.129804,473538,174552,519740,1167830
2019-08-12,FINRA / Nasdaq TRF Carteret (DQ),936853740,394121307,619412534,1950387581,34842801626.9783,22063424079.4277,27579160457.930192,84485386164.336192,3508212,799387,2259381,6566980
2019-08-12,EDGA Equities (J),72037651,25509112,37158834,134705597,2654030180.22,1380341752.74,1640225734.564100,5674597667.524100,892667,140354,484739,1517760
2019-08-12,EDGX Equities (K),145411794,79267549,123668313,348347656,4594985443.18,4524717749.13,5215319733.439103,14335022925.749103,1222952,349668,911926,2484546
2019-08-12,NYSE Chicago (M),18749613,7688157,4632402,31070172,659529007.3,569381271.3,540523903.713600,1769434182.313600,4767,1143,5483,11393
2019-08-12,NYSE (N),797139744,44129681,34495712,875765137,31546553070,2499409383,1606562253.153200,35652524706.153200,2691966,106738,226778,3025482
2019-08-12,NYSE Arca (P),150790067,254125374,136040481,540955922,5469807139,14476579058,6585157966.373599,26531544163.373599,1334116,703555,1291089,3328760
2019-08-12,NASDAQ (Q),433420766,195848052,589486984,1218755802,17268673438.2125,12566129661.0440,30444932400.539687,60279735499.796187,4138517,893773,4227495,9259785
2019-08-12,IEX (V),129677049,19854215,67487470,217018734,5293021881,1092028935,3467974652.275000,9853025468.275000,921412,87000,518663,1527075
2019-08-12,NASDAQ PSX (X),17456966,20792005,13095719,51344690,513212864.0894,1651979372.5982,854118528.131100,3019310764.818700,119969,89133,113450,322552
2019-08-12,BYX Equities (Y),134485066,60943943,56968131,252397140,3447605469.74,2802117504.26,2164902010.333100,8414624984.333100,1272590,309752,644955,2227297
2019-08-12,BZX Equities (Z),182072746,91464622,119563209,393100577,7247685767.58,6526220984.57,6283793427.522999,20057700179.672999,1608057,405459,1057550,3071066
2019-08-09,NYSE American (A),6116241,19059633,3278456,28454330,254954379.055000,215379672.818800,167632387.530400,637966439.404200,70536,49841,41471,161848
2019-08-09,NASDAQ BX (B),52045429,24190553,29728185,105964167,1899278087.241100,1297800725.261700,1472325828.709000,4669404641.211800,531757,100144,313583,945484
2019-08-09,NYSE National (C),53173871,28135026,20486138,101795035,1013579148.495800,938701865.507300,545227326.510500,2497508340.513600,440245,114307,205069,759621
2019-08-09,FINRA / Nasdaq TRF Chicago (DB),2678983,1088423,4324499,8091905,102456009.695400,67824243.490000,249219728.698400,419499981.883800,12022,4488,19712,36222
2019-08-09,FINRA / NYSE TRF (DN),207655577,89326886,232721855,529704318,5303446869.218799,3005930916.287201,8564618254.121502,16873996039.627502,471572,172490,540107,1184169
2019-08-09,FINRA / Nasdaq TRF Carteret (DQ),930724056,328758730,671535193,1931017979,33383630718.426399,19742493836.038295,27569039063.324795,80695163617.789489,3471716,759111,2400171,6630998
2019-08-09,EDGA Equities (J),79638178,27553656,40478801,147670635,2921544071.000000,1597426574.405500,1804271818.257700,6323242463.663200,989881,153921,525041,1668843
2019-08-09,EDGX Equities (K),153231768,94246310,133162758,380640836,4848463670.729501,5535279640.681000,5878811615.872698,16262554927.283199,1243630,410760,977534,2631924
2019-08-09,NYSE Chicago (M),9683501,23249428,7297315,40230244,567232813.350000,1567425303.448800,809962968.236900,2944621085.035700,5091,1143,6149,12383
2019-08-09,NYSE (N),775619362,45094772,35598856,856312990,29933772476.997000,2685379156.712300,1795026243.955200,34414177877.664500,2863772,117431,237759,3218962
2019-08-09,NYSE Arca (P),153236465,249701644,146876028,549814137,5729885287.515900,15028501553.160199,7418319970.265202,28176706810.941301,1329787,789550,1358708,3478045
2019-08-09,NASDAQ (Q),447596103,212378196,622567833,1282542132,18135741801.172093,13833367915.695293,32191546589.717391,64160656306.584777,4243264,980990,4585839,9810093
2019-08-09,IEX (V),129625199,18282060,69139170,217046429,5105206676.042300,1142815819.801400,3387929528.321200,9635952024.164900,921994,88069,521332,1531395
2019-08-09,NASDAQ PSX (X),17306570,21267427,13637439,52211436,532313588.183200,1628349553.809600,973026681.528600,3133689823.521400,117658,91993,122009,331660
2019-08-09,BYX Equities (Y),143846934,66590707,59240642,269678283,3801072391.432900,3158255609.388201,2309562662.362900,9268890663.184001,1414667,343182,679948,2437797
2019-08-09,BZX Equities (Z),194678918,106606138,131108552,432393608,7993524604.034701,8106483561.393702,7485222130.012300,23585230295.440703,1692957,468679,1167483,3329119
2019-08-08,NYSE American (A),6996205,21399372,4143610,32539187,291268764.660700,322055360.585800,223596029.364800,836920154.611300,78846,61523,50107,190476
2019-08-08,NASDAQ BX (B),62396961,30638409,33596931,126632301,2349038957.401700,1558913729.143100,1713528251.939900,5621480938.484700,620219,128615,348630,1097464
2019-08-08,NYSE National (C),60698069,34035488,21301620,116035177,1173783095.687100,1169036814.175200,617124250.474200,2959944160.336500,475347,134487,207993,817827
2019-08-08,FINRA / Nasdaq TRF Chicago (DB),2384781,1181513,3544443,7110737,99561184.359000,68091241.957700,250043825.542100,417696251.858800,12264,4183,19797,36244
2019-08-08,FINRA / NYSE TRF (DN),225576220,100804169,223018473,549398862,5980371494.282999,3271140393.851698,9719051028.219900,18970562916.354597,523701,194321,570189,1288211
2019-08-08,FINRA / Nasdaq TRF Carteret (DQ),1190187597,441592627,733311043,2365091267,44149618986.277705,25549327786.810090,34489915763.918805,104188862537.006600,4030337,966376,2704631,7701344
2019-08-08,EDGA Equities (J),91349182,33195066,47489885,172034133,3516726769.565900,1770430634.502500,2368211258.565900,7655368662.634300,1106740,186692,593453,1886885
2019-08-08,EDGX Equities (K),174519145,107781249,139399880,421700274,5770371614.868599,5708741312.330602,7149425373.445798,18628538300.644999,1421851,451121,1087376,2960348
2019-08-08,NYSE Chicago (M),15849785,25864407,7693719,49407911,711303962.774900,1410867058.570800,1225975697.096200,3348146718.441900,5660,1122,5536,12318
2019-08-08,NYSE (N),1027527075,48426978,38336871,1114290924,43671434052.747495,2800708963.161500,1949010217.430600,48421153233.339595,3043726,122547,259325,3425598
2019-08-08,NYSE Arca (P),183555277,289373358,163654819,636583454,7045288580.963301,16902154788.223192,9045402615.166207,32992845984.352700,1526102,815172,1552386,3893660
2019-08-08,NASDAQ (Q),518082242,239417238,722224165,1479723645,21621050804.664296,14883730346.929212,40266674708.102392,76771455859.695900,4809597,1013113,4974190,10796900
2019-08-08,IEX (V),154217417,25403774,79989835,259611026,6088735863.015000,1422756641.533600,4241793000.061702,11753285504.610302,1068110,108581,608892,1785583
2019-08-08,NASDAQ PSX (X),19062483,26420056,14844602,60327141,594138141.262800,1772820854.301900,961565004.158200,3328523999.722900,132257,100495,126816,359568
2019-08-08,BYX Equities (Y),160598371,79278158,65033677,304910206,4287984514.785700,3835882719.707800,2743461785.187000,10867329019.680500,1510226,400191,738677,2649094
2019-08-08,BZX Equities (Z),225531725,116520952,145370420,487423097,9369711628.186098,8082991793.324503,8512750935.555199,25965454357.065800,1899651,479564,1307498,3686713
2019-08-07,NYSE American (A),8126690,19828296,3838300,31793286,356515090.423500,369677913.943900,247487395.907500,973680400.274900,92644,72692,49129,214465
2019-08-07,NASDAQ BX (B),67771492,43374386,36155401,147301279,2521141295.986600,2250096417.848000,2037299587.598400,6808537301.433000,654855,179083,375449,1209387
2019-08-07,NYSE National (C),69588874,39973654,23000827,132563355,1284361851.058300,1365935732.476100,697547886.369200,3347845469.903600,532106,167002,223247,922355
2019-08-07,FINRA / Nasdaq TRF Chicago (DB),925690,535593,1114182,2575465,51518064.991900,36514216.660000,96957079.448500,184989361.100400,5539,1767,7167,14473
2019-08-07,FINRA / NYSE TRF (DN),267591016,125443134,230401223,623435373,6873913818.989604,4173006630.245400,9213481533.946196,20260401983.181200,571218,231419,514536,1317173
2019-08-07,FINRA / Nasdaq TRF Carteret (DQ),1286369952,537980921,744622246,2568973119,45552454695.800892,33899087992.712695,35914518260.996593,115366060949.510180,4594682,1175069,2598698,8368449
2019-08-07,EDGA Equities (J),102904954,47683760,49614718,200203432,3573584649.576100,2513116471.140200,2462563000.085100,8549264120.801400,1183738,246476,591789,2022003
2019-08-07,EDGX Equities (K),202424585,146535018,144911643,493871246,6667279735.974702,8863209499.487496,7638005551.975005,23168494787.437203,1671800,685040,1133674,3490514
2019-08-07,NYSE Chicago (M),11316073,13740175,5948779,31005027,523699758.775300,904178705.483200,622801567.781700,2050680032.040200,6609,1543,7662,15814
2019-08-07,NYSE (N),1009037032,76753192,44081721,1129871945,39428899953.612596,4196905987.066801,2446124317.863001,46071930258.542398,3719951,186846,289695,4196492
2019-08-07,NYSE Arca (P),216319567,413376759,171577999,801274325,8294589571.151900,23716858081.658997,10349477668.027293,42360925320.838190,1838040,1245640,1614927,4698607
2019-08-07,NASDAQ (Q),611908611,335956731,690312692,1638178034,24455881604.559306,20986654037.155105,39646666698.908601,85089202340.623012,5707168,1492515,5337473,12537156
2019-08-07,IEX (V),169608135,28462293,73253276,271323704,6623393143.714299,1748884096.452600,4156684453.094200,12528961693.261099,1128234,127427,568054,1823715
2019-08-07,NASDAQ PSX (X),22074190,36446168,15885325,74405683,705878120.075100,2629661825.481799,1154283746.450100,4489823692.006999,158073,156599,145276,459948
2019-08-07,BYX Equities (Y),189543430,107279233,71229595,368052258,4704626177.850400,5118848422.962000,3068148607.293000,12891623208.105400,1743845,536209,792290,3072344
2019-08-07,BZX Equities (Z),277214107,186471376,164227247,627912730,11125026842.925102,14111524803.782201,9750931180.322605,34987482827.029908,2318489,814626,1453817,4586932
2019-08-06,NYSE American (A),7563469,15922324,3336933,26822726,328665701.589100,276610057.502200,187361722.870700,792637481.962000,86761,61826,44375,192962
2019-08-06,NASDAQ BX (B),67433163,32197455,32793978,132424596,2501552576.640500,1833149870.255500,1725530345.116100,6060232792.012100,662624,142881,346843,1152348
2019-08-06,NYSE National (C),57778478,35857709,21738938,115375125,1127254319.230300,1235111982.915700,613017682.203600,2975383984.349600,458376,131878,209182,799436
2019-08-06,FINRA / Nasdaq TRF Chicago (DB),1378322,665146,1339016,3382484,57834970.273100,27361937.169200,128864313.328000,214061220.770300,8322,2523,11812,22657
2019-08-06,FINRA / NYSE TRF (DN),259762678,108083010,194758242,562603930,7038599179.666597,4058109319.079400,9400376033.266698,20497084532.012695,588226,219571,526986,1334783
2019-08-06,FINRA / Nasdaq TRF Carteret (DQ),1189876480,478051292,676817233,2344745005,43534541508.080205,30747887788.794990,34936476858.492794,109218906155.367989,4513079,1153718,2618339,8285136
2019-08-06,EDGA Equities (J),97327706,33576960,43520001,174424667,3515624401.857000,1953826783.648900,2112137082.609600,7581588268.115500,1138404,197581,531634,1867619
2019-08-06,EDGX Equities (K),188196625,108173129,129361743,425731497,6356623153.693098,6923265715.369901,6701062674.649496,19980951543.712495,1593455,546653,1013588,3153696
2019-08-06,NYSE Chicago (M),10883800,11959860,4988229,27831889,578148692.688600,741021942.565600,675132719.412900,1994303354.667100,6427,1204,6156,13787
2019-08-06,NYSE (N),923516652,52761626,38648207,1014926485,37136701901.703498,3386654944.345599,1969473287.794000,42492830133.843097,3295156,144284,254536,3693976
2019-08-06,NYSE Arca (P),197351753,327224547,153252371,677828671,7908352767.822802,21324290687.308011,9240735601.276999,38473379056.407812,1723473,1017030,1516086,4256589
2019-08-06,NASDAQ (Q),557497722,248609232,628284004,1434390958,23473012448.594205,16918515479.317198,36939801173.150303,77331329101.061706,5314678,1154530,4816527,11285735
2019-08-06,IEX (V),156438869,27033103,72573641,256045613,6408679206.524600,1737958706.967800,3966711799.073200,12113349712.565600,1099181,115262,556824,1771267
2019-08-06,NASDAQ PSX (X),20733992,25315382,13509793,59559167,660948160.222000,2112681732.837099,968423071.069700,3742052964.128799,142825,112104,113570,368499
2019-08-06,BYX Equities (Y),169654905,84934933,62742321,317332159,4548819189.240500,4391983627.125600,2599057605.073400,11539860421.439500,1625514,458789,708226,2792529
2019-08-06,BZX Equities (Z),251247321,133260258,139961215,524468794,10430813257.217700,10397312482.549497,8535541638.449401,29363667378.216598,2134712,608088,1266775,4009575
2019-08-05,NYSE American (A),8127047,22106172,4693682,34926901,380187394.646600,402427532.108500,348668703.008300,1131283629.763400,97595,78104,57151,232850
2019-08-05,NASDAQ BX (B),66435533,46453586,41928134,154817253,2651623680.873400,2550484755.890099,2327211971.341100,7529320408.104599,655319,185489,405638,1246446
2019-08-05,NYSE National (C),64755359,49567422,25313728,139636509,1323706238.471900,1653581557.385800,739229227.316400,3716517023.174100,511242,177580,238042,926864
2019-08-05,FINRA / Nasdaq TRF Chicago (DB),1504178,1092499,1655059,4251736,67806610.538900,49118804.730000,167284021.798000,284209437.066900,10157,3578,15257,28992
2019-08-05,FINRA / NYSE TRF (DN),272648382,136469630,226042642,635160654,8129977708.296395,5227042993.231798,11397712542.124704,24754733243.652897,680794,314387,665293,1660474
2019-08-05,FINRA / Nasdaq TRF Carteret (DQ),1228390848,626658740,760452622,2615502210,47247854992.677989,38861252039.152007,41718293496.281394,127827400528.111390,5019149,1662341,3124405,9805895
2019-08-05,EDGA Equities (J),101728131,49804135,53022864,204555130,3929753710.723700,2964532941.106300,2721025066.949200,9615311718.779200,1203372,274802,645155,2123329
2019-08-05,EDGX Equities (K),211046588,161150904,154864637,527062129,7410067624.614199,10776115517.865603,8981008572.955493,27167191715.435295,1794151,735219,1282022,3811392
2019-08-05,NYSE Chicago (M),8644299,10933987,5566070,25144356,444775880.053600,1177569277.029700,551817439.636400,2174162596.719700,7478,1254,7212,15944
2019-08-05,NYSE (N),1098308017,76823905,50765668,1225897590,46318222852.342701,5227800198.692302,2681547251.528800,54227570302.563803,3989398,202511,326868,4518777
2019-08-05,NYSE Arca (P),213233964,482689067,187951170,883874201,8622744796.355999,30908455667.095614,11967419876.486504,51498620339.938117,1898119,1400641,1882633,5181393
2019-08-05,NASDAQ (Q),636519986,360941233,793520686,1790981905,28049579863.130506,25804699591.107389,49501344103.259096,103355623557.496991,6221039,1584996,6025957,13831992
2019-08-05,IEX (V),161339986,32798216,80595689,274733891,7137285508.008400,2172686927.877800,4883415153.968801,14193387589.855001,1165729,154581,639858,1960168
2019-08-05,NASDAQ PSX (X),23075254,39295872,21379459,83750585,756512922.541500,3636890348.493502,1713654818.968099,6107058090.003101,161571,173529,181755,516855
2019-08-05,BYX Equities (Y),185187740,115007367,83198370,383393477,5118992631.335399,6221941708.740701,3695902897.049300,15036837237.125400,1778355,606570,906788,3291713
2019-08-05,BZX Equities (Z),261905359,176163665,170833169,608902193,11767966327.732298,13569136143.393602,11188933794.305797,36526036265.431697,2324995,760168,1594746,4679909
2019-08-02,NYSE American (A),7385343,15772027,4112054,27269424,359544582.393600,267088390.493600,289676825.925500,916309798.812700,86349,61412,50145,197906
2019-08-02,NASDAQ BX (B),68916821,36528920,36265413,141711154,2835621533.947000,2098618217.255000,1981956374.632100,6916196125.834100,671869,152536,358749,1183154
2019-08-02,NYSE National (C),40450929,23880697,17117354,81448980,983074003.526400,919660690.936300,570127180.385300,2472861874.848000,353869,107447,177823,639139
2019-08-02,FINRA / Nasdaq TRF Chicago (DB),1279065,821624,1630864,3731553,61779865.488000,35805536.886400,147724630.986900,245310033.361300,9028,2912,13063,25003
2019-08-02,FINRA / NYSE TRF (DN),238099997,101212223,208834358,548146578,7135287691.264204,3582748146.524103,9035327385.079004,19753363222.867311,582246,214567,545629,1342442
2019-08-02,FINRA / Nasdaq TRF Carteret (DQ),1041436705,476088081,648413133,2165937919,41169457939.839395,30537849373.879597,34272927118.345493,105980234432.064485,4340784,1301105,2608775,8250664
2019-08-02,EDGA Equities (J),88209166,34838431,43271452,166319049,3464747777.014800,2057182002.127600,2179217547.749200,7701147326.891600,1054341,212420,541491,1808252
2019-08-02,EDGX Equities (K),190227284,123841612,133207197,447276093,6794560244.572100,7993447808.968203,7330894611.649198,22118902665.189501,1590570,582001,1063100,3235671
2019-08-02,NYSE Chicago (M),9393511,9109251,11224279,29727041,515259215.813100,854544113.261600,982200264.130300,2352003593.205000,5956,1134,6124,13214
2019-08-02,NYSE (N),881148807,61157698,42081591,984388096,35907484742.642496,3909683103.343399,2337890104.126801,42155057950.112696,3429883,164718,273123,3867724
2019-08-02,NYSE Arca (P),190284668,333372788,156751106,680408562,7857674197.387700,20806844968.070194,9743495074.927397,38408014240.385291,1637910,1075327,1533710,4246947
2019-08-02,NASDAQ (Q),563388964,275104450,654144114,1492637528,25099540266.498504,19197439134.160496,38933787885.407482,83230767286.066482,5274421,1239385,5114063,11627869
2019-08-02,IEX (V),144056716,27007194,71669518,242733428,6620587924.993899,1671452296.098300,4250762168.057399,12542802389.149598,1054507,125702,567862,1748071
2019-08-02,NASDAQ PSX (X),21733714,27621954,15885473,65241141,699000420.290200,2223774978.144999,1227397740.265700,4150173138.700899,144380,126059,130857,401296
2019-08-02,BYX Equities (Y),170485404,88961173,70810211,330256788,4784694607.677600,4973004687.766600,3110031294.023100,12867730589.467300,1605747,486543,775426,2867716
2019-08-02,BZX Equities (Z),226318175,131379195,147141859,504839229,10473809766.430699,10248129348.591999,10116637857.171498,30838576972.194196,1969131,590474,1309473,3869078
2019-08-01,NYSE American (A),9213781,20292472,5226292,34732545,401044708.116700,344944023.467500,307413947.675000,1053402679.259200,100684,76358,61893,238935
2019-08-01,NASDAQ BX (B),77835713,52518743,43257519,173611975,3030377323.127200,2652341413.280400,2427008667.841700,8109727404.249300,733200,204533,409571,1347304
2019-08-01,NYSE National (C),40667877,27651307,17520054,85839238,1041795588.520100,1059683641.128100,668666567.755100,2770145797.403300,352150,128926,182837,663913
2019-08-01,FINRA / Nasdaq TRF Chicago (DB),1555140,830691,1758060,4143891,82194393.762000,37395015.595000,164653066.875800,284242476.232800,9749,2954,13394,26097
2019-08-01,FINRA / NYSE TRF (DN),281578145,120842905,262366295,664787345,8149151741.622297,4188851657.720398,12001752777.134998,24339756176.477693,645457,237023,640959,1523439
2019-08-01,FINRA / Nasdaq TRF Carteret (DQ),1312634080,574972930,823580456,2711187466,51281686044.644910,33278111561.679401,41850496727.993299,126410294334.317610,5043518,1258756,3033606,9335880
2019-08-01,EDGA Equities (J),116175963,55104251,54454772,225734986,4315549824.988800,3228394779.767000,2764592932.229700,10308537536.985500,1296228,315351,645203,2256782
2019-08-01,EDGX Equities (K),232642664,180306990,168239279,581188933,8213482527.706702,11314828294.847392,9074054705.365898,28602365527.919992,1877800,851192,1295630,4024622
2019-08-01,NYSE Chicago (M),15001408,8152841,5282576,28436825,822167925.389000,941302339.394100,623996857.200500,2387467121.983600,7567,1424,8765,17756
2019-08-01,NYSE (N),1051265846,79515085,48672287,1179453218,43587689119.654106,4901573195.222701,2890615387.627701,51379877702.504508,3981645,205413,327438,4514496
2019-08-01,NYSE Arca (P),232456898,503855415,201205703,937518016,9854468361.647000,29771156103.006300,12687393379.312896,52313017843.966196,1956646,1518825,1835836,5311307
2019-08-01,NASDAQ (Q),708197035,396085556,804462207,1908744798,31170610837.096002,26380360122.241901,47859962697.671283,105410933657.009186,6398580,1765680,6180347,14344607
2019-08-01,IEX (V),177973703,32292204,87325284,297591191,8005319382.355801,2248585017.749600,5067765772.093101,15321670172.198502,1258461,148972,689333,2096766
2019-08-01,NASDAQ PSX (X),30524088,44660681,20624116,95808885,957068202.621900,3355828489.919001,1524063016.941800,5836959709.482701,188924,187356,174056,550336
2019-08-01,BYX Equities (Y),207906858,121673446,85394562,414974866,5528351342.846700,6332794951.577298,3743202018.312198,15604348312.736196,1873106,648363,909281,3430750
2019-08-01,BZX Equities (Z),298183882,215644422,186053911,699882215,13136870920.027699,16679604062.968001,12209524205.335297,42025999188.330997,2461896,919192,1629082,5010170
2019-07-31,NYSE American (A),7450780,20613339,4419717,32483836,333027090.711500,331980120.832500,260010180.034800,925017391.578800,85651,63043,49602,198296
2019-07-31,NASDAQ BX (B),70385163,41424795,37502978,149312936,2774875097.890400,2121229740.496100,2162610819.535700,7058715657.922200,666103,154560,373590,1194253
2019-07-31,NYSE National (C),37135486,17915634,16656857,71707977,938882414.037200,724851869.719400,576277258.318300,2240011542.074900,309522,87163,162946,559631
2019-07-31,FINRA / Nasdaq TRF Chicago (DB),1471293,746032,1886830,4104155,62667979.488400,35846301.660000,169170534.138000,267684815.286400,8170,2938,13526,24634
2019-07-31,FINRA / NYSE TRF (DN),254402022,101709198,258105940,614217160,6989847319.303302,3479093391.333499,11107613157.828697,21576553868.465498,536281,199636,599303,1335220
2019-07-31,FINRA / Nasdaq TRF Carteret (DQ),1206206207,417283902,758559061,2382049170,48878920109.341104,25314667696.417492,39400353261.521015,113593941067.279611,4271274,983802,2709138,7964214
2019-07-31,EDGA Equities (J),128062571,50194478,58863271,237120320,4305776746.225500,2772963073.930400,2672339571.271301,9751079391.427201,1338828,266229,667583,2272640
2019-07-31,EDGX Equities (K),211025317,118329294,158822066,488176677,7114805280.457299,7371317567.242298,8093031464.866099,22579154312.565696,1666417,560973,1168588,3395978
2019-07-31,NYSE Chicago (M),7507972,8872992,5683092,22064056,394414424.847700,957255655.984400,521610440.292800,1873280521.124900,6431,1314,6349,14094
2019-07-31,NYSE (N),1250792977,56098439,41647516,1348538932,53881436580.518698,3515271691.198400,2326454444.048700,59723162715.765798,3665130,147776,268798,4081704
2019-07-31,NYSE Arca (P),210479686,373401579,181772103,765653368,8588952733.581001,22572304102.345297,11232442031.798600,42393698867.724898,1670069,1049428,1596530,4316027
2019-07-31,NASDAQ (Q),620981256,297547639,823166435,1741695330,27221514497.920798,20399334361.050103,47379058674.520308,94999907533.491209,5682536,1360158,5635687,12678381
2019-07-31,IEX (V),151757442,24279661,76924105,252961208,6803663058.040799,1859672610.350000,4737380364.876301,13400716033.267100,1072245,113557,600060,1785862
2019-07-31,NASDAQ PSX (X),26394234,31364749,17151947,74910930,824505153.057400,2124805094.686900,1195283169.756900,4144593417.501200,168505,130919,142717,442141
2019-07-31,BYX Equities (Y),181130727,86860079,76120000,344110806,4828919815.678300,4701140035.288500,3339815343.236200,12869875194.203000,1638737,485650,815727,2940114
2019-07-31,BZX Equities (Z),261148621,153275529,161954001,576378151,10967112845.398700,12124149669.456601,10091909252.717402,33183171767.572703,2202281,673911,1424664,4300856
2019-07-30,NYSE American (A),6227318,14850205,2899181,23976704,260773585.956800,204962661.120200,181540192.702000,647276439.779000,69837,47570,34090,151497
2019-07-30,NASDAQ BX (B),59595640,24072646,25554923,109223209,2255959976.851400,1197151263.868600,1410050779.472200,4863162020.192200,564639,91884,268909,925432
2019-07-30,NYSE National (C),30217956,10803807,12486170,53507933,739372295.659500,390726850.448600,405680990.148800,1535780136.256900,257294,50230,125824,433348
2019-07-30,FINRA / Nasdaq TRF Chicago (DB),4562376,1363998,3610711,9537085,156843877.172300,75960423.511300,233610975.349800,466415276.033400,16473,5010,17260,38743
2019-07-30,FINRA / NYSE TRF (DN),221773854,71234899,197777419,490786172,6058653113.854799,2213155663.170200,7749774231.875798,16021583008.900797,500177,145141,475514,1120832
2019-07-30,FINRA / Nasdaq TRF Carteret (DQ),1062543584,301645195,553663916,1917852695,39796848050.727696,16677875493.604103,27205731452.067889,83680454996.399688,3879986,734429,2118628,6733043
2019-07-30,EDGA Equities (J),108513826,27674581,43735035,179923442,3743909962.935800,1489915589.995000,1939074058.184000,7172899611.114800,1180674,151220,536149,1868043
2019-07-30,EDGX Equities (K),162568915,67586065,115018269,345173249,5579185925.330198,3797715491.494500,6002062267.816801,15378963684.641499,1317015,281958,834056,2433029
2019-07-30,NYSE Chicago (M),8182930,11464126,5442813,25089869,431512796.715800,1241687452.717700,507657526.146800,2180857775.580300,4271,634,4503,9408
2019-07-30,NYSE (N),773569229,30064398,29463342,833096969,31425324468.805102,1766980280.892600,1435239631.657400,34627544381.355102,2728999,70918,176295,2976212
2019-07-30,NYSE Arca (P),181089333,192850693,130890186,504830212,7679694571.008802,11331754475.941100,7721208712.627494,26732657759.577396,1554611,568833,1249124,3372568
2019-07-30,NASDAQ (Q),512721415,149388860,542817559,1204927834,22237822054.285599,9173717408.241699,30633103019.480783,62044642482.008081,4533941,629607,4006407,9169955
2019-07-30,IEX (V),129105322,16380462,56917724,202403508,5709978487.784800,1094816604.857100,3250042285.582599,10054837378.224499,916785,74280,455658,1446723
2019-07-30,NASDAQ PSX (X),22865183,16130230,11581523,50576936,572801074.530600,1191348006.268700,684335165.478600,2448484246.277900,130654,64153,89395,284202
2019-07-30,BYX Equities (Y),145428042,52751582,53313602,251493226,3970259530.611600,2627719504.346200,2102884060.073000,8700863095.030800,1364869,284732,611388,2260989
2019-07-30,BZX Equities (Z),203807901,72957319,108444040,385209260,8592351239.035198,5106169886.234802,6261326931.229899,19959848056.499899,1705689,318108,950494,2974291
2019-07-29,NYSE American (A),5207711,12826552,2994214,21028477,249356871.364000,193871225.508800,185154947.311700,628383044.184500,59947,44055,35539,139541
2019-07-29,NASDAQ BX (B),49752887,22519627,25504281,97776795,1982167460.902400,1009129873.944000,1421444717.553300,4412742052.399700,489691,86333,270210,846234
2019-07-29,NYSE National (C),25177068,9434008,11342287,45953363,627577565.304300,323865582.516100,397593505.219800,1349036653.040200,215306,41998,113646,370950
2019-07-29,FINRA / Nasdaq TRF Chicago (DB),3603762,1266636,4296119,9166517,129367445.804100,49758254.918100,296289930.937500,475415631.659700,13149,4512,21176,38837
2019-07-29,FINRA / NYSE TRF (DN),188303529,63450548,178871761,430625838,5551977366.488702,1966376140.752200,9029847950.224000,16548201457.464902,483631,145829,526185,1155645
2019-07-29,FINRA / Nasdaq TRF Carteret (DQ),977382308,328232221,593371576,1898986105,39815857702.160298,16637797613.553197,33221704383.384699,89675359699.098194,3479703,662308,2201510,6343521
2019-07-29,EDGA Equities (J),91829980,23080265,41633553,156543798,3366481107.986500,1175657864.675200,1907245333.984100,6449384306.645800,1058671,131513,514420,1704604
2019-07-29,EDGX Equities (K),142426571,57109403,105164161,304700135,5206611264.952501,3163361597.898701,6172719106.457501,14542691969.308703,1228367,247144,865455,2340966
2019-07-29,NYSE Chicago (M),5971720,5170151,6378575,17520446,401736268.168800,625778283.870700,693395316.037800,1720909868.077300,4463,558,6079,11100
2019-07-29,NYSE (N),743399083,26449808,29101912,798950803,29894609489.382794,1507733717.768000,1411050224.212400,32813393431.363194,2465171,66130,175152,2706453
2019-07-29,NYSE Arca (P),140372207,176664992,120422320,437459519,5720851636.055701,9829125674.811603,7460918515.424102,23010895826.291406,1200545,461903,1203250,2865698
2019-07-29,NASDAQ (Q),431363174,125623078,543497243,1100483495,19933837016.846105,7472634147.729304,33935701029.545913,61342172194.121322,4059026,531196,4009264,8599486
2019-07-29,IEX (V),108200776,14248201,55473328,177922305,4888702620.877900,890223173.857700,3355832607.424500,9134758402.160100,808502,68522,444603,1321627
2019-07-29,NASDAQ PSX (X),18466117,14447201,11382293,44295611,505613780.283000,1020155391.432001,747425374.811100,2273194546.526101,112397,56832,88211,257440
2019-07-29,BYX Equities (Y),123248438,43475091,48573606,215297135,3418128905.621000,2184967558.135800,2001056626.516200,7604153090.273000,1210074,232314,567177,2009565
2019-07-29,BZX Equities (Z),169785093,64809498,104973219,339567810,7532484857.627602,4354111046.906997,6675347530.421495,18561943434.956094,1500979,279472,969928,2750379
2019-07-26,NYSE American (A),5419660,12783050,2920583,21123293,231860314.108000,174797198.921900,201341868.802500,607999381.832400,60193,44269,33302,137764
2019-07-26,NASDAQ BX (B),54200377,19489592,25317332,99007301,2066439950.123500,1013048372.914800,1704591710.153600,4784080033.191900,511795,75945,276797,864537
2019-07-26,NYSE National (C),26418663,8863357,12326984,47609004,681214178.753000,351810567.232000,468385161.665900,1501409907.650900,231679,39362,121866,392907
2019-07-26,FINRA / Nasdaq TRF Chicago (DB),4115264,1181620,4065992,9362876,137920211.436100,56712459.966400,298642202.973600,493274874.376100,14417,4503,21445,40365
2019-07-26,FINRA / NYSE TRF (DN),203583228,63256034,210038188,476877450,5802863193.225002,2066071905.796201,9237528957.026000,17106464056.047203,484940,134905,526637,1146482
2019-07-26,FINRA / Nasdaq TRF Carteret (DQ),930793967,245990228,595264447,1772048642,38497500686.171695,14909993377.463897,34047589184.527515,87455083248.163107,3479805,594462,2247959,6322226
2019-07-26,EDGA Equities (J),95359137,21024512,44629040,161012689,3411649315.196700,1168636153.028800,2182737160.143900,6763022628.369400,1060822,126372,537874,1725068
2019-07-26,EDGX Equities (K),146917848,53032797,110175205,310125850,5173537793.741201,3096992031.699901,6519456886.145002,14789986711.586104,1184389,234079,823199,2241667
2019-07-26,NYSE Chicago (M),7960957,6685118,9495335,24141410,357019835.595800,731182550.667200,708041642.561000,1796244028.824000,3931,620,5588,10139
2019-07-26,NYSE (N),736170883,23886815,29112140,789169838,30989125864.304303,1395610045.950400,1615864070.042600,34000599980.297303,2390779,58716,183552,2633047
2019-07-26,NYSE Arca (P),158052262,160946754,124695129,443694145,6403155141.859699,10003191950.855602,8493340836.463400,24899687929.178701,1259415,456746,1207516,2923677
2019-07-26,NASDAQ (Q),441401725,121898758,571558961,1134859444,20103687436.494898,7737271784.351796,39367326935.824106,67208286156.670800,3931497,524666,4018219,8474382
2019-07-26,IEX (V),114333346,12373305,57003191,183709842,5437220109.570900,845616245.892100,3927798413.607700,10210634769.070700,840374,61864,462246,1364484
2019-07-26,NASDAQ PSX (X),19747525,13314384,11349780,44411689,540807726.628100,950959716.746600,848645327.046800,2340412770.421500,125125,52804,95398,273327
2019-07-26,BYX Equities (Y),134114495,40544580,53482712,228141787,3893992676.576300,2239139330.762500,2438463499.529200,8571595506.868000,1280832,231108,610115,2122055
2019-07-26,BZX Equities (Z),181582607,61206513,113677372,356466492,8080287120.632098,4167339032.904099,8140191069.902504,20387817223.438701,1529327,270665,1004613,2804605
2019-07-25,NYSE American (A),6478333,13450072,3481101,23409506,308430914.314500,239829937.193800,219993746.150400,768254597.658700,71685,49643,38163,159491
2019-07-25,NASDAQ BX (B),63383696,27740802,29132789,120257287,2603830991.177700,1277439200.966300,1772284751.668900,5653554943.812900,601826,109162,310760,1021748
2019-07-25,NYSE National (C),29113645,10755703,12368234,52237582,747631407.061000,397010752.494100,462514100.672100,1607156260.227200,248190,50189,130202,428581
2019-07-25,FINRA / Nasdaq TRF Chicago (DB),4584872,1637565,3867185,10089622,150089981.418900,92479573.449300,305088540.245400,547658095.113600,15667,5844,20870,42381
2019-07-25,FINRA / NYSE TRF (DN),228415189,70432413,218643159,517490761,6528878665.220600,2402468124.771100,9815269965.173900,18746616755.165600,505783,146881,519063,1171727
2019-07-25,FINRA / Nasdaq TRF Carteret (DQ),994634107,290783025,609426732,1894843864,38265365693.268696,16360215343.870102,30962613103.500408,85588194140.639206,3707773,714079,2259693,6681545
2019-07-25,EDGA Equities (J),104854749,28430292,45383994,178669035,3854413287.299300,1510719612.519499,2223624593.764600,7588757493.583399,1139401,157880,552511,1849792
2019-07-25,EDGX Equities (K),169933546,71259257,118999252,360192055,5960465561.193501,4108042282.171902,7587546429.641600,17656054273.007003,1326079,319825,895066,2540970
2019-07-25,NYSE Chicago (M),9737137,9124620,6946976,25808733,500897104.928000,748979830.525000,608242998.950800,1858119934.403800,4979,805,5030,10814
2019-07-25,NYSE (N),843514611,33220400,30385863,907120874,34381272152.738503,1970358673.609700,1605352145.452300,37956982971.800503,2787507,82309,199179,3068995
2019-07-25,NYSE Arca (P),178961570,232128078,139273393,550363041,7259431388.248997,13801811531.225798,9595737360.227101,30656980279.701896,1449963,647645,1345403,3443011
2019-07-25,NASDAQ (Q),508568661,166554621,588490311,1263613593,23158607190.584403,10366237266.164697,37424529503.051871,70949373959.800971,4508798,734596,4391147,9634541
2019-07-25,IEX (V),125837080,16359599,58756666,200953345,5515956046.936601,1072160466.951100,3780414420.683500,10368530934.571201,882399,76925,452299,1411623
2019-07-25,NASDAQ PSX (X),24509328,17733915,13029618,55272861,714518733.861600,1298156138.885000,904627686.404900,2917302559.151500,148405,68010,112301,328716
2019-07-25,BYX Equities (Y),151211219,56604470,57323169,265138858,4302081799.872700,2863247185.265599,2480047606.376900,9645376591.515199,1431563,318000,660425,2409988
2019-07-25,BZX Equities (Z),213321782,83563724,122583893,419469399,9554491577.244500,5735623315.869399,7754644594.505698,23044759487.619597,1762751,368832,1075202,3206785
2019-07-24,NYSE American (A),5826941,12281028,3064859,21172828,264506476.626400,166686461.225200,183144764.017400,614337701.869000,65807,41311,36368,143486
2019-07-24,NASDAQ BX (B),56448715,21577107,27701604,105727426,2453157437.757000,990809818.531000,1591553152.528100,5035520408.816100,576898,82559,305820,965277
2019-07-24,NYSE National (C),27395112,8418973,13119209,48933294,736619374.707700,307529683.016100,429150608.215600,1473299665.939400,244968,40438,133332,418738
2019-07-24,FINRA / Nasdaq TRF Chicago (DB),4030056,1520535,3806671,9357262,152381540.526700,77681794.490400,244036790.595300,474100125.612400,15687,5629,18626,39942
2019-07-24,FINRA / NYSE TRF (DN),221270533,72754959,187355072,481380564,6417047164.969501,2257577822.207200,8473231114.263703,17147856101.440404,512427,153060,486085,1151572
2019-07-24,FINRA / Nasdaq TRF Carteret (DQ),1000227401,293863347,596459635,1890550383,41676864762.680090,17450730011.983899,30904216828.812005,90031811603.475994,3678690,646331,2208220,6533241
2019-07-24,EDGA Equities (J),98889116,22617255,46693185,168199556,3726957772.435900,1197666746.073500,2289022212.122000,7213646730.631400,1141599,135931,581509,1859039
2019-07-24,EDGX Equities (K),159311677,60764505,112944060,333020242,6080567275.418898,3618227557.976199,6391671492.963096,16090466326.358193,1318784,273122,873873,2465779
2019-07-24,NYSE Chicago (M),10516418,13446997,6449283,30412698,609611245.975900,1018583168.149600,820572784.046800,2448767198.172300,4415,575,4890,9880
2019-07-24,NYSE (N),777481298,28018561,28347272,833847131,33892929616.518599,1683523352.206000,1474254011.835800,37050706980.560399,2720173,69297,191063,2980533
2019-07-24,NYSE Arca (P),155398361,180631801,125401646,461431808,6828398700.366602,10552043844.294894,7882068890.214702,25262511434.876198,1340951,520513,1280332,3141796
2019-07-24,NASDAQ (Q),457215953,137313525,564534816,1159064294,22099149661.496099,8642562072.149006,33949509891.377810,64691221625.022915,4277597,600468,4281915,9159980
2019-07-24,IEX (V),112508185,14380424,56831112,183719721,5451705274.341800,999233938.841900,3357179219.546901,9808118432.730601,819991,68697,437217,1325905
2019-07-24,NASDAQ PSX (X),20277061,14955358,10897215,46129634,624444602.147500,1075882815.566500,764982952.969200,2465310370.683200,130223,59221,94882,284326
2019-07-24,BYX Equities (Y),136084472,44702223,57392674,238179369,4199385817.963700,2173327183.987400,2350555790.515800,8723268792.466900,1389178,249374,681402,2319954
2019-07-24,BZX Equities (Z),190341216,70292337,112678347,373311900,8887172860.812300,4910599542.191199,6750145051.323099,20547917454.326598,1669098,310141,1049126,3028365
2019-07-23,NYSE American (A),5158730,12643457,2822104,20624291,243407355.757000,166269299.442000,140682932.849500,550359588.048500,61382,43876,32572,137830
2019-07-23,NASDAQ BX (B),51386703,20439491,24986876,96813070,2141916893.658600,922612694.726800,1315956097.208600,4380485685.594000,528607,79186,259892,867685
2019-07-23,NYSE National (C),26586895,9322324,11572927,47482146,704616370.701700,345601412.801500,374315625.321600,1424533408.824800,244675,44812,119179,408666
2019-07-23,FINRA / Nasdaq TRF Chicago (DB),4108175,1330339,3716862,9155376,143585381.096100,68253836.150400,219788939.077400,431628156.323900,14996,5095,17596,37687
2019-07-23,FINRA / NYSE TRF (DN),212514217,70395997,186770219,469680433,6352116585.532199,2429562693.160999,7774075991.725800,16555755270.418998,487484,151309,459798,1098591
2019-07-23,FINRA / Nasdaq TRF Carteret (DQ),1017306069,293102599,585723452,1896132120,40717691641.386695,15649466114.097300,29000564060.296515,85367721815.780510,3517607,678065,2062313,6257985
2019-07-23,EDGA Equities (J),88438462,22337837,40067869,150844168,3272989605.668500,1101486163.793900,1698288151.507200,6072763920.969600,1030203,130479,485410,1646092
2019-07-23,EDGX Equities (K),158361762,59435005,107564591,325361358,5713059220.089101,3420628433.571202,5343789578.500199,14477477232.160502,1307843,260952,816031,2384826
2019-07-23,NYSE Chicago (M),12064429,11721343,6537431,30323203,565149527.600900,967702753.477600,679499199.084300,2212351480.162800,4232,766,5553,10551
2019-07-23,NYSE (N),702621892,27245652,27352655,757220199,29420674380.926400,1582823646.128500,1308382167.183300,32311880194.238200,2555630,68324,178726,2802680
2019-07-23,NYSE Arca (P),159995937,190541482,119420872,469958291,6614175873.429100,10992241176.216599,6493831763.030202,24100248812.675901,1367210,523069,1155450,3045729
2019-07-23,NASDAQ (Q),451355716,135901712,506980080,1094237508,20837386629.223400,8498075200.630196,28282027903.990191,57617489733.843787,4114628,589942,3764088,8468658
2019-07-23,IEX (V),107074406,13265787,53696824,174037017,4967795857.785500,877220164.367400,2752979223.865100,8597995246.018000,777727,63657,404495,1245879
2019-07-23,NASDAQ PSX (X),19354797,14909427,9970372,44234596,580486849.644600,1058887744.802500,644784892.329800,2284159486.776900,118092,56236,83294,257622
2019-07-23,BYX Equities (Y),137451433,51277142,53348724,242077299,4083664709.047900,2426893054.513600,2104150583.286400,8614708346.847900,1378910,274542,642499,2295951
2019-07-23,BZX Equities (Z),180035867,70519218,104521629,355076714,8091761842.488300,4710492061.563400,5836936178.948897,18639190083.000597,1578869,308434,938496,2825799
2019-07-22,NYSE American (A),4843306,13343551,2670110,20856967,203400878.710600,169381411.473800,155626981.897400,528409272.081800,59676,41109,30721,131506
2019-07-22,NASDAQ BX (B),49485303,18832622,25370269,93688194,2008732923.276600,803656898.262300,1405869545.893500,4218259367.432400,514105,72975,271090,858170
2019-07-22,NYSE National (C),24826462,8740630,11647802,45214894,629694484.223900,310076427.280700,383977176.189200,1323748087.693800,233594,41461,121865,396920
2019-07-22,FINRA / Nasdaq TRF Chicago (DB),3538021,1370818,3860751,8769590,120798155.420300,71971221.522300,252182998.821100,444952375.763700,13772,4862,18350,36984
2019-07-22,FINRA / NYSE TRF (DN),192255647,66490174,207158499,465904320,5256856251.436803,2212198944.664800,8437126470.519800,15906181666.621403,468097,147940,484311,1100348
2019-07-22,FINRA / Nasdaq TRF Carteret (DQ),886733753,288459513,564771724,1739964990,34680046199.309296,15620589844.591597,27787889043.133804,78088525087.034697,3220834,646451,1999701,5866986
2019-07-22,EDGA Equities (J),85277182,21707364,39572377,146556923,3174569700.324500,1021448366.269100,1767984144.578900,5964002211.172500,1066781,124851,524463,1716095
2019-07-22,EDGX Equities (K),134142840,54167636,112525652,300836128,4697504479.170299,2986717831.293400,5225200808.502901,12909423118.966600,1161168,239282,787092,2187542
2019-07-22,NYSE Chicago (M),7240704,7831701,7438890,22511295,398141773.152400,727660706.479400,782949967.878000,1908752447.509800,3410,787,4117,8314
2019-07-22,NYSE (N),717102230,22759952,26885477,766747659,29395298758.250803,1331101126.743500,1318140638.913700,32044540523.908003,2499343,62288,177646,2739277
2019-07-22,NYSE Arca (P),133651709,169933921,125121886,428707516,5472890683.120100,9616310199.034598,6307911253.659301,21397112135.813999,1176457,490427,1141871,2808755
2019-07-22,NASDAQ (Q),388400059,129478749,519465527,1037344335,17632547205.867902,7500903866.288998,28798998264.165302,53932449336.322202,3759613,551908,3708067,8019588
2019-07-22,IEX (V),92368658,13149780,48235203,153753641,4076649916.856899,761482059.380000,2762744260.331100,7600876236.567999,702059,61549,380436,1144044
2019-07-22,NASDAQ PSX (X),16676340,13000763,9843186,39520289,473947418.686000,926941826.062300,601475960.898900,2002365205.647200,105818,54986,81594,242398
2019-07-22,BYX Equities (Y),125520539,46301339,54527469,226349347,3754243855.376000,2134571680.750400,2189411332.679000,8078226868.805400,1342114,250944,659617,2252675
2019-07-22,BZX Equities (Z),154141018,61191252,101346169,316678439,6839551952.492799,4004157492.246801,5564828015.884202,16408537460.623802,1398314,273150,901007,2572471
2019-07-19,NYSE American (A),6936192,14536040,3576274,25048506,324064374.772400,249727046.046700,216469993.901200,790261414.720300,80904,56948,40615,178467
2019-07-19,NASDAQ BX (B),54918485,28238030,27371036,110527551,2172650788.738400,1257516493.178800,1459603536.137600,4889770818.054800,559943,108461,294912,963316
2019-07-19,NYSE National (C),27222676,12221775,12876051,52320502,735502801.247600,458711209.347800,444381293.961800,1638595304.557200,246488,55986,128150,430624
2019-07-19,FINRA / Nasdaq TRF Chicago (DB),3582580,1733787,3889334,9205701,131600517.367000,101863005.268500,237407140.300000,470870662.935500,13402,6773,17891,38066
2019-07-19,FINRA / NYSE TRF (DN),198350126,81736335,174621701,454708162,5399545420.186902,2670185052.884100,7823066653.727998,15892797126.799000,447172,163398,431149,1041719
2019-07-19,FINRA / Nasdaq TRF Carteret (DQ),916777011,336980399,562088339,1815845749,36560298480.659503,21277505106.904994,29376440853.250406,87214244440.814903,3310452,712872,2026501,6049825
2019-07-19,EDGA Equities (J),95163849,30540193,41981947,167685989,3557906097.877900,1541017532.934700,1994543917.175800,7093467547.988400,1138501,169380,554568,1862449
2019-07-19,EDGX Equities (K),139500879,73625576,106953574,320080029,5234984524.514201,4378647403.170402,5500950810.342600,15114582738.027203,1233133,311352,832754,2377239
2019-07-19,NYSE Chicago (M),9799533,21187813,13465704,44453050,481486231.644900,1858793908.910000,1951802966.067000,4292083106.621900,4194,721,4302,9217
2019-07-19,NYSE (N),802409435,34670161,30106481,867186077,34899537240.944896,2020504253.687400,1611035284.067500,38531076778.699796,2622435,82952,218060,2923447
2019-07-19,NYSE Arca (P),144659903,227883974,121540471,494084348,6296088358.240299,13079491232.871999,6926381015.980305,26301960607.092603,1287035,621710,1188438,3097183
2019-07-19,NASDAQ (Q),443426277,173734752,559951311,1177112340,19989531572.623696,10728267589.896099,34400202863.496669,65118002026.016464,4081097,727277,3950017,8758391
2019-07-19,IEX (V),102637248,14483012,52889364,170009624,4493721257.525100,948417456.220400,3000525174.193600,8442663887.939100,753929,74928,396533,1225390
2019-07-19,NASDAQ PSX (X),20623061,18968785,12071423,51663269,661374729.709500,1352804552.104200,849344355.548200,2863523637.361900,139107,71544,103799,314450
2019-07-19,BYX Equities (Y),142664908,63563280,59787927,266016115,4386850923.813600,3034175442.229400,2591437875.671200,10012464241.714200,1523365,317901,732924,2574190
2019-07-19,BZX Equities (Z),177220803,87205023,109879952,374305778,8237177697.456702,6059631028.603901,7046201839.079003,21343010565.139606,1610366,357789,1043107,3011262
2019-07-18,NYSE American (A),6715218,17292765,3640697,27648680,268359006.477600,284782324.501100,198395961.706200,751537292.684900,77004,61280,39559,177843
2019-07-18,NASDAQ BX (B),55827961,27648283,29089685,112565929,2140070252.557500,1193481823.681400,1502955375.143500,4836507451.382400,532490,104592,285390,922472
2019-07-18,NYSE National (C),27341586,11942911,12622035,51906532,677636426.865700,418671580.924400,384232784.218500,1480540792.008600,228759,51467,117626,397852
2019-07-18,FINRA / Nasdaq TRF Chicago (DB),6067966,3426670,6719460,16214096,208095665.924000,156985154.674000,397460977.711100,762541798.309100,20656,11432,28803,60891
2019-07-18,FINRA / NYSE TRF (DN),204885356,95201425,198754014,498840795,5765358999.246801,2993356855.065999,8887748685.072101,17646464539.384901,472185,179530,489516,1141231
2019-07-18,FINRA / Nasdaq TRF Carteret (DQ),1022109235,416314996,677604759,2116028990,40051883727.374810,21267012439.270906,33525853682.104000,94844749848.749716,3496369,790177,2203418,6489964
2019-07-18,EDGA Equities (J),96243025,31813786,47946354,176003165,3538206748.935800,1517235589.568100,2126234934.134800,7181677272.638700,1093912,169857,567088,1830857
2019-07-18,EDGX Equities (K),148623146,83149377,126617862,358390385,5439690212.879301,4380169000.071700,6286706461.113097,16106565674.064098,1285272,321348,909514,2516134
2019-07-18,NYSE Chicago (M),10126579,14370325,6902512,31399416,465055067.132100,1142183446.804900,707756790.642300,2314995304.579300,4648,801,4214,9663
2019-07-18,NYSE (N),734276894,37160100,32922611,804359605,29624938600.456597,2043706439.576300,1654930259.425900,33323575299.458797,2502391,82524,202045,2786960
2019-07-18,NYSE Arca (P),152444430,250649632,139241980,542336042,6261183454.507799,12802204768.424498,7780359943.620999,26843748166.553296,1287682,640566,1272207,3200455
2019-07-18,NASDAQ (Q),447666818,185459268,537245224,1170371310,20036164957.626606,10424904922.429403,31515451763.439503,61976521643.495512,4064175,726638,3871691,8662504
2019-07-18,IEX (V),106724822,18861291,54955125,180541238,4874349501.170000,1217619026.374400,3123241036.741600,9215209564.286000,760017,83216,411918,1255151
2019-07-18,NASDAQ PSX (X),21085353,18964170,13572123,53621646,614214525.174000,1233496530.510900,781762230.176600,2629473285.861500,131656,69665,101353,302674
2019-07-18,BYX Equities (Y),146767130,69783936,61340515,277891581,4472916378.874400,3119450733.468699,2522827119.052500,10115194231.395599,1481311,338375,708850,2528536
2019-07-18,BZX Equities (Z),182921219,91292824,114619328,388833371,8051591952.022900,5627567106.338600,6866818075.659497,20545977134.020997,1568849,376426,1030715,2975990
2019-07-17,NYSE American (A),6302829,14377692,3838603,24519124,253621148.267500,181248907.498000,188616082.808000,623486138.573500,75071,53343,42155,170569
2019-07-17,NASDAQ BX (B),57213583,24947260,27413292,109574135,2206060410.172800,1069318887.653200,1382635638.976400,4658014936.802400,563682,100653,288579,952914
2019-07-17,NYSE National (C),26978552,10284753,12636920,49900225,673968915.965400,352187623.484800,382228095.042800,1408384634.493000,232829,47458,115649,395936
2019-07-17,FINRA / Nasdaq TRF Chicago (DB),4900904,2200241,4377689,11478834,154877825.116800,91773287.345900,248610215.025500,495261327.488200,15875,7491,18711,42077
2019-07-17,FINRA / NYSE TRF (DN),204448906,84419070,186286518,475154494,5694585631.339198,2414785663.037100,7212182551.291700,15321553845.667998,460168,171222,440434,1071824
2019-07-17,FINRA / Nasdaq TRF Carteret (DQ),921644030,345488895,575018773,1842151698,35283912866.746201,17029336339.222296,26285813959.803598,78599063165.772095,3460332,716681,2069197,6246210
2019-07-17,EDGA Equities (J),92993982,26311700,46050143,165355825,3514895945.637200,1220138083.165200,1966176635.560900,6701210664.363300,1088548,152134,548752,1789434
2019-07-17,EDGX Equities (K),140106788,68446984,113120140,321673912,5111890880.841301,3484123802.955900,5221834903.816200,13817849587.613401,1185481,276780,814951,2277212
2019-07-17,NYSE Chicago (M),6341628,9865187,9915684,26122499,461090310.934500,692816973.901700,820731678.125100,1974638962.961300,3923,652,3490,8065
2019-07-17,NYSE (N),702185212,29771562,28491602,760448376,28989083625.550706,1692584873.774000,1348259418.304900,32029927917.629606,2435343,70722,188038,2694103
2019-07-17,NYSE Arca (P),144932483,203463526,125515580,473911589,6022187605.112400,10808981428.323905,6703743147.829599,23534912181.265904,1242920,535745,1216911,2995576
2019-07-17,NASDAQ (Q),434002836,153544401,522652220,1110199457,19868494448.297911,8602776756.559001,28098338257.868494,56569609462.725406,4012954,620965,3700714,8334633
2019-07-17,IEX (V),106119674,15719761,57413854,179253289,4823008341.889200,940900951.259100,2957681146.613400,8721590439.761700,782895,80868,435266,1299029
2019-07-17,NASDAQ PSX (X),20349071,15740230,11007056,47096357,586427462.802600,1003441443.116900,654299294.694400,2244168200.613900,128083,60679,88742,277504
2019-07-17,BYX Equities (Y),144656795,55760261,60433616,260850672,4490747398.150300,2519835872.353500,2339523572.357500,9350106842.861300,1460079,285362,693460,2438901
2019-07-17,BZX Equities (Z),172479282,73062103,102958004,348499389,7788757392.554900,4564281808.157099,5503338572.628798,17856377773.340797,1556854,315436,954753,2827043
2019-07-16,NYSE American (A),5768015,12127606,3205605,21101226,234156443.539700,193838296.980400,155668774.671600,583663515.191700,63949,47715,35314,146978
2019-07-16,NASDAQ BX (B),56236525,26462402,26644997,109343924,2153069841.112400,1124042444.425400,1389611678.473800,4666723964.011600,548346,94889,283899,927134
2019-07-16,NYSE National (C),27064736,12312548,11932852,51310136,666357088.794500,405001483.178600,367548593.115100,1438907165.088200,245336,49040,125279,419655
2019-07-16,FINRA / Nasdaq TRF Chicago (DB),3672393,1770615,4059966,9502974,138388871.720400,73499489.230200,254588204.618100,466476565.568700,13280,5527,18116,36923
2019-07-16,FINRA / NYSE TRF (DN),217083340,72369318,223371150,512823808,5864372322.285699,2303026787.860099,7994780350.243499,16162179460.389297,492773,160513,476781,1130067
2019-07-16,FINRA / Nasdaq TRF Carteret (DQ),1010520681,309477701,610276086,1930274468,36945178617.565813,16641559115.258300,27120351637.706093,80707089370.530206,3486407,738567,2055961,6280935
2019-07-16,EDGA Equities (J),96925169,28451978,44497133,169874280,3699259940.559700,1347703021.873200,2057941091.393900,7104904053.826800,1148573,150160,583409,1882142
2019-07-16,EDGX Equities (K),149290978,64661971,123825534,337778483,5339276981.379399,3381187898.565800,5357245355.752999,14077710235.698198,1254736,252434,848458,2355628
2019-07-16,NYSE Chicago (M),21268497,13401903,7956391,42626791,431068298.546800,1147532098.132800,662318916.980300,2240919313.659900,4554,597,4570,9721
2019-07-16,NYSE (N),679568256,29259819,29144849,737972924,28078015711.668397,1684501125.790100,1452411630.560600,31214928468.019097,2499970,72943,195648,2768561
2019-07-16,NYSE Arca (P),151758357,181662708,122247461,455668526,6218977633.373301,10080828968.718101,6282379457.825601,22582186059.917003,1309878,524940,1174885,3009703
2019-07-16,NASDAQ (Q),435168587,142859852,505057393,1083085832,19761669031.034796,8209723113.334201,26751792591.820796,54723184736.189793,4091006,585408,3775039,8451453
2019-07-16,IEX (V),111811677,18832060,55199566,185843303,4906636388.936400,1196429704.913500,3097633619.953400,9200699713.803300,833920,88991,451748,1374659
2019-07-16,NASDAQ PSX (X),19140092,15146678,11508257,45795027,529145197.567100,916857088.714000,704104004.606200,2150106290.887300,116065,58400,94555,269020
2019-07-16,BYX Equities (Y),140288675,61469989,58642310,260400974,4262461082.211100,2743391511.319999,2317745380.269600,9323597973.800699,1487066,294630,711648,2493344
2019-07-16,BZX Equities (Z),171469821,70838862,109448439,351757122,7691344151.778099,4464202210.623000,5680322389.753502,17835868752.154601,1582397,299122,980848,2862367
2019-07-15,NYSE American (A),4739743,14787759,2474777,22002279,211408065.160000,143878431.753300,127631849.053700,482918345.967000,56127,43996,27850,127973
2019-07-15,NASDAQ BX (B),46030064,16921794,22236033,85187891,1783454425.836800,731823423.971900,1165651411.354200,3680929261.162900,454669,71994,238762,765425
2019-07-15,NYSE National (C),22946814,6891219,10329351,40167384,575717806.796100,247337688.300400,325432395.868900,1148487890.965400,206031,36354,105381,347766
2019-07-15,FINRA / Nasdaq TRF Chicago (DB),3445266,1275747,3818425,8539438,118870342.261400,53900570.538900,236040845.893200,408811758.693500,12784,4561,17299,34644
2019-07-15,FINRA / NYSE TRF (DN),176610240,64491128,203868598,444969966,5066266822.812899,2098647388.554700,7358551824.926098,14523466036.293697,445992,165170,466740,1077902
2019-07-15,FINRA / Nasdaq TRF Carteret (DQ),853118910,258722592,551862664,1663704166,33886471102.202102,14465336006.969395,25646226264.508706,73998033373.680203,3101586,636814,1913615,5652015
2019-07-15,EDGA Equities (J),84103144,19196976,38065925,141366045,3277696029.308400,1003136479.300800,1756482346.251700,6037314854.860900,985896,119709,490081,1595686
2019-07-15,EDGX Equities (K),126721246,50932870,111866360,289520476,4743433872.592301,2703969553.528102,4833608393.047298,12281011819.167701,1055155,220316,741874,2017345
2019-07-15,NYSE Chicago (M),6197332,6270902,5081145,17549379,287088190.141000,468215734.785000,523269186.196600,1278573111.122600,5042,557,4326,9925
2019-07-15,NYSE (N),677607864,21675371,24592000,723875235,29655367725.948401,1203122802.758900,1193528903.730800,32052019432.438101,2198701,55508,162077,2416286
2019-07-15,NYSE Arca (P),124340039,142474627,114504841,381319507,5161174355.255401,8382934947.313904,5772615499.523498,19316724802.092803,1076015,435282,1098326,2609623
2019-07-15,NASDAQ (Q),373518665,110188602,497748624,981455891,17201135451.128996,6517715952.742397,27059073526.265601,50777924930.136994,3572218,491935,3343004,7407157
2019-07-15,IEX (V),86513516,11874000,47883500,146271016,3928283706.416200,732334977.499000,2474956167.972500,7135574851.887700,670092,61931,368635,1100658
2019-07-15,NASDAQ PSX (X),17232907,10842770,9813395,37889072,548134970.473700,729906658.518500,635971369.142400,1914012998.134600,112064,46721,82375,241160
2019-07-15,BYX Equities (Y),122898285,42909477,51263216,217070978,3780330548.473200,2049112709.248400,2059559332.263900,7889002589.985500,1259573,234651,606016,2100240
2019-07-15,BZX Equities (Z),150082418,56148050,95367840,301598308,6730603802.862102,3696441667.100700,5145523870.677200,15572569340.640002,1343195,252324,858107,2453626
2019-07-12,NYSE American (A),5211606,19048911,2855379,27115896,234904313.905000,200738833.027700,158960041.683600,594603188.616300,60304,59202,33206,152712
2019-07-12,NASDAQ BX (B),53736121,18059708,27617625,99413454,2233678168.074200,888104565.817600,1589523311.307400,4711306045.199200,554858,84730,305480,945068
2019-07-12,NYSE National (C),25216971,8967292,11421382,45605645,645959175.902100,332327489.215100,390747341.533400,1369034006.650600,224947,47015,118424,390386
2019-07-12,FINRA / Nasdaq TRF Chicago (DB),4568408,1825039,3760266,10153713,153089736.678400,55233621.481400,218750847.024400,427074205.184200,15947,5895,17307,39149
2019-07-12,FINRA / NYSE TRF (DN),195218577,74635134,192787101,462640812,6071599976.396000,2314787542.012501,7469287546.684605,15855675065.093106,511708,178983,456811,1147502
2019-07-12,FINRA / Nasdaq TRF Carteret (DQ),886675196,287870648,553351404,1727897248,35635786591.637897,15364424445.762296,26714902532.469602,77715113569.869795,3343241,716326,1983354,6042921
2019-07-12,EDGA Equities (J),79084085,22109854,36076049,137269988,2942632823.712301,1143091338.539000,1567650954.418400,5653375116.669701,927209,136093,441511,1504813
2019-07-12,EDGX Equities (K),130968729,59448156,112095477,302512362,5051641599.166899,3301180183.956501,5135195239.362000,13488017022.485400,1132978,252581,774568,2160127
2019-07-12,NYSE Chicago (M),6045557,10827467,8707100,25580124,257150247.134000,965114668.676000,821884749.318800,2044149665.128800,4697,789,4053,9539
2019-07-12,NYSE (N),670945945,31378530,27310901,729635376,29323504562.215403,1725867082.661900,1386477432.789900,32435849077.667203,2420290,88506,177211,2686007
2019-07-12,NYSE Arca (P),133400899,155026787,116153656,404581342,5708966260.079400,9271378895.490795,6219842221.808102,21200187377.378297,1155674,501756,1124746,2782176
2019-07-12,NASDAQ (Q),393293030,128121376,531079764,1052494170,18542337594.116797,8031474432.690799,30783711058.686826,57357523085.494422,3781954,554729,3586654,7923337
2019-07-12,IEX (V),101115191,13584226,50759449,165458866,4664587744.779100,861932506.477600,2890736258.642000,8417256509.898700,732797,70561,391224,1194582
2019-07-12,NASDAQ PSX (X),17071771,12636128,10975598,40683497,563290787.591300,923111593.528600,738842354.172100,2225244735.292000,111595,56577,93767,261939
2019-07-12,BYX Equities (Y),125137337,46510608,53523183,225171128,4037187513.378400,2322485359.317100,2310458922.105300,8670131794.800800,1315170,272575,631964,2219709
2019-07-12,BZX Equities (Z),156459809,61551544,97490957,315502310,7497682104.406303,4338145895.314999,5870043905.077200,17705871904.798502,1449240,288331,914144,2651715
2019-07-11,NYSE American (A),5938249,13627060,3334993,22900302,246123001.198300,217389671.658400,169941135.731100,633453808.587800,67818,50567,37115,155500
2019-07-11,NASDAQ BX (B),60414368,23874831,29403212,113692411,2489577287.119900,1133056596.530100,1539458552.394600,5162092436.044600,609961,102965,314908,1027834
2019-07-11,NYSE National (C),26827328,11277049,12500187,50604564,711898574.564400,467120340.687700,409943282.995700,1588962198.247800,242374,55761,127891,426026
2019-07-11,FINRA / Nasdaq TRF Chicago (DB),4164486,1549437,4414863,10128786,142604051.696300,76733040.349000,283038631.792100,502375723.837400,14649,5797,19668,40114
2019-07-11,FINRA / NYSE TRF (DN),200563715,72641417,236132829,509337961,6307655976.083902,2608184661.075200,8707284123.616904,17623124760.776006,475773,168204,493548,1137525
2019-07-11,FINRA / Nasdaq TRF Carteret (DQ),959330335,317505688,603940629,1880776652,38295267398.340599,18693120971.572194,28421752101.966598,85410140471.879391,3420387,705851,2084126,6210364
2019-07-11,EDGA Equities (J),84373797,24589586,39247797,148211180,2913319257.202600,1253763364.714700,1795525973.010500,5962608594.927800,944401,141503,459618,1545522
2019-07-11,EDGX Equities (K),138059314,62111204,125153928,325324446,5109933367.282800,3546319916.556300,5518163218.383003,14174416502.222103,1151927,276187,835872,2263986
2019-07-11,NYSE Chicago (M),9401098,5002592,4039676,18443366,360223063.481700,319964677.310000,386402338.018900,1066590078.810600,4147,789,4127,9063
2019-07-11,NYSE (N),684456137,36669285,29763011,750888433,28522711105.123800,2069270665.009500,1448432042.368400,32040413812.501700,2294608,98221,189562,2582391
2019-07-11,NYSE Arca (P),138548892,206957370,129542515,475048777,6075834822.168601,12047752354.271102,6837562689.671099,24961149866.110802,1201894,572172,1181843,2955909
2019-07-11,NASDAQ (Q),406815375,147296170,521323103,1075434648,18875675619.408901,9226071886.614601,29235546441.731200,57337293947.754702,3761697,625083,3549536,7936316
2019-07-11,IEX (V),116878424,14981801,53356678,185216903,5358665165.073800,971263468.847600,3097588799.352700,9427517433.274100,826838,72531,420168,1319537
2019-07-11,NASDAQ PSX (X),17976871,16084234,11598295,45659400,573117425.148800,1128856189.099500,858958139.380000,2560931753.628300,117772,67331,99814,284917
2019-07-11,BYX Equities (Y),136509228,55203783,60350424,252063435,4399746703.313100,2667439935.150201,2469941346.747100,9537127985.210401,1429522,302601,677369,2409492
2019-07-11,BZX Equities (Z),165461018,70951052,106595145,343007215,7649900755.951299,5022046702.141900,6407613551.075498,19079561009.168697,1463145,331456,934423,2729024
2019-07-10,NYSE American (A),6672693,15433233,3750785,25856711,273288626.210000,239861963.990200,214609246.592400,727759836.792600,86208,60915,47250,194373
2019-07-10,NASDAQ BX (B),55795243,24696650,29295406,109787299,2092521221.836800,1209411165.508400,1598088959.477700,4900021346.822900,584082,108069,326439,1018590
2019-07-10,NYSE National (C),27935239,12215394,12898192,53048825,701338252.873800,460821243.211200,442460079.067200,1604619575.152200,262940,57512,137884,458336
2019-07-10,FINRA / Nasdaq TRF Chicago (DB),4138239,1952778,4428903,10519920,127376840.182300,108835619.842100,302128888.312800,538341348.337200,14116,6858,20858,41832
2019-07-10,FINRA / NYSE TRF (DN),204751990,85646969,221848158,512247117,5456598447.199001,2863493417.805801,8528895828.115491,16848987693.120293,458847,188043,504532,1151422
2019-07-10,FINRA / Nasdaq TRF Carteret (DQ),939519243,363881711,656535808,1959936762,34690136126.115702,20843110727.325803,30367519498.326114,85900766351.767619,3309053,756280,2143436,6208769
2019-07-10,EDGA Equities (J),87909870,29135702,41768975,158814547,2965906528.805300,1455841339.598700,1879051490.366000,6300799358.770000,1039147,163044,514600,1716791
2019-07-10,EDGX Equities (K),144542749,73266035,126534703,344343487,4654324032.196899,3951172503.435398,5979921003.568402,14585417539.200699,1159493,301655,870831,2331979
2019-07-10,NYSE Chicago (M),7795855,6155856,8639181,22590892,338121034.060000,518300240.186800,541060469.201400,1397481743.448200,5064,920,5098,11082
2019-07-10,NYSE (N),701090132,40328599,32666008,774084739,27527140002.437403,2089118817.393799,1632626895.875700,31248885715.706902,2414478,109486,205605,2729569
2019-07-10,NYSE Arca (P),141333320,231114611,136512812,508960743,5634651406.330000,13202663968.790902,7551664940.216703,26388980315.337605,1241652,632331,1293604,3167587
2019-07-10,NASDAQ (Q),412102908,169924715,549081200,1131108823,17752478239.670704,10377178010.330197,31715591412.550504,59845247662.551405,3842051,703947,3861456,8407454
2019-07-10,IEX (V),99243010,14918281,55906323,170067614,4294696992.133900,998641464.329500,3297519646.554599,8590858103.017999,756633,73762,431766,1262161
2019-07-10,NASDAQ PSX (X),19487000,18892608,11573068,49952676,548616777.612100,1371913193.424200,815715487.289200,2736245458.325500,123432,72917,97866,294215
2019-07-10,BYX Equities (Y),141971105,61740851,66081961,269793917,4194161526.073600,2882519477.234101,2667801119.899700,9744482123.207401,1486859,332320,737827,2557006
2019-07-10,BZX Equities (Z),163520083,77845464,109120897,350486444,6757565346.877498,5238289007.162201,6884004179.822602,18879858533.862301,1446574,350425,981528,2778527
2019-07-09,NYSE American (A),5761046,17497716,3110927,26369689,252329229.743000,222581061.227400,174866634.440000,649776925.410400,67947,62009,37371,167327
2019-07-09,NASDAQ BX (B),54825212,17760066,27818652,100403930,2225815718.566900,902643368.414300,1459114197.426700,4587573284.407900,563808,88097,309517,961422
2019-07-09,NYSE National (C),27949206,9394800,14227871,51571877,732005064.238200,381787376.027900,428577867.467800,1542370307.733900,248352,49139,129479,426970
2019-07-09,FINRA / Nasdaq TRF Chicago (DB),3951869,1443265,3546313,8941447,112619868.811200,54403521.207000,212154506.731700,379177896.749900,12053,5242,15860,33155
2019-07-09,FINRA / NYSE TRF (DN),179044777,73788698,202395175,455228650,5109495585.806300,2146748339.439600,7423299061.250402,14679542986.496302,434152,193373,449722,1077247
2019-07-09,FINRA / Nasdaq TRF Carteret (DQ),948380746,296908565,602702807,1847992118,37196511728.795707,17293454264.442995,27945693364.705019,82435659357.943721,3331891,771545,1989621,6093057
2019-07-09,EDGA Equities (J),83454281,21730642,39807436,144992359,2944181334.818200,1087644411.152700,1790226408.891600,5822052154.862500,968500,127972,489682,1586154
2019-07-09,EDGX Equities (K),128383997,60131761,115658655,304174413,4699087242.149502,2998975259.548699,5214267958.684495,12912330460.382696,1105643,257318,777636,2140597
2019-07-09,NYSE Chicago (M),16052360,7745920,5736996,29535276,764610624.303700,797223999.696000,516577090.186000,2078411714.185700,5167,596,3985,9748
2019-07-09,NYSE (N),667554614,29356419,27801665,724712698,28238964392.702797,1609755176.398700,1226694529.546900,31075414098.648397,2237415,83933,170565,2491913
2019-07-09,NYSE Arca (P),138223983,174834925,115073693,428132601,5775951977.359299,9775669602.269505,6088035154.854002,21639656734.482806,1207107,506814,1118820,2832741
2019-07-09,NASDAQ (Q),383329381,129207584,496449825,1008986790,18115213941.184796,7457219417.532401,28704328618.627199,54276761977.344396,3669743,569293,3421389,7660425
2019-07-09,IEX (V),101467504,13363971,53209375,168040850,4519080232.121900,852207154.401500,3021230064.398200,8392517450.921600,777166,70503,419195,1266864
2019-07-09,NASDAQ PSX (X),16517482,12783660,11105866,40407008,517370593.476700,836346079.414400,722244848.400200,2075961521.291300,109096,54158,87879,251133
2019-07-09,BYX Equities (Y),129645952,44406461,58846030,232898443,4210885024.425200,2098927887.744700,2448796894.908100,8758609807.078000,1358856,260489,662266,2281611
2019-07-09,BZX Equities (Z),148796956,58414492,93939836,301151284,6560862037.820200,3983673253.326501,5734163072.206600,16278698363.353301,1350367,274034,876458,2500859
2019-07-08,NYSE American (A),5104852,13457782,2955954,21518588,222228983.025000,193321973.537700,152636240.311900,568187196.874600,59856,48714,33341,141911
2019-07-08,NASDAQ BX (B),49387439,18932739,26988335,95308513,1953059649.413800,903494151.899800,1350208102.199000,4206761903.512600,519174,78315,298850,896339
2019-07-08,NYSE National (C),26284898,9298179,13010969,48594046,689268296.674700,366119255.641100,376942938.559300,1432330490.875100,234572,46773,123370,404715
2019-07-08,FINRA / Nasdaq TRF Chicago (DB),3660546,1296060,3758181,8714787,117096988.813600,73385908.258500,207034650.308300,397517547.380400,11646,5019,16745,33410
2019-07-08,FINRA / NYSE TRF (DN),165139195,72341222,235867102,473347519,4453342627.199900,2408053955.369702,6850727636.936802,13712124219.506404,423579,173405,466582,1063566
2019-07-08,FINRA / Nasdaq TRF Carteret (DQ),847909196,281712880,602955783,1732577859,32072535795.491588,17037205059.483899,24079671257.694805,73189412112.670292,3094941,728868,1956773,5780582
2019-07-08,EDGA Equities (J),74891992,21948976,37754209,134595177,2764637084.462200,1117972361.030500,1500858060.044900,5383467505.537600,875627,116064,439155,1430846
2019-07-08,EDGX Equities (K),117193509,55398293,128019000,300610802,4196788002.077601,3000080464.036001,4819665911.020599,12016534377.134201,1036045,232702,767014,2035761
2019-07-08,NYSE Chicago (M),8918888,6756347,5082524,20757759,486031868.615000,618998581.830600,520742751.710800,1625773202.156400,4219,656,4309,9184
2019-07-08,NYSE (N),736979998,31677754,27082158,795739910,29899403208.751202,1619676170.609400,1235315709.256500,32754395088.617102,2182462,86284,177011,2445757
2019-07-08,NYSE Arca (P),122427791,187086087,118653905,428167783,5102921784.272900,10750890471.806304,5673187765.920397,21527000021.999601,1095844,478244,1103180,2677268
2019-07-08,NASDAQ (Q),369572102,127347325,543650496,1040569923,16520017785.775501,7618572927.449201,27337795614.450808,51476386327.675510,3520995,532421,3447430,7500846
2019-07-08,IEX (V),99762346,13749709,51168383,164680438,4631848117.658700,840641271.869000,2875932079.762900,8348421469.290600,727668,68574,402621,1198863
2019-07-08,NASDAQ PSX (X),23149241,12594763,10364324,46108328,538639212.018600,874037624.694900,640363138.985800,2053039975.699300,106315,48631,84978,239924
2019-07-08,BYX Equities (Y),124770733,47514194,57741965,230026892,4011718914.563700,2409012943.379000,2321060305.608300,8741792163.551000,1299837,261824,660991,2222652
2019-07-08,BZX Equities (Z),147212418,57497999,92116482,296826899,6446030656.757502,3946625918.662800,4934235947.345398,15326892522.765700,1314079,257280,835556,2406915
2019-07-05,NYSE American (A),4980905,14660927,2660820,22302652,191134485.386700,215092239.004100,129960539.622200,536187264.013000,54212,56334,29884,140430
2019-07-05,NASDAQ BX (B),45197293,26553297,23663888,95414478,1744364541.262300,1310215261.661500,1254040010.040700,4308619812.964500,454594,108321,260133,823048
2019-07-05,NYSE National (C),23892800,12841871,12894382,49629053,606450069.984500,514716051.803200,389584576.223700,1510750698.011400,211184,58153,116539,385876
2019-07-05,FINRA / Nasdaq TRF Chicago (DB),3087648,1680339,3591441,8359428,106054152.290300,87126792.142200,207245135.858000,400426080.290500,11004,6287,15675,32966
2019-07-05,FINRA / NYSE TRF (DN),144393945,72126255,203465365,419985565,3953889394.299602,2359543405.048799,6405907860.428401,12719340659.776802,352753,159160,405341,917254
2019-07-05,FINRA / Nasdaq TRF Carteret (DQ),682829106,293180739,509656529,1485666374,27591616610.934902,16271370861.371096,21631103652.351502,65494091124.657500,2637958,735178,1667646,5040782
2019-07-05,EDGA Equities (J),68742220,27309377,33511234,129562831,2339636638.277200,1398993564.013800,1420356539.117100,5158986741.408100,762411,147691,380477,1290579
2019-07-05,EDGX Equities (K),107461625,66943973,116617179,291022777,3749989970.212600,3925518881.056298,4475973226.800299,12151482078.069197,887454,280330,671728,1839512
2019-07-05,NYSE Chicago (M),5491450,7062927,3916167,16470544,231048670.703500,649101677.345000,473860184.537200,1354010532.585700,3427,806,3676,7909
2019-07-05,NYSE (N),578339591,38720536,25143728,642203855,23811041954.631002,1978304194.058300,1241511205.214200,27030857353.903502,1996615,105556,161662,2263833
2019-07-05,NYSE Arca (P),112733183,220254326,109847036,442834545,4645623325.554998,12870654149.132607,5652389367.080796,23168666841.768401,982663,592288,1004666,2579617
2019-07-05,NASDAQ (Q),325907107,150767194,461498101,938172402,14207467207.895893,9359184088.037199,25063660580.823496,48630311876.756588,2987257,649910,3079703,6716870
2019-07-05,IEX (V),71529372,15044478,38698840,125272690,3225175547.487900,874407273.427900,2125173376.268900,6224756197.184700,558631,75401,311272,945304
2019-07-05,NASDAQ PSX (X),15676385,16048726,9525111,41250222,481306555.930100,1106941475.169901,692784694.164700,2281032725.264701,103127,67819,88420,259366
2019-07-05,BYX Equities (Y),111049733,54813078,49310043,215172854,3463350626.416600,2750933802.681101,2117276221.639500,8331560650.737201,1124964,297607,560017,1982588
2019-07-05,BZX Equities (Z),133369940,73802250,86709264,293881454,5665914216.855599,5230680724.247699,5385078002.662098,16281672943.765396,1158604,322543,782545,2263692
2019-07-03,NYSE American (A),4056272,11111651,2526156,17694079,173535177.118200,135992297.782900,126947853.204600,436475328.105700,47481,35591,27082,110154
2019-07-03,NASDAQ BX (B),29796805,14578628,17151577,61527010,1068550051.781200,731489247.838700,904376212.407100,2704415512.027000,292459,58065,169299,519823
2019-07-03,NYSE National (C),16455774,8000740,8500259,32956773,417438378.961800,298720640.766300,241390617.154600,957549636.882700,148332,34446,76250,259028
2019-07-03,FINRA / Nasdaq TRF Chicago (DB),2742886,978740,2769301,6490927,84650466.560900,51501696.559000,169853821.441600,306005984.561500,9302,4207,12965,26474
2019-07-03,FINRA / NYSE TRF (DN),124788505,58793489,204652803,388234797,3351020659.175200,1711342706.933300,5179586696.034201,10241950062.142701,295686,119661,352780,768127
2019-07-03,FINRA / Nasdaq TRF Carteret (DQ),532050738,220689470,442963714,1195703922,21428270594.519303,13768987340.668299,17163099671.664401,52360357606.852003,2047676,487848,1291843,3827367
2019-07-03,EDGA Equities (J),57771583,17975108,35070176,110816867,2149266543.903100,1000629341.535800,1324739121.000700,4474635006.439600,665114,98696,348693,1112503
2019-07-03,EDGX Equities (K),81997048,47239568,107090596,236327212,3014742050.610700,2525183250.323700,3520021611.395298,9059946912.329698,685679,189892,539609,1415180
2019-07-03,NYSE Chicago (M),6941515,2709988,1785632,11437135,197003937.413300,225540524.770000,185525445.977500,608069908.160800,3476,511,3537,7524
2019-07-03,NYSE (N),506628266,25020451,20191046,551839763,22150871485.129498,1439008492.459500,993550568.938500,24583430546.527498,1556389,65947,140957,1763293
2019-07-03,NYSE Arca (P),92573943,141229178,118675225,352478346,3870530207.869200,8739600570.094200,4678240349.324400,17288371127.287800,813709,392597,836215,2042521
2019-07-03,NASDAQ (Q),245436643,97439406,432872970,775749019,11763139937.883501,6474359395.645800,22304613859.027800,40542113192.557101,2459838,414534,2452645,5327017
2019-07-03,IEX (V),67323910,10947238,33424387,111695535,2936558948.616800,786940626.939300,1867901162.612800,5591400738.168900,471265,50998,258129,780392
2019-07-03,NASDAQ PSX (X),11803956,10664774,7839260,30307990,409622959.671400,726305664.983700,539300555.190900,1675229179.846000,82055,40883,67116,190054
2019-07-03,BYX Equities (Y),80548068,34862421,40411628,155822117,2525119963.409700,1852144976.312900,1566157510.106500,5943422449.829100,827587,194988,414517,1437092
2019-07-03,BZX Equities (Z),102660373,48088247,72319983,223068603,4595973137.929000,3482546105.254201,4039049272.637200,12117568515.820401,929127,215634,620418,1765179
2019-07-02,NYSE American (A),6885560,15018877,3560578,25465015,294175636.025900,249589835.198400,178152334.866900,721917806.091200,78084,61367,41714,181165
2019-07-02,NASDAQ BX (B),67118552,30686741,30121961,127927254,2523038820.756500,1393596271.528800,1442547108.492700,5359182200.778000,678490,125364,326435,1130289
2019-07-02,NYSE National (C),32333234,15496920,15416016,63246170,844779437.609900,562336385.445600,453903771.801900,1861019594.857400,287190,67273,147673,502136
2019-07-02,FINRA / Nasdaq TRF Chicago (DB),3705100,1804092,3886013,9395205,110887029.565300,89561886.022100,211669655.844800,412118571.432200,12986,6169,17268,36423
2019-07-02,FINRA / NYSE TRF (DN),183317562,90760404,214709692,488787658,5201324262.450301,2993528721.495498,6791191848.502202,14986044832.448001,425590,184276,439391,1049257
2019-07-02,FINRA / Nasdaq TRF Carteret (DQ),954321299,409157457,594728326,1958207082,35568252787.295792,25420125910.659504,25715873229.458182,86704251927.413478,3583452,978743,2078389,6640584
2019-07-02,EDGA Equities (J),98490990,32365277,45971956,176828223,3688704870.440500,1609208419.273700,1918466152.300100,7216379442.014300,1160347,178246,574450,1913043
2019-07-02,EDGX Equities (K),130636716,74595072,113954003,319185791,4649661871.171601,4029290775.663400,4503156563.081999,13182109209.917000,1153145,310204,777053,2240402
2019-07-02,NYSE Chicago (M),9188462,14127300,12126508,35442270,383007440.831500,958491339.150000,1024695537.652300,2366194317.633800,5462,802,4299,10563
2019-07-02,NYSE (N),733362413,45193156,31395491,809951060,30450380623.514694,2392247530.750800,1529235813.472600,34371863967.738094,2611554,112514,204395,2928463
2019-07-02,NYSE Arca (P),146126050,258356300,138465079,542947429,6215593716.012701,14260495520.889003,6389486890.830701,26865576127.732405,1364894,655571,1300662,3321127
2019-07-02,NASDAQ (Q),433870565,189167573,526747528,1149785666,19877574742.586496,11493585523.906401,27393704241.835697,58764864508.328594,4202282,762591,3780148,8745021
2019-07-02,IEX (V),99967728,23548214,52185313,175701255,4410192829.967800,1457128655.568100,2791460488.879299,8658781974.415199,753116,100078,413932,1267126
2019-07-02,NASDAQ PSX (X),20525687,19884086,10679889,51089662,596046931.403300,1210818976.400900,654524189.425900,2461390097.230100,134539,76883,96450,307872
2019-07-02,BYX Equities (Y),136751259,68944634,61117664,266813557,4139988927.141900,3316772670.466701,2336014063.210500,9792775660.819101,1438514,351394,701519,2491427
2019-07-02,BZX Equities (Z),167897019,86402606,101531835,355831460,7324761641.756600,5988457246.063900,5610310226.142000,18923529113.962500,1559283,374525,971081,2904889
2019-07-01,NYSE American (A),7425153,16545251,4167152,28137556,343633985.544800,263357997.444000,209605073.785800,816597056.774600,87642,62202,48436,198280
2019-07-01,NASDAQ BX (B),72375918,32379025,36402956,141157899,2841851286.319600,1667432532.524200,1893845918.103500,6403129736.947300,709798,140179,378881,1228858
2019-07-01,NYSE National (C),34626866,17951729,17184080,69762675,934828294.982400,720318625.573400,563860700.655500,2219007621.211300,312728,77748,168493,558969
2019-07-01,FINRA / Nasdaq TRF Chicago (DB),4373623,1855536,4817245,11046404,143779838.720400,93419233.705700,303888702.980500,541087775.406600,16834,7306,23189,47329
2019-07-01,FINRA / NYSE TRF (DN),202144153,97359044,195531960,495035157,6108932975.441897,3610182858.872499,8706208780.677199,18425324614.991595,491817,212514,520546,1224877
2019-07-01,FINRA / Nasdaq TRF Carteret (DQ),1028614501,475779563,669376117,2173770181,43648169161.705602,29526929942.284601,33274063564.959601,106449162668.949804,4012418,948881,2581272,7542571
2019-07-01,EDGA Equities (J),105138035,36145005,53596166,194879206,4029061507.850100,1958228493.143900,2404494504.392300,8391784505.386300,1254724,205874,674586,2135184
2019-07-01,EDGX Equities (K),130894872,74932737,118765408,324593017,5136171379.519900,4716214470.933601,6026057961.233700,15878443811.687201,1237247,347177,958516,2542940
2019-07-01,NYSE Chicago (M),17396034,7159836,10604953,35160823,849706616.900800,780779612.300000,1115200551.108600,2745686780.309400,5961,842,4390,11193
2019-07-01,NYSE (N),804553018,48134518,38977736,891665272,34731258164.462195,2845161226.563801,1986448070.621600,39562867461.647596,2935188,137351,255606,3328145
2019-07-01,NYSE Arca (P),184285022,312500679,158788857,655574558,7878250638.308300,18873823077.738505,8572533528.261796,35324607244.308601,1626940,828135,1605111,4060186
2019-07-01,NASDAQ (Q),462249005,200746172,634856557,1297851734,21336754914.465504,13386370726.513099,35645683922.287206,70368809563.265809,4503951,841103,4583944,9928998
2019-07-01,IEX (V),115925163,22172854,66536690,204634707,5388663518.365800,1415647560.876200,3691137087.503299,10495448166.745299,880622,107938,532637,1521197
2019-07-01,NASDAQ PSX (X),19995891,22902249,14172946,57071086,628273315.505600,1533466998.627000,979370038.922800,3141110353.055400,141998,93934,119558,355490
2019-07-01,BYX Equities (Y),149963043,67301960,70404093,287669096,4698940566.781501,3727485531.340899,2969812856.290800,11396238954.413200,1549216,386833,816880,2752929
2019-07-01,BZX Equities (Z),184905078,99479930,124855378,409240386,8557491515.510302,7176161458.923199,7497611100.837799,23231264075.271300,1723486,434718,1197321,3355525
2019-06-28,NYSE American (A),8390823,104205736,4501730,117098289,369546448.766200,653614303.168800,207320443.895000,1230481195.830000,100352,74077,53441,227870
2019-06-28,NASDAQ BX (B),63072799,35229531,35995816,134298146,2670823847.695800,1795084610.002400,1796467678.880300,6262376136.578500,642651,139679,377903,1160233
2019-06-28,NYSE National (C),43392982,19315329,21287182,83995493,1164321590.876200,812170229.565600,654213344.676700,2630705165.118500,374191,83664,199324,657179
2019-06-28,FINRA / Nasdaq TRF Chicago (DB),3417766,1257778,4322803,8998347,124104714.460800,75291877.585700,223201402.534900,422597994.581400,12966,5199,18970,37135
2019-06-28,FINRA / NYSE TRF (DN),180326114,82440366,175133275,437899755,5783690315.614200,2455282624.336401,6728047793.630202,14967020733.580803,443880,165567,456448,1065895
2019-06-28,FINRA / Nasdaq TRF Carteret (DQ),1652315384,415876843,1379862560,3448054787,72729823151.103495,22693275879.364297,58711574736.578793,154134673767.046585,3761219,778818,2498216,7038253
2019-06-28,EDGA Equities (J),114740928,35263145,59577018,209581091,4431187537.464700,1941995164.225800,2341961278.465500,8715143980.156000,1367684,188062,732733,2288479
2019-06-28,EDGX Equities (K),121250621,67402126,95734570,284387317,4956795890.901900,4198629388.217601,4381548978.730599,13536974257.850100,1200645,305282,847170,2353097
2019-06-28,NYSE Chicago (M),7144606,8095231,4032832,19272669,430135757.387800,679356235.880000,393129650.962000,1502621644.229800,5322,3589,5401,14312
2019-06-28,NYSE (N),2105405549,40431321,40817990,2186654860,92602138992.969797,2446877831.539800,1827456139.550400,96876472964.059997,3160676,100871,267435,3528982
2019-06-28,NYSE Arca (P),188186275,264172493,174886189,627244957,8259225437.079002,17233680711.782495,8359401950.506899,33852308099.368396,1647806,712505,1625041,3985352
2019-06-28,NASDAQ (Q),453413948,184432408,1814440563,2452286919,21356676108.222598,12081528378.529099,69750137661.094685,103188342147.846382,4413462,754619,4818915,9986996
2019-06-28,IEX (V),122987784,21868703,73400907,218257394,5630485249.569400,1345438436.764300,3901058203.936100,10876981890.269800,920127,99850,562132,1582109
2019-06-28,NASDAQ PSX (X),21669267,21535856,15861300,59066423,782962522.305700,1446505505.756100,947619102.299600,3177087130.361400,162813,87168,136505,386486
2019-06-28,BYX Equities (Y),146165722,70090822,72507216,288763760,4739030091.642400,3710427894.706900,2922601010.930000,11372058997.279300,1495199,368125,830497,2693821
2019-06-28,BZX Equities (Z),190775262,93672558,129128554,413576374,8722804527.773803,6425021249.158602,6952225783.548002,22100051560.480407,1725544,400510,1180535,3306589
2019-06-27,NYSE American (A),6635437,15988580,4285361,26909378,277604699.465000,210854288.292900,183770138.652000,672229126.409900,74485,57071,44423,175979
2019-06-27,NASDAQ BX (B),52265687,29331832,29413674,111011193,2107547745.706800,1225457224.455600,1366042848.712200,4699047818.874600,538424,109367,299472,947263
2019-06-27,NYSE National (C),35671236,14564424,16695203,66930863,887329111.476500,522876933.985100,467921490.350400,1878127535.812000,294244,61421,152049,507714
2019-06-27,FINRA / Nasdaq TRF Chicago (DB),3567228,1389294,4018124,8974646,126606054.555400,72618867.476100,195801465.247600,395026387.279100,13392,5239,18050,36681
2019-06-27,FINRA / NYSE TRF (DN),178349688,75880598,190362988,444593274,5731415864.475000,2256771798.707799,6470044864.900305,14458232528.083104,437290,155707,435069,1028066
2019-06-27,FINRA / Nasdaq TRF Carteret (DQ),967003142,303172109,678859744,1949034995,38550362210.680499,15864856698.013099,28052358806.629707,82467577715.323305,3363091,676229,2152262,6191582
2019-06-27,EDGA Equities (J),96989607,27069947,48163954,172223508,3620539373.566200,1291625140.724100,1861979152.205800,6774143666.496100,1129868,146356,577730,1853954
2019-06-27,EDGX Equities (K),107834263,52856269,91398247,252088779,4346345870.030899,2929748045.253501,3755477395.221299,11031571310.505699,1026656,231795,722315,1980766
2019-06-27,NYSE Chicago (M),10761460,7123507,5578206,23463173,599493233.710900,721777642.885000,843341095.864800,2164611972.460700,5923,3212,5769,14904
2019-06-27,NYSE (N),727257200,30535167,34091127,791883494,30159363134.049202,1683122905.041500,1498853473.179800,33341339512.270502,2533347,79111,209396,2821854
2019-06-27,NYSE Arca (P),165052759,203257948,161152630,529463337,7088286652.452997,11476653352.968502,6996430878.575098,25561370883.996597,1419191,569009,1388013,3376213
2019-06-27,NASDAQ (Q),395947812,151493154,572079296,1119520262,17710809143.430798,8839246087.089699,27542025201.147205,54092080431.667702,3790238,620722,3841880,8252840
2019-06-27,IEX (V),108103016,15407278,60821244,184331538,4839420912.243600,829365669.490900,3140240435.246401,8809027016.980901,787319,73514,472296,1333129
2019-06-27,NASDAQ PSX (X),18761351,15936910,13000299,47698560,609918277.061000,891343918.442300,662562505.120600,2163824700.623900,134337,61507,106722,302566
2019-06-27,BYX Equities (Y),126604132,54912014,61025254,242541400,3920806376.455000,2562939359.638499,2292349544.009300,8776095280.102799,1312015,285677,689478,2287170
2019-06-27,BZX Equities (Z),161702251,74295613,112977152,348975016,7146531231.098100,4854610306.401700,5563865802.735902,17565007340.235702,1471343,317185,987802,2776330
2019-06-26,NYSE American (A),8710105,19393218,4039218,32142541,375115274.658100,229869537.104000,204891286.279900,809876098.042000,102210,66896,48610,217716
2019-06-26,NASDAQ BX (B),61271175,25423880,32687467,119382522,2526193788.591500,1076388994.741700,1637796637.768900,5240379421.102100,633666,103144,349412,1086222
2019-06-26,NYSE National (C),35845060,13679085,16351962,65876107,919047335.780200,491306006.193700,489426323.514900,1899779665.488800,304055,61020,155029,520104
2019-06-26,FINRA / Nasdaq TRF Chicago (DB),3681589,1764435,4505653,9951677,131712040.377400,78394292.189700,246670757.289300,456777089.856400,13622,6036,20233,39891
2019-06-26,FINRA / NYSE TRF (DN),189986554,100255913,196421047,486663514,5861914133.828301,2627595816.245200,7425438902.042402,15914948852.115903,453625,187980,472310,1113915
2019-06-26,FINRA / Nasdaq TRF Carteret (DQ),1054917050,359447097,681633913,2095998060,41996407672.109195,20415102138.496895,30230115640.490395,92641625451.096485,3726475,738472,2282475,6747422
2019-06-26,EDGA Equities (J),103870092,26294530,51147086,181311708,3879321132.488000,1250664156.101300,2083940233.567600,7213925522.156900,1216429,154037,629668,2000134
2019-06-26,EDGX Equities (K),120374790,60053355,91795288,272223433,4657967523.214800,3253827509.813201,4346016888.611700,12257811921.639701,1162639,271835,792518,2226992
2019-06-26,NYSE Chicago (M),6833868,13640575,5452368,25926811,487479689.840400,1109437181.508600,700494851.580900,2297411722.929900,5548,3308,4589,13445
2019-06-26,NYSE (N),821449334,33095653,36223199,890768186,35606911647.103798,1684584101.495800,1724201350.027000,39015697098.626598,2783655,86271,231893,3101819
2019-06-26,NYSE Arca (P),195247454,238925317,161079711,595252482,7801148400.578298,13719250481.645501,8021691461.426691,29542090343.650490,1610762,657580,1528498,3796840
2019-06-26,NASDAQ (Q),451254781,170043006,581740127,1203037914,20026197787.375700,9625262581.833801,32507871231.468896,62159331600.678397,4365580,703829,4058916,9128325
2019-06-26,IEX (V),114176075,16615197,62675740,193467012,5128732855.407600,941040004.640700,3327632796.844000,9397405656.892300,872856,76373,493846,1443075
2019-06-26,NASDAQ PSX (X),24007965,16541846,15526757,56076568,732570152.395200,922050720.099600,886721304.133200,2541342176.628000,163614,64350,130082,358046
2019-06-26,BYX Equities (Y),140391598,51878895,62890720,255161213,4157336203.637500,2555234409.442500,2383148812.755200,9095719425.835200,1461441,302952,724850,2489243
2019-06-26,BZX Equities (Z),179338561,79175261,118565628,377079450,7825818055.027598,5040351104.418997,6339891609.664499,19206060769.111094,1647459,347960,1093517,3088936
2019-06-25,NYSE American (A),7625460,20815680,3678380,32119520,334178108.834200,264253177.477800,186529578.191300,784960864.503300,86667,70674,42715,200056
2019-06-25,NASDAQ BX (B),63180554,34287227,32070123,129537904,2756156708.798300,1388975428.116700,1617023036.053000,5762155172.968000,646473,119241,331424,1097138
2019-06-25,NYSE National (C),36371518,19777562,16744872,72893952,915403726.048500,645171514.518800,521806727.970800,2082381968.538100,296106,74165,150325,520596
2019-06-25,FINRA / Nasdaq TRF Chicago (DB),3692539,2137376,3748262,9578177,149684175.474800,93351565.222400,233546230.194200,476581970.891400,13784,6666,17256,37706
2019-06-25,FINRA / NYSE TRF (DN),192022917,108080127,183306758,483409802,6049202611.522001,3063760811.336301,7471342722.963604,16584306145.821906,485612,215669,462940,1164221
2019-06-25,FINRA / Nasdaq TRF Carteret (DQ),1017817332,445370474,675665627,2138853433,42689653424.636384,27290526157.962694,30787148661.783776,100767328244.382854,3813545,894273,2295204,7003022
2019-06-25,EDGA Equities (J),108443526,35116419,50474416,194034361,4172164993.726700,1595978199.142100,2093104933.309100,7861248126.177900,1255179,183892,624934,2064005
2019-06-25,EDGX Equities (K),123778624,73563651,90447492,287789767,5018223667.634701,4044768199.386999,4533421899.122603,13596413766.144303,1206208,320125,775319,2301652
2019-06-25,NYSE Chicago (M),7130968,17698077,7015536,31844581,542823939.043600,1442459087.395000,835980537.585700,2821263564.024300,5549,5574,6600,17723
2019-06-25,NYSE (N),876818229,46358353,40795830,963972412,37451521776.505300,2535157770.774200,1938572864.391800,41925252411.671300,2752276,114610,236110,3102996
2019-06-25,NYSE Arca (P),194843677,297606380,164857181,657307238,8712046498.801801,17111320584.205802,8437361336.330303,34260728419.337906,1639762,800374,1479625,3919761
2019-06-25,NASDAQ (Q),466891105,216232248,595751206,1278874559,21678743300.345300,12213219833.698197,33002939015.879497,66894902149.922994,4417122,866374,4014899,9298395
2019-06-25,IEX (V),119910087,19743568,62045654,201699309,5399172723.590900,1170232914.611900,3003627051.950800,9573032690.153600,860378,88995,465982,1415355
2019-06-25,NASDAQ PSX (X),25608102,23107254,14821021,63536377,757668919.325000,1333118900.108800,905712968.476100,2996500787.909900,165526,87570,126827,379923
2019-06-25,BYX Equities (Y),144376459,69025599,68218656,281620714,4383816016.295500,3249426320.466700,2571875984.544500,10205118321.306700,1459333,362338,741607,2563278
2019-06-25,BZX Equities (Z),190923030,102575878,122909319,416408227,8672020083.098305,6849258237.034199,7031113853.016103,22552392173.148607,1714323,438887,1103712,3256922
2019-06-24,NYSE American (A),6906528,23274148,3883868,34064544,286717498.954500,229476259.035400,179225729.565900,695419487.555800,78394,76046,42272,196712
2019-06-24,NASDAQ BX (B),51723764,28837034,28956308,109517106,2120026717.091000,1219376901.828500,1379284869.120300,4718688488.039800,533977,112532,292727,939236
2019-06-24,NYSE National (C),33576942,16539569,16655280,66771791,817340931.480600,524660988.625300,460651000.336800,1802652920.442700,283647,67244,151887,502778
2019-06-24,FINRA / Nasdaq TRF Chicago (DB),4260230,1860024,3766706,9886960,140118240.376000,77521017.669700,195945928.733500,413585186.779200,14779,6134,17883,38796
2019-06-24,FINRA / NYSE TRF (DN),173700144,101395544,178288384,453384072,5155215599.668402,2541892360.141900,6263915770.860300,13961023730.670602,466840,213693,461120,1141653
2019-06-24,FINRA / Nasdaq TRF Carteret (DQ),891996817,400365451,699944096,1992306364,35639612394.491101,21262188161.992201,28078662923.153902,84980463479.637204,3490686,854509,2223093,6568288
2019-06-24,EDGA Equities (J),75783151,25532053,44204213,145519417,3190453349.991800,1232408726.371600,1864001639.038200,6286863715.401600,992222,143008,561203,1696433
2019-06-24,EDGX Equities (K),106903104,61190758,87042935,255136797,4069137202.519901,2979842041.458600,3596882248.505999,10645861492.484500,1056407,261180,728782,2046369
2019-06-24,NYSE Chicago (M),15447230,11565323,12593747,39606300,478372814.622700,1101862937.720000,873801044.318800,2454036796.661500,5193,2468,5045,12706
2019-06-24,NYSE (N),801707198,32831666,33846930,868385794,33486436986.062904,1594831083.635300,1388704309.642800,36469972379.341004,2667507,83494,200297,2951298
2019-06-24,NYSE Arca (P),160340153,241899394,157546109,559785656,6323887701.749697,12638080812.860803,6783088091.929702,25745056606.540202,1392233,613127,1414877,3420237
2019-06-24,NASDAQ (Q),392524886,168276586,559127352,1119928824,17603360116.346296,8861878600.767397,28852486164.674501,55317724881.788194,3947538,661699,3956953,8566190
2019-06-24,IEX (V),93237298,18906396,55468788,167612482,3958439836.549300,902568978.231700,2550068317.300400,7411077132.081400,718769,81492,419204,1219465
2019-06-24,NASDAQ PSX (X),23940579,16487866,13634082,54062527,619183713.169600,899356831.386300,676642087.331500,2195182631.887400,142690,66632,108923,318245
2019-06-24,BYX Equities (Y),138373567,63441054,65316405,267131026,4165202976.032400,2789614088.694200,2389027713.498500,9343844778.225100,1449593,335128,751825,2536546
2019-06-24,BZX Equities (Z),166538491,75877412,113199392,355615295,7344330715.809800,4683933907.001498,5638679039.240499,17666943662.051797,1593699,341569,1066629,3001897
2019-06-21,NYSE American (A),7358543,81107139,3570318,92036000,306106334.241000,373039703.505200,180638793.762000,859784831.508200,82500,65757,40770,189027
2019-06-21,NASDAQ BX (B),59311770,28680627,31055540,119047937,2335234358.918300,1444027164.559700,1570496752.869000,5349758276.347000,589782,115414,310217,1015413
2019-06-21,NYSE National (C),41980014,21024354,18507218,81511586,1008727963.975900,847037070.854200,539579253.834600,2395344288.664700,335219,87246,161097,583562
2019-06-21,FINRA / Nasdaq TRF Chicago (DB),4274437,1716902,3577924,9569263,146219064.049900,86837623.390500,206660790.768200,439717478.208600,15379,5902,17298,38579
2019-06-21,FINRA / NYSE TRF (DN),190800760,83812785,211854309,486467854,5701126399.705701,2808315413.035900,6633377815.221799,15142819627.963400,505529,180144,449345,1135018
2019-06-21,FINRA / Nasdaq TRF Carteret (DQ),1276312239,439329954,781612921,2497255114,51002312165.697597,28702248970.004001,39907675306.714787,119612236442.416385,3625919,921087,2126286,6673292
2019-06-21,EDGA Equities (J),87720198,25428043,43199843,156348084,3597768748.264800,1486876846.877600,1918681703.848700,7003327298.991100,1064064,151780,528284,1744128
2019-06-21,EDGX Equities (K),127348207,66411812,94690281,288450300,4737007292.026800,4377689233.431999,4498155591.407897,13612852116.866696,1182460,299200,749415,2231075
2019-06-21,NYSE Chicago (M),9371110,12201069,9020130,30592309,517502931.972400,1110486718.576000,1326699737.695800,2954689388.244200,4760,3348,5702,13810
2019-06-21,NYSE (N),2078363676,37074149,37689951,2153127776,92985988420.488093,2282054376.683500,1726763511.495000,96994806308.666593,2866486,95386,221621,3183493
2019-06-21,NYSE Arca (P),192154985,268051139,151626412,611832536,7819693813.524602,16937694300.333502,7965010466.417004,32722398580.275108,1583373,704760,1325421,3613554
2019-06-21,NASDAQ (Q),450504101,177966503,1253564238,1882034842,20118073931.242799,11137532386.007395,67494370162.329791,98749976479.579985,4217354,723620,4007520,8948494
2019-06-21,IEX (V),116344217,19249441,58207317,193800975,4844070920.488201,1132142914.754800,2871015410.488301,8847229245.731302,855437,98890,440743,1395070
2019-06-21,NASDAQ PSX (X),28880866,18500421,15278343,62659630,804028682.685000,1254661275.457100,987798472.298200,3046488430.440300,174349,78871,122872,376092
2019-06-21,BYX Equities (Y),144517082,64426804,66543681,275487567,4276085090.013300,3348229766.601499,2735084844.215300,10359399700.830099,1430000,356730,722226,2508956
2019-06-21,BZX Equities (Z),188304087,93699925,129547472,411551484,8416048770.981900,6605699074.194502,7466269962.949201,22488017808.125603,1683503,400883,1126014,3210400
2019-06-20,NYSE American (A),7402319,19780681,3792696,30975696,323194544.356500,270923605.152100,196807395.685400,790925545.194000,85069,76072,42310,203451
2019-06-20,NASDAQ BX (B),61521789,39489835,29579808,130591432,2521209679.983100,1852494024.015900,1613346728.828300,5987050432.827300,611392,164280,314231,1089903
2019-06-20,NYSE National (C),43918087,30783303,16683027,91384417,1066178105.625500,1034957778.479600,530748394.410500,2631884278.515600,345746,118255,159042,623043
2019-06-20,FINRA / Nasdaq TRF Chicago (DB),4895749,2581738,4367495,11844982,164326295.277100,123970932.013200,270837631.904400,559134859.194700,16692,8125,20372,45189
2019-06-20,FINRA / NYSE TRF (DN),233237663,110984525,196308099,540530287,6992030955.353202,3574289135.628600,7686876104.510601,18253196195.492403,587580,224543,515513,1327636
2019-06-20,FINRA / Nasdaq TRF Carteret (DQ),1158880737,586911480,669872458,2415664675,44821881412.897285,39960842849.545589,33548833763.075808,118331558025.518682,3856745,1011796,2243434,7111975
2019-06-20,EDGA Equities (J),87867936,35662454,39881574,163411964,3694378426.268700,1891570254.409400,1896039639.893100,7481988320.571200,1095553,212020,523583,1831156
2019-06-20,EDGX Equities (K),141700785,85466929,97925348,325093062,5397687821.749899,5091111745.947000,4975655743.218701,15464455310.915600,1240315,388716,794984,2424015
2019-06-20,NYSE Chicago (M),6356837,17782770,6533708,30673315,372060563.793300,1573199739.419801,589926075.202700,2535186378.415801,5699,5599,6121,17419
2019-06-20,NYSE (N),974265020,48712537,36275629,1059253186,41431277914.856996,2720936276.593900,1923036180.176500,46075250371.627396,2793056,120186,234614,3147856
2019-06-20,NYSE Arca (P),207233044,365818229,161210046,734261319,8526036418.132395,19614726844.522317,8719426451.898505,36860189714.553217,1665044,875528,1447186,3987758
2019-06-20,NASDAQ (Q),500874567,241816764,593907844,1336599175,22298221017.270399,14365778812.969605,33563240616.490779,70227240446.730783,4570578,934872,4047012,9552462
2019-06-20,IEX (V),122466446,25961284,58261846,206689576,5424516307.319600,1566870811.866900,3281244275.677798,10272631394.864298,902315,121078,470333,1493726
2019-06-20,NASDAQ PSX (X),32279848,24481023,14380450,71141321,795204897.005000,1475396439.178000,919749648.961800,3190350985.144800,170091,92924,121205,384220
2019-06-20,BYX Equities (Y),160914170,87584710,61893250,310392130,4755560900.844800,4353059700.180200,2735564182.003900,11844184783.028900,1554446,461180,735147,2750773
2019-06-20,BZX Equities (Z),199245082,117987515,117377789,434610386,8698298394.329899,7861488252.184598,7111910700.989302,23671697347.503799,1713884,486433,1088342,3288659
2019-06-19,NYSE American (A),6748777,13506831,3462918,23718526,295477180.038100,235502555.984400,168111662.603800,699091398.626300,76761,52976,40308,170045
2019-06-19,NASDAQ BX (B),56969803,29910472,29573074,116453349,2337587324.374900,1328550261.231900,1569692030.236800,5235829615.843600,587217,113426,303306,1003949
2019-06-19,NYSE National (C),39005825,22940441,16681275,78627541,928037267.283200,838277231.988800,501422603.783300,2267737103.055300,320147,92466,154867,567480
2019-06-19,FINRA / Nasdaq TRF Chicago (DB),3864133,1525295,3933783,9323211,129806139.381900,84090166.187700,247482418.135000,461378723.704600,13091,5378,18617,37086
2019-06-19,FINRA / NYSE TRF (DN),183745801,83459925,199411403,466617129,5465171703.645500,2597858779.763100,7770224800.810498,15833255284.219098,443339,167611,488029,1098979
2019-06-19,FINRA / Nasdaq TRF Carteret (DQ),918592379,372702665,607607627,1898902671,36940149466.125402,24738010513.493700,28246471131.128499,89924631110.747601,3421256,781802,2125036,6328094
2019-06-19,EDGA Equities (J),78557095,25230038,39902164,143689297,3225011569.483500,1405365237.602100,1769314461.192800,6399691268.278400,1008043,142275,500268,1650586
2019-06-19,EDGX Equities (K),121630673,70675280,96595846,288901799,4721734140.345301,4228773917.290300,4423237297.181100,13373745354.816701,1163686,318162,752023,2233871
2019-06-19,NYSE Chicago (M),6400953,14287383,5958170,26646506,450906140.866400,1545770677.547500,775341114.765400,2772017933.179300,4929,5746,5419,16094
2019-06-19,NYSE (N),807447657,41444657,34725768,883618082,33341963080.749199,2199969510.814500,1726423184.231800,37268355775.795499,2648352,103658,216627,2968637
2019-06-19,NYSE Arca (P),178565119,264581963,160305340,603452422,7266585158.483200,15258088588.829803,7755156928.497099,30279830675.810102,1485319,779035,1333712,3598066
2019-06-19,NASDAQ (Q),449836158,221446609,582571047,1253853814,19793872992.897899,13172915723.262699,31942078343.192710,64908867059.353308,4253002,872243,3967275,9092520
2019-06-19,IEX (V),111320006,21171825,56838491,189330322,4772887328.497100,1268802888.933000,3022496505.399500,9064186722.829600,815033,94604,443441,1353078
2019-06-19,NASDAQ PSX (X),21302178,22209473,14501542,58013193,741425065.278700,1294715854.407600,917868680.848700,2954009600.535000,155762,79485,116523,351770
2019-06-19,BYX Equities (Y),141282164,67839278,61493026,270614468,4149203467.478200,3307879088.655401,2516335081.878200,9973417638.011801,1415903,357273,684478,2457654
2019-06-19,BZX Equities (Z),174960280,101725463,113963488,390649231,7886522442.845398,6835013157.953299,6642951374.608398,21364486975.407095,1577642,425048,1004804,3007494
2019-06-18,NYSE American (A),7398991,16681769,4017566,28098326,316889055.637900,369931221.028800,244457274.657100,931277551.323800,84414,69041,49670,203125
2019-06-18,NASDAQ BX (B),60186052,34519702,32803792,127509546,2402719767.936300,1736900056.775600,1967075604.352800,6106695429.064700,606420,141521,345255,1093196
2019-06-18,NYSE National (C),40793564,27187546,18617096,86598206,990474926.181000,1005786601.058100,605252863.100500,2601514390.339600,341144,111501,177666,630311
2019-06-18,FINRA / Nasdaq TRF Chicago (DB),4704472,1786964,5133562,11624998,162339625.131300,83230372.175600,347144971.326400,592714968.633300,15466,5934,25068,46468
2019-06-18,FINRA / NYSE TRF (DN),205178965,97676858,223287329,526143152,6267803048.862803,2984273232.936700,10027190683.767200,19279266965.566703,516065,191212,593787,1301064
2019-06-18,FINRA / Nasdaq TRF Carteret (DQ),1006467562,423072991,695473663,2125014216,40696639312.531391,25504309215.474903,35439168695.833004,101640117223.839298,3680206,926866,2436709,7043781
2019-06-18,EDGA Equities (J),84503197,31120540,44248242,159871979,3480403039.508800,1680437511.789500,2238423815.755400,7399264367.053700,1083367,185515,578577,1847459
2019-06-18,EDGX Equities (K),129520370,79986908,104851416,314358694,5007023573.323201,5175822705.002700,5891921951.388799,16074768229.714700,1236031,359811,868059,2463901
2019-06-18,NYSE Chicago (M),6835445,19496439,8303001,34634885,446238648.705800,2224403481.592000,883227102.049700,3553869232.347500,5843,9468,8246,23557
2019-06-18,NYSE (N),772721222,47514877,40045483,860281582,31593205807.134100,2935310716.503300,2115888010.689000,36644404534.326400,2700358,115787,234248,3050393
2019-06-18,NYSE Arca (P),185300032,296076422,171118687,652495141,7755560548.645198,17380493699.580607,10145857748.693091,35281911996.918896,1558073,819154,1484233,3861460
2019-06-18,NASDAQ (Q),459965496,229823380,617807615,1307596491,20411959802.682796,14160536693.451504,37673226685.612486,72245723181.746786,4299543,888759,4430468,9618770
2019-06-18,IEX (V),120014326,23312167,64411487,207737980,5374507590.603600,1282032481.506400,3961995609.401302,10618535681.511302,881222,109503,511320,1502045
2019-06-18,NASDAQ PSX (X),22891357,24449809,16329157,63670323,740251827.516200,1645239693.108500,1043660743.533800,3429152264.158500,162028,92070,136310,390408
2019-06-18,BYX Equities (Y),153677829,80246159,71098375,305022363,4535685452.755400,4046720061.413500,3234015405.365600,11816420919.534500,1537997,422699,815430,2776126
2019-06-18,BZX Equities (Z),181384832,107734844,133011902,422131578,8210333994.578300,7420636485.496500,8365982041.575501,23996952521.650301,1655541,459532,1190813,3305886
2019-06-17,NYSE American (A),5968439,13245017,3753655,22967111,235859636.430300,178168525.361800,183133509.872200,597161671.664300,69506,46621,40145,156272
2019-06-17,NASDAQ BX (B),48689246,19407211,26495266,94591723,1905746049.156100,892315919.253600,1296007790.397000,4094069758.806700,509222,87171,274904,871297
2019-06-17,NYSE National (C),33739498,15330576,16890802,65960876,774517081.806500,516595054.799800,452933254.382600,1744045390.988900,284480,64045,151292,499817
2019-06-17,FINRA / Nasdaq TRF Chicago (DB),3247394,1302337,4136531,8686262,104700213.327200,66030934.537200,255315962.963000,426047110.827400,11886,4659,19662,36207
2019-06-17,FINRA / NYSE TRF (DN),157979263,68755103,197298754,424033120,4740408564.487500,2051395227.072500,7763899788.223497,14555703579.783497,428896,154528,497255,1080679
2019-06-17,FINRA / Nasdaq TRF Carteret (DQ),812475284,296769622,609781618,1719026524,30895013751.204703,15294486268.806100,27913916227.040189,74103416247.050992,3229423,691719,2155440,6076582
2019-06-17,EDGA Equities (J),72713366,17916134,39084081,129713581,2969284372.201300,911063382.996700,1756209175.772700,5636556930.970700,944206,107454,524084,1575744
2019-06-17,EDGX Equities (K),102335716,45866177,88238155,236440048,3763830401.806800,2638845558.417900,4213179005.341199,10615854965.565899,1030999,217755,735133,1983887
2019-06-17,NYSE Chicago (M),7116037,8547322,5432692,21096051,503728445.935000,938423504.111400,606425558.483800,2048577508.530200,6142,4062,4871,15075
2019-06-17,NYSE (N),681698186,25015459,31145500,737859145,27315913596.161900,1361738594.030200,1384201758.030900,30061853948.223000,2311676,68547,188525,2568748
2019-06-17,NYSE Arca (P),148814316,195791530,153316882,497922728,5800281776.471700,10259300959.039495,7357868817.117599,23417451552.628794,1334090,511972,1305483,3151545
2019-06-17,NASDAQ (Q),374617513,133155304,537716276,1045489093,16252029799.658802,7619004022.115498,28423304891.004308,52294338712.778608,3746500,557909,3730981,8035390
2019-06-17,IEX (V),93452773,15153003,59936885,168542661,3940719657.591500,755026376.889100,3001772942.697901,7697518977.178501,713936,71680,462339,1247955
2019-06-17,NASDAQ PSX (X),16352184,12193417,12356512,40902113,530610891.235000,720866935.478700,697747168.711500,1949224995.425200,123516,48967,104835,277318
2019-06-17,BYX Equities (Y),125079053,48173063,58258169,231510285,3607581354.258900,2223052868.098200,2258917175.244900,8089551397.602000,1305297,266899,679532,2251728
2019-06-17,BZX Equities (Z),144125144,60628096,106713564,311466804,6095242328.419500,3782289141.253199,5632140917.214398,15509672386.887097,1357278,274777,972598,2604653
2019-06-14,NYSE American (A),5669965,17313979,2989959,25973903,221782929.148200,228312086.335000,169250428.334200,619345443.817400,65247,56337,35286,156870
2019-06-14,NASDAQ BX (B),51271131,24608738,25094910,100974779,1940997481.317200,1046760695.616400,1383909204.349200,4371667381.282800,509147,95289,265578,870014
2019-06-14,NYSE National (C),36307814,18209434,16095751,70612999,810810909.648300,589940593.041400,469844063.651500,1870595566.341200,287474,71415,149131,508020
2019-06-14,FINRA / Nasdaq TRF Chicago (DB),3332521,1456656,3763782,8552959,96463911.686700,69610401.016000,241963540.097500,408037852.800200,12395,5202,17913,35510
2019-06-14,FINRA / NYSE TRF (DN),167346109,83327804,187611589,438285502,4497697558.283398,2172910402.791801,7103467067.065702,13774075028.140901,436796,165401,440551,1042748
2019-06-14,FINRA / Nasdaq TRF Carteret (DQ),847906655,327551295,559121517,1734579467,30312057903.361508,18282962407.077002,25857198157.425901,74452218467.864411,3261901,698290,2063680,6023871
2019-06-14,EDGA Equities (J),76610482,21074703,37490385,135175570,2975132896.964200,1030201097.001200,1675649578.437800,5680983572.403200,947675,119340,493880,1560895
2019-06-14,EDGX Equities (K),109084785,53938521,85896265,248919571,3829695744.688100,3061434140.284799,4018475964.424102,10909605849.397001,1042375,238456,694879,1975710
2019-06-14,NYSE Chicago (M),7572085,19375281,4940142,31887508,376762560.250200,1563959606.830000,957343447.756400,2898065614.836600,4911,4561,6080,15552
2019-06-14,NYSE (N),733011928,31048324,30148038,794208290,28015554313.843495,1668394824.333500,1407034732.152800,31090983870.329795,2255086,75229,182694,2513009
2019-06-14,NYSE Arca (P),157688475,197539074,134747463,489975012,5883532188.119700,9953046086.964402,6649038257.208004,22485616532.292106,1311614,554900,1199435,3065949
2019-06-14,NASDAQ (Q),393210385,155958049,496859329,1046027763,16490912436.310197,8287223872.066299,27295245929.881793,52073382238.258289,3653381,602619,3576802,7832802
2019-06-14,IEX (V),103459664,15312387,53925296,172697347,4402635342.854999,826818837.665000,2960892296.754400,8190346477.274399,757036,77022,441189,1275247
2019-06-14,NASDAQ PSX (X),17966284,16304138,11499648,45770070,560380870.481700,902878095.490700,780000760.638100,2243259726.610500,131249,60741,101448,293438
2019-06-14,BYX Equities (Y),135255810,52715188,57005601,244976599,3743391130.244300,2342315855.923600,2306851462.775500,8392558448.943400,1310097,281485,660209,2251791
2019-06-14,BZX Equities (Z),147119091,69284249,101186276,317589616,6028675864.234199,4367383472.326200,5750028501.087001,16146087837.647400,1371585,305107,948199,2624891
2019-06-13,NYSE American (A),5690699,14747875,3193350,23631924,223544654.849400,225369536.844700,146185791.204100,595099982.898200,63611,55612,34984,154207
2019-06-13,NASDAQ BX (B),51267400,24545240,24865991,100678631,1954342968.247800,1105425129.911100,1308019879.699600,4367787977.858500,512642,99642,267633,879917
2019-06-13,NYSE National (C),38229652,16986173,15449960,70665785,852402743.543200,567216539.947400,456956810.074400,1876576093.565000,296027,71840,149495,517362
2019-06-13,FINRA / Nasdaq TRF Chicago (DB),3466802,1337676,3565616,8370094,116433516.479600,64391808.573900,239076240.977900,419901566.031400,12250,5000,17574,34824
2019-06-13,FINRA / NYSE TRF (DN),175441121,81420076,200856860,457718057,5016083201.565900,2245419189.743900,7731111237.628504,14992613628.938304,425589,161262,462475,1049326
2019-06-13,FINRA / Nasdaq TRF Carteret (DQ),944322800,360694983,590635757,1895653540,36283923987.920298,19493747672.836595,26311330137.322692,82089001798.079585,3282182,675359,2061520,6019061
2019-06-13,EDGA Equities (J),76119718,23096286,37007833,136223837,3034643089.925100,1184770625.041300,1652831766.497000,5872245481.463400,956501,125803,497317,1579621
2019-06-13,EDGX Equities (K),110678838,57567175,84278890,252524903,3997682983.679700,3095136052.630101,3917402404.234199,11010221440.544000,1037673,233842,694323,1965838
2019-06-13,NYSE Chicago (M),10902705,12569496,5778244,29250445,415331023.334600,923949025.070000,595961506.509900,1935241554.914500,5417,3548,5065,14030
2019-06-13,NYSE (N),710475628,32736357,30611690,773823675,28783608684.244598,1810716561.070300,1372614166.868000,31966939412.182898,2283193,74627,180436,2538256
2019-06-13,NYSE Arca (P),159206921,216363005,135654372,511224298,6202102872.818397,11565963756.453703,6639557830.692999,24407624459.965099,1326001,546470,1194530,3067001
2019-06-13,NASDAQ (Q),403756967,156865007,499348254,1059970228,17531393703.785797,8680620252.463702,26424733762.035894,52636747718.285393,3746727,589118,3513739,7849584
2019-06-13,IEX (V),107924278,15310827,54981429,178216534,4501109724.867100,851972706.550300,2835224119.574300,8188306550.991700,773551,76751,430664,1280966
2019-06-13,NASDAQ PSX (X),18504664,18000699,11447191,47952554,583078417.007600,1036270890.938900,701162490.271400,2320511798.217900,127155,64236,97328,288719
2019-06-13,BYX Equities (Y),136186896,54338075,54229484,244754455,3768872546.397700,2519577115.693500,2164368112.642601,8452817774.733801,1308456,279575,632995,2221026
2019-06-13,BZX Equities (Z),148465738,70355312,96463546,315284596,6255875879.080799,4415905329.838799,5204647642.097499,15876428851.017097,1370542,290480,899769,2560791
2019-06-12,NYSE American (A),6728790,12354422,3379821,22463033,256082030.687000,185695103.944300,168525698.723300,610302833.354600,73436,48662,35911,158009
2019-06-12,NASDAQ BX (B),54124221,23284623,26381931,103790775,2009718945.019200,1042666191.273200,1461924472.963000,4514309609.255400,525316,90722,284239,900277
2019-06-12,NYSE National (C),37850806,15828308,14675408,68354522,907505057.177600,537181445.040500,444590510.896100,1889277013.114200,321389,69507,146055,536951
2019-06-12,FINRA / Nasdaq TRF Chicago (DB),3669590,1677940,4071351,9418881,113038331.267000,80250755.609700,278666525.633100,471955612.509800,12099,4813,19620,36532
2019-06-12,FINRA / NYSE TRF (DN),168352704,75174268,243856313,487383285,4492511725.654400,2271367082.228800,8482132217.024197,15246011024.907397,391768,153168,502642,1047578
2019-06-12,FINRA / Nasdaq TRF Carteret (DQ),893548816,305731871,605619840,1804900527,32542998368.515007,16236438643.433003,26094210579.312596,74873647591.260606,3352745,651159,2084905,6088809
2019-06-12,EDGA Equities (J),81481841,20106019,39915940,141503800,3221238731.699800,973775455.202000,1794589511.370700,5989603698.272500,1031042,112282,517441,1660765
2019-06-12,EDGX Equities (K),113214378,49927274,102685668,265827320,4052783894.689300,2853518048.824601,4176422783.917202,11082724727.431103,1063255,223731,736929,2023915
2019-06-12,NYSE Chicago (M),13703209,14407429,5889200,33999838,519323810.186700,1125149069.050000,601486310.702300,2245959189.939000,4005,2823,4698,11526
2019-06-12,NYSE (N),676942281,30335978,31285584,738563843,26263031901.003204,1648450281.180600,1490750436.358100,29402232618.541904,2285013,72189,189261,2546463
2019-06-12,NYSE Arca (P),163658721,207094735,149736429,520489885,6297998311.570701,10860029546.734302,7137388797.190701,24295416655.495704,1351545,541487,1241330,3134362
2019-06-12,NASDAQ (Q),403352847,146263623,522658148,1072274618,17418157766.145994,7810648920.734401,27071821695.393804,52300628382.274199,3770859,570945,3687150,8028954
2019-06-12,IEX (V),112211998,15761497,54597574,182571069,4509987889.858100,890417803.757700,2847743187.613900,8248148881.229700,815560,79352,442553,1337465
2019-06-12,NASDAQ PSX (X),19368306,15782355,11917174,47067835,588032108.088600,953588947.885200,851949298.242200,2393570354.216000,133712,59174,112274,305160
2019-06-12,BYX Equities (Y),141963952,52755066,58350813,253069831,3977314388.575900,2420601751.736501,2307823787.983701,8705739928.296102,1394391,278756,654978,2328125
2019-06-12,BZX Equities (Z),149706763,65473201,103917782,319097746,6129335060.422100,3982003990.694901,5252907391.766201,15364246442.883202,1375432,283358,909927,2568717
2019-06-11,NYSE American (A),8318623,15116359,3849998,27284980,347275812.745600,205021077.490200,227033426.183500,779330316.419300,90189,51886,46814,188889
2019-06-11,NASDAQ BX (B),60072901,22580275,28899498,111552674,2448525904.236600,1091982688.235500,1527423293.273700,5067931885.745800,592541,99247,310451,1002239
2019-06-11,NYSE National (C),41004095,16074606,16381943,73460644,1020947160.333900,598588132.297100,516767206.804200,2136302499.435200,342310,75526,160336,578172
2019-06-11,FINRA / Nasdaq TRF Chicago (DB),3632927,1602934,4899002,10134863,134039598.458600,97441934.811200,310076224.913800,541557758.183600,13310,5692,21998,41000
2019-06-11,FINRA / NYSE TRF (DN),178500821,78182705,209095616,465779142,5329133702.862100,2680115750.437901,9241483315.871302,17250732769.171303,424699,169346,529615,1123660
2019-06-11,FINRA / Nasdaq TRF Carteret (DQ),1090496230,364009660,667544233,2122050123,39116300633.729205,22234014737.385901,31734706178.907600,93085021550.022706,3665901,748392,2325736,6740029
2019-06-11,EDGA Equities (J),84399741,22248423,45452102,152100266,3412658769.669300,1237922490.856800,1814234422.197200,6464815682.723300,1054712,129479,528096,1712287
2019-06-11,EDGX Equities (K),122213983,56642664,107882631,286739278,4576573997.922999,3530758178.737900,4788849715.843403,12896181892.504302,1177156,263467,810357,2250980
2019-06-11,NYSE Chicago (M),14043379,21386373,6162708,41592460,699372846.371300,1683808327.218801,739428980.083400,3122610153.673501,5146,3185,5616,13947
2019-06-11,NYSE (N),864611817,33837621,37869992,936319430,30231415770.502700,2076052670.482800,1836792251.297400,34144260692.282900,2589101,84574,215431,2889106
2019-06-11,NYSE Arca (P),168375535,221435818,162258943,552070296,6580066064.935998,12648223734.551901,8248972931.544594,27477262731.032493,1384871,624109,1357922,3366902
2019-06-11,NASDAQ (Q),448178955,160388392,576503616,1185070963,20165937321.300695,9440323115.002397,31765980873.245088,61372241309.548180,4374593,651474,4230365,9256432
2019-06-11,IEX (V),125066157,17159393,59271950,201497500,5096838526.489400,1041980760.992700,3278651342.365900,9417470629.848000,870934,85141,478487,1434562
2019-06-11,NASDAQ PSX (X),21850219,16730155,13663266,52243640,666091476.342500,1004223261.672100,907804637.314200,2578119375.328800,146625,64171,126517,337313
2019-06-11,BYX Equities (Y),157702996,57439109,66230731,281372836,4445794542.261300,2914206926.277700,2567479246.600800,9927480715.139800,1553308,311519,739892,2604719
2019-06-11,BZX Equities (Z),162534200,75639119,115192914,353366233,6988161550.848299,4989989355.302303,6124526846.404102,18102677752.554704,1538808,332943,1046883,2918634
2019-06-10,NYSE American (A),8181608,19310177,3697964,31189749,353911426.752000,210551985.577800,204895249.812700,769358662.142500,89122,55083,44396,188601
2019-06-10,NASDAQ BX (B),56493499,27295703,31016986,114806188,2499128371.575800,1391727922.490300,1818823293.804299,5709679587.870399,578621,117262,328400,1024283
2019-06-10,NYSE National (C),38983706,17429790,16766376,73179872,955723781.858700,655590284.656700,527203986.169300,2138518052.684700,313735,82806,157808,554349
2019-06-10,FINRA / Nasdaq TRF Chicago (DB),4119776,1664286,5311590,11095652,156868858.007700,103717065.290300,363144364.316800,623730287.614800,15143,5766,25774,46683
2019-06-10,FINRA / NYSE TRF (DN),195202644,94028778,201358149,490589571,6064466820.850702,3006163757.053100,10421058009.967800,19491688587.871602,516717,198715,608754,1324186
2019-06-10,FINRA / Nasdaq TRF Carteret (DQ),929638253,370292569,629462003,1929392825,38099182619.112599,21173406360.780607,33355650646.979396,92628239626.872602,3656785,854940,2463265,6974990
2019-06-10,EDGA Equities (J),82627460,23339364,40558524,146525348,3670148035.231700,1254859158.611100,2031878213.625200,6956885407.468000,1033919,140822,538156,1712897
2019-06-10,EDGX Equities (K),125916739,63222273,95404515,284543527,5139737538.696201,3834411893.875099,5485705410.870501,14459854843.441801,1218157,285310,845110,2348577
2019-06-10,NYSE Chicago (M),6189927,9633638,5919139,21742704,380501707.560200,931800267.299100,771536169.248500,2083838144.107800,4664,4113,5983,14760
2019-06-10,NYSE (N),740513565,30720851,39446879,810681295,30668935862.530499,2002490321.492801,1935837665.972500,34607263849.995800,2629782,86559,223728,2940069
2019-06-10,NYSE Arca (P),165011056,245909313,150933793,561854162,7101134041.722898,13852199970.539796,8692206526.837801,29645540539.100495,1411241,644551,1396126,3451918
2019-06-10,NASDAQ (Q),418452739,167120804,572136613,1157710156,19914862404.942400,10148966052.871098,35210307898.567282,65274136356.380780,4217130,693842,4427021,9337993
2019-06-10,IEX (V),108598444,17619195,58919419,185137058,4933475304.985300,1167393715.983500,3318748093.514700,9419617114.483500,820998,92855,473987,1387840
2019-06-10,NASDAQ PSX (X),19106200,16202796,14618587,49927583,669013228.675700,1032081688.533900,1020212858.281400,2721307775.491000,133615,62669,126178,322462
2019-06-10,BYX Equities (Y),151737340,67206482,66298069,285241891,4475600097.617600,3321390042.959201,2742371012.141000,10539361152.717801,1515232,354888,769712,2639832
2019-06-10,BZX Equities (Z),159124140,79173627,110497333,348795100,7452648224.372599,5201470358.053002,6717192935.674798,19371311518.100399,1539234,351073,1071498,2961805
2019-06-07,NYSE American (A),6988414,12776133,3238610,23003157,294524061.535400,255344307.656800,184195189.158400,734063558.350600,76582,52737,37354,166673
2019-06-07,NASDAQ BX (B),61818477,26787281,32440277,121046035,2537731775.613700,1326927039.890600,1882216289.388400,5746875104.892700,633688,110727,334037,1078452
2019-06-07,NYSE National (C),38654605,18250743,16267373,73172721,932086042.850100,660272077.372900,508110938.793600,2100469059.016600,320536,81705,158404,560645
2019-06-07,FINRA / Nasdaq TRF Chicago (DB),3822023,1961953,4819848,10603824,127368220.762400,107422409.295800,335648565.454000,570439195.512200,13241,6089,22931,42261
2019-06-07,FINRA / NYSE TRF (DN),199532988,87942892,202018085,489493965,5843360877.073996,3059815728.735199,9637789665.918905,18540966271.728100,470812,169553,550968,1191333
2019-06-07,FINRA / Nasdaq TRF Carteret (DQ),961144699,368120314,671229707,2000494720,37114427998.222206,21748408336.309002,35174813036.675405,94037649371.206613,3568290,783114,2312979,6664383
2019-06-07,EDGA Equities (J),79582756,23793448,38681043,142057247,3168540793.012100,1352204530.647500,1874295073.008600,6395040396.668200,989424,139908,494089,1623421
2019-06-07,EDGX Equities (K),120773745,64744794,94742848,280261387,4500875633.303799,4278061209.632000,5280178576.238403,14059115419.174202,1149693,281649,798448,2229790
2019-06-07,NYSE Chicago (M),7118157,13793108,7504471,28415736,360857166.929900,1261028084.480000,926528861.269000,2548414112.678900,4565,4269,5941,14775
2019-06-07,NYSE (N),728015450,39484312,37220095,804719857,29262892181.961501,2197581340.336399,1984277577.975000,33444751100.272900,2463810,89693,209240,2762743
2019-06-07,NYSE Arca (P),170958314,250289907,152721088,573969309,6491692718.674999,14522264535.499097,8711133201.288003,29725090455.462099,1367466,656041,1283981,3307488
2019-06-07,NASDAQ (Q),419668614,179155001,565302809,1164126424,18529718357.205098,11043151490.495595,34739870670.368989,64312740518.069682,3973262,710724,4040208,8724194
2019-06-07,IEX (V),120759896,18495776,59388423,198644095,5024278124.208400,1236211880.164700,3485027455.408200,9745517459.781300,828328,87343,456302,1371973
2019-06-07,NASDAQ PSX (X),19944297,19300711,14887232,54132240,637338962.793000,1190312662.145700,1126476694.935700,2954128319.874400,134773,70019,128437,333229
2019-06-07,BYX Equities (Y),147737094,60629020,63961827,272327941,4412803020.123600,3094031457.802301,2673517663.014000,10180352140.939901,1482658,330391,699939,2512988
2019-06-07,BZX Equities (Z),157864185,86344271,109701811,353910267,6801081413.548601,5893088629.226601,7265090497.048801,19959260539.824003,1480167,374216,1017644,2872027
2019-06-06,NYSE American (A),6433515,12553821,3210524,22197860,257209391.831900,207082074.154200,163878899.266600,628170365.252700,68956,50814,35606,155376
2019-06-06,NASDAQ BX (B),58250217,28017159,28713772,114981148,2387864966.551300,1303725818.918000,1580695429.491100,5272286214.960400,585690,112782,301588,1000060
2019-06-06,NYSE National (C),39431258,18128691,16244077,73804026,931417808.600400,681536539.560300,474250648.035800,2087204996.196500,327555,83653,157479,568687
2019-06-06,FINRA / Nasdaq TRF Chicago (DB),4553487,1784844,4524305,10862636,130298364.473700,105343561.170900,250285398.806000,485927324.450600,13991,5712,20301,40004
2019-06-06,FINRA / NYSE TRF (DN),199801880,82445208,200054517,482301605,5288749945.111500,2764409333.039099,7920376978.528097,15973536256.678696,448989,159639,493109,1101737
2019-06-06,FINRA / Nasdaq TRF Carteret (DQ),1049902639,377383951,699300209,2126586799,40143917619.053504,22457819842.636598,32316397863.086605,94918135324.776707,3648331,753233,2160921,6562485
2019-06-06,EDGA Equities (J),78193293,23641142,36945109,138779544,3133200844.465500,1366172973.850300,1692115406.719200,6191489225.035000,974687,140101,484049,1598837
2019-06-06,EDGX Equities (K),130099620,65879772,94038478,290017870,4611135702.131500,4280325824.709099,4513554158.743998,13405015685.584597,1213827,298770,775863,2288460
2019-06-06,NYSE Chicago (M),8026217,14319066,7515291,29860574,387770739.351000,1139192764.462000,999041004.114800,2526004507.927800,4988,3172,4615,12775
2019-06-06,NYSE (N),789856605,36045396,35903191,861805192,32143016673.203900,2192976854.764901,1680709858.609100,36016703386.577901,2704989,92658,204293,3001940
2019-06-06,NYSE Arca (P),173864741,251230170,144713830,569808741,6306002440.763901,15029965042.980793,7042069898.217403,28378037381.962097,1391080,663806,1235633,3290519
2019-06-06,NASDAQ (Q),448567709,175366832,578619577,1202554118,19544588087.872600,10936203452.035795,29574251115.399810,60055042655.308205,4261191,702470,3937843,8901504
2019-06-06,IEX (V),118463240,17861810,58686898,195011948,4925274279.648600,1269320407.634700,3029115594.424901,9223710281.708201,842417,87651,436638,1366706
2019-06-06,NASDAQ PSX (X),19498415,18772869,14184554,52455838,634559063.658700,1119834207.411600,976818422.485900,2731211693.556200,137304,72530,123534,333368
2019-06-06,BYX Equities (Y),155858146,62615019,65172267,283645432,4533657681.715900,3138495165.988601,2429896298.853900,10102049146.558401,1562105,336563,723075,2621743
2019-06-06,BZX Equities (Z),164348951,86169761,105645911,356164623,6749909433.385600,5916381131.914403,5815111902.088100,18481402467.388103,1541348,376813,960926,2879087
2019-06-05,NYSE American (A),6729314,14875590,3314604,24919508,295430582.243700,226964726.257000,192050870.325800,714446178.826500,76968,56538,43053,176559
2019-06-05,NASDAQ BX (B),65458876,30879341,32008122,128346339,2759828865.451500,1414746149.914300,1764912891.769400,5939487907.135200,672261,121726,342715,1136702
2019-06-05,NYSE National (C),41648200,24155784,17248660,83052644,989176418.357000,809034988.079200,541878700.884900,2340090107.321100,349521,98653,174481,622655
2019-06-05,FINRA / Nasdaq TRF Chicago (DB),4649406,2055021,4747006,11451433,153064333.365200,106402446.019400,297509005.947300,556975785.331900,15352,6184,22486,44022
2019-06-05,FINRA / NYSE TRF (DN),207634705,99271189,211065829,517971723,5867891499.628999,3195114258.807000,9172648786.100300,18235654544.536299,473495,183750,524135,1181380
2019-06-05,FINRA / Nasdaq TRF Carteret (DQ),1046318033,426258766,675354348,2147931147,40430780647.591507,24103202551.274307,33658423123.814706,98192406322.680520,3900474,827942,2337855,7066271
2019-06-05,EDGA Equities (J),82826760,27419468,40809711,151055939,3362447347.233100,1361911417.721400,1934787276.247600,6659146041.202100,1040993,157446,534415,1732854
2019-06-05,EDGX Equities (K),136404569,75682127,101380470,313467166,4997493656.651100,4668517930.119100,4986974976.402799,14652986563.172999,1310873,344819,859361,2515053
2019-06-05,NYSE Chicago (M),8580265,12257684,5337197,26175146,521287322.185600,1338951100.155000,705307016.870300,2565545439.210900,5581,5003,6697,17281
2019-06-05,NYSE (N),819066142,41382865,36543442,896992449,33606755358.704600,2487491975.394100,1846154135.633900,37940401469.732600,2931592,113825,236861,3282278
2019-06-05,NYSE Arca (P),179951627,313096456,163375655,656423738,7069063341.352701,17678820136.072897,8432768234.602796,33180651712.028394,1544959,816346,1407796,3769101
2019-06-05,NASDAQ (Q),477043891,196426180,584982713,1258452784,21490311215.142600,11368650398.427400,33224594189.749116,66083555803.319116,4948372,808262,4475646,10232280
2019-06-05,IEX (V),130419747,20416652,62891951,213728350,5525554303.963000,1250141235.906300,3503941605.332001,10279637145.201301,939428,97171,498069,1534668
2019-06-05,NASDAQ PSX (X),19745217,19870155,14367916,53983288,691949616.046500,1141410643.479900,995323246.971700,2828683506.498100,148068,76785,129405,354258
2019-06-05,BYX Equities (Y),160683898,75658083,69323197,305665178,4687156439.517800,3484686101.438299,2741213552.378900,10913056093.334999,1649890,396788,802685,2849363
2019-06-05,BZX Equities (Z),183599828,100622934,116543749,400766511,7726574415.378300,6259812860.985597,6629136777.437300,20615524053.801197,1773214,434503,1120956,3328673
2019-06-04,NYSE American (A),7761252,15590586,3905751,27257589,339899485.688300,272772090.490800,255310755.857000,867982332.036100,87897,60788,47121,195806
2019-06-04,NASDAQ BX (B),72489356,33761878,38777681,145028915,3089929372.311100,1684925111.532200,2300204639.124901,7075059122.968201,721797,139636,397888,1259321
2019-06-04,NYSE National (C),46172712,22982425,19122427,88277564,1172519145.415500,863348615.932900,691318191.713900,2727185953.062300,379151,100693,188147,667991
2019-06-04,FINRA / Nasdaq TRF Chicago (DB),4049740,1878514,5059156,10987410,140567903.809500,101992211.607900,348274460.504300,590834575.921700,13917,5967,22448,42332
2019-06-04,FINRA / NYSE TRF (DN),201936433,92267118,235062810,529266361,5827695419.436297,3171508814.769600,10934961839.716896,19934166073.922793,487958,189659,542631,1220248
2019-06-04,FINRA / Nasdaq TRF Carteret (DQ),1120086790,395288716,716357532,2231733038,44265837989.554497,23345700828.813297,36836873070.426292,104448411888.794086,4174614,942759,2585313,7702686
2019-06-04,EDGA Equities (J),92327655,29759023,48833772,170920450,3801887703.377900,1708658998.537900,2431794141.074600,7942340842.990400,1159862,180593,628278,1968733
2019-06-04,EDGX Equities (K),143786382,76442069,111496532,331724983,5458841670.060098,5147219730.212000,5845653925.741001,16451715326.013099,1424600,359783,956560,2740943
2019-06-04,NYSE Chicago (M),9894814,15354790,7756110,33005714,377821507.711100,1517280657.460000,1003614600.634000,2898716765.805100,5183,4773,7404,17360
2019-06-04,NYSE (N),889041960,42762921,45153549,976958430,35068370166.377796,2658022177.805600,2326455394.640398,40052847738.823794,3068056,113519,261117,3442692
2019-06-04,NYSE Arca (P),195756426,292157412,174938500,662852338,7945025780.257902,17154044673.112408,9853178206.510005,34952248659.880315,1685060,809609,1526963,4021632
2019-06-04,NASDAQ (Q),506799859,200140534,675325182,1382265575,23380741246.496497,12771038269.605392,38954412350.183909,75106191866.285798,4996912,829271,4711794,10537977
2019-06-04,IEX (V),132246259,21145028,66937452,220328739,5843823224.892599,1385275044.589400,4173764527.342099,11402862796.824098,986319,107333,547379,1641031
2019-06-04,NASDAQ PSX (X),22512744,21536824,16786510,60836078,741255714.559500,1356682523.076900,1213359039.690500,3311297277.326900,160842,86555,142535,389932
2019-06-04,BYX Equities (Y),176997408,74087239,77964800,329049447,5317191529.866500,3828120668.459701,3291829650.334600,12437141848.660801,1800145,413488,881854,3095487
2019-06-04,BZX Equities (Z),192273269,98855990,130652772,421782031,8353608829.661400,6794763470.107398,7735897173.766699,22884269473.535497,1881072,441632,1234398,3557102
2019-06-03,NYSE American (A),8614497,16160248,4026817,28801562,359823907.308800,297399493.304500,263133564.303400,920356964.916700,95843,63355,48951,208149
2019-06-03,NASDAQ BX (B),72003568,38489913,40143817,150637298,2985972150.562600,1806819244.292800,2573365515.649400,7366156910.504800,751274,162034,434338,1347646
2019-06-03,NYSE National (C),49906073,28326358,20521345,98753776,1158110997.648700,999181063.310800,698746721.595300,2856038782.554800,412466,127150,203450,743066
2019-06-03,FINRA / Nasdaq TRF Chicago (DB),4930141,2393942,5796687,13120770,173055150.853700,143486967.812300,418382413.766800,734924532.432800,16170,7677,28037,51884
2019-06-03,FINRA / NYSE TRF (DN),197514430,112786086,242852534,553153050,5653561928.231299,4251800692.287202,12035926900.541405,21941289521.059906,498197,215875,593366,1307438
2019-06-03,FINRA / Nasdaq TRF Carteret (DQ),1073130580,566030458,773759906,2412920944,41130991216.132993,33223292528.991392,44953050131.490510,119307333876.614895,4330979,1082975,2895217,8309171
2019-06-03,EDGA Equities (J),95845517,35987276,48882831,180715624,3741792631.590300,1920131017.114100,2621539617.661600,8283463266.366000,1205120,194526,645378,2045024
2019-06-03,EDGX Equities (K),149963150,95459613,123342937,368765700,5554845807.333301,6412385549.167300,7151321130.094801,19118552486.595402,1545605,441215,1092904,3079724
2019-06-03,NYSE Chicago (M),11192638,14483004,8124248,33799890,574311583.074400,1400848961.000000,1205723389.548400,3180883933.622800,6154,5621,9071,20846
2019-06-03,NYSE (N),982283403,58391961,50981304,1091656668,38438637988.262601,3663654938.869600,2774009830.257300,44876302757.389501,3548201,158410,316000,4022611
2019-06-03,NYSE Arca (P),198801428,363450278,199801396,762053102,8040177986.389898,21141443407.841701,12562347565.762797,41743968959.994396,1773425,1026438,1776237,4576100
2019-06-03,NASDAQ (Q),547756719,252526315,731190137,1531473171,24942684615.398407,16100071082.666606,46918814737.400916,87961570435.465929,5656035,1083648,5686085,12425768
2019-06-03,IEX (V),133767005,29320534,72643292,235730831,5818214125.085000,1919039414.587500,5142225823.974700,12879479363.647200,1016660,132063,595864,1744587
2019-06-03,NASDAQ PSX (X),25511393,29747044,22505635,77764072,839075763.569500,1937119973.454600,1803174883.091500,4579370620.115600,179482,120525,190464,490471
2019-06-03,BYX Equities (Y),192719690,90904887,86728189,370352766,5501586302.882000,4671856325.062099,3906914772.155701,14080357400.099800,1976336,501976,1001814,3480126
2019-06-03,BZX Equities (Z),208427128,135560678,149378739,493366545,8728150556.724100,9094605791.104801,9816749814.290297,27639506162.119198,2045646,612994,1440376,4099016
2019-05-31,NYSE American (A),8221102,16154691,3827808,28203601,329988357.803400,286646172.343200,219801958.252600,836436488.399200,93198,62032,47025,202255
2019-05-31,NASDAQ BX (B),69984215,34857691,34793320,139635226,2770543505.087900,1539138237.401800,1933264382.059600,6242946124.549300,700181,147295,360646,1208122
2019-05-31,NYSE National (C),46387912,27891937,19762884,94042733,1067903675.506900,993098967.727700,581911816.674800,2642914459.909400,380923,119316,186328,686567
2019-05-31,FINRA / Nasdaq TRF Chicago (DB),4351584,2231714,4738838,11322136,132132199.935500,89903306.394800,284364425.238100,506399931.568400,14310,6685,20200,41195
2019-05-31,FINRA / NYSE TRF (DN),210197450,106863200,207805760,524866410,6106990082.551900,3459865739.550202,7952644636.583001,17519500458.685103,486826,201920,489641,1178387
2019-05-31,FINRA / Nasdaq TRF Carteret (DQ),1153529467,508555932,673693326,2335778725,42534826394.084594,28355823850.035196,32658068476.419683,103548718720.539473,4170267,997522,2396244,7564033
2019-05-31,EDGA Equities (J),93735968,33573583,44958662,172268213,3678834790.163200,1787988118.836300,2185332159.611200,7652155068.610700,1022255,174759,516763,1713777
2019-05-31,EDGX Equities (K),146325095,85820438,105916435,338061968,5292931274.875600,5339724603.375802,5132018489.200603,15764674367.452005,1233546,339409,822697,2395652
2019-05-31,NYSE Chicago (M),23121943,13394528,6929099,43445570,890143394.839400,1118530438.924800,610164110.132700,2618837943.896900,5366,4773,5976,16115
2019-05-31,NYSE (N),994517908,52466493,41938032,1088922433,37848504271.359593,2964814524.318300,2027621488.299100,42840940283.976993,3043927,127502,248023,3419452
2019-05-31,NYSE Arca (P),195489347,325963732,164366053,685819132,7509141652.033300,18457841163.059800,8453469358.061500,34420452173.154600,1586474,848414,1414223,3849111
2019-05-31,NASDAQ (Q),499610693,236997732,650904013,1387512438,21944281496.029996,13974800455.585594,35180190175.110200,71099272126.725790,4767847,884186,4323598,9975631
2019-05-31,IEX (V),140823139,26241067,65681429,232745635,5635453267.360301,1703128673.148700,3447862265.654700,10786444206.163701,999832,115936,520483,1636251
2019-05-31,NASDAQ PSX (X),22337070,25861294,16194784,64393148,755747807.982300,1562741481.814500,1209056323.639700,3527545613.436500,162601,102396,138083,403080
2019-05-31,BYX Equities (Y),179093530,83634662,76185289,338913481,5069890958.649700,3859370622.154801,3088289005.587100,12017550586.391601,1734442,436181,828301,2998924
2019-05-31,BZX Equities (Z),194945698,120140255,121725852,436811805,8063560949.309699,7584102757.141702,7186510799.002098,22834174505.453499,1784754,503097,1146394,3434245
2019-05-30,NYSE American (A),6387298,12043464,2968606,21399368,257528795.785400,189844271.880200,152147222.161100,599520289.826700,72738,46579,35320,154637
2019-05-30,NASDAQ BX (B),63463230,28965298,29696552,122125080,2332846151.482200,1241640378.887400,1438688863.603400,5013175393.973000,623237,116276,315019,1054532
2019-05-30,NYSE National (C),42958121,20419279,17197096,80574496,963883495.510400,713662841.815200,480728716.147600,2158275053.473200,349165,87759,170019,606943
2019-05-30,FINRA / Nasdaq TRF Chicago (DB),4135150,1863573,4336947,10335670,128618547.406600,103939039.332300,226985058.897000,459542645.635900,12964,5680,18351,36995
2019-05-30,FINRA / NYSE TRF (DN),186707229,84794938,188942393,460444560,5294907712.494500,2903224049.492599,6881048708.858096,15079180470.845195,421960,160970,457001,1039931
2019-05-30,FINRA / Nasdaq TRF Carteret (DQ),967085473,324832684,569521563,1861439720,34613473961.942504,18997758039.090394,24482475535.538595,78093707536.571493,3591803,737046,2147657,6476506
2019-05-30,EDGA Equities (J),81028115,25224364,38002062,144254541,3018244459.461700,1302909452.538800,1583933217.850700,5905087129.851200,873172,132323,447289,1452784
2019-05-30,EDGX Equities (K),126372202,64231612,94169886,284773700,4560905302.880999,4040731710.019500,4204020275.275799,12805657288.176298,1065975,263082,739641,2068698
2019-05-30,NYSE Chicago (M),18912320,17199479,5901285,42013084,817483580.266000,1365844915.080000,671112629.695000,2854441125.041000,4344,3228,5415,12987
2019-05-30,NYSE (N),699786749,38776369,36510275,775073393,25101507097.936598,2250777634.030900,1650284531.823200,29002569263.790698,2633625,96685,208877,2939187
2019-05-30,NYSE Arca (P),168873305,231186012,140181172,540240489,6382916555.682599,12904564670.143999,6698224624.160096,25985705849.986694,1222774,628132,1122675,2973581
2019-05-30,NASDAQ (Q),437522050,176241186,499048521,1112811757,18552240817.524601,10434699605.902993,25229442898.659894,54216383322.087488,4107702,709351,3753039,8570092
2019-05-30,IEX (V),124478791,17228273,58579657,200286721,4935871995.548600,1124076209.692100,2945649577.220097,9005597782.460797,868497,85855,466624,1420976
2019-05-30,NASDAQ PSX (X),20789341,19120480,14339579,54249400,615111213.653500,1181288655.024200,887936671.540500,2684336540.218200,135005,73621,119817,328443
2019-05-30,BYX Equities (Y),157278064,63854365,66886349,288018778,4330372334.370000,3033131808.952701,2436253461.622700,9799757604.945401,1539180,337495,746341,2623016
2019-05-30,BZX Equities (Z),170252907,87290117,108907651,366450675,6835711154.377201,5475960510.040200,5787125603.641999,18098797268.059400,1601912,387256,1040996,3030164
2019-05-29,NYSE American (A),7795720,13449087,3824644,25069451,338639228.110600,257053037.884600,200920174.633000,796612440.628200,86259,56435,44763,187457
2019-05-29,NASDAQ BX (B),67041742,34802539,36914854,138759135,2600713745.761600,1631021483.848800,1932899963.143100,6164635192.753500,671042,135159,380268,1186469
2019-05-29,NYSE National (C),48769490,25843439,21509099,96122028,1110857696.811600,893822201.629500,619309552.358800,2623989450.799900,403626,107870,210109,721605
2019-05-29,FINRA / Nasdaq TRF Chicago (DB),4172788,1992592,4846941,11012321,131876152.847200,86014038.856800,309980759.797100,527870951.501100,13612,6017,21801,41430
2019-05-29,FINRA / NYSE TRF (DN),196149181,101171024,209708905,507029110,5598333651.586898,3703529854.553298,9059819478.512401,18361682984.652597,471661,190166,529708,1191535
2019-05-29,FINRA / Nasdaq TRF Carteret (DQ),1102053989,436314840,698597671,2236966500,40827255049.576703,28349279018.168887,31912060066.484598,101088594134.230188,4207386,1005713,2561173,7774272
2019-05-29,EDGA Equities (J),87780732,30131009,44631382,162543123,3421833503.922200,1620664221.528900,2021983288.549000,7064481014.000100,970462,158057,524021,1652540
2019-05-29,EDGX Equities (K),136078658,77893741,108282198,322254597,5272063287.148499,5599758311.883704,5428736772.847200,16300558371.879403,1204681,347337,868160,2420178
2019-05-29,NYSE Chicago (M),11959243,12396496,5244150,29599889,529703316.327400,1267882540.134000,670786538.896900,2468372395.358300,5159,4401,7094,16654
2019-05-29,NYSE (N),823143709,46769658,45574925,915488292,32707368407.126697,3136942208.636800,2114072382.895499,37958382998.658996,3297138,129688,260191,3687017
2019-05-29,NYSE Arca (P),185910722,285753041,169563972,641227735,7338061709.099795,17305271951.238597,8468284116.174599,33111617776.512991,1445161,822074,1362603,3629838
2019-05-29,NASDAQ (Q),508884969,212447821,639850523,1361183313,23087159836.596196,14136864707.008693,34535981359.703904,71760005903.308793,5012285,943551,4872905,10828741
2019-05-29,IEX (V),134343340,20665514,71511928,226520782,5572383898.574300,1567914041.460900,3958940536.050200,11099238476.085400,1008221,105065,544040,1657326
2019-05-29,NASDAQ PSX (X),22398691,23186171,16756010,62340872,750749337.391600,1457335127.973900,965394215.759200,3173478681.124700,159887,101420,152487,413794
2019-05-29,BYX Equities (Y),172389109,75062789,78057316,325509214,4955853045.770001,3788241562.834800,3027986475.380000,11772081083.984801,1763450,406240,877425,3047115
2019-05-29,BZX Equities (Z),192246332,105720518,127248748,425215598,8314137492.828001,7778597973.644799,7117109916.659698,23209845383.132498,1914306,504687,1261943,3680936
2019-05-28,NYSE American (A),6943395,19342729,3449184,29735308,295806818.288400,430900602.965100,178290497.330700,904997918.584200,74824,51414,37662,163900
2019-05-28,NASDAQ BX (B),63916807,32418252,31597474,127932533,2555559550.441300,1530018668.502200,1617819433.444300,5703397652.387800,641666,136068,339707,1117441
2019-05-28,NYSE National (C),46884121,22082750,20428835,89395706,1073021083.218800,914105445.856400,582191480.034300,2569318009.109500,374911,101531,192909,669351
2019-05-28,FINRA / Nasdaq TRF Chicago (DB),4427310,1610957,5016669,11054936,138614192.211900,63873962.246400,289837360.114000,492325514.572300,13017,4583,21658,39258
2019-05-28,FINRA / NYSE TRF (DN),175972417,75398594,192454522,443825533,4933663626.075298,2467856413.731599,8044640727.645600,15446160767.452497,434739,157544,497328,1089611
2019-05-28,FINRA / Nasdaq TRF Carteret (DQ),1105304311,416180075,709691573,2231175959,44619960523.880292,23423942177.558794,34051315311.994496,102095218013.433582,3743288,812695,2340105,6896088
2019-05-28,EDGA Equities (J),83483124,27750506,40539467,151773097,3321982805.200300,1498210553.233200,1863297194.154500,6683490552.588000,921080,155368,471797,1548245
2019-05-28,EDGX Equities (K),128581138,60364151,95817660,284762949,4730312690.250300,4062731921.569903,4645319894.939197,13438364506.759400,1087526,269310,771900,2128736
2019-05-28,NYSE Chicago (M),10265578,10706647,6409020,27381245,492140173.494000,1039698221.238400,603348831.174700,2135187225.907100,5396,3922,6411,15729
2019-05-28,NYSE (N),1444865218,34279037,39302172,1518446427,65834673666.906999,2134283111.663500,1701755301.091600,69670712079.662099,2871663,92347,221532,3185542
2019-05-28,NYSE Arca (P),172919773,253897283,148421042,575238098,6517630017.935598,14965157041.731799,7473554567.678302,28956341627.345699,1232397,636194,1190265,3058856
2019-05-28,NASDAQ (Q),438992205,164867980,827646910,1431507095,19510450188.338703,10844076569.983499,46435177811.883494,76789704570.205696,4215945,702755,4215480,9134180
2019-05-28,IEX (V),115934358,20900210,58789530,195624098,4951955266.877601,1414842132.683400,3222561822.022800,9589359221.583801,847313,99007,465142,1411462
2019-05-28,NASDAQ PSX (X),19989585,16290729,13696313,49976627,665821886.005000,1049460600.746200,841942944.442000,2557225431.193200,136229,69051,125329,330609
2019-05-28,BYX Equities (Y),157108397,72086159,71091752,300286308,4638773173.331900,3644455171.559999,2885589662.664200,11168818007.556099,1567509,398908,795378,2761795
2019-05-28,BZX Equities (Z),171398083,82502508,114127490,368028081,7243625869.131102,5735112544.509899,6159447310.056699,19138185723.697700,1660279,380293,1097286,3137858
2019-05-24,NYSE American (A),5430269,11612865,2602587,19645721,232496310.702900,199881878.696700,142965634.528600,575343823.928200,59201,43685,31098,133984
2019-05-24,NASDAQ BX (B),56599204,23541449,27353200,107493853,2285357503.769200,1124013433.843000,1549911979.209800,4959282916.822000,579399,100380,308240,988019
2019-05-24,NYSE National (C),36545364,15604765,16075638,68225767,834579457.780900,577519470.809800,476029004.718700,1888127933.309400,302555,71856,158474,532885
2019-05-24,FINRA / Nasdaq TRF Chicago (DB),3233349,1075223,3810166,8118738,113303373.521700,46060346.083100,242308946.964100,401672666.568900,11185,3637,17482,32304
2019-05-24,FINRA / NYSE TRF (DN),168683030,67039338,170214228,405936596,4903649870.118202,2297122722.056500,7020961954.176797,14221734546.351499,396317,136091,414046,946454
2019-05-24,FINRA / Nasdaq TRF Carteret (DQ),877134357,260966222,525858017,1663958596,33327536736.078510,16144410166.304591,24555319644.700495,74027266547.083596,3318001,638725,1967619,5924345
2019-05-24,EDGA Equities (J),72359458,21393141,35134889,128887488,2906223738.735600,1135975900.398000,1679899794.142300,5722099433.275900,808602,118606,420142,1347350
2019-05-24,EDGX Equities (K),107694618,49334659,80605979,237635256,4127372615.862601,3103426975.484801,4150437338.757097,11381236930.104499,918591,217602,641353,1777546
2019-05-24,NYSE Chicago (M),4848992,7069325,6345441,18263758,305242694.290000,733676774.158500,477010707.532900,1515930175.981400,4811,3193,5732,13736
2019-05-24,NYSE (N),639716977,31167821,28886560,699771358,25409269752.164300,1814093078.478400,1385425010.270900,28608787840.913600,2234408,83571,184395,2502374
2019-05-24,NYSE Arca (P),142653559,182883389,128212439,453749387,5922289646.153697,10789494231.180499,6649480120.344202,23361263997.678398,1083640,535991,1023804,2643435
2019-05-24,NASDAQ (Q),381315843,134277381,459253670,974846894,18051882360.509800,7814207128.515603,26159540264.414602,52025629753.440005,3668308,579869,3445384,7693561
2019-05-24,IEX (V),101125555,14586842,48795547,164507944,4427558412.972199,1000272861.757700,2703491804.669000,8131323079.398899,749854,74492,399506,1223852
2019-05-24,NASDAQ PSX (X),17254752,14288702,11253660,42797114,594269760.529600,785212317.388000,804485989.026800,2183968066.944400,120958,59918,107389,288265
2019-05-24,BYX Equities (Y),134870502,51097495,56200511,242168508,4119306447.505301,2492470639.478799,2328695708.002000,8940472794.986100,1377383,295764,664871,2338018
2019-05-24,BZX Equities (Z),139768728,65954166,84628448,290351342,5916909271.250900,4254211650.400200,5070538878.018900,15241659799.670000,1321001,311370,849679,2482050
2019-05-23,NYSE American (A),7763781,14820367,3803473,26387621,344214960.477000,236357685.820200,210352629.214500,790925275.511700,81251,51827,41878,174956
2019-05-23,NASDAQ BX (B),74874639,38770844,38897072,152542555,2934213932.978300,1686356792.014000,2118607016.968800,6739177741.961100,734314,149152,410835,1294301
2019-05-23,NYSE National (C),50892382,27474622,22455592,100822596,1193965150.328800,978009156.610700,668744010.607700,2840718317.547200,410662,116447,202617,729726
2019-05-23,FINRA / Nasdaq TRF Chicago (DB),4904711,2156286,5256585,12317582,169234033.607500,112807943.884800,341527130.530900,623569108.023200,15647,6523,23040,45210
2019-05-23,FINRA / NYSE TRF (DN),229922731,104348670,214412314,548683715,6240749534.252902,3505643411.615199,9155412127.616302,18901805073.484403,503441,203178,519010,1225629
2019-05-23,FINRA / Nasdaq TRF Carteret (DQ),1129445434,424730611,651318196,2205494241,40739190112.686393,24643072595.919704,31255719032.816595,96637981741.422692,4111913,974565,2488119,7574597
2019-05-23,EDGA Equities (J),95599497,31477348,46074283,173151128,3703499901.326000,1626020673.987400,2203188849.214900,7532709424.528300,984076,163350,501773,1649199
2019-05-23,EDGX Equities (K),146737818,84899486,108609426,340246730,5440141200.587200,5559118234.718599,5869899750.880500,16869159186.186299,1176313,349004,845378,2370695
2019-05-23,NYSE Chicago (M),19388682,12540533,12754716,44683931,775954714.225200,1106688288.914000,1064186785.843600,2946829788.982800,4764,4518,7289,16571
2019-05-23,NYSE (N),869912550,50689243,43052531,963654324,33894968806.569898,3190805388.780901,2182193446.354400,39267967641.705199,2905021,131318,240202,3276541
2019-05-23,NYSE Arca (P),209173246,298212484,172637061,680022791,7805930687.422502,17768403476.365498,9557030621.247399,35131364785.035399,1465037,862834,1363982,3691853
2019-05-23,NASDAQ (Q),520028835,228128500,665825092,1413982427,23403514384.688704,14081947821.331606,37728042949.559401,75213505155.579711,4841177,949286,4619637,10410100
2019-05-23,IEX (V),138587530,23041404,69575627,231204561,5798572103.871398,1532739286.325900,3940721876.339900,11272033266.537198,982036,108657,534183,1624876
2019-05-23,NASDAQ PSX (X),26862915,26189460,16983561,70035936,779278750.035800,1621917902.489400,1117865669.501700,3519062322.026900,168372,97864,149703,415939
2019-05-23,BYX Equities (Y),180185188,84539482,75253203,339977873,5210805132.895900,4075878092.218098,3128201663.639700,12414884888.753698,1752586,449003,824738,3026327
2019-05-23,BZX Equities (Z),195049115,112328250,123629383,431006748,8089232563.347301,7764229721.786001,7326503045.716004,23179965330.849306,1766345,510300,1164053,3440698
2019-05-22,NYSE American (A),6791662,10588678,2945458,20325798,248087193.389500,156689403.703600,162215834.603000,566992431.696100,63366,41833,31637,136836
2019-05-22,NASDAQ BX (B),56245030,24547872,27926615,108719517,2166092885.380900,1114656097.123200,1552722443.899400,4833471426.403500,566272,100845,300888,968005
2019-05-22,NYSE National (C),40805533,17142129,16462266,74409928,993445305.543900,629110245.349200,516770952.700100,2139326503.593200,342808,77564,159104,579476
2019-05-22,FINRA / Nasdaq TRF Chicago (DB),2955681,1224236,3547614,7727531,103341444.911300,57425840.447400,228385440.129300,389152725.488000,11135,4286,16851,32272
2019-05-22,FINRA / NYSE TRF (DN),200983453,66848435,190359123,458191011,5872693699.517799,2157050640.672099,7464134265.147005,15493878605.336903,444721,143000,472536,1060257
2019-05-22,FINRA / Nasdaq TRF Carteret (DQ),979820094,302764531,595000833,1877585458,37147179238.871208,16564182973.821898,26991326645.894400,80702688858.587506,3533671,649329,2142257,6325257
2019-05-22,EDGA Equities (J),80860084,22517273,37043051,140420408,3319708433.035900,1163013431.772600,1824099131.670000,6306820996.478500,868791,124677,422507,1415975
2019-05-22,EDGX Equities (K),122290531,52745001,95042726,270078258,4674836742.499700,3161742532.085802,4576901143.646499,12413480418.232001,981159,240037,690946,1912142
2019-05-22,NYSE Chicago (M),10780381,11406556,10323822,32510759,479919774.993600,1351407221.110000,994924836.844900,2826251832.948500,3758,3319,5727,12804
2019-05-22,NYSE (N),685778499,30207236,31414989,747400724,26586648217.187295,1722050708.041600,1464542799.265200,29773241724.494095,2302976,86313,177594,2566883
2019-05-22,NYSE Arca (P),167554911,194621389,154745317,516921617,6808758960.323001,11035974472.139297,7390672061.999598,25235405494.461896,1219093,567638,1122192,2908923
2019-05-22,NASDAQ (Q),421921892,147178188,505474998,1074575078,18645485233.522702,8554640252.748101,27116501966.946407,54316627453.217210,3757625,603832,3552564,7914021
2019-05-22,IEX (V),114733465,12767138,57933378,185433981,5055709204.470500,789095051.603800,3144621799.472500,8989426055.546800,821921,67893,450711,1340525
2019-05-22,NASDAQ PSX (X),19152760,16159852,12362566,47675178,572523208.147500,988655831.103000,867547281.796900,2428726321.047400,125538,64067,109174,298779
2019-05-22,BYX Equities (Y),149200484,53548864,61142726,263892074,4469400924.854999,2637520267.533300,2514983843.841300,9621905036.229599,1451902,304876,688969,2445747
2019-05-22,BZX Equities (Z),134134096,64472489,82935346,281541931,5352327623.523199,4102880582.234899,4652923178.457702,14108131384.215800,1218172,314840,784062,2317074
2019-05-21,NYSE American (A),6259671,11636886,3221973,21118530,265158660.863100,174562185.337800,168990352.056500,608711198.257400,69683,44922,36430,151035
2019-05-21,NASDAQ BX (B),59276101,23869742,29420202,112566045,2386532239.664700,1114386982.488900,1635904157.583700,5136823379.737300,606545,98400,326097,1031042
2019-05-21,NYSE National (C),38376393,15939837,17236536,71552766,991455599.658300,600434277.587100,564821277.233900,2156711154.479300,318987,71804,163203,553994
2019-05-21,FINRA / Nasdaq TRF Chicago (DB),2474992,1076835,3596877,7148704,91230427.901100,55055661.511200,233433552.609400,379719642.021700,9713,3786,16678,30177
2019-05-21,FINRA / NYSE TRF (DN),174371051,65789185,194348505,434508741,5300692754.546102,2172380404.243100,7742953983.577799,15216027142.367001,415149,145787,479802,1040738
2019-05-21,FINRA / Nasdaq TRF Carteret (DQ),1003220471,302644049,659336895,1965201415,38914970125.170699,17368679652.648393,29701204837.225497,85984854615.044589,3559291,685867,2253726,6498884
2019-05-21,EDGA Equities (J),80781865,19482604,37492701,137757170,3330586209.226300,1109164428.090800,1811879847.041200,6251630484.358300,879012,116458,443926,1439396
2019-05-21,EDGX Equities (K),118437179,48582147,95361695,262381021,4665755047.279299,2865175362.416401,4628566813.781999,12159497223.477699,983626,217903,721318,1922847
2019-05-21,NYSE Chicago (M),7776182,12447474,7361112,27584768,398414643.093900,887081730.365000,718187484.732700,2003683858.191600,3692,2459,5160,11311
2019-05-21,NYSE (N),733921682,29440656,33487520,796849858,29782800766.260501,1734876020.750000,1515123531.702600,33032800318.713101,2325089,82153,201976,2609218
2019-05-21,NYSE Arca (P),164448987,192016900,150609663,507075550,6712186065.105699,11051085745.734099,7241912900.509898,25005184711.349696,1221811,542575,1145046,2909432
2019-05-21,NASDAQ (Q),414848838,141663455,542862350,1099374643,19218807770.616603,8490280727.872800,30037359705.256617,57746448203.746020,3810004,596607,3808816,8215427
2019-05-21,IEX (V),110680810,15204715,60435318,186320843,4794708422.996500,1041913148.030200,3169311615.573900,9005933186.600600,801974,76256,459517,1337747
2019-05-21,NASDAQ PSX (X),20270965,14885395,12837642,47994002,616618951.847600,809277089.921900,808704035.759700,2234600077.529200,129977,57053,110391,297421
2019-05-21,BYX Equities (Y),142522171,52085814,62026366,256634351,4388794901.230300,2664223826.089500,2365203352.746300,9418222080.066100,1409829,301885,695072,2406786
2019-05-21,BZX Equities (Z),145390401,62917865,90496593,298804859,5888577476.215901,4035585188.729699,4917721625.161600,14841884290.107200,1326187,303343,871700,2501230
2019-05-20,NYSE American (A),5999627,12338788,3201304,21539719,252045576.356000,199842694.334900,182093412.153500,633981682.844400,67107,47094,39691,153892
2019-05-20,NASDAQ BX (B),58905787,23337496,33551316,115794599,2351167968.946200,1166114125.018300,1922216401.667200,5439498495.631700,595867,101745,357189,1054801
2019-05-20,NYSE National (C),37943633,17618371,18435332,73997336,907186331.540200,659658706.591700,566574329.457600,2133419367.589500,315203,82196,173956,571355
2019-05-20,FINRA / Nasdaq TRF Chicago (DB),4127778,1756732,5443379,11327889,138235843.523500,97861165.624800,319760593.470200,555857602.618500,13739,5539,23193,42471
2019-05-20,FINRA / NYSE TRF (DN),185042378,75429881,200341804,460814063,5282953649.908600,2550339113.749899,8845958765.304501,16679251528.963000,447105,164359,530159,1141623
2019-05-20,FINRA / Nasdaq TRF Carteret (DQ),982000005,271807751,640392693,1894200449,36811002935.290401,15726913028.616301,32288639872.191086,84826555836.097788,3593471,737584,2464249,6795304
2019-05-20,EDGA Equities (J),77716918,20944314,41726685,140387917,3058235475.807700,1201976606.223600,2133735225.396000,6393947307.427300,830107,129065,482172,1441344
2019-05-20,EDGX Equities (K),120357114,58765141,105743469,284865724,4619314245.180099,3963823383.302401,5464268948.756600,14047406577.239100,1016504,283343,837434,2137281
2019-05-20,NYSE Chicago (M),4917726,13878504,6209162,25005392,403039511.697500,1233081556.820000,735634542.751100,2371755611.268600,5112,3640,7432,16184
2019-05-20,NYSE (N),773210462,35499245,41420408,850130115,30739860792.045503,2333757574.604901,2143988051.986500,35217606418.636904,2576204,108753,247754,2932711
2019-05-20,NYSE Arca (P),171684668,218145095,170156078,559985841,6652217867.884402,13020397343.729902,8992425651.703099,28665040863.317403,1265930,692314,1334672,3292916
2019-05-20,NASDAQ (Q),429623581,162049728,606303027,1197976336,19155360814.805493,10270932333.906000,34688537984.474688,64114831133.186181,4025512,767740,4487168,9280420
2019-05-20,IEX (V),108887573,14198638,60036239,183122450,4659797361.663600,1071856322.189700,3557632891.590698,9289286575.443998,776621,77898,479084,1333603
2019-05-20,NASDAQ PSX (X),20576954,17728749,15766383,54072086,639431996.194300,1083846486.588000,1098234972.434600,2821513455.216900,134415,74507,133180,342102
2019-05-20,BYX Equities (Y),148277295,54208996,66860781,269347072,4459300645.701400,2632926935.818099,2680006585.743800,9772234167.263299,1492488,329977,766078,2588543
2019-05-20,BZX Equities (Z),164479563,78392920,115115790,357988273,6777843850.760200,5595772904.230800,6754756279.364499,19128373034.355499,1509306,396514,1116711,3022531
2019-05-17,NYSE American (A),6518001,17719393,3533185,27770579,266265348.382900,243176681.847200,180302401.656100,689744431.886200,69359,49437,39212,158008
2019-05-17,NASDAQ BX (B),57141700,29237308,32056003,118435011,2216850288.515200,1583303635.699099,1784533324.111500,5584687248.325799,572841,126398,344765,1044004
2019-05-17,NYSE National (C),41982623,21120912,19838755,82942290,986402362.861800,812546374.635600,609199969.978500,2408148707.475900,341395,99842,181736,622973
2019-05-17,FINRA / Nasdaq TRF Chicago (DB),3659007,1919512,5281624,10860143,135709629.124600,121070812.007000,324177207.269300,580957648.400900,12538,5883,22657,41078
2019-05-17,FINRA / NYSE TRF (DN),185665709,83429921,199974950,469070580,5340236078.595402,2781228365.532000,9302188555.424398,17423652999.551800,440490,161326,541364,1143180
2019-05-17,FINRA / Nasdaq TRF Carteret (DQ),886660600,365587210,639084564,1891332374,34229677262.934199,25282642524.179005,31531010058.084702,91043329845.197906,3422151,762755,2359494,6544400
2019-05-17,EDGA Equities (J),81560353,26326499,42936564,150823416,3239191247.672900,1551853985.719000,2266220219.307300,7057265452.699200,871907,153939,494327,1520173
2019-05-17,EDGX Equities (K),119938437,67725100,107179363,294842900,4625270868.507701,4596659862.013199,5885119502.700302,15107050233.221202,996587,297285,816182,2110054
2019-05-17,NYSE Chicago (M),14722194,22965146,8345472,46032812,661276656.417900,2071825667.650200,1136823385.510100,3869925709.578200,4737,4384,6311,15432
2019-05-17,NYSE (N),872005117,44581958,41227452,957814527,35330054191.529099,2922707853.041798,2054765533.821600,40307527578.392497,2630262,118291,244878,2993431
2019-05-17,NYSE Arca (P),167614729,259544032,163575463,590734224,6924847180.962799,15716603534.745504,9004103017.424095,31645553733.132398,1291228,741522,1281939,3314689
2019-05-17,NASDAQ (Q),434177697,191711769,651051219,1276940685,20082111011.941098,12719583414.833898,38472586216.359911,71274280643.134907,4140407,806364,4446216,9392987
2019-05-17,IEX (V),103601646,16329811,59072616,179004073,4275643831.776700,1153635142.705200,3262933748.960800,8692212723.442700,743978,85608,456030,1285616
2019-05-17,NASDAQ PSX (X),21440482,22017669,17360574,60818725,738068113.100300,1437510903.606500,1335221039.249000,3510800055.955800,146348,84009,139863,370220
2019-05-17,BYX Equities (Y),152971282,69821403,69630922,292423607,4409169888.358900,3608436704.620800,2733291289.962100,10750897882.941800,1519830,396270,765482,2681582
2019-05-17,BZX Equities (Z),166390284,97327285,116235180,379952749,7094811091.805497,6898769027.165401,7317172488.675298,21310752607.646196,1539873,465093,1106189,3111155
2019-05-16,NYSE American (A),6260693,12797435,3738684,22796812,273700974.146000,196894158.318500,191669745.167200,662264877.631700,69263,47386,40079,156728
2019-05-16,NASDAQ BX (B),60294114,26694876,31578318,118567308,2393118522.405100,1377480147.460600,1976719130.054900,5747317799.920600,590601,111262,338711,1040574
2019-05-16,NYSE National (C),40563328,19249471,18218374,78031173,1019214928.134700,732852647.208400,592734623.099700,2344802198.442800,333411,86823,176758,596992
2019-05-16,FINRA / Nasdaq TRF Chicago (DB),3854464,1725624,5105161,10685249,151670741.247200,104188830.344900,311427236.145300,567286807.737400,13758,5928,21820,41506
2019-05-16,FINRA / NYSE TRF (DN),204029802,82825101,205771060,492625963,6629882804.117400,2945903493.559600,9797866242.766099,19373652540.443099,545720,174761,596781,1317262
2019-05-16,FINRA / Nasdaq TRF Carteret (DQ),993968870,353446386,704255531,2051670787,39668251874.612605,22437876838.146898,34667815855.534590,96773944568.294093,3596091,809828,2465484,6871403
2019-05-16,EDGA Equities (J),81682647,23908148,42396520,147987315,3400741032.042300,1376224594.622200,2281330836.867700,7058296463.532200,888057,133758,499197,1521012
2019-05-16,EDGX Equities (K),125118947,63550280,106900825,295570052,5049097168.898298,4076734595.797700,5875315025.248000,15001146789.943998,1039481,265790,832253,2137524
2019-05-16,NYSE Chicago (M),8607264,15942293,12032735,36582292,461957786.528500,1340239039.030000,1490964711.915300,3293161537.473800,4740,4017,5642,14399
2019-05-16,NYSE (N),759430278,36957360,39622669,836010307,31296137532.207305,2443802394.624400,2018766528.627500,35758706455.459205,2568551,98665,228528,2895744
2019-05-16,NYSE Arca (P),175669333,231281312,159308703,566259348,7363358318.930100,14066925015.327198,9019672848.236500,30449956182.493798,1298042,664588,1293666,3256296
2019-05-16,NASDAQ (Q),430029659,164248017,577706010,1171983686,19912841496.007702,10908359648.558502,35135538777.345308,65956739921.911512,3995464,696176,4272686,8964326
2019-05-16,IEX (V),109624363,16937786,61404938,187967087,4863102391.121000,1283241411.113400,3477260748.216900,9623604550.451300,797137,80667,473783,1351587
2019-05-16,NASDAQ PSX (X),21459459,19263608,15518350,56241417,693699359.374100,1170689505.755600,1170898861.615200,3035287726.744900,135493,74470,129299,339262
2019-05-16,BYX Equities (Y),150860941,63387613,69232260,283480814,4574203041.462900,3333538753.828200,2870772408.623600,10778514203.914700,1484714,351999,769267,2605980
2019-05-16,BZX Equities (Z),167021624,80455517,115930994,363408135,7215169307.853903,5788943938.604897,7249843394.233700,20253956640.692500,1529954,375413,1113338,3018705
2019-05-15,NYSE American (A),7101009,13537872,3864491,24503372,323070533.158500,181988726.728100,206837011.450600,711896271.337200,78505,44006,46189,168700
2019-05-15,NASDAQ BX (B),55364825,27138403,31394044,113897272,2270036698.308100,1390361000.762000,1839723699.104900,5500121398.175000,570779,109121,330548,1010448
2019-05-15,NYSE National (C),38438894,19912450,18692591,77043935,976608610.826700,778617328.496800,578849349.809100,2334075289.132600,328315,92968,173992,595275
2019-05-15,FINRA / Nasdaq TRF Chicago (DB),3550172,1614990,4662513,9827675,151266136.451500,91164822.257800,303262876.733900,545693835.443200,13428,5504,19524,38456
2019-05-15,FINRA / NYSE TRF (DN),192000611,87549930,187258289,466808830,6111289542.718300,2878367138.734400,8963749095.185698,17953405776.638398,511831,171533,536797,1220161
2019-05-15,FINRA / Nasdaq TRF Carteret (DQ),885314341,316210158,628648062,1830172561,35834836629.314295,19925973902.045593,30588625000.735091,86349435532.094979,3478015,707700,2270262,6455977
2019-05-15,EDGA Equities (J),80226869,24504856,41742710,146474435,3343068056.344800,1401753328.373900,2161670884.815100,6906492269.533800,1014853,151232,550004,1716089
2019-05-15,EDGX Equities (K),123017219,69231377,96131181,288379777,5109030220.455699,4486998660.316899,5480318395.315900,15076347276.088498,1197488,317203,869477,2384168
2019-05-15,NYSE Chicago (M),10225500,19518242,6780448,36524190,509309971.614200,1535074279.158000,872846315.538400,2917230566.310600,4836,5037,6293,16166
2019-05-15,NYSE (N),723663707,44347438,38687967,806699112,29611712951.208804,2681754576.623100,2045658866.538400,34339126394.370304,2641757,113863,221931,2977551
2019-05-15,NYSE Arca (P),177803910,262163535,151858493,591825938,7764012690.751900,15557144073.565497,8760778787.110103,32081935551.427500,1348964,737360,1273656,3359980
2019-05-15,NASDAQ (Q),417413265,189334231,555033585,1161781081,19803432748.047500,12174212781.379699,33544479516.988902,65522125046.416101,4103876,765541,4147374,9016791
2019-05-15,IEX (V),104582957,14691018,57642727,176916702,4544407123.216200,1043669150.497300,3250563214.419399,8838639488.132899,770482,74631,444512,1289625
2019-05-15,NASDAQ PSX (X),18977748,23342428,15060955,57381131,684761503.283000,1511101168.958800,1127071379.707300,3322934051.949100,132596,88820,127042,348458
2019-05-15,BYX Equities (Y),141839681,62123194,66349710,270312585,4380784641.845800,3142619592.502700,2697224353.387400,10220628587.735900,1473825,357024,744123,2574972
2019-05-15,BZX Equities (Z),161389123,95923031,110281029,367593183,7112255818.326000,6295549906.582098,6806922897.578500,20214728622.486598,1566098,437974,1076010,3080082
2019-05-14,NYSE American (A),6659421,14880014,3174119,24713554,284602269.665800,215713685.646200,179622151.255100,679938106.567100,72818,51577,36816,161211
2019-05-14,NASDAQ BX (B),63599684,29858761,35802861,129261306,2487962647.195100,1541188390.803100,2073036100.287700,6102187138.285900,660152,121716,380012,1161880
2019-05-14,NYSE National (C),40753787,22233021,19207540,82194348,1057301850.065800,868474204.897000,643388004.496700,2569164059.459500,343892,96874,183183,623949
2019-05-14,FINRA / Nasdaq TRF Chicago (DB),3346559,1608076,4872616,9827251,128448799.976300,71983307.382000,276386399.949000,476818507.307300,12934,5472,20315,38721
2019-05-14,FINRA / NYSE TRF (DN),193347718,88052064,191126580,472526362,5863906528.450300,3079132360.367402,9187234158.446102,18130273047.263804,538011,187894,548433,1274338
2019-05-14,FINRA / Nasdaq TRF Carteret (DQ),1009416701,364702413,670995525,2045114639,38987895701.198486,20385040467.486798,32487851751.280393,91860787919.965677,3713843,837837,2359076,6910756
2019-05-14,EDGA Equities (J),83363135,26951007,44392419,154706561,3412322150.588400,1527664316.547100,2254627511.504301,7194613978.639801,1049266,167589,581556,1798411
2019-05-14,EDGX Equities (K),128113931,71490211,99951695,299555837,5110002668.928601,4761247689.230000,5346757935.827897,15218008293.986498,1251180,348565,914155,2513900
2019-05-14,NYSE Chicago (M),7432207,15976631,6812977,30221815,437925272.949200,1254330732.209800,888114221.617000,2580370226.776000,5394,4654,7059,17107
2019-05-14,NYSE (N),768808337,40793138,41823535,851425010,31511339445.146602,2637061658.251599,2303668037.450300,36452069140.848501,2787611,113794,229506,3130911
2019-05-14,NYSE Arca (P),177366739,271166688,150204458,598737885,7271760470.855098,16515719508.224298,8292039437.903000,32079519416.982396,1373890,762130,1246623,3382643
2019-05-14,NASDAQ (Q),427370352,186568651,577989723,1191928726,19927170447.805404,12500519798.726902,33769779306.334820,66197469552.867126,4302662,792668,4338834,9434164
2019-05-14,IEX (V),114645563,19763649,59058810,193468022,4793443557.527700,1338774131.179500,3233175516.535400,9365393205.242600,814361,96567,462555,1373483
2019-05-14,NASDAQ PSX (X),19781085,21346067,15388113,56515265,660438572.784100,1429265032.070899,1057185067.075200,3146888671.930199,132637,83346,121971,337954
2019-05-14,BYX Equities (Y),144021851,72610203,66861296,283493350,4421192079.679900,3661108593.635300,2765916972.973100,10848217646.288300,1579342,403347,791704,2774393
2019-05-14,BZX Equities (Z),166833129,90932112,115483934,373249175,7319440818.795302,6148819318.270999,6791160402.048300,20259420539.114601,1608633,431643,1109124,3149400
2019-05-13,NYSE American (A),8312472,18405999,4227144,30945615,375585581.703100,338859902.824900,270842578.774300,985288063.302300,91909,63805,48795,204509
2019-05-13,NASDAQ BX (B),66285811,38708159,37269313,142263283,2546652664.074800,1944431199.759800,2129919377.744400,6621003241.579000,665345,157089,394378,1216812
2019-05-13,NYSE National (C),49220247,33306868,22914498,105441613,1267921684.345400,1252181055.835400,814304903.447200,3334407643.628000,407339,144588,216750,768677
2019-05-13,FINRA / Nasdaq TRF Chicago (DB),2893076,1642900,3249559,7785535,92443053.779200,96059822.712400,207781133.877600,396284010.369200,9548,5082,14165,28795
2019-05-13,FINRA / NYSE TRF (DN),240678778,109027756,224134472,573841006,6829257900.145900,3911122296.752301,10851579125.754709,21591959322.652910,677861,254948,691114,1623923
2019-05-13,FINRA / Nasdaq TRF Carteret (DQ),1076880704,509725067,720355748,2306961519,41903973867.268695,30859863808.672221,38729687746.663605,111493525422.604521,4228774,1257571,2848678,8335023
2019-05-13,EDGA Equities (J),91892989,41639948,52549985,186082922,3811979811.608400,2294629659.493500,2665172210.874500,8771781681.976400,1155511,240234,671380,2067125
2019-05-13,EDGX Equities (K),153494246,109598268,124883192,387975706,6083545317.522101,7458645276.727298,7341636343.681000,20883826937.930399,1513429,530072,1178390,3221891
2019-05-13,NYSE Chicago (M),8358635,20194678,11168972,39722285,512154892.619400,2042383804.160000,1294639714.725300,3849178411.504700,5374,7856,8908,22138
2019-05-13,NYSE (N),931184719,68301194,50430357,1049916270,36919600419.598996,4535092655.512699,2804160628.320100,44258853703.431795,3407633,178822,291495,3877950
2019-05-13,NYSE Arca (P),215949457,392350520,188651337,796951314,8785116365.486502,23739099967.890701,11157604826.320796,43681821159.697999,1638308,1134422,1577187,4349917
2019-05-13,NASDAQ (Q),527792072,282894802,730649918,1541336792,24260015292.837297,19233125842.925598,44036833980.731790,87529975116.494685,5382335,1245734,5728033,12356102
2019-05-13,IEX (V),127846505,26838629,67774106,222459240,5441072602.681900,2095507347.647200,3986013483.676500,11522593434.005600,903428,125258,537251,1565937
2019-05-13,NASDAQ PSX (X),22738205,32786267,20236002,75760474,768973957.450000,2317580108.043200,1472289537.002000,4558843602.495200,154103,133384,172314,459801
2019-05-13,BYX Equities (Y),175839745,101500494,80929972,358270211,5245312495.857700,5136795213.172500,3356750022.308300,13738857731.338500,1878362,585142,962491,3425995
2019-05-13,BZX Equities (Z),200904393,154233901,145401644,500539938,8529554139.769304,10814177308.388504,8694048969.940700,28037780418.098508,1897796,723687,1387734,4009217
2019-05-10,NYSE American (A),7950154,14143345,3959097,26052596,354297748.856600,244371849.926500,226622508.588100,825292107.371200,82852,50729,42295,175876
2019-05-10,NASDAQ BX (B),68288060,32796181,39408779,140493020,2574837594.153300,1767014223.093101,2455709996.847801,6797561814.094202,690812,136667,439061,1266540
2019-05-10,NYSE National (C),44134719,25816023,20265877,90216619,1239268116.602500,1056327668.348400,773215859.200700,3068811644.151600,380953,125121,197240,703314
2019-05-10,FINRA / Nasdaq TRF Chicago (DB),3779077,2485240,6509546,12773863,150959821.418300,174166211.419000,371780512.190000,696906545.027300,14778,7892,25605,48275
2019-05-10,FINRA / NYSE TRF (DN),226899296,91495845,239205364,557600505,6233016917.821901,3467480120.564198,11229801747.037201,20930298785.423300,605745,188245,652850,1446840
2019-05-10,FINRA / Nasdaq TRF Carteret (DQ),956314964,401217659,743769343,2101301966,37141796293.391597,24525660180.084399,34553895634.978887,96221352108.454883,3821884,955119,2702799,7479802
2019-05-10,EDGA Equities (J),90329188,31758839,48968616,171056643,3712013526.886600,1841335623.919000,2607629316.433300,8160978467.238900,1124362,187288,650361,1962011
2019-05-10,EDGX Equities (K),143395528,85897277,119121702,348414507,5617133312.837900,6185150565.790300,6834541956.995599,18636825835.623799,1377275,435854,1059668,2872797
2019-05-10,NYSE Chicago (M),6962120,14684945,7315117,28962182,306950617.212400,1721167629.295000,754845824.003200,2782964070.510600,6293,6489,8206,20988
2019-05-10,NYSE (N),863273933,57553906,44458189,965286028,33874195269.979090,4190020040.826601,2336373358.277200,40400588669.082891,3146119,168832,280973,3595924
2019-05-10,NYSE Arca (P),202614975,304513608,186662219,693790802,8159592725.499599,19667444738.340191,9904721111.355797,37731758575.195587,1565976,982986,1483596,4032558
2019-05-10,NASDAQ (Q),467798409,232203490,658125113,1358127012,21649214906.593395,16979788832.629402,38037105442.358774,76666109181.581571,4833136,1031348,5296478,11160962
2019-05-10,IEX (V),122511219,22437056,71117601,216065876,5189644183.190300,1658585205.030100,3804632161.112600,10652861549.333000,871796,103877,539431,1515104
2019-05-10,NASDAQ PSX (X),17511940,26445413,17576013,61533366,663406169.166900,2078458437.893800,1523831972.199100,4265696579.259800,128486,103842,155894,388222
2019-05-10,BYX Equities (Y),156480134,82541859,74349234,313371227,4797601333.643601,4554055726.914899,3090518479.261900,12442175539.820400,1607290,466784,842114,2916188
2019-05-10,BZX Equities (Z),188543817,129551406,140658960,458754183,8150354295.742098,9177913277.038902,9062874319.124202,26391141891.905202,1815125,633612,1350974,3799711
2019-05-09,NYSE American (A),7254978,14613535,3978624,25847137,329148193.359700,274525993.896900,214469020.773400,818143208.030000,78765,57669,42724,179158
2019-05-09,NASDAQ BX (B),67139640,38117479,39016055,144273174,2575758522.114200,2061753808.641400,2260581049.327800,6898093380.083400,676103,162333,415078,1253514
2019-05-09,NYSE National (C),46031037,26923351,21212750,94167138,1204195928.010600,1092066145.674200,752421739.652600,3048683813.337400,387254,126344,203045,716643
2019-05-09,FINRA / Nasdaq TRF Chicago (DB),4121327,2453248,6763962,13338537,159876090.385900,150676004.044900,376399957.888400,686952052.319200,15031,8191,27493,50715
2019-05-09,FINRA / NYSE TRF (DN),223458261,98125331,260517900,582101492,6395698625.908399,3561118260.876500,11131423383.426301,21088240270.211200,566949,200396,695247,1462592
2019-05-09,FINRA / Nasdaq TRF Carteret (DQ),1040327614,403998623,758836799,2203163036,40405335369.684904,24488552087.316302,34874348098.640879,99768235555.642085,3969780,1108574,2778662,7857016
2019-05-09,EDGA Equities (J),90673967,36318557,50344828,177337352,3655735243.835400,1984523396.418801,2456002344.571700,8096260984.825901,1124797,206202,637939,1968938
2019-05-09,EDGX Equities (K),146658546,89979773,132083443,368721762,5752488616.846999,6298626604.038699,7012180749.643498,19063295970.529196,1413926,458959,1116760,2989645
2019-05-09,NYSE Chicago (M),8374404,17597539,8094120,34066063,430850458.541000,1676121304.519999,559695998.652800,2666667761.713799,5728,6295,7114,19137
2019-05-09,NYSE (N),833817727,62524065,50032134,946373926,32616094369.410808,4063529913.984599,2819530288.612600,39499154572.008007,3160093,166638,285779,3612510
2019-05-09,NYSE Arca (P),212562325,339429073,206635858,758627256,8928286326.158704,20379081519.995086,10773901912.427300,40081269758.581090,1638944,994329,1581498,4214771
2019-05-09,NASDAQ (Q),481070468,236860087,701009996,1418940551,22143401261.706000,16820088908.539000,38541820148.771885,77505310319.016885,4688324,1043710,5300287,11032321
2019-05-09,IEX (V),121573870,24382365,69394442,215350677,5186609294.150700,1610501323.187800,3664473370.301101,10461583987.639601,873686,103267,524718,1501671
2019-05-09,NASDAQ PSX (X),17756763,30057650,18421207,66235620,669080599.056000,2309732634.849600,1458010260.360700,4436823494.266300,127241,112862,165086,405189
2019-05-09,BYX Equities (Y),158548890,80443454,76435852,315428196,4741263446.912700,4179575884.313400,3070521601.926000,11991360933.152100,1607986,443368,830384,2881738
2019-05-09,BZX Equities (Z),199681156,135389952,146727557,481798665,8624396349.073500,9314288081.377097,8514375178.298600,26453059608.749197,1859977,664602,1351011,3875590
2019-05-08,NYSE American (A),6582342,13380785,3528188,23491315,268338007.230300,261163408.558500,221280140.968200,750781556.757000,70116,52549,39424,162089
2019-05-08,NASDAQ BX (B),63528239,31830999,35096268,130455506,2416522739.042800,1723930361.713700,2071634710.252300,6212087811.008800,624623,143309,373744,1141676
2019-05-08,NYSE National (C),40655714,21944383,18026931,80627028,1051648782.928200,931795816.494600,659393780.703400,2642838380.126200,340628,104993,170379,616000
2019-05-08,FINRA / Nasdaq TRF Chicago (DB),3408166,2089343,5096701,10594210,135070959.128500,118822494.761600,296652183.723900,550545637.614000,13447,6822,21931,42200
2019-05-08,FINRA / NYSE TRF (DN),215398367,85594398,214113912,515106677,6196881011.069503,2969958808.351500,9088760269.080201,18255600088.501204,530146,173944,584949,1289039
2019-05-08,FINRA / Nasdaq TRF Carteret (DQ),1051804386,377188941,690123235,2119116562,39978427000.823901,23876432197.950805,31965280225.250103,95820139424.024809,3716895,868060,2426311,7011266
2019-05-08,EDGA Equities (J),81551802,28821009,44466848,154839659,3320917821.296400,1682787275.401400,2259126834.691200,7262831931.389000,994707,171368,556916,1722991
2019-05-08,EDGX Equities (K),133966599,77843798,110930056,322740453,4995661492.555400,5563983163.681398,5857198642.542898,16416843298.779696,1194210,389874,927439,2511523
2019-05-08,NYSE Chicago (M),17440878,15620176,9091359,42152413,930946547.767600,1652653675.530000,755679142.607500,3339279365.905100,4820,5569,6428,16817
2019-05-08,NYSE (N),814416304,49213652,41675431,905305387,31669070761.630296,3193709339.940001,2145610569.782200,37008390671.352497,2929930,136737,242790,3309457
2019-05-08,NYSE Arca (P),203368071,273355732,172495448,649219251,8166102385.977699,17089540522.239303,8924183962.103402,34179826870.320404,1489883,846838,1358068,3694789
2019-05-08,NASDAQ (Q),454769882,198935880,612647559,1266353321,20318772083.846998,13831103381.041200,34492686822.684195,68642562287.572393,4317782,882205,4570225,9770212
2019-05-08,IEX (V),116512226,20655803,62036594,199204623,5009534028.265800,1342220278.530700,3293588876.302000,9645343183.098500,828926,90067,468459,1387452
2019-05-08,NASDAQ PSX (X),18456558,23879758,14142798,56479114,626218552.605500,1728162469.495501,1159865212.644200,3514246234.745201,119552,87475,123996,331023
2019-05-08,BYX Equities (Y),144780598,68920163,64741893,278442654,4305903514.234200,3522663920.145301,2763745431.958100,10592312866.337601,1404917,384754,711313,2500984
2019-05-08,BZX Equities (Z),176479003,108814573,116476000,401769576,7277251539.501400,7654855922.275900,6701519232.624701,21633626694.402001,1644633,521356,1112613,3278602
2019-05-07,NYSE American (A),8135566,13858848,4042766,26037180,373746814.583600,290860702.137200,244987222.686900,909594739.407700,86208,56384,45574,188166
2019-05-07,NASDAQ BX (B),70226291,39362939,39510691,149099921,2782791551.416000,2015338944.628300,2400075904.676600,7198206400.720900,708493,161494,421963,1291950
2019-05-07,NYSE National (C),50013754,29681942,22671776,102367472,1253074190.521100,1156774449.858600,795234789.721100,3205083430.100800,415117,134507,220696,770320
2019-05-07,FINRA / Nasdaq TRF Chicago (DB),4158100,2948023,5582072,12688195,175114405.284300,197940368.566300,401324415.386300,774379189.236900,16739,9746,26684,53169
2019-05-07,FINRA / NYSE TRF (DN),233966345,103322433,227012433,564301211,7555266333.393800,4299481379.220902,11309256303.038210,23164004015.652912,601700,240625,670686,1513011
2019-05-07,FINRA / Nasdaq TRF Carteret (DQ),1049459221,485528525,699784619,2234772365,42939969183.896394,33538329461.414206,36506632663.744725,112984931309.055325,4016695,1167983,2654937,7839615
2019-05-07,EDGA Equities (J),88549298,36255581,49087306,173892185,3640114627.059800,2004302921.402700,2557079963.137100,8201497511.599600,927701,196392,532542,1656635
2019-05-07,EDGX Equities (K),137583114,87597833,118601620,343782567,5820713403.222900,6721009387.205698,7460845738.441400,20002568528.869998,1157398,404375,944682,2506455
2019-05-07,NYSE Chicago (M),12072574,19520343,5600550,37193467,419466291.112100,2039800947.283000,521931579.341000,2981198817.736100,5109,6481,6570,18160
2019-05-07,NYSE (N),922545920,61562727,51471953,1035580600,37629137125.139989,4489435400.690599,2805177563.552200,44923750089.382788,3325702,170378,299504,3795584
2019-05-07,NYSE Arca (P),217015351,355424718,188240820,760680889,9558225866.628401,23265787233.440286,11120621326.708407,43944634426.777094,1703859,1083893,1549526,4337278
2019-05-07,NASDAQ (Q),499351737,253709788,695820486,1448882011,24002900331.287306,18336929500.186702,43320977481.920821,85660807313.394829,5026381,1101555,5270657,11398593
2019-05-07,IEX (V),125520370,22735588,65472002,213727960,5564852885.353400,1778608524.985500,3963814100.805400,11307275511.144300,873020,108628,502366,1484014
2019-05-07,NASDAQ PSX (X),18399976,27430250,17287661,63117887,724555391.061700,2124364249.407200,1416649283.875300,4265568924.344200,133878,108981,140328,383187
2019-05-07,BYX Equities (Y),165904740,84848491,74551007,325304238,5005823958.385300,4517611626.600701,3163707251.808600,12687142836.794601,1420473,427432,730416,2578321
2019-05-07,BZX Equities (Z),190163508,126853198,132869404,449886110,8540596965.458898,9628598131.424602,8248220433.648297,26417415530.531797,1810057,598138,1265699,3673894
2019-05-06,NYSE American (A),5673321,13146409,3130123,21949853,247552197.923200,227313755.279400,194195660.013800,669061613.216400,63057,50206,36065,149328
2019-05-06,NASDAQ BX (B),55511856,29940312,29667308,115119476,2321782625.433100,1554969143.824700,1887913675.164100,5764665444.421900,582273,120845,322660,1025778
2019-05-06,NYSE National (C),38369321,26590882,17309493,82269696,977483934.616500,1061571880.400800,626345840.464900,2665401655.482200,330411,108074,175215,613700
2019-05-06,FINRA / Nasdaq TRF Chicago (DB),3761932,1787451,4953324,10502707,163241630.011300,112608097.866600,325616580.232400,601466308.110300,15138,6592,22546,44276
2019-05-06,FINRA / NYSE TRF (DN),196889402,84708893,200012092,481610387,6881426531.160800,3027683010.933401,9727930842.826499,19637040384.920700,558904,193795,580383,1333082
2019-05-06,FINRA / Nasdaq TRF Carteret (DQ),900555834,377396056,590319187,1868271077,38747429776.373693,26462962651.444291,31201296071.775213,96411688499.593197,3591345,874912,2298628,6764885
2019-05-06,EDGA Equities (J),75217820,28221770,39677056,143116646,3267442696.522700,1636393985.243400,2173854137.579600,7077690819.345700,854856,150124,470862,1475842
2019-05-06,EDGX Equities (K),114115449,63086916,96457993,273660358,4986097077.500700,4419450943.041601,5546536903.599003,14952084924.141304,979623,277210,728284,1985117
2019-05-06,NYSE Chicago (M),6835485,9598552,5288620,21722657,423091046.024000,993928930.370000,555099575.692200,1972119552.086200,5147,4391,6217,15755
2019-05-06,NYSE (N),798986991,45132478,35858280,879977749,33649986007.675997,3111517144.711900,1897827580.234300,38659330732.622197,2717136,123085,217032,3057253
2019-05-06,NYSE Arca (P),178739468,318020751,158914426,655674645,8142136129.868104,21360566668.781800,9208322187.941593,38711024986.591497,1412337,809766,1279283,3501386
2019-05-06,NASDAQ (Q),412983094,175541335,566876824,1155401253,20141580353.868500,12737148233.171594,33996408851.034103,66875137438.074197,4044852,733919,4137162,8915933
2019-05-06,IEX (V),109806854,21634933,57654027,189095814,5107800944.625601,1438988524.341200,3262929449.757700,9809718918.724501,794902,92206,449231,1336339
2019-05-06,NASDAQ PSX (X),14829674,19101974,12510407,46442055,586939591.611000,1420027961.949199,995138071.849700,3002105625.409899,107412,67478,98050,272940
2019-05-06,BYX Equities (Y),131337750,68520783,58047387,257905920,4202566429.914400,3744772173.084300,2600008805.668500,10547347408.667200,1168915,339817,592132,2100864
2019-05-06,BZX Equities (Z),159650058,87403604,102977840,350031502,7171950465.191199,6185500271.377000,6302584080.793401,19660034817.361600,1517937,396942,1013914,2928793
2019-05-03,NYSE American (A),6289836,14590717,2938373,23818926,262310520.867900,179603285.703200,196265129.630300,638178936.201400,63717,46890,34837,145444
2019-05-03,NASDAQ BX (B),61467760,23131951,32128211,116727922,2423596892.577000,1284551644.027400,2143116245.609400,5851264782.213800,604834,101750,344318,1050902
2019-05-03,NYSE National (C),40279837,22972276,19179245,82431358,1018165023.088600,922153833.019400,665474307.595700,2605793163.703700,336506,96618,185420,618544
2019-05-03,FINRA / Nasdaq TRF Chicago (DB),3993335,1655550,4719194,10368079,137009990.535600,91375096.476700,354317832.666600,582702919.678900,15227,5839,23136,44202
2019-05-03,FINRA / NYSE TRF (DN),213246070,81134542,203910081,498290693,6395394565.053502,2261747011.470099,9430441630.739203,18087583207.262804,546382,171376,579943,1297701
2019-05-03,FINRA / Nasdaq TRF Carteret (DQ),986503488,304246371,654010706,1944760565,37192202212.698195,18261086644.202606,35454143296.124188,90907432153.024989,3639176,681596,2466912,6787684
2019-05-03,EDGA Equities (J),79960169,22421889,42251947,144634005,3346856485.929500,1273008640.965700,2300712822.825500,6920577949.720700,851629,118175,490229,1460033
2019-05-03,EDGX Equities (K),119272888,55959821,92077616,267310325,4612098766.573501,3405658729.892400,5909787694.245301,13927545190.711202,948062,231520,729757,1909339
2019-05-03,NYSE Chicago (M),8884411,13815116,7373610,30073137,451360891.094100,1078149960.330000,639108137.399000,2168618988.823100,3884,2735,5135,11754
2019-05-03,NYSE (N),793288611,35975707,39933192,869197510,31194251436.179902,2272705120.325700,1873272089.694200,35340228646.199802,2657689,94919,242942,2995550
2019-05-03,NYSE Arca (P),186727258,247502832,164323755,598553845,7457664470.157701,14625594980.407405,9972903807.971100,32056163258.536206,1382591,631051,1354791,3368433
2019-05-03,NASDAQ (Q),419481677,141500504,574165547,1135147728,18859396236.997799,9118423175.356002,35823555092.666927,63801374505.020728,3794239,551088,4156885,8502212
2019-05-03,IEX (V),113096720,16572479,63834740,193503939,4859509677.820802,1027888594.370200,3589085552.465300,9476483824.656302,793514,78280,480613,1352407
2019-05-03,NASDAQ PSX (X),17737741,14478686,12198101,44414528,547679004.255700,1046986839.396800,1149960924.817100,2744626768.469600,106508,50581,102490,259579
2019-05-03,BYX Equities (Y),138675703,54928269,61994787,255598759,4175127804.637700,2836285987.492000,2825228494.475000,9836642286.604700,1157013,265969,613885,2036867
2019-05-03,BZX Equities (Z),168276190,68176123,106047551,342499864,7016801354.932201,4455170098.848700,6659953848.785398,18131925302.566299,1519815,297688,1027818,2845321
2019-05-02,NYSE American (A),7591645,13802940,3544989,24939574,317048379.967100,209895434.511300,207386004.178900,734329818.657300,77699,52039,38204,167942
2019-05-02,NASDAQ BX (B),70059536,27515048,35700786,133275370,2831111054.611600,1425020699.432400,2206090238.277800,6462221992.321800,680744,116721,372700,1170165
2019-05-02,NYSE National (C),43751888,30102471,19306503,93160862,1138534045.463300,1125685387.085500,630889653.848500,2895109086.397300,361438,123463,181495,666396
2019-05-02,FINRA / Nasdaq TRF Chicago (DB),4785949,1940038,4901578,11627565,184688966.486400,115233304.655800,328712464.507900,628634735.650100,18276,6484,22523,47283
2019-05-02,FINRA / NYSE TRF (DN),242142338,106452890,221835134,570430362,7647563715.202603,3379276503.523901,10585719841.753602,21612560060.480106,664011,205447,623030,1492488
2019-05-02,FINRA / Nasdaq TRF Carteret (DQ),1150892063,380507146,673467958,2204867167,44267090755.714594,20283375668.458896,35596249420.364286,100146715844.537776,4157288,922752,2519040,7599080
2019-05-02,EDGA Equities (J),87379347,26381807,42599698,156360852,3563183611.246500,1376418640.807500,2250794561.638900,7190396813.692900,894140,139620,471672,1505432
2019-05-02,EDGX Equities (K),142569280,67700647,98228038,308497965,5509461349.737500,4260641434.503801,5551952697.303302,15322055481.544603,1127497,289056,748053,2164606
2019-05-02,NYSE Chicago (M),8092278,8918944,12102526,29113748,461073695.918000,792286960.660000,785791843.385100,2039152499.963100,4459,3405,5860,13724
2019-05-02,NYSE (N),837909699,50836994,45853767,934600460,32337619050.171104,3423768681.062800,2171061811.205800,37932449542.439704,3198862,139931,253205,3591998
2019-05-02,NYSE Arca (P),207927909,313422570,175491098,696841577,8641633151.507900,17927719404.229901,9884517995.271903,36453870551.009704,1588566,826312,1425069,3839947
2019-05-02,NASDAQ (Q),494043141,188628271,602551744,1285223156,22872955185.997602,12499026257.331796,35317173349.093595,70689154792.422993,4663715,761595,4594664,10019974
2019-05-02,IEX (V),132191129,19396293,62315772,213903194,5616763734.706200,1220521578.405600,3534717120.949402,10372002434.061202,905646,90215,468941,1464802
2019-05-02,NASDAQ PSX (X),17073320,20844968,17181677,55099965,646025244.692500,1583174428.180199,1348597529.858700,3577797202.731399,126558,76170,130581,333309
2019-05-02,BYX Equities (Y),160539052,70195945,70258963,300993960,4685843919.497700,3405288575.400000,2914089631.132300,11005222126.030000,1342119,343058,663236,2348413
2019-05-02,BZX Equities (Z),195350318,93614251,126193243,415157812,8262399630.606800,6177142022.391001,7376269254.857602,21815810907.855403,1793598,418627,1151440,3363665
2019-05-01,NYSE American (A),6183504,14627412,3228775,24039691,280896808.747900,206629954.462200,209179445.211000,696706208.421100,68697,48229,36044,152970
2019-05-01,NASDAQ BX (B),69805971,30546710,32728602,133081283,2899940039.267100,1567320680.072100,2057803071.075500,6525063790.414700,670930,127400,336118,1134448
2019-05-01,NYSE National (C),44327245,36493553,19412387,100233185,1134318436.479500,1327279135.326700,701067592.127400,3162665163.933600,369454,145707,185759,700920
2019-05-01,FINRA / Nasdaq TRF Chicago (DB),4526294,1976311,5009664,11512269,169162286.768400,106224534.892200,369963685.513500,645350507.174100,17565,6727,24610,48902
2019-05-01,FINRA / NYSE TRF (DN),238205672,100232590,238878052,577316314,7632688639.539396,3112043245.172200,11359939044.673895,22104670929.385491,611566,194697,624162,1430425
2019-05-01,FINRA / Nasdaq TRF Carteret (DQ),1082293219,405089638,704806128,2192188985,44261015438.173302,23074651796.630109,37344072861.989890,104679740096.793301,3938092,839032,2503217,7280341
2019-05-01,EDGA Equities (J),82350968,28689440,41794516,152834924,3426565442.930600,1534893490.044100,2210624237.588300,7172083170.563000,855484,144309,459720,1459513
2019-05-01,EDGX Equities (K),136484843,73302568,102286466,312073877,5432093486.087701,4454048715.334398,5889736650.876102,15775878852.298201,1073001,296256,742884,2112141
2019-05-01,NYSE Chicago (M),9462579,8069736,10887930,28420245,642676848.698900,867096425.835000,1129572257.623500,2639345532.157400,5056,3779,5185,14020
2019-05-01,NYSE (N),866916014,53941742,42366732,963224488,34646914667.879199,3078565714.514200,2063846324.336700,39789326706.730099,3109710,135607,258161,3503478
2019-05-01,NYSE Arca (P),187418009,369549814,176377042,733344865,8058265490.507502,20614887245.277304,10305553629.041603,38978706364.826409,1429215,895477,1388951,3713643
2019-05-01,NASDAQ (Q),449867358,202753938,626241095,1278862391,21505511374.287694,13353119759.222895,37870604475.235618,72729235608.746207,4292130,767368,4339748,9399246
2019-05-01,IEX (V),117950278,20510368,60216805,198677451,5542139532.924500,1288312690.766000,3820107784.372100,10650560008.062600,866001,88315,466535,1420851
2019-05-01,NASDAQ PSX (X),16745700,22361857,14950768,54058325,639542547.328900,1549895024.195500,1238691968.552700,3428129540.077100,117835,68436,118714,304985
2019-05-01,BYX Equities (Y),152864129,72467762,65570281,290902172,4575228195.858500,3450479615.670401,2955872356.149400,10981580167.678301,1278801,348406,634814,2262021
2019-05-01,BZX Equities (Z),203930071,126639695,128789013,459358779,8409785037.388001,7891098015.790400,7826468088.684701,24127351141.863102,1776416,490557,1144188,3411161
2019-04-30,NYSE American (A),6281706,21094985,3063930,30440621,277622693.477600,233913941.668100,209381668.145500,720918303.291200,66137,46958,35343,148438
2019-04-30,NASDAQ BX (B),72076271,18733679,32144665,122954615,2994751637.612000,1137259875.000900,2166334719.313401,6298346231.926301,672076,80243,322920,1075239
2019-04-30,NYSE National (C),49321725,27026544,20766581,97114850,1263767834.623100,1092797516.614400,726578138.513100,3083143489.750600,386586,103031,192735,682352
2019-04-30,FINRA / Nasdaq TRF Chicago (DB),4655561,1643705,4038033,10337299,173107169.286000,91354082.528900,295294077.938700,559755329.753600,18306,5370,19811,43487
2019-04-30,FINRA / NYSE TRF (DN),234908927,91209293,196476730,522594950,7853831672.146898,2626069631.189500,9767327347.293702,20247228650.630100,606752,183707,547539,1337998
2019-04-30,FINRA / Nasdaq TRF Carteret (DQ),1151691493,360740202,669169261,2181600956,46929223581.563307,26745201821.809591,36727470903.869807,110401896307.242705,3996134,704615,2308129,7008878
2019-04-30,EDGA Equities (J),93733398,25433748,40236521,159403667,3677027186.306400,1487983819.487600,2405488026.093800,7570499031.887800,923450,128897,458444,1510791
2019-04-30,EDGX Equities (K),127604770,55631966,88646548,271883284,5218616739.334202,3203076451.092101,5827801617.626804,14249494808.053107,961903,196011,653297,1811211
2019-04-30,NYSE Chicago (M),13497432,18107386,5200769,36805587,847470681.653900,1519125281.618800,595118947.380500,2961714910.653200,4188,2652,3996,10836
2019-04-30,NYSE (N),1042193186,43347403,39672313,1125212902,43810489886.578105,2746569699.604500,2083844009.142200,48640903595.324805,2806991,111522,229963,3148476
2019-04-30,NYSE Arca (P),204764936,252710404,167640223,625115563,8442173829.927799,15401952876.001902,10729371023.225905,34573497729.155606,1413979,637375,1291849,3343203
2019-04-30,NASDAQ (Q),452937454,145727618,622977166,1221642238,21582401404.657100,9865932712.448899,39349259370.161216,70797593487.267215,3889535,531971,3842784,8264290
2019-04-30,IEX (V),137525551,18472291,60375973,216373815,6663748964.697700,1286276204.400700,4357003882.332600,12307029051.431000,932694,75304,465737,1473735
2019-04-30,NASDAQ PSX (X),17623496,16607471,13009845,47240812,643685034.303300,1227113783.119100,1077562244.220300,2948361061.642700,123149,53840,99518,276507
2019-04-30,BYX Equities (Y),148422965,59604421,62160002,270187388,4664302787.076200,3016588217.881900,3020983164.147402,10701874169.105502,1212132,266872,598218,2077222
2019-04-30,BZX Equities (Z),182525766,75260517,106281407,364067690,8012917709.323300,5099795906.026197,7124096654.664200,20236810270.013697,1628193,316086,1018957,2963236
2019-04-29,NYSE American (A),5467955,11754551,2424334,19646840,244459342.619600,172571602.570900,166592286.262500,583623231.453000,59298,40180,28777,128255
2019-04-29,NASDAQ BX (B),61197226,16338940,27166902,104703068,2694751902.874800,831471274.836700,1745619158.202000,5271842335.913500,647159,71111,307383,1025653
2019-04-29,NYSE National (C),41809551,21887045,18480671,82177267,1080957447.855000,766709021.072400,587373938.361300,2435040407.288700,349901,85123,180383,615407
2019-04-29,FINRA / Nasdaq TRF Chicago (DB),985145,330838,993959,2309942,44843104.994300,14633105.276400,76542827.755600,136019038.026300,4616,1265,5691,11572
2019-04-29,FINRA / NYSE TRF (DN),212182757,69720592,178191606,460094955,7250892580.292601,2179912035.645500,8550916431.847999,17981721047.786100,576842,174872,526481,1278195
2019-04-29,FINRA / Nasdaq TRF Carteret (DQ),980643075,334184016,588695910,1903523001,41621503214.158894,22632479117.138001,31505595714.241998,95759578045.538893,3602126,659899,2138114,6400139
2019-04-29,EDGA Equities (J),74865330,18883603,35887912,129636845,3203460054.385200,1088816593.456900,2056874070.668900,6349150718.511000,844226,110447,443162,1397835
2019-04-29,EDGX Equities (K),111186030,38390002,74963885,224539917,4590363630.844299,2283426110.655400,4652581078.505501,11526370820.005200,843019,155502,588119,1586640
2019-04-29,NYSE Chicago (M),13686830,9473286,14151793,37311909,536889185.367700,809984302.115000,2128776655.623200,3475650143.105900,3537,1680,5001,10218
2019-04-29,NYSE (N),741386865,31800123,34505950,807692938,30937787590.569806,1885825204.360100,1576764047.560200,34400376842.490106,2483655,87675,207883,2779213
2019-04-29,NYSE Arca (P),156453842,199943990,135717412,492115244,7032642078.800500,10709129673.053801,8741275982.839699,26483047734.694000,1168965,501621,1158858,2829444
2019-04-29,NASDAQ (Q),367932929,107339879,473591922,948864730,17853672296.925500,6829979673.604298,29963087265.657895,54646739236.187693,3311757,420475,3502602,7234834
2019-04-29,IEX (V),99776686,12362909,48937015,161076610,4611577369.289400,854441964.705600,3097433352.369499,8563452686.364499,728445,61339,392474,1182258
2019-04-29,NASDAQ PSX (X),13633247,12461949,10618721,36713917,546256801.450600,789292138.249800,780886407.022200,2116435346.722600,101227,45179,81020,227426
2019-04-29,BYX Equities (Y),121738790,45020518,51510080,218269388,4036498424.376000,2126816595.664700,2281573000.108100,8444888020.148800,1135552,219931,570853,1926336
2019-04-29,BZX Equities (Z),147451061,53679588,86027283,287157932,6514513627.234600,3300032482.083001,5233745223.600301,15048291332.917902,1351094,238964,852871,2442929
2019-04-26,NYSE American (A),5568049,15039171,2888180,23495400,249763894.201400,167557017.990000,172345683.631400,589666595.822800,58651,47293,31578,137522
2019-04-26,NASDAQ BX (B),60634381,18253464,31213961,110101806,2594175109.286500,1010827394.563900,2077417977.766000,5682420481.616400,602745,88502,330600,1021847
2019-04-26,NYSE National (C),45024128,29226234,20761514,95011876,1170967453.645000,969235502.368100,766218203.529100,2906421159.542200,364910,106343,196156,667409
2019-04-26,FINRA / Nasdaq TRF Chicago (DB),1244268,475856,1262462,2982586,43118728.550300,21130795.001300,100590413.558900,164839937.110500,4470,1632,6717,12819
2019-04-26,FINRA / NYSE TRF (DN),214817979,98684573,201541787,515044339,6639422270.459498,2563253895.591200,10609873069.747597,19812549235.798295,577971,201680,599417,1379068
2019-04-26,FINRA / Nasdaq TRF Carteret (DQ),997360191,368346335,628834388,1994540914,39915343597.473394,19253006982.670196,34769198706.021099,93937549286.164689,3664712,718123,2355591,6738426
2019-04-26,EDGA Equities (J),73707730,25735829,40591321,140034880,3126178604.610300,1304082349.660000,2328479229.306300,6758740183.576600,791848,132100,447716,1371664
2019-04-26,EDGX Equities (K),117964068,53378965,87205702,258548735,4715101528.823901,2994137078.158199,5901267596.792701,13610506203.774801,881103,206961,647904,1735968
2019-04-26,NYSE Chicago (M),11615510,17525692,6472403,35613605,661405196.276200,1080927189.868500,761232964.920100,2503565351.064800,3525,2260,4521,10306
2019-04-26,NYSE (N),765428101,38686425,38164045,842278571,31050948404.965500,2275387694.914800,1821070554.415600,35147406654.295900,2440970,106967,217687,2765624
2019-04-26,NYSE Arca (P),169110992,277081640,154879327,601071959,7196821857.943399,13954321092.856305,10035554322.613902,31186697273.413606,1242293,633969,1232676,3108938
2019-04-26,NASDAQ (Q),392851884,139192287,537142638,1069186809,18288999956.172898,8344798173.722098,34864621742.898507,61498419872.793503,3336812,538010,3577391,7452213
2019-04-26,IEX (V),101363551,15271772,57191811,173827134,4696419189.784900,943075810.010300,3574425814.106600,9213920813.901800,735291,70966,431025,1237282
2019-04-26,NASDAQ PSX (X),15217354,15247639,13456068,43921061,556032646.961400,1000317936.508000,1152865485.037800,2709216068.507200,104883,53664,104333,262880
2019-04-26,BYX Equities (Y),126653779,57956449,56300504,240910732,3965784712.349100,2699217230.987800,2643025410.940400,9308027354.277300,1079715,266407,561430,1907552
2019-04-26,BZX Equities (Z),165828329,75488883,104662543,345979755,6970088835.739100,4693599863.550301,6899551075.984899,18563239775.274300,1441182,322090,967180,2730452
2019-04-25,NYSE American (A),6279411,14062840,2815419,23157670,278543179.596700,162363393.177300,186563898.841000,627470471.615000,65968,48669,32775,147412
2019-04-25,NASDAQ BX (B),68366520,18545738,33991098,120903356,2999131311.312400,1021906456.787400,2149101104.374000,6170138872.473800,687632,88622,357372,1133626
2019-04-25,NYSE National (C),50684215,25568354,21167866,97420435,1363950692.886800,901143929.914800,762880434.596000,3027975057.397600,401940,105986,199196,707122
2019-04-25,FINRA / Nasdaq TRF Chicago (DB),1374425,472357,1487004,3333786,53115971.542300,21212566.619400,112187233.066400,186515771.228100,5095,1624,7273,13992
2019-04-25,FINRA / NYSE TRF (DN),223796291,97918714,214816350,536531355,7636900140.063099,2583314518.565899,10690967923.135898,20911182581.764896,589534,184891,614634,1389059
2019-04-25,FINRA / Nasdaq TRF Carteret (DQ),1003861359,337783174,626238845,1967883378,42967669811.209216,20398117717.656997,35528030027.659687,98893817556.525900,3866837,746734,2379791,6993362
2019-04-25,EDGA Equities (J),94178301,30505845,49323180,174007326,4057095899.927000,1593161842.518500,3098020456.632500,8748278199.078000,976086,162480,550932,1689498
2019-04-25,EDGX Equities (K),124620253,52401486,94458122,271479861,5424518012.172099,2869787553.053900,6476830643.791701,14771136209.017700,966025,200421,711094,1877540
2019-04-25,NYSE Chicago (M),9072607,7173074,6634578,22880259,362865310.302500,626988978.735000,753695390.607400,1743549679.644900,4406,2381,3936,10723
2019-04-25,NYSE (N),792525586,40447114,39786317,872759017,32788027835.758499,2485042729.225000,2045828455.752201,37318899020.735700,2642366,111558,227483,2981407
2019-04-25,NYSE Arca (P),194530370,253907358,172846703,621284431,8482539956.068203,13872317770.483101,11513039982.398803,33867897708.950107,1412231,673227,1336286,3421744
2019-04-25,NASDAQ (Q),424493438,143557717,570032792,1138083947,20168708082.002103,9083617623.074596,36194561711.120701,65446887416.197400,3599468,556129,3808448,7964045
2019-04-25,IEX (V),112704479,17510868,57345397,187560744,5315618021.257901,1001667226.556600,3848140302.964400,10165425550.778901,804871,75359,426121,1306351
2019-04-25,NASDAQ PSX (X),17314606,16265154,13431894,47011654,627280577.780800,1127719300.716600,1095128049.285800,2850127927.783200,118308,58765,106456,283529
2019-04-25,BYX Equities (Y),135554986,57020732,59688419,252264137,4288427814.580300,2762817667.916401,2700895703.433799,9752141185.930500,1153940,268561,577926,2000427
2019-04-25,BZX Equities (Z),180657416,77547527,109308080,367513023,7783464219.290401,4681248955.868201,6981367009.138800,19446080184.297402,1583899,337683,1041973,2963555
2019-04-24,NYSE American (A),5957533,13526498,2620144,22104175,266170946.767700,176362098.855600,160615005.293800,603148050.917100,66311,45884,31533,143728
2019-04-24,NASDAQ BX (B),65244681,20250512,32313605,117808798,3052900751.463500,1024151828.142700,1940209539.358000,6017262118.964200,675665,93508,337878,1107051
2019-04-24,NYSE National (C),48019782,26396291,20501360,94917433,1266586188.800900,1004974026.928400,720034467.117500,2991594682.846800,385315,106504,190726,682545
2019-04-24,FINRA / Nasdaq TRF Chicago (DB),288648,89088,228953,606689,10596656.216700,4071762.527900,17457030.224300,32125448.968900,1136,329,1411,2876
2019-04-24,FINRA / NYSE TRF (DN),219758891,86666252,211966852,518391995,7475590393.279400,2582008348.425601,8603346350.697997,18660945092.402998,581342,178607,582412,1342361
2019-04-24,FINRA / Nasdaq TRF Carteret (DQ),1088988876,349438008,669505807,2107932691,46725352630.140621,19715226566.367301,34737763312.229713,101178342508.737635,3845002,744463,2287987,6877452
2019-04-24,EDGA Equities (J),95475885,33386937,48774118,177636940,4371320705.828099,1561351333.474900,2790358852.471000,8723030891.773999,1048368,167989,561198,1777555
2019-04-24,EDGX Equities (K),119783771,46214246,91633484,257631501,5265759886.819201,2608968339.236601,5217804976.836799,13092533202.892601,914264,184022,641425,1739711
2019-04-24,NYSE Chicago (M),11455359,8196618,8838727,28490704,657495650.471400,847648962.652000,786866769.057200,2292011382.180600,3406,2096,3470,8972
2019-04-24,NYSE (N),804527953,41150898,35632129,881310980,34087731988.795697,2419489233.219600,1792638336.934100,38299859558.949397,2520700,107296,218337,2846333
2019-04-24,NYSE Arca (P),186565760,254799656,165595075,606960491,8697036375.570099,13528378583.999792,10139765203.460402,32365180163.030293,1355893,648784,1238195,3242872
2019-04-24,NASDAQ (Q),404868568,144196058,538105346,1087169972,19877371940.818601,8602134603.710201,31568693085.272273,60048199629.801075,3445809,518929,3480087,7444825
2019-04-24,IEX (V),114222440,18812401,54276148,187310989,5500957744.360700,1052441314.496600,3128289974.845501,9681689033.702801,818739,81384,409888,1310011
2019-04-24,NASDAQ PSX (X),15238372,16010768,12028676,43277816,602499835.920600,1022756698.875100,932417403.264500,2557673938.060200,114956,57371,95226,267553
2019-04-24,BYX Equities (Y),126038998,58832835,55851252,240723085,4149532610.943200,2814855277.745899,2427012245.193000,9391400133.882099,1105983,266291,536489,1908763
2019-04-24,BZX Equities (Z),162051936,67067517,95444035,324563488,7154029365.953200,4007042905.296299,5545377739.570599,16706450010.820098,1462795,294507,904927,2662229
2019-04-23,NYSE American (A),7006302,16214394,2940237,26160933,307452799.810300,191432435.895700,177107110.395200,675992346.101200,75195,53137,34004,162336
2019-04-23,NASDAQ BX (B),71581449,17908969,35296136,124786554,3259428006.566000,995962502.331700,2071447734.860700,6326838243.758400,730401,90796,375509,1196706
2019-04-23,NYSE National (C),51673935,23929862,21899827,97503624,1433041466.757100,880191887.523800,753181493.821300,3066414848.102200,430152,99704,209740,739596
2019-04-23,FINRA / Nasdaq TRF Chicago (DB),396030,126410,408641,931081,16445629.498400,6193115.089000,33656914.079200,56295658.666600,1778,427,2134,4339
2019-04-23,FINRA / NYSE TRF (DN),242139711,102269286,208698912,553107909,8716678842.224101,2729125301.471700,9512114630.106297,20957918773.802098,626714,202472,597931,1427117
2019-04-23,FINRA / Nasdaq TRF Carteret (DQ),1176741517,371993247,695108634,2243843398,50631189484.565492,21910790770.574606,36925503333.087794,109467483588.227892,4067194,792195,2397602,7256991
2019-04-23,EDGA Equities (J),105424979,32233400,54749393,192407772,4928142094.336700,1719929173.481900,3376841931.636300,10024913199.454900,1152548,181674,656763,1990985
2019-04-23,EDGX Equities (K),128766736,55914622,92109286,276790644,5478325118.716101,3071440745.313800,5174290482.632600,13724056346.662501,982655,209804,661702,1854161
2019-04-23,NYSE Chicago (M),10017580,7879509,9665135,27562224,532856161.027600,593264819.140000,1144321423.792700,2270442403.960300,3174,2402,3939,9515
2019-04-23,NYSE (N),823610641,41013105,36136110,900759856,34885037134.067298,2683660121.872601,1884907454.631900,39453604710.571799,2607213,111701,221439,2940353
2019-04-23,NYSE Arca (P),196503680,233094664,160391336,589989680,8422403801.899601,13653900248.027802,8959523462.614203,31035827512.541606,1402254,635695,1236155,3274104
2019-04-23,NASDAQ (Q),409380452,138530111,544669449,1092580012,20184343834.273699,9109547753.058000,33116214143.709990,62410105731.041689,3573388,520081,3601542,7695011
2019-04-23,IEX (V),118806327,17093324,60981371,196881022,5683842620.459900,1112428300.114900,3549628744.079301,10345899664.654101,842787,79669,454631,1377087
2019-04-23,NASDAQ PSX (X),16505417,15588253,12986788,45080458,651033825.628100,1084189782.866300,976170496.282100,2711394104.776500,123376,55477,99822,278675
2019-04-23,BYX Equities (Y),136584429,55737239,61090511,253412179,4577146381.472400,2797166306.401700,2692335312.488200,10066648000.362300,1209130,267053,594795,2070978
2019-04-23,BZX Equities (Z),179345793,74454350,102285730,356085873,7950770329.424501,4761517323.629200,6363500153.728799,19075787806.782500,1632261,336170,997878,2966309
2019-04-22,NYSE American (A),5708942,15441821,2146125,23296888,225200123.425100,184301390.959400,125219760.633600,534721275.018100,60289,46703,25423,132415
2019-04-22,NASDAQ BX (B),53540793,15651890,26518889,95711572,2350665940.279000,849432756.476900,1490389621.826500,4690488318.582400,545137,79685,275883,900705
2019-04-22,NYSE National (C),44715622,20530323,17994661,83240606,1178946402.305100,743498284.682500,592607241.841100,2515051928.828700,372573,91389,180620,644582
2019-04-22,FINRA / Nasdaq TRF Chicago (DB),219139,54825,259173,533137,8660821.395100,2138521.530200,18779922.558100,29579265.483400,862,225,1210,2297
2019-04-22,FINRA / NYSE TRF (DN),206127552,82125893,201555073,489808518,6700270895.614500,2300813630.585300,7990926912.458599,16992011438.658399,561155,191106,559093,1311354
2019-04-22,FINRA / Nasdaq TRF Carteret (DQ),913362094,394895615,582207537,1890465246,37808308041.590806,22957561892.267804,28895455449.973307,89661325383.831917,3401677,737623,2077240,6216540
2019-04-22,EDGA Equities (J),82777043,26332008,41013624,150122675,3738102602.196000,1347286362.606200,2368468211.561700,7453857176.363900,918651,148920,495163,1562734
2019-04-22,EDGX Equities (K),105438176,41974209,79906554,227318939,4343458063.014700,2013538678.578800,4117387585.066600,10474384326.660100,840119,166942,561833,1568894
2019-04-22,NYSE Chicago (M),17540937,15065968,5299732,37906637,458637706.277700,1618988704.226000,615580285.655700,2693206696.159400,2947,2088,3418,8453
2019-04-22,NYSE (N),729977032,30991291,27834731,788803054,30382047277.215901,1863244956.706599,1354682068.339600,33599974302.262100,2288941,89345,183403,2561689
2019-04-22,NYSE Arca (P),151313650,220675063,141230888,513219601,6552257326.535302,11688096399.099101,7079185494.065297,25319539219.699700,1163638,568137,1073427,2805202
2019-04-22,NASDAQ (Q),336281150,112066757,470716302,919064209,15687655479.022402,6668042871.382502,25690826498.407497,48046524848.812401,3024710,447287,3102512,6574509
2019-04-22,IEX (V),99183777,14511394,49491730,163186901,4577654881.176600,904254006.596800,2717967451.765000,8199876339.538400,684068,69397,357206,1110671
2019-04-22,NASDAQ PSX (X),13434329,12162027,10983544,36579900,512660260.422900,786778187.886800,652709132.477900,1952147580.787600,101609,44913,76427,222949
2019-04-22,BYX Equities (Y),107955745,44321121,48776195,201053061,3570950476.883200,2156993260.728500,2097946128.100800,7825889865.712500,978058,227441,494756,1700255
2019-04-22,BZX Equities (Z),142555992,55644471,85058989,283259452,6007810884.273799,3270532492.928300,4664488833.088098,13942832210.290197,1320712,258326,812922,2391960
2019-04-18,NYSE American (A),6555446,15769146,2704239,25028831,282659305.702200,197160910.727700,163089648.103000,642909864.532900,64215,50892,30438,145545
2019-04-18,NASDAQ BX (B),71738311,19851463,36189660,127779434,3281564298.684000,1121442805.380000,2071417391.870100,6474424495.934100,709574,92330,372073,1173977
2019-04-18,NYSE National (C),47329497,25459652,21025160,93814309,1327237336.038700,964085636.870600,725772172.142400,3017095145.051700,393415,107731,202394,703540
2019-04-18,FINRA / Nasdaq TRF Chicago (DB),244254,52678,279170,576102,11027590.294700,2357648.673700,19871855.471800,33257094.440200,826,233,1254,2313
2019-04-18,FINRA / NYSE TRF (DN),238643846,81302202,207503674,527449722,8002980226.674001,2503208702.898200,7393573484.244302,17899762413.816503,575743,170331,541089,1287163
2019-04-18,FINRA / Nasdaq TRF Carteret (DQ),1033854163,399815008,667637014,2101306185,44092070576.033485,27162289258.247895,33130250345.087407,104384610179.368787,3820236,724045,2316208,6860489
2019-04-18,EDGA Equities (J),91125069,33255826,46029016,170409911,4086086299.740000,1791326611.297400,2484099624.655600,8361512535.693000,937652,167964,518248,1623864
2019-04-18,EDGX Equities (K),117019427,50136927,90041980,257198334,4907160500.615700,3017405513.666400,4533157108.661100,12457723122.943200,908531,204730,633168,1746429
2019-04-18,NYSE Chicago (M),15829863,17535647,13562210,46927720,631641174.861600,1424862309.010000,1599389038.240000,3655892522.111600,3638,2275,3935,9848
2019-04-18,NYSE (N),871762388,44608808,38353586,954724782,39340011635.311797,2764376804.597900,2058015355.958500,44162403795.868197,2454607,114192,218981,2787780
2019-04-18,NYSE Arca (P),181587224,260979505,160124082,602690811,7949301558.660000,14702816197.212806,8353497669.828201,31005615425.701007,1318838,686079,1225596,3230513
2019-04-18,NASDAQ (Q),396346420,144679915,610596782,1151623117,19684407214.324199,9281406788.977598,35683764021.180594,64649578024.482391,3410774,547879,3552304,7510957
2019-04-18,IEX (V),117309161,18841867,59498467,195649495,5548120258.754801,1234380774.383500,3266118802.307600,10048619835.445901,804702,83164,441876,1329742
2019-04-18,NASDAQ PSX (X),16620643,16295242,13404033,46319918,709287552.426000,1159547201.270300,1036698812.241300,2905533565.937600,122107,59358,104371,285836
2019-04-18,BYX Equities (Y),135281983,55701324,59909506,250892813,4676233661.954800,2832154247.413600,2666326237.428600,10174714146.797000,1167878,275323,588739,2031940
2019-04-18,BZX Equities (Z),165856151,75346592,97772644,338975387,7353812206.547300,4871458381.705200,5817735019.080699,18043005607.333199,1458153,331599,902138,2691890
2019-04-17,NYSE American (A),7160950,15306774,3416117,25883841,325160026.989200,210993773.478600,208429838.556200,744583639.024000,75679,49707,40001,165387
2019-04-17,NASDAQ BX (B),75818569,20108242,39350971,135277782,3502290212.463200,1105719691.449800,2276429381.249700,6884439285.162700,778529,95589,422963,1297081
2019-04-17,NYSE National (C),48075798,27031958,20084344,95192100,1380918913.112400,1045938434.616800,755814276.452400,3182671624.181600,390745,117756,202878,711379
2019-04-17,FINRA / Nasdaq TRF Chicago (DB),88869,12872,105466,207207,5141429.069500,523329.695100,9969659.807700,15634418.572300,339,75,475,889
2019-04-17,FINRA / NYSE TRF (DN),224995825,89184560,255757973,569938358,8292562117.515502,2879682846.891900,10148211906.394499,21320456870.801901,579207,190536,635142,1404885
2019-04-17,FINRA / Nasdaq TRF Carteret (DQ),1103757529,367889251,724518318,2196165098,48526181579.803399,20537332137.972401,36929364192.470496,105992877910.246296,3764822,767340,2442779,6974941
2019-04-17,EDGA Equities (J),112591931,37189027,58737190,208518148,5234245144.200500,1924837706.320600,3764325308.825100,10923408159.346200,1190944,195990,706546,2093480
2019-04-17,EDGX Equities (K),127755350,55160662,108502633,291418645,5559604747.981500,3298327317.324800,5881323591.236301,14739255656.542601,999074,213749,748229,1961052
2019-04-17,NYSE Chicago (M),10475929,12903642,9918790,33298361,549900422.278000,898554633.433000,1205283838.563800,2653738894.274800,3650,2565,5193,11408
2019-04-17,NYSE (N),841474252,42885150,41814680,926174082,34987104584.414101,2755067165.887900,2143171061.931600,39885342812.233601,2582441,121555,252124,2956120
2019-04-17,NYSE Arca (P),188310827,254441708,183849646,626602181,8347533402.680999,14653158986.633297,9870363807.826905,32871056197.141201,1404571,740625,1412782,3557978
2019-04-17,NASDAQ (Q),425953188,149167698,608544125,1183665011,21335553354.062104,9766102441.396402,33768178422.390721,64869834217.849227,3781951,612138,4098435,8492524
2019-04-17,IEX (V),125792342,17720035,65900407,209412784,6305321411.661298,1115078133.537700,3946404063.989701,11366803609.188699,879943,82356,495289,1457588
2019-04-17,NASDAQ PSX (X),18474953,15779709,14138717,48393379,699276302.967200,1146086703.127400,993030512.468300,2838393518.562900,129476,60169,112135,301780
2019-04-17,BYX Equities (Y),143446999,59722928,62300884,265470811,4671235817.525500,2897135742.624899,2768353407.693300,10336724967.843699,1222361,277138,615216,2114715
2019-04-17,BZX Equities (Z),193927684,82762686,120397984,397088354,8846243239.072400,5325371129.279599,7473586784.954801,21645201153.306800,1724534,377897,1180172,3282603
2019-04-16,NYSE American (A),6294001,13630258,2843685,22767944,296938794.720300,172302555.589200,197137934.910500,666379285.220000,66966,44808,35067,146841
2019-04-16,NASDAQ BX (B),80219914,18923876,42284758,141428548,3906186205.059500,1050967711.570800,2312908939.005700,7270062855.636000,838902,92322,452797,1384021
2019-04-16,NYSE National (C),44299525,23890198,18247918,86437641,1252830335.757300,856278777.941800,655822594.834100,2764931708.533200,364230,94774,177922,636926
2019-04-16,FINRA / Nasdaq TRF Chicago (DB),68843,12092,70449,151384,5035829.139300,396399.783000,8310087.330400,13742316.252700,321,32,413,766
2019-04-16,FINRA / NYSE TRF (DN),227847251,80112475,248785394,556745120,8411928298.861302,2515357356.745000,8916561988.022510,19843847643.628812,585914,179410,574931,1340255
2019-04-16,FINRA / Nasdaq TRF Carteret (DQ),1045840398,341017984,661015921,2047874303,42700161621.125896,20658850356.579292,30434046782.939604,93793058760.644792,3758495,798597,2228338,6785430
2019-04-16,EDGA Equities (J),87093898,29549645,40758783,157402326,3663721505.218300,1472262530.494000,2514940116.187100,7650924151.899400,866073,154887,462504,1483464
2019-04-16,EDGX Equities (K),116901656,46612099,95508521,259022276,5065211374.840599,2865545249.490899,4644536112.579498,12575292736.910996,905757,180629,611243,1697629
2019-04-16,NYSE Chicago (M),11164714,11016101,12501919,34682734,488659737.018300,1116148334.710000,970302018.065000,2575110089.793300,3019,1886,3835,8740
2019-04-16,NYSE (N),759751933,39046866,37844195,836642994,31394213024.172996,2481480251.323400,1761841592.656700,35637534868.153096,2439497,105047,213744,2758288
2019-04-16,NYSE Arca (P),182936582,245629203,172230836,600796621,7881701169.865002,13237443092.511002,8860756197.961499,29979900460.337503,1305005,622178,1233260,3160443
2019-04-16,NASDAQ (Q),404081315,134979085,537547082,1076607482,19405296100.019705,8414455888.329000,29292508747.188993,57112260735.537698,3508492,505778,3527518,7541788
2019-04-16,IEX (V),116063401,14411711,60028899,190504011,5561646511.153400,925382160.071400,3329981131.373900,9817009802.598700,800686,76507,432556,1309749
2019-04-16,NASDAQ PSX (X),16360744,14982790,13051298,44394832,607523848.218400,1012402617.987200,832885531.690400,2452811997.896000,116664,54198,96746,267608
2019-04-16,BYX Equities (Y),134649572,51817019,55584392,242050983,4452567074.349400,2511929547.833700,2366498781.007200,9330995403.190300,1122538,241136,535589,1899263
2019-04-16,BZX Equities (Z),169550751,66199034,104440896,340190681,7600292588.656100,4266048317.419201,6268067107.967300,18134408014.042601,1505626,290602,963495,2759723
2019-04-15,NYSE American (A),5385044,12976784,2270763,20632591,225427088.424200,165930577.483700,136136224.427400,527493890.335300,57356,42603,27509,127468
2019-04-15,NASDAQ BX (B),71789185,16824670,36360923,124974778,3293236526.823000,990130087.341100,2014372232.756500,6297738846.920600,768336,90230,420334,1278900
2019-04-15,NYSE National (C),44489987,22509533,19075481,86075001,1232778735.740100,814215408.438000,665155825.343000,2712149969.521100,392981,97932,199221,690134
2019-04-15,FINRA / Nasdaq TRF Chicago (DB),12542,1936,11889,26367,1342033.741000,57940.830000,1408804.932000,2808779.503000,58,12,106,176
2019-04-15,FINRA / NYSE TRF (DN),207504929,74481705,210482318,492468952,6776543937.780196,2229603821.025901,7175157040.895801,16181304799.701898,559512,175686,552339,1287537
2019-04-15,FINRA / Nasdaq TRF Carteret (DQ),931798697,284739074,580627339,1797165110,38054859303.610803,17412314829.970393,26648772417.085590,82115946550.666786,3349304,691673,1952712,5993689
2019-04-15,EDGA Equities (J),77326915,26552468,35481855,139361238,3082332147.085000,1333489584.964900,2132893323.427800,6548715055.477700,754282,139845,413356,1307483
2019-04-15,EDGX Equities (K),103692704,39850279,81141826,224684809,4253414086.810800,2357294970.851001,3697078667.794400,10307787725.456201,803881,154739,543023,1501643
2019-04-15,NYSE Chicago (M),10535880,7686565,8180165,26402610,361846346.610300,646157351.339000,531064661.908200,1539068359.857500,3358,1998,3147,8503
2019-04-15,NYSE (N),754835041,33211727,32898575,820945343,31365538397.851299,2120363216.514300,1477514986.536500,34963416600.902099,2178259,97483,188836,2464578
2019-04-15,NYSE Arca (P),157814409,204574638,150456434,512845481,6895157107.281998,11482369497.357400,6876336419.024101,25253863023.663499,1144923,559310,1076976,2781209
2019-04-15,NASDAQ (Q),359321664,114921577,472052963,946296204,16826756473.881507,7107707574.736701,25786781940.883806,49721245989.502014,3097027,456597,3106418,6660042
2019-04-15,IEX (V),103048390,14832288,48088848,165969526,4683272725.194900,951858424.471600,2532386079.748900,8167517229.415400,724976,70300,365196,1160472
2019-04-15,NASDAQ PSX (X),14560129,12538236,11115725,38214090,496074215.968400,856065491.050000,727872037.954200,2080011744.972600,99218,48651,88465,236334
2019-04-15,BYX Equities (Y),121591068,45405945,52807481,219804494,3913452652.456100,2202599939.182500,2159068370.483000,8275120962.121600,1052451,222285,531498,1806234
2019-04-15,BZX Equities (Z),150826911,57620316,86657958,295105185,6644908818.466599,3698279635.550600,4905045428.472499,15248233882.489698,1337437,263328,828760,2429525
2019-04-12,NYSE American (A),6402126,11696560,2569935,20668621,302727357.930300,177679109.394900,147854256.998900,628260724.324100,65161,39464,28277,132902
2019-04-12,NASDAQ BX (B),82640534,19919226,37479109,140038869,3893950679.491600,1166911005.066600,2151426718.083000,7212288402.641200,856419,97253,429182,1382854
2019-04-12,NYSE National (C),51879482,26015858,20024052,97919392,1445748118.234900,950252091.810900,700057387.409700,3096057597.455500,431871,107051,202495,741417
2019-04-12,FINRA / Nasdaq TRF Chicago (DB),10617,2799,12756,26172,867978.666800,118408.950000,1650109.480000,2636497.096800,52,14,115,181
2019-04-12,FINRA / NYSE TRF (DN),231628149,78318174,228288737,538235060,8666155859.630003,2598158024.784599,7707259113.680303,18971572998.094905,588995,163266,549891,1302152
2019-04-12,FINRA / Nasdaq TRF Carteret (DQ),1180171557,344312565,638894512,2163378634,51373590424.201685,23193798695.716204,29997343000.146902,104564732120.064791,3811811,714276,1983142,6509229
2019-04-12,EDGA Equities (J),93541434,32414826,38731492,164687752,3905750583.535700,1620966122.588000,2369570181.195800,7896286887.319500,886078,161533,433724,1481335
2019-04-12,EDGX Equities (K),125310162,48464255,88214220,261988637,5491309281.939303,2927389116.515099,4458754085.691298,12877452484.145700,920319,183982,568885,1673186
2019-04-12,NYSE Chicago (M),8846994,9889261,8176366,26912621,360690938.462500,826530248.990000,494468467.775900,1681689655.228400,3313,2004,3378,8695
2019-04-12,NYSE (N),804573958,42978147,34316976,881869081,33519458422.423806,2618170490.115100,1743486602.030600,37881115514.569506,2435345,107476,204936,2747757
2019-04-12,NYSE Arca (P),209012746,252248423,158515057,619776226,9743486576.794597,14103296292.532398,7531907440.275703,31378690309.602698,1443399,638782,1102107,3184288
2019-04-12,NASDAQ (Q),438872713,142390051,503925999,1085188763,21608505567.248315,9054071905.551596,27979613703.188907,58642191175.988818,3653745,534261,3175589,7363595
2019-04-12,IEX (V),121125457,16412515,47462484,185000456,5737311464.422900,1104812006.588700,2743074411.386200,9585197882.397800,831270,75665,373549,1280484
2019-04-12,NASDAQ PSX (X),18923144,16649292,11866324,47438760,740629443.625500,1162100774.596300,866031509.751400,2768761727.973200,131346,59950,93179,284475
2019-04-12,BYX Equities (Y),147323484,60226694,55202675,262752853,5060588744.348601,2861712437.664699,2309125533.637400,10231426715.650700,1250951,269517,544952,2065420
2019-04-12,BZX Equities (Z),205794487,77452117,95222558,378469162,9337597763.276202,4831422980.981498,5996142055.411300,20165162799.669000,1718643,328376,904728,2951747
2019-04-11,NYSE American (A),5371445,12731725,2529267,20632437,227027669.362000,176217693.453700,144271066.412300,547516429.228000,52336,43374,27209,122919
2019-04-11,NASDAQ BX (B),69522821,20461393,37856710,127840924,3158886921.870800,1059597604.184700,2020211303.236400,6238695829.291900,741954,97848,413787,1253589
2019-04-11,NYSE National (C),46279152,27811999,20394005,94485156,1249011824.961000,991392792.174800,664598042.662600,2905002659.798400,387409,113303,198490,699202
2019-04-11,FINRA / Nasdaq TRF Chicago (DB),816,100,3550,4466,41282.180000,1207.000000,583101.170000,625590.350000,3,1,17,21
2019-04-11,FINRA / NYSE TRF (DN),194117993,73327945,224237347,491683285,5530281962.622699,2481814276.151100,7056653507.102998,15068749745.876797,478671,166003,543934,1188608
2019-04-11,FINRA / Nasdaq TRF Carteret (DQ),898836488,328490093,635604858,1862931439,34978357667.274298,18529847367.566998,25599018228.937793,79107223263.779089,3023051,696342,1936246,5655639
2019-04-11,EDGA Equities (J),75905872,33802110,39283664,148991646,3074990804.658400,1606471356.152400,2309264975.322000,6990727136.132800,737864,171726,423411,1333001
2019-04-11,EDGX Equities (K),106387197,48808997,92746994,247943188,4071996888.725800,2960510652.151397,3852793383.840100,10885300924.717297,776499,176475,566801,1519775
2019-04-11,NYSE Chicago (M),9827392,12563713,9137904,31529009,442051307.283800,985480770.790000,412945112.324500,1840477190.398300,2772,1688,2914,7374
2019-04-11,NYSE (N),705196986,42313447,38184732,785695165,27613930197.668001,2391991955.360500,1672330565.882500,31678252718.911001,2108028,109375,203079,2420482
2019-04-11,NYSE Arca (P),151050925,241745736,163645919,556442580,6385807210.533000,13039224813.012903,6987690264.075094,26412722287.620997,1110999,596561,1106262,2813822
2019-04-11,NASDAQ (Q),330363061,134078216,496350417,960791694,15430897513.504903,8460153677.840805,25081242789.166613,48972293980.512321,2956824,529695,3196462,6682981
2019-04-11,IEX (V),93742554,16534949,48714267,158991770,4215977617.344500,976177007.252100,2557290405.300700,7749445029.897300,666142,75528,361692,1103362
2019-04-11,NASDAQ PSX (X),13490000,16261832,13003310,42755142,473539333.034800,1203613298.734300,789604233.459800,2466756865.228900,96890,58952,88870,244712
2019-04-11,BYX Equities (Y),125506443,59129806,56882236,241518485,4052923302.328400,2749781658.137900,2195604139.109300,8998309099.575600,1072650,269278,556595,1898523
2019-04-11,BZX Equities (Z),145053541,75619059,90913620,311586220,6140684884.155599,4599464925.067800,5051466077.939501,15791615887.162900,1284969,313877,845642,2444488
2019-04-10,NYSE American (A),4902273,14285260,2154586,21342119,208380085.885200,169288593.733900,120708293.828700,498376973.447800,51877,41374,25484,118735
2019-04-10,NASDAQ BX (B),74766058,19967466,39229277,133962801,3347816175.893800,1084143245.720100,2057919591.997600,6489879013.611500,785991,96583,437902,1320476
2019-04-10,NYSE National (C),44590759,22795157,19070870,86456786,1222704604.481700,869041010.200000,690795061.409900,2782540676.091600,367544,95908,186912,650364
2019-04-10,FINRA / Nasdaq TRF Chicago (DB),1510,0,2941,4451,64522.640000,0.000000,450742.040000,515264.680000,5,0,15,20
2019-04-10,FINRA / NYSE TRF (DN),201191449,85733451,249592485,536517385,5635181431.382900,2302382479.766400,7862726762.569997,15800290673.719297,480549,161624,570201,1212374
2019-04-10,FINRA / Nasdaq TRF Carteret (DQ),920624366,347528340,609278857,1877431563,34838569617.368993,19552046228.035097,26085912089.689002,80476527935.093092,3142092,644233,1980317,5766642
2019-04-10,EDGA Equities (J),78527436,31725111,39362126,149614673,3057840902.592200,1635907103.040100,2261158780.975301,6954906786.607601,750643,160665,433159,1344467
2019-04-10,EDGX Equities (K),110212319,50028767,101735280,261976366,4034404894.746001,2862845342.240300,4146163658.726403,11043413895.712704,808324,176930,602930,1588184
2019-04-10,NYSE Chicago (M),12470912,12394484,6630018,31495414,504502081.624800,1639725351.405000,505580867.185400,2649808300.215200,3285,2022,2973,8280
2019-04-10,NYSE (N),744281930,39123567,34811294,818216791,27426446055.650302,2373403889.649200,1593640030.291600,31393489975.591102,2244580,106069,198261,2548910
2019-04-10,NYSE Arca (P),157128150,224286729,167241111,548655990,6294774310.424100,12758924935.146397,7208282486.057299,26261981731.627796,1111212,600956,1134188,2846356
2019-04-10,NASDAQ (Q),359786026,130677776,531994503,1022458305,16172246754.711102,8448974223.174599,26350339843.161805,50971560821.047506,3156119,520999,3404065,7081183
2019-04-10,IEX (V),95060612,14574446,50106924,159741982,4033998281.607801,948932728.184000,2677340486.588300,7660271496.380101,684423,68844,376972,1130239
2019-04-10,NASDAQ PSX (X),14710312,15172371,12760524,42643207,499852574.880200,1199258859.668500,824474494.095800,2523585928.644500,102974,56824,95467,255265
2019-04-10,BYX Equities (Y),124396377,55458024,57222972,237077373,4033311101.612300,2703579729.611500,2251540389.146100,8988431220.369900,1060796,262479,547303,1870578
2019-04-10,BZX Equities (Z),149581359,69765069,91104792,310451220,6263341162.519600,4555948858.884401,5192637108.866601,16011927130.270602,1328918,306613,885645,2521176
2019-04-09,NYSE American (A),5590228,16354451,2602001,24546680,225425008.394500,168310072.022600,151029603.082600,544764683.499700,58546,45570,30338,134454
2019-04-09,NASDAQ BX (B),74162160,21791643,40792018,136745821,3376503873.862500,1205738796.367200,2285502335.427200,6867745005.656900,771464,107843,431222,1310529
2019-04-09,NYSE National (C),47840562,21332332,22019454,91192348,1249627120.172300,786744313.081600,767371791.070600,2803743224.324500,407662,92037,212909,712608
2019-04-09,FINRA / NYSE TRF (DN),189169681,107571875,254320136,551061692,5480632477.727501,2775719343.736000,8367255912.947707,16623607734.411208,467309,191707,563223,1222239
2019-04-09,FINRA / Nasdaq TRF Carteret (DQ),874416329,413526978,653067460,1941010767,33263920632.287794,22364484537.227493,28997893788.500395,84626298958.015682,3083045,764844,2014225,5862114
2019-04-09,EDGA Equities (J),92126579,37277835,47847963,177252377,3559197282.159900,1834907714.724900,2691478820.022001,8085583816.906801,884576,188064,487267,1559907
2019-04-09,EDGX Equities (K),112022701,57917439,104309756,274249896,4238781907.865700,3218043542.829800,4310004973.410902,11766830424.106402,825165,195727,586877,1607769
2019-04-09,NYSE Chicago (M),8655710,10099822,4238635,22994167,425917890.032000,997601001.761000,412539038.473100,1836057930.266100,2910,2470,3111,8491
2019-04-09,NYSE (N),717231665,40474761,37362180,795068606,27905378182.597805,2511242938.537000,1790261302.584800,32206882423.719605,2142437,108240,205606,2456283
2019-04-09,NYSE Arca (P),152896379,259147869,163181958,575226206,6106844469.365699,14279370618.395705,7573530426.788802,27959745514.550206,1090464,639045,1115272,2844781
2019-04-09,NASDAQ (Q),360287437,146851716,533273261,1040412414,16008355540.267495,9773838198.655203,27843355368.933403,53625549107.856101,3018311,561099,3267721,6847131
2019-04-09,IEX (V),97857937,19096060,50428055,167382052,4236273891.175799,1182585754.502500,2936182666.779200,8355042312.457499,714335,80838,387626,1182799
2019-04-09,NASDAQ PSX (X),17151185,16726225,13131521,47008931,528477676.011300,1313341024.324100,906520679.036500,2748339379.371900,111691,63497,93956,269144
2019-04-09,BYX Equities (Y),132213426,60567418,59091100,251871944,4024299029.994600,3123714737.435700,2494521367.451700,9642535134.882000,1104842,289308,560722,1954872
2019-04-09,BZX Equities (Z),150864696,75240831,93144138,319249665,6187071922.793700,5122748519.161401,5575052385.172200,16884872827.127301,1315412,325882,870067,2511361
2019-04-08,NYSE American (A),5847513,14396941,2234139,22478593,240134653.781900,157862483.484100,135690286.979100,533687424.245100,61116,41236,26656,129008
2019-04-08,NASDAQ BX (B),69498563,19707073,38428159,127633795,3155769214.894000,1038162920.758300,2038999040.882900,6232931176.535200,745900,100988,412056,1258944
2019-04-08,NYSE National (C),46091085,20470756,19522884,86084725,1254993840.391500,719356743.504600,672976472.170100,2647327056.066200,385517,96355,191367,673239
2019-04-08,FINRA / NYSE TRF (DN),201185411,79334236,292040662,572560309,5959801327.926904,2304543297.638100,7960395147.456804,16224739773.021808,497889,181170,600669,1279728
2019-04-08,FINRA / Nasdaq TRF Carteret (DQ),878518702,304453375,620144287,1803116364,34491520839.215597,17844629899.710804,26381278236.589488,78717428975.515889,3124039,726921,1972563,5823523
2019-04-08,EDGA Equities (J),91950301,33837390,46366965,172154656,3488670094.689500,1629735187.276300,2409862605.658700,7528267887.624500,889989,181981,485217,1557187
2019-04-08,EDGX Equities (K),111863432,48477376,115772453,276113261,4357577883.048099,2668040911.937999,4102658978.776698,11128277773.762796,822648,183592,579340,1585580
2019-04-08,NYSE Chicago (M),7482810,14525892,3916686,25925388,343959177.703300,1006056976.690000,477184351.481300,1827200505.874600,3131,2148,3393,8672
2019-04-08,NYSE (N),744263059,35990396,34589632,814843087,30248929566.899999,2135524315.906500,1608817693.481900,33993271576.288399,2146523,112561,198324,2457408
2019-04-08,NYSE Arca (P),150893644,216905149,164471041,532269834,6168728276.692900,12128798317.461993,6874941429.155803,25172468023.310696,1063155,576173,1060555,2699883
2019-04-08,NASDAQ (Q),358452588,126328892,534010139,1018791619,15790257532.434103,8068133605.387001,26811168149.029912,50669559286.851016,2954807,514323,3182673,6651803
2019-04-08,IEX (V),92174061,16627062,45739978,154541101,4006176505.229100,1046471790.861300,2534492651.900100,7587140947.990500,655769,78192,351425,1085386
2019-04-08,NASDAQ PSX (X),16863280,14698671,12544397,44106348,552570082.521500,1062874592.911100,757368073.363500,2372812748.796100,109220,61696,85731,256647
2019-04-08,BYX Equities (Y),134000284,54042994,58467619,246510897,4108818434.241800,2733317201.681100,2396415235.158900,9238550871.081800,1132669,289615,561767,1984051
2019-04-08,BZX Equities (Z),147376651,66956401,87309155,301642207,6133775978.693000,4381242038.301498,4917856944.780800,15432874961.775298,1294108,299808,839083,2432999
2019-04-05,NYSE American (A),5508901,12959370,2694431,21162702,242826023.193400,174299038.852400,162413865.452900,579538927.498700,59194,38673,28730,126597
2019-04-05,NASDAQ BX (B),71926963,20404459,40523539,132854961,3346563119.438400,1174302807.374200,2130499907.614500,6651365834.427100,763848,104094,436909,1304851
2019-04-05,NYSE National (C),48252017,23127446,22200962,93580425,1287103603.335200,809692273.580300,750523216.455800,2847319093.371300,403467,94731,216220,714418
2019-04-05,FINRA / NYSE TRF (DN),205155097,77670331,270973164,553798592,6121611879.238300,2474646140.676901,7919346262.597002,16515604282.512203,500348,171042,590042,1261432
2019-04-05,FINRA / Nasdaq TRF Carteret (DQ),958371437,350237296,689085776,1997694509,38495977132.218104,21641953061.358201,30006435973.795907,90144366167.372212,3205706,725906,2049158,5980770
2019-04-05,EDGA Equities (J),68565829,33617510,36153513,138336852,2524496341.957000,1687947562.589700,1980213385.471600,6192657290.018300,641078,164372,362931,1168381
2019-04-05,EDGX Equities (K),115572215,52376888,101980593,269929696,4528083025.145200,3105602237.601100,4344659025.410000,11978344288.156300,839745,199300,594808,1633853
2019-04-05,NYSE Chicago (M),8726504,10413059,5931194,25070757,329628953.503700,780535169.238200,501935569.383500,1612099692.125400,3108,1649,3372,8129
2019-04-05,NYSE (N),775175444,41047199,35975315,852197958,31250710550.261899,2445513840.999200,1692262972.680500,35388487363.941599,2180734,111471,209885,2502090
2019-04-05,NYSE Arca (P),153703522,222582893,169855194,546141609,6441218794.516603,12925896089.712395,7353675703.951501,26720790588.180499,1083716,616425,1087016,2787157
2019-04-05,NASDAQ (Q),354715077,134261208,561478894,1050455179,16158678614.722396,8679784485.947998,27720278920.937608,52558742021.608002,2972189,536078,3187833,6696100
2019-04-05,IEX (V),99018828,17904397,50989567,167912792,4522616678.343700,1185223600.191000,2818031372.564901,8525871651.099601,716113,91885,385592,1193590
2019-04-05,NASDAQ PSX (X),15961623,17357486,12879973,46199082,535656021.709000,1336331541.203800,874101158.477600,2746088721.390400,106203,69107,91277,266587
2019-04-05,BYX Equities (Y),129038625,60452019,62617412,252108056,4145970904.380400,3000028550.192200,2472849451.745400,9618848906.318000,1128279,301981,591968,2022228
2019-04-05,BZX Equities (Z),146282311,74348366,93719951,314350628,6393438722.085100,4822031150.379201,5475977267.466899,16691447139.931200,1305248,326464,879963,2511675
2019-04-04,NYSE American (A),5395045,14043923,2967200,22406168,233682086.476700,212295766.766100,169607252.156300,615585105.399100,59613,44793,32973,137379
2019-04-04,NASDAQ BX (B),75055320,21048790,44581169,140685279,3468766590.944500,1144590688.093700,2355831225.994200,6969188505.032400,791124,108433,469112,1368669
2019-04-04,NYSE National (C),50278872,27108420,23537864,100925156,1347008769.396900,936132050.427900,827331524.178000,3110472344.002800,422755,109897,226375,759027
2019-04-04,FINRA / NYSE TRF (DN),196078727,82847112,237944483,516870322,6280364199.711900,2530979453.920699,8967715985.035206,17779059638.667805,497097,169310,623133,1289540
2019-04-04,FINRA / Nasdaq TRF Carteret (DQ),876486054,349612625,649800535,1875899214,36151382253.881606,17843905511.946803,29905643081.208404,83900930847.036813,3316996,740217,2319397,6376610
2019-04-04,EDGA Equities (J),69542553,34813916,37745717,142102186,2566755027.499900,1754153846.989800,2141866972.343100,6462775846.832800,644748,177368,393610,1215726
2019-04-04,EDGX Equities (K),112961827,50392315,103073252,266427394,4658858045.044702,3010290103.230299,4901659335.820998,12570807484.095999,868848,207958,681409,1758215
2019-04-04,NYSE Chicago (M),8820853,11314283,4611477,24746613,366249241.263100,733432274.140000,491669349.646700,1591350865.049800,3537,2526,4314,10377
2019-04-04,NYSE (N),713420322,44734793,41644736,799799851,28682170482.106902,2650280686.217300,1949994097.309200,33282445265.633402,2330279,122400,235977,2688656
2019-04-04,NYSE Arca (P),158386573,259142738,180362096,597891407,6728366113.372401,13922814853.356709,8704756125.250302,29355937091.979412,1134732,683970,1256354,3075056
2019-04-04,NASDAQ (Q),365003902,144487071,577254475,1086745448,17192005883.457903,9005847581.747299,31412839698.671700,57610693163.876902,3189095,562585,3701901,7453581
2019-04-04,IEX (V),100754217,17866108,58744781,177365106,4733847205.487200,1104390417.060800,3303314199.846501,9141551822.394501,729466,79042,439074,1247582
2019-04-04,NASDAQ PSX (X),15770632,19023342,14848929,49642903,559079455.183600,1315856735.706500,955599305.096500,2830535495.986600,109271,70513,108075,287859
2019-04-04,BYX Equities (Y),134345015,70181074,68968820,273494909,4333626305.141200,3360664542.651600,2753912780.755700,10448203628.548500,1184802,343051,648953,2176806
2019-04-04,BZX Equities (Z),156441552,78448090,106563928,341453570,6975432287.605399,5048205081.965200,6218207258.674495,18241844628.245094,1419613,350948,1004482,2775043
2019-04-03,NYSE American (A),6316758,12731750,3254595,22303103,252100586.260000,170459781.722100,194845070.627600,617405438.609700,65351,41633,36342,143326
2019-04-03,NASDAQ BX (B),86376552,24103005,50948505,161428062,3900713337.334100,1356702737.450300,2791021238.557300,8048437313.341700,898699,123785,527775,1550259
2019-04-03,NYSE National (C),54421955,28930045,26417341,109769341,1427186680.334300,1005729055.657800,895963606.131400,3328879342.123500,448443,115788,246520,810751
2019-04-03,FINRA / Nasdaq TRF Chicago (DB),20,0,1,21,7795.400000,0.000000,1825.730000,9621.130000,1,0,1,2
2019-04-03,FINRA / NYSE TRF (DN),218151955,88020696,275085203,581257854,6482646479.723199,3022445030.110400,10903483393.103894,20408574902.937493,537920,182113,676897,1396930
2019-04-03,FINRA / Nasdaq TRF Carteret (DQ),1016706964,377984144,774104184,2168795292,39402860728.918909,22677561466.865001,35973144202.408479,98053566398.192389,3567903,873141,2479792,6920836
2019-04-03,EDGA Equities (J),79785742,41050677,41633571,162469990,2809415056.396301,2003863592.649100,2400114618.829600,7213393267.875001,713595,207454,416534,1337583
2019-04-03,EDGX Equities (K),135752040,63342863,116763410,315858313,5264038603.173599,3935015795.076899,5552920893.412201,14751975291.662699,1008579,245843,755893,2010315
2019-04-03,NYSE Chicago (M),19815201,10220964,6853646,36889811,570624235.281000,827347349.350000,619759585.809200,2017731170.440200,3974,2811,4220,11005
2019-04-03,NYSE (N),869945743,50581723,50743171,971270637,35234726995.461593,2974851670.814400,2246604539.928300,40456183206.204293,2563637,135916,263969,2963522
2019-04-03,NYSE Arca (P),178855221,274581120,198502097,651938438,7307598988.146800,15206846272.219201,9339899597.954604,31854344858.320605,1273694,734480,1348460,3356634
2019-04-03,NASDAQ (Q),425554131,162855255,675973149,1264382535,19264695949.915501,10924887226.160203,36601941618.074506,66791524794.150210,3644793,625360,4011921,8282074
2019-04-03,IEX (V),114272751,18281495,63781361,196335607,5208470641.980400,1168546986.564300,3491224844.361401,9868242472.906101,833500,89321,481140,1403961
2019-04-03,NASDAQ PSX (X),19273390,20546914,18954798,58775102,624266630.459700,1537276322.257101,1189653778.054400,3351196730.771201,124747,78709,130067,333523
2019-04-03,BYX Equities (Y),160131453,75138927,78673856,313944236,4908540356.653700,3468355590.695100,3190651025.121799,11567546972.470599,1361167,360965,727076,2449208
2019-04-03,BZX Equities (Z),184649882,96783508,127946398,409379788,7753083197.474100,6261709087.564100,7320250576.989498,21335042862.027698,1621109,409462,1154839,3185410
2019-04-02,NYSE American (A),5794053,13817506,2526745,22138304,234048431.501000,168834072.861700,143478751.121700,546361255.484400,61019,44408,29666,135093
2019-04-02,NASDAQ BX (B),83721853,20604085,43248976,147574914,3648223329.269600,1080085889.290900,2260269742.170400,6988578960.730900,877354,106444,467332,1451130
2019-04-02,NYSE National (C),53650187,24306882,22746595,100703664,1456093813.444300,891121710.176600,785911782.251200,3133127305.872100,458085,97965,223746,779796
2019-04-02,FINRA / NYSE TRF (DN),197408419,77054826,234802392,509265637,5655434032.463798,2440873442.928501,8401529858.931398,16497837334.323697,508259,177791,586176,1272226
2019-04-02,FINRA / Nasdaq TRF Carteret (DQ),974953756,349155620,686817657,2010927033,37030379943.429797,19227782267.993703,30792180550.079792,87050342761.503292,3478377,841283,2219840,6539500
2019-04-02,EDGA Equities (J),79162091,36511569,36823170,152496830,2780266913.558200,1690490596.036000,2114502771.446500,6585260281.040700,735386,184088,396683,1316157
2019-04-02,EDGX Equities (K),119621334,49643784,95309403,264574521,4419941460.135299,2854416163.687301,4284341831.611599,11558699455.434199,878653,191046,623106,1692805
2019-04-02,NYSE Chicago (M),9653982,12194750,5528520,27377252,293842014.993700,760076332.880000,498654565.328400,1552572913.202100,3521,2389,3775,9685
2019-04-02,NYSE (N),743250610,35484131,36477846,815212587,28229872673.244505,1916424348.270300,1543752075.544000,31690049097.058805,2361029,99456,217075,2677560
2019-04-02,NYSE Arca (P),163441107,228151095,163839617,555431819,6508413436.325402,12722964474.895600,7446068583.953497,26677446495.174499,1177344,617900,1164859,2960103
2019-04-02,NASDAQ (Q),398103894,141189910,558522761,1097816565,18145286047.849305,8562939286.580801,29262313116.764693,55970538451.194799,3511747,540143,3578878,7630768
2019-04-02,IEX (V),106793504,15649747,56805189,179248440,4628092972.503100,917611809.380800,3044864190.795699,8590568972.679599,776905,78566,435351,1290822
2019-04-02,NASDAQ PSX (X),17340012,16388738,12378870,46107620,586583469.542600,1121697719.204600,739186486.782000,2447467675.529200,120055,64794,89953,274802
2019-04-02,BYX Equities (Y),150090643,64157913,67377595,281626151,4793661130.369800,3064096288.780600,2757461411.657400,10615218830.807800,1316764,316687,648595,2282046
2019-04-02,BZX Equities (Z),164230905,77579996,100050349,341861250,6938181350.787602,4612152747.996700,5480990697.114702,17031324795.899004,1489624,327984,949470,2767078
2019-04-01,NYSE American (A),6481894,14650767,2998038,24130699,277482414.365100,272339350.596600,170552895.296300,720374660.258000,71722,53001,35613,160336
2019-04-01,NASDAQ BX (B),87299162,27261804,46426630,160987596,4037125908.327200,1606909711.858000,2601275617.990000,8245311238.175200,931081,140195,504058,1575334
2019-04-01,NYSE National (C),59146406,34266814,24647525,118060745,1561551831.436400,1256598246.259400,880328056.596800,3698478134.292600,485298,125487,235150,845935
2019-04-01,FINRA / NYSE TRF (DN),216246108,95533940,229901496,541681544,6584069328.868501,3242260669.730499,9159793149.087701,18986123147.686701,565184,218538,628279,1412001
2019-04-01,FINRA / Nasdaq TRF Carteret (DQ),1047109069,477570736,729169615,2253849420,43143436011.856599,28842810510.033200,35400479560.536304,107386726082.426103,3745840,946320,2422223,7114383
2019-04-01,EDGA Equities (J),86179031,46991789,40650556,173821376,3179135476.150000,2495290393.044200,2494358837.347199,8168784706.541399,792009,239951,430622,1462582
2019-04-01,EDGX Equities (K),125628295,67308766,98239027,291176088,5193872505.593699,4106210729.933300,5118387569.901398,14418470805.428397,954787,254250,682954,1891991
2019-04-01,NYSE Chicago (M),9172367,8636792,6296164,24105323,337631472.233100,801465374.572000,516221154.138800,1655318000.943900,4376,4028,4505,12909
2019-04-01,NYSE (N),837282499,52274351,44193123,933749973,33834694215.257203,3291093583.438000,2103069388.398700,39228857187.093903,2767369,149978,270885,3188232
2019-04-01,NYSE Arca (P),179072574,311970300,168832131,659875005,7475257225.391397,18136869355.069497,8535539996.776298,34147666577.237192,1278821,785910,1258064,3322795
2019-04-01,NASDAQ (Q),427483310,170121595,582916322,1180521227,20201297908.015406,11355825866.767200,33113656306.126012,64670780080.908618,3799962,668116,4006900,8474978
2019-04-01,IEX (V),110488462,23992535,57600380,192081377,5022781771.828700,1550553224.808400,3239570348.580700,9812905345.217800,836489,107611,455870,1399970
2019-04-01,NASDAQ PSX (X),18823478,21488616,13895582,54207676,669024947.323100,1580506566.857900,902697551.171100,3152229065.352100,135433,79153,104242,318828
2019-04-01,BYX Equities (Y),164233793,84182109,72839891,321255793,5433377480.132299,4256548929.469100,3129832050.813301,12819758460.414700,1442666,415588,708860,2567114
2019-04-01,BZX Equities (Z),185447233,99649046,111444006,396540285,8061832483.578800,6482403499.333601,6415176353.438500,20959412336.350901,1687403,423368,1073923,3184694
2019-03-29,NYSE American (A),6673111,18975325,3265075,28913511,275510916.862100,254230829.244000,167118372.046900,696860118.153000,68066,52336,33655,154057
2019-03-29,NASDAQ BX (B),88506840,27201420,46642597,162350857,3951584647.898600,1590523607.386400,2388816605.988900,7930924861.273900,909937,134618,491306,1535861
2019-03-29,NYSE National (C),62363939,29133512,26508285,118005736,1628653218.912800,1124490941.438500,928190276.517600,3681334436.868900,504381,107413,245265,857059
2019-03-29,FINRA / NYSE TRF (DN),191323104,83509219,202865242,477697565,5736083581.291498,2786211014.350400,7604190487.061997,16126485082.703895,485118,176441,558555,1220114
2019-03-29,FINRA / Nasdaq TRF Carteret (DQ),1049829573,390293985,679613923,2119737481,42737283687.168798,25143804810.887497,32440663144.101120,100321751642.157415,3517798,849234,2231035,6598067
2019-03-29,EDGA Equities (J),85858105,45551120,41050144,172459369,3056848141.711000,2423543560.351100,2327410109.760000,7807801811.822100,749221,220210,411717,1381148
2019-03-29,EDGX Equities (K),113645815,62274577,95991250,271911642,4817828554.872801,4142869458.986101,4658917943.026000,13619615956.884902,875048,248604,620721,1744373
2019-03-29,NYSE Chicago (M),11855665,11651670,8286146,31793481,392573432.400000,979603715.316400,472376440.399300,1844553588.115700,4768,3947,4230,12945
2019-03-29,NYSE (N),1089562714,54675480,48477464,1192715658,45948023430.588901,3392212074.484301,2209437666.510099,51549673171.583301,2617634,149976,265712,3033322
2019-03-29,NYSE Arca (P),175667494,298847446,171877651,646392591,7509534066.312802,18286487727.979005,8702802412.602796,34498824206.894603,1316480,809550,1237172,3363202
2019-03-29,NASDAQ (Q),418838699,171647119,733710296,1324196114,19533527190.668295,11131474728.038004,39836000236.507690,70501002155.213989,3633992,695687,3741856,8071535
2019-03-29,IEX (V),112516083,22258845,59458597,194233525,4935375130.068200,1351520706.385600,3179755696.554400,9466651533.008200,813080,98532,446600,1358212
2019-03-29,NASDAQ PSX (X),18478307,20653103,14172912,53304322,662903933.103900,1638182879.248500,909776415.637100,3210863227.989500,131428,81418,102132,314978
2019-03-29,BYX Equities (Y),154109858,77491537,70948523,302549918,4921591559.090100,3769029932.915600,2952306107.891200,11642927599.896900,1311641,365755,669914,2347310
2019-03-29,BZX Equities (Z),173293586,87023447,108923519,369240552,7614838984.511199,6062235202.505699,6298736769.147502,19975810956.164400,1558525,393544,1008939,2961008
2019-03-28,NYSE American (A),5788407,13244869,2459403,21492679,235923817.217000,171430935.226500,122477686.444000,529832438.887500,59598,47322,27888,134808
2019-03-28,NASDAQ BX (B),79910445,24525185,42984578,147420208,3436388875.461900,1193142775.135000,2184690897.387700,6814222547.984600,817867,116126,447815,1381808
2019-03-28,NYSE National (C),54844775,26959074,21699587,103503436,1301557516.619700,884195805.933100,702944880.727300,2888698203.280100,416953,100123,203576,720652
2019-03-28,FINRA / NYSE TRF (DN),183459934,79196615,205133737,467790286,5625179345.021198,2588849355.951900,7701164560.610799,15915193261.583897,460261,166077,508580,1134918
2019-03-28,FINRA / Nasdaq TRF Carteret (DQ),920406861,323621686,570361154,1814389701,36119538515.610201,16264134315.409398,25498592309.848498,77882265140.868097,3194468,721730,1961220,5877418
2019-03-28,EDGA Equities (J),77913466,42087645,36721401,156722512,2660070350.138700,2060216484.700801,2124448071.303500,6844734906.143001,682068,195477,363077,1240622
2019-03-28,EDGX Equities (K),107898968,54759582,89477640,252136190,4237165130.454400,3240873414.246800,4149181456.170099,11627220000.871299,817662,231859,573353,1622874
2019-03-28,NYSE Chicago (M),15844352,16752019,4821830,37418201,488019572.888600,1204099404.290000,576051700.860300,2268170678.038900,3326,2955,4489,10770
2019-03-28,NYSE (N),756471989,48838051,41024802,846334842,28766554583.989108,2866849663.866000,1862056012.359100,33495460260.214208,2345398,137984,220616,2703998
2019-03-28,NYSE Arca (P),158860887,294373778,157465901,610700566,6444887390.182899,16098644994.557195,7304185960.922599,29847718345.662693,1146371,752192,1094443,2993006
2019-03-28,NASDAQ (Q),399428841,165115589,525741516,1090285946,17723770705.295303,9939174953.402806,26661964879.712206,54324910538.410315,3410794,677217,3379740,7467751
2019-03-28,IEX (V),106924276,15822067,51045966,173792309,4717276203.148100,962572179.939000,2650874516.991800,8330722900.078900,746972,83007,393941,1223920
2019-03-28,NASDAQ PSX (X),17535031,18832214,14192568,50559813,568845467.077800,1407652389.215400,837715553.407600,2814213409.700800,117053,74706,93973,285732
2019-03-28,BYX Equities (Y),141856205,65415527,61759374,269031106,4325208402.111800,2899584919.631100,2486638788.594800,9711432110.337700,1169106,312154,590935,2072195
2019-03-28,BZX Equities (Z),158315855,77791071,97268124,333375050,6498475107.225999,4979975881.499499,5494428107.856100,16972879096.581598,1401439,368524,904263,2674226
2019-03-27,NYSE American (A),6281456,13686071,2972208,22939735,251389575.764700,194411076.861800,170624914.671800,616425567.298300,61526,49682,30760,141968
2019-03-27,NASDAQ BX (B),86384181,25294302,47925332,159603815,3802816345.331700,1394124767.552700,2491167650.179100,7688108763.063500,878747,131418,487796,1497961
2019-03-27,NYSE National (C),58453418,30989117,25934309,115376844,1483498215.485700,1076874710.496500,903049910.582200,3463422836.564400,451799,126665,229521,807985
2019-03-27,FINRA / NYSE TRF (DN),198014876,93869538,229644375,521528789,6110697383.424199,3031519137.159501,9564927008.878600,18707143529.462300,491109,182775,574416,1248300
2019-03-27,FINRA / Nasdaq TRF Carteret (DQ),987575145,368546084,694225756,2050346985,39334796978.097703,20136420279.888994,30635936189.258402,90107153447.245099,3383353,811902,2224561,6419816
2019-03-27,EDGA Equities (J),85699068,49104365,43054577,177858010,3095728197.702300,2456315075.901600,2503638750.096200,8055682023.700100,747332,235997,413078,1396407
2019-03-27,EDGX Equities (K),114296718,63709379,98679091,276685188,4524918107.368000,3889675977.944899,4870856742.727499,13285450828.040398,830949,264197,639622,1734768
2019-03-27,NYSE Chicago (M),12433720,21926602,5427497,39787819,516793219.240000,1307000495.215000,601372605.585000,2425166320.040000,4394,3881,5599,13874
2019-03-27,NYSE (N),823110065,60542825,49196395,932849285,31417955238.366403,3632244934.241600,2268164778.747501,37318364951.355504,2577942,175707,249179,3002828
2019-03-27,NYSE Arca (P),179747105,329319319,177648687,686715111,7340140983.004100,18088583217.960500,8490959827.326099,33919684028.290699,1335489,932806,1285281,3553576
2019-03-27,NASDAQ (Q),430687832,189624497,610274221,1230586550,19546027182.224297,12629479317.463199,31982533136.736506,64158039636.424002,3772003,821834,3972768,8566605
2019-03-27,IEX (V),107727270,18163664,56024100,181915034,4763026130.065699,1184570742.309500,3053103523.870399,9000700396.245598,773662,96004,427096,1296762
2019-03-27,NASDAQ PSX (X),17198795,21650209,17156085,56005089,572870807.371300,1653972982.180000,1003081288.164700,3229925077.716000,116128,87172,107759,311059
2019-03-27,BYX Equities (Y),150835120,73676025,74462135,298973280,4577792267.157700,3457407788.693900,2877816368.262499,10913016424.114099,1271630,375050,659840,2306520
2019-03-27,BZX Equities (Z),163961907,94518347,111452787,369933041,6909876646.714000,6400097601.609902,6214625547.951299,19524599796.275201,1475800,452831,1015591,2944222
2019-03-26,NYSE American (A),5510640,12775807,2569389,20855836,222850543.370400,171272201.526800,151065303.628500,545188048.525700,57885,47132,28315,133332
2019-03-26,NASDAQ BX (B),85602615,22177878,45241374,153021867,3570665357.162300,1267670843.251700,2422434333.584100,7260770533.998100,872028,116786,480063,1468877
2019-03-26,NYSE National (C),55109823,24926865,23209507,103246195,1374893528.646200,905989777.639400,812828772.200000,3093712078.485600,427672,103827,215148,746647
2019-03-26,FINRA / NYSE TRF (DN),198948304,86238284,228424490,513611078,5750369562.647699,3086670560.079201,10788519728.084686,19625559850.811586,482388,170087,571663,1224138
2019-03-26,FINRA / Nasdaq TRF Carteret (DQ),924109481,334887913,621762824,1880760218,34784586907.902396,19948036222.692798,30330161490.750082,85062784621.345276,3231346,814232,2119895,6165473
2019-03-26,EDGA Equities (J),80337391,40928932,38317045,159583368,2742034924.697100,2151413485.505400,2487592928.898201,7381041339.100701,712089,209683,391034,1312806
2019-03-26,EDGX Equities (K),115432988,53999077,96271589,265703654,4480923957.339501,3410374069.996699,5181693061.212701,13072991088.548901,837367,217177,629938,1684482
2019-03-26,NYSE Chicago (M),13976754,17483503,8619129,40079386,594397705.748900,1281699218.800000,921647639.464500,2797744564.013400,4362,3564,4854,12780
2019-03-26,NYSE (N),818839718,49585354,46693626,915118698,31998844963.693198,3088587842.564800,2210377196.453000,37297810002.710998,2447318,140984,246846,2835148
2019-03-26,NYSE Arca (P),170201158,275648460,166648966,612498584,6703466689.798402,15906767946.832104,8711530414.106403,31321765050.736909,1218093,755235,1234496,3207824
2019-03-26,NASDAQ (Q),393519153,152435198,563414310,1109368661,17585774694.422702,10016694142.865201,32720671105.523292,60323139942.811195,3399472,651532,3691231,7742235
2019-03-26,IEX (V),99294111,17532815,51596046,168422972,4263189307.959699,1027451898.812000,3025393977.830200,8316035184.601899,723520,83407,398509,1205436
2019-03-26,NASDAQ PSX (X),16692867,17809784,13719621,48222272,539736087.552500,1314235015.349700,973185797.762300,2827156900.664500,112603,70323,100353,283279
2019-03-26,BYX Equities (Y),151907360,70611347,70069011,292587718,4662699225.055400,3497243295.028000,2980845270.548001,11140787790.631401,1273704,362348,663565,2299617
2019-03-26,BZX Equities (Z),159093300,76647991,103802899,339544190,6541692889.771400,5192074398.895397,6378837436.543499,18112604725.210296,1422100,359422,992362,2773884
2019-03-25,NYSE American (A),5762005,14626854,2484368,22873227,254079119.748800,199729214.089400,151334028.187100,605142362.025300,65275,51673,29402,146350
2019-03-25,NASDAQ BX (B),88044458,29750180,46296610,164091248,3671892737.676101,1549413707.677400,2299638455.047700,7520944900.401201,907852,143923,479303,1531078
2019-03-25,NYSE National (C),58618497,32688651,27204199,118511347,1464128128.631600,1123065175.985100,931167594.343000,3518360898.959700,460775,121185,235063,817023
2019-03-25,FINRA / NYSE TRF (DN),204650259,94929685,221512878,521092822,5537148866.055298,3262676472.591998,10047864944.354701,18847690283.001997,489270,191857,572880,1254007
2019-03-25,FINRA / Nasdaq TRF Carteret (DQ),943410739,370828602,664366437,1978605778,35394137728.727608,22916818969.026195,31313940402.939895,89624897100.693698,3342526,845743,2146330,6334599
2019-03-25,EDGA Equities (J),82883961,51019915,40833196,174737072,2690722692.701700,2430475764.323400,2447732132.446600,7568930589.471700,722216,249932,395981,1368129
2019-03-25,EDGX Equities (K),119303868,68775082,95539378,283618328,4569978028.606299,4373827353.481402,5197434945.959800,14141240328.047501,901676,286823,653048,1841547
2019-03-25,NYSE Chicago (M),11549891,13769388,6192798,31512077,310515484.425000,1190343160.345100,694709539.662500,2195568184.432600,4401,4795,5546,14742
2019-03-25,NYSE (N),815696745,63349131,49895084,928940960,30169977921.342090,3916984583.468800,2479443234.615200,36566405739.426090,2687705,183495,263533,3134733
2019-03-25,NYSE Arca (P),177529835,319074823,173990659,670595317,6784756769.744101,18169382277.959695,8935710432.272001,33889849479.975797,1301988,923268,1286900,3512156
2019-03-25,NASDAQ (Q),430832635,201040851,572315079,1204188565,19165836358.429489,13437785987.617002,32494592001.242600,65098214347.289091,3800057,850730,4014470,8665257
2019-03-25,IEX (V),107222262,21800012,53399212,182421486,4615406485.098600,1318450028.682100,3135558376.917399,9069414890.698099,790884,101828,415929,1308641
2019-03-25,NASDAQ PSX (X),19267301,23242365,15639126,58148792,616143825.795000,1781126769.091800,1072631984.444300,3469902579.331100,132944,96299,110676,339919
2019-03-25,BYX Equities (Y),165539767,84270589,77691682,327502038,4878247848.729500,3926714372.153400,2990524201.383000,11795486422.265900,1406332,407325,709341,2522998
2019-03-25,BZX Equities (Z),175803854,99607561,115138337,390549752,7200323183.032200,6853220453.824202,6802210737.012499,20855754373.868901,1597165,475912,1071881,3144958
2019-03-22,NYSE American (A),7332849,16708262,3085289,27126400,308608591.242100,269225371.552200,177410077.746600,755244040.540900,74498,55259,33315,163072
2019-03-22,NASDAQ BX (B),103370737,38157833,54062337,195590907,4392413902.140300,2149075382.890400,2938493752.054400,9479983037.085100,1028860,187740,541638,1758238
2019-03-22,NYSE National (C),75434466,45144950,31294569,151873985,1789391453.850600,1588743773.466900,1067971744.735400,4446106972.052900,551672,153690,270381,975743
2019-03-22,FINRA / NYSE TRF (DN),251581374,113884571,259523598,624989543,7540406587.647099,4230354952.103801,11694425862.831305,23465187402.582205,612468,226775,659898,1499141
2019-03-22,FINRA / Nasdaq TRF Carteret (DQ),1143987647,488183242,709972612,2342143501,42078843525.943904,28914959401.368808,37260695094.618892,108254498021.931604,3948379,1027290,2443145,7418814
2019-03-22,EDGA Equities (J),104935073,67411433,49875208,222221714,3422985702.317500,3470676557.705699,2892606419.796500,9786268679.819699,862647,314391,450009,1627047
2019-03-22,EDGX Equities (K),155128920,97954226,121371622,374454768,6028848890.669298,6705191450.441200,6649241908.159399,19383282249.269897,1072760,403672,775660,2252092
2019-03-22,NYSE Chicago (M),11615545,16599561,5673807,33888913,343442988.625500,1183391350.415300,552491359.070500,2079325698.111300,4629,5249,5234,15112
2019-03-22,NYSE (N),1056289898,90291047,60749974,1207330919,39723799242.510102,5818694255.297602,3092014148.913700,48634507646.721404,3129660,249094,304324,3683078
2019-03-22,NYSE Arca (P),231481258,420938110,202470897,854890265,8658109063.099303,25618515506.502697,10967167199.862204,45243791769.464204,1540698,1282841,1463078,4286617
2019-03-22,NASDAQ (Q),542034554,284981418,697744990,1524760962,23351441964.839000,19769668584.070495,40687740478.441918,83808851027.351413,4483212,1153816,4508225,10145253
2019-03-22,IEX (V),127905991,29294174,61815891,219016056,5621560662.697400,1993362755.442300,3538432901.313900,11153356319.453600,905674,136834,467675,1510183
2019-03-22,NASDAQ PSX (X),23699029,35095856,19220405,78015290,727813383.188200,2855031098.242301,1461251756.025800,5044096237.456301,148910,133943,129210,412063
2019-03-22,BYX Equities (Y),194237893,119957079,87774314,401969286,5680922692.815899,6139146210.240999,3622835928.175500,15442904831.232398,1556678,564283,770354,2891315
2019-03-22,BZX Equities (Z),224699822,141709126,140113349,506522297,9322538982.802800,10236542225.862198,8971996986.504003,28531078195.169001,1935651,651579,1246421,3833651
2019-03-21,NYSE American (A),6251788,16151638,2908130,25311556,251853853.319100,222510329.890400,168480775.995800,642844959.205300,65931,52824,31610,150365
2019-03-21,NASDAQ BX (B),91456088,30834413,52500115,174790616,3941833647.202100,1759135771.055100,2840265405.346500,8541234823.603700,918782,140383,535219,1594384
2019-03-21,NYSE National (C),60897687,31985120,26861736,119744543,1490704841.371700,1103904307.859800,922868513.174100,3517477662.405600,474902,110395,245904,831201
2019-03-21,FINRA / NYSE TRF (DN),198912764,99416654,256501046,554830464,6000365468.354601,3053130923.696200,11416282587.699603,20469778979.750404,528787,188475,656680,1373942
2019-03-21,FINRA / Nasdaq TRF Carteret (DQ),1034978823,440067320,782158805,2257204948,39928642593.961285,24370061897.668203,38843346455.553489,103142050947.182977,3499194,820361,2359376,6678931
2019-03-21,EDGA Equities (J),89778977,54204589,46635325,190618891,3012769843.660700,2936360831.838499,2746812877.660700,8695943553.159899,772130,235107,438447,1445684
2019-03-21,EDGX Equities (K),129696442,73327128,117198984,320222554,5058425730.468399,4419931664.631100,6401084244.587101,15879441639.686600,923333,275411,731216,1929960
2019-03-21,NYSE Chicago (M),11217480,16185850,5893515,33296845,372824769.742000,1249061161.310000,458233681.364100,2080119612.416100,4332,4161,4581,13074
2019-03-21,NYSE (N),890155970,59370078,52969265,1002495313,33330950677.402201,4073620961.204700,2625290879.697800,40029862518.304701,2548835,156418,261960,2967213
2019-03-21,NYSE Arca (P),183941997,328375296,187475628,699792921,7133419079.942697,18915697518.395808,10172328330.756406,36221444929.094911,1259312,894363,1328921,3482596
2019-03-21,NASDAQ (Q),436652096,209082209,683617323,1329351628,18998922698.328693,13079352000.700400,39246171602.159398,71324446301.188491,3562083,764387,3976026,8302496
2019-03-21,IEX (V),113921854,24197389,64105187,202224430,5081679061.148900,1775202388.401800,3722882989.294200,10579764438.844900,825489,105946,471112,1402547
2019-03-21,NASDAQ PSX (X),18886673,24064343,17419892,60370908,620527321.765200,1727582688.198900,1174047940.468300,3522157950.432400,125053,84829,111940,321822
2019-03-21,BYX Equities (Y),165170113,89790922,81351337,336312372,4956077297.676500,4344460024.875700,3254885425.812000,12555422748.364200,1349187,400101,727208,2476496
2019-03-21,BZX Equities (Z),180707621,100183692,125216475,406107788,7462573482.354302,6658822235.996499,7646341461.646998,21767737179.997799,1573571,432176,1124579,3130326
2019-03-20,NYSE American (A),8228694,14255282,3282542,25766518,381390944.166900,200966002.901800,187441833.262700,769798780.331400,81147,47007,33134,161288
2019-03-20,NASDAQ BX (B),94483708,30869596,53482842,178836146,4160822317.180800,1663438666.123300,2786698449.700400,8610959433.004500,952533,149734,536341,1638608
2019-03-20,NYSE National (C),56098980,28803941,24225379,109128300,1520782548.147000,1020661433.666900,867839301.983800,3409283283.797700,466141,112916,225788,804845
2019-03-20,FINRA / NYSE TRF (DN),230322549,98154456,259808662,588285667,6883455443.151798,3247511943.736000,9871629533.786799,20002596920.674597,548462,192868,609789,1351119
2019-03-20,FINRA / Nasdaq TRF Carteret (DQ),1067860198,423727592,770664352,2262252142,43181584509.199898,24780176923.429796,36726095125.161012,104687856557.790706,3618556,856662,2268575,6743793
2019-03-20,EDGA Equities (J),89377561,58821554,49332898,197532013,3237416014.956000,3109015758.444700,2863419268.743200,9209851042.143900,773854,275450,440422,1489726
2019-03-20,EDGX Equities (K),142445760,77961267,117968488,338375515,5617572603.473000,4876979196.012802,5993247817.188298,16487799616.674100,1007514,308180,711091,2026785
2019-03-20,NYSE Chicago (M),9913639,12615233,10211522,32740394,409141074.514400,1129647788.622000,1305522392.786399,2844311255.922799,3631,4505,4199,12335
2019-03-20,NYSE (N),928443447,67748984,50588987,1046781418,37829815797.548002,4133308981.393300,2292280292.505400,44255405071.446702,2784024,179672,260159,3223855
2019-03-20,NYSE Arca (P),198923719,351692857,193439583,744056159,7967849066.700497,20482186274.662391,9190181032.612002,37640216373.974890,1413807,1026464,1326966,3767237
2019-03-20,NASDAQ (Q),453031329,219729834,648634633,1321395796,20633548765.571604,14774570638.202001,35649503583.655600,71057622987.429205,3922662,898153,3983257,8804072
2019-03-20,IEX (V),113567831,22191155,59971786,195730772,5131874449.395000,1377378920.728500,3439020136.467300,9948273506.590800,821558,103825,443052,1368435
2019-03-20,NASDAQ PSX (X),19577904,25624491,16152102,61354497,668335712.176300,1828363046.269700,1093890776.035800,3590589534.481800,133853,95829,113028,342710
2019-03-20,BYX Equities (Y),164733970,85184419,78724560,328642949,5086085828.060500,4054649102.727501,3138574964.968400,12279309895.756401,1376187,413795,690810,2480792
2019-03-20,BZX Equities (Z),202154624,123355637,127748130,453258391,8467809825.566799,8144756980.588900,7706882992.965200,24319449799.120899,1767203,531040,1136191,3434434
2019-03-19,NYSE American (A),5913240,16026209,2493525,24432974,247941473.085100,174314043.012500,142969147.559300,565224663.656900,59469,42087,27185,128741
2019-03-19,NASDAQ BX (B),90707161,23516479,49839993,164063633,4080400874.645100,1416254528.630900,2668934975.534700,8165590378.810700,949438,122444,522639,1594521
2019-03-19,NYSE National (C),50205474,19042309,21794325,91042108,1407807981.838400,768378819.119500,803773732.803600,2979960533.761500,426524,84119,211170,721813
2019-03-19,FINRA / NYSE TRF (DN),216618173,99285412,288781198,604684783,6528026991.020898,2925215039.492000,10970956943.778696,20424198974.291594,545569,190001,672597,1408167
2019-03-19,FINRA / Nasdaq TRF Carteret (DQ),1031251696,386097910,754374564,2171724170,41281470852.317493,25186342272.351395,35074455197.994220,101542268322.663108,3464408,772653,2287002,6524063
2019-03-19,EDGA Equities (J),82994377,41321103,45726788,170042268,3021967599.581700,2238101088.763500,2512830698.409501,7772899386.754701,745793,198385,416736,1360914
2019-03-19,EDGX Equities (K),134584270,63966015,121025146,319575431,5277474960.441100,4195820039.110199,5784158137.006697,15257453136.557996,949954,253314,693805,1897073
2019-03-19,NYSE Chicago (M),12690273,13817069,7607489,34114831,397799449.120000,1153418718.645000,641194765.056600,2192412932.821600,4407,3299,4299,12005
2019-03-19,NYSE (N),967600687,51410794,46002025,1065013506,40831489828.961297,3486650335.002501,2199213218.334600,46517353382.298398,2569225,138089,242130,2949444
2019-03-19,NYSE Arca (P),181529751,253344465,188112707,622986923,7180258976.847601,15885000544.693586,8651421949.059400,31716681470.600587,1257297,759950,1272165,3289412
2019-03-19,NASDAQ (Q),423818042,157498762,674137075,1255453879,19488176839.241789,11614016557.783707,37004439338.327883,68106632735.353379,3721587,668626,3793518,8183731
2019-03-19,IEX (V),108694280,17439318,57524195,183657793,4755981148.095600,1244548832.366000,3291195451.529302,9291725431.990902,783929,86068,435309,1305306
2019-03-19,NASDAQ PSX (X),18424472,18357992,14658597,51441061,609804537.487000,1566527114.971300,952150722.703900,3128482375.162200,124481,74030,102738,301249
2019-03-19,BYX Equities (Y),155878846,70573892,75349801,301802539,5029235299.986500,3442223348.062700,2908264715.632700,11379723363.681900,1339417,332204,664666,2336287
2019-03-19,BZX Equities (Z),169838726,82852533,110498676,363189935,7286654158.189499,6068702665.911199,6460153033.008701,19815509857.109399,1523438,373591,1002932,2899961
2019-03-18,NYSE American (A),5885871,14055341,2661882,22603094,250115579.657500,175667675.664700,152897992.848900,578681248.171100,59879,39427,28066,127372
2019-03-18,NASDAQ BX (B),87921520,21662328,48766657,158350505,3959870573.872600,1162776367.952900,2620661390.092600,7743308331.918100,923086,110372,518619,1552077
2019-03-18,NYSE National (C),45597007,18773288,20032048,84402343,1218992897.547600,665458754.375600,714820310.052800,2599271961.976000,387491,72809,204924,665224
2019-03-18,FINRA / NYSE TRF (DN),217871606,75084105,246396343,539352054,6612913679.637098,2535256644.790501,9286793813.401797,18434964137.829396,565369,178190,646813,1390372
2019-03-18,FINRA / Nasdaq TRF Carteret (DQ),1084441152,333056074,735294476,2152791702,43364122037.611911,20910360833.983406,34207264114.039994,98481746985.635311,3523471,776305,2304527,6604303
2019-03-18,EDGA Equities (J),79042336,33972467,38355328,151370131,2768967830.715300,1779193676.365300,2117342405.610600,6665503912.691200,734172,176938,389178,1300288
2019-03-18,EDGX Equities (K),136083424,48268902,111770471,296122797,5211296006.506998,3214455656.732099,5101482770.403197,13527234433.642294,969487,209775,695928,1875190
2019-03-18,NYSE Chicago (M),13536458,14100933,6601678,34239069,538837068.988600,1151680065.495000,626584704.909400,2317101839.393000,4983,2495,4436,11914
2019-03-18,NYSE (N),950941019,40562619,40014866,1031518504,39563025597.595102,2544353278.201200,1950598100.610100,44057976976.406402,2504194,111495,224388,2840077
2019-03-18,NYSE Arca (P),172407571,225218417,182378619,580004607,6926527874.725603,13101179182.545401,8370538069.728604,28398245126.999608,1183400,649295,1235162,3067857
2019-03-18,NASDAQ (Q),393646316,121742953,632083320,1147472589,18334803095.220503,8548848151.748598,34354146053.333190,61237797300.302291,3324988,541769,3712052,7578809
2019-03-18,IEX (V),108533889,18670558,57826800,185031247,5130736398.286300,1302851870.197801,3000494426.836099,9434082695.320200,794655,89795,433674,1318124
2019-03-18,NASDAQ PSX (X),17472892,14480704,13994054,45947650,592290123.615800,1116310467.701200,892060869.453000,2600661460.770000,120287,61193,98196,279676
2019-03-18,BYX Equities (Y),145731152,63046766,65963247,274741165,4619474513.250300,3019515118.961700,2545445227.654900,10184434859.866900,1250312,302760,625964,2179036
2019-03-18,BZX Equities (Z),161665403,64549640,100001119,326216162,6890845421.663400,4455854233.311099,5751018741.801299,17097718396.775798,1453252,299910,946294,2699456
2019-03-15,NYSE American (A),6512422,59702982,3223634,69439038,273954888.411900,345723662.454400,170793821.897700,790472372.764000,64656,45105,33542,143303
2019-03-15,NASDAQ BX (B),98585631,27729505,53485787,179800923,4307535439.879300,1504319886.997400,2857665738.346800,8669521065.223500,968150,131849,546637,1646636
2019-03-15,NYSE National (C),55400114,25319659,22902877,103622650,1451761224.959900,944229866.458900,853390121.767400,3249381213.186200,440922,96430,226790,764142
2019-03-15,FINRA / NYSE TRF (DN),228328852,76993625,230133864,535456341,7040735616.579498,2650904536.594800,9502585085.911699,19194225239.085997,566155,176793,628196,1371144
2019-03-15,FINRA / Nasdaq TRF Carteret (DQ),1459620252,426247459,985818254,2871685965,58838317688.648407,25680453305.926111,48094753282.102006,132613524276.676524,3708403,777847,2459341,6945591
2019-03-15,EDGA Equities (J),94248517,47663061,44555848,186467426,3328464833.492100,2459095201.248699,2542622559.525500,8330182594.266299,836364,207191,438270,1481825
2019-03-15,EDGX Equities (K),148080235,64884852,117801591,330766678,5782306750.725200,4137018443.034899,6154310807.956699,16073636001.716798,1014721,245087,753738,2013546
2019-03-15,NYSE Chicago (M),15464688,20677439,11128447,47270574,654860709.140000,2623892224.290000,1236359695.556000,4515112628.986000,3864,2511,4197,10572
2019-03-15,NYSE (N),2735501559,51188309,44819013,2831508881,117443554747.916600,3100659994.364800,2198565590.786800,122742780333.068200,2657403,126529,255160,3039092
2019-03-15,NYSE Arca (P),192134241,297022542,185007971,674164754,7644049390.395001,17462285223.195609,9566420114.736496,34672754728.327106,1285038,744038,1297670,3326746
2019-03-15,NASDAQ (Q),435396033,163962052,1468106181,2067464266,19940320480.892203,11481531788.785297,77166357540.866196,108588209810.543696,3638233,642338,4024143,8304714
2019-03-15,IEX (V),124338433,22593867,69187646,216119946,5336607886.342100,1461505103.065300,4028757015.416200,10826870004.823600,862691,101304,495120,1459115
2019-03-15,NASDAQ PSX (X),19680205,21142296,16510468,57332969,714396766.882300,1600503580.900200,1210358704.123400,3525259051.905900,131471,76079,112433,319983
2019-03-15,BYX Equities (Y),168131411,86830570,79238252,334200233,5219211699.023801,4357843221.566199,3302706454.551200,12879761375.141200,1348032,379344,721957,2449333
2019-03-15,BZX Equities (Z),188366009,87688691,119940347,395995047,7976646444.089200,5891405484.242900,7373912910.764800,21241964839.096900,1589737,364426,1079224,3033387
2019-03-14,NYSE American (A),6120059,13584366,2533081,22237506,248049215.207800,153775538.727700,137085005.064400,538909758.999900,59658,37511,27559,124728
2019-03-14,NASDAQ BX (B),88894940,20036425,48202849,157134214,4035460526.214800,1069366856.368100,2453514177.525600,7558341560.108500,963307,104260,530525,1598092
2019-03-14,NYSE National (C),46589409,17518989,20394650,84503048,1290203900.949300,606952088.174200,770473170.116900,2667629159.240400,398398,71192,201692,671282
2019-03-14,FINRA / NYSE TRF (DN),209595213,67253310,213418752,490267275,6015670327.246501,2197185611.695300,7162665095.557703,15375521034.499504,513438,149956,581027,1244421
2019-03-14,FINRA / Nasdaq TRF Carteret (DQ),997913060,316070159,665639831,1979623050,38796595284.529007,20388180061.594397,29477136754.129002,88661912100.252406,3433209,639418,2192000,6264627
2019-03-14,EDGA Equities (J),81708696,34934394,40169724,156812814,2872930454.427900,1755311548.108100,2199842798.371300,6828084800.907300,766744,173295,417263,1357302
2019-03-14,EDGX Equities (K),131265932,45513303,112073964,288853199,4983309331.890100,2853518676.181401,4771110700.682200,12607938708.753701,938608,195792,703922,1838322
2019-03-14,NYSE Chicago (M),11963462,11072304,7363986,30399752,581369416.882700,1075723580.758200,707075911.382100,2364168909.023000,8357,3414,4420,16191
2019-03-14,NYSE (N),912186846,37128322,39160000,988475168,37747135469.753801,2265289050.609101,1790794397.207200,41803218917.570102,2375820,103032,222181,2701033
2019-03-14,NYSE Arca (P),175362307,220616560,179925035,575903902,6767550335.205898,12105001433.271801,7599848955.286100,26472400723.763799,1224825,584787,1254628,3064240
2019-03-14,NASDAQ (Q),405854106,121737769,628482918,1156074793,18754614699.491896,7828969586.179098,32646753296.023507,59230337581.694501,3613817,517440,3750188,7881445
2019-03-14,IEX (V),117801374,18442904,58575552,194819830,5215959163.277300,1081295426.763300,3068758564.862900,9366013154.903500,833787,83015,437280,1354082
2019-03-14,NASDAQ PSX (X),14044439,16754912,13471260,44270611,501921910.236400,1221516925.330300,798299784.135000,2521738619.701700,106443,63042,87859,257344
2019-03-14,BYX Equities (Y),148067031,56720358,69466447,274253836,4758547514.068700,2828668786.707700,2783964867.275000,10371181168.051400,1323159,292645,680997,2296801
2019-03-14,BZX Equities (Z),158308801,62463015,100026562,320798378,6446572523.349799,4079229868.226400,5435430437.104899,15961232828.681098,1400993,288914,933766,2623673
2019-03-13,NYSE American (A),6777887,13080912,2694295,22553094,320503252.248300,168912179.606300,150291398.778800,639706830.633400,71248,38335,30157,139740
2019-03-13,NASDAQ BX (B),98811708,21963013,51046208,171820929,4524213542.308900,1224885812.156900,2654942120.382600,8404041474.848400,1044187,112750,550465,1707402
2019-03-13,NYSE National (C),50403781,19165446,21367764,90936991,1447824082.469500,722206524.304200,789519676.862100,2959550283.635800,433462,82343,211609,727414
2019-03-13,FINRA / NYSE TRF (DN),226399692,77127308,232304211,535831211,7539292716.359998,2747099613.350900,8476350651.870599,18762742981.581497,595241,169123,621812,1386176
2019-03-13,FINRA / Nasdaq TRF Carteret (DQ),1070821419,362955797,747874403,2181651619,43205344661.265397,24313222957.888293,35446715027.219576,102965282646.373266,3618587,737150,2321922,6677659
2019-03-13,EDGA Equities (J),92256039,38577223,42731630,173564892,3611156811.992300,2040209050.969300,2280601375.946600,7931967238.908200,827046,184793,416623,1428462
2019-03-13,EDGX Equities (K),143812429,55524005,114536910,313873344,6055702286.557398,3546907447.155001,5399596781.360798,15002206515.073197,1023161,228179,718888,1970228
2019-03-13,NYSE Chicago (M),15274524,12196521,5233144,32704189,1114087265.523600,1098428854.246200,610535464.238200,2823051584.008000,20494,4942,5286,30722
2019-03-13,NYSE (N),959804008,45073884,45074645,1049952537,40389468773.450100,2880697243.337500,2080479187.862900,45350645204.650500,2504817,120910,240171,2865898
2019-03-13,NYSE Arca (P),201765298,230550321,192199593,624515212,8467764245.362298,13282442300.095806,8656881481.764296,30407088027.222400,1365187,677043,1309905,3352135
2019-03-13,NASDAQ (Q),435630758,152027184,661607071,1249265013,20982625458.709697,10245807598.801404,35334252829.135208,66562685886.646309,3796101,604834,3835427,8236362
2019-03-13,IEX (V),124505790,21638852,67534717,213679359,5478777643.361900,1372303522.742000,3589685846.001700,10440767012.105600,893756,97914,488537,1480207
2019-03-13,NASDAQ PSX (X),15466781,19270384,12157850,46895015,594838604.971100,1451693636.181501,854787204.087400,2901319445.240001,122556,74929,88722,286207
2019-03-13,BYX Equities (Y),162688992,65791855,72545636,301026483,5576803082.955600,3141013493.140401,2867292201.740300,11585108777.836301,1361584,315738,674225,2351547
2019-03-13,BZX Equities (Z),177832692,73863527,110353665,362049884,7973475958.018799,4996822224.180200,6167528914.165300,19137827096.364299,1559303,334967,1002527,2896797
2019-03-12,NYSE American (A),6511110,12543238,2388537,21442885,252573206.713000,171163583.680900,140921010.424300,564657800.818200,62530,39643,26740,128913
2019-03-12,NASDAQ BX (B),94228820,23455975,48926651,166611446,4270837501.987300,1286911703.117100,2492475279.129000,8050224484.233400,994190,116657,524582,1635429
2019-03-12,NYSE National (C),52318181,18944658,22239017,93501856,1443994931.882100,716632618.318600,802163236.742600,2962790786.943300,430692,79942,210193,720827
2019-03-12,FINRA / NYSE TRF (DN),203514628,74842436,221923044,500280108,7440384294.886898,2637924335.160999,7631712390.809401,17710021020.857298,544237,163785,575288,1283310
2019-03-12,FINRA / Nasdaq TRF Carteret (DQ),957404794,408238863,670159979,2035803636,39842958346.519896,27981582056.859407,31192753982.306395,99017294385.685698,3504275,769644,2211755,6485674
2019-03-12,EDGA Equities (J),88322745,37396211,41234290,166953246,3307849372.914800,2038512664.968900,2285803580.347500,7632165618.231200,799951,184427,409158,1393536
2019-03-12,EDGX Equities (K),131103578,53371870,107864690,292340138,5715012381.693599,3397283089.268900,5154091749.882599,14266387220.845098,983002,227763,699801,1910566
2019-03-12,NYSE Chicago (M),13135316,9307225,7013833,29456374,581595567.748600,904301855.912500,842212086.981500,2328109510.642600,4752,4362,4417,13531
2019-03-12,NYSE (N),825336517,40187090,44812899,910336506,33673527147.702396,2721372922.614100,2138265522.151300,38533165592.467796,2456657,110999,239534,2807190
2019-03-12,NYSE Arca (P),189343086,251098999,177250104,617692189,7851574843.645401,14217079417.682805,8232394752.847502,30301049014.175708,1301964,689882,1249789,3241635
2019-03-12,NASDAQ (Q),417753093,140953191,583875841,1142582125,20209752979.968394,9580947398.054203,31398982891.832997,61189683269.855594,3753034,592796,3723867,8069697
2019-03-12,IEX (V),109832171,18248573,57752330,185833074,4859703222.350000,1135010945.620600,3139829419.008000,9134543586.978600,802684,90266,436469,1329419
2019-03-12,NASDAQ PSX (X),17537697,18745853,13011630,49295180,592442693.205000,1462945277.675900,823174622.028500,2878562592.909400,125487,78702,93277,297466
2019-03-12,BYX Equities (Y),158651364,62682820,68725454,290059638,5032257246.417400,3106630476.878600,2802266807.549100,10941154530.845100,1331712,313795,652068,2297575
2019-03-12,BZX Equities (Z),167355638,69386654,104450294,341192586,7039158431.892801,4821901831.625301,6012796506.110001,17873856769.628103,1487809,327471,967106,2782386
2019-03-11,NYSE American (A),6261443,14265427,2555454,23082324,255347529.561700,180355003.440000,152613011.211200,588315544.212900,64700,43608,29227,137535
2019-03-11,NASDAQ BX (B),95808187,21323612,48535937,165667736,4307641579.194201,1208897426.976900,2513157592.607400,8029696598.778501,1003734,116088,531998,1651820
2019-03-11,NYSE National (C),52703400,17503746,23745265,93952411,1381258430.338800,659439591.612800,816865310.123900,2857563332.075500,441024,78505,224876,744405
2019-03-11,FINRA / NYSE TRF (DN),197058316,79625548,214936262,491620126,7596905776.704399,2736310465.415901,7645019509.344901,17978235751.465201,541911,176856,593492,1312259
2019-03-11,FINRA / Nasdaq TRF Carteret (DQ),1119707346,353613834,733725508,2207046688,44735192435.314390,20814485590.465310,33938611948.102991,99488289973.882691,3740374,780480,2324038,6844892
2019-03-11,EDGA Equities (J),92134013,35818497,41461322,169413832,3133366939.576400,1844299725.710400,2179457162.283899,7157123827.570699,822190,186050,425753,1433993
2019-03-11,EDGX Equities (K),135007179,54006732,104934791,293948702,5868451824.495497,3305872238.450798,5189748514.315300,14364072577.261595,1031506,231319,703729,1966554
2019-03-11,NYSE Chicago (M),44889234,8739859,12242058,65871151,4674061943.062200,952390240.747400,646265742.450100,6272717926.259700,9072,5742,5578,20392
2019-03-11,NYSE (N),919513868,44388369,42068375,1005970612,35752393550.113296,2666695136.920601,1952283950.697300,40371372637.731197,2640691,115005,231782,2987478
2019-03-11,NYSE Arca (P),192070990,268506286,172441858,633019134,8091465238.210696,14941724388.978307,8291857616.099303,31325047243.288306,1322914,698744,1242427,3264085
2019-03-11,NASDAQ (Q),430015273,149144235,603863363,1183022871,20643601743.865901,9647460840.815198,32650109947.016884,62941172531.697983,3858700,602262,3835664,8296626
2019-03-11,IEX (V),121526421,17864907,58256115,197647443,5074828774.211501,1157343264.042200,3123428926.288600,9355600964.542301,876067,89031,452614,1417712
2019-03-11,NASDAQ PSX (X),19693531,20313642,13847901,53855074,656417759.958100,1414053246.254700,838787942.951900,2909258949.164700,137234,81936,95901,315071
2019-03-11,BYX Equities (Y),161638973,63918290,71402630,296959893,4963352700.142800,3141835629.908700,2842648672.436500,10947837002.488000,1355311,319675,680973,2355959
2019-03-11,BZX Equities (Z),176823086,72632561,104444270,353899917,7317170314.114200,4732533729.879400,5898918358.897101,17948622402.890701,1543365,327922,980291,2851578
2019-03-08,NYSE American (A),6191029,14391736,2638399,23221164,256531081.865500,191646115.675300,157021741.544600,605198939.085400,64781,43099,29825,137705
2019-03-08,NASDAQ BX (B),89841699,28107410,48840319,166789428,3772901004.588900,1450919085.038400,2552768490.548900,7776588580.176200,921938,135667,511731,1569336
2019-03-08,NYSE National (C),48716588,22121480,21266512,92104580,1285841517.063700,815878570.350900,758778450.674700,2860498538.089300,418157,91261,209012,718430
2019-03-08,FINRA / NYSE TRF (DN),198424733,93756908,232008110,524189751,5071038737.078998,3409007714.359301,7655275461.835501,16135321913.273800,475942,186407,584373,1246722
2019-03-08,FINRA / Nasdaq TRF Carteret (DQ),983216594,421034529,682213979,2086465102,37983671987.588203,23708431723.288490,30015905109.168993,91708008820.045686,3485883,904602,2296942,6687427
2019-03-08,EDGA Equities (J),82046282,50428607,42811902,175286791,2831402549.951100,2532938225.944000,2340852775.273699,7705193551.168799,734449,235253,410224,1379926
2019-03-08,EDGX Equities (K),126622181,72441445,113249266,312312892,4872387388.506500,4729088272.352100,5110416325.669103,14711891986.527703,956646,302910,737100,1996656
2019-03-08,NYSE Chicago (M),15676155,13437398,6311532,35425085,1151407188.345100,1339941396.635000,577086487.355000,3068435072.335100,10817,6909,5048,22774
2019-03-08,NYSE (N),816426403,57788461,44974622,919189486,31134255376.711605,3716614127.848498,2237744580.044200,37088614084.604303,2602949,159223,254492,3016664
2019-03-08,NYSE Arca (P),175672518,320374882,181745300,677792700,6797628813.329899,17631281707.192998,8102837024.349296,32531747544.872193,1291964,885763,1294106,3471833
2019-03-08,NASDAQ (Q),424924850,204392081,620308587,1249625518,18830516980.611002,13080520073.998094,31530775499.979612,63441812554.588708,3867894,807762,4053922,8729578
2019-03-08,IEX (V),109175327,21616901,59848151,190640379,4575031361.713700,1341532386.107000,3102512603.196401,9019076351.017101,821881,106664,463820,1392365
2019-03-08,NASDAQ PSX (X),16664621,26897604,15352087,58914312,560111160.146300,1982237862.917701,1057273195.246400,3599622218.310401,118583,109884,105830,334297
2019-03-08,BYX Equities (Y),154396396,77974809,72575385,304946590,4558249958.893701,3606517995.902399,2887254718.205499,11052022673.001599,1305199,377618,682438,2365255
2019-03-08,BZX Equities (Z),176308765,102999764,116814784,396123313,7160490206.299200,6936631899.773199,6780720889.873601,20877842995.946000,1600349,469846,1084647,3154842
2019-03-07,NYSE American (A),6515141,14925268,2981072,24421481,273089732.035200,195930758.495300,159581208.794600,628601699.325100,67490,43705,32671,143866
2019-03-07,NASDAQ BX (B),95334296,28944067,50870279,175148642,4067454679.559000,1616834012.734600,2582762256.744600,8267050949.038200,962808,147627,532231,1642666
2019-03-07,NYSE National (C),57811770,25705414,24107578,107624762,1513106469.186100,1071081271.340500,881697810.109500,3465885550.636100,465526,113746,233679,812951
2019-03-07,FINRA / Nasdaq TRF Chicago (DB),1417,2521,4780,8718,139745.784300,167968.913600,79730.085500,387444.783400,901,848,484,2233
2019-03-07,FINRA / NYSE TRF (DN),224361879,95107949,254381599,573851427,6317714686.025000,3908379992.517700,8325522836.782096,18551617515.324796,550442,195414,634318,1380174
2019-03-07,FINRA / Nasdaq TRF Carteret (DQ),1170571946,458277713,765630117,2394479776,46741348302.955706,26483598012.564300,33403377683.573609,106628323999.093615,3765016,922887,2400600,7088503
2019-03-07,EDGA Equities (J),90285927,47213841,45437941,182937709,3087215040.213300,2575373105.744299,2439895534.611900,8102483680.569499,770759,241566,426852,1439177
2019-03-07,EDGX Equities (K),141685627,75451650,119080716,336217993,5529574059.256001,5126276578.955900,5550896042.664301,16206746680.876202,1047619,319740,762099,2129458
2019-03-07,NYSE Chicago (M),28551404,11924607,6808205,47284216,2416550357.200400,1083881755.030000,550797761.124500,4051229873.354900,8815,5540,5569,19924
2019-03-07,NYSE (N),921302347,64883710,48174074,1034360131,36229616088.336996,4263532012.149001,2198133735.270300,42691281835.756297,2839182,174127,266809,3280118
2019-03-07,NYSE Arca (P),217648756,343810823,204162681,765622260,7986674072.978898,20120570714.787894,8878278255.072494,36985523042.839286,1446476,992585,1391168,3830229
2019-03-07,NASDAQ (Q),474024875,208403722,657442247,1339870844,21423053305.801204,14386338622.334601,34265878194.189396,70075270122.325201,4264252,860694,4332284,9457230
2019-03-07,IEX (V),119698041,22907399,62525206,205130646,5099337231.240700,1328193029.091700,3395895592.940000,9823425853.272400,843385,103026,474934,1421345
2019-03-07,NASDAQ PSX (X),20201285,29792232,16960850,66954367,654608174.184600,2334156360.074700,1045849643.911900,4034614178.171200,134802,127167,115701,377670
2019-03-07,BYX Equities (Y),163913264,84942941,75331028,324187233,4835487693.309400,4172638635.237199,2960385362.918500,11968511691.465099,1363546,416341,705918,2485805
2019-03-07,BZX Equities (Z),200249440,109989131,128796668,439035239,8137255011.951299,7568636130.145300,7092050729.937399,22797941872.033998,1757651,497594,1141399,3396644
2019-03-06,NYSE American (A),6346542,15359974,2689647,24396163,257141718.999000,187210946.909300,161303945.667900,605656611.576200,63634,39551,30469,133654
2019-03-06,NASDAQ BX (B),94101845,24145206,48638449,166885500,3929789217.339200,1295039920.132600,2528912623.495500,7753741760.967300,949500,124397,512655,1586552
2019-03-06,NYSE National (C),52779501,20275129,22931680,95986310,1315310372.836200,751919574.818400,811919454.236700,2879149401.891300,429258,87152,225048,741458
2019-03-06,FINRA / Nasdaq TRF Chicago (DB),2,0,1,3,18.190000,0.000000,174.360000,192.550000,2,0,1,3
2019-03-06,FINRA / NYSE TRF (DN),242962566,99287976,235302493,577553035,6083707880.254001,3392031960.059901,8846831677.047203,18322571517.361105,570396,181495,598064,1349955
2019-03-06,FINRA / Nasdaq TRF Carteret (DQ),1107325849,436062967,694556097,2237944913,42220964568.713512,24351689837.741199,30406067721.842396,96978722128.297107,3583536,791172,2326733,6701441
2019-03-06,EDGA Equities (J),84152578,43235067,41508964,168896609,2896909264.606500,2251987573.838600,2283813873.800300,7432710712.245400,735940,209579,404420,1349939
2019-03-06,EDGX Equities (K),144861661,66799149,114426542,326087352,5045757689.071601,3951875973.245001,5331462369.259400,14329096031.576002,996741,259403,730933,1987077
2019-03-06,NYSE Chicago (M),23867292,22891146,8204696,54963134,1745653402.278900,1212249688.117000,863224114.585100,3821127204.981000,11728,2993,3629,18350
2019-03-06,NYSE (N),881228270,52381736,44313150,977923156,32110873662.294201,3386747812.301900,2026177377.640000,37523798852.236101,2594540,141056,246692,2982288
2019-03-06,NYSE Arca (P),218704162,302453272,182573608,703731042,7456171674.790100,16436214389.817200,8151898798.722804,32044284863.330104,1381589,808137,1285022,3474748
2019-03-06,NASDAQ (Q),461390987,173335944,601559303,1236286234,19705585824.236097,11293262108.674302,30413432457.858504,61412280390.768903,3945321,679889,4047686,8672896
2019-03-06,IEX (V),118334963,20944870,60419351,199699184,4913991907.067100,1237375206.682000,3349841766.757800,9501208880.506900,851066,95625,461410,1408101
2019-03-06,NASDAQ PSX (X),19271385,23639925,14201355,57112665,587156828.445600,2087649704.578801,912322015.564300,3587128548.588701,124590,99082,101244,324916
2019-03-06,BYX Equities (Y),159267639,72475698,70426129,302169466,4539528925.824200,3425846781.281600,2846868279.375599,10812243986.481399,1283729,353687,663698,2301114
2019-03-06,BZX Equities (Z),185594526,87345999,114801041,387741566,7256906023.463100,5762700433.778001,6175713583.878200,19195320041.119301,1596090,383419,1051495,3031004
2019-03-05,NYSE American (A),6159509,14016606,2495379,22671494,269970294.035000,173678582.072000,152509916.834000,596158792.941000,63266,42482,29145,134893
2019-03-05,NASDAQ BX (B),93863386,19817123,47943509,161624018,4271716321.489700,1076431876.191900,2465818014.107700,7813966211.789300,977845,108777,528792,1615414
2019-03-05,NYSE National (C),50490980,19249088,22697870,92437938,1498252018.223000,720677413.931300,891580595.929100,3110510028.083400,432558,81313,224413,738284
2019-03-05,FINRA / Nasdaq TRF Chicago (DB),1226,0,10930,12156,47054.750000,0.000000,6267418.430600,6314473.180600,32,0,99,131
2019-03-05,FINRA / NYSE TRF (DN),224169744,82785350,227134307,534089401,6572178150.795901,2635234465.463100,8529601038.193801,17737013654.452802,566833,174816,584021,1325670
2019-03-05,FINRA / Nasdaq TRF Carteret (DQ),1067912969,357198200,688104878,2113216047,42425710106.345987,20602191459.310996,31933577303.628874,94961478869.285857,3629638,747412,2285102,6662152
2019-03-05,EDGA Equities (J),81194914,36545829,41045538,158786281,3039189063.130800,1894317173.190600,2287832142.649800,7221338378.971200,755349,180644,416575,1352568
2019-03-05,EDGX Equities (K),143324710,54529379,104079120,301933209,5339409301.679102,3060514744.457499,5217845152.276700,13617769198.413301,994746,214200,685996,1894942
2019-03-05,NYSE Chicago (M),20899309,10324537,5026246,36250092,1813911567.192300,1008924426.833000,471199536.058000,3294035530.083300,6009,2742,4231,12982
2019-03-05,NYSE (N),864009981,42152024,39907205,946069210,35534929546.238596,2619148332.798301,1949294593.748200,40103372472.785097,2538208,120357,232938,2891503
2019-03-05,NYSE Arca (P),201717956,244678788,172506949,618903693,7592280318.541802,13806517802.283502,8086701268.050900,29485499388.876204,1350233,678906,1222753,3251892
2019-03-05,NASDAQ (Q),420521468,134644535,575394202,1130560205,19535684287.304302,8446436100.177197,31820554606.981135,59802674994.462634,3774864,552425,3792900,8120189
2019-03-05,IEX (V),113043284,15994861,57493596,186531741,5001268576.926500,981491312.178800,3195520572.276899,9178280461.382199,818892,77481,442523,1338896
2019-03-05,NASDAQ PSX (X),17092892,17280740,11986812,46360444,561174149.071400,1322900271.458100,789871167.051200,2673945587.580700,115729,69383,89711,274823
2019-03-05,BYX Equities (Y),150262265,62363425,66535031,279160721,4697242269.324000,3060726429.500300,2728362200.383000,10486330899.207300,1268152,302128,650906,2221186
2019-03-05,BZX Equities (Z),176718578,73703298,104311945,354733821,7251808707.659100,4619940678.711199,5939323092.844999,17811072479.215298,1568776,326541,1004322,2899639
2019-03-04,NYSE American (A),6630067,16042465,2979723,25652255,280529632.112400,232634283.939700,181798865.084400,694962781.136500,68948,45541,34389,148878
2019-03-04,NASDAQ BX (B),96558604,27778418,54208873,178545895,4331064856.121300,1545614659.312100,2868305835.093200,8744985350.526600,999026,150017,570779,1719822
2019-03-04,NYSE National (C),53418229,22580578,23905868,99904675,1553436543.157300,889426716.745500,961424550.216300,3404287810.119100,457316,99168,235692,792176
2019-03-04,FINRA / Nasdaq TRF Chicago (DB),396,0,458,854,31193.440200,0.000000,117217.520000,148410.960200,2,0,5,7
2019-03-04,FINRA / NYSE TRF (DN),242334715,102314331,288054031,632703077,7256817642.413802,3844314404.005297,10530353856.017500,21631485902.436599,629892,215732,719262,1564886
2019-03-04,FINRA / Nasdaq TRF Carteret (DQ),1115694750,429282197,777011110,2321988057,45075109588.075885,27648510327.055693,35987682187.914693,108711302103.046271,4028372,1011546,2698688,7738606
2019-03-04,EDGA Equities (J),88971730,50390339,48656646,188018715,3334691563.476000,2876918160.865199,2766217203.731400,8977826928.072599,816841,268059,458038,1542938
2019-03-04,EDGX Equities (K),147591105,76483414,135103093,359177612,6006624558.259900,4970707279.729998,6632349064.580298,17609680902.570196,1125330,319772,856178,2301280
2019-03-04,NYSE Chicago (M),15389932,7965097,5455465,28810494,1490657103.002400,692057556.281500,521399338.055700,2704113997.339600,6542,5046,5305,16893
2019-03-04,NYSE (N),982776808,58309839,50752601,1091839248,38848474311.440796,4032655726.708001,2665956538.442600,45547086576.591397,2987745,174674,283237,3445656
2019-03-04,NYSE Arca (P),214019355,322662196,210190503,746872054,8534999641.916402,19072654669.024900,10105472150.252299,37713126461.193601,1517242,982395,1476440,3976077
2019-03-04,NASDAQ (Q),480226384,188412572,697361145,1366000101,23177136042.906806,13606980230.548492,38453074932.028282,75237191205.483580,4510073,816829,4608228,9935130
2019-03-04,IEX (V),117355693,27159665,62895425,207410783,5214936809.380400,1712867501.012800,3599621265.370200,10527425575.763400,878087,120326,491262,1489675
2019-03-04,NASDAQ PSX (X),18337109,23161892,15323967,56822968,648036293.946600,2037363988.313801,1063848453.344900,3749248735.605301,129321,105346,112848,347515
2019-03-04,BYX Equities (Y),171048988,87026089,79367133,337442210,5173264810.373900,4309503868.057899,3266045203.230500,12748813881.662299,1420247,428798,741135,2590180
2019-03-04,BZX Equities (Z),199384222,105637932,130825326,435847480,8361858805.652303,7603141990.438896,7646332430.918497,23611333227.009696,1800301,492782,1202054,3495137
2019-03-01,NYSE American (A),6591040,15289790,3007482,24888312,254173582.329600,197261434.186600,175283252.672500,626718269.188700,64893,45810,32083,142786
2019-03-01,NASDAQ BX (B),102075776,30762684,53649131,186487591,4443246412.010800,1646754747.606600,2772272046.090300,8862273205.707700,1022558,145607,560439,1728604
2019-03-01,NYSE National (C),54362047,24790707,22909088,102061842,1509575373.201000,846644666.828100,909244673.307100,3265464713.336200,441276,87704,226456,755436
2019-03-01,FINRA / Nasdaq TRF Chicago (DB),0,0,122,122,0.000000,0.000000,203891.480000,203891.480000,0,0,4,4
2019-03-01,FINRA / NYSE TRF (DN),236173859,95735374,257564186,589473419,6922195842.954299,3277434702.544898,8960350496.546098,19159981042.045295,588994,197250,661128,1447372
2019-03-01,FINRA / Nasdaq TRF Carteret (DQ),1153175035,465731027,776756787,2395662849,44951589308.013810,26277954866.753914,36030134242.000296,107259678416.768020,3989979,885771,2667187,7542937
2019-03-01,EDGA Equities (J),87322216,45565661,44342401,177230278,3204707370.010000,2437375065.195900,2540983819.089801,8183066254.295701,783999,208801,440690,1433490
2019-03-01,EDGX Equities (K),150995735,76236845,127593483,354826063,5865818935.707800,4600788530.095199,6274928721.177002,16741536186.980001,1098869,271041,813889,2183799
2019-03-01,NYSE Chicago (M),25164549,10034746,11454316,46653611,2155936634.309999,898585456.824000,1149045673.690700,4203567764.824699,5355,3281,4468,13104
2019-03-01,NYSE (N),953582844,56455235,45112912,1055150991,37793202450.452998,3596785022.484901,2147141868.271000,43537129341.208899,2782151,141935,273000,3197086
2019-03-01,NYSE Arca (P),222876036,334858460,202834091,760568587,8372239690.928102,18207987435.145009,9537260910.338098,36117488036.411209,1484514,840312,1401211,3726037
2019-03-01,NASDAQ (Q),476616070,171485321,659641273,1307742664,21879466748.935002,11435093331.009598,36044714338.256005,69359274418.200605,4139001,668882,4217801,9025684
2019-03-01,IEX (V),133625732,24576009,71953200,230154941,5706641397.784700,1466444234.924200,3877955601.876201,11051041234.585101,974184,105445,537676,1617305
2019-03-01,NASDAQ PSX (X),17087140,23253408,12966590,53307138,580028803.776900,1934624282.533100,914327466.332700,3428980552.642700,120878,89049,96412,306339
2019-03-01,BYX Equities (Y),173075805,89894351,77492248,340462404,5237748956.290400,4228007920.707799,3248112230.532800,12713869107.530999,1409050,419511,720476,2549037
2019-03-01,BZX Equities (Z),202234710,104354351,123649336,430238397,8213876981.090598,6478886097.111801,6878462849.545197,21571225927.747596,1770857,407273,1130424,3308554
2019-02-28,NYSE American (A),7581836,21964159,3169181,32715176,314448327.731400,207871648.341700,160642123.250000,682962099.323100,74431,37558,32070,144059
2019-02-28,NASDAQ BX (B),102704451,23409063,52869762,178983276,4570876875.678000,1258752491.173800,2648726979.857900,8478356346.709700,1037657,117136,546062,1700855
2019-02-28,NYSE National (C),50377349,17098814,21252232,88728395,1529381573.733500,691093498.651700,869960263.219000,3090435335.604200,426822,68655,208274,703751
2019-02-28,FINRA / NYSE TRF (DN),240562014,76157674,268579293,585298981,7323503546.493203,2466189735.467200,7929099580.206601,17718792862.167004,590781,164861,619284,1374926
2019-02-28,FINRA / Nasdaq TRF Carteret (DQ),1273679161,356600360,844314125,2474593646,50879152591.715386,21351222517.211089,37250951021.170307,109481326130.096782,4017965,732570,2439542,7190077
2019-02-28,EDGA Equities (J),92250401,35780917,45590974,173622292,3454139054.218699,1987779204.458501,2346319486.604300,7788237745.281500,851126,169691,423441,1444258
2019-02-28,EDGX Equities (K),156201521,58541113,127896020,342638654,5945172937.520901,3571701412.426700,5307650062.881103,14824524412.828704,1095652,226902,744758,2067312
2019-02-28,NYSE Chicago (M),22940182,9574878,6997901,39512961,1399187437.945000,799191697.372000,769454089.120200,2967833224.437200,6029,2589,3815,12433
2019-02-28,NYSE (N),1271469347,43641814,43116578,1358227739,51522597306.983897,2827330469.304500,2107779469.480800,56457707245.769197,2782842,115767,251151,3149760
2019-02-28,NYSE Arca (P),206595173,267082389,195133599,668811161,8107320433.291398,15644500413.827807,8346362280.213204,32098183127.332409,1445596,640806,1282761,3369163
2019-02-28,NASDAQ (Q),495912042,151557217,788156900,1435626159,22434921855.194891,10455868113.295405,39925291174.290316,72816081142.780612,4121950,559233,3974164,8655347
2019-02-28,IEX (V),127898169,18881339,66202314,212981822,5353356093.386600,1122167263.985500,3434218926.995400,9909742284.367500,905836,83469,474884,1464189
2019-02-28,NASDAQ PSX (X),16885119,15470349,12427014,44782482,612609381.847900,1391219331.921400,768944391.944400,2772773105.713700,125906,62778,91845,280529
2019-02-28,BYX Equities (Y),174536551,69307393,74642337,318486281,5359012223.859900,3357867405.650800,2976442574.403900,11693322203.914600,1419346,327254,677343,2423943
2019-02-28,BZX Equities (Z),206190914,80674235,126444551,413309700,8451884677.772900,5276668181.866399,6384506310.029603,20113059169.668902,1780789,340152,1098634,3219575
2019-02-27,NYSE American (A),6248274,14804454,2705410,23758138,260042111.752100,168110817.361900,144218141.288100,572371070.402100,62367,39379,28334,130080
2019-02-27,NASDAQ BX (B),98858480,22944797,50874966,172678243,4289374222.840100,1179992559.771000,2452792570.369799,7922159352.980899,1013433,117066,541089,1671588
2019-02-27,NYSE National (C),46072697,14421284,19244235,79738216,1335442224.600400,595627694.886400,777046333.452800,2708116252.939600,394664,61439,194330,650433
2019-02-27,FINRA / NYSE TRF (DN),254459348,89582957,271880489,615922794,7324919507.852099,2551089323.368800,8077949129.781804,17953957961.002703,592696,171181,602752,1366629
2019-02-27,FINRA / Nasdaq TRF Carteret (DQ),1135903299,355007057,757717426,2248627782,43568334055.911607,19304754091.665391,30535851442.266801,93408939589.843799,3857010,741244,2418561,7016815
2019-02-27,EDGA Equities (J),81912900,34096924,43709385,159719209,3005368190.412400,1932128536.468700,2265563632.026100,7203060358.907200,752527,170895,409457,1332879
2019-02-27,EDGX Equities (K),157461147,61460144,131759713,350681004,5756212536.877398,3549270487.771600,5363277352.898197,14668760377.547195,1062577,238709,738744,2040030
2019-02-27,NYSE Chicago (M),22222464,8084680,13842592,44149736,1917452593.630701,644358030.252600,1793226948.552001,4355037572.435302,3363,2948,3207,9518
2019-02-27,NYSE (N),831762979,42917444,44882788,919563211,32540390822.933800,2635666013.193400,2062853920.857100,37238910756.984300,2548196,118352,243777,2910325
2019-02-27,NYSE Arca (P),195757453,228045181,196954460,620757094,7529243906.978700,12321979236.251799,7978049327.370098,27829272470.600597,1355492,614257,1231439,3201188
2019-02-27,NASDAQ (Q),460380163,151158010,623843513,1235381686,20038758510.459600,9311535985.394501,29924610136.902200,59274904632.756301,3769864,592390,3816928,8179182
2019-02-27,IEX (V),114413435,17104211,60933742,192451388,4895949018.790700,1041048280.005800,3124194586.398000,9061191885.194500,808055,80615,446509,1335179
2019-02-27,NASDAQ PSX (X),15558188,15337570,11870598,42766356,542686032.661100,1311032024.764000,725059292.407900,2578777349.833000,115638,61385,89252,266275
2019-02-27,BYX Equities (Y),158756519,62227017,74334320,295317856,4723946322.246399,2958619496.806600,2758985461.871500,10441551280.924499,1289383,316733,664535,2270651
2019-02-27,BZX Equities (Z),192030354,81701866,126238564,399970784,7619108097.729502,5298416502.889998,6163034334.633800,19080558935.253300,1642778,364313,1073211,3080302
2019-02-26,NYSE American (A),5757718,18349955,2586367,26694040,229887102.790600,158810053.564900,114664917.379600,503362073.735100,59087,47769,26700,133556
2019-02-26,NASDAQ BX (B),96520688,22329374,51165843,170015905,4332631239.427600,1221101245.497000,2508288336.394500,8062020821.319100,1023948,120973,552613,1697534
2019-02-26,NYSE National (C),46338003,13317717,20121707,79777427,1433297178.437700,517287631.031500,812214506.727800,2762799316.197000,401463,60853,203910,666226
2019-02-26,FINRA / NYSE TRF (DN),246987998,93113822,235777344,575879164,6629352382.246999,2658676991.731900,7646243083.133098,16934272457.111997,591321,190714,583666,1365701
2019-02-26,FINRA / Nasdaq TRF Carteret (DQ),1094848851,357462647,726861862,2179173360,41878394849.235708,19768646732.046696,30247645017.261097,91894686598.543501,3747239,758708,2340664,6846611
2019-02-26,EDGA Equities (J),79015937,32026319,41048201,152090457,2928191702.334000,1910332106.430000,2154962918.021000,6993486726.785000,744445,163873,413016,1321334
2019-02-26,EDGX Equities (K),146128269,63432337,117265800,326826406,5460231252.201902,3790152188.942000,5064594112.088899,14314977553.232801,1034263,245578,717707,1997548
2019-02-26,NYSE Chicago (M),15981536,11829088,5511309,33321933,947063819.761600,831929820.010000,341076428.885200,2120070068.656800,3485,2587,3178,9250
2019-02-26,NYSE (N),867557955,39405805,41526633,948490393,34518533847.734197,2548387543.609000,1871810008.940599,38938731400.283796,2532947,118483,242338,2893768
2019-02-26,NYSE Arca (P),188407856,237350218,175134507,600892581,7303384777.462698,13305105085.288000,7324036772.827002,27932526635.577700,1343217,630211,1202943,3176371
2019-02-26,NASDAQ (Q),429810164,150048674,636364325,1216223163,19217168987.049703,9593287313.709802,30306090297.332203,59116546598.091708,3724466,609684,3724249,8058399
2019-02-26,IEX (V),109060511,17882048,60750238,187692797,4747568034.908900,1171614897.981500,2934844850.804300,8854027783.694700,796262,90980,448070,1335312
2019-02-26,NASDAQ PSX (X),14636996,14309767,11279046,40225809,519514576.660100,1304223880.339500,697571444.968500,2521309901.968100,111304,60020,86468,257792
2019-02-26,BYX Equities (Y),151863744,60171701,68531473,280566918,4635219296.309599,2954323064.288400,2607858630.402100,10197400991.000099,1276684,300947,639346,2216977
2019-02-26,BZX Equities (Z),183292120,78071214,111837355,373200689,7424110259.906899,5226109620.067900,5664997846.315798,18315217726.290597,1610622,352968,1028764,2992354
2019-02-25,NYSE American (A),5744727,14437185,2973820,23155732,236096496.785500,173000939.792900,152486943.012300,561584379.590700,58249,43897,30535,132681
2019-02-25,NASDAQ BX (B),94423219,23772673,51513772,169709664,4347015534.680400,1342872219.373000,2583171176.151400,8273058930.204800,998798,127196,558420,1684414
2019-02-25,NYSE National (C),47002104,16224485,20171622,83398211,1352079627.783500,597830145.638800,810874778.127400,2760784551.549700,388187,65955,208475,662617
2019-02-25,FINRA / NYSE TRF (DN),239987973,87742862,251466742,579197577,6631860215.298003,2979340883.873699,9489274989.173501,19100476088.345203,607306,195009,694533,1496848
2019-02-25,FINRA / Nasdaq TRF Carteret (DQ),1210357302,385417039,776191157,2371965498,45050250485.700399,23170732584.799201,35731332476.674515,103952315547.174115,3820844,843286,2557650,7221780
2019-02-25,EDGA Equities (J),79923724,34053503,40858831,154836058,2878701479.903100,1854898900.904200,2235459176.425100,6969059557.232400,721278,181094,415195,1317567
2019-02-25,EDGX Equities (K),148363609,63548122,120729436,332641167,5445971310.718499,3833453771.750301,5814658466.149100,15094083548.617900,1004806,249347,777104,2031257
2019-02-25,NYSE Chicago (M),16253674,10741403,9203708,36198785,938565289.302400,822448771.250000,604846853.147800,2365860913.700200,5339,3060,4244,12643
2019-02-25,NYSE (N),894802002,42023229,41981179,978806410,35224153865.420599,2684885960.895500,1892984531.426000,39802024357.742099,2467755,117954,239903,2825612
2019-02-25,NYSE Arca (P),202002719,251969857,183564661,637537237,7619135370.957195,13876345534.730005,8575080793.898001,30070561699.585201,1370596,678782,1335971,3385349
2019-02-25,NASDAQ (Q),443124075,150804926,638564916,1232493917,19348213233.236497,10386381156.686001,33142816012.951813,62877410402.874311,3628982,624571,3917877,8171430
2019-02-25,IEX (V),119622784,19394842,62204518,201222144,5054507143.341400,1207031491.273700,3237062422.503600,9498601057.118700,833676,94615,461147,1389438
2019-02-25,NASDAQ PSX (X),16194544,14727577,11988076,42910197,557985995.951500,1387597061.480000,736081055.566000,2681664112.997500,116526,64836,90284,271646
2019-02-25,BYX Equities (Y),155291493,65220217,70311084,290822794,4692308353.335200,3084888006.578899,2853087731.216500,10630284091.130599,1268197,328445,675658,2272300
2019-02-25,BZX Equities (Z),187166455,83563258,117688188,388417901,7358939562.862000,5677183984.238500,6248722662.009099,19284846209.109599,1583650,367471,1075012,3026133
2019-02-22,NYSE American (A),6057461,14561594,3623479,24242534,233564161.205900,196384228.314700,171549533.490600,601497923.011200,63093,40534,37665,141292
2019-02-22,NASDAQ BX (B),96648253,21183135,55161936,172993324,4346851194.786300,1225370698.577500,2693226841.395100,8265448734.758900,1017845,112113,586512,1716470
2019-02-22,NYSE National (C),46238266,14964777,22798531,84001574,1341769905.716600,613144096.661100,875338218.440700,2830252220.818400,394639,65701,221523,681863
2019-02-22,FINRA / NYSE TRF (DN),213773259,76786027,249286784,539846070,6390771026.761500,2529952235.150299,9099174354.398402,18019897616.310201,543869,173808,676508,1394185
2019-02-22,FINRA / Nasdaq TRF Carteret (DQ),992533323,355557792,772355598,2120446713,36685938279.098601,23514296211.200687,32887488393.952190,93087722884.251478,3566388,717531,2603058,6886977
2019-02-22,EDGA Equities (J),77213158,28966495,43470820,149650473,2752923942.571100,1794786048.493200,2184909337.775400,6732619328.839700,725366,154883,430572,1310821
2019-02-22,EDGX Equities (K),133927134,55560763,123400087,312887984,5190222934.707502,3568867910.142399,5795495854.643401,14554586699.493302,997969,223235,794146,2015350
2019-02-22,NYSE Chicago (M),20002121,9695972,6126465,35824558,1042692700.045000,737395867.137800,488409819.380900,2268498386.563700,7179,2719,3203,13101
2019-02-22,NYSE (N),798687160,38595353,44436614,881719127,31316727830.521500,2762578564.259100,2014347649.930700,36093654044.711300,2520722,111912,248976,2881610
2019-02-22,NYSE Arca (P),178287226,220924287,196861547,596073060,7102766538.659302,12973995591.590299,8950542121.285999,29027304251.535600,1355706,594757,1413980,3364443
2019-02-22,NASDAQ (Q),414439137,142033448,636403321,1192875906,18570339419.484301,9865460586.655702,32628762490.551406,61064562496.691409,3618764,575279,3938173,8132216
2019-02-22,IEX (V),105305126,16622936,63943979,185872041,4378319722.801800,1068984769.823200,3035703606.008300,8483008098.633300,758888,83625,458712,1301225
2019-02-22,NASDAQ PSX (X),15938854,14880426,12377114,43196394,529261532.336300,1662474346.776300,834457633.990000,3026193513.102600,121198,61846,95075,278119
2019-02-22,BYX Equities (Y),149239336,59508892,73957658,282705886,4449544070.051600,2992976199.667100,2885008425.856500,10327528695.575200,1239694,302803,682400,2224897
2019-02-22,BZX Equities (Z),181061495,75170569,124358374,380590438,7025685277.175300,5273386108.047201,6305093908.263698,18604165293.486199,1567971,335845,1110695,3014511
2019-02-21,NYSE American (A),6507985,16706236,2913266,26127487,280771513.898800,159203256.625500,172371119.410600,612345889.934900,69582,45707,31707,146996
2019-02-21,NASDAQ BX (B),102349776,23483408,52142509,177975693,4591056101.491700,1221040564.506300,2573461004.429800,8385557670.427800,1078725,123371,570297,1772393
2019-02-21,NYSE National (C),47962476,14700377,20512585,83175438,1322980000.317100,564665916.333400,780212912.500400,2667858829.150900,401570,67713,204989,674272
2019-02-21,FINRA / NYSE TRF (DN),212988719,89287272,230711084,532987075,6194465782.996402,2854698896.317301,8000004381.193601,17049169060.507304,520846,182468,592740,1296054
2019-02-21,FINRA / Nasdaq TRF Carteret (DQ),1032889595,364678691,669972152,2067540438,38593357111.010094,19714265597.632692,29871198565.046294,88178821273.689080,3621690,729166,2219284,6570140
2019-02-21,EDGA Equities (J),82198796,33082026,41229526,156510348,2876226617.613300,1955004271.126000,2122301110.344200,6953531999.083500,756964,171209,400558,1328731
2019-02-21,EDGX Equities (K),142624072,62341520,115311152,320276744,5475609914.645500,3734521098.061501,5350872330.362898,14561003343.069899,1038622,252952,737389,2028963
2019-02-21,NYSE Chicago (M),16889991,12237053,4433239,33560283,1161520166.061500,972429228.636200,440546605.232900,2574495999.930600,7935,3117,3487,14539
2019-02-21,NYSE (N),854564605,42662711,38268941,935496257,31431410045.989603,2878227978.515600,1832528433.920400,36142166458.425603,2626169,121197,219278,2966644
2019-02-21,NYSE Arca (P),183660668,240258270,172652124,596571062,7150938019.271400,13057471954.869699,7578258917.851397,27786668891.992496,1421725,667891,1245043,3334659
2019-02-21,NASDAQ (Q),451888371,152496914,551421477,1155806762,19721380163.783697,9482378334.731102,28766103487.438298,57969861985.953097,3756177,639089,3689814,8085080
2019-02-21,IEX (V),103552504,18078169,53471443,175102116,4282539396.257700,1063406144.421800,2787009821.144600,8132955361.824100,758656,83836,401730,1244222
2019-02-21,NASDAQ PSX (X),14787990,14827515,12393719,42009224,512097876.261100,1388415577.058300,808484235.250300,2708997688.569700,118133,64024,89317,271474
2019-02-21,BYX Equities (Y),154526268,61464250,66904078,282894596,4566769028.412300,2958393523.382400,2689465361.792700,10214627913.587400,1295079,317066,659546,2271691
2019-02-21,BZX Equities (Z),190877932,83059698,112348004,386285634,7432058064.048100,5506231659.799198,5939372122.352000,18877661846.199298,1657909,382630,1041791,3082330
2019-02-20,NYSE American (A),7222131,17519921,3113880,27855932,274461679.558000,173335455.499400,147092197.326800,594889332.384200,73314,45316,32404,151034
2019-02-20,NASDAQ BX (B),106694223,25296842,52154387,184145452,4635566390.589600,1342368060.829200,2566810281.198500,8544744732.617300,1089606,132106,568011,1789723
2019-02-20,NYSE National (C),51481934,17365416,20831966,89679316,1442360296.007400,659771561.678700,822509758.190000,2924641615.876100,430314,70197,207803,708314
2019-02-20,FINRA / NYSE TRF (DN),227543757,96444515,224761423,548749695,6726473337.378902,2735169339.299100,8200215032.716301,17661857709.394303,567139,195159,589161,1351459
2019-02-20,FINRA / Nasdaq TRF Carteret (DQ),1172627818,427032764,698702591,2298363173,46228350830.682394,24730731405.341592,31398279176.480910,102357361412.504896,3803803,817113,2256976,6877892
2019-02-20,EDGA Equities (J),88504908,38318523,40797396,167620827,3169249217.015000,2207801078.188599,2231029115.704500,7608079410.908099,808902,197817,418962,1425681
2019-02-20,EDGX Equities (K),144200679,65618863,109316244,319135786,5513501933.573299,3833547987.037101,5222398257.849401,14569448178.459801,1061557,261101,715980,2038638
2019-02-20,NYSE Chicago (M),23842929,14640755,8373042,46856726,1444744777.780600,1085565919.176400,1317648979.967499,3847959676.924499,4091,3776,3756,11623
2019-02-20,NYSE (N),932686503,44498842,39942625,1017127970,36334534116.263602,3197783237.381499,1869350551.146900,41401667904.792001,2703483,122519,220762,3046764
2019-02-20,NYSE Arca (P),188858325,257906427,166488688,613253440,7391761711.237501,14088650970.680404,7607075639.858898,29087488321.776803,1370721,717133,1213272,3301126
2019-02-20,NASDAQ (Q),464695616,173740544,585553110,1223989270,19957860294.913101,11318008957.170997,30365537605.587302,61641406857.671400,3948986,717668,3760335,8426989
2019-02-20,IEX (V),116427846,17927170,59418022,193773038,4748754304.357800,1085496049.077800,2858760138.725500,8693010492.161100,838345,83057,434844,1356246
2019-02-20,NASDAQ PSX (X),16379822,17589900,12085224,46054946,555199879.208400,1776771636.006201,820486549.281500,3152458064.496101,124547,73395,88335,286277
2019-02-20,BYX Equities (Y),165760621,66794134,67833380,300388135,4869412963.487500,3163001885.895500,2701650835.439700,10734065684.822700,1377596,336240,646981,2360817
2019-02-20,BZX Equities (Z),197910268,86310997,113298715,397519980,7701779480.968200,5736316313.055299,5944510970.723201,19382606764.746700,1737923,392786,1062424,3193133
2019-02-19,NYSE American (A),7092228,17627528,2984911,27704667,265118546.971100,164813275.244500,137292465.293200,567224287.508800,71266,48028,32457,151751
2019-02-19,NASDAQ BX (B),93404900,26207252,50153760,169765912,4176722472.123100,1368644571.903000,2492866222.804601,8038233266.830701,984547,131115,555708,1671370
2019-02-19,NYSE National (C),47145245,14316080,20157121,81618446,1310569426.597700,557808356.206900,747960365.142000,2616338147.946600,394351,62081,203541,659973
2019-02-19,FINRA / NYSE TRF (DN),227728528,96088420,224518423,548335371,6622906859.205601,2649785426.578401,7752375509.483800,17025067795.267802,577631,197681,579765,1355077
2019-02-19,FINRA / Nasdaq TRF Carteret (DQ),1044200473,460513169,699213262,2203926904,40778928168.259005,24726863581.050597,30829647968.819202,96335439718.128804,3670255,866338,2303524,6840117
2019-02-19,EDGA Equities (J),73416741,37945712,36099259,147461712,2644770419.903400,1933414327.923200,1903339425.930800,6481524173.757400,699409,180534,379872,1259815
2019-02-19,EDGX Equities (K),137663735,61902807,99999933,299566475,5374627701.938299,3389000366.483800,4697227980.487301,13460856048.909400,1024541,233887,689542,1947970
2019-02-19,NYSE Chicago (M),14726852,9039318,4907089,28673259,1132118320.387100,701917909.922000,656675851.240400,2490712081.549500,3485,3175,3245,9905
2019-02-19,NYSE (N),838763277,38054052,36108018,912925347,33733458369.521395,2634888002.912300,1590803158.750800,37959149531.184495,2492233,105262,215070,2812565
2019-02-19,NYSE Arca (P),172778292,259175270,157542728,589496290,6848133258.668802,13280472402.026102,6859042419.519501,26987648080.214405,1253525,607978,1144979,3006482
2019-02-19,NASDAQ (Q),423299110,152340553,556395311,1132034974,18551698877.305798,9445271184.091103,28378359386.355608,56375329447.752509,3581492,612125,3563329,7756946
2019-02-19,IEX (V),113205588,21043903,61131717,195381208,4893542090.598101,1158441833.256300,3000788159.035500,9052772082.889901,809932,91615,452922,1354469
2019-02-19,NASDAQ PSX (X),14785750,14883262,11069994,40739006,549479132.535500,1341108149.513900,699594223.784200,2590181505.833600,118236,59926,85528,263690
2019-02-19,BYX Equities (Y),149177746,63427004,63611861,276216611,4530048326.916000,2912373609.953300,2587695629.386300,10030117566.255600,1260813,303098,631607,2195518
2019-02-19,BZX Equities (Z),177891114,75187996,100249661,353328771,7097104987.897400,4820964560.924599,5050166500.399200,16968236049.221199,1556612,336512,947922,2841046
2019-02-15,NYSE American (A),6105588,16898844,2959875,25964307,247288633.068300,180975339.820200,139079988.957500,567343961.846000,62940,42716,30208,135864
2019-02-15,NASDAQ BX (B),93635172,23110287,50941211,167686670,4446562995.013500,1376473111.176300,2627786826.796700,8450822932.986500,984424,121600,541906,1647930
2019-02-15,NYSE National (C),46427726,16386058,20965075,83778859,1311065554.083400,648031084.827500,764995965.320900,2724092604.231800,391660,63997,200414,656071
2019-02-15,FINRA / NYSE TRF (DN),217257241,93432878,225009176,535699295,7002327575.031001,3105685272.908300,9289834718.114305,19397847566.053606,559188,189316,592550,1341054
2019-02-15,FINRA / Nasdaq TRF Carteret (DQ),1079507691,377965463,692079318,2149552472,42077108990.149197,25584401487.368200,31541390909.605790,99202901387.123187,3674763,734232,2319768,6728763
2019-02-15,EDGA Equities (J),74979642,34947216,40910850,150837708,2931833110.408800,2041723536.236999,2215042405.134500,7188599051.780299,719086,175910,403309,1298305
2019-02-15,EDGX Equities (K),138568562,63353899,108456749,310379210,5662081264.399103,4131375327.676400,5436387690.856201,15229844282.931704,1020582,255602,704995,1981179
2019-02-15,NYSE Chicago (M),11684683,12205757,5794779,29685219,714602622.028600,1133063718.588200,775458488.925100,2623124829.541900,3094,4587,4029,11710
2019-02-15,NYSE (N),947494658,42638016,42082577,1032215251,41629056408.530293,3221290306.567501,1867282909.053100,46717629624.150894,2495435,119487,225233,2840155
2019-02-15,NYSE Arca (P),174122207,248091601,161492832,583706640,7239193565.130299,15058949285.369291,7720834489.182101,30018977339.681691,1271881,654688,1143816,3070385
2019-02-15,NASDAQ (Q),404807245,153699460,651269165,1209775870,18961275540.947504,11319799355.907100,35238268669.261917,65519343566.116521,3520603,650539,3621761,7792903
2019-02-15,IEX (V),110347789,19964786,62449301,192761876,4888264557.507300,1284696560.414000,3104612938.388799,9277574056.310099,783134,94732,445910,1323776
2019-02-15,NASDAQ PSX (X),14488646,16268248,13210345,43967239,570148886.987700,1849381416.620500,926012166.956400,3345542470.564600,117270,69221,98209,284700
2019-02-15,BYX Equities (Y),144812277,63971732,69768036,278552045,4626914822.447200,3114858924.193800,2752843228.967700,10494616975.608700,1230087,302287,649529,2181903
2019-02-15,BZX Equities (Z),184444436,80026124,116252595,380723155,7867969334.769799,6078648486.643002,6445489603.284502,20392107424.697303,1621102,377795,1040181,3039078
2019-02-14,NYSE American (A),7003324,15470121,2731451,25204896,276657423.267000,191595167.486300,139713530.015000,607966120.768300,73429,46144,29552,149125
2019-02-14,NASDAQ BX (B),99619389,25559685,50734519,175913593,4466143674.198801,1407207661.706100,2506834537.554400,8380185873.459301,1035745,138044,542672,1716461
2019-02-14,NYSE National (C),46737383,14767106,19443146,80947635,1294188683.781600,591323415.366200,715586491.973400,2601098591.121200,391115,72224,195759,659098
2019-02-14,FINRA / NYSE TRF (DN),223410210,86141670,217752076,527303956,6579077607.469899,2938480910.919301,8458592286.035597,17976150804.424797,547446,167223,542577,1257246
2019-02-14,FINRA / Nasdaq TRF Carteret (DQ),1121432463,378501694,636412655,2136346812,41411099173.750197,21170712601.458598,29820165066.933201,92401976842.141996,3665844,736696,2125691,6528231
2019-02-14,EDGA Equities (J),80063221,38880774,40542955,159486950,3050606501.992100,2330329548.301300,2241058107.254800,7621994157.548200,755229,198790,396420,1350439
2019-02-14,EDGX Equities (K),147407230,74483539,108620934,330511703,5496746770.258400,4691996079.950701,5207131980.130199,15395874830.339300,1045346,296343,696402,2038091
2019-02-14,NYSE Chicago (M),22180413,12271919,6173087,40625419,1570763099.112901,1298874732.575000,588529913.203400,3458167744.891301,3685,4798,3855,12338
2019-02-14,NYSE (N),949377551,48712169,40140943,1038230663,34175350654.053101,3612407335.493800,1921878719.374200,39709636708.921101,2599642,144062,231191,2974895
2019-02-14,NYSE Arca (P),198189943,278430315,168355483,644975741,7552233685.940000,15792842288.134304,7906242624.786703,31251318598.861007,1370057,770301,1179146,3319504
2019-02-14,NASDAQ (Q),455633544,175869871,576742860,1208246275,20020885758.011907,11845140820.116801,29519380916.755199,61385407494.883907,3894801,752968,3642492,8290261
2019-02-14,IEX (V),118573644,20735326,57479257,196788227,4802768682.198200,1289909347.695200,2909264402.041599,9001942431.934999,806339,97633,416135,1320107
2019-02-14,NASDAQ PSX (X),16821168,20247747,12906807,49975722,600854789.877400,2017601703.672301,877002522.904400,3495459016.454101,127011,82854,102135,312000
2019-02-14,BYX Equities (Y),155734166,66258191,65369662,287362019,4619587085.375800,3116680810.357000,2656297569.170400,10392565464.903200,1295124,333879,632041,2261044
2019-02-14,BZX Equities (Z),203213110,98653949,114094779,415961838,7994676879.664002,6846475443.357498,6115443233.211401,20956595556.232901,1707635,454150,1020973,3182758
2019-02-13,NYSE American (A),5757482,12570998,2530860,20859340,212716706.714700,154298358.632900,139115838.361200,506130903.708800,58474,37398,26992,122864
2019-02-13,NASDAQ BX (B),93555821,24197474,49192320,166945615,4209028795.131800,1323677089.760100,2596742266.712101,8129448151.604001,976373,128957,532421,1637751
2019-02-13,NYSE National (C),44079407,14813148,18260202,77152757,1199162895.729800,547540018.574500,674622386.999800,2421325301.304100,374740,63898,183508,622146
2019-02-13,FINRA / NYSE TRF (DN),237935518,81714660,237728760,557378938,7121433660.191797,2978405724.392499,9172758505.989799,19272597890.574095,571339,172145,570642,1314126
2019-02-13,FINRA / Nasdaq TRF Carteret (DQ),1138294838,397067988,668411220,2203774046,40888379539.136192,20980555663.442493,29902338709.884498,91771273912.463183,3676688,747051,2151695,6575434
2019-02-13,EDGA Equities (J),70513365,35012447,37673027,143198839,2708641352.427200,1801754149.127300,2053137872.369500,6563533373.924000,670396,175817,366110,1212323
2019-02-13,EDGX Equities (K),148341018,62595842,105432320,316369180,5590258038.569100,3606029258.897900,5163338804.142299,14359626101.609299,1031588,239116,676989,1947693
2019-02-13,NYSE Chicago (M),13093755,13172400,5773258,32039413,974468135.890600,1311042705.724000,802430536.099400,3087941377.714000,3702,3543,3594,10839
2019-02-13,NYSE (N),820070995,41772604,38059121,899902720,31229226941.648500,2968153684.327000,1779357195.123600,35976737821.099100,2445880,110288,215944,2772112
2019-02-13,NYSE Arca (P),192252556,233961597,159635126,585849279,7167623977.563599,12941844605.786496,7359645807.701600,27469114391.051695,1291076,647752,1107537,3046365
2019-02-13,NASDAQ (Q),440910472,153263586,539544013,1133718071,19106040784.950002,9964047403.976200,28409855370.351099,57479943559.277301,3645086,613948,3462299,7721333
2019-02-13,IEX (V),117095905,19377130,58845409,195318444,4920174046.796000,1134663465.702000,3061087028.492900,9115924540.990900,804232,94829,418651,1317712
2019-02-13,NASDAQ PSX (X),15040699,16476312,11872613,43389624,520318524.457400,1585930078.177999,749992612.715000,2856241215.350399,114790,64070,88980,267840
2019-02-13,BYX Equities (Y),153172298,59974328,62548643,275695269,4510779374.757199,2802106296.102900,2572761951.084500,9885647621.944599,1269310,302248,602851,2174409
2019-02-13,BZX Equities (Z),194803976,81240824,108342216,384387016,7532606783.346601,5141013220.787101,5699615393.097500,18373235397.231202,1612485,356875,972484,2941844
2019-02-12,NYSE American (A),6037816,13439147,2453697,21930660,222607290.733800,178245268.649500,136312518.710300,537165078.093600,62564,42369,27201,132134
2019-02-12,NASDAQ BX (B),102587458,24753121,50417294,177757873,4586808287.258700,1420137208.890200,2741407557.663400,8748353053.812300,1038179,134303,546063,1718545
2019-02-12,NYSE National (C),47528843,15271986,19868342,82669171,1292532539.508500,630814621.815300,761105051.302000,2684452212.625800,398754,65456,197437,661647
2019-02-12,FINRA / NYSE TRF (DN),244131969,85194738,218587751,547914458,7248549711.248701,2956416114.311600,9574502141.362700,19779467966.923001,571131,179661,567564,1318356
2019-02-12,FINRA / Nasdaq TRF Carteret (DQ),1153994540,390787783,684746987,2229529310,41619674286.324595,22721648550.539306,32627785447.394099,96969108284.258000,3810901,771088,2221734,6803723
2019-02-12,EDGA Equities (J),77273922,33707598,36713644,147695164,2808324933.239900,1862924706.551499,2166250409.121300,6837500048.912699,701127,171638,365289,1238054
2019-02-12,EDGX Equities (K),153367646,61816628,103422564,318606838,5901405797.638600,3664649602.694000,5643133581.570200,15209188981.902800,1125357,241259,702965,2069581
2019-02-12,NYSE Chicago (M),14475335,14031489,8827998,37334822,714276100.150000,1538240394.147000,921327209.014000,3173843703.311000,2895,4541,3661,11097
2019-02-12,NYSE (N),872775970,38417025,37373019,948566014,33852446043.106302,2921848832.175601,1806494989.218100,38580789864.500003,2522924,110344,210171,2843439
2019-02-12,NYSE Arca (P),195217061,233268589,165621670,594107320,7321477323.868603,13708685971.674395,8392829811.651904,29422993107.194902,1340366,645590,1179631,3165587
2019-02-12,NASDAQ (Q),467102291,151767934,557886825,1176757050,20628557269.733604,10332766401.588203,31995143886.788787,62956467558.110594,3847872,614431,3585640,8047943
2019-02-12,IEX (V),126334337,21171338,61942100,209447775,5220093721.511200,1381042207.645600,3335067430.177900,9936203359.334700,846169,96588,442531,1385288
2019-02-12,NASDAQ PSX (X),16297786,15689929,12935235,44922950,566359054.262000,1475180292.122800,841776146.805000,2883315493.189800,121031,64413,99394,284838
2019-02-12,BYX Equities (Y),164887299,64780921,69116327,298784547,4794813866.028100,3283660456.922300,2915740870.024500,10994215192.974900,1327779,311930,640045,2279754
2019-02-12,BZX Equities (Z),201014191,80245804,110221310,391481305,7746798106.217000,5442178801.752598,6143218903.437401,19332195811.406999,1704455,355528,1006372,3066355
2019-02-11,NYSE American (A),5318635,10443038,2211565,17973238,195642331.771600,117807738.654000,113046669.525100,426496739.950700,55533,32784,24914,113231
2019-02-11,NASDAQ BX (B),86529466,20537434,43489297,150556197,3731131546.210899,1053321386.841000,2191300504.366300,6975753437.418199,897238,110947,483636,1491821
2019-02-11,NYSE National (C),42767853,11690635,17945550,72404038,1154493299.776500,471324033.801100,703299378.556700,2329116712.134300,370047,57353,185597,612997
2019-02-11,FINRA / NYSE TRF (DN),214319657,73690869,192245881,480256407,6284146831.510199,2737701477.031601,7723929430.448798,16745777738.990598,536559,161806,522959,1221324
2019-02-11,FINRA / Nasdaq TRF Carteret (DQ),1008780658,348938230,603686335,1961405223,37899317318.921999,20414168918.474895,28551722300.144916,86865208537.541810,3409800,663547,2058482,6131829
2019-02-11,EDGA Equities (J),66696957,31126354,34964124,132787435,2602729267.655700,1652624880.413600,2000306142.477300,6255660290.546600,632520,152165,361303,1145988
2019-02-11,EDGX Equities (K),130830735,53652401,90508407,274991543,4877718102.691400,3023475416.966300,4421792649.907500,12322986169.565200,963691,217008,635158,1815857
2019-02-11,NYSE Chicago (M),12918191,12025751,5798857,30742799,854218055.799500,1472504465.115000,622937611.108400,2949660132.022900,3098,3264,3478,9840
2019-02-11,NYSE (N),813346854,31223028,35059070,879628952,31811830803.024006,1991418960.618500,1568890527.841300,35372140291.483806,2317060,94698,195806,2607564
2019-02-11,NYSE Arca (P),156134335,216204049,140240922,512579306,6189225316.993899,11630919551.751899,6816640366.241001,24636785234.986799,1170220,597100,1077079,2844399
2019-02-11,NASDAQ (Q),399770200,122287774,512567180,1034625154,17561974772.513899,7748766850.494300,28342926623.404896,53653668246.413095,3498195,560235,3351017,7409447
2019-02-11,IEX (V),109306569,15615626,53967393,178889588,4656686580.578400,900411725.647000,2784956072.626200,8342054378.851600,769611,81108,403031,1253750
2019-02-11,NASDAQ PSX (X),13599977,13007867,10781658,37389502,493873706.242500,1060132356.041600,642774553.476400,2196780615.760500,107742,53173,81722,242637
2019-02-11,BYX Equities (Y),155846726,60131900,65150245,281128871,4297484283.957900,3917810949.027601,2860209758.897701,11075504991.883202,1290930,322817,649685,2263432
2019-02-11,BZX Equities (Z),179163767,67136869,99881812,346182448,6879670064.626601,4415415134.547800,5402881756.879099,16697966956.053500,1542188,308493,944370,2795051
2019-02-08,NYSE American (A),6012915,11148609,2604210,19765734,215509498.796700,134664591.282100,141847376.013000,492021466.091800,58390,38124,27645,124159
2019-02-08,NASDAQ BX (B),97480188,24042732,48045713,169568633,4120356976.984700,1267536303.530500,2517062503.330700,7904955783.845900,984306,130805,513890,1629001
2019-02-08,NYSE National (C),47226895,14230792,18516854,79974541,1202745489.648000,585296684.108500,738001114.773000,2526043288.529500,385970,66256,186477,638703
2019-02-08,FINRA / NYSE TRF (DN),227900417,89103521,224340762,541344700,6242105321.506902,3282050980.287101,8773256070.025996,18297412371.819999,534246,176131,544433,1254810
2019-02-08,FINRA / Nasdaq TRF Carteret (DQ),1067394179,366829705,651839656,2086063540,37003928993.849901,19879939223.406100,30219820848.213291,87103689065.469292,3529480,825183,2153973,6508636
2019-02-08,EDGA Equities (J),65308528,27921528,31785620,125015676,2432642500.552300,1448515703.794300,1790354637.150000,5671512841.496600,604667,144418,318537,1067622
2019-02-08,EDGX Equities (K),145050550,58452859,103200864,306704273,5188985814.494900,3698938700.986499,5084913117.466001,13972837632.947400,1032755,252154,698014,1982923
2019-02-08,NYSE Chicago (M),12298096,10707461,6286523,29292080,788167368.297700,828584241.710000,544823578.830400,2161575188.838100,3169,4646,3879,11694
2019-02-08,NYSE (N),832960788,37334501,39234630,909529919,31182616450.168102,2750861809.263300,1931928378.987500,35865406638.418902,2414471,117981,224947,2757399
2019-02-08,NYSE Arca (P),184995892,237908466,164936918,587841276,6795806972.695601,13070081129.265592,8008734931.620702,27874623033.581895,1304427,649900,1180135,3134462
2019-02-08,NASDAQ (Q),460799928,153046197,554307703,1168153828,19179488873.725197,10439751499.669296,29955711282.776184,59574951656.170677,3787351,669566,3617058,8073975
2019-02-08,IEX (V),112387048,17981613,58753277,189121938,4428636633.164800,1028791153.599400,2906246902.415500,8363674689.179700,779153,92366,413372,1284891
2019-02-08,NASDAQ PSX (X),16885024,15961961,13383082,46230067,561378063.555300,1666471671.626800,920002236.082700,3147851971.264800,125807,71400,97992,295199
2019-02-08,BYX Equities (Y),174623672,61748949,70821077,307193698,4618123440.483000,2771826874.721800,2706008029.792100,10095958344.996900,1390092,310775,650562,2351429
2019-02-08,BZX Equities (Z),198193167,80867803,114468600,393529570,7479316102.291200,5332100634.393900,6279777110.448399,19091193847.133499,1658587,376367,1038798,3073752
2019-02-07,NYSE American (A),6669132,10769782,2951926,20390840,252114958.637400,172276586.535100,149555367.682500,573946912.855000,67605,38493,30737,136835
2019-02-07,NASDAQ BX (B),101163359,31668220,51672485,184504064,4299554308.277500,1709701513.839600,2619704142.129400,8628959964.246500,1014847,162420,532814,1710081
2019-02-07,NYSE National (C),50190307,17201612,21005925,88397844,1315329982.124100,671651726.580200,809189382.597500,2796171091.301800,409117,79902,206368,695387
2019-02-07,FINRA / NYSE TRF (DN),251605737,103414830,233922903,588943470,7580376405.170202,4119367128.023703,9285345959.183896,20985089492.377801,593340,210698,599184,1403222
2019-02-07,FINRA / Nasdaq TRF Carteret (DQ),1200420457,435244431,692930776,2328595664,41874303990.208309,25488686838.732597,32588651180.947508,99951642009.888414,3891378,934823,2267443,7093644
2019-02-07,EDGA Equities (J),66339514,33553860,33852441,133745815,2559223169.460400,1717751157.132500,1761452935.098500,6038427261.691400,620472,159818,317611,1097901
2019-02-07,EDGX Equities (K),163769081,82222928,115570546,361562555,6215760389.328301,5346063772.987802,5865614945.299301,17427439107.615404,1165776,343011,777296,2286083
2019-02-07,NYSE Chicago (M),11994224,18202118,6327520,36523862,561873236.023200,1633241160.920000,626212847.848600,2821327244.791800,3990,5114,4944,14048
2019-02-07,NYSE (N),946634597,52624666,48733489,1047992752,35025448900.965199,3557659491.544701,2399684297.421900,40982792689.931800,2819310,159387,252239,3230936
2019-02-07,NYSE Arca (P),218180376,313317500,182762886,714260762,8516113404.249799,18074262837.978093,9036923452.582499,35627299694.810391,1527578,886297,1322349,3736224
2019-02-07,NASDAQ (Q),536852401,206151106,630446536,1373450043,23045616008.125503,13868885491.016297,35010228656.807703,71924730155.949503,4491510,909561,4108671,9509742
2019-02-07,IEX (V),128499801,22802673,65308031,216610505,5104348792.780700,1422619120.562600,3285233504.204502,9812201417.547802,871152,110189,458689,1440030
2019-02-07,NASDAQ PSX (X),17244846,25220588,16511733,58977167,597910865.566900,2378897965.395700,1106276312.151800,4083085143.114400,133022,108715,113727,355464
2019-02-07,BYX Equities (Y),184449670,81032674,77418201,342900545,4874439315.432799,3813088191.433000,3064419987.287100,11751947494.152899,1479959,398838,708983,2587780
2019-02-07,BZX Equities (Z),230027338,118213651,131285781,479526770,9083071574.131498,8291978297.309500,7298297402.312302,24673347273.753300,1977028,537102,1165118,3679248
2019-02-06,NYSE American (A),6065629,9960846,2692605,18719080,229275353.246500,123382474.948800,142627174.439800,495285002.635100,58889,34097,28057,121043
2019-02-06,NASDAQ BX (B),86789291,23382479,47534870,157706640,3798041997.193100,1231570481.840000,2461704054.853200,7491316533.886300,900618,118629,505007,1524254
2019-02-06,NYSE National (C),43318915,14321396,18473222,76113533,1165048152.253800,537465640.663200,755938201.489500,2458451994.406500,365450,62536,186587,614573
2019-02-06,FINRA / NYSE TRF (DN),234429859,76953492,227502375,538885726,6538907780.468701,2908579464.754300,9888092897.668001,19335580142.891002,569075,167139,614054,1350268
2019-02-06,FINRA / Nasdaq TRF Carteret (DQ),1034790125,374641124,705611257,2115042506,36811501478.209388,21613320797.530506,32189754797.438816,90614577073.178710,3598012,733316,2265029,6596357
2019-02-06,EDGA Equities (J),55753575,24920929,29613768,110288272,2057542302.533500,1285008468.173000,1622350407.543400,4964901178.249900,534394,114737,291484,940615
2019-02-06,EDGX Equities (K),143886429,58063080,107386568,309336077,5236010792.543201,3276080663.418300,5552086551.978902,14064178007.940403,1023563,231404,736896,1991863
2019-02-06,NYSE Chicago (M),10439555,11886888,9257012,31583455,588011863.967400,932618933.085100,1174103581.650000,2694734378.702500,3247,3447,4589,11283
2019-02-06,NYSE (N),794222458,38304188,38682375,871209021,30334122911.623800,2467205829.663599,1817323242.418900,34618651983.706299,2407323,107240,216019,2730582
2019-02-06,NYSE Arca (P),180777460,248514543,165741969,595033972,7011440930.088899,13656525987.012999,8152790145.952702,28820757063.054600,1288229,597646,1213515,3099390
2019-02-06,NASDAQ (Q),437058046,143592915,568428242,1149079203,18499629207.248398,9002690448.111501,31142818185.480712,58645137840.840611,3649951,603090,3658007,7911048
2019-02-06,IEX (V),102387776,18711891,63617118,184716785,4207343978.007700,1085203075.160900,3311908754.294900,8604455807.463500,743032,83740,435654,1262426
2019-02-06,NASDAQ PSX (X),15377175,16018855,12337216,43733246,502695443.518100,1347518408.328300,764535859.062800,2614749710.909200,116421,66007,90957,273385
2019-02-06,BYX Equities (Y),153791279,59179373,69563718,282534370,4309022880.088700,2782861698.351800,2780151103.469100,9872035681.909600,1273060,285922,648718,2207700
2019-02-06,BZX Equities (Z),187511078,78104799,112965780,378581657,7079486747.142999,4885083594.310300,6069769992.736098,18034340334.189397,1614381,344299,1024591,2983271
2019-02-05,NYSE American (A),5718229,10659588,2988584,19366401,222909401.725200,140879202.331400,157724757.862200,521513361.918800,59413,33411,29599,122423
2019-02-05,NASDAQ BX (B),89399609,24341336,48551004,162291949,4100403275.301500,1402460219.575600,2736332349.679500,8239195844.556600,929581,124476,524254,1578311
2019-02-05,NYSE National (C),43147734,15449872,19808715,78406321,1211965575.457200,617481768.613600,770135845.676600,2599583189.747400,366194,64525,194624,625343
2019-02-05,FINRA / NYSE TRF (DN),228061184,82359081,249316524,559736789,7231694579.300498,3292919404.593401,10261741723.146594,20786355707.040493,562529,182977,601845,1347351
2019-02-05,FINRA / Nasdaq TRF Carteret (DQ),1112198781,435570150,736578142,2284347073,41995489604.213399,27637504773.050800,35451984280.306995,105084978657.571194,3776821,847265,2370975,6995061
2019-02-05,EDGA Equities (J),56440780,26833578,28899208,112173566,2253972595.211000,1448545294.941200,1713182266.908900,5415700157.061100,540353,119284,286009,945646
2019-02-05,EDGX Equities (K),147964376,62604987,117342033,327911396,5599845489.479299,3713997494.092200,6055882793.153303,15369725776.724802,1034927,247137,733980,2016044
2019-02-05,NYSE Chicago (M),7517859,15145932,7562429,30226220,426004208.460000,1365175206.090800,666253903.454300,2457433318.005100,3049,4550,4575,12174
2019-02-05,NYSE (N),841737694,38225602,39263023,919226319,34368468397.643699,2622351078.499300,1957698511.865800,38948517988.008799,2417598,108727,217560,2743885
2019-02-05,NYSE Arca (P),175978129,252613276,178596780,607188185,7154351267.579503,15003830251.130898,9197143470.309000,31355324989.019401,1263026,624543,1224796,3112365
2019-02-05,NASDAQ (Q),427836327,149813434,590362172,1168011933,19835421701.922693,10044913133.094200,34100477614.922488,63980812449.939381,3672828,607611,3589210,7869649
2019-02-05,IEX (V),109015224,20528436,61445804,190989464,4710603715.366099,1276463923.671300,3337220882.715201,9324288521.752600,772919,88976,433175,1295070
2019-02-05,NASDAQ PSX (X),14710832,15469828,13071580,43252240,511801606.077300,1378425243.225300,847279857.910700,2737506707.213300,114301,63260,93787,271348
2019-02-05,BYX Equities (Y),149156022,65036088,72805994,286998104,4487409672.699100,3195996014.154001,3012203804.051400,10695609490.904501,1246649,304146,668391,2219186
2019-02-05,BZX Equities (Z),188743163,85389395,118373045,392505603,7740287267.998802,5708014387.705801,6462840486.532401,19911142142.237004,1662225,355033,1045416,3062674
2019-02-04,NYSE American (A),5505076,9937533,2361465,17804074,201489620.169700,151698710.319600,132863784.021800,486052114.511100,54177,35134,24917,114228
2019-02-04,NASDAQ BX (B),83956750,20253284,42814150,147024184,3728965882.799300,1130026068.753900,2327043967.788100,7186035919.341300,858590,113551,462392,1434533
2019-02-04,NYSE National (C),41471414,14723302,17968573,74163289,1188116699.990900,552444880.643500,721961150.753400,2462522731.387800,347936,59099,177231,584266
2019-02-04,FINRA / NYSE TRF (DN),231950750,74150682,240300594,546402026,6458926788.271400,2883006610.058900,10089249803.361106,19431183201.691406,615499,189988,671395,1476882
2019-02-04,FINRA / Nasdaq TRF Carteret (DQ),1020238441,437227517,697441333,2154907291,38713861829.523707,24438820274.318400,35785426120.991312,98938108224.833419,3547215,879255,2181651,6608121
2019-02-04,EDGA Equities (J),55625356,24672576,26754237,107052169,2111032627.421700,1370931145.453300,1594766359.660200,5076730132.535200,530801,124104,271746,926651
2019-02-04,EDGX Equities (K),138870174,58685744,108301582,305857500,5425675534.676902,3404573294.511697,5852153361.222601,14682402190.411200,1008094,240253,710267,1958614
2019-02-04,NYSE Chicago (M),12688509,13009083,5209891,30907483,608019860.508400,1039032890.130000,649961878.201700,2297014628.840100,2800,3532,4428,10760
2019-02-04,NYSE (N),792143422,35665953,35639354,863448729,32114313022.376504,2288653688.173799,1775545818.294600,36178512528.844903,2247552,109950,204513,2562015
2019-02-04,NYSE Arca (P),161065061,227670637,155978624,544714322,6668748353.233902,12974550048.749601,8458977910.415205,28102276312.398708,1188091,580870,1114483,2883444
2019-02-04,NASDAQ (Q),398839092,131393832,538037433,1068270357,18180435277.252097,8602870313.413701,31277175336.456090,58060480927.121888,3371087,572622,3307293,7251002
2019-02-04,IEX (V),97516583,18507223,53439937,169463743,4236117953.051700,1073072318.629900,2927856683.375200,8237046955.056800,701227,91511,382579,1175317
2019-02-04,NASDAQ PSX (X),14896947,14405775,12042607,41345329,499107619.042500,1223498400.625600,854199468.432800,2576805488.100900,110999,62659,85070,258728
2019-02-04,BYX Equities (Y),141232547,54280977,63454259,258967783,4198157405.638100,2612572204.068000,2716030032.028700,9526759641.734800,1191055,282384,602173,2075612
2019-02-04,BZX Equities (Z),173459240,73890727,106290306,353640273,7084503684.294401,4841792620.040800,5937908754.635003,17864205058.970204,1511042,337560,949611,2798213
2019-02-01,NYSE American (A),6964388,10689779,3035614,20689781,286790573.751600,200415641.062600,192445926.316600,679652141.130800,68729,40245,32336,141310
2019-02-01,NASDAQ BX (B),93048195,27932146,48854142,169834483,4164148973.574200,1593323783.517200,2853354131.890400,8610826888.981800,950149,145808,515898,1611855
2019-02-01,NYSE National (C),47870949,17273374,20381641,85525964,1382407110.594800,675332528.529600,877234408.452100,2934974047.576500,406561,75094,206924,688579
2019-02-01,FINRA / NYSE TRF (DN),245029517,94359266,239655581,579044364,7012850310.150199,3921359957.812899,10823190937.900298,21757401205.863396,603055,202961,635303,1441319
2019-02-01,FINRA / Nasdaq TRF Carteret (DQ),1091372130,495850130,729122724,2316344984,42086255740.875293,29381326454.797293,36749081544.642296,108216663740.314882,3762434,878998,2315558,6956990
2019-02-01,EDGA Equities (J),61748957,30801671,32577117,125127745,2505877141.213300,1690221682.064600,2076013150.633200,6272111973.911100,587067,151289,321606,1059962
2019-02-01,EDGX Equities (K),159830726,75350252,123739959,358920937,6206556463.269399,4522664120.092002,7139132813.079899,17868353396.441300,1167369,313342,810246,2290957
2019-02-01,NYSE Chicago (M),14441987,11840922,10164042,36446951,645981576.741900,1254132916.685000,783713061.662900,2683827555.089800,3991,5827,5346,15164
2019-02-01,NYSE (N),885330428,43271788,44306009,972908225,37033576861.038998,3132632068.442600,2250798369.853000,42417007299.334598,2720085,137026,251090,3108201
2019-02-01,NYSE Arca (P),193504947,270652799,177354740,641512486,8139759676.021601,16061401488.796405,10148384783.455403,34349545948.273409,1438068,771232,1265711,3475011
2019-02-01,NASDAQ (Q),467250351,173575500,690056119,1330881970,22263671552.208796,11615329757.584899,38467521627.696607,72346522937.490302,4121964,755678,3899083,8776725
2019-02-01,IEX (V),120810901,21101424,61848001,203760326,5376272944.962401,1224593561.939300,3668686756.005199,10269553262.906900,835684,102554,447320,1385558
2019-02-01,NASDAQ PSX (X),15339794,18163695,14415293,47918782,591823265.536600,1620552026.036700,1065929372.029500,3278304663.602800,122732,77224,102575,302531
2019-02-01,BYX Equities (Y),170969185,71101238,76390567,318460990,5041419480.817100,3467045103.323801,3408662356.298599,11917126940.439500,1387153,355415,706324,2448892
2019-02-01,BZX Equities (Z),208979634,100803073,126900945,436683652,8844870453.357201,6705138249.808400,7747061759.721800,23297070462.887401,1853563,457658,1141189,3452410
2019-01-31,NYSE American (A),8407305,13263030,3081824,24752159,331480354.028100,222031868.991100,188695698.039000,742207921.058200,78443,43265,31564,153272
2019-01-31,NASDAQ BX (B),113587391,35882297,60204630,209674318,5213844734.660601,2057681427.125000,3504721858.947400,10776248020.733001,1117840,180600,608473,1906913
2019-01-31,NYSE National (C),55986821,21024876,23657519,100669216,1624372495.887100,868948296.658800,1017295518.393900,3510616310.939800,452607,88971,228440,770018
2019-01-31,FINRA / NYSE TRF (DN),274163024,103387472,345230149,722780645,7980305551.904698,3790400766.339799,13297309129.931298,25068015448.175795,632256,217049,738442,1587747
2019-01-31,FINRA / Nasdaq TRF Carteret (DQ),1426320239,583276255,888165262,2897761756,53997504675.394704,35685321853.070908,45654186422.662803,135337012951.128415,4339712,1056010,2720606,8116328
2019-01-31,EDGA Equities (J),74332748,40155597,39373920,153862265,3095657344.789000,2161139646.276000,2391034105.785201,7647831096.850201,687631,178858,360667,1227156
2019-01-31,EDGX Equities (K),182395120,90826199,150360621,423581940,7339033519.799902,5372499545.433799,8668283769.675707,21379816834.909408,1302173,340809,933861,2576843
2019-01-31,NYSE Chicago (M),11582881,16350160,8569722,36502763,743339696.260300,1429445433.980000,875383465.103100,3048168595.343400,3698,8017,5558,17273
2019-01-31,NYSE (N),1395451076,56631813,49241863,1501324752,58673032978.842904,3847391968.155300,2568334909.732299,65088759856.730503,3103786,158888,273251,3535925
2019-01-31,NYSE Arca (P),245699206,342268006,211036183,799003395,9891463941.658902,19911325675.301701,13201468614.519692,43004258231.480295,1655395,901833,1490727,4047955
2019-01-31,NASDAQ (Q),551191802,210617003,829551362,1591360167,25481072785.081495,14881544898.789303,49617756397.473682,89980374081.344480,4563796,883109,4480069,9926974
2019-01-31,IEX (V),144202727,31290015,74773250,250265992,6463558039.878300,1815993581.875300,4673718098.836299,12953269720.589899,953887,127809,528558,1610254
2019-01-31,NASDAQ PSX (X),18821010,23542755,16638394,59002159,731845824.345700,1980914434.184001,1179509521.444000,3892269779.973701,151562,94169,122569,368300
2019-01-31,BYX Equities (Y),211070498,100147423,95404057,406621978,6232190540.823600,4856565264.182999,3853753474.408901,14942509279.415500,1618802,451922,796067,2866791
2019-01-31,BZX Equities (Z),240595797,119852075,152208730,512656602,10071170636.732400,7925485004.865998,8528933732.956799,26525589374.555197,2037865,501956,1270362,3810183
2019-01-30,NYSE American (A),7050715,13047692,3111875,23210282,293718832.800100,188682633.827500,166686176.309800,649087642.937400,67368,42139,30645,140152
2019-01-30,NASDAQ BX (B),99383393,31500777,54156545,185040715,4368180363.370700,1721199424.912100,2765087239.419300,8854467027.702100,980425,162190,529628,1672243
2019-01-30,NYSE National (C),49309674,19465647,21147857,89923178,1425140763.959800,791263495.722200,916052399.815400,3132456659.497400,413138,82735,208255,704128
2019-01-30,FINRA / NYSE TRF (DN),237986435,95220782,286043524,619250741,8181546362.269199,3725439438.839201,11449031291.564601,23356017092.673001,577497,196277,651633,1425407
2019-01-30,FINRA / Nasdaq TRF Carteret (DQ),1118150258,476277860,774995834,2369423952,43546334830.630596,27114439638.405896,35451513927.579685,106112288396.616177,3891690,899794,2428636,7220120
2019-01-30,EDGA Equities (J),62117817,34493939,33170020,129781776,2511575164.805200,1891483222.148300,1918960625.653400,6322019012.606900,582267,162883,309681,1054831
2019-01-30,EDGX Equities (K),165131883,88914544,145242882,399289309,6947930792.651402,5431475160.763702,7526853420.991400,19906259374.406504,1183429,358300,865192,2406921
2019-01-30,NYSE Chicago (M),7212444,16788742,11221491,35222677,458222409.795200,1315779372.935000,964968226.423400,2738970009.153600,3670,6116,4503,14289
2019-01-30,NYSE (N),842807153,50655865,50322754,943785772,33453264459.128294,3601828656.980800,2539399668.828100,39594492784.937194,2859745,146859,260002,3266606
2019-01-30,NYSE Arca (P),222784793,317957885,213858007,754600685,9539549592.306302,18273387103.867900,11865011105.709010,39677947801.883212,1586697,889556,1433291,3909544
2019-01-30,NASDAQ (Q),525018914,218347773,663639698,1407006385,24666365799.742200,14665170929.320300,37447432985.984213,76778969715.046713,4442627,916554,4218357,9577538
2019-01-30,IEX (V),122316805,23479147,65557400,211353352,5548179687.942600,1483370449.897400,3520770383.480301,10552320521.320301,843713,111360,458487,1413560
2019-01-30,NASDAQ PSX (X),18525819,26420771,16437344,61383934,690161706.074500,2230114894.942900,1183259389.485000,4103535990.502400,139873,105370,118561,363804
2019-01-30,BYX Equities (Y),181862541,82061917,87130689,351055147,5229158948.482799,3960664924.938400,3474662029.522700,12664485902.943899,1455494,398313,746165,2599972
2019-01-30,BZX Equities (Z),223617289,128617133,143374900,495609322,9628601157.049399,8324658041.290303,8136543535.765400,26089802734.105102,1957297,546491,1215600,3719388
2019-01-29,NYSE American (A),5574920,14609323,2147194,22331437,210654295.843000,150379712.589100,116256832.980100,477290841.412200,53291,43665,22359,119315
2019-01-29,NASDAQ BX (B),88638927,24718777,40728371,154086075,3727696824.676300,1211993346.759300,1988213096.124000,6927903267.559600,875408,125713,432915,1434036
2019-01-29,NYSE National (C),41840303,14684117,17186134,73710554,1104769666.968600,530237068.376800,664657284.738400,2299664020.083800,344852,60306,171133,576291
2019-01-29,FINRA / NYSE TRF (DN),220029667,84880852,239776973,544687492,6586822187.745201,3016103784.491299,8494831557.223503,18097757529.460003,531476,201048,549795,1282319
2019-01-29,FINRA / Nasdaq TRF Carteret (DQ),1067195009,443882151,671122934,2182200094,39094134821.164999,24868659721.703005,29320666130.089380,93283460672.957384,3603817,829293,2055863,6488973
2019-01-29,EDGA Equities (J),58166019,27440902,27738601,113345522,2225560239.263200,1344753218.179200,1404977082.397800,4975290539.840200,534526,129460,267647,931633
2019-01-29,EDGX Equities (K),143566422,70228184,123603102,337397708,5628957017.948001,3538501789.593398,5259255614.224701,14426714421.766100,1066775,280808,696916,2044499
2019-01-29,NYSE Chicago (M),8575931,11810355,6820723,27207009,459410504.404600,1179072754.670000,552143414.813400,2190626673.888000,3232,4203,3889,11324
2019-01-29,NYSE (N),769395216,33546616,35256882,838198714,29069321252.685300,2248814454.022300,1647772581.896300,32965908288.603900,2425327,113545,194829,2733701
2019-01-29,NYSE Arca (P),188297154,244607659,162481049,595385862,7434263633.295699,12640814966.094599,8146637828.801101,28221716428.191399,1339215,690135,1129132,3158482
2019-01-29,NASDAQ (Q),442919289,153450094,538375910,1134745293,19621522089.165405,9085282779.164903,27452844519.503389,56159649387.833697,3712021,667052,3376883,7755956
2019-01-29,IEX (V),115114177,19688911,53134550,187937638,4539414601.161500,1061041091.104300,2751913789.304700,8352369481.570500,788624,94114,392021,1274759
2019-01-29,NASDAQ PSX (X),15567298,14919195,12219065,42705558,541221927.775000,1198178078.405199,754466368.944200,2493866375.124399,121876,66792,86671,275339
2019-01-29,BYX Equities (Y),161509563,64890747,71348450,297748760,4422712034.263901,2779941334.997701,2457418958.082000,9660072327.343602,1262649,301808,595087,2159544
2019-01-29,BZX Equities (Z),191687266,84063101,104433847,380184214,7611159300.036701,5147542358.594102,5399710033.897298,18158411692.528101,1688583,383103,945579,3017265
2019-01-28,NYSE American (A),6267105,10965486,2285752,19518343,222529685.238200,174976786.059500,125903605.515200,523410076.812900,54962,33960,24656,113578
2019-01-28,NASDAQ BX (B),90943533,29934255,49830508,170708296,3689440731.243100,1677076140.804600,2448881864.044501,7815398736.092201,887193,148603,493413,1529209
2019-01-28,NYSE National (C),42978403,17021036,18588364,78587803,1136123511.809200,632884904.837400,717981196.932400,2486989613.579000,351558,66787,185048,603393
2019-01-28,FINRA / NYSE TRF (DN),219946050,81449923,293313476,594709449,6071581055.257703,3264618246.608501,9273662848.323407,18609862150.189611,539639,198103,625401,1363143
2019-01-28,FINRA / Nasdaq TRF Carteret (DQ),1086122533,477882235,777695252,2341700020,38869993856.975496,29422542030.121101,33660640116.290789,101953176003.387386,3740290,933652,2322076,6996018
2019-01-28,EDGA Equities (J),57878157,30314800,28696456,116889413,2012667039.785700,1553871670.925700,1549229087.476900,5115767798.188300,516750,136455,275912,929117
2019-01-28,EDGX Equities (K),151323684,67333907,142560489,361218080,5726928825.099099,4136733016.436999,5583308010.566698,15446969852.102796,1068095,293301,745115,2106511
2019-01-28,NYSE Chicago (M),10015206,12747821,7656052,30419079,403947265.661400,1157117262.832000,644251101.120000,2205315629.613400,3397,6517,4593,14507
2019-01-28,NYSE (N),820654288,39531994,45353940,905540222,30708916627.987898,2801991650.469401,2142921820.907600,35653830099.364899,2529377,134840,243283,2907500
2019-01-28,NYSE Arca (P),197277578,281105849,185827594,664211021,7396461773.967100,15613907691.086298,8859905022.007107,31870274487.060505,1360924,800845,1230841,3392610
2019-01-28,NASDAQ (Q),456260926,163517006,631287345,1251065277,19099958142.280295,11102542096.714498,32043498971.050405,62245999210.045198,3666524,764171,3687361,8118056
2019-01-28,IEX (V),109977169,26216636,54525922,190719727,4256490257.386200,1451367833.578500,2883310077.263201,8591168168.227901,739280,100441,397307,1237028
2019-01-28,NASDAQ PSX (X),16137306,18659541,14120740,48917587,559566395.130000,1689677812.188500,933910557.137800,3183154764.456300,126890,87235,105013,319138
2019-01-28,BYX Equities (Y),166675199,78132207,80663867,325471273,4457817497.230699,3608962027.848000,2757826370.682000,10824605895.760699,1272378,343124,645344,2260846
2019-01-28,BZX Equities (Z),198369771,90558326,116390435,405318532,7892099823.801700,5862869907.969699,6075698260.760100,19830667992.531499,1705386,426276,1029188,3160850
2019-01-25,NYSE American (A),5983582,10171584,2556864,18712030,224633238.196400,148290099.242100,144773938.727700,517697276.166200,53320,32582,25349,111251
2019-01-25,NASDAQ BX (B),88333230,26247310,48478549,163059089,3664465457.474300,1451827473.483900,2484517617.630700,7600810548.588900,828670,130683,483141,1442494
2019-01-25,NYSE National (C),45376704,19628916,20528250,85533870,1228894222.075900,735784073.158000,823704679.971600,2788382975.205500,363131,73662,198377,635170
2019-01-25,FINRA / NYSE TRF (DN),236267659,80250680,248655420,565173759,6698055592.431901,3330474227.058600,10003217186.795400,20031747006.285901,546593,184041,591816,1322450
2019-01-25,FINRA / Nasdaq TRF Carteret (DQ),1171273051,427769304,770997012,2370039367,41286983232.182500,25432600505.161692,35783809513.483998,102503393250.828190,3766756,842843,2427059,7036658
2019-01-25,EDGA Equities (J),60843839,29354265,30902867,121100971,2299738852.562700,1533446732.302000,1706852670.994400,5540038255.859100,547359,129120,291464,967943
2019-01-25,EDGX Equities (K),154522332,72890251,131913971,359326554,5807515442.679000,4868815484.144099,6167202721.000500,16843533647.823599,1048476,306560,784345,2139381
2019-01-25,NYSE Chicago (M),9406877,17753260,13729626,40889763,439894926.423300,1325559254.812800,924383882.364700,2689838063.600800,2867,5535,5282,13684
2019-01-25,NYSE (N),863605279,40890457,46253732,950749468,33775987632.878998,2807497819.981900,2261645485.015000,38845130937.875898,2654332,123346,244935,3022613
2019-01-25,NYSE Arca (P),206105446,282272528,193629927,682007901,8067811419.226500,16014863008.924301,9725512733.939900,33808187162.090701,1430362,774456,1328360,3533178
2019-01-25,NASDAQ (Q),459850974,178566054,639831358,1278248386,19429436343.603001,12570358822.423397,35453003902.802815,67452799068.829213,3681311,746401,3941916,8369628
2019-01-25,IEX (V),118920044,23578541,66810928,209309513,4690930028.717800,1414548830.890100,3387353604.705701,9492832464.313601,769436,105948,445518,1320902
2019-01-25,NASDAQ PSX (X),17138573,21577530,14951442,53667545,601588339.446500,2033462732.746601,1076265627.298600,3711316699.491701,124708,87813,109657,322178
2019-01-25,BYX Equities (Y),172711678,78251948,81673707,332637333,4790667041.074600,3644958288.274000,3179952045.713699,11615577375.062299,1316533,347350,709611,2373494
2019-01-25,BZX Equities (Z),210668300,98743266,135640201,445051767,8431555107.354799,6869142881.555798,7464962059.540303,22765660048.450900,1757989,447605,1172995,3378589
2019-01-24,NYSE American (A),4992759,8394952,2274211,15661922,191104001.273100,126939427.891200,104568361.267400,422611790.431700,47221,30011,22319,99551
2019-01-24,NASDAQ BX (B),84636650,22795459,47444141,154876250,3646523304.409800,1220005857.371400,2414251638.553400,7280780800.334600,816749,118981,476631,1412361
2019-01-24,NYSE National (C),40030643,13186156,17955274,71172073,1109145266.557200,497445911.718000,711484504.395300,2318075682.670500,324971,59414,171893,556278
2019-01-24,FINRA / NYSE TRF (DN),198365649,74250036,246605779,519221464,5755882255.129497,3110443686.992700,9078139250.784098,17944465192.906295,477334,163137,546823,1187294
2019-01-24,FINRA / Nasdaq TRF Carteret (DQ),1038767223,395456205,768411474,2202634902,38605473925.314794,20888087573.974710,35041429541.744508,94534991041.034012,3565136,753033,2346530,6664699
2019-01-24,EDGA Equities (J),53004291,24842197,31981217,109827705,1988842043.623600,1289743017.674400,1576966304.508400,4855551365.806400,491983,119207,289162,900352
2019-01-24,EDGX Equities (K),137073683,58788516,134395851,330258050,5344356372.528300,3675691900.463402,5652811364.806796,14672859637.798498,979374,256154,745500,1981028
2019-01-24,NYSE Chicago (M),10911924,15879884,10833254,37625062,650444405.220200,1041614147.629900,810668700.832400,2502727253.682500,2953,5216,5603,13772
2019-01-24,NYSE (N),789758813,33814099,42250850,865823762,30986854450.224402,2227529974.159501,1981905642.654400,35196290067.038303,2458206,109919,230273,2798398
2019-01-24,NYSE Arca (P),183453067,243190138,211334643,637977848,7359063355.444600,13906898010.491795,9339776178.641097,30605737544.577492,1373449,732901,1296592,3402942
2019-01-24,NASDAQ (Q),430746323,147986777,618336005,1197069105,18943371145.932295,9701400810.143995,32649064241.323114,61293836197.399404,3547639,659596,3773326,7980561
2019-01-24,IEX (V),106054901,17582430,58292817,181930148,4315515751.046100,1019694842.424000,3053549506.807299,8388760100.277399,714797,84784,414622,1214203
2019-01-24,NASDAQ PSX (X),13690264,16671829,13883150,44245243,519391940.795500,1423646132.837900,818558464.571500,2761596538.204900,112585,78586,106168,297339
2019-01-24,BYX Equities (Y),164012754,64435552,83222488,311670794,4561197143.973800,2951155997.092400,2934901356.547900,10447254497.614100,1275403,299385,690030,2264818
2019-01-24,BZX Equities (Z),193734642,84368420,131896343,409999405,8014890803.424199,5571987329.199202,6656609156.667301,20243487289.290702,1703830,403510,1129881,3237221
2019-01-23,NYSE American (A),5196736,10092720,2116151,17405607,217201790.779300,155899709.549600,114687535.929000,487789036.257900,51248,33047,21853,106148
2019-01-23,NASDAQ BX (B),82872345,24330349,45605156,152807850,3645233035.242600,1388996383.591300,2267164878.222200,7301394297.056100,824004,129882,473950,1427836
2019-01-23,NYSE National (C),39479787,15238727,17879656,72598170,1154318297.148800,558072326.088200,771315003.939300,2483705627.176300,337745,61592,175813,575150
2019-01-23,FINRA / NYSE TRF (DN),199928149,87492915,228973894,516394958,6250911769.149199,3966640317.907301,8828785148.151308,19046337235.207808,473344,197152,538571,1209067
2019-01-23,FINRA / Nasdaq TRF Carteret (DQ),978968693,401597480,690214710,2070780883,38343409578.121196,23590947471.602105,31067589473.539594,93001946523.262895,3507473,855764,2201146,6564383
2019-01-23,EDGA Equities (J),56569197,27518511,30329346,114417054,2151180674.319700,1473282151.142600,1625674090.875800,5250136916.338100,534619,127558,284997,947174
2019-01-23,EDGX Equities (K),134414760,68327493,151251511,353993764,5371437023.410500,4522276575.168398,5369847215.732298,15263560814.311196,1013938,311314,737894,2063146
2019-01-23,NYSE Chicago (M),16183605,14795192,8795288,39774085,757239107.695800,1243496902.880000,908343064.158300,2909079074.734100,3142,6843,6205,16190
2019-01-23,NYSE (N),772844460,38278660,41454562,852577682,31459802755.569100,2715770265.418398,2071749391.614800,36247322412.602298,2523339,129038,221136,2873513
2019-01-23,NYSE Arca (P),176200759,252546365,195185242,623932366,7531575467.508398,14830194288.493094,8585758511.962401,30947528267.963893,1396451,806876,1272804,3476131
2019-01-23,NASDAQ (Q),427056161,176978276,603093580,1207128017,19295661607.127098,12099079543.849190,31202560078.189217,62597301229.165505,3700302,835812,3762947,8299061
2019-01-23,IEX (V),100036709,19076856,55713050,174826615,4320140040.884600,1171993603.022900,2895936501.410500,8388070145.318000,729918,94803,409790,1234511
2019-01-23,NASDAQ PSX (X),14693785,17820948,14649135,47163868,569875759.881000,1588900228.761701,950223851.387600,3108999840.030301,119092,78705,106822,304619
2019-01-23,BYX Equities (Y),160761960,66017309,80537318,307316587,4672654575.124300,3157657503.180301,2838809172.788100,10669121251.092701,1321340,314042,676943,2312325
2019-01-23,BZX Equities (Z),193569758,95819141,122294327,411683226,8090438751.265400,6580416435.195400,6507615454.909501,21178470641.370301,1736137,484845,1080029,3301011
2019-01-22,NYSE American (A),5714762,13297340,2247790,21259892,236078525.844600,177793776.843000,128758390.812100,542630693.499700,55775,38114,23142,117031
2019-01-22,NASDAQ BX (B),91801901,37662886,48430612,177895399,3876613827.576100,2063443360.213400,2567887643.842300,8507944831.631800,898237,183285,508937,1590459
2019-01-22,NYSE National (C),44743575,23352549,20130298,88226422,1249184612.100500,910274909.620600,830542349.594500,2990001871.315600,377051,88615,199121,664787
2019-01-22,FINRA / NYSE TRF (DN),228964850,94264667,219715305,542944822,6642528790.852699,4093036099.457501,9840474462.444800,20576039352.755000,553544,219512,585339,1358395
2019-01-22,FINRA / Nasdaq TRF Carteret (DQ),1136523826,585841663,731459236,2453824725,43933643906.402398,35225916787.516002,38555335190.567401,117714895884.485801,3905363,1097484,2380723,7383570
2019-01-22,EDGA Equities (J),60630978,39151604,32343430,132126012,2331078632.763500,2117620840.597700,1953370627.928600,6402070101.289800,561848,181691,311833,1055372
2019-01-22,EDGX Equities (K),155846714,96423711,121288316,373558741,6031530732.689399,6547866919.183301,6248873720.207799,18828271372.080499,1133929,421104,825439,2380472
2019-01-22,NYSE Chicago (M),12700003,11801600,14266814,38768417,461178533.056700,1401937253.235000,991955028.404000,2855070814.695700,4130,9544,6020,19694
2019-01-22,NYSE (N),972906607,50352654,45069855,1068329116,40078004948.905305,3586293338.469100,2206901952.436900,45871200239.811305,2892699,163408,247968,3304075
2019-01-22,NYSE Arca (P),202057743,355926269,188812887,746796899,8121989544.071900,20906308216.833811,9584151302.159299,38612449063.065010,1529221,1018279,1350268,3897768
2019-01-22,NASDAQ (Q),482693643,223058461,687787405,1393539509,21115146395.453295,15471297909.045404,39775543950.204517,76361988254.703216,4185078,978710,4256191,9419979
2019-01-22,IEX (V),115469801,25729706,61704914,202904421,4657607739.506700,1480185294.027100,3323321150.915300,9461114184.449100,809775,121051,441653,1372479
2019-01-22,NASDAQ PSX (X),17417605,26261414,15534248,59213267,667256120.745700,2129868466.312500,1143686791.026500,3940811378.084700,138140,109099,116365,363604
2019-01-22,BYX Equities (Y),182675111,96317953,79393004,358386068,5083869868.902500,4528237466.385200,3273554241.323799,12885661576.611499,1438898,430172,729649,2598719
2019-01-22,BZX Equities (Z),213811060,130904502,129479490,474195052,8738269058.116100,9284056328.072498,7339603836.069699,25361929222.258297,1900458,619613,1174997,3695068
2019-01-18,NYSE American (A),6315126,12771656,2265283,21352065,243043948.378800,140725566.293900,178147549.297000,561917063.969700,59298,35789,23997,119084
2019-01-18,NASDAQ BX (B),88624410,31875717,47696336,168196463,3896124891.116300,1815589847.393700,2828630161.678100,8540344900.188100,869634,156653,505207,1531494
2019-01-18,NYSE National (C),43505060,17911144,18753883,80170087,1238882088.980400,716765899.828400,848773587.864700,2804421576.673500,357807,67930,185811,611548
2019-01-18,FINRA / NYSE TRF (DN),226907170,95799372,234915573,557622115,6649295059.872501,3931993167.774402,11168383970.726802,21749672198.373705,557030,217338,619061,1393429
2019-01-18,FINRA / Nasdaq TRF Carteret (DQ),1186330913,539856779,765357934,2491545626,45080929112.265503,37768929109.394893,41128368682.843909,123978226904.504305,3926349,990802,2464786,7381937
2019-01-18,EDGA Equities (J),65293103,33609743,33658598,132561444,2508517411.397000,1956053752.365100,2073536094.528400,6538107258.290500,590489,154288,326305,1071082
2019-01-18,EDGX Equities (K),158583225,89456248,126163395,374202868,6226536820.057700,5706595013.250404,6660068021.773099,18593199855.081203,1133191,365207,815109,2313507
2019-01-18,NYSE Chicago (M),13345695,17989133,14791970,46126798,594881705.720900,1476032475.480000,2048862565.356701,4119776746.557601,3710,7381,6113,17204
2019-01-18,NYSE (N),1010170853,44960503,43011447,1098142803,43869918135.710908,3092942226.048300,2371604763.141700,49334465124.900908,2788165,140488,242974,3171627
2019-01-18,NYSE Arca (P),200672658,342793474,195646564,739112696,8243098386.047600,20465604294.739803,10868117528.112499,39576820208.899902,1510154,920699,1353909,3784762
2019-01-18,NASDAQ (Q),462547849,202565813,684900778,1350014440,20444762716.016897,13786141374.588703,42994527033.064228,77225431123.669828,3933217,851968,4068842,8854027
2019-01-18,IEX (V),121830776,26284649,61605371,209720796,5056472789.024300,1548172077.285100,3616422694.102799,10221067560.412199,837429,118058,448843,1404330
2019-01-18,NASDAQ PSX (X),18112600,22419422,16532651,57064673,729195807.131500,1855127795.004100,1275852410.916500,3860176013.052100,145846,89475,125818,361139
2019-01-18,BYX Equities (Y),184087134,86580897,78981569,349649600,5330100121.776399,4043305853.691602,3424308788.243701,12797714763.711702,1469751,368321,734786,2572858
2019-01-18,BZX Equities (Z),222683768,116135325,135643737,474462830,9235435914.194901,8041373390.839301,7968501095.069803,25245310400.104005,1960138,540386,1224227,3724751
2019-01-17,NYSE American (A),5315206,9952165,1715523,16982894,211138117.521700,119279791.075100,105207753.827400,435625662.424200,49616,31462,18380,99458
2019-01-17,NASDAQ BX (B),86366177,25051831,43616436,155034444,3642791914.727500,1370086810.850900,2251061985.413900,7263940710.992300,842276,128066,466365,1436707
2019-01-17,NYSE National (C),39116914,15474606,16178266,70769786,1110059669.985800,610983418.434000,683600360.982300,2404643449.402100,323172,63535,159949,546656
2019-01-17,FINRA / NYSE TRF (DN),221700777,82759590,223913683,528374050,6603838327.657300,3927884356.029802,8437082279.201906,18968804962.889008,519116,191055,529002,1239173
2019-01-17,FINRA / Nasdaq TRF Carteret (DQ),1142863454,416717040,671253756,2230834250,42510015348.876092,26699076514.588786,32102690157.042903,101311782020.507781,3681052,814874,2149645,6645571
2019-01-17,EDGA Equities (J),59376558,26414413,27269318,113060289,2175833676.592800,1428548861.394801,1498801405.688300,5103183943.675901,531777,123262,258857,913896
2019-01-17,EDGX Equities (K),148598067,72272399,116797718,337668184,5472034068.721000,4501109165.415301,5420726149.122298,15393869383.258599,1048106,303517,724246,2075869
2019-01-17,NYSE Chicago (M),9103230,16447900,8875422,34426552,430017668.538600,1776308924.180000,821980621.278800,3028307213.997400,3780,6197,4413,14390
2019-01-17,NYSE (N),914044457,38690091,38158905,990893453,34015025016.676297,2713473508.544400,1901037736.569100,38629536261.789797,2622277,120843,216677,2959797
2019-01-17,NYSE Arca (P),198588525,276970874,178552563,654111962,7546802562.082997,15699833657.141106,8717578511.289898,31964214730.514001,1436641,794799,1220818,3452258
2019-01-17,NASDAQ (Q),449502740,174182423,562873650,1186558813,18998541867.770704,11512947716.032898,29708429328.721193,60219918912.524795,3768734,734849,3609683,8113266
2019-01-17,IEX (V),121996181,20775088,57532193,200303462,4827795908.747000,1259871183.328700,3041629851.931499,9129296944.007199,814280,94551,424175,1333006
2019-01-17,NASDAQ PSX (X),17172241,19269072,13121656,49562969,649417576.562700,1652546275.720099,964411390.739500,3266375243.022299,136080,77319,101834,315233
2019-01-17,BYX Equities (Y),175616779,75314464,72585603,323516846,4937571785.836301,3400737334.119400,2869903309.875800,11208212429.831501,1392357,341903,682667,2416927
2019-01-17,BZX Equities (Z),213056542,102590892,116837856,432485290,8502459146.178799,6759304226.994301,6688157049.496498,21949920422.669598,1839667,476008,1079307,3394982
2019-01-16,NYSE American (A),6662437,9606888,2142943,18412268,259674383.615000,121034553.471900,134119272.706500,514828209.793400,61586,32642,22917,117145
2019-01-16,NASDAQ BX (B),90172434,26286392,43679087,160137913,3757248573.894800,1472188981.055800,2334097594.438600,7563535149.389200,873313,132082,467126,1472521
2019-01-16,NYSE National (C),36196569,13719471,14254233,64170273,986465810.830800,561926911.830500,581551621.689000,2129944344.350300,300395,56021,142242,498658
2019-01-16,FINRA / NYSE TRF (DN),237963237,81005844,209284401,528253482,6476016899.067001,3326867849.251002,8711120109.992802,18514004858.310805,534989,196471,539976,1271436
2019-01-16,FINRA / Nasdaq TRF Carteret (DQ),1184766565,591266364,722769601,2498802530,40488332948.144781,37307571036.038107,38328851805.686285,116124755789.869173,3801647,880920,2181423,6863990
2019-01-16,EDGA Equities (J),64447340,28435829,29407674,122290843,2389422104.142900,1521905661.822700,1737386447.744000,5648714213.709600,580554,123006,285971,989531
2019-01-16,EDGX Equities (K),162180269,68652786,110086855,340919910,6116963483.974499,4160776830.497501,5475964290.817499,15753704605.289499,1127721,277203,731880,2136804
2019-01-16,NYSE Chicago (M),13051084,25842021,8597450,47490555,514822757.853000,1633837466.355400,935459363.765700,3084119587.974100,3593,6058,4278,13929
2019-01-16,NYSE (N),863043680,35567550,35452907,934064137,33895897668.875897,2331432965.606700,1892680518.560500,38120011153.043097,2524469,108820,207218,2840507
2019-01-16,NYSE Arca (P),215474356,274822127,178722007,669018490,8116745756.972500,14990996962.072894,8593266109.566700,31701008828.612094,1494050,722482,1207227,3423759
2019-01-16,NASDAQ (Q),461357842,165223363,560360147,1186941352,19544959163.099000,10622965088.754395,31530217334.058188,61698141585.911583,3809240,693571,3592268,8095079
2019-01-16,IEX (V),126487488,27909028,54801228,209197744,4861331887.984099,1605061721.893200,3114100672.610300,9580494282.487599,835317,108457,413091,1356865
2019-01-16,NASDAQ PSX (X),17979835,16226844,12664635,46871314,639495884.122400,1285672895.102100,978095976.706300,2903264755.930800,139532,66311,98709,304552
2019-01-16,BYX Equities (Y),184668766,74298214,70707685,329674665,5157615014.466500,3426934463.120401,2854029903.138200,11438579380.725101,1433743,322495,658982,2415220
2019-01-16,BZX Equities (Z),217730524,93050445,110806668,421587637,8611258463.405099,6082730998.844301,6344500247.164800,21038489709.414200,1844103,428254,1040627,3312984
2019-01-15,NYSE American (A),6176973,10965612,1793625,18936210,235388971.019500,137676457.211300,101318738.525000,474384166.755800,55665,41826,19388,116879
2019-01-15,NASDAQ BX (B),81884314,27284855,42349949,151519118,3313118003.858100,1465017016.537900,2305809460.401100,7083944480.797100,798809,136230,444034,1379073
2019-01-15,NYSE National (C),33579071,13203956,13159275,59942302,893102188.549800,465060262.938100,561163209.604700,1919325661.092600,284412,55232,134614,474258
2019-01-15,FINRA / NYSE TRF (DN),228609721,90522855,225643539,544776115,6282095405.124499,4004936097.205402,9397657143.829302,19684688646.159203,555685,206802,585565,1348052
2019-01-15,FINRA / Nasdaq TRF Carteret (DQ),1030793446,445215690,631611979,2107621115,35568844456.300905,26375379870.524301,31782164743.326306,93726389070.151512,3691471,855554,2184370,6731395
2019-01-15,EDGA Equities (J),56600647,28822920,29787721,115211288,2023129980.928700,1525867441.775900,1758366991.893500,5307364414.598100,510743,127416,265222,903381
2019-01-15,EDGX Equities (K),152638043,75917834,112073521,340629398,5709389908.311299,4636483250.151802,5873874164.750700,16219747323.213801,1072177,310764,735057,2117998
2019-01-15,NYSE Chicago (M),8504655,11465698,10472902,30443255,386258713.000400,1089939469.127000,737206721.316900,2213404903.444300,4253,5888,5989,16130
2019-01-15,NYSE (N),870105362,41593842,37712433,949411637,31533031042.342897,2745684052.742700,1996353497.581700,36275068592.667297,2615112,119766,222393,2957271
2019-01-15,NYSE Arca (P),193525979,284602750,165129177,643257906,7462876034.724101,16016797741.637800,9259979501.073098,32739653277.434999,1415325,808316,1183346,3406987
2019-01-15,NASDAQ (Q),430155829,177755527,548643380,1156554736,18042133641.106902,11339642091.079501,32243403345.814602,61625179078.001005,3658383,757435,3611423,8027241
2019-01-15,IEX (V),115739952,22346170,53424449,191510571,4538139510.568100,1317130551.871100,3005278669.119800,8860548731.559000,798899,109175,406046,1314120
2019-01-15,NASDAQ PSX (X),15243567,19109000,13722490,48075057,545001869.845700,1556128381.752000,1030666875.539200,3131797127.136900,117813,78026,99684,295523
2019-01-15,BYX Equities (Y),174229937,77159175,66993796,318382908,4673787343.618900,3378371594.186699,2815794912.119500,10867953849.925099,1377587,340991,647032,2365610
2019-01-15,BZX Equities (Z),203402413,105751589,113576026,422730028,8177483820.186898,6982470107.260899,6760300572.226501,21920254499.674298,1776645,484477,1047533,3308655
2019-01-14,NYSE American (A),5577687,10415470,1848177,17841334,221753004.471600,113715518.298000,98434561.935600,433903084.705200,51611,33247,18805,103663
2019-01-14,NASDAQ BX (B),86583166,24959829,39866995,151409990,3494396466.064700,1271220978.500700,2039597684.631200,6805215129.196600,818895,120226,421691,1360812
2019-01-14,NYSE National (C),33644870,11340034,13141868,58126772,850437567.062500,383736795.939500,455923494.733500,1690097857.735500,273488,45728,131012,450228
2019-01-14,FINRA / NYSE TRF (DN),210671008,79456521,204736793,494864322,5582923936.024202,2989991228.911100,8218495997.268501,16791411162.203803,518324,194934,517452,1230710
2019-01-14,FINRA / Nasdaq TRF Carteret (DQ),1129984783,437089716,627557097,2194631596,39115717518.446404,27542056163.714288,30961333615.488497,97619107297.649189,3660489,815479,2019268,6495236
2019-01-14,EDGA Equities (J),59575354,25670003,28092416,113337773,2079979795.647500,1270180010.569000,1508958287.485200,4859118093.701700,519739,115615,254308,889662
2019-01-14,EDGX Equities (K),146945409,60744070,102384547,310074026,5186197033.286999,3604577544.023398,5048022759.950801,13838797337.261198,1037526,259093,683260,1979879
2019-01-14,NYSE Chicago (M),11710196,10729552,4752085,27191833,413129973.082400,980746640.320000,463347913.824000,1857224527.226400,3776,5596,4366,13738
2019-01-14,NYSE (N),892243336,30609727,32386000,955239063,34467804858.214699,2029002718.943100,1444306955.937700,37941114533.095499,2486020,100176,189843,2776039
2019-01-14,NYSE Arca (P),189819511,253839418,141041841,584700770,6821759293.450699,13259974143.843498,7595315975.750604,27677049413.044801,1372494,659201,1067386,3099081
2019-01-14,NASDAQ (Q),406850093,149001811,533131723,1088983627,16251577329.592800,9095407866.189500,29715669045.359504,55062654241.141804,3360268,642899,3243037,7246204
2019-01-14,IEX (V),123524223,19410134,51734236,194668593,4521796187.755300,1049479882.445300,2672222336.794799,8243498406.995399,821244,90304,387570,1299118
2019-01-14,NASDAQ PSX (X),15566806,15171688,11088796,41827290,541570720.822000,1161206471.345899,733400895.892200,2436178088.060099,120660,62220,90158,273038
2019-01-14,BYX Equities (Y),174521635,66249404,65198950,305969989,4537806721.017500,2859875667.147600,2456629717.766600,9854312105.931700,1347747,289807,619244,2256798
2019-01-14,BZX Equities (Z),202155419,82610849,103824414,388590682,7669322601.921399,5287318684.147200,5716876834.652999,18673518120.721598,1749264,399251,965925,3114440
2019-01-11,NYSE American (A),5587105,10207508,2234525,18029138,210149692.035000,125997237.097400,119364040.372800,455510969.505200,52404,34353,22071,108828
2019-01-11,NASDAQ BX (B),81526795,24979875,42304849,148811519,3378859907.659900,1397655872.974800,2199737202.795800,6976252983.430500,799119,123100,441971,1364190
2019-01-11,NYSE National (C),32448584,12146448,13692080,58287112,826036595.646000,439473028.439600,503089777.818900,1768599401.904500,271580,50965,137888,460433
2019-01-11,FINRA / NYSE TRF (DN),208146778,79069742,229871847,517088367,5286822224.265700,3151822285.321099,9004520860.595008,17443165370.181807,490067,183836,520615,1194518
2019-01-11,FINRA / Nasdaq TRF Carteret (DQ),1014700330,471172936,660317859,2146191125,33599025125.705690,28472490225.087904,30331084657.307493,92402600008.101087,3596893,851662,2127019,6575574
2019-01-11,EDGA Equities (J),55950772,26260380,27929181,110140333,1991722858.826800,1419020529.531100,1433412970.080600,4844156358.438500,511202,121406,248851,881459
2019-01-11,EDGX Equities (K),144004606,63849139,109578832,317432577,5148955652.579800,3994673107.093000,5392542513.723299,14536171273.396099,1082086,268487,734956,2085529
2019-01-11,NYSE Chicago (M),10068863,11912820,7483084,29464767,424036635.840300,1062809998.445000,485415510.936300,1972262145.221600,3401,6052,5099,14552
2019-01-11,NYSE (N),802636995,34773728,36005789,873416512,29606159712.102592,2239986243.246800,1656145538.129300,33502291493.478692,2480859,111033,204574,2796466
2019-01-11,NYSE Arca (P),186819769,247936702,154142103,588898574,6828108210.716399,13540209762.318503,7772118412.798399,28140436385.833301,1372927,679984,1127066,3179977
2019-01-11,NASDAQ (Q),414632095,153746404,542301375,1110679874,16695255352.495897,9560837967.485202,29023186856.434708,55279280176.415807,3435452,652348,3400709,7488509
2019-01-11,IEX (V),110221088,25526671,57432130,193179889,4115087263.652700,1390880338.046400,2909961236.110701,8415928837.809801,759042,99957,413405,1272404
2019-01-11,NASDAQ PSX (X),15255660,16371264,12426623,44053547,521197984.396100,1204266588.239400,854264655.765200,2579729228.400700,116854,62558,97268,276680
2019-01-11,BYX Equities (Y),166696687,69480100,67196386,303373173,4333241242.666999,3169474725.905999,2596002641.498600,10098718610.071598,1305671,308999,639138,2253808
2019-01-11,BZX Equities (Z),198773039,86532778,111398641,396704458,7537837281.444500,5580500257.716498,6008719127.552701,19127056666.713699,1706997,413499,1007729,3128225
2019-01-10,NYSE American (A),6066625,11072478,2130991,19270094,226398664.517400,150372695.757600,119250270.052000,496021630.327000,56465,38414,21432,116311
2019-01-10,NASDAQ BX (B),84933732,30439221,45030785,160403738,3594073524.289700,1600627569.013800,2375263444.517100,7569964537.820600,848129,141402,468796,1458327
2019-01-10,NYSE National (C),33583128,13528159,14499632,61610919,892268653.387900,483046860.967700,571518701.391200,1946834215.746800,285260,58561,148053,491874
2019-01-10,FINRA / NYSE TRF (DN),229460257,94852881,235380591,559693729,6269734210.508702,4043401344.666603,10185853847.705400,20498989402.880705,533101,205881,535908,1274890
2019-01-10,FINRA / Nasdaq TRF Carteret (DQ),1103569750,565967178,675988089,2345525017,39352720973.046909,31848019206.394088,32252883291.142893,103453623470.583890,3641529,937644,2160431,6739604
2019-01-10,EDGA Equities (J),57009368,30835966,28001665,115846999,2133291687.564300,1606666615.657100,1593263104.827100,5333221408.048500,523381,134959,266283,924623
2019-01-10,EDGX Equities (K),152700664,84194014,115946703,352841381,5712129860.943898,5011880373.046499,5603668291.480600,16327678525.470997,1117228,348662,749650,2215540
2019-01-10,NYSE Chicago (M),8300128,16407497,8352621,33060246,406439413.751800,1463597823.365000,799332381.613400,2669369618.730200,3490,8317,6295,18102
2019-01-10,NYSE (N),896286792,44627485,41296314,982210591,34172632560.311901,2996143702.063601,1946900982.919000,39115677245.294502,2647361,141095,231025,3019481
2019-01-10,NYSE Arca (P),195650996,309844890,168963066,674458952,7565116917.894401,16716208644.767000,8635135579.705702,32916461142.367103,1502509,833331,1208723,3544563
2019-01-10,NASDAQ (Q),443183629,193010097,588031771,1224225497,18083296746.862499,12365283559.325705,32239898400.895690,62688478707.083894,3751490,833550,3616828,8201868
2019-01-10,IEX (V),118854869,26742562,57034148,202631579,4631386355.284400,1474317598.942400,3137273544.411900,9242977498.638700,812948,120526,424671,1358145
2019-01-10,NASDAQ PSX (X),16565215,19519263,14412730,50497208,570886107.227100,1483949714.288701,1033785634.716100,3088621456.231901,126179,75337,102939,304455
2019-01-10,BYX Equities (Y),163319690,77176688,70509426,311005804,4350138891.501100,3507680675.861800,2907981640.298300,10765801207.661200,1317776,347253,667651,2332680
2019-01-10,BZX Equities (Z),211822266,110986425,124539526,447348217,8205631458.001201,7003106741.698200,7132571167.190000,22341309366.889401,1874733,520182,1093371,3488286
2019-01-09,NYSE American (A),6904054,12641156,2558386,22103596,267208659.460400,167828176.521000,146618565.791600,581655401.773000,67364,41377,26314,135055
2019-01-09,NASDAQ BX (B),92592749,32574613,49723704,174891066,3832691089.257300,1747011722.400200,2570132503.329300,8149835314.986800,916219,164404,510521,1591144
2019-01-09,NYSE National (C),39237466,14770123,17001415,71009004,1045629402.032000,540135790.138000,680843567.174400,2266608759.344400,331592,70175,170869,572636
2019-01-09,FINRA / NYSE TRF (DN),256556975,110779431,252958815,620295221,6697916391.194498,4630900050.435702,10535412201.839105,21864228643.469305,566337,226533,591174,1384044
2019-01-09,FINRA / Nasdaq TRF Carteret (DQ),1176348577,536890725,753976038,2467215340,40269677757.206207,30153828192.389297,35313821743.725308,105737327693.320812,4046746,987031,2391193,7424970
2019-01-09,EDGA Equities (J),64856769,32579937,31825829,129262535,2533588848.423000,1716219427.279600,1958157274.310499,6207965550.013099,604737,150710,310056,1065503
2019-01-09,EDGX Equities (K),177676791,91184804,131392593,400254188,6643583371.249002,5167937740.262998,6538077913.030300,18349599024.542300,1311785,373931,882621,2568337
2019-01-09,NYSE Chicago (M),11189569,22853070,9354048,43396687,501034154.526200,1813903071.958399,944704801.234500,3259642027.719099,3825,9706,7656,21187
2019-01-09,NYSE (N),941481729,46391240,46057483,1033930452,34049579570.961294,3000294392.138700,2128589526.055100,39178463489.155094,3002099,153330,257477,3412906
2019-01-09,NYSE Arca (P),227980899,363968900,195364101,787313900,8821035363.446598,18851084260.228804,9891994152.446599,37564113776.122001,1746573,971683,1385509,4103765
2019-01-09,NASDAQ (Q),510587155,221930762,636496199,1369014116,21000463060.320601,13411149157.772699,34587337510.713980,68998949728.807280,4285325,944163,4137349,9366837
2019-01-09,IEX (V),139612941,27204804,68454889,235272634,5591555600.449500,1511203791.933000,3687121773.535900,10789881165.918400,980477,122361,510747,1613585
2019-01-09,NASDAQ PSX (X),18078431,21140778,17746245,56965454,601358368.242900,1516619946.367201,1117908065.657200,3235886380.267301,140739,83869,132797,357405
2019-01-09,BYX Equities (Y),187548761,85426732,79466929,352442422,4903902709.520100,3833103834.930699,3133437430.184100,11870443974.634899,1493691,391025,733859,2618575
2019-01-09,BZX Equities (Z),238095385,119500986,142127719,499724090,9335622613.867998,7338814308.853899,8301294618.010302,24975731540.732199,2094818,563005,1259213,3917036
2019-01-08,NYSE American (A),6737037,16843676,2715887,26296600,259504307.827200,224721305.693600,134903016.912200,619128630.433000,65127,48625,27106,140858
2019-01-08,NASDAQ BX (B),95725082,32205709,51816340,179747131,4008774841.674500,1711069447.135800,2807336148.790999,8527180437.601299,953970,168569,554829,1677368
2019-01-08,NYSE National (C),37931248,13829677,16589741,68350666,964278943.779200,493932359.189200,648101372.196000,2106312675.164400,313703,66927,165734,546364
2019-01-08,FINRA / NYSE TRF (DN),231803198,105030174,235833324,572666696,6010173556.731198,4512913889.350701,10660262526.841299,21183349972.923198,526213,222086,593046,1341345
2019-01-08,FINRA / Nasdaq TRF Carteret (DQ),1162926575,570431893,749682833,2483041301,40736699918.190897,33422903531.428295,36678826922.595414,110838430372.214606,4022092,966683,2478466,7467241
2019-01-08,EDGA Equities (J),62642347,31287242,32896973,126826562,2346359272.073500,1678193042.460900,2317188535.904900,6341740850.439300,587016,148034,320026,1055076
2019-01-08,EDGX Equities (K),172854219,84950435,126843686,384648340,6237415982.436599,5100104565.755997,6679108586.194904,18016629134.387500,1286297,376578,902968,2565843
2019-01-08,NYSE Chicago (M),8752892,16282637,7782277,32817806,402428555.400100,1320979645.607400,774927667.259900,2498335868.267400,3433,8844,7705,19982
2019-01-08,NYSE (N),1013559422,44665370,47485887,1105710679,37229176017.790895,3143382147.135400,2474640282.230900,42847198447.157195,3044737,137438,266784,3448959
2019-01-08,NYSE Arca (P),232745729,302582965,182040213,717368907,8379149070.773201,17016798360.504306,10077669349.594798,35473616780.872305,1663627,894312,1376647,3934586
2019-01-08,NASDAQ (Q),509146021,199771736,659161362,1368079119,20712297138.102799,12602428830.308996,37767179422.282103,71081905390.693898,4320064,885698,4224368,9430130
2019-01-08,IEX (V),127968599,29409688,65684712,223062999,5031025022.476000,1634345087.088899,3712885306.671000,10378255416.235899,923304,136706,495606,1555616
2019-01-08,NASDAQ PSX (X),20677529,19665293,15627662,55970484,644551341.705000,1488250027.998600,1071155055.019500,3203956424.723100,143844,83059,125068,351971
2019-01-08,BYX Equities (Y),197460849,83769097,78521686,359751632,5134884520.979500,3704769527.348899,3264948854.809601,12104602903.138000,1566941,391022,757825,2715788
2019-01-08,BZX Equities (Z),239135923,110293805,134664109,484093837,9436058560.315599,7161859394.838999,7747997103.963501,24345915059.118099,2136721,555233,1273972,3965926
2019-01-07,NYSE American (A),6875760,12238582,2301069,21415411,251650167.451100,177835306.007100,120095213.456700,549580686.914900,64956,42554,23829,131339
2019-01-07,NASDAQ BX (B),96174728,33143001,52038122,181355851,3826350023.698000,1892810035.337400,2714195828.391199,8433355887.426599,955776,175206,557388,1688370
2019-01-07,NYSE National (C),40942793,13209072,16787539,70939404,1020277323.402400,526008507.799200,693764081.426000,2240049912.627600,355645,70065,174345,600055
2019-01-07,FINRA / NYSE TRF (DN),231990570,101532178,260034946,593557694,5891367262.539901,4846264513.011298,10974337215.513503,21711968991.064702,536190,232379,641221,1409790
2019-01-07,FINRA / Nasdaq TRF Carteret (DQ),1186170373,507936151,797132965,2491239489,42187186045.682617,32063589110.052403,38898756975.006695,113149532130.741715,4050341,1074259,2541494,7666094
2019-01-07,EDGA Equities (J),63676022,31160962,31345393,126182377,2275907424.427400,1651681027.475100,1943076878.774101,5870665330.676601,606494,151370,323828,1081692
2019-01-07,EDGX Equities (K),164990806,85247719,134489305,384727830,5880570822.330199,5071916467.664802,6810408914.588596,17762896204.583597,1245499,381946,928704,2556149
2019-01-07,NYSE Chicago (M),9998141,19952098,8699512,38649751,580262115.925100,1735274335.055000,1027227344.918500,3342763795.898600,5323,11453,8271,25047
2019-01-07,NYSE (N),1017459145,43950508,46865853,1108275506,38097893535.622600,2971529130.384000,2380016056.318001,43449438722.324601,3134103,145070,274286,3553459
2019-01-07,NYSE Arca (P),222962172,311208095,193870405,728040672,8134881572.218698,17568932365.736196,10718481425.468403,36422295363.423297,1719793,933361,1492482,4145636
2019-01-07,NASDAQ (Q),517457442,205465371,682823675,1405746488,20579566031.669704,12951787444.298106,38785095852.687216,72316449328.655026,4523604,913465,4597516,10034585
2019-01-07,IEX (V),132226465,27634393,65497784,225358642,4953627791.317300,1517712334.913600,3662595847.142599,10133935973.373499,958170,131371,502106,1591647
2019-01-07,NASDAQ PSX (X),19790622,20436121,16202233,56428976,676959041.625800,1521678723.066700,1108476903.486900,3307114668.179400,160740,84898,141878,387516
2019-01-07,BYX Equities (Y),187122748,80049396,76756384,343928528,4753650195.777600,3525410986.874300,3245250639.732000,11524311822.383900,1512360,376437,764215,2653012
2019-01-07,BZX Equities (Z),235289414,114901728,138606005,488797147,8989623141.254401,7291310233.793100,7911115444.256497,24192048819.303998,2131514,574789,1335001,4041304
2019-01-04,NYSE American (A),7172120,12147909,2523777,21843806,276609572.492800,172940367.066700,152293905.686300,601843845.245800,68940,37054,26368,132362
2019-01-04,NASDAQ BX (B),96684846,35163601,51078566,182927013,3754303518.997800,1889222375.436100,2805690567.980699,8449216462.414599,915608,181865,528705,1626178
2019-01-04,NYSE National (C),40749195,17737667,17967977,76454839,1022614995.640400,650617041.648800,732285012.329500,2405517049.618700,341458,83635,180215,605308
2019-01-04,FINRA / NYSE TRF (DN),239897057,112339831,248286041,600522929,6202744464.472100,5239442130.541099,11106785321.698411,22548971916.711610,511702,239516,589302,1340520
2019-01-04,FINRA / Nasdaq TRF Carteret (DQ),1122372338,582612586,749086362,2454071286,39346433244.337805,34342276548.471314,38452072204.552393,112140781997.361512,3980011,1125836,2471566,7577413
2019-01-04,EDGA Equities (J),66905619,37146229,36357011,140408859,2408373552.709100,2048414002.529600,2226805777.933300,6683593333.172000,621077,177106,333412,1131595
2019-01-04,EDGX Equities (K),172285122,112132454,140462845,424880421,6377384411.278900,7107451752.540600,7412758713.069903,20897594876.889403,1274251,499052,931649,2704952
2019-01-04,NYSE Chicago (M),24294011,21823058,12881603,58998672,826953775.047000,1871734066.411000,1655041940.084400,4353729781.542400,4782,14482,9317,28581
2019-01-04,NYSE (N),1104384519,57118685,46379582,1207882786,41604244707.010405,4268517408.978300,2512928657.304800,48385690773.293505,3159129,194742,264356,3618227
2019-01-04,NYSE Arca (P),228551701,436677862,202462503,867692066,8598163182.309400,24051488745.509095,11065050200.632993,43714702128.451488,1724929,1210998,1453518,4389445
2019-01-04,NASDAQ (Q),539543708,270500802,766992369,1577036879,21907646045.285493,18227013811.865101,44639305274.986916,84773965132.137510,4664697,1231547,4613507,10509751
2019-01-04,IEX (V),131577747,30992830,69016990,231587567,5049319376.251900,1827502820.428400,3960122361.673500,10836944558.353800,968947,151995,517327,1638269
2019-01-04,NASDAQ PSX (X),21159824,26308614,19468283,66936721,780000319.180000,2206988366.986601,1560349095.963800,4547337782.130401,171733,116282,156950,444965
2019-01-04,BYX Equities (Y),191389385,97064475,85152367,373606227,4950904097.871301,4409228238.447799,3584405281.840100,12944537618.159200,1534904,460233,783078,2778215
2019-01-04,BZX Equities (Z),247177973,154372260,148042045,549592278,9589153819.277201,10229738067.508401,9185344589.289202,29004236476.074804,2180592,776073,1361887,4318552
2019-01-03,NYSE American (A),6804256,10383152,2800846,19988254,273882658.943400,172751507.463700,143832264.555300,590466430.962400,64584,36306,28989,129879
2019-01-03,NASDAQ BX (B),94036318,33727820,52881976,180646114,3654881166.550200,1818502056.219200,2765517100.943100,8238900323.712500,908969,180350,544794,1634113
2019-01-03,NYSE National (C),38146473,19585707,18075923,75808103,985780083.479700,660476454.112800,676008852.047000,2322265389.639500,330751,87993,182273,601017
2019-01-03,FINRA / NYSE TRF (DN),198568823,108070119,268990377,575629319,5406838194.842603,5592130582.753700,10826789582.355299,21825758359.951602,453512,233625,602329,1289466
2019-01-03,FINRA / Nasdaq TRF Carteret (DQ),1016229125,451512498,745701213,2213442836,37174944410.452795,28812162392.486203,37897196170.288800,103884302973.227798,3859808,1121909,2578624,7560341
2019-01-03,EDGA Equities (J),65815181,32536708,37935483,136287372,2472181060.187900,1860407056.870700,2013924635.919100,6346512752.977700,615419,162977,344452,1122848
2019-01-03,EDGX Equities (K),158690144,99302824,144543286,402536254,6009914955.317000,6622920410.943303,7186960142.440305,19819795508.700608,1236816,479474,959696,2675986
2019-01-03,NYSE Chicago (M),7504031,16083301,8992030,32579362,352267199.984200,1606687751.975000,895083720.335000,2854038672.294200,5853,14256,8979,29088
2019-01-03,NYSE (N),958009271,53638060,49150200,1060797531,36299195955.816400,4033601484.613901,2625246926.323500,42958044366.753801,3326233,197821,299461,3823515
2019-01-03,NYSE Arca (P),217630969,371244932,219633366,808509267,8271436974.174100,21556141345.182595,11866398056.926298,41693976376.282993,1719008,1182270,1599062,4500340
2019-01-03,NASDAQ (Q),529054690,267846847,751652705,1548554242,21792202196.120906,17812064045.491692,42681963726.440913,82286229968.053511,4714456,1289691,4947661,10951808
2019-01-03,IEX (V),123477474,27574452,68747337,219799263,4953836079.681200,1703581755.985000,3952803076.757403,10610220912.423603,932503,136378,533214,1602095
2019-01-03,NASDAQ PSX (X),19171564,26831754,18976145,64979463,699620736.322300,2158886909.319700,1407055123.648600,4265562769.290600,161082,127022,160709,448813
2019-01-03,BYX Equities (Y),183747758,87929780,85060045,356737583,4773667863.247900,3901963201.641100,3452014574.453401,12127645639.342401,1508875,430136,809547,2748558
2019-01-03,BZX Equities (Z),241953437,154149993,158414707,554518137,9553086362.693399,10124815095.520297,9330941144.780500,29008842602.994196,2190034,823800,1475207,4489041
2019-01-02,NYSE American (A),6397049,12806606,2236114,21439769,243391400.116000,217284793.527300,111665293.612800,572341487.256100,61627,40249,23040,124916
2019-01-02,NASDAQ BX (B),85926977,34254147,45701260,165882384,3261933297.639500,1837859486.375500,2242263766.448700,7342056550.463700,849666,175845,471595,1497106
2019-01-02,NYSE National (C),38494091,16017199,16407886,70919176,980653065.300300,584833248.690700,603565737.823800,2169052051.814800,339295,77738,170809,587842
2019-01-02,FINRA / NYSE TRF (DN),197190419,105960542,230540036,533690997,4832386803.769400,4732606869.720200,9326902221.683002,18891895895.172602,454724,229439,506757,1190920
2019-01-02,FINRA / Nasdaq TRF Carteret (DQ),1003841743,587380242,669625834,2260847819,33717059004.934891,34831046012.568909,32507525795.555604,101055630813.059404,3603871,1040425,2134411,6778707
2019-01-02,EDGA Equities (J),60947061,33287977,30857743,125092781,2165300721.853500,1794286008.742900,1778816818.434700,5738403549.031100,574250,171494,295947,1041691
2019-01-02,EDGX Equities (K),152291237,92472321,119729428,364492986,5282772611.527200,5801459418.716303,6061323399.712299,17145555429.955802,1178855,429515,838862,2447232
2019-01-02,NYSE Chicago (M),11337579,18391086,7006803,36735468,371755371.622200,2120831791.570001,681127343.440100,3173714506.632301,4794,13461,10452,28707
2019-01-02,NYSE (N),962323370,50379540,42000057,1054702967,34073263495.864502,3642114066.162999,2231665788.681800,39947043350.709301,3146933,182282,243147,3572362
2019-01-02,NYSE Arca (P),209389232,390390296,181749515,781529043,7540938970.767301,21806572891.344799,9770334899.685896,39117846761.797996,1643052,1131672,1371565,4146289
2019-01-02,NASDAQ (Q),490327022,249103425,661384765,1400815212,19240769695.304701,16213406124.094099,35655791221.611297,71109967041.010097,4417611,1181452,4361590,9960653
2019-01-02,IEX (V),114894736,30514046,55433505,200842287,4255870369.455300,1917424119.773699,2894233269.327100,9067527758.556099,878174,154323,434175,1466672
2019-01-02,NASDAQ PSX (X),17416845,24019498,17294791,58731134,622372164.771600,1841103528.363099,1239459397.403300,3702935090.537999,140656,111159,128659,380474
2019-01-02,BYX Equities (Y),177810154,84578176,72386960,334775290,4442666698.052500,3743067585.609400,2879711876.953100,11065446160.615000,1464449,426752,703634,2594835
2019-01-02,BZX Equities (Z),221342931,138328210,127725627,487396768,8320824579.335400,9087570844.526400,7266827088.225299,24675222512.087099,2032858,724882,1218772,3976512
