Day,Market Participant,Tape A Shares,Tape B Shares,Tape C Shares,Total Shares,Tape A Notional,Tape B Notional,Tape C Notional,Total Notional,Tape A Trade Count,Tape B Trade Count,Tape C Trade Count,Total Trade Count
2015-12-31,NYSE MKT (A),0,11313234,2455884,13769118,0.000000,70846626.226500,73969542.810000,144816169.036500,0,26560,13519,40079
2015-12-31,NASDAQ BX (B),51598147,27405684,27997702,107001533,1669915871.610101,1319802461.726100,1097769307.731220,4087487641.067421,471772,119327,254566,845665
2015-12-31,NSX (C),0,800,1100,1900,0.000000,10549.000000,4868.100000,15417.100000,0,8,2,10
2015-12-31,NYSE (DN),93494226,41046096,51606111,186146433,2817516813.114241,1785325654.909196,1816962393.053902,6419804861.077339,401705,111789,205385,718879
2015-12-31,NASDAQ (DQ),759302817,456165135,480832621,1696300573,20735948283.891318,22775455614.689867,14951299474.324970,58462703372.906155,2763602,886674,1470880,5121156
2015-12-31,EDGA (J),78667882,38559500,32727382,149954764,1827993924.281599,1754461773.951203,1120024299.136508,4702479997.369310,532869,174893,267257,975019
2015-12-31,EDGX (K),153833606,106666175,143320276,403820057,4550882011.120703,5181549028.315805,4901697469.257959,14634128508.694467,1007676,404348,801006,2213030
2015-12-31,CHX (M),7494845,8554449,2779696,18828990,502383556.185900,1072250128.920000,224061985.854000,1798695670.959900,282,4560,967,5809
2015-12-31,NYSE (N),753730125,0,0,753730125,26611570114.467610,0.000000,0.000000,26611570114.467610,2326788,0,0,2326788
2015-12-31,NYSE Arca (P),163448209,262224445,133550819,559223473,5759475132.681127,15515344689.655522,5356506833.749565,26631326656.086214,1285653,750496,972504,3008653
2015-12-31,NASDAQ (Q),321244359,123658960,405804166,850707485,11996319231.962215,7557096025.484224,16469733631.375277,36023148888.821716,2768481,502830,2119932,5391243
2015-12-31,NASDAQ PSX (X),19155499,15029707,18917734,53102940,570670437.534200,792214920.458200,512261951.488099,1875147309.480499,145377,67281,114126,326784
2015-12-31,BATS BYX (Y),111069432,62186198,57294354,230549984,3223458739.204085,2556045215.596301,1910242695.418478,7689746650.218864,1004787,281412,502772,1788971
2015-12-31,BATS BZX (Z),142913755,89335603,81948416,314197774,4574957347.684015,5818985972.800896,3335185766.486879,13729129086.971790,1225337,400040,682009,2307386
2015-12-30,NYSE MKT (A),0,8502846,3213058,11715904,0.000000,50876506.494400,89144279.121000,140020785.615400,0,20968,15586,36554
2015-12-30,NASDAQ BX (B),45725306,20163660,25469215,91358181,1476606278.888402,913887209.256501,967387875.375094,3357881363.519997,431093,91811,234625,757529
2015-12-30,NSX (C),1675,0,24200,25875,1419.100000,0.000000,26661.560000,28080.660000,3,0,9,12
2015-12-30,NYSE (DN),86306260,41469667,43635505,171411432,2766035466.087928,1616376433.439201,1740174667.609518,6122586567.136647,354711,101636,168217,624564
2015-12-30,NASDAQ (DQ),770365689,423888696,460426000,1654680385,20689792674.383941,18940474404.239494,13480790273.217882,53111057351.841317,2822046,792391,1421876,5036313
2015-12-30,EDGA (J),71470514,30027016,29193172,130690702,1603211194.904703,1319649411.214900,846615096.912902,3769475703.032505,488349,140495,224509,853353
2015-12-30,EDGX (K),143556694,85290909,139664274,368511877,4027198339.150083,3675568230.308997,4099872409.566719,11802638979.025799,911670,312585,699670,1923925
2015-12-30,CHX (M),6732739,7312368,4005447,18050554,227209119.037000,755133708.350000,330448107.862800,1312790935.249800,382,3447,1568,5397
2015-12-30,NYSE (N),562638020,0,0,562638020,18222854280.477095,0.000000,0.000000,18222854280.477095,2064086,0,0,2064086
2015-12-30,NYSE Arca (P),162534621,210264822,124297668,497097111,5571963858.597589,10442285596.453918,4598804394.577285,20613053849.628792,1236726,586529,870145,2693400
2015-12-30,NASDAQ (Q),274366962,87923466,284600984,646891412,10499959209.583491,4876179945.778200,10772724137.577542,26148863292.939233,2466312,377783,1805128,4649223
2015-12-30,NASDAQ PSX (X),16957978,11389214,12272842,40620034,507277726.644200,577367058.494000,414497951.412499,1499142736.550699,135479,49218,87069,271766
2015-12-30,BATS BYX (Y),97527483,49248593,50024153,196800229,2685014830.705106,1890645799.493699,1686120239.616400,6261780869.815205,866237,219219,436100,1521556
2015-12-30,BATS BZX (Z),130958849,67440906,72435304,270835059,4233643043.582681,3781498050.170304,2685445513.209886,10700586606.962871,1153624,301432,608859,2063915
2015-12-29,NYSE MKT (A),0,7139997,2909354,10049351,0.000000,44614900.555700,98372592.412000,142987492.967700,0,20043,16317,36360
2015-12-29,NASDAQ BX (B),53125965,21626650,28922094,103674709,1735972880.448588,1029726471.792102,1168983936.402901,3934683288.643591,486225,101564,262760,850549
2015-12-29,NSX (C),0,0,100,100,0.000000,0.000000,982.000000,982.000000,0,0,1,1
2015-12-29,NYSE (DN),98538757,43455502,49649573,191643832,3030200929.366355,1835419541.495500,2083920620.861193,6949541091.723048,398274,108391,201238,707903
2015-12-29,NASDAQ (DQ),837577976,455870807,500099733,1793548516,23400244908.584757,21855048588.895055,16439638309.802252,61694931807.282064,3038202,875730,1598071,5512003
2015-12-29,EDGA (J),66792456,33846873,34554398,135193727,1934431543.519393,1476322776.933102,1173952097.385603,4584706417.838098,569641,160746,272516,1002903
2015-12-29,EDGX (K),158440976,95205771,155736886,409383633,4728754774.643812,4295757607.440514,5214450557.323555,14238962939.407881,1032084,345887,833228,2211199
2015-12-29,CHX (M),4116205,10214751,6236754,20567710,117620586.114000,1303675299.880000,418073638.523600,1839369524.517600,433,4204,1423,6060
2015-12-29,NYSE (N),589774278,0,0,589774278,19820810507.163230,0.000000,0.000000,19820810507.163230,2129792,0,0,2129792
2015-12-29,NYSE Arca (P),167867334,219279196,140371854,527518384,5959780264.715201,12244134222.698026,5515398268.738345,23719312756.151572,1291735,619417,970691,2881843
2015-12-29,NASDAQ (Q),299998289,101438316,312994615,714431220,11552260453.965263,5476147337.111788,13111313998.483160,30139721789.560211,2663581,405206,1970761,5039548
2015-12-29,NASDAQ PSX (X),17625601,11515187,14763756,43904544,554104608.248900,545419298.879501,537037400.181899,1636561307.310300,143916,50741,101807,296464
2015-12-29,BATS BYX (Y),109431096,58153282,56317277,223901655,3214028057.461696,2332817062.388194,1926863020.647407,7473708140.497297,991171,253583,490155,1734909
2015-12-29,BATS BZX (Z),139556051,78795321,82242132,300593504,4628670484.816919,4489246795.708287,3275022734.422607,12392940014.947813,1218570,343001,669471,2231042
2015-12-28,NYSE MKT (A),0,6779046,2894359,9673405,0.000000,39338976.024000,89821194.581600,129160170.605600,0,18149,15949,34098
2015-12-28,NASDAQ BX (B),49940330,23026944,27237107,100204381,1600044449.367696,963541184.250499,962094887.021800,3525680520.639995,470222,100651,248753,819626
2015-12-28,NSX (C),300,0,0,300,4848.000000,0.000000,0.000000,4848.000000,3,0,0,3
2015-12-28,NYSE (DN),95823093,41393771,47015482,184232346,3013159127.404820,1658062022.605001,1758881033.050714,6430102183.060535,380930,119362,186780,687072
2015-12-28,NASDAQ (DQ),818635589,457588160,460201692,1736425441,23458872216.827127,19902978182.701747,13345729310.542256,56707579710.071130,2949838,853771,1462386,5265995
2015-12-28,EDGA (J),58230972,34639682,31482224,124352878,1675138818.293203,1418485910.250800,922864315.471204,4016489044.015207,517876,160011,246537,924424
2015-12-28,EDGX (K),149831744,91285334,150479690,391596768,4377579104.140808,4000997205.308605,4406037155.070574,12784613464.519987,1003779,356291,783122,2143192
2015-12-28,CHX (M),10676319,6319351,3671555,20667225,416820244.332000,589550035.072500,492392902.345000,1498763181.749500,1689,3257,1051,5997
2015-12-28,NYSE (N),614836401,0,0,614836401,20777761771.401451,0.000000,0.000000,20777761771.401451,2130316,0,0,2130316
2015-12-28,NYSE Arca (P),163004244,222868986,131557733,517430963,5776459061.036317,10767647535.042006,4602726086.323813,21146832682.402136,1290531,636618,931497,2858646
2015-12-28,NASDAQ (Q),290856388,99139722,317073409,707069519,10976594947.280448,5248781262.315815,12037855887.170360,28263232096.766623,2637035,433573,1943704,5014312
2015-12-28,NASDAQ PSX (X),16665713,12400035,13434460,42500208,507340611.138401,607252370.599000,468171372.990600,1582764354.728001,141364,55894,96473,293731
2015-12-28,BATS BYX (Y),100213603,53411157,52791521,206416281,2842384415.151038,1992234757.041295,1634429655.305193,6469048827.497526,926080,240444,457471,1623995
2015-12-28,BATS BZX (Z),128567902,74257200,75518388,278343490,4088038887.919456,4030295700.844795,2696661672.427806,10814996261.192057,1148627,334039,624005,2106671
2015-12-24,NYSE MKT (A),0,4880473,1641080,6521553,0.000000,30682095.471500,46042462.849000,76724558.320500,0,12952,9404,22356
2015-12-24,NASDAQ BX (B),24065662,10585409,13231652,47882723,784582154.667401,492221574.395600,476243212.436700,1753046941.499701,231896,50304,122632,404832
2015-12-24,NYSE (DN),48482105,21779853,24377286,94639244,1517830075.450400,838547853.930101,820836330.331596,3177214259.712097,202244,59593,99333,361170
2015-12-24,NASDAQ (DQ),433629795,227461440,244695394,905786629,11400667348.885586,10392514359.925909,6700490598.193679,28493672307.005174,1500208,444908,765816,2710932
2015-12-24,EDGA (J),30037825,17603192,17060350,64701367,784600765.629900,694336805.706000,494509828.872701,1973447400.208601,259182,74236,130092,463510
2015-12-24,EDGX (K),93667480,45513461,75591497,214772438,2573680378.663212,2125104594.703700,2252209643.170708,6950994616.537620,596087,180675,426306,1203068
2015-12-24,CHX (M),989414,4478886,2707202,8175502,35686179.072100,400103157.250000,100935413.160000,536724749.482100,216,1344,485,2045
2015-12-24,NYSE (N),393091793,0,0,393091793,12817362914.182908,0.000000,0.000000,12817362914.182908,1307279,0,0,1307279
2015-12-24,NYSE Arca (P),94365034,123646778,73085960,291097772,3146770979.981000,7018948793.461206,2596837851.979904,12762557625.422110,741791,334694,530206,1606691
2015-12-24,NASDAQ (Q),161881474,51622274,181595225,395098973,5838111900.529380,2987113457.529401,6855830722.470051,15681056080.528832,1457537,221202,1078999,2757738
2015-12-24,NASDAQ PSX (X),8835626,5462709,8170523,22468858,253350508.247900,265414932.332200,201915542.509500,720680983.089600,71920,25005,48495,145420
2015-12-24,BATS BYX (Y),48225129,23841405,25702589,97769123,1345827623.649099,906387060.071700,804283399.627503,3056498083.348302,451646,112639,222764,787049
2015-12-24,BATS BZX (Z),75061487,38638115,39331786,153031388,2244907153.009902,2201421822.020698,1434601971.061406,5880930946.092006,670698,173553,349482,1193733
2015-12-23,NYSE MKT (A),0,8149091,3697937,11847028,0.000000,63095539.077300,115569960.540000,178665499.617300,0,24425,20671,45096
2015-12-23,NASDAQ BX (B),68602335,30912306,33276620,132791261,2188947451.379902,1422367539.326103,1268789028.109001,4880104018.815006,632053,143562,293907,1069522
2015-12-23,NSX (C),100,0,43465,43565,954.000000,0.000000,1481068.060000,1482022.060000,1,0,342,343
2015-12-23,NYSE (DN),130113794,47982836,61470124,239566754,4161307462.306838,1922398354.526101,2315410296.431103,8399116113.264042,511310,116270,234607,862187
2015-12-23,NASDAQ (DQ),1129385545,512076943,569029951,2210492439,32942859668.873848,24509520022.723927,17551858399.145889,75004238090.743664,3735829,930875,1738643,6405347
2015-12-23,EDGA (J),89011408,46909414,39157992,175078814,2363209896.397910,1990076764.168004,1180323663.492597,5533610324.058511,728815,209188,298846,1236849
2015-12-23,EDGX (K),210023293,115473018,166506689,492003000,5930858817.107418,4920509790.759998,5074686883.740617,15926055491.608033,1334341,423935,931184,2689460
2015-12-23,CHX (M),6221204,14930763,10005845,31157812,266204517.693000,1604244669.514899,544676233.122600,2415125420.330499,439,3086,960,4485
2015-12-23,NYSE (N),842551536,0,0,842551536,27921547375.957064,0.000000,0.000000,27921547375.957064,2834678,0,0,2834678
2015-12-23,NYSE Arca (P),241498724,293383837,160188628,695071189,8126642938.245034,15912315546.967249,5870803415.510366,29909761900.722649,1750848,818022,1119668,3688538
2015-12-23,NASDAQ (Q),407178597,132467142,376127082,915772821,14977148476.302405,7393715754.806512,14579376881.742359,36950241112.851276,3447399,551937,2266855,6266191
2015-12-23,NASDAQ PSX (X),23703594,15592307,15301250,54597151,715508586.639902,764966900.734800,540812574.569700,2021288061.944402,192279,67378,106187,365844
2015-12-23,BATS BYX (Y),139858914,71577617,64073232,275509763,3763518325.124845,2610812932.865803,2044436472.817103,8418767730.807751,1222853,317542,533078,2073473
2015-12-23,BATS BZX (Z),198628952,104353104,94927863,397909919,6151852491.614563,5930485799.038187,3479302680.452247,15561640971.104997,1639826,440146,768960,2848932
2015-12-22,NYSE MKT (A),0,9091382,3926849,13018231,0.000000,61878369.324000,121368706.141000,183247075.465000,0,24252,21611,45863
2015-12-22,NASDAQ BX (B),71712561,30317125,34207001,136236687,2420992211.961891,1357978626.530598,1302249042.618398,5081219881.110887,657956,146328,308975,1113259
2015-12-22,NSX (C),17951,0,200,18151,505877.300000,0.000000,527.000000,506404.300000,81,0,2,83
2015-12-22,NYSE (DN),148330995,47558343,60299490,256188828,4552186971.584732,2032910684.602690,2326419811.964582,8911517468.152004,566551,113621,239081,919253
2015-12-22,NASDAQ (DQ),1106167899,488493391,533426479,2128087769,31725793700.257459,23796946073.417958,17270980422.606183,72793720196.281600,3793743,875848,1725736,6395327
2015-12-22,EDGA (J),88200804,43933788,39833803,171968395,2483599082.713393,1878266284.162500,1248041821.929294,5609907188.805187,763088,211517,317265,1291870
2015-12-22,EDGX (K),206138699,108042323,160303398,474484420,5981133445.722658,5210961816.763290,5163048179.878872,16355143442.364820,1335044,425374,927552,2687970
2015-12-22,CHX (M),9210137,16590400,3989649,29790186,402941953.689200,1211145123.490000,257821814.985000,1871908892.164200,548,3545,867,4960
2015-12-22,NYSE (N),849765456,0,0,849765456,28441060965.679523,0.000000,0.000000,28441060965.679523,2932368,0,0,2932368
2015-12-22,NYSE Arca (P),240914099,279865313,166597602,687377014,8327897028.245945,15764914182.564094,6419441892.158312,30512253102.968351,1828064,860988,1212294,3901346
2015-12-22,NASDAQ (Q),419178261,130777164,370922411,920877836,16167917115.881016,7693765334.336900,15119043460.541949,38980725910.759865,3729334,565090,2405255,6699679
2015-12-22,NASDAQ PSX (X),23956708,14536174,16564692,55057574,746425605.456800,749382988.087900,609012723.773000,2104821317.317700,190051,65314,119134,374499
2015-12-22,BATS BYX (Y),150842864,68455065,66702095,286000024,4157414557.753772,2558889214.567998,2151108243.870593,8867412016.192363,1333051,319412,580316,2232779
2015-12-22,BATS BZX (Z),209587158,97980579,102588361,410156098,6754391350.920699,5896213663.030309,3864350823.842494,16514955837.793502,1791468,438455,859279,3089202
2015-12-21,NYSE MKT (A),0,10698711,3313828,14012539,0.000000,66585481.295100,86352241.374000,152937722.669100,0,25881,18365,44246
2015-12-21,NASDAQ BX (B),76427694,35008426,36636164,148072284,2489615738.658501,1459068376.597102,1387369496.012902,5336053611.268505,696174,164031,332050,1192255
2015-12-21,NYSE (DN),146371153,50888105,62557173,259816431,4502162046.192632,2119387638.308789,2472319959.000801,9093869643.502222,595446,126398,256171,978015
2015-12-21,NASDAQ (DQ),1140080719,499083946,572783953,2211948618,32947726798.120820,21764501904.485710,19063319132.437318,73775547835.043848,4091573,968248,1887751,6947572
2015-12-21,EDGA (J),97928412,49556752,40993454,188478618,2778812749.192993,1949627722.626301,1346469942.426995,6074910414.246289,828705,233835,335928,1398468
2015-12-21,EDGX (K),218634639,123914617,170658380,513207636,6359746314.123458,5583466300.940005,5751302737.996256,17694515353.059719,1507130,489828,1035401,3032359
2015-12-21,CHX (M),13154382,20213112,4984267,38351761,248069639.649000,1054325243.810000,354168272.510300,1656563155.969300,598,3858,964,5420
2015-12-21,NYSE (N),925336811,0,0,925336811,30197110765.263748,0.000000,0.000000,30197110765.263748,3150628,0,0,3150628
2015-12-21,NYSE Arca (P),264593568,317212747,171676333,753482648,8762205752.634007,15227032748.560747,6936847789.381245,30926086290.575999,2003375,930315,1314840,4248530
2015-12-21,NASDAQ (Q),473648653,150808762,415569713,1040027128,17803533387.016783,8099730642.741970,16872567770.820172,42775831800.578925,4200269,649212,2745708,7595189
2015-12-21,NASDAQ PSX (X),27403459,15627032,18299770,61330261,844406041.670699,777850913.339000,700235831.381296,2322492786.390995,226148,74076,134396,434620
2015-12-21,BATS BYX (Y),161647716,73953933,72145765,307747414,4491369067.834001,2641384072.490796,2351541881.295473,9484295021.620270,1398304,338797,635254,2372355
2015-12-21,BATS BZX (Z),219093700,116858761,107973702,443926163,6881409115.259888,7081336851.855320,4157386854.870784,18120132821.985992,1868040,484419,923054,3275513
2015-12-18,NYSE MKT (A),0,113114794,4349548,117464342,0.000000,345338504.121300,145464120.147000,490802624.268300,0,32474,21279,53753
2015-12-18,NASDAQ BX (B),108352300,53212792,54355477,215920569,3569498586.945577,2505654697.050702,2110145606.498777,8185298890.495056,950600,237089,481007,1668696
2015-12-18,NYSE (DN),181661143,59940143,83351481,324952767,5883113427.901335,2852234454.023000,3453052737.687516,12188400619.611851,742983,163457,323595,1230035
2015-12-18,NASDAQ (DQ),1930932726,803809284,1273566136,4008308146,58116195527.303060,39447656308.775463,41595651486.778251,139159503322.856774,4755967,1231980,2268107,8256054
2015-12-18,EDGA (J),134078839,75225936,63433275,272738050,3766476511.203286,3316800418.624502,2094992773.010297,9178269702.838085,1098357,351236,499261,1948854
2015-12-18,EDGX (K),278699623,176804509,223916147,679420279,8456212785.990100,9923278757.866520,7777377214.948360,26156868758.804980,1914999,722498,1348361,3985858
2015-12-18,CHX (M),34817068,27146041,11665531,73628640,887264224.802800,2183640095.177401,894976598.225000,3965880918.205201,848,6529,2552,9929
2015-12-18,NYSE (N),2542904218,0,0,2542904218,87757411572.665351,0.000000,0.000000,87757411572.665351,3986763,0,0,3986763
2015-12-18,NYSE Arca (P),356531100,453605410,228414260,1038550770,12371542575.444113,27066687649.900762,9549045624.405208,48987275849.750083,2638040,1377459,1683036,5698535
2015-12-18,NASDAQ (Q),604886254,236321522,1560464506,2401672282,23149804602.776664,15924748336.113365,56113883519.244106,95188436458.134135,5140723,1016005,3742925,9899653
2015-12-18,NASDAQ PSX (X),35557384,24062232,26096583,85716199,1102835140.395800,1418445693.582901,1018129966.202299,3539410800.181000,275844,108422,188092,572358
2015-12-18,BATS BYX (Y),232655507,104281852,109477052,446414411,6528036150.651307,4299194676.768299,3513815736.045922,14341046563.465528,1902434,487543,905076,3295053
2015-12-18,BATS BZX (Z),291087212,171266023,150909061,613262296,9449708313.858541,11249511542.314835,6213821599.637515,26913041455.810891,2378182,750859,1231423,4360464
2015-12-17,NYSE MKT (A),0,9779674,4909257,14688931,0.000000,64031791.443700,126141537.136000,190173328.579700,0,26059,24123,50182
2015-12-17,NASDAQ BX (B),91969099,43715867,44015370,179700336,3081149528.491691,1899816304.437302,1737905181.225497,6718871014.154490,843295,189846,406421,1439562
2015-12-17,NYSE (DN),183291819,60523739,73962610,317778168,5777735238.789899,2622820841.063294,2979627260.039601,11380183339.892794,672276,164211,303794,1140281
2015-12-17,NASDAQ (DQ),1383456396,611927770,654699266,2650083432,39738358306.212647,30394309388.778276,22314361079.853002,92447028774.843925,4721925,1101498,2135685,7959108
2015-12-17,EDGA (J),115353222,64201928,48830569,228385719,3333212358.279492,2725402753.050606,1714294189.785000,7772909301.115098,974734,285221,417293,1677248
2015-12-17,EDGX (K),261967765,150193238,193779634,605940637,7766302988.831146,8024347579.941205,6842281079.381924,22632931648.154275,1775869,586684,1202673,3565226
2015-12-17,CHX (M),15951617,25402832,5930634,47285083,534138291.198500,2223206571.580000,310595027.421200,3067939890.199700,580,8053,2192,10825
2015-12-17,NYSE (N),960098966,0,0,960098966,32318559178.364892,0.000000,0.000000,32318559178.364892,3358724,0,0,3358724
2015-12-17,NYSE Arca (P),302115678,396123551,195801483,894040712,10447534029.161764,22498836952.775092,8428553436.542799,41374924418.479655,2211342,1097693,1498877,4807912
2015-12-17,NASDAQ (Q),550080575,186225449,454164245,1190470269,21663455424.561528,11742813774.513427,19484391001.732419,52890660200.807374,4819052,776701,3018620,8614373
2015-12-17,NASDAQ PSX (X),32155951,20761183,20123840,73040974,1069816640.692199,1100430390.334799,844509733.638600,3014756764.665598,258345,86129,153697,498171
2015-12-17,BATS BYX (Y),181497113,88796341,80655397,350948851,5108517996.989216,3575371976.491598,2771383241.492803,11455273214.973617,1537927,404790,712659,2655376
2015-12-17,BATS BZX (Z),255562453,147313429,124543764,527419646,8349590516.582577,9643393291.667286,5179311081.686477,23172294889.936340,2123897,609204,1069038,3802139
2015-12-16,NYSE MKT (A),0,9597529,4122332,13719861,0.000000,82655076.022800,111277162.687000,193932238.709800,0,26954,24489,51443
2015-12-16,NASDAQ BX (B),90547440,50637710,44059532,185244682,3120856283.101711,2350500244.377303,1782709095.285504,7254065622.764518,836481,237391,424289,1498161
2015-12-16,NYSE (DN),183672676,61490757,77040943,322204376,6024273094.049414,2834990232.269201,3175278016.523520,12034541342.842135,677854,170561,298766,1147181
2015-12-16,NASDAQ (DQ),1391147789,611629706,671301675,2674079170,41708518531.212706,32241593632.236717,23867688382.802581,97817800546.252004,4539665,1176536,2183510,7899711
2015-12-16,EDGA (J),118827347,77544315,52499082,248870744,3386665104.944710,3485515031.377290,1677026533.238979,8549206669.560979,990200,373275,444690,1808165
2015-12-16,EDGX (K),305100930,178846927,215052758,699000615,9179011092.169964,9157774244.366838,7654714525.990056,25991499862.526858,1997612,684863,1347254,4029729
2015-12-16,CHX (M),21796205,23176624,7702729,52675558,649523239.427300,2553480352.300000,667875778.281000,3870879370.008300,1042,11989,2677,15708
2015-12-16,NYSE (N),1003063911,0,0,1003063911,33353724839.404915,0.000000,0.000000,33353724839.404915,3717055,0,0,3717055
2015-12-16,NYSE Arca (P),349510903,433314437,228016398,1010841738,12038768357.127596,24655297826.417881,9550043734.047188,46244109917.592665,2530914,1292746,1698934,5522594
2015-12-16,NASDAQ (Q),628105325,226779192,473541718,1328426235,24628367921.013527,14068133465.243212,20537509212.936366,59234010599.193105,5407071,966768,3302307,9676146
2015-12-16,NASDAQ PSX (X),40170740,26224641,24205618,90600999,1267988775.202501,1391165838.681801,938332656.651398,3597487270.535700,312759,113334,180409,606502
2015-12-16,BATS BYX (Y),185761981,105660046,84534826,375956853,5363292739.479782,4183906632.201191,2864224639.333319,12411424011.014292,1589994,485518,772307,2847819
2015-12-16,BATS BZX (Z),293029661,176185276,142397871,611612808,9542149422.219029,11222519246.564870,5878643392.633365,26643312061.417264,2384961,753052,1225990,4364003
2015-12-15,NYSE MKT (A),0,9287115,4458584,13745699,0.000000,74528395.429400,144324825.948000,218853221.377400,0,27008,27406,54414
2015-12-15,NASDAQ BX (B),91605956,41870558,46495287,179971801,3192630872.994375,1861790111.905602,1878539900.073305,6932960884.973282,868259,194996,438117,1501372
2015-12-15,NYSE (DN),180862897,56157465,86789459,323809821,6216835666.765145,2480831282.557501,3582189280.330169,12279856229.652815,705867,147579,340451,1193897
2015-12-15,NASDAQ (DQ),1373431111,597224823,704899689,2675555623,41981937366.559887,30849189845.260133,25751544276.003817,98582671487.823837,4790511,1076399,2268736,8135646
2015-12-15,EDGA (J),113007501,58429214,52578723,224015438,3359668498.084870,2512469638.041501,1742049404.782001,7614187540.908372,990428,273431,428895,1692754
2015-12-15,EDGX (K),262858214,139073467,203564176,605495857,8458991106.639860,7280881981.671197,7315312254.916155,23055185343.227212,1806726,550456,1260905,3618087
2015-12-15,CHX (M),12210552,33585461,7157237,52953250,348118641.945000,3242115087.661496,643238882.167000,4233472611.773496,601,11915,3355,15871
2015-12-15,NYSE (N),975225101,0,0,975225101,33984417441.647898,0.000000,0.000000,33984417441.647898,3521024,0,0,3521024
2015-12-15,NYSE Arca (P),300892634,335297157,220424868,856614659,11047152004.999543,18727894066.268924,9592884093.451152,39367930164.719619,2323456,1002975,1635057,4961488
2015-12-15,NASDAQ (Q),545297977,167960534,478231750,1191490261,22379665231.067419,10863354718.640782,21140570204.670781,54383590154.378982,4859951,723369,3220225,8803545
2015-12-15,NASDAQ PSX (X),33432554,18716579,22667906,74817039,1145784330.146899,1033894773.255099,946413992.321098,3126093095.723096,280468,81215,175325,537008
2015-12-15,BATS BYX (Y),205895079,89834087,94485765,390214931,6128740984.364542,3485428824.925593,3180560652.463560,12794730461.753695,1854811,413918,844103,3112832
2015-12-15,BATS BZX (Z),261504835,131913800,139042597,532461232,9015098788.262352,8571878118.653612,5788492775.797392,23375469682.713356,2268748,562167,1171094,4002009
2015-12-14,NYSE MKT (A),0,10515519,4180115,14695634,0.000000,60079108.939700,124659258.028000,184738366.967700,0,26854,24979,51833
2015-12-14,NASDAQ BX (B),97876254,52768234,49928998,200573486,3366371917.133521,2342203413.183703,2065170581.179388,7773745911.496612,907511,240641,466338,1614490
2015-12-14,NYSE (DN),186786290,67298500,86937884,341022674,5639708363.275782,3056164067.197696,3675717450.826796,12371589881.300274,747129,177459,344080,1268668
2015-12-14,NASDAQ (DQ),1352648970,655234860,719187263,2727071093,38352786491.344357,31256288491.520093,24138766395.237290,93747841378.101740,4856030,1269886,2334812,8460728
2015-12-14,EDGA (J),125159621,77971057,60208466,263339144,3652689003.691006,3421491848.747008,2157618204.451997,9231799056.890011,1078131,376125,505434,1959690
2015-12-14,EDGX (K),278275384,185496730,221972919,685745033,8416298807.032209,10289260661.585776,7862696029.102485,26568255497.720470,1988557,773058,1419885,4181500
2015-12-14,CHX (M),36493763,23789998,10222177,70505938,847160671.200100,2633436808.715199,493016937.384000,3973614417.299299,1051,14513,3552,19116
2015-12-14,NYSE (N),1084079251,0,0,1084079251,36821027829.779273,0.000000,0.000000,36821027829.779273,4078695,0,0,4078695
2015-12-14,NYSE Arca (P),327453881,436822984,233244373,997521238,11410197115.537962,23395918245.680028,9838403031.321268,44644518392.539258,2521363,1411706,1781656,5714725
2015-12-14,NASDAQ (Q),614437839,240347908,538755022,1393540769,24035300787.188956,14836788030.713762,22874445335.528572,61746534153.431290,5440342,1108213,3693535,10242090
2015-12-14,NASDAQ PSX (X),38713641,25786695,27023572,91523908,1363580581.158600,1426622926.290601,1144953293.532096,3935156800.981297,313375,114797,198215,626387
2015-12-14,BATS BYX (Y),196852619,115368154,94909701,407130474,5685011464.410061,4729625587.939385,3253884608.529481,13668521660.878927,1730625,564336,848705,3143666
2015-12-14,BATS BZX (Z),284445887,179593912,156237605,620277404,9557410432.932704,12199251505.702268,6428837111.251647,28185499049.886619,2437622,830758,1321261,4589641
2015-12-11,NYSE MKT (A),0,8378985,3997126,12376111,0.000000,63504992.663400,109907381.366000,173412374.029400,0,23819,20480,44299
2015-12-11,NASDAQ BX (B),90157930,50252006,44321236,184731172,3249810742.557398,2216738062.426299,1897146767.014190,7363695571.997887,806833,212730,413313,1432876
2015-12-11,NYSE (DN),175950500,62480236,82629773,321060509,6059665560.541622,2880718648.503997,3709342450.152413,12649726659.198032,717653,168193,320629,1206475
2015-12-11,NASDAQ (DQ),1283080607,656910606,697080652,2637071865,38897874506.465572,35559931204.197068,24023001044.420878,98480806755.083518,4462864,1277591,2180144,7920599
2015-12-11,EDGA (J),111244708,69914170,53645778,234804656,3356200219.731801,3138509213.361588,1930657615.741897,8425367048.835286,934626,325891,434064,1694581
2015-12-11,EDGX (K),264642565,176212188,217059318,657914071,8313210754.288116,9576665035.047305,7678352729.883407,25568228519.218828,1772877,697337,1288431,3758645
2015-12-11,CHX (M),17629269,27690572,8252422,53572263,589260459.214000,3197995033.848001,667031699.071500,4454287192.133501,781,13692,4481,18954
2015-12-11,NYSE (N),1023269949,0,0,1023269949,34798603219.006454,0.000000,0.000000,34798603219.006454,3436432,0,0,3436432
2015-12-11,NYSE Arca (P),307318122,414073881,216054383,937446386,10908830750.355694,24238981997.618745,9358863931.628313,44506676679.602752,2208149,1265261,1577386,5050796
2015-12-11,NASDAQ (Q),542468122,210194400,511148954,1263811476,21720809686.820845,13851032996.607148,22301476836.874867,57873319520.302860,4632942,908789,3178882,8720613
2015-12-11,NASDAQ PSX (X),35841549,24335454,24824376,85001379,1225839855.925500,1338471113.633499,1001918204.036798,3566229173.595797,275723,104010,180624,560357
2015-12-11,BATS BYX (Y),183909483,103557893,88261814,375729190,5438059468.612512,4183576014.420817,3160617206.997100,12782252690.030429,1559375,472863,777812,2810050
2015-12-11,BATS BZX (Z),268145789,169879281,140776239,578801309,8994553830.353518,11475117187.384374,5943140042.657080,26412811060.394972,2199435,717087,1156200,4072722
2015-12-10,NYSE MKT (A),0,6658750,3914178,10572928,0.000000,42316553.534200,116536255.679000,158852809.213200,0,19003,20951,39954
2015-12-10,NASDAQ BX (B),74117035,34728725,37791766,146637526,2539791316.371806,1411413981.748001,1494505905.303902,5445711203.423709,661374,152316,338859,1152549
2015-12-10,NYSE (DN),145051910,43655714,69513922,258221546,4958078018.109332,2081506447.510796,2785907024.205476,9825491489.825604,582168,121173,271474,974815
2015-12-10,NASDAQ (DQ),1166671813,438928049,608076910,2213676772,35374090323.662030,21412347722.513338,20289412082.491968,77075850128.667336,3982289,866934,1958427,6807650
2015-12-10,EDGA (J),93017684,49509789,44417314,186944787,2783003846.898315,2177411947.769100,1468662104.915001,6429077899.582416,774965,233402,354207,1362574
2015-12-10,EDGX (K),234101241,116465317,180627864,531194422,7346525941.558005,5947714158.459429,6163924430.338484,19458164530.355918,1580859,471324,1096446,3148629
2015-12-10,CHX (M),11697679,13950439,4065715,29713833,489196277.907200,1567003137.410699,480330807.017800,2536530222.335699,518,8591,2663,11772
2015-12-10,NYSE (N),872683798,0,0,872683798,30068273312.731065,0.000000,0.000000,30068273312.731065,2965321,0,0,2965321
2015-12-10,NYSE Arca (P),254687642,268638154,180911237,704237033,8898980939.835320,16627583502.626957,7332604171.291922,32859168613.754199,1885890,858331,1325946,4070167
2015-12-10,NASDAQ (Q),462761742,124010497,415309229,1002081468,18370737002.649958,7553605376.442418,17274340663.131788,43198683042.224164,4019941,577805,2654164,7251910
2015-12-10,NASDAQ PSX (X),26771868,13321214,17238917,57331999,934239415.966800,770406266.116700,716782475.870700,2421428157.954200,214678,60066,129346,404090
2015-12-10,BATS BYX (Y),148727963,80626167,73073322,302427452,4420632333.503433,3047024831.636392,2561856373.678097,10029513538.817922,1241807,350749,627202,2219758
2015-12-10,BATS BZX (Z),228231621,102643266,114179596,445054483,7639124820.358808,6447308759.664081,4542837971.725636,18629271551.748525,1888896,471296,959789,3319981
2015-12-09,NYSE MKT (A),0,7367860,3720169,11088029,0.000000,44862385.253000,115853635.458000,160716020.711000,0,21119,21672,42791
2015-12-09,NASDAQ BX (B),88348969,47017597,43671543,179038109,3069278125.274103,1995586104.452201,1842666553.516298,6907530783.242602,794020,208542,396997,1399559
2015-12-09,NYSE (DN),162788839,54134838,72608243,289531920,5317669261.258997,2517113670.706606,3502334459.616390,11337117391.581993,635635,143997,297160,1076792
2015-12-09,NASDAQ (DQ),1321405376,532436244,677124364,2530965984,40208661252.524425,26432733646.617511,23835294239.230638,90476689138.372574,4314879,1054532,2129953,7499364
2015-12-09,EDGA (J),114885952,66331282,51758141,232975375,3292844804.380294,2962997584.779005,1793912858.916595,8049755248.075894,932150,321849,421855,1675854
2015-12-09,EDGX (K),284196131,165736071,212267429,662199631,8454408168.715311,8531964573.592383,8022842958.885814,25009215701.193508,1864698,662014,1317230,3843942
2015-12-09,CHX (M),12770441,18477914,9243669,40492024,502663318.593600,2338206131.660002,930658334.207000,3771527784.460602,776,10449,3858,15083
2015-12-09,NYSE (N),1018248584,0,0,1018248584,35073078026.945453,0.000000,0.000000,35073078026.945453,3534390,0,0,3534390
2015-12-09,NYSE Arca (P),337943087,383443174,217540685,938926946,11191500219.741337,22881381409.935945,9455237123.531020,43528118753.208302,2314867,1217291,1612911,5145069
2015-12-09,NASDAQ (Q),553136014,187287161,476654552,1217077727,21901562089.164805,11488340270.378134,21394790941.645046,54784693301.187985,4750779,861479,3184423,8796681
2015-12-09,NASDAQ PSX (X),33269936,20075134,21066420,74411490,1144404505.163802,1139356147.930600,907059201.339999,3190819854.434401,258932,95067,152034,506033
2015-12-09,BATS BYX (Y),177963938,104244308,81151035,363359281,5235419779.091093,3983976113.036093,2954120708.641405,12173516600.768591,1490284,465040,722506,2677830
2015-12-09,BATS BZX (Z),283643348,150496309,140735887,574875544,9366889092.454367,9348225898.870678,6176622184.465468,24891737175.790513,2333714,686606,1203126,4223446
2015-12-08,NYSE MKT (A),0,8425478,3304136,11729614,0.000000,54470606.486200,102316971.108000,156787577.594200,0,23725,18627,42352
2015-12-08,NASDAQ BX (B),88918091,38019860,41844955,168782906,3057566062.761714,1551177297.803601,1709040663.284916,6317784023.850231,773884,170750,378825,1323459
2015-12-08,NYSE (DN),170395668,52702943,75958050,299056661,5602151334.295778,2218101635.879600,3058607924.527218,10878860894.702596,633947,130453,284360,1048760
2015-12-08,NASDAQ (DQ),1285684126,515110798,643527912,2444322836,37374446714.935559,22579937582.385088,21378465581.956677,81332849879.277324,4307826,1016503,2007750,7332079
2015-12-08,EDGA (J),110575782,54688432,48736620,214000834,3229298952.886895,2276069679.098999,1650004836.138494,7155373468.124388,899886,265086,392885,1557857
2015-12-08,EDGX (K),264994666,133551839,196119646,594666151,8221978443.650355,6005092852.824115,6928536329.029300,21155607625.503770,1776143,524932,1196058,3497133
2015-12-08,CHX (M),12888826,16413514,5366434,34668774,485122387.714100,1679425359.600000,439405742.233800,2603953489.547900,716,7009,2161,9886
2015-12-08,NYSE (N),971217122,0,0,971217122,32551820987.892939,0.000000,0.000000,32551820987.892939,3223335,0,0,3223335
2015-12-08,NYSE Arca (P),300461349,320838188,193312277,814611814,10388197537.445013,16519305858.628177,8081915157.829738,34989418553.902928,2161448,993667,1421263,4576378
2015-12-08,NASDAQ (Q),504654193,144004983,444194250,1092853426,19784303081.122266,8183310805.182611,18823907884.120200,46791521770.425077,4255103,640514,2818274,7713891
2015-12-08,NASDAQ PSX (X),30676944,17255048,20053402,67985394,1029618785.537699,881412144.167200,799892957.506502,2710923887.211401,239695,76796,144889,461380
2015-12-08,BATS BYX (Y),179853686,84379779,78220418,342453883,5098488312.206105,3126375813.101305,2706354159.189688,10931218284.497098,1438782,383553,686127,2508462
2015-12-08,BATS BZX (Z),259604940,116284010,127008755,502897705,8462009992.863503,6794858376.200303,5127077972.648015,20383946341.711821,2139879,516421,1083011,3739311
2015-12-07,NYSE MKT (A),0,9568521,3922962,13491483,0.000000,77794509.488500,103889655.820000,181684165.308500,0,26064,20102,46166
2015-12-07,NASDAQ BX (B),82792794,37874680,39835275,160502749,2872499162.870097,1479050121.436597,1640726922.536706,5992276206.843400,764777,166754,373329,1304860
2015-12-07,NYSE (DN),166051801,52235642,75613752,293901195,5385063913.863598,2160817554.642899,3126776620.285600,10672658088.792097,626252,133129,283533,1042914
2015-12-07,NASDAQ (DQ),1262071536,522886343,698743984,2483701863,37565167863.257236,22634444416.901744,22352686054.719686,82552298334.878666,4376518,1014299,2084923,7475740
2015-12-07,EDGA (J),100242537,51555316,48549504,200347357,3000219039.748612,2072425410.396803,1568654227.669506,6641298677.814921,865686,239125,385459,1490270
2015-12-07,EDGX (K),255663647,126300354,208835680,590799681,7960841499.577856,5752547795.225915,6833382168.527096,20546771463.330867,1753728,489817,1201699,3445244
2015-12-07,CHX (M),4921204,11984125,2774229,19679558,223478282.179000,946377515.050000,195464942.770000,1365320739.999000,592,4530,1434,6556
2015-12-07,NYSE (N),954034778,0,0,954034778,32222821146.624623,0.000000,0.000000,32222821146.624623,3190029,0,0,3190029
2015-12-07,NYSE Arca (P),272132197,315857823,202389837,790379857,9780271307.050532,16383784454.599927,8388477592.229519,34552533353.879978,2041483,921784,1464478,4427745
2015-12-07,NASDAQ (Q),510110473,132137997,457805789,1100054259,20219203421.977033,7466989431.599507,18810197706.823156,46496390560.399696,4440918,596629,2947935,7985482
2015-12-07,NASDAQ PSX (X),28828211,14379031,19022269,62229511,1000261478.222898,796248692.282700,790717578.590000,2587227749.095598,238334,66812,144894,450040
2015-12-07,BATS BYX (Y),168269542,82284909,76528112,327082563,4943896027.785925,2939051347.857904,2746869033.885303,10629816409.529132,1440969,359634,689455,2490058
2015-12-07,BATS BZX (Z),241426196,103985419,121067343,466478958,8071941818.458231,6077992710.852506,4892448239.233383,19042382768.544120,2069023,460230,1046343,3575596
2015-12-04,NYSE MKT (A),0,8415355,3914319,12329674,0.000000,49748530.967200,124704997.826000,174453528.793200,0,22808,20293,43101
2015-12-04,NASDAQ BX (B),81890667,41518253,39519384,162928304,2821661747.473900,1822539758.731002,1745309276.656100,6389510782.861002,727104,188799,361573,1277476
2015-12-04,NYSE (DN),169657881,52864802,70604901,293127584,5592739940.822876,2419987371.350796,3291569135.247276,11304296447.420948,656544,139800,283003,1079347
2015-12-04,NASDAQ (DQ),1313843717,523839571,645755896,2483439184,39671627289.020808,29425101247.417547,24174876023.563467,93271604560.001822,4433350,1028215,2091417,7552982
2015-12-04,EDGA (J),103064326,60571188,45507199,209142713,3007403801.961085,2757891524.224794,1682469105.714886,7447764431.900765,847124,290904,366576,1504604
2015-12-04,EDGX (K),286536746,151176665,209719470,647432881,8869700237.647027,7757279790.312828,7982824600.640765,24609804628.600620,1883132,594203,1235584,3712919
2015-12-04,CHX (M),12998841,20476704,5882892,39358437,429143201.913000,2719454097.226700,715716464.904000,3864313764.043700,566,9901,2915,13382
2015-12-04,NYSE (N),1002519257,0,0,1002519257,35842414577.261864,0.000000,0.000000,35842414577.261864,3187032,0,0,3187032
2015-12-04,NYSE Arca (P),287358859,352424627,200118027,839901513,10242939845.406724,22734841322.794088,9115330627.052926,42093111795.253738,2035552,1054363,1446174,4536089
2015-12-04,NASDAQ (Q),506828581,155515533,463307700,1125651814,20715350135.197964,10351433980.102702,22311444759.009276,53378228874.309942,4259503,688211,2957636,7905350
2015-12-04,NASDAQ PSX (X),31420423,17521894,19147463,68089780,1072697582.504000,1092916609.040300,865760950.124298,3031375141.668598,249296,82071,146608,477975
2015-12-04,BATS BYX (Y),165457984,89274636,73527231,328259851,4889050880.897694,3546482146.370404,2794100259.296625,11229633286.564723,1374694,397820,644303,2416817
2015-12-04,BATS BZX (Z),256740486,128627700,123100782,508468968,8626072313.093328,8619328529.634603,5643650550.805450,22889051393.533381,2073395,564205,1034258,3671858
2015-12-03,NYSE MKT (A),0,7297473,4247515,11544988,0.000000,49933372.795800,132482508.179000,182415880.974800,0,19993,20127,40120
2015-12-03,NASDAQ BX (B),85909890,42876550,44039116,172825556,3045452109.913795,2307145902.600001,1943981363.598508,7296579376.112304,759394,200675,398808,1358877
2015-12-03,NYSE (DN),180279704,52678240,82100866,315058810,6588709516.095710,2498416844.695600,3897619437.173318,12984745797.964628,712780,143775,337674,1194229
2015-12-03,NASDAQ (DQ),1275261547,543225464,693163745,2511650756,40627868738.440592,28888465347.039902,26506524401.861378,96022858487.341872,4350081,1093884,2223521,7667486
2015-12-03,EDGA (J),99858620,62031895,51611233,213501748,3036140739.074392,3173452600.779103,1834007609.448401,8043600949.301896,816473,296621,413594,1526688
2015-12-03,EDGX (K),282522806,153083242,233427287,669033335,9021066452.554454,8004308096.520493,8715121371.208195,25740495920.283142,1880571,615823,1408805,3905199
2015-12-03,CHX (M),11382570,22772636,5720599,39875805,379815280.169000,2639362666.510000,477713702.320300,3496891648.999300,740,10096,2561,13397
2015-12-03,NYSE (N),1021039825,0,0,1021039825,36321896597.941064,0.000000,0.000000,36321896597.941064,3464120,0,0,3464120
2015-12-03,NYSE Arca (P),318401058,363291162,222322643,904014863,12127479668.224110,21767474634.316909,9836308555.260037,43731262857.801056,2218137,1120441,1622770,4961348
2015-12-03,NASDAQ (Q),555169254,164878890,514181358,1234229502,23528559217.347239,10914451002.767966,24000534088.971497,58443544309.086702,4802677,755851,3442535,9001063
2015-12-03,NASDAQ PSX (X),39719647,17714099,21630306,79064052,1455914830.853303,1085380478.856500,924750503.688799,3466045813.398602,318727,80346,153435,552508
2015-12-03,BATS BYX (Y),177993572,89976759,84503550,352473881,5552367090.098756,4025985543.589702,3137681272.711616,12716033906.400074,1484208,423868,728568,2636644
2015-12-03,BATS BZX (Z),261075616,129287813,134248420,524611849,8859981201.121336,8256474130.698203,5756489167.323908,22872944499.143447,2148327,569203,1159400,3876930
2015-12-02,NYSE MKT (A),0,7458006,4004611,11462617,0.000000,43050206.078700,96749548.398000,139799754.476700,0,21407,16775,38182
2015-12-02,NASDAQ BX (B),86246031,37274536,41994972,165515539,2859898068.133784,1664256746.132502,1690548393.971999,6214703208.238285,773158,163463,381721,1318342
2015-12-02,NYSE (DN),149848824,47857419,73948992,271655235,5400877645.818027,1962472249.426805,3200677289.050496,10564027184.295328,590038,120410,276878,987326
2015-12-02,NASDAQ (DQ),1186652998,464782090,761758787,2413193875,36975669091.975636,21486118139.108164,23425213924.610811,81887001155.694611,4189810,951001,2158066,7298877
2015-12-02,EDGA (J),101369377,52540587,52574183,206484147,2936856545.515985,2367710960.270302,1555975623.375294,6860543129.161581,827165,235814,389541,1452520
2015-12-02,EDGX (K),264173154,128913365,240344584,633431103,8395012453.667684,5990733060.506995,7357849873.947051,21743595388.121730,1754503,473755,1218281,3446539
2015-12-02,CHX (M),16338600,11757967,5455151,33551718,792500250.875000,1447815600.745001,492317257.169100,2732633108.789101,1249,5015,1270,7534
2015-12-02,NYSE (N),954246730,0,0,954246730,32351925895.729775,0.000000,0.000000,32351925895.729775,2962827,0,0,2962827
2015-12-02,NYSE Arca (P),276124280,296412923,210543255,783080458,9745265467.762148,16048965439.757041,8268512908.087587,34062743815.606776,1944481,845203,1394985,4184669
2015-12-02,NASDAQ (Q),494092300,129733305,469395894,1093221499,20033373138.465484,7779953013.203310,19840189631.394242,47653515783.063036,4243057,563940,2882183,7689180
2015-12-02,NASDAQ PSX (X),36080931,13714754,18058477,67854162,1334521174.438597,727579214.027000,782870820.987399,2844971209.452996,301590,64355,135239,501184
2015-12-02,BATS BYX (Y),167225061,77459176,73153592,317837829,4897303619.690827,3199190203.788203,2533634872.973901,10630128696.452931,1383766,353572,624316,2361654
2015-12-02,BATS BZX (Z),222777469,105802170,113158550,441738189,7390600968.971673,6251500637.172188,4589216707.121256,18231318313.265117,1828357,444620,926539,3199516
2015-12-01,NYSE MKT (A),0,8092504,4119684,12212188,0.000000,51763095.170000,102862114.455000,154625209.625000,0,21077,17164,38241
2015-12-01,NASDAQ BX (B),78728254,30140983,41367171,150236408,2755807139.307498,1515477370.702499,1683730127.305000,5955014637.314997,713888,138390,373560,1225838
2015-12-01,NYSE (DN),141098427,41710932,72431115,255240474,5075688093.806306,1756698322.454000,3039441429.446905,9871827845.707211,563420,116242,268027,947689
2015-12-01,NASDAQ (DQ),1185349562,452542881,745122868,2383015311,38976698254.780272,22839720690.673920,24191546440.992846,86007965386.447038,4031756,888770,2134327,7054853
2015-12-01,EDGA (J),90201547,42928371,50608941,183738859,2743249234.398790,2139184487.078801,1507112177.699596,6389545899.177187,751467,199996,372636,1324099
2015-12-01,EDGX (K),237010002,107489478,226046705,570546185,7846031051.001851,5467256597.564677,7001944855.574498,20315232504.141026,1618507,412012,1194618,3225137
2015-12-01,CHX (M),20253788,10662395,4979863,35896046,845837719.387100,1212477961.430000,328233440.415900,2386549121.233000,600,4865,1802,7267
2015-12-01,NYSE (N),867904924,0,0,867904924,31237508660.215766,0.000000,0.000000,31237508660.215766,2866746,0,0,2866746
2015-12-01,NYSE Arca (P),251861978,268409918,205649752,725921648,9388654079.514424,15497633787.817204,8288455939.068656,33174743806.400284,1890887,723170,1425256,4039313
2015-12-01,NASDAQ (Q),445338548,106107698,480870570,1032316816,18991692727.397889,6955445447.879026,20093207042.333180,46040345217.610095,4018831,466062,2926441,7411334
2015-12-01,NASDAQ PSX (X),33368617,11903181,17491484,62763282,1213414515.001799,673174374.176000,725422577.953798,2612011467.131597,276973,56702,133402,467077
2015-12-01,BATS BYX (Y),154335987,65519586,76158638,296014211,4833706339.225007,2846530946.098502,2609509331.907363,10289746617.230872,1350302,291255,661630,2303187
2015-12-01,BATS BZX (Z),208483628,92680550,113721262,414885440,7186980814.750005,5888763545.312990,4600096744.489812,17675841104.552807,1734575,396530,932721,3063826
2015-11-30,NYSE MKT (A),0,10870470,3563424,14433894,0.000000,97104744.987500,106991551.719000,204096296.706500,0,19911,18243,38154
2015-11-30,NASDAQ BX (B),89346920,35270745,42945517,167563182,3021604637.489395,1769241742.370401,1820581959.562222,6611428339.422018,789848,167029,391951,1348828
2015-11-30,NYSE (DN),132494120,41422214,67608700,241525034,4639737876.404510,1809497083.314199,2716768737.742047,9166003697.460756,540626,112402,273774,926802
2015-11-30,NASDAQ (DQ),1285761538,431663537,813719602,2531144677,44769395249.794953,23411156601.216348,28547131909.790316,96727683760.801617,3845322,817512,2020585,6683419
2015-11-30,EDGA (J),103253358,47081331,54281637,204616326,3174794051.219100,2369698575.014298,1717432997.118681,7261925623.352079,857506,215711,394351,1467568
2015-11-30,EDGX (K),234612220,107513878,231219706,573345804,7492273141.386193,5260217218.402202,6446895123.535957,19199385483.324352,1493995,404467,1121760,3020222
2015-11-30,CHX (M),10052358,11881128,3879213,25812699,541952559.359500,1421320730.730000,296737966.042000,2260011256.131500,498,4856,1054,6408
2015-11-30,NYSE (N),1349098240,0,0,1349098240,49914767101.135310,0.000000,0.000000,49914767101.135310,2940538,0,0,2940538
2015-11-30,NYSE Arca (P),254538533,297111294,206126279,757776106,9050404511.368705,16795561565.417657,7913975941.738973,33759942018.525335,1813917,783024,1388022,3984963
2015-11-30,NASDAQ (Q),467191330,114166231,635353079,1216710640,19284715133.775986,7140806703.734825,29428634099.427477,55854155936.938288,4003165,483858,2928391,7415414
2015-11-30,NASDAQ PSX (X),26960137,12978959,16398189,56337285,945975308.240600,626140469.467200,645465266.362401,2217581044.070201,216031,58065,125068,399164
2015-11-30,BATS BYX (Y),171974886,73640258,78699163,324314307,5048092939.863527,3289945046.077097,2746566609.827138,11084604595.767762,1420502,316935,666079,2403516
2015-11-30,BATS BZX (Z),218557715,99296842,111160478,429015035,7269275647.914038,6190856623.910674,4505071587.670415,17965203859.495127,1782797,411451,959728,3153976
2015-11-27,NYSE MKT (A),0,3704420,2324374,6028794,0.000000,23843172.275600,54813496.301300,78656668.576900,0,9470,9780,19250
2015-11-27,NASDAQ BX (B),33458606,16045067,16729139,66232812,1115640417.490792,661012803.937200,635819071.582994,2412472293.010986,297278,69082,150231,516591
2015-11-27,NYSE (DN),43601896,18957711,22390996,84950603,1604103884.611100,712995621.463800,974392479.797397,3291491985.872297,180776,52829,92835,326440
2015-11-27,NASDAQ (DQ),415349613,203742340,264651747,883743700,13271294648.645444,9029183395.957879,7952416747.896544,30252894792.499867,1493496,375852,844511,2713859
2015-11-27,EDGA (J),32146550,20774009,18480725,71401284,923495875.409302,879944134.849700,564980065.469502,2368420075.728504,270129,87532,140225,497886
2015-11-27,EDGX (K),98703635,54978608,96293806,249976049,3195798378.957604,2329593324.800698,2599663672.782189,8125055376.540491,623349,193864,461094,1278307
2015-11-27,CHX (M),2430249,3804577,650808,6885634,96841268.905700,484429795.720000,67716655.048000,648987719.673700,130,2374,602,3106
2015-11-27,NYSE (N),388391127,0,0,388391127,13301212992.705375,0.000000,0.000000,13301212992.705375,1328943,0,0,1328943
2015-11-27,NYSE Arca (P),111507982,150293732,85730388,347532102,3744274181.204001,6895305641.824697,3278925645.185475,13918505468.214173,784867,368455,611168,1764490
2015-11-27,NASDAQ (Q),184231772,51800039,196045771,432077582,7613919947.560742,2905063679.466690,7895259401.273357,18414243028.300789,1652072,216293,1249712,3118077
2015-11-27,NASDAQ PSX (X),14452082,5865512,6587548,26905142,553626494.873999,272489551.236100,237940374.210100,1064056420.320199,120679,25741,49294,195714
2015-11-27,BATS BYX (Y),58541861,30126705,27334128,116002694,1767032814.679397,1137950898.152199,911979988.128405,3816963700.960001,519280,134779,240824,894883
2015-11-27,BATS BZX (Z),85952804,44663156,44799704,175415664,2940281356.646099,2363985947.429795,1798521102.149109,7102788406.225003,743566,181864,386618,1312048
2015-11-25,NYSE MKT (A),0,7839327,3184104,11023431,0.000000,41819567.146900,88274584.520900,130094151.667800,0,20116,15702,35818
2015-11-25,NASDAQ BX (B),62035198,21002817,29762197,112800212,2106902037.057005,988811779.883099,1119916449.041297,4215630265.981401,544550,103262,267139,914951
2015-11-25,NYSE (DN),112453813,30128783,56312060,198894656,3903635831.091587,1172271800.666600,2165849019.326203,7241756651.084390,418975,78736,220284,717995
2015-11-25,NASDAQ (DQ),903457050,287363541,552684920,1743505511,27848447000.064902,12535565489.172565,15526789113.104385,55910801602.341852,3002535,609918,1616434,5228887
2015-11-25,EDGA (J),68115347,28800826,39721651,136637824,2006498248.801906,1354853495.578001,1045009084.754308,4406360829.134215,559260,138335,279121,976716
2015-11-25,EDGX (K),196616580,80250961,182776527,459644068,6043222933.828611,3476459183.554203,4968823304.337195,14488505421.720009,1217757,308713,912847,2439317
2015-11-25,CHX (M),10791966,5620157,3378667,19790790,542771309.660700,697380723.240000,196893591.676000,1437045624.576700,323,3872,864,5059
2015-11-25,NYSE (N),677507702,0,0,677507702,23172314280.133839,0.000000,0.000000,23172314280.133839,2200868,0,0,2200868
2015-11-25,NYSE Arca (P),196777775,189017651,164681311,550476737,7011940011.054277,9593140049.583054,5599848048.892424,22204928109.529755,1409322,572907,1084120,3066349
2015-11-25,NASDAQ (Q),336228398,78700313,358721232,773649943,13967249775.886018,4335746080.275206,13634633042.557843,31937628898.719067,2974517,352449,2156266,5483232
2015-11-25,NASDAQ PSX (X),23170332,8384366,11717672,43272370,873906045.606400,419280861.339000,428126263.402099,1721313170.347499,201201,39734,88748,329683
2015-11-25,BATS BYX (Y),112028606,43149187,55422110,210599903,3307885750.750089,1913262767.355099,1707568900.350089,6928717418.455277,943166,219419,465034,1627619
2015-11-25,BATS BZX (Z),156601174,63719589,82887019,303207782,5295517040.859841,3451900483.095908,3125063450.118911,11872480974.074660,1320441,288702,702573,2311716
2015-11-24,NYSE MKT (A),0,7869055,4821609,12690664,0.000000,70836947.802800,138265569.082000,209102516.884800,0,21615,22019,43634
2015-11-24,NASDAQ BX (B),79328245,31529401,42397552,153255198,2824619529.794000,1582699331.177399,1635749286.814600,6043068147.785999,692216,146490,365863,1204569
2015-11-24,NYSE (DN),151019536,36784395,74304969,262108900,5414177898.927206,1667755965.552500,3263903804.377800,10345837668.857506,535437,103744,260590,899771
2015-11-24,NASDAQ (DQ),1225891803,365554321,707340798,2298786922,38462789077.623380,16743198049.961982,23323931210.221546,78529918337.806908,3805158,775509,2017794,6598461
2015-11-24,EDGA (J),96004272,43294792,52346057,191645121,2661375462.019695,2034124058.268902,1637987890.276603,6333487410.565200,737203,198890,373243,1309336
2015-11-24,EDGX (K),256647948,108117802,210968953,575734703,7261507350.692280,5021654004.732180,6873698458.755011,19156859814.179471,1511235,435733,1125973,3072941
2015-11-24,CHX (M),12796007,12593783,4717845,30107635,623217572.987400,1607359954.470000,356951057.105200,2587528584.562600,538,5362,1663,7563
2015-11-24,NYSE (N),915899168,0,0,915899168,30773100466.939967,0.000000,0.000000,30773100466.939967,2867028,0,0,2867028
2015-11-24,NYSE Arca (P),276860218,265584847,214806561,757251626,9481384844.641501,15300945391.015522,8203483135.096446,32985813370.753469,1899092,767079,1420121,4086292
2015-11-24,NASDAQ (Q),470287157,110316494,436104424,1016708075,19284005135.832645,6742600724.221204,19099864855.352968,45126470715.406817,3985887,504670,2792522,7283079
2015-11-24,NASDAQ PSX (X),32706562,12080003,18520698,63307263,1147621412.723799,623574648.279801,687879079.489000,2459075140.492600,267019,56708,128602,452329
2015-11-24,BATS BYX (Y),150022885,63405442,76812555,290240882,4427981931.499991,2763237690.430198,2400142566.441919,9591362188.372108,1226948,297683,630740,2155371
2015-11-24,BATS BZX (Z),222611745,92182043,114798086,429591874,7418121709.826350,5637420929.112605,4593944021.676596,17649486660.615551,1785731,412441,939587,3137759
2015-11-23,NYSE MKT (A),0,8716033,3389820,12105853,0.000000,69374398.728900,92586995.947000,161961394.675900,0,21132,16387,37519
2015-11-23,NASDAQ BX (B),71526758,26287414,37057933,134872105,2543078055.775311,1219107119.114802,1464253826.124402,5226439001.014515,625345,123909,327400,1076654
2015-11-23,NYSE (DN),145348376,34927039,68828564,249103979,5534123770.852912,1472077910.787897,2843901800.315884,9850103481.956693,535469,94204,260958,890631
2015-11-23,NASDAQ (DQ),1144995140,354993475,574359944,2074348559,36376048328.987154,16148598506.342273,20439260015.080379,72963906850.409806,3637748,733942,1918769,6290459
2015-11-23,EDGA (J),90323909,34645667,41581119,166550695,2625110460.858890,1633915714.994200,1436505753.293603,5695531929.146693,697956,174739,340207,1212902
2015-11-23,EDGX (K),239790027,91951696,176291242,508032965,7260823722.425381,4020509563.600598,5862847700.026553,17144180986.052532,1379027,366710,1007584,2753321
2015-11-23,CHX (M),12544418,7607769,5180129,25332316,605247203.934900,689134974.699999,434893223.803000,1729275402.437899,1139,3563,1411,6113
2015-11-23,NYSE (N),863644367,0,0,863644367,29739871103.755175,0.000000,0.000000,29739871103.755175,2588186,0,0,2588186
2015-11-23,NYSE Arca (P),249343321,210487240,175963241,635793802,9305796577.628943,10810656545.370309,7504447027.415064,27620900150.414316,1703152,643891,1297178,3644221
2015-11-23,NASDAQ (Q),406454202,93259861,403156799,902870862,17074679461.699815,5178871202.305507,17320720386.608640,39574271050.613962,3388607,411185,2542227,6342019
2015-11-23,NASDAQ PSX (X),29277710,9911644,14234158,53423512,1090892831.322500,498026765.803800,527285344.866100,2116204941.992400,241735,47394,108513,397642
2015-11-23,BATS BYX (Y),139836509,50688342,66597507,257122358,4096420042.879494,2175868640.595504,2177272893.926205,8449561577.401203,1121408,241924,562165,1925497
2015-11-23,BATS BZX (Z),201555873,76169027,103674959,381399859,6974869140.196298,4133848530.805710,4205173929.088807,15313891600.090815,1653486,348315,897238,2899039
2015-11-20,NYSE MKT (A),0,8403031,3319987,11723018,0.000000,47888456.916200,109130920.491000,157019377.407200,0,19803,18614,38417
2015-11-20,NASDAQ BX (B),77923967,32059353,37769940,147753260,2740128936.758909,1468719882.975500,1553555447.457708,5762404267.192117,664598,141064,338017,1143679
2015-11-20,NYSE (DN),153241837,41466701,73849197,268557735,5683133852.287401,1620579908.004903,3173095211.533491,10476808971.825795,584623,116568,285468,986659
2015-11-20,NASDAQ (DQ),1235513137,418984488,608376029,2262873654,38355748936.498179,20168839077.988802,23145282569.828970,81669870584.315951,3902670,818274,1990193,6711137
2015-11-20,EDGA (J),93644210,46349010,43254333,183247553,2710686384.302301,2010846484.054905,1474032650.431601,6195565518.788807,716852,199822,353765,1270439
2015-11-20,EDGX (K),281506381,106168600,184304572,571979553,8362919074.362788,5005645390.852099,6817123325.110634,20185687790.325521,1543287,412268,1103558,3059113
2015-11-20,CHX (M),12678586,13414962,7965615,34059163,586387885.175800,1706273795.279999,370779621.349500,2663441301.805299,392,4877,1516,6785
2015-11-20,NYSE (N),976483641,0,0,976483641,36276550534.152520,0.000000,0.000000,36276550534.152520,2763740,0,0,2763740
2015-11-20,NYSE Arca (P),262683013,262344132,180522089,705549234,9599740488.389968,13415799154.885428,7900629309.890314,30916168953.165710,1798130,729737,1351811,3879678
2015-11-20,NASDAQ (Q),455979033,112261489,446865858,1015106380,18746986394.437710,6455137926.217309,20454113751.622901,45656238072.277920,3566600,467503,2694352,6728455
2015-11-20,NASDAQ PSX (X),32974923,13888950,16526461,63390334,1268243685.276097,685601301.081400,666444432.746601,2620289419.104098,264836,58766,122410,446012
2015-11-20,BATS BYX (Y),149859765,67664325,66665612,284189702,4476350982.532662,2808694949.817496,2401738766.630864,9686784698.981022,1182917,300157,591366,2074440
2015-11-20,BATS BZX (Z),207596972,92516287,106135137,406248396,7281566204.477367,5373259453.902697,4525248960.062060,17180074618.442124,1719221,403247,922040,3044508
2015-11-19,NYSE MKT (A),0,7119363,3221630,10340993,0.000000,42043688.301400,89843955.961000,131887644.262400,0,17021,19258,36279
2015-11-19,NASDAQ BX (B),74515181,29077764,38591365,142184310,2690534102.061303,1383956987.586001,1643610518.907909,5718101608.555213,650881,134905,347153,1132939
2015-11-19,NYSE (DN),144819060,37407816,78306975,260533851,5408649259.361812,1555767554.623398,3431456686.993098,10395873500.978308,548245,99221,288835,936301
2015-11-19,NASDAQ (DQ),1138107346,400530237,633093590,2171731173,36845632408.600302,20112282145.840996,23350490701.358225,80308405255.799523,3771075,789668,2002419,6563162
2015-11-19,EDGA (J),89666808,42459438,43671317,175797563,2632580485.849099,1880882700.645800,1502732104.016607,6016195290.511506,695032,197377,356140,1248549
2015-11-19,EDGX (K),252857417,101286109,195226366,549369892,7997684177.513017,4690891758.478502,6774741684.555166,19463317620.546685,1559232,398266,1150407,3107905
2015-11-19,CHX (M),42398448,14648485,5619131,62666064,1468028345.653000,1459269130.761199,469917460.853000,3397214937.267199,426,4629,2020,7075
2015-11-19,NYSE (N),820952244,0,0,820952244,28372323168.501495,0.000000,0.000000,28372323168.501495,2753979,0,0,2753979
2015-11-19,NYSE Arca (P),266050316,246963325,192313964,705327605,9698692632.029471,13165258938.064288,8483865021.105460,31347816591.199219,1833612,740168,1421035,3994815
2015-11-19,NASDAQ (Q),434117179,104412631,415003735,953533545,17793319917.332653,5850364414.799592,17564392988.093811,41208077320.226056,3600561,461697,2653425,6715683
2015-11-19,NASDAQ PSX (X),31090127,11909139,16796493,59795759,1146966803.634697,595244917.036200,702543854.456699,2444755575.127596,245173,55066,121297,421536
2015-11-19,BATS BYX (Y),137976022,58824466,66720119,263520607,4071344211.105490,2506197320.879905,2355139846.353811,8932681378.339206,1130238,281266,579255,1990759
2015-11-19,BATS BZX (Z),199067035,88145838,107266515,394479388,6821791776.333804,5205764123.046788,4516295044.450676,16543850943.831268,1628833,394450,914740,2938023
2015-11-18,NYSE MKT (A),0,7202990,3730989,10933979,0.000000,46462628.091700,118096213.294000,164558841.385700,0,19262,21398,40660
2015-11-18,NASDAQ BX (B),79591465,34297647,42421804,156310916,2698309587.406091,1773564405.328500,1751282834.348003,6223156827.082594,693957,156303,383786,1234046
2015-11-18,NYSE (DN),149215443,42217802,81032307,272465552,5072198923.490393,1856946275.304999,3457788622.014089,10386933820.809481,543023,111002,291849,945874
2015-11-18,NASDAQ (DQ),1174998610,412424390,714980814,2302403814,36632734063.823417,20915680229.568738,26024938393.830082,83573352687.222237,3875698,840153,2190286,6906137
2015-11-18,EDGA (J),94203122,48464486,49567498,192235106,2745925921.690300,2325998618.469199,1725841206.617785,6797765746.777284,755984,217323,403755,1377062
2015-11-18,EDGX (K),271149970,122833770,211853572,605837312,8308141790.213724,5957792101.855007,7987859062.248066,22253792954.316797,1700034,475723,1299447,3475204
2015-11-18,CHX (M),94568072,15313530,7238111,117119713,2938582601.798000,1590814800.970000,434455350.053000,4963852752.821000,420,5962,1778,8160
2015-11-18,NYSE (N),909666638,0,0,909666638,30971806380.959881,0.000000,0.000000,30971806380.959881,3004553,0,0,3004553
2015-11-18,NYSE Arca (P),283614294,297923587,219342968,800880849,10024854851.957365,16875756563.231791,9547212949.649315,36447824364.838471,2006928,840828,1603364,4451120
2015-11-18,NASDAQ (Q),470992290,134081445,475450320,1080524055,19351469605.694466,7989109226.004494,22343859751.401275,49684438583.100235,4077842,593055,3006531,7677428
2015-11-18,NASDAQ PSX (X),35788424,15909988,19978750,71677162,1229176662.932098,829834115.730000,863072238.059200,2922083016.721298,274243,71466,140299,486008
2015-11-18,BATS BYX (Y),151545914,73356520,75346725,300249159,4457227866.220412,3211833400.216500,2671311585.977534,10340372852.414446,1255849,330876,658854,2245579
2015-11-18,BATS BZX (Z),221055832,106984236,124176930,452216998,7490010251.379887,6418918172.214604,5288703129.373680,19197631552.968171,1838765,463553,1048294,3350612
2015-11-17,NYSE MKT (A),0,7256438,4157071,11413509,0.000000,65428613.180500,109038691.570000,174467304.750500,0,20022,21883,41905
2015-11-17,NASDAQ BX (B),86851747,36312663,41077421,164241831,2981639019.934305,1815540186.598102,1709892825.391484,6507072031.923891,744261,160919,370358,1275538
2015-11-17,NYSE (DN),160678069,42540856,75468583,278687508,5438103822.028602,1901537067.469298,3241083528.835081,10580724418.332981,604589,113590,281310,999489
2015-11-17,NASDAQ (DQ),1266606586,436636261,639961080,2343203927,37032833331.303413,22100981993.704026,22071740435.214438,81205555760.221877,3968978,878487,2059163,6906628
2015-11-17,EDGA (J),98133885,49985139,46430568,194549592,2859796473.944983,2366499500.752394,1652139778.344796,6878435753.042173,757003,227777,384515,1369295
2015-11-17,EDGX (K),293189177,122727973,203841543,619758693,8824546640.767779,6363755425.374868,7198965919.234012,22387267985.376659,1824871,501852,1263631,3590354
2015-11-17,CHX (M),181960571,13698896,6844554,202504021,5651295621.546498,1493143086.330001,476379606.132000,7620818314.008499,407,5809,1669,7885
2015-11-17,NYSE (N),1075217794,0,0,1075217794,33674757496.044416,0.000000,0.000000,33674757496.044416,3210018,0,0,3210018
2015-11-17,NYSE Arca (P),318033573,293006336,201076830,812116739,11057926177.534579,16660609647.449786,8506824382.194015,36225360207.178380,2123559,895238,1540027,4558824
2015-11-17,NASDAQ (Q),525982991,131363451,439823090,1097169532,20773671395.355003,8250190244.861105,18607754300.800009,47631615941.016117,4349317,588911,2964590,7902818
2015-11-17,NASDAQ PSX (X),36294865,16019373,18789325,71103563,1274112242.457298,907591773.504199,776872507.762202,2958576523.723699,278812,68265,137056,484133
2015-11-17,BATS BYX (Y),159574557,78260332,72777421,310612310,4668882226.550584,3453853741.582197,2587007386.297936,10709743354.430717,1306744,357223,654612,2318579
2015-11-17,BATS BZX (Z),238952524,111344794,118327557,468624875,7941041981.589264,6902472829.227903,4907028464.114912,19750543274.932079,1945433,488676,1032536,3466645
2015-11-16,NYSE MKT (A),0,6820978,3957914,10778892,0.000000,41018691.577100,137544821.392000,178563512.969100,0,17681,21201,38882
2015-11-16,NASDAQ BX (B),77928359,32661035,39537557,150126951,2650195107.512992,1646814731.456302,1754601181.336995,6051611020.306289,672380,146272,366406,1185058
2015-11-16,NYSE (DN),144404190,40489286,73906190,258799666,4905612646.191068,1809938385.004898,3708015557.813601,10423566589.009567,547021,109861,294384,951266
2015-11-16,NASDAQ (DQ),1116540376,389460238,618930764,2124931378,35031346827.180856,19592397770.357740,24276287306.473253,78900031904.011849,3852162,870367,2099694,6822223
2015-11-16,EDGA (J),85927412,48105185,43468956,177501553,2511455227.368106,2241141358.369804,1693203384.513504,6445799970.251414,707687,221946,363501,1293134
2015-11-16,EDGX (K),255998506,113392280,198068049,567458835,8065069576.503932,5837591329.743101,7689460414.592920,21592121320.839953,1632629,469661,1233300,3335590
2015-11-16,CHX (M),90487024,12347557,4398222,107232803,2924983370.598000,1177942358.972500,297990157.892500,4400915887.463000,599,5510,1892,8001
2015-11-16,NYSE (N),865912063,0,0,865912063,29959621190.048091,0.000000,0.000000,29959621190.048091,2951825,0,0,2951825
2015-11-16,NYSE Arca (P),256626478,265434583,199167910,721228971,9172014175.634018,15635552900.534937,9224507678.983666,34032074755.152621,1844926,824490,1484926,4154342
2015-11-16,NASDAQ (Q),459045069,126691733,442111806,1027848608,18425541930.649130,7759345271.891623,20991955506.971818,47176842709.512571,3815592,579762,2938307,7333661
2015-11-16,NASDAQ PSX (X),32844473,14707805,17595512,65147790,1160390522.138901,789477802.365400,767094666.224700,2716962990.729001,254149,68244,125774,448167
2015-11-16,BATS BYX (Y),144562798,70560947,71201320,286325065,4251943593.224592,2971441967.026803,2703361441.129776,9926747001.381171,1206569,324466,623764,2154799
2015-11-16,BATS BZX (Z),216122317,100324167,110928156,427374640,7166174952.521638,6286652335.256091,4917816521.356750,18370643809.134479,1747528,459210,971909,3178647
2015-11-13,NYSE MKT (A),0,7231035,3165540,10396575,0.000000,42160738.463300,97746292.140000,139907030.603300,0,20068,17046,37114
2015-11-13,NASDAQ BX (B),88920485,36734274,43248156,168902915,2988983734.068904,1923231091.484600,1866090415.640398,6778305241.193902,746779,163860,388254,1298893
2015-11-13,NYSE (DN),171815555,48692943,84517947,305026445,5747706967.233798,2378595704.883498,3821601827.628773,11947904499.746069,629287,130998,301241,1061526
2015-11-13,NASDAQ (DQ),1297118284,472451442,662818109,2432387835,39716293318.942964,25074803069.596558,24482999450.761216,89274095839.300738,4190206,1016200,2172701,7379107
2015-11-13,EDGA (J),98755109,56925585,50848052,206528746,2838007492.361794,2920889814.887092,1787452060.037898,7546349367.286784,772861,257478,403633,1433972
2015-11-13,EDGX (K),288704214,141711257,225745569,656161040,8903042786.675705,7248248643.047329,8495519553.810287,24646810983.533321,1799402,575620,1346919,3721941
2015-11-13,CHX (M),130713212,17387294,5091736,153192242,4337010506.002701,2041729027.253002,410071056.550000,6788810589.805703,2238,8953,2677,13868
2015-11-13,NYSE (N),947919841,0,0,947919841,32482605292.564677,0.000000,0.000000,32482605292.564677,3109896,0,0,3109896
2015-11-13,NYSE Arca (P),301713357,319220359,227278631,848212347,10874040361.041940,18596021295.657449,10063410136.432514,39533471793.131903,2076360,1002782,1602519,4681661
2015-11-13,NASDAQ (Q),521362519,158567190,474868841,1154798550,21224965294.617381,10289555593.721923,21223458372.057487,52737979260.396791,4293693,692113,3084609,8070415
2015-11-13,NASDAQ PSX (X),38065053,17893028,20390284,76348365,1372521285.541696,989267763.164599,829646579.797600,3191435628.503895,293766,78577,142053,514396
2015-11-13,BATS BYX (Y),162895107,80114858,76500179,319510144,4715690612.986679,3507465063.425000,2800640325.720073,11023796002.131752,1308140,357725,673577,2339442
2015-11-13,BATS BZX (Z),235770561,126398977,132801375,494970913,7797457949.979788,7992954309.164802,5865869825.512168,21656282084.656758,1915892,555078,1114819,3585789
2015-11-12,NYSE MKT (A),0,6817432,3006772,9824204,0.000000,39226910.560000,82337875.995200,121564786.555200,0,20295,14717,35012
2015-11-12,NASDAQ BX (B),83115609,34628507,37371451,155115567,2833902769.193700,1684590465.239896,1517621564.515504,6036114798.949100,713199,151046,339480,1203725
2015-11-12,NYSE (DN),158661966,42097499,75438386,276197851,5425426110.231985,1905204954.104497,2978275242.517404,10308906306.853886,609346,112834,281484,1003664
2015-11-12,NASDAQ (DQ),1231541358,452878635,630289751,2314709744,38515961317.953996,22507792384.601289,21027481246.331000,82051234948.886285,4072375,885362,1990615,6948352
2015-11-12,EDGA (J),92684716,49815832,45797903,188298451,2750693660.035397,2334530859.294397,1486625442.089495,6571849961.419289,729505,220909,356788,1307202
2015-11-12,EDGX (K),264943440,134676276,197684781,597304497,8161219174.781636,7119722026.751092,6806372289.278705,22087313490.811433,1667673,496645,1196118,3360436
2015-11-12,CHX (M),154461412,14007242,4299749,172768403,5002798234.454801,1889808997.160001,286859399.985000,7179466631.599802,538,6616,1844,8998
2015-11-12,NYSE (N),878775369,0,0,878775369,30246688041.767497,0.000000,0.000000,30246688041.767497,3058419,0,0,3058419
2015-11-12,NYSE Arca (P),281328834,280113097,206052477,767494408,10233318896.505344,15714309312.558712,8167769665.072604,34115397874.136660,1976075,855015,1428069,4259159
2015-11-12,NASDAQ (Q),465923612,137624050,416839274,1020386936,19177118169.671320,8346384794.566485,17467311041.072077,44990814005.309882,3914944,575512,2745930,7236386
2015-11-12,NASDAQ PSX (X),35415561,15279384,18507551,69202496,1257066268.077398,830321206.572700,718057690.268098,2805445164.918196,274050,63983,128215,466248
2015-11-12,BATS BYX (Y),157326190,71203474,71658368,300188032,4726540713.189276,2952184556.308199,2485412057.771924,10164137327.269399,1309909,313204,625196,2248309
2015-11-12,BATS BZX (Z),219088368,111675921,117692411,448456700,7362405667.181212,6980284668.204982,4727702891.069366,19070393226.455560,1842929,476048,1002679,3321656
2015-11-11,NYSE MKT (A),0,5848580,2594251,8442831,0.000000,44344465.294500,84841961.220000,129186426.514500,0,18893,13314,32207
2015-11-11,NASDAQ BX (B),71629911,23561405,35944983,131136299,2384122798.613788,1073299569.518000,1490852083.689605,4948274451.821393,618849,107380,319450,1045679
2015-11-11,NYSE (DN),154378565,31217364,71473701,257069630,5071329288.619186,1374720847.422401,3096616396.755704,9542666532.797291,578451,86897,266522,931870
2015-11-11,NASDAQ (DQ),1165678592,301414572,586921652,2054014816,34757014872.383309,13239645301.243965,21435055825.117702,69431715998.744976,3836685,667662,1947534,6451881
2015-11-11,EDGA (J),82640047,34024037,39637978,156302062,2354129945.228702,1557259904.419501,1428605096.806299,5339994946.454502,656097,157949,322979,1137025
2015-11-11,EDGX (K),245511787,86687049,182175874,514374710,7263686567.694982,4039459237.626013,6570281485.812251,17873427291.133246,1511728,337439,1090923,2940090
2015-11-11,CHX (M),97229562,8097892,6499689,111827143,3015185404.914200,871171280.500000,448737417.936000,4335094103.350200,388,3705,1437,5530
2015-11-11,NYSE (N),809180487,0,0,809180487,26934922384.147818,0.000000,0.000000,26934922384.147818,2707474,0,0,2707474
2015-11-11,NYSE Arca (P),264322483,193395896,188014144,645732523,9015575015.116753,10316105238.577408,8205619371.873598,27537299625.567759,1777926,589300,1359011,3726237
2015-11-11,NASDAQ (Q),437515574,91050223,384155619,912721416,17032906464.805972,5430400263.900802,16556815252.186598,39020121980.893372,3541374,403191,2526801,6471366
2015-11-11,NASDAQ PSX (X),31572461,10692374,16178623,58443458,1094654700.509500,542483134.101700,677151380.877697,2314289215.488897,237307,45317,113377,396001
2015-11-11,BATS BYX (Y),138813851,48711285,62522501,250047637,3927235717.017456,1966509850.559497,2231566514.240520,8125312081.817473,1149302,220633,544641,1914576
2015-11-11,BATS BZX (Z),197366279,73563999,102462254,373392532,6435159167.219930,4442810982.286283,4387496340.955932,15265466490.462145,1613594,332539,868050,2814183
2015-11-10,NYSE MKT (A),0,6634496,4172842,10807338,0.000000,52348526.866100,138337599.041900,190686125.908000,0,21453,17735,39188
2015-11-10,NASDAQ BX (B),78376938,29606655,41394810,149378403,2724983629.929802,1437761634.330200,1681095481.933401,5843840746.193403,684131,133041,371317,1188489
2015-11-10,NYSE (DN),154757608,35144405,81602402,271504415,5360947172.525877,1430872272.509301,3436093001.349392,10227912446.384570,590383,99104,291256,980743
2015-11-10,NASDAQ (DQ),1186607438,379821627,684100695,2250529760,37021752053.822151,17545969514.689402,25282149250.774975,79849870819.286528,4003605,746574,2122719,6872898
2015-11-10,EDGA (J),91305265,40854160,45564580,177724005,2679618400.605601,1929098465.196699,1694206391.850896,6302923257.653196,740960,186495,374149,1301604
2015-11-10,EDGX (K),249314043,95667200,196450813,541432056,7896125542.680174,4661152625.792094,7202936450.777988,19760214619.250256,1597624,389555,1209277,3196456
2015-11-10,CHX (M),100143770,10078285,6567876,116789931,3210065441.935300,967674100.169600,486118458.120000,4663858000.224900,618,4289,1418,6325
2015-11-10,NYSE (N),845438282,0,0,845438282,29117125622.756021,0.000000,0.000000,29117125622.756021,2931934,0,0,2931934
2015-11-10,NYSE Arca (P),269449392,221467675,198899764,689816831,9763866290.418637,12143735404.737780,8603336514.093765,30510938209.250182,1914766,691851,1477226,4083843
2015-11-10,NASDAQ (Q),458614863,110470514,451335280,1020420657,18347929838.560018,6690909890.127299,19637593905.176935,44676433633.864252,3857608,488167,2793448,7139223
2015-11-10,NASDAQ PSX (X),33935068,12338158,16936675,63209901,1165650649.081101,651118396.895000,665166671.548201,2481935717.524302,256316,56438,128323,441077
2015-11-10,BATS BYX (Y),153067167,59380767,76680262,289128196,4472074384.189506,2298528915.192395,2666025227.965894,9436628527.347795,1270570,264174,668543,2203287
2015-11-10,BATS BZX (Z),202813330,89891458,105654112,398358900,6661575872.983793,5608381684.536624,4386428799.217842,16656386356.738259,1660391,388912,905492,2954795
2015-11-09,NYSE MKT (A),0,8402080,3109467,11511547,0.000000,70581375.700000,98393981.661000,168975357.361000,0,22828,16861,39689
2015-11-09,NASDAQ BX (B),79449245,36405444,40045424,155900113,2839786584.421716,1802656007.237899,1775956791.100515,6418399382.760130,721151,157804,369310,1248265
2015-11-09,NYSE (DN),142180673,42193223,79733358,264107254,5123058561.407682,1908231731.835803,3558018797.312600,10589309090.556085,565360,125329,295341,986030
2015-11-09,NASDAQ (DQ),1116047725,508215436,631384947,2255648108,36380874584.247720,30153404523.286640,23438558726.600903,89972837834.135263,4000213,955654,2135538,7091405
2015-11-09,EDGA (J),92114613,52070262,45086924,189271799,2769935240.326302,2474271260.082607,1644777267.794989,6888983768.203898,754003,223619,372973,1350595
2015-11-09,EDGX (K),254138694,118987064,201927137,575052895,7966067410.450959,5755771861.943097,7192637635.770049,20914476908.164105,1657775,481269,1233419,3372463
2015-11-09,CHX (M),58316506,15663759,4351408,78331673,1983908030.030600,1849168191.850005,336266230.944000,4169342452.824605,577,8516,1433,10526
2015-11-09,NYSE (N),973847467,0,0,973847467,33979903419.954111,0.000000,0.000000,33979903419.954111,3201515,0,0,3201515
2015-11-09,NYSE Arca (P),277737462,301472358,193644366,772854186,10080773323.848350,16201577328.501432,8745024504.408615,35027375156.758397,2029935,872243,1511992,4414170
2015-11-09,NASDAQ (Q),490245414,130676290,459355256,1080276960,19653982275.324156,8055737698.402636,20648755559.293919,48358475533.020711,4191456,597899,2993030,7782385
2015-11-09,NASDAQ PSX (X),36662570,14792547,16849249,68304366,1295732870.804303,803117310.404199,685269289.878899,2784119471.087401,282517,67364,125589,475470
2015-11-09,BATS BYX (Y),155762012,75280551,71464743,302507306,4633077560.464529,3236974577.079299,2545740477.562073,10415792615.105901,1326505,325859,629406,2281770
2015-11-09,BATS BZX (Z),209741721,107251957,105890383,422884061,6963865848.054143,7100631167.904118,4334108857.235916,18398605873.194177,1767886,467720,945249,3180855
2015-11-06,NYSE MKT (A),0,9310896,3107110,12418006,0.000000,52249749.956500,90432053.924000,142681803.880500,0,22718,15480,38198
2015-11-06,NASDAQ BX (B),83458525,34950801,41818416,160227742,2925323064.887700,1785748269.335500,1838372788.103905,6549444122.327105,716674,150367,382263,1249304
2015-11-06,NYSE (DN),176328362,43869818,93248171,313446351,6441130183.930234,1879604529.716204,4054792393.001997,12375527106.648435,650634,123930,331144,1105708
2015-11-06,NASDAQ (DQ),1341222975,423827647,710539140,2475589762,42440210866.368013,19792061457.020336,26030405567.719520,88262677891.107869,4406680,945643,2348475,7700798
2015-11-06,EDGA (J),102586346,50564852,48765449,201916647,3057296567.825120,2495803072.753698,1798184424.011899,7351284064.590717,806913,222813,403774,1433500
2015-11-06,EDGX (K),282172725,128855176,223617486,634645387,8956755307.450212,6437243555.653132,8051779068.244548,23445777931.347892,1782782,488521,1372444,3643747
2015-11-06,CHX (M),70645082,12182377,5732487,88559946,2241369165.235800,1615159697.255000,462256558.388000,4318785420.878800,405,6440,1739,8584
2015-11-06,NYSE (N),1006333460,0,0,1006333460,34439165879.510504,0.000000,0.000000,34439165879.510504,3302804,0,0,3302804
2015-11-06,NYSE Arca (P),326697693,309812226,225343308,861853227,11662632407.021847,17347560361.781244,9891939474.397831,38902132243.200922,2199462,890039,1705426,4794927
2015-11-06,NASDAQ (Q),535934368,139551353,496495387,1171981108,21802367069.339344,8544965356.753900,21487055392.143055,51834387818.236299,4445677,605053,3297592,8348322
2015-11-06,NASDAQ PSX (X),40051958,15593708,21094928,76740594,1379935132.372498,866928823.859600,839134797.466003,3085998753.698101,293484,69471,152671,515626
2015-11-06,BATS BYX (Y),168657703,78021106,77669881,324348690,4842033906.835318,3259246113.681192,2765181657.182428,10866461677.698938,1363234,322289,683678,2369201
2015-11-06,BATS BZX (Z),238170131,110745642,121797734,470713507,7788396036.078337,6913516858.746912,5194500315.443279,19896413210.268528,1900937,457454,1071836,3430227
2015-11-05,NYSE MKT (A),0,7670246,3267558,10937804,0.000000,58782408.145900,103146122.374500,161928530.520400,0,23096,16436,39532
2015-11-05,NASDAQ BX (B),79949777,29879281,41456828,151285886,2814496899.702011,1291837747.617799,1807721142.753508,5914055790.073318,683686,130985,371145,1185816
2015-11-05,NYSE (DN),165352500,36823375,99951321,302127196,5980835154.677972,1529072541.463198,4789451420.883012,12299359117.024182,628508,106094,359723,1094325
2015-11-05,NASDAQ (DQ),1256649276,415272020,719961738,2391883034,39439793474.968956,18707750240.287438,27531293119.494732,85678836834.751126,4209551,830675,2404600,7444826
2015-11-05,EDGA (J),99219119,43718794,47795485,190733398,2867815835.842704,1947695538.778399,1741853760.958997,6557365135.580100,781691,193893,392611,1368195
2015-11-05,EDGX (K),263263769,109185171,228130937,600579877,8427630802.607163,4936070688.431195,8336069190.633967,21699770681.672325,1721873,426540,1363458,3511871
2015-11-05,CHX (M),67743422,12653505,7636373,88033300,2148100165.779000,1190694091.670000,435724458.956100,3774518716.405100,643,5603,1563,7809
2015-11-05,NYSE (N),895105212,0,0,895105212,30833748174.332098,0.000000,0.000000,30833748174.332098,3162769,0,0,3162769
2015-11-05,NYSE Arca (P),291624386,247347714,220990886,759962986,10477386053.945313,12577539885.954238,10291934798.271313,33346860738.170864,2061176,736168,1687941,4485285
2015-11-05,NASDAQ (Q),522892595,113058272,475910488,1111861355,21060191641.532223,6286102562.418602,21400369702.436155,48746663906.386980,4332809,513087,3206583,8052479
2015-11-05,NASDAQ PSX (X),35093505,12456388,19674522,67224415,1254029223.392698,660102056.620700,823799576.520901,2737930856.534299,271544,58064,144496,474104
2015-11-05,BATS BYX (Y),162247162,65760646,74532153,302539961,4616226911.434296,2570300437.707304,2733171185.356494,9919698534.498094,1284231,280727,655246,2220204
2015-11-05,BATS BZX (Z),215368771,93677052,121107877,430153700,7108080923.257451,5442240834.458490,5190543665.486024,17740865423.201965,1746003,402829,1053019,3201851
2015-11-04,NYSE MKT (A),0,8318089,3965444,12283533,0.000000,54533630.700200,119708746.619000,174242377.319200,0,21440,20551,41991
2015-11-04,NASDAQ BX (B),81438155,33654730,43269559,158362444,2818539468.304898,1582307406.426501,1817201174.878503,6218048049.609902,702007,144577,382442,1229026
2015-11-04,NYSE (DN),156498638,38836990,94259726,289595354,5487080119.170744,1640459737.985503,3842909699.014073,10970449556.170320,573916,108054,326402,1008372
2015-11-04,NASDAQ (DQ),1277224005,394037588,749143868,2420405461,41192925967.404331,20387823620.020524,27303469936.369778,88884219523.794633,4317072,847929,2385986,7550987
2015-11-04,EDGA (J),95431692,46888847,48816951,191137490,2814330429.873486,2195868906.293999,1643689250.519698,6653888586.687183,763578,210995,385927,1360500
2015-11-04,EDGX (K),274330526,110630131,235028443,619989100,8805433763.441287,5371187471.971102,8631101757.991458,22807722993.403847,1804123,441613,1386799,3632535
2015-11-04,CHX (M),52282302,11261832,6683603,70227737,1665620665.840600,1271645727.680000,467549493.615900,3404815887.136500,436,5168,1437,7041
2015-11-04,NYSE (N),934492991,0,0,934492991,32890047348.514689,0.000000,0.000000,32890047348.514689,3242496,0,0,3242496
2015-11-04,NYSE Arca (P),291439048,264771285,218642480,774852813,10373243771.194474,14565050841.967061,9833347225.679106,34771641838.840641,2058076,776279,1632585,4466940
2015-11-04,NASDAQ (Q),519229789,122334525,488296121,1129860435,20988600365.894896,7191925398.127414,21405376290.708351,49585902054.730661,4378179,545060,3130692,8053931
2015-11-04,NASDAQ PSX (X),35003363,13495939,20235875,68735177,1254106281.724198,708035619.549600,839876277.622601,2802018178.896399,278132,60630,142554,481316
2015-11-04,BATS BYX (Y),158559481,68424289,79814238,306798008,4647469874.153305,2835913189.663904,2672029540.336620,10155412604.153829,1290581,300787,652224,2243592
2015-11-04,BATS BZX (Z),210868356,97150642,119874558,427893556,7020057137.952056,5896070625.805799,4985856618.890900,17901984382.648755,1733589,421720,987524,3142833
2015-11-03,NYSE MKT (A),0,9058031,3300819,12358850,0.000000,46141605.094400,101278495.806300,147420100.900700,0,20794,17864,38658
2015-11-03,NASDAQ BX (B),82697101,31514687,42019100,156230888,2896988038.723895,1426727991.549702,1741493770.548294,6065209800.821891,715849,135256,374546,1225651
2015-11-03,NYSE (DN),179192377,39477211,86190747,304860335,6145921181.231449,1791122672.524502,3638056252.045989,11575100105.801940,662999,110968,338514,1112481
2015-11-03,NASDAQ (DQ),1350357834,448755298,729821820,2528934952,42830320193.985806,23646336173.809160,25299261288.520264,91775917656.315230,4579529,885151,2389105,7853785
2015-11-03,EDGA (J),102562957,47233132,50350910,200146999,3127314625.818693,2223042037.806900,1669613766.788396,7019970430.413989,825299,208800,394420,1428519
2015-11-03,EDGX (K),288154476,110254100,227634508,626043084,8910728994.699184,5249692434.040769,7720677811.085723,21881099239.825676,1833063,418918,1340015,3591996
2015-11-03,CHX (M),75880922,13584657,4960802,94426381,2521685579.465000,1051874551.300000,340069840.915000,3913629971.680000,872,3966,1502,6340
2015-11-03,NYSE (N),936502056,0,0,936502056,32149321131.657372,0.000000,0.000000,32149321131.657372,3261374,0,0,3261374
2015-11-03,NYSE Arca (P),310279526,247439693,213198650,770917869,10896477469.952298,13740024447.934961,8869214908.747130,33505716826.634389,2126517,741869,1603266,4471652
2015-11-03,NASDAQ (Q),515686831,114744018,463993047,1094423896,20461830809.902461,6736590105.056127,19521107027.027995,46719527941.986583,4280444,483469,3015902,7779815
2015-11-03,NASDAQ PSX (X),37071392,13822516,18886427,69780335,1274304275.383293,774111626.597500,763553613.095197,2811969515.075990,287899,60949,141801,490649
2015-11-03,BATS BYX (Y),172060260,68155943,80196578,320412781,5056459056.884608,2715814093.217706,2755056183.853050,10527329333.955364,1403373,291132,672565,2367070
2015-11-03,BATS BZX (Z),224924297,96273231,114753539,435951067,7275462312.179287,5747679596.930617,4429795665.383535,17452937574.493439,1794591,391550,964073,3150214
2015-11-02,NYSE MKT (A),0,6836520,3419913,10256433,0.000000,45948183.398800,98998769.559500,144946952.958300,0,18274,18821,37095
2015-11-02,NASDAQ BX (B),77253238,27587702,39855273,144696213,2939417788.107193,1290462787.382200,1676103645.771805,5905984221.261198,701558,117073,364055,1182686
2015-11-02,NYSE (DN),164926037,42399047,88680261,296005345,5960861446.289165,1879819503.964398,3526315605.280201,11366996555.533764,629642,112577,322000,1064219
2015-11-02,NASDAQ (DQ),1155485339,441502981,666692893,2263681213,39056665862.680248,23469110510.372308,23509173904.298165,86034950277.350721,4328661,861204,2299444,7489309
2015-11-02,EDGA (J),95209633,41729884,46641376,183580893,3133833953.389601,2028387861.719898,1617738032.162208,6779959847.271707,809933,178688,373150,1361771
2015-11-02,EDGX (K),243055278,96464889,198753625,538273792,8311948887.133271,4945100196.655587,6743774827.356538,20000823911.145396,1654668,395170,1202961,3252799
2015-11-02,CHX (M),19733972,15725289,3894336,39353597,800369924.790800,1243565991.574999,266039570.818300,2309975487.184099,465,4577,1492,6534
2015-11-02,NYSE (N),868207303,0,0,868207303,31810839631.630333,0.000000,0.000000,31810839631.630333,3012523,0,0,3012523
2015-11-02,NYSE Arca (P),266477097,261174533,196216622,723868252,10390965253.595777,16202449716.664892,8141565817.641180,34734980787.901849,1958851,704860,1480673,4144384
2015-11-02,NASDAQ (Q),475742165,107077293,445481111,1028300569,19941778551.083116,6932286656.625121,19120121882.071128,45994187089.779365,4034792,461110,2896855,7392757
2015-11-02,NASDAQ PSX (X),34033673,12613557,18311789,64959019,1252067796.921401,708095832.688000,706594839.363500,2666758468.972901,275501,56514,133724,465739
2015-11-02,BATS BYX (Y),160121893,63820721,75769928,299712542,4954272916.041643,2511196013.644691,2632586739.989009,10098055669.675343,1414079,264486,641059,2319624
2015-11-02,BATS BZX (Z),204732520,83640044,108569895,396942459,7183566242.957569,5275877284.522193,4281486619.837964,16740930147.317726,1712958,350960,905073,2968991
2015-10-30,NYSE MKT (A),0,8559898,2938497,11498395,0.000000,57903014.463500,87608581.403200,145511595.866700,0,17670,17669,35339
2015-10-30,NASDAQ BX (B),85610282,28202024,43386584,157198890,3317509554.769490,1378959297.974400,1926324310.751192,6622793163.495082,748695,121892,393018,1263605
2015-10-30,NYSE (DN),164809431,38061114,91668990,294539535,6320182499.271423,1657148946.339502,3799772564.045912,11777104009.656837,650759,98882,338339,1087980
2015-10-30,NASDAQ (DQ),1233222510,406508747,676923417,2316654674,42292785530.593928,23095718964.633336,26291107407.414400,91679611902.641664,4306498,754558,2243120,7304176
2015-10-30,EDGA (J),98621265,45651400,47608367,191881032,3142615749.252499,2332480081.878200,1731116789.615005,7206212620.745704,796079,195153,379635,1370867
2015-10-30,EDGX (K),249734174,100995877,194622946,545352997,8509067591.101434,5491482801.546902,7753549139.155620,21754099531.803956,1687745,402147,1236493,3326385
2015-10-30,CHX (M),29517312,12671741,3795516,45984569,1195775975.910100,1637336292.579999,285837501.047600,3118949769.537699,441,5101,1529,7071
2015-10-30,NYSE (N),1140875665,0,0,1140875665,43651913625.659587,0.000000,0.000000,43651913625.659587,3249265,0,0,3249265
2015-10-30,NYSE Arca (P),305369076,263255125,211917829,780542030,11654484057.828882,16966483622.558230,9643307684.855881,38264275365.242993,2139538,755074,1612807,4507419
2015-10-30,NASDAQ (Q),523394653,121110716,531032638,1175538007,22679529409.752164,8269121756.865922,24265059403.969195,55213710570.587281,4361577,506093,3055691,7923361
2015-10-30,NASDAQ PSX (X),39644968,13532389,20142102,73319459,1499133579.703699,742121951.600000,775794377.176101,3017049908.479800,311830,59483,146287,517600
2015-10-30,BATS BYX (Y),166655039,67072762,79032769,312760570,5120496602.773078,2869450734.478804,2806514262.405828,10796461599.657710,1353291,276202,659827,2289320
2015-10-30,BATS BZX (Z),221239467,91825357,120566218,433631042,7787199604.373676,6383686074.391988,5163750400.757709,19334636079.523373,1795082,387724,971904,3154710
2015-10-29,NYSE MKT (A),0,6762222,2866845,9629067,0.000000,46229050.955500,83629357.504900,129858408.460400,0,17783,15473,33256
2015-10-29,NASDAQ BX (B),78442682,27562087,39933344,145938113,2894072089.425413,1205732639.632399,1854400302.492199,5954205031.550011,667514,119164,362724,1149402
2015-10-29,NYSE (DN),164085310,36296284,91590944,291972538,6215800864.844583,1407280915.362897,4262855873.965527,11885937654.173007,618323,107659,341099,1067081
2015-10-29,NASDAQ (DQ),1313616820,372014524,677555456,2363186800,41156942176.897429,18903413221.678820,25841668522.331928,85902023920.908177,4162517,800227,2261823,7224567
2015-10-29,EDGA (J),93713600,44927972,44072901,182714473,2802390550.917195,2188014286.517598,1673760656.371907,6664165493.806700,745364,199883,364309,1309556
2015-10-29,EDGX (K),260699978,109422461,206856246,576978685,8292359930.070497,5225565620.328408,7935597751.141438,21453523301.540343,1705396,429328,1290321,3425045
2015-10-29,CHX (M),23432227,10463079,9386457,43281763,1180350283.111700,1132290983.646900,630856600.502600,2943497867.261200,415,4102,1430,5947
2015-10-29,NYSE (N),871575450,0,0,871575450,30362131174.541496,0.000000,0.000000,30362131174.541496,3113432,0,0,3113432
2015-10-29,NYSE Arca (P),302624474,262564173,209318777,774507424,11568323064.426940,13879800699.656689,9342083404.740444,34790207168.824073,2098037,728363,1592210,4418610
2015-10-29,NASDAQ (Q),499053211,118160179,448448444,1065661834,20697587649.487633,6843824769.264504,19819262368.734284,47360674787.486421,4130124,524763,3029797,7684684
2015-10-29,NASDAQ PSX (X),36630609,14530065,19225120,70385794,1316715369.055099,770120466.045000,758695275.818402,2845531110.918501,286027,64713,139916,490656
2015-10-29,BATS BYX (Y),156627433,60248673,70615074,287491180,4508470973.783576,2381056517.845004,2601884448.371511,9491411940.000091,1235811,255851,598851,2090513
2015-10-29,BATS BZX (Z),213641684,92613168,113794414,420049266,7209645822.279889,5477318008.205584,4975734931.939803,17662698762.425276,1692660,393716,959319,3045695
2015-10-28,NYSE MKT (A),0,9231147,3590864,12822011,0.000000,115015996.330400,115329562.191100,230345558.521500,0,23882,19684,43566
2015-10-28,NASDAQ BX (B),94457786,42076306,44085496,180619588,3220270428.848408,1890635094.943196,1978685101.544007,7089590625.335611,770196,171720,410683,1352599
2015-10-28,NYSE (DN),182225123,53901759,94893505,331020387,6385685024.420143,2319196512.766403,4681075933.644487,13385957470.831033,686623,139556,359528,1185707
2015-10-28,NASDAQ (DQ),1446844537,493357370,720702199,2660904106,43253107818.511942,24736389834.146368,28884674218.197603,96874171870.855913,4397300,989684,2341601,7728585
2015-10-28,EDGA (J),112526338,59945827,50015751,222487916,3187287575.064696,2677590820.463210,1793636296.407005,7658514691.934911,865163,258560,409731,1533454
2015-10-28,EDGX (K),318440175,165102613,231102628,714645416,9475605359.116978,8061734887.707888,9178850873.076108,26716191119.900974,1962198,605945,1431017,3999160
2015-10-28,CHX (M),27674006,16260943,7707857,51642806,945837562.047600,1966180521.286001,575342852.894600,3487360936.228201,431,9102,2600,12133
2015-10-28,NYSE (N),1012440554,0,0,1012440554,35409225289.085833,0.000000,0.000000,35409225289.085833,3742743,0,0,3742743
2015-10-28,NYSE Arca (P),388636660,386257773,239946973,1014841406,12906752418.369616,21631154837.467406,11312692363.230980,45850599619.068002,2464592,1024509,1821016,5310117
2015-10-28,NASDAQ (Q),620656687,186121790,521292865,1328071342,23851195403.308727,10878041682.213530,23682336952.316913,58411574037.839170,4919857,791825,3552281,9263963
2015-10-28,NASDAQ PSX (X),48084640,22567806,22573493,93225939,1526103969.890402,1155471742.474500,935773668.493500,3617349380.858402,328955,93812,161541,584308
2015-10-28,BATS BYX (Y),174344397,80158247,76638272,331140916,4991044494.204064,3330153110.180294,2725331603.087495,11046529207.471853,1363984,336178,666435,2366597
2015-10-28,BATS BZX (Z),275482434,153599859,135646354,564728647,8867104389.099287,9385951178.461423,6085026500.016260,24338082067.576970,2080310,608940,1124092,3813342
2015-10-27,NYSE MKT (A),0,9425895,3673913,13099808,0.000000,48537893.510600,108940558.528600,157478452.039200,0,23555,19663,43218
2015-10-27,NASDAQ BX (B),84755855,30365360,42335255,157456470,3018649746.207908,1240766189.151399,1830304912.564104,6089720847.923411,730317,117038,383609,1230964
2015-10-27,NYSE (DN),177944035,39852263,85843659,303639957,6150861079.776389,1677283047.688999,3912266714.456069,11740410841.921457,659181,106639,343973,1109793
2015-10-27,NASDAQ (DQ),1333698104,357519743,709887419,2401105266,42783228273.687557,17478204234.976564,26483143591.000614,86744576099.664735,4274434,766612,2219600,7260646
2015-10-27,EDGA (J),96565303,40615808,46599175,183780286,3013916143.960910,1892507429.683402,1757238679.629205,6663662253.273517,788151,179596,380820,1348567
2015-10-27,EDGX (K),275355130,100298783,206336404,581990317,8612864212.024593,4805199481.886887,7930105625.938908,21348169319.850388,1755429,404188,1283873,3443490
2015-10-27,CHX (M),25051119,12885145,7260974,45197238,757339958.865000,1014490400.100000,482641136.606600,2254471495.571600,1305,3418,1407,6130
2015-10-27,NYSE (N),995042859,0,0,995042859,35275194848.156203,0.000000,0.000000,35275194848.156203,3236808,0,0,3236808
2015-10-27,NYSE Arca (P),313646485,233912869,206851576,754410930,11426348785.210643,12722011916.720183,9548736166.774739,33697096868.705565,2145986,703005,1591850,4440841
2015-10-27,NASDAQ (Q),520815035,103044692,478556133,1102415860,21080887593.628132,6333166497.224784,21638015147.652624,49052069238.505540,4270128,475571,3072011,7817710
2015-10-27,NASDAQ PSX (X),39652044,12236345,18820958,70709347,1396145776.305500,695075696.170200,794337317.939898,2885558790.415598,312811,55236,140220,508267
2015-10-27,BATS BYX (Y),150537386,56656905,72495493,279689784,4515608588.554031,2363794761.119895,2612656952.148718,9492060301.822644,1235965,247442,621400,2104807
2015-10-27,BATS BZX (Z),217834359,88134650,114549752,420518761,7221778479.797669,5552298874.259208,4910663004.769684,17684740358.826561,1732712,384321,959651,3076684
2015-10-26,NYSE MKT (A),0,6583569,2746445,9330014,0.000000,38463394.282000,72743958.002000,111207352.284000,0,17747,14907,32654
2015-10-26,NASDAQ BX (B),70100094,21305283,37504704,128910081,2581044707.220000,968632871.403400,1740177463.668584,5289855042.291984,636208,101172,347839,1085219
2015-10-26,NYSE (DN),139662620,33587197,80853886,254103703,5314754310.325701,1374348754.310399,3929842507.610476,10618945572.246576,566270,95874,317889,980033
2015-10-26,NASDAQ (DQ),999369026,359255486,595941956,1954566468,33962913376.764652,17329528338.504177,24890388066.166859,76182829781.435688,3654936,700671,2053259,6408866
2015-10-26,EDGA (J),81737388,34616390,40302056,156655834,2653315789.720196,1585825201.399201,1579859053.858800,5819000044.978197,701060,159562,347525,1208147
2015-10-26,EDGX (K),219793766,97464537,183989173,501247476,7344820096.767719,4467851457.253303,7705071164.260131,19517742718.281153,1490694,384217,1195670,3070581
2015-10-26,CHX (M),27341597,7022583,8942207,43306387,751106486.105600,743055661.520000,532955799.130000,2027117946.755600,296,3848,1552,5696
2015-10-26,NYSE (N),840871235,0,0,840871235,31168125116.833532,0.000000,0.000000,31168125116.833532,2836964,0,0,2836964
2015-10-26,NYSE Arca (P),246631023,226748759,185507534,658887316,9457690240.090021,11422559986.440199,9205269667.815366,30085519894.345586,1795442,657107,1459458,3912007
2015-10-26,NASDAQ (Q),432139406,96979757,438120313,967239476,18337025137.389285,5455512188.657693,21542347523.528320,45334884849.575298,3715614,433249,2886470,7035333
2015-10-26,NASDAQ PSX (X),32214355,12241877,18421784,62878016,1235174864.643400,614551697.900000,787945278.195799,2637671840.739199,261036,53371,133475,447882
2015-10-26,BATS BYX (Y),126970297,49676040,63722448,240368785,3970757597.614094,1898741598.540999,2472747662.338907,8342246858.494000,1082062,218841,564977,1865880
2015-10-26,BATS BZX (Z),181367089,78444863,106531272,366343224,6342471393.885904,4652148014.551201,4826924092.922130,15821543501.359235,1497679,351867,892299,2741845
2015-10-23,NYSE MKT (A),0,8340218,2861507,11201725,0.000000,42942933.747800,87572005.262800,130514939.010600,0,19956,15591,35547
2015-10-23,NASDAQ BX (B),80109384,32805653,44816944,157731981,3019216851.795486,1534985935.520199,2262440232.349508,6816643019.665193,702095,150395,405027,1257517
2015-10-23,NYSE (DN),168118884,43858555,91718378,303695817,6427342826.556778,2015813469.117698,5170289880.436105,13613446176.110581,657966,128219,369715,1155900
2015-10-23,NASDAQ (DQ),1175325932,445588704,726831793,2347746429,41301055258.806556,25280361802.101666,32790154776.459839,99371571837.368061,4285748,875191,2416088,7577027
2015-10-23,EDGA (J),95603493,47380815,51468678,194452986,3002131150.818991,2452196959.320999,2121186990.746301,7575515100.886291,773384,220694,413002,1407080
2015-10-23,EDGX (K),280230451,136389190,238382542,655002183,9594508113.937093,6968536117.046611,10661173516.141118,27224217747.124822,1909022,529137,1514370,3952529
2015-10-23,CHX (M),29714984,14563880,7693431,51972295,892630865.917000,1738146742.670001,575140363.231000,3205917971.818001,372,6779,2041,9192
2015-10-23,NYSE (N),1004850119,0,0,1004850119,38217629320.688530,0.000000,0.000000,38217629320.688530,3430182,0,0,3430182
2015-10-23,NYSE Arca (P),308461193,308129226,234898732,851489151,11804431859.335432,18455988638.637615,13101945941.638254,43362366439.611301,2231630,912575,1805127,4949332
2015-10-23,NASDAQ (Q),544088081,143529943,540885614,1228503638,23522791904.501858,9251753537.258696,28024740587.841892,60799286029.602446,4558655,607820,3461674,8628149
2015-10-23,NASDAQ PSX (X),41265804,17601622,23040949,81908375,1500678650.336200,951015013.756000,959727990.004296,3411421654.096496,320913,73463,165107,559483
2015-10-23,BATS BYX (Y),148267434,68294028,77417837,293979299,4656427807.476501,2876617948.106895,3129047003.005669,10662092758.589065,1220946,309633,672056,2202635
2015-10-23,BATS BZX (Z),234067691,116723063,139774846,490565600,8300809106.315228,7605161718.475727,6726314940.386785,22632285765.177740,1860612,492093,1112912,3465617
2015-10-22,NYSE MKT (A),0,6706389,3286579,9992968,0.000000,62332304.115200,75386713.865000,137719017.980200,0,18364,13726,32090
2015-10-22,NASDAQ BX (B),81631062,31410209,44035641,157076912,3300621853.208099,1678033216.079202,2053682321.649198,7032337390.936499,722989,139489,391826,1254304
2015-10-22,NYSE (DN),191387227,41877081,100661758,333926066,8134790206.758642,2009290381.123504,4425084967.290914,14569165555.173060,751158,120668,382080,1253906
2015-10-22,NASDAQ (DQ),1336844632,441970509,704570937,2483386078,48558804656.746818,27036662786.229314,27212523420.525578,102807990863.501710,4530761,837384,2296964,7665109
2015-10-22,EDGA (J),101814890,50020244,51230264,203065398,3438647751.734287,2805040073.247703,1936566834.093996,8180254659.075986,822314,227020,413238,1462572
2015-10-22,EDGX (K),293636091,135201845,235120070,663958006,10390781076.189538,7329602657.926810,9530597395.839401,27250981129.955749,1973271,549025,1503069,4025365
2015-10-22,CHX (M),14354690,16892700,7922365,39169755,553875628.276000,2161715052.249999,623759579.322100,3339350259.848099,395,7864,2234,10493
2015-10-22,NYSE (N),1052097202,0,0,1052097202,40379506733.219096,0.000000,0.000000,40379506733.219096,3641609,0,0,3641609
2015-10-22,NYSE Arca (P),328800479,316608422,236493554,881902455,13679647608.759032,20126617316.386592,11863783902.135710,45670048827.281334,2374858,950603,1785595,5111056
2015-10-22,NASDAQ (Q),592460542,141625064,535420011,1269505617,26693373130.418481,10002422279.054493,25174124398.985212,61869919808.458186,4806901,635752,3502435,8945088
2015-10-22,NASDAQ PSX (X),42725882,17428973,24740132,84894987,1620443509.000797,1012063843.255000,1031945567.348898,3664452919.604695,321249,75108,169822,566179
2015-10-22,BATS BYX (Y),156409326,66427277,77480115,300316718,5169532739.766720,3051567544.315202,2932987574.232312,11154087858.314234,1285316,303240,665511,2254067
2015-10-22,BATS BZX (Z),246756720,119956441,142088910,508802071,9087862394.498552,8053431862.942381,6226458931.957441,23367753189.398374,1936862,524000,1114497,3575359
2015-10-21,NYSE MKT (A),0,6668105,3281328,9949433,0.000000,46744632.102300,85700705.869400,132445337.971700,0,17734,15878,33612
2015-10-21,NASDAQ BX (B),73377883,29471736,40090350,142939969,2974213164.520313,1430949961.353500,1753905673.576397,6159068799.450210,667632,130836,378449,1176917
2015-10-21,NYSE (DN),158312134,40431252,82830119,281573505,7532029637.256275,1684687021.958099,3840455991.925062,13057172651.139436,648296,110400,323781,1082477
2015-10-21,NASDAQ (DQ),1073654377,396253320,634186530,2104094227,41752120952.344990,20339333178.867888,23950529051.083163,86041983182.296041,3903560,791694,2055762,6751016
2015-10-21,EDGA (J),84412860,46270053,44615105,175298018,2910921510.440705,2303969477.474797,1618052949.653899,6832943937.569401,706339,208026,372984,1287349
2015-10-21,EDGX (K),240142268,127447814,209623219,577213301,8620717264.104099,6209599568.157612,7461901871.279088,22292218703.540799,1631501,475024,1292843,3399368
2015-10-21,CHX (M),24849333,10441602,6487845,41778780,924429270.362800,1262699112.610000,524199146.637600,2711327529.610400,479,5626,1511,7616
2015-10-21,NYSE (N),859822962,0,0,859822962,32324821651.607622,0.000000,0.000000,32324821651.607622,3166959,0,0,3166959
2015-10-21,NYSE Arca (P),278064658,289029081,208717022,775810761,11993973616.971649,15118962556.871930,9469957348.348202,36582893522.191781,2049623,845711,1600334,4495668
2015-10-21,NASDAQ (Q),481021438,133732755,456264615,1071018808,22328681144.239891,8085506414.090087,19709468159.328159,50123655717.658137,4120979,561263,3101457,7783699
2015-10-21,NASDAQ PSX (X),34418240,16330668,20419788,71168696,1362052939.885601,852959984.433000,800865555.219900,3015878479.538501,274276,65495,141298,481069
2015-10-21,BATS BYX (Y),140301631,67294905,72507906,280104442,4558856713.283901,2718921897.078204,2573677454.990194,9851456065.352299,1186321,296486,634641,2117448
2015-10-21,BATS BZX (Z),205781364,112572826,121046643,439400833,7787486555.269342,6595109215.159182,5176032950.111903,19558628720.540427,1686786,450897,978311,3115994
2015-10-20,NYSE MKT (A),0,9291848,2633858,11925706,0.000000,57435674.455900,60170367.161900,117606041.617800,0,20507,13980,34487
2015-10-20,NASDAQ BX (B),65666973,23578538,35754928,125000439,2436531630.210600,1119309647.522900,1553084384.330107,5108925662.063607,594728,110857,309472,1015057
2015-10-20,NYSE (DN),134285535,35235714,73253902,242775151,5416050392.282679,1433667016.946299,3461966090.806512,10311683500.035490,542519,104899,295359,942777
2015-10-20,NASDAQ (DQ),1009350867,333570316,592728864,1935650047,35150918075.471488,17270969061.555770,23024154344.867739,75446041481.894997,3569724,694707,1959149,6223580
2015-10-20,EDGA (J),81107507,34524543,40698383,156330433,2693651387.599902,1666300592.622701,1553790967.454592,5913742947.677195,686561,164422,337667,1188650
2015-10-20,EDGX (K),215829646,94201150,187396994,497427790,7151961479.356296,4440400087.072404,7265731887.620598,18858093454.049298,1435265,385977,1145502,2966744
2015-10-20,CHX (M),34044826,7525242,6379283,47949351,1169814674.204200,827528796.605000,429330104.448000,2426673575.257200,674,4053,1145,5872
2015-10-20,NYSE (N),791958382,0,0,791958382,28943280514.749919,0.000000,0.000000,28943280514.749919,2781226,0,0,2781226
2015-10-20,NYSE Arca (P),238845458,219010324,177280448,635136230,9581276904.140165,11242643019.795904,8281117441.847235,29105037365.783304,1727197,660399,1346529,3734125
2015-10-20,NASDAQ (Q),419253561,97619299,406978904,923851764,18168558067.776156,5631927996.087515,18298094675.029996,42098580738.893667,3553428,433933,2660123,6647484
2015-10-20,NASDAQ PSX (X),30503494,10380530,19548547,60432571,1149487231.448600,564079018.575500,752603269.460998,2466169519.485098,246406,49368,130885,426659
2015-10-20,BATS BYX (Y),129313859,49295243,64787569,243396671,3935031808.935187,2032484540.294501,2307068791.857489,8274585141.087177,1091790,232564,539525,1863879
2015-10-20,BATS BZX (Z),185412950,79890575,106665164,371968689,6374842265.306891,4656113846.670110,4559534925.353922,15590491037.330923,1460393,355266,847864,2663523
2015-10-19,NYSE MKT (A),0,7075079,2677425,9752504,0.000000,40600520.559600,65433325.081800,106033845.641400,0,18710,13340,32050
2015-10-19,NASDAQ BX (B),64958517,24405261,33465254,122829032,2366013085.230799,1085803062.819201,1455468385.981702,4907284534.031702,584261,112648,308029,1004938
2015-10-19,NYSE (DN),136186940,36912974,74213093,247313007,4908966763.744278,1531241854.013400,3264827251.873404,9705035869.631082,533771,109850,295977,939598
2015-10-19,NASDAQ (DQ),970364490,372608469,552584015,1895556974,31806166007.757804,16592141712.164593,20500091119.048111,68898398838.970508,3445731,758408,1814470,6018609
2015-10-19,EDGA (J),84641785,37108670,38822711,160573166,2733999838.929895,1705875610.334101,1413300034.331790,5853175483.595786,713891,176251,332250,1222392
2015-10-19,EDGX (K),209531966,99092873,171304821,479929660,6666471840.981424,4714323186.133289,6253233174.607935,17634028201.722648,1374996,402280,1048676,2825952
2015-10-19,CHX (M),37380734,10234338,6174907,53789979,1278467592.992400,860722935.790000,417436466.185000,2556626994.967400,467,3915,1182,5564
2015-10-19,NYSE (N),826547629,0,0,826547629,30400577102.527756,0.000000,0.000000,30400577102.527756,2734098,0,0,2734098
2015-10-19,NYSE Arca (P),231131327,249546303,168196279,648873909,8395703362.377602,12501503573.102678,7382437470.126245,28279644405.606525,1658167,712018,1292728,3662913
2015-10-19,NASDAQ (Q),403960647,101759387,399869478,905589512,16768915235.586861,5975727847.340189,17476409436.573488,40221052519.500538,3411446,446330,2556684,6414460
2015-10-19,NASDAQ PSX (X),29760441,11928157,16530696,58219294,1093919745.798000,633653513.655000,675282363.732801,2402855623.185801,233601,56672,119290,409563
2015-10-19,BATS BYX (Y),124707420,52745308,61908767,239361495,3834685684.945410,2077882386.637501,2234415456.011279,8146983527.594190,1033042,246881,524019,1803942
2015-10-19,BATS BZX (Z),176519673,83785511,98213592,358518776,6003831145.782938,4962841417.335704,4033925231.884072,15000597795.002714,1426010,374780,809632,2610422
2015-10-16,NYSE MKT (A),0,7666158,3102700,10768858,0.000000,69727159.941600,72941680.560000,142668840.501600,0,18277,16409,34686
2015-10-16,NASDAQ BX (B),64944556,27675762,35292815,127913133,2332759226.823605,1397647037.659298,1422045034.847202,5152451299.330105,570669,122008,306378,999055
2015-10-16,NYSE (DN),133011631,36665197,72991319,242668147,4724672106.727108,1640395983.144903,2917917077.856623,9282985167.728634,514027,109786,282118,905931
2015-10-16,NASDAQ (DQ),1062780673,414072973,636050901,2112904547,35340100859.767600,20684987290.173117,21631325271.010616,77656413420.951333,3648802,792300,1913383,6354485
2015-10-16,EDGA (J),82811767,41455301,40198470,164465538,2554471184.209593,2035599440.124202,1356865918.662496,5946936542.996291,682604,188813,327005,1198422
2015-10-16,EDGX (K),231316440,109794286,187206826,528317552,7291900492.773725,5635163139.802094,6547170806.655483,19474234439.231302,1500613,426297,1136473,3063383
2015-10-16,CHX (M),21239122,14994769,6598359,42832250,917347057.020900,1362436918.008800,489107733.864800,2768891708.894500,664,4404,1331,6399
2015-10-16,NYSE (N),960433942,0,0,960433942,35970702099.568071,0.000000,0.000000,35970702099.568071,2898516,0,0,2898516
2015-10-16,NYSE Arca (P),254056226,271665178,176701820,702423224,9054716507.273578,16244461942.710783,7538894187.350236,32838072637.334597,1767728,756685,1343317,3867730
2015-10-16,NASDAQ (Q),429927677,113490332,517717263,1061135272,17459769740.688553,7351835467.224312,21248967038.696110,46060572246.608975,3580016,493248,2719866,6793130
2015-10-16,NASDAQ PSX (X),31193417,14276660,17627711,63097788,1128325635.696003,849725903.392900,653310643.173501,2631362182.262404,238654,60359,122544,421557
2015-10-16,BATS BYX (Y),129675868,56153439,63386486,249215793,3961631211.595192,2433749783.125598,2097947489.878810,8493328484.599600,1117381,260333,530015,1907729
2015-10-16,BATS BZX (Z),203153024,97872625,107144152,408169801,6868301802.049791,6156752511.428379,4371531698.219079,17396586011.697249,1604690,408365,862587,2875642
2015-10-15,NYSE MKT (A),0,8085026,2979062,11064088,0.000000,48090565.332600,72367940.351500,120458505.684100,0,21425,15961,37386
2015-10-15,NASDAQ BX (B),74102673,30867015,41208018,146177706,2621948793.383113,1588824713.815099,1737996310.883895,5948769818.082107,637315,141211,372870,1151396
2015-10-15,NYSE (DN),145907293,44221221,81744705,271873219,5390696549.620534,2030556717.866208,3588070658.348910,11009323925.835652,556208,127277,335892,1019377
2015-10-15,NASDAQ (DQ),1114199696,473564845,661333624,2249098165,36147923234.293170,25544552246.200852,23950341376.145734,85642816856.639756,3740601,883243,2103782,6727626
2015-10-15,EDGA (J),89719597,48978388,47556273,186254258,2686341564.913904,2419506259.257596,1658836316.883382,6764684141.054882,727752,226110,387600,1341462
2015-10-15,EDGX (K),238890179,125480740,210171498,574542417,7479566854.847610,6387160000.890415,7487959802.345794,21354686658.083819,1512833,490104,1258896,3261833
2015-10-15,CHX (M),17596645,15571120,11617412,44785177,649926078.403000,1556852483.823999,419661468.839700,2626440031.066699,449,5562,1852,7863
2015-10-15,NYSE (N),955522540,0,0,955522540,33747314728.645318,0.000000,0.000000,33747314728.645318,3060042,0,0,3060042
2015-10-15,NYSE Arca (P),277022304,297631080,201216190,775869574,9994499046.011280,17831683912.391044,9031030506.518056,36857213464.920380,1898535,884488,1528211,4311234
2015-10-15,NASDAQ (Q),466074586,129071854,472854450,1068000890,19018753709.645589,8263626814.482370,20932841995.498056,48215222519.626015,3761526,563063,3003982,7328571
2015-10-15,NASDAQ PSX (X),35921312,14106201,20678405,70705918,1250534728.789101,796426262.355800,805696825.615602,2852657816.760503,266697,60291,150831,477819
2015-10-15,BATS BYX (Y),142423570,64600295,73433249,280457114,4116548446.148924,2793257964.270195,2498999623.774880,9408806034.193999,1171183,302207,621369,2094759
2015-10-15,BATS BZX (Z),221002170,116623227,123766478,461391875,7294305656.791622,7022957528.139140,5222526914.300922,19539790099.231684,1670431,479453,989594,3139478
2015-10-14,NYSE MKT (A),0,7441641,2774697,10216338,0.000000,42314284.505700,67203773.382600,109518057.888300,0,20145,15245,35390
2015-10-14,NASDAQ BX (B),70344546,32337277,39186713,141868536,2442349265.885088,1434041894.013798,1654610448.933598,5531001608.832484,599020,142055,349325,1090400
2015-10-14,NYSE (DN),148655635,44156807,85251006,278063448,5509756742.147823,1859573939.743097,3731918303.458999,11101248985.349919,590106,127129,360034,1077269
2015-10-14,NASDAQ (DQ),1079218292,450721039,633599450,2163538781,35369067455.357493,20302297360.676875,23299486395.547249,78970851211.581617,3588734,841430,2078030,6508194
2015-10-14,EDGA (J),89849528,50002887,46659340,186511755,2591775153.281904,2325512407.532900,1572005381.710203,6489292942.525007,697140,227405,363580,1288125
2015-10-14,EDGX (K),233184277,126514425,205764065,565462767,7280140437.472135,6219243374.885498,7703913794.472116,21203297606.829749,1491815,489662,1286701,3268178
2015-10-14,CHX (M),8241402,10943992,5828180,25013574,382721695.631900,1049894970.349999,298488557.998000,1731105223.979899,426,5214,1736,7376
2015-10-14,NYSE (N),886776279,0,0,886776279,30995699399.747543,0.000000,0.000000,30995699399.747543,3065387,0,0,3065387
2015-10-14,NYSE Arca (P),280557300,299037961,206166304,785761565,10268819757.753556,15195561006.032112,9417333791.750330,34881714555.535998,1956191,855544,1560922,4372657
2015-10-14,NASDAQ (Q),462037374,129716201,462046042,1053799617,18824703537.833244,7980954212.540910,20079090815.797239,46884748566.171393,3795158,582876,3075712,7453746
2015-10-14,NASDAQ PSX (X),34321663,16108690,21017581,71447934,1179559532.209400,878892121.017501,765499798.026001,2823951451.252902,255221,66346,140307,461874
2015-10-14,BATS BYX (Y),142459202,65808996,71844347,280112545,4032833434.912766,2576709259.997498,2471168554.620583,9080711249.530847,1145138,294240,606560,2045938
2015-10-14,BATS BZX (Z),220970149,117531107,126762025,465263281,7307432243.451429,6985737857.833479,5311592958.728407,19604763060.013315,1689962,485679,1017837,3193478
2015-10-13,NYSE MKT (A),0,7293499,2486791,9780290,0.000000,40309298.802600,55338033.313000,95647332.115600,0,18760,12185,30945
2015-10-13,NASDAQ BX (B),67698218,26599891,32737885,127035994,2359712786.201202,1258200614.553900,1405727060.352401,5023640461.107503,583327,125545,300503,1009375
2015-10-13,NYSE (DN),127166514,42636537,64803258,234606309,4546572680.443683,1730770277.712101,2825361110.031404,9102704068.187188,513680,117502,264090,895272
2015-10-13,NASDAQ (DQ),1022911451,405558540,542986158,1971456149,32662938975.696164,18331381964.689066,19148311909.246761,70142632849.631991,3273857,772461,1728601,5774919
2015-10-13,EDGA (J),84573689,45504285,38052116,168130090,2501109201.932511,2147039642.092297,1316751779.518803,5964900623.543611,673536,212137,310255,1195928
2015-10-13,EDGX (K),201233112,115255016,167042910,483531038,6298179855.921408,5759555543.698618,5936124932.331888,17993860331.951914,1324233,461156,1044746,2830135
2015-10-13,CHX (M),12382593,8052103,4525673,24960369,393934034.559600,747950623.180000,300195561.268000,1442080219.007600,373,3519,1542,5434
2015-10-13,NYSE (N),858262332,0,0,858262332,30427234506.176726,0.000000,0.000000,30427234506.176726,2753880,0,0,2753880
2015-10-13,NYSE Arca (P),256461752,267143855,164331145,687936752,8976454321.900571,14517881086.918228,7262615268.072686,30756950676.891485,1739414,800926,1270779,3811119
2015-10-13,NASDAQ (Q),409992380,114872706,377702999,902568085,16515461790.780967,6972182974.537296,16613717691.591589,40101362456.909852,3376060,502997,2469193,6348250
2015-10-13,NASDAQ PSX (X),30151196,14243813,15742770,60137779,1060189397.098199,758562358.749001,596697822.685800,2415449578.533000,226898,58300,112645,397843
2015-10-13,BATS BYX (Y),138852481,57122633,59754886,255730000,3992587992.626717,2380387712.148497,2059633897.851805,8432609602.627019,1111190,262216,514019,1887425
2015-10-13,BATS BZX (Z),202012950,102897881,99671960,404582791,6638868246.789811,6329691997.601209,4136790436.155023,17105350680.546043,1563049,434132,833833,2831014
2015-10-12,NYSE MKT (A),0,7085870,2384964,9470834,0.000000,43334469.776800,54845390.957900,98179860.734700,0,18379,13533,31912
2015-10-12,NASDAQ BX (B),57078766,20607022,29298304,106984092,2010691696.819605,860533809.337497,1251695769.863806,4122921276.020908,518937,97279,269846,886062
2015-10-12,NYSE (DN),108916398,30999600,55431189,195347187,3765080827.521895,1155825947.225101,2454530910.372921,7375437685.119917,434285,88887,226389,749561
2015-10-12,NASDAQ (DQ),844748729,309238701,448528687,1602516117,27203071169.448915,14156111496.695366,15398716234.305461,56757898900.449742,3097164,650470,1598248,5345882
2015-10-12,EDGA (J),71381588,33061952,33735924,138179464,2154857530.600599,1427710671.356599,1172736753.991096,4755304955.948294,590568,158047,268736,1017351
2015-10-12,EDGX (K),192305419,89826511,146472943,428604873,5972965875.293125,4084537261.212593,5238644597.576914,15296147734.082632,1257003,369607,908319,2534929
2015-10-12,CHX (M),6572073,7606797,3498404,17677274,340071085.595900,625510480.530000,137081776.065000,1102663342.190900,497,2797,1074,4368
2015-10-12,NYSE (N),716463899,0,0,716463899,24968003596.755443,0.000000,0.000000,24968003596.755443,2494814,0,0,2494814
2015-10-12,NYSE Arca (P),224002556,210802797,143486069,578291422,7972343865.626403,9988646875.155077,6283400893.698774,24244391634.480254,1593518,617941,1118767,3330226
2015-10-12,NASDAQ (Q),369836302,82249169,333938895,786024366,14430922993.160871,4363103940.891001,14063239200.846769,32857266134.898641,3044937,384268,2134961,5564166
2015-10-12,NASDAQ PSX (X),25991802,10257879,13086903,49336584,902712639.370201,511513520.096100,493711746.746599,1907937906.212900,197682,44341,94355,336378
2015-10-12,BATS BYX (Y),110947978,42694009,54355787,207997774,3413457142.859502,1596010073.321701,1864267325.692729,6873734541.873932,948229,203505,465728,1617462
2015-10-12,BATS BZX (Z),167187635,72448108,82220569,321856312,5558989449.923701,3958579106.886685,3337335521.319006,12854904078.129392,1339729,330367,693034,2363130
2015-10-09,NYSE MKT (A),0,8627988,3216529,11844517,0.000000,72229470.925400,82266518.020100,154495988.945500,0,20475,15112,35587
2015-10-09,NASDAQ BX (B),68645713,29047520,35904388,133597621,2363077263.739303,1267856377.947200,1404725189.777487,5035658831.463990,597854,129813,301080,1028747
2015-10-09,NYSE (DN),138298845,40416956,76842647,255558448,4673387531.232680,1723247212.908003,3022066134.827132,9418700878.967815,536657,118525,294465,949647
2015-10-09,NASDAQ (DQ),1105710258,428133465,621190612,2155034335,33540069128.829643,23012569097.327092,21111366280.635390,77664004506.792125,3677336,815142,1948915,6441393
2015-10-09,EDGA (J),90647197,50830511,43541220,185018928,2533734186.282809,2359539377.089998,1412323965.344703,6305597528.717510,710640,218082,331672,1260394
2015-10-09,EDGX (K),242643191,124898832,190519950,558061973,7234534299.664040,6272824232.293598,6796540264.836221,20303898796.793859,1561704,488004,1136476,3186184
2015-10-09,CHX (M),12863628,11233366,5815986,29912980,586092617.760000,1069901293.640000,373130334.182600,2029124245.582600,349,3812,1213,5374
2015-10-09,NYSE (N),921636199,0,0,921636199,32360533473.024108,0.000000,0.000000,32360533473.024108,2966392,0,0,2966392
2015-10-09,NYSE Arca (P),282011227,271050911,203077350,756139488,9534242233.357274,14084127310.191730,7838179660.115730,31456549203.664734,1952153,783371,1375710,4111234
2015-10-09,NASDAQ (Q),465638468,122549191,428079130,1016266789,18044849500.084681,7196566357.025185,18185694925.240718,43427110782.350584,3766974,553382,2668169,6988525
2015-10-09,NASDAQ PSX (X),31341400,13596553,19684301,64622254,1121230310.511997,706179537.727100,627794625.437899,2455204473.676996,233356,58520,112339,404215
2015-10-09,BATS BYX (Y),138808363,57236811,69324446,265369620,3949128383.562080,2298945198.314909,2112250099.003715,8360323680.880704,1147885,262174,546415,1956474
2015-10-09,BATS BZX (Z),218652595,113409835,113163588,445226018,6954277370.175055,6836088291.193127,4420209763.564982,18210575424.933164,1700306,481128,875226,3056660
2015-10-08,NYSE MKT (A),0,7340946,2862479,10203425,0.000000,44815449.892800,81298403.992500,126113853.885300,0,19426,16057,35483
2015-10-08,NASDAQ BX (B),71575799,33334813,38857858,143768470,2480840209.592902,1652978658.665803,1757409010.904090,5891227879.162795,624098,151171,350906,1126175
2015-10-08,NYSE (DN),154357195,44320558,89444453,288122206,5221084671.052613,2132420398.599704,3865287746.783739,11218792816.436056,587325,123693,348908,1059926
2015-10-08,NASDAQ (DQ),1158528144,411849401,665547057,2235924602,35032619088.292568,21669754856.461874,24685913277.054655,81388287221.809097,3841033,870688,2142853,6854574
2015-10-08,EDGA (J),93841042,53999614,47306418,195147074,2583377704.715906,2875742017.515299,1666812685.850986,7125932408.082191,722355,247228,372431,1342014
2015-10-08,EDGX (K),276281712,146458459,222217907,644958078,8002263528.856137,8109335984.480073,8433133770.597544,24544733283.933754,1742460,579885,1335197,3657542
2015-10-08,CHX (M),14157482,13079269,8034601,35271352,467230802.063600,1500527126.490000,384099947.133800,2351857875.687400,1783,5383,2233,9399
2015-10-08,NYSE (N),919969985,0,0,919969985,30968389327.834753,0.000000,0.000000,30968389327.834753,3221156,0,0,3221156
2015-10-08,NYSE Arca (P),315265457,308923215,217329317,841517989,10553835187.513612,19030699506.846553,9901211155.423854,39485745849.784019,2084426,957183,1598809,4640418
2015-10-08,NASDAQ (Q),508469742,154507528,470856989,1133834259,19652127482.089892,10654891567.116060,20901967464.886269,51208986514.092221,4102855,694144,3119061,7916060
2015-10-08,NASDAQ PSX (X),38131824,16865147,20250677,75247648,1265063828.063102,934889904.146001,817281371.421400,3017235103.630503,259209,74333,136866,470408
2015-10-08,BATS BYX (Y),149985626,67953808,71666810,289606244,4220540608.859413,2976057625.285199,2526492559.679389,9723090793.824001,1236374,313855,613754,2163983
2015-10-08,BATS BZX (Z),243006562,137638351,134307673,514952586,7761251215.990371,9541573673.552724,5934370389.267933,23237195278.811028,1872914,578472,1067458,3518844
2015-10-07,NYSE MKT (A),0,10161581,2780897,12942478,0.000000,87984119.174600,50088078.175000,138072197.349600,0,24737,12341,37078
2015-10-07,NASDAQ BX (B),87627943,37539253,44754562,169921758,3066032677.064810,1645279992.676700,1831923525.881002,6543236195.622512,773309,168804,411179,1353292
2015-10-07,NYSE (DN),168896921,49059487,87328389,305284797,5633051524.784318,2248300125.243700,3747643305.215721,11628994955.243739,648724,140118,346543,1135385
2015-10-07,NASDAQ (DQ),1317269155,497676473,711060994,2526006622,39523452466.741909,23890979613.787025,25040371447.539530,88454803528.068464,4307621,966971,2142721,7417313
2015-10-07,EDGA (J),112874127,66591710,53369116,232834953,3084191501.581402,3115609993.604001,1751569602.691489,7951371097.876892,891947,290077,429567,1611591
2015-10-07,EDGX (K),328119690,159363532,227650960,715134182,9314669911.337715,7932420822.958287,8083005602.577370,25330096336.873372,2098439,659581,1435941,4193961
2015-10-07,CHX (M),35369842,13283087,5046058,53698987,1458343819.521000,1267268555.580700,261684508.915200,2987296884.016900,992,4956,1813,7761
2015-10-07,NYSE (N),1186087564,0,0,1186087564,39256296746.187809,0.000000,0.000000,39256296746.187809,3889523,0,0,3889523
2015-10-07,NYSE Arca (P),352746495,333483186,225067559,911297240,11563050719.587013,18448664482.656663,9480914489.247451,39492629691.491127,2433328,1054162,1690257,5177747
2015-10-07,NASDAQ (Q),605731541,165960270,549589286,1321281097,22872603415.325742,10379487706.565096,23684910588.117978,56937001710.008816,4890611,755609,3423488,9069708
2015-10-07,NASDAQ PSX (X),42969653,16810992,22091947,81872592,1447506846.807500,926830589.926900,785427097.111099,3159764533.845499,325012,73279,150158,548449
2015-10-07,BATS BYX (Y),164250157,78726660,79607631,322584448,4658773361.372390,3159591785.505104,2607149912.675929,10425515059.553423,1362859,348159,697740,2408758
2015-10-07,BATS BZX (Z),277792328,145675175,145887591,569355094,8780553494.824312,8725064677.213617,5869196961.611158,23374815133.649087,2175753,643412,1159159,3978324
2015-10-06,NYSE MKT (A),0,9214710,2819772,12034482,0.000000,72703749.787800,72059527.458800,144763277.246600,0,21224,13693,34917
2015-10-06,NASDAQ BX (B),77445996,36490430,43967049,157903475,2659028762.009302,1479634164.389901,1828667146.348897,5967330072.748100,675962,162789,377866,1216617
2015-10-06,NYSE (DN),164108116,45401352,87390206,296899674,5425996710.216498,2067902113.519795,3744630851.401411,11238529675.137704,634397,130519,343463,1108379
2015-10-06,NASDAQ (DQ),1247561605,431323248,717299491,2396184344,38015560765.670058,20989155336.974378,25660055034.462096,84664771137.106532,4081182,937323,2141233,7159738
2015-10-06,EDGA (J),100187204,53870852,50161230,204219286,2830647508.487200,2347705115.760100,1734627393.792503,6912980018.039803,802220,248297,399570,1450087
2015-10-06,EDGX (K),289058345,134893334,214374278,638325957,8327933786.920780,6656829132.131911,7891892243.077288,22876655162.129979,1849283,556215,1341652,3747150
2015-10-06,CHX (M),10356467,9832168,6110105,26298740,393746147.493700,1028102447.740000,273531644.658400,1695380239.892100,1046,4253,1802,7101
2015-10-06,NYSE (N),1007288465,0,0,1007288465,33931666352.894944,0.000000,0.000000,33931666352.894944,3441874,0,0,3441874
2015-10-06,NYSE Arca (P),304402882,306960738,232209008,843572628,10230137473.786005,16183783033.448928,9433098331.496470,35847018838.731403,2147931,959124,1625503,4732558
2015-10-06,NASDAQ (Q),561731689,142359851,496734901,1200826441,21464738891.383370,8619017569.330787,21787735395.159004,51871491855.873161,4542098,661472,3215355,8418925
2015-10-06,NASDAQ PSX (X),38705083,15717949,20748011,75171043,1316901275.561398,900231768.102901,764398699.838402,2981531743.502701,280942,73442,136597,490981
2015-10-06,BATS BYX (Y),155093579,69468813,81052681,305615073,4364006232.340795,2818384950.810501,2663804869.809409,9846196052.960705,1300380,327111,678953,2306444
2015-10-06,BATS BZX (Z),252447702,120534768,135383029,508365499,8170124752.045611,7468071297.421197,5589770178.498865,21227966227.965673,1985988,542038,1090754,3618780
2015-10-05,NYSE MKT (A),0,9834157,3107657,12941814,0.000000,47750473.027800,77099057.543600,124849530.571400,0,23070,13176,36246
2015-10-05,NASDAQ BX (B),81899979,39776629,41303900,162980508,2812330582.166998,1844036665.866397,1635825023.308086,6292192271.341481,735868,178444,375721,1290033
2015-10-05,NYSE (DN),161090062,55557596,86273284,302920942,5612348035.451324,2626767677.433811,3548028450.828199,11787144163.713334,638448,164237,336631,1139316
2015-10-05,NASDAQ (DQ),1264169344,534578710,660756657,2459504711,38136162729.106002,25984115328.495590,23231058810.573178,87351336868.174770,4234275,1011717,2187409,7433401
2015-10-05,EDGA (J),108238166,56914592,47586245,212739003,3069994834.225925,2764735552.984996,1572645495.528710,7407375882.739631,863873,253542,385926,1503341
2015-10-05,EDGX (K),286758705,140176138,210454661,637389504,8330789613.963912,7082628884.746711,7221777593.619559,22635196092.330182,1803630,551691,1290170,3645491
2015-10-05,CHX (M),72642841,12939014,9111955,94693810,3158626006.023400,1283943459.948000,458316182.469200,4900885648.440600,417,4893,1977,7287
2015-10-05,NYSE (N),1091723610,0,0,1091723610,37878811953.473425,0.000000,0.000000,37878811953.473425,3359253,0,0,3359253
2015-10-05,NYSE Arca (P),295184640,335826297,210104271,841115208,10189921136.141902,18765808068.824841,8747814404.216352,37703543609.183095,2115714,959085,1606173,4680972
2015-10-05,NASDAQ (Q),525850264,151706687,516167312,1193724263,20565604908.755138,9952712413.616494,21710257020.858185,52228574343.229817,4318327,655396,3011301,7985024
2015-10-05,NASDAQ PSX (X),39942054,17012806,20662945,77617805,1387813258.792500,976969181.135000,794523849.016200,3159306288.943700,310690,73798,146302,530790
2015-10-05,BATS BYX (Y),162323415,71508429,73731585,307563429,4480717385.363520,3103925378.995400,2430636539.033571,10015279303.392491,1347928,327314,647907,2323149
2015-10-05,BATS BZX (Z),254261777,135270356,131729285,521261418,8263748712.203164,8105283632.077389,5258382355.876001,21627414700.156554,1987365,558280,1066744,3612389
2015-10-02,NYSE MKT (A),0,7374690,3338916,10713606,0.000000,52559407.878800,65411956.386000,117971364.264800,0,19360,14811,34171
2015-10-02,NASDAQ BX (B),83568682,47329190,46337593,177235465,2757006089.391801,2099867958.393796,1864660501.121503,6721534548.907100,714031,201470,402467,1317968
2015-10-02,NYSE (DN),159460630,56339149,88669499,304469278,5165855923.678799,2620032310.299505,3647518647.586712,11433406881.565016,624779,164016,357029,1145824
2015-10-02,NASDAQ (DQ),1262314700,523561913,704945593,2490822206,36891598058.786491,26302981128.334737,24966489890.072491,88161069077.193719,4264718,1089109,2333040,7686867
2015-10-02,EDGA (J),102170427,68364219,53458661,223993307,2807903590.934300,3447554166.643902,1791922852.822995,8047380610.401197,796054,314951,420998,1532003
2015-10-02,EDGX (K),298737129,179784283,232492309,711013721,8698910558.372103,9896445796.142639,8859809923.499504,27455166278.014246,1870766,721215,1471007,4062988
2015-10-02,CHX (M),19493387,19875388,8900419,48269194,612314638.568000,2306003195.539600,690628981.084000,3608946815.191600,880,9355,2818,13053
2015-10-02,NYSE (N),1078516604,0,0,1078516604,36529325513.593517,0.000000,0.000000,36529325513.593517,3596072,0,0,3596072
2015-10-02,NYSE Arca (P),320612607,405016035,244205843,969834485,11012505543.082257,26166853224.711725,10977130541.019790,48156489308.813772,2279922,1205081,1841002,5326005
2015-10-02,NASDAQ (Q),573570204,193022279,547092113,1313684596,21743562657.784216,13091972426.608191,23814003298.406263,58649538382.798670,4591048,878328,3516529,8985905
2015-10-02,NASDAQ PSX (X),41796586,20340574,23321686,85458846,1391716172.538702,1285102165.910001,896842823.231799,3573661161.680502,309068,89663,163419,562150
2015-10-02,BATS BYX (Y),167014437,88514486,80785649,336314572,4519098141.289089,3778559208.093293,2692750000.951292,10990407350.333674,1321935,387299,690270,2399504
2015-10-02,BATS BZX (Z),277656694,164949623,153283781,595890098,8720909937.133919,10490670483.273039,6356624993.084607,25568205413.491565,2101724,705622,1212858,4020204
2015-10-01,NYSE MKT (A),0,8172295,3895021,12067316,0.000000,52811815.987100,89403469.539000,142215285.526100,0,20643,16490,37133
2015-10-01,NASDAQ BX (B),83626660,36986115,45336099,165948874,2927359200.312298,1703974316.617798,1774409262.072007,6405742779.002103,753207,168973,409440,1331620
2015-10-01,NYSE (DN),143859377,48003994,91877160,283740531,4909379786.020885,2630112832.566514,3646108829.490554,11185601448.077953,592576,135191,372595,1100362
2015-10-01,NASDAQ (DQ),1098375826,472883770,698507495,2269767091,34506890538.351721,24707052005.768334,23284177779.675434,82498120323.795489,4080043,951325,2265406,7296774
2015-10-01,EDGA (J),96673166,54633362,51746095,203052623,2916020597.576702,2627916196.402199,1771547000.146914,7315483794.125815,815255,262076,427618,1504949
2015-10-01,EDGX (K),259452272,142530603,211318335,613301210,8019445207.336400,7305793723.885512,7369180939.209551,22694419870.431463,1847314,591970,1384682,3823966
2015-10-01,CHX (M),15089353,13778597,6672196,35540146,650920675.643900,1305191845.000801,529427106.440000,2485539627.084701,778,5896,2624,9298
2015-10-01,NYSE (N),988069874,0,0,988069874,33914766802.524473,0.000000,0.000000,33914766802.524473,3625753,0,0,3625753
2015-10-01,NYSE Arca (P),295388354,288966118,245962658,830317130,10641622068.160920,16052179663.221027,10138093014.053630,36831894745.435577,2268331,935666,1873281,5077278
2015-10-01,NASDAQ (Q),558541747,154680146,536573564,1249795457,22202404643.096030,9991683517.770939,21801500238.927939,53995588399.794908,4833016,717399,3463077,9013492
2015-10-01,NASDAQ PSX (X),41077901,16444058,21611803,79133762,1440263222.546097,973760004.744999,815138712.479100,3229161939.770196,327528,71610,155737,554875
2015-10-01,BATS BYX (Y),158118930,75079036,82348601,315546567,4604025736.661791,3011213008.851704,2695633263.553992,10310872009.067487,1325908,337129,718048,2381085
2015-10-01,BATS BZX (Z),258640228,136330323,144885617,539856168,8477777127.521875,8608080710.639006,5821543592.002291,22907401430.163172,2082748,609171,1192123,3884042
2015-09-30,NYSE MKT (A),0,12015801,2853738,14869539,0.000000,88994783.205100,75958988.190800,164953771.395900,0,25605,13722,39327
2015-09-30,NASDAQ BX (B),91893746,45550995,48308081,185752822,3029516712.462315,2191636764.086294,1955074512.662189,7176227989.210798,793871,200183,442399,1436453
2015-09-30,NYSE (DN),168171979,51951890,99797787,319921656,5702006846.238949,2309372732.534898,3958248545.939147,11969628124.712994,687804,142947,392464,1223215
2015-09-30,NASDAQ (DQ),1299633091,517406505,801401153,2618440749,39494184739.668398,27714101699.718226,27094943810.354271,94303230249.740895,4185765,969884,2304246,7459895
2015-09-30,EDGA (J),107930967,62428018,57528566,227887551,3029373396.614510,2842734681.115300,1853379147.148403,7725487224.878213,865108,285324,453190,1603622
2015-09-30,EDGX (K),258961595,158340366,225105999,642407960,7517008536.944051,7902731096.070883,7801191162.422738,23220930795.437672,1734579,605204,1377329,3717112
2015-09-30,CHX (M),22979894,17801424,4292470,45073788,891841520.647600,1718692523.257000,239233629.016400,2849767672.921000,426,5777,1914,8117
2015-09-30,NYSE (N),1234119331,0,0,1234119331,42355646939.898737,0.000000,0.000000,42355646939.898737,3494582,0,0,3494582
2015-09-30,NYSE Arca (P),314319894,338998144,240875887,894193925,10753793932.859405,19151659988.374129,10347685185.056887,40253139106.290421,2270250,967456,1788615,5026321
2015-09-30,NASDAQ (Q),546799168,167286967,659336934,1373423069,21050751394.447642,11022414780.537917,26933741588.723216,59006907763.708775,4560001,732342,3500822,8793165
2015-09-30,NASDAQ PSX (X),40451775,17763452,22779086,80994313,1396337268.137799,1063852643.789400,866522941.718000,3326712853.645199,319027,73147,161114,553288
2015-09-30,BATS BYX (Y),175572937,79192361,86124436,340889734,4914657834.382580,3180638125.580504,2910979306.192096,11006275266.155180,1427700,340891,753236,2521827
2015-09-30,BATS BZX (Z),267084152,150923999,153949259,571957410,8402823189.162582,9202586157.573826,6218060285.004572,23823469631.740980,2032414,615729,1217573,3865716
2015-09-29,NYSE MKT (A),0,8373327,2759610,11132937,0.000000,59158701.044600,69762509.169000,128921210.213600,0,22980,13083,36063
2015-09-29,NASDAQ BX (B),86018237,40915377,48036766,174970380,2978157859.188010,1981013892.994303,1931078621.620407,6890250373.802720,765301,182016,435828,1383145
2015-09-29,NYSE (DN),162431241,51202591,101621742,315255574,5817678265.908705,2365932393.752306,4217109951.669184,12400720611.330195,679742,144397,403939,1228078
2015-09-29,NASDAQ (DQ),1167359042,475436726,739718402,2382514170,36352694843.866754,24649497926.622285,25510575934.162814,86512768704.651853,4070260,999284,2341616,7411160
2015-09-29,EDGA (J),102550613,61898834,58121293,222570740,2916655771.329099,2882673900.836302,1958223187.254194,7757552859.419595,834991,292759,467094,1594844
2015-09-29,EDGX (K),258861271,150727598,237273340,646862209,7942535948.392781,7654896069.047376,8189089083.360593,23786521100.800750,1818506,626588,1505719,3950813
2015-09-29,CHX (M),13403652,12683205,7481185,33568042,508147060.158200,1580380486.490000,399011285.202800,2487538831.851000,612,6099,2439,9150
2015-09-29,NYSE (N),1016243418,0,0,1016243418,34789675854.809262,0.000000,0.000000,34789675854.809262,3762460,0,0,3762460
2015-09-29,NYSE Arca (P),305513870,301240839,245581133,852335842,11223603791.453673,18513423886.685093,10787861365.195646,40524889043.334412,2328741,1014266,1887473,5230480
2015-09-29,NASDAQ (Q),561111478,166179784,584492430,1311783692,22381458800.214478,11019602434.758765,24036362028.465391,57437423263.438634,4818290,786312,3808495,9413097
2015-09-29,NASDAQ PSX (X),39920091,16709920,24807801,81437812,1407124320.169403,1059723220.115501,951324391.541499,3418171931.826403,313329,72198,169074,554601
2015-09-29,BATS BYX (Y),164554125,78320387,88103199,330977711,4619877564.122174,3164167288.001006,2899244044.372453,10683288896.495633,1409830,347529,781719,2539078
2015-09-29,BATS BZX (Z),261670518,145893869,161149907,568714294,8517385121.461784,9436107639.761305,6722647485.654487,24676140246.877576,2040674,636734,1311244,3988652
2015-09-28,NYSE MKT (A),0,10072882,2499048,12571930,0.000000,63036624.568600,56419136.417000,119455760.985600,0,25510,12647,38157
2015-09-28,NASDAQ BX (B),86732582,42864219,48413908,178010709,2983802932.614509,2050364708.245398,2054268565.439387,7088436206.299294,781616,195739,447948,1425303
2015-09-28,NYSE (DN),187977151,61079790,107314196,356371137,6578027231.165817,2928752601.065706,4568881390.934071,14075661223.165594,727663,179541,436658,1343862
2015-09-28,NASDAQ (DQ),1241277000,559767787,799638894,2600683681,39232266416.717744,30139533840.830450,28044099577.861047,97415899835.409241,4358769,1182088,2578483,8119340
2015-09-28,EDGA (J),107259886,65432938,58653071,231345895,3102310649.283292,2994495952.164015,1985056975.090804,8081863576.538111,867991,304032,469024,1641047
2015-09-28,EDGX (K),279910702,173238106,255301364,708450172,8693458870.462032,9056279448.953993,8849163671.821445,26598901991.237470,1886498,700193,1576564,4163255
2015-09-28,CHX (M),19356900,11646916,5394535,36398351,866335361.887000,1400830671.940001,329374909.450000,2596540943.277001,441,4871,1435,6747
2015-09-28,NYSE (N),1054236021,0,0,1054236021,36887600823.171245,0.000000,0.000000,36887600823.171245,3695907,0,0,3695907
2015-09-28,NYSE Arca (P),327296784,352539057,255945192,935781033,11669760731.838981,20900064903.920179,11411645634.972664,43981471270.731824,2355548,1093333,1924374,5373255
2015-09-28,NASDAQ (Q),560969103,175331082,594908182,1331208367,22747242452.909567,11529911611.895902,25096751560.613315,59373905625.418784,4674260,798705,3855323,9328288
2015-09-28,NASDAQ PSX (X),42360295,20499036,24558678,87418009,1458422617.610005,1318991943.184599,965288582.600901,3742703143.395505,329029,82523,172068,583620
2015-09-28,BATS BYX (Y),161028127,78020766,83087416,322136309,4530002059.544018,3302956015.754203,2906996058.558532,10739954133.856753,1358452,366908,740841,2466201
2015-09-28,BATS BZX (Z),264701868,151882136,158721867,575305871,8697805129.252761,9861563960.493022,6614485545.778845,25173854635.524628,2088964,652788,1310924,4052676
2015-09-25,NYSE MKT (A),0,9498514,3839200,13337714,0.000000,72684529.412900,113556301.328000,186240830.740900,0,21812,20637,42449
2015-09-25,NASDAQ BX (B),74891504,34514144,42842386,152248034,2462277174.548888,1685072630.417897,1834662614.204310,5982012419.171095,658251,159307,405553,1223111
2015-09-25,NYSE (DN),137689468,49795165,86641820,274126453,4838154101.792400,2643856021.948507,3735962556.862702,11217972680.603609,550750,136046,348826,1035622
2015-09-25,NASDAQ (DQ),1002878117,448890170,658481869,2110250156,31867664620.927934,23848168707.631414,24050131001.879856,79765964330.439204,3599903,899962,2209862,6709727
2015-09-25,EDGA (J),94378050,56330146,52558900,203267096,2630519208.505412,2601353691.803198,1769254912.827802,7001127813.136412,749288,259323,431580,1440191
2015-09-25,EDGX (K),237063052,140015791,219292246,596371089,7503928638.616290,7410946989.047809,7913222456.492906,22828098084.157005,1598715,570301,1379140,3548156
2015-09-25,CHX (M),14617040,13268518,5131229,33016787,558306043.560100,1460963318.090000,375160633.297300,2394429994.947400,469,5337,2128,7934
2015-09-25,NYSE (N),976964833,0,0,976964833,33531966008.286621,0.000000,0.000000,33531966008.286621,3148244,0,0,3148244
2015-09-25,NYSE Arca (P),287790889,295785479,221750492,805326860,10166108642.213083,17528222331.662840,10223060065.559993,37917391039.435916,2024781,903921,1688389,4617091
2015-09-25,NASDAQ (Q),500415437,152934983,531873110,1185223530,19775723246.192177,10123257365.744606,22458499034.044501,52357479645.981284,4101330,681440,3332081,8114851
2015-09-25,NASDAQ PSX (X),35863258,15483178,22007592,73354028,1273261894.745900,943273014.467701,848293517.448500,3064828426.662101,273056,63473,146791,483320
2015-09-25,BATS BYX (Y),137323819,64299808,74042050,275665677,3878054026.244396,2639090343.873411,2571165945.527998,9088310315.645805,1117378,295479,663071,2075928
2015-09-25,BATS BZX (Z),227526128,131854845,136640733,496021706,7655694440.232435,8598086290.222394,5785532455.989439,22039313186.444268,1774842,546569,1111010,3432421
2015-09-24,NYSE MKT (A),0,9987390,3688132,13675522,0.000000,122555374.977400,88802077.901900,211357452.879300,0,24556,20036,44592
2015-09-24,NASDAQ BX (B),79869370,50050672,39195939,169115981,2595607585.851599,1951536286.683097,1584565914.475798,6131709787.010494,688536,200050,345849,1234435
2015-09-24,NYSE (DN),152107953,60323505,80250428,292681886,5133112278.504097,2645202548.192405,3285051822.386996,11063366649.083498,614412,165696,335411,1115519
2015-09-24,NASDAQ (DQ),1162197033,556200301,655935715,2374333049,35889212876.284745,24514256862.077781,22180910563.920281,82584380302.282807,3913553,1082145,2020472,7016170
2015-09-24,EDGA (J),102106562,70163786,48992298,221262646,2753225585.047283,2958784851.324200,1612995184.163408,7325005620.534891,788419,320516,371896,1480831
2015-09-24,EDGX (K),261390631,177244073,212518292,651152996,7808061462.812744,8212159109.727190,7515544989.208655,23535765561.748589,1712223,673733,1281788,3667744
2015-09-24,CHX (M),17713563,17158830,9293380,44165773,551398766.257600,1642044035.194000,323527984.068200,2516970785.519800,823,5693,1607,8123
2015-09-24,NYSE (N),1031832537,0,0,1031832537,34602932861.707594,0.000000,0.000000,34602932861.707594,3336271,0,0,3336271
2015-09-24,NYSE Arca (P),312355001,372181309,217237847,901774157,10531382426.146150,20388893509.239144,9345201373.899345,40265477309.284639,2187541,1042802,1604542,4834885
2015-09-24,NASDAQ (Q),545754282,184380375,512260226,1242394883,20618727248.211796,11174040991.794848,21520446163.101705,53313214403.108349,4348272,770997,3061064,8180333
2015-09-24,NASDAQ PSX (X),40620723,19595866,21029474,81246063,1325817268.875298,1058172453.646600,781326435.131900,3165316157.653798,305578,77885,140340,523803
2015-09-24,BATS BYX (Y),144362556,84609417,66632535,295604508,3887654099.554884,3068964695.011588,2283605379.946486,9240224174.512958,1157060,355108,557856,2070024
2015-09-24,BATS BZX (Z),247607424,160013154,131705479,539326057,7682166666.820963,9217302355.920849,5385369484.586732,22284838507.328544,1859177,636274,1051439,3546890
2015-09-23,NYSE MKT (A),0,7339292,3668607,11007899,0.000000,57132845.525500,109509962.690000,166642808.215500,0,22926,18948,41874
2015-09-23,NASDAQ BX (B),68108781,32145867,33033508,133288156,2093111656.108997,1324174997.933798,1241106207.274507,4658392861.317302,579934,136197,289181,1005312
2015-09-23,NYSE (DN),128694946,41425740,69187443,239308129,4127885627.261385,1770610297.758998,2698391510.297598,8596887435.317981,507905,106455,270702,885062
2015-09-23,NASDAQ (DQ),911710578,402446763,546524727,1860682068,26804872025.879455,18318604381.600037,16443285441.976759,61566761849.456251,3153395,782633,1671057,5607085
2015-09-23,EDGA (J),81043311,43740369,41648193,166431873,2195816951.132998,1873174604.767501,1264155126.744900,5333146682.645399,626579,211888,306981,1145448
2015-09-23,EDGX (K),223560538,122030950,188450349,534041837,6503115043.716942,5212772418.722992,5960074014.083741,17675961476.523675,1425539,465839,1053714,2945092
2015-09-23,CHX (M),13868196,11859524,3707835,29435555,551944783.574000,955546777.455000,221235600.014400,1728727161.043400,1493,3517,933,5943
2015-09-23,NYSE (N),782642454,0,0,782642454,26164559508.041717,0.000000,0.000000,26164559508.041717,2651967,0,0,2651967
2015-09-23,NYSE Arca (P),233849827,219641298,163003763,616494888,7982894639.407220,11538209517.042104,6902404584.497396,26423508740.946720,1683077,668017,1228324,3579418
2015-09-23,NASDAQ (Q),403404227,110422590,387421846,901248663,15420907849.510378,6443914128.239276,14873763430.414460,36738585408.164114,3322616,496886,2413767,6233269
2015-09-23,NASDAQ PSX (X),30784266,11689795,15004054,57478115,1040485645.480099,600382770.592700,554462327.719400,2195330743.792199,226498,50358,101544,378400
2015-09-23,BATS BYX (Y),122937094,56118972,57064886,236120952,3254930770.595982,2077010180.869196,1920508993.599128,7252449945.064306,995291,247754,477832,1720877
2015-09-23,BATS BZX (Z),195662963,96883264,101409173,393955400,6137864587.424933,5094000522.471384,3997269388.710393,15229134498.606710,1499075,410387,815318,2724780
2015-09-22,NYSE MKT (A),0,8844196,3831406,12675602,0.000000,70243490.113500,100895752.288200,171139242.401700,0,22680,18513,41193
2015-09-22,NASDAQ BX (B),74932156,39997731,39539815,154469702,2489714365.181298,1783009767.702698,1665911756.803301,5938635889.687297,643318,177796,350368,1171482
2015-09-22,NYSE (DN),139619595,47642733,82830280,270092608,4635899291.917170,2126738289.058192,3332981085.989405,10095618666.964767,564229,128021,331555,1023805
2015-09-22,NASDAQ (DQ),1080047491,513110214,686093647,2279251352,32745411319.958602,27170686653.265270,22022991009.026922,81939088982.250794,3741470,941938,2010035,6693443
2015-09-22,EDGA (J),95164178,57696393,55351632,208212203,2691390231.487092,2565002926.002503,1742241563.384897,6998634720.874492,734333,272522,384470,1391325
2015-09-22,EDGX (K),251076815,147660614,235466679,634204108,7638589058.387307,7394331923.202488,7738200350.175986,22771121331.765781,1626944,588078,1286779,3501801
2015-09-22,CHX (M),17177869,13182516,7203598,37563983,699757519.404400,1499374144.340001,577200975.245000,2776332638.989401,874,5520,1644,8038
2015-09-22,NYSE (N),962112840,0,0,962112840,33234454759.064480,0.000000,0.000000,33234454759.064480,3098157,0,0,3098157
2015-09-22,NYSE Arca (P),294399273,308520865,208857947,811778085,10484169094.636796,16731728434.787225,9444281865.645918,36660179395.069939,2042184,891525,1521035,4454744
2015-09-22,NASDAQ (Q),489969606,142235282,510032501,1142237389,19194906824.324504,8882442574.571764,20890196691.704347,48967546090.600615,3924861,644795,2938811,7508467
2015-09-22,NASDAQ PSX (X),36493185,16026466,20339093,72858744,1232136496.048399,864900122.512100,801018205.330401,2898054823.890900,274103,66642,141491,482236
2015-09-22,BATS BYX (Y),138489022,70289182,67995084,276773288,3837839643.362277,2805771979.119305,2444288586.600592,9087900209.082174,1119951,317484,574269,2011704
2015-09-22,BATS BZX (Z),232431256,123442013,129710195,485583464,7527488461.058482,7106529897.895282,5473279242.612017,20107297601.565781,1774882,522783,1026180,3323845
2015-09-21,NYSE MKT (A),0,9696072,3317982,13014054,0.000000,64829799.639000,76582214.180000,141412013.819000,0,21946,16008,37954
2015-09-21,NASDAQ BX (B),69644645,33627004,38126691,141398340,2301263146.645504,1511315052.204299,1553412937.917887,5365991136.767690,607736,146376,347027,1101139
2015-09-21,NYSE (DN),131443000,41117865,84356504,256917369,4544029839.689223,1797128078.341203,3403946622.327295,9745104540.357721,550283,117924,322746,990953
2015-09-21,NASDAQ (DQ),937121023,400633847,697647459,2035402329,29505456319.701741,19506190163.296629,21820417190.218031,70832063673.216401,3413659,838087,2008503,6260249
2015-09-21,EDGA (J),82099653,46815423,54414566,183329642,2414837316.368287,2153915802.276706,1650629846.561503,6219382965.206496,668414,220947,386968,1276329
2015-09-21,EDGX (K),223232993,129048212,254487632,606768837,7162043901.394336,6279613634.259100,7829776127.771361,21271433663.424797,1522092,502393,1338368,3362853
2015-09-21,CHX (M),20390251,13327406,5554032,39271689,743026096.865300,1314689136.894300,363696492.270300,2421411726.029900,371,5081,1139,6591
2015-09-21,NYSE (N),821955211,0,0,821955211,28955599120.477397,0.000000,0.000000,28955599120.477397,2978383,0,0,2978383
2015-09-21,NYSE Arca (P),238538372,268088793,208655394,715282559,8899129838.311598,14223424469.292850,8513731014.736932,31636285322.341380,1822532,740487,1435953,3998972
2015-09-21,NASDAQ (Q),428926021,122952092,476154993,1028033106,17348900812.018070,8086042786.424502,19070746036.285472,44505689634.728044,3697167,564520,3014798,7276485
2015-09-21,NASDAQ PSX (X),30819348,12423203,19035516,62278067,1076995904.018397,731107383.761400,736512095.414498,2544615383.194295,247308,53368,138031,438707
2015-09-21,BATS BYX (Y),127376603,59374169,74242474,260993246,3662622269.902114,2390117510.142698,2450579665.211674,8503319445.256486,1111075,270613,640354,2022042
2015-09-21,BATS BZX (Z),202139199,103189761,126510029,431838989,6847273119.513146,6085543571.709391,4980897344.426362,17913714035.648899,1618528,452395,1018323,3089246
2015-09-18,NYSE MKT (A),0,46415033,3461123,49876156,0.000000,218402630.726200,84671615.382500,303074246.108700,0,35173,17056,52229
2015-09-18,NASDAQ BX (B),89811090,45659694,43791006,179261790,2918601951.923079,2189666830.367804,1777929006.975807,6886197789.266690,765897,202900,393631,1362428
2015-09-18,NYSE (DN),160117725,53445892,81957958,295521575,5439374905.745244,2333962207.727896,3502930991.335903,11276268104.809043,643477,147461,334923,1125861
2015-09-18,NASDAQ (DQ),1440779618,594334319,985220920,3020334857,42425201311.439316,35101956896.017413,36238297880.781370,113765456088.238099,4088434,1083208,2052775,7224417
2015-09-18,EDGA (J),120804170,70280478,60042145,251126793,3477467980.537371,3181088917.780710,2086131075.933490,8744687974.251571,948512,321875,451829,1722216
2015-09-18,EDGX (K),298152477,182978485,242000451,723131413,9539976574.080056,8902716630.426371,8223844688.410609,26666537892.917036,1972293,692802,1354130,4019225
2015-09-18,CHX (M),18273579,20305549,6088689,44667817,794803090.594400,2470828758.670000,590746233.723000,3856378082.987400,968,8013,1686,10667
2015-09-18,NYSE (N),2580230305,0,0,2580230305,91730708947.769375,0.000000,0.000000,91730708947.769375,3782365,0,0,3782365
2015-09-18,NYSE Arca (P),330717707,371718694,214673808,917110209,11586357112.806482,21496052992.920467,9748628285.306408,42831038391.033357,2365633,1072736,1605329,5043698
2015-09-18,NASDAQ (Q),561329490,183793139,1398006219,2143128848,22228546774.238725,12398612142.952160,55175784035.248387,89802942952.439272,4540149,791499,3392494,8724142
2015-09-18,NASDAQ PSX (X),43151026,16835413,21886049,81872488,1547498283.846097,1047585393.985000,851679184.640802,3446762862.471899,332138,71844,157771,561753
2015-09-18,BATS BYX (Y),178237940,87171477,83868873,349278290,5010279532.778896,3380044139.293592,2961995202.986502,11352318875.058990,1487916,383869,753790,2625575
2015-09-18,BATS BZX (Z),274958365,155122518,140235226,570316109,9232010422.517985,9739601058.218987,5978378212.043212,24949989692.780184,2115765,638236,1134670,3888671
2015-09-17,NYSE MKT (A),0,8682326,5881207,14563533,0.000000,55249100.372500,137632200.721400,192881301.093900,0,27213,28558,55771
2015-09-17,NASDAQ BX (B),83118025,49944278,41161923,174224226,2798086021.858590,2389776892.376606,1723420230.104507,6911283144.339703,708312,219733,374709,1302754
2015-09-17,NYSE (DN),145875801,59798554,70396326,276070681,4952542868.856885,2588673165.254195,3195917447.041200,10737133481.152280,572368,154894,287426,1014688
2015-09-17,NASDAQ (DQ),1115764114,598838092,578218236,2292820442,35691665678.321898,38398314519.232696,23346819745.362795,97436799942.917389,3784791,1068277,1948717,6801785
2015-09-17,EDGA (J),111161518,70031997,49264120,230457635,3172154707.324905,3121972886.611203,1832382285.446317,8126509879.382425,865718,344175,409925,1619818
2015-09-17,EDGX (K),313351295,208146678,222828665,744326638,9530818577.305355,10250636135.178279,8708065890.883336,28489520603.366970,1976631,803426,1399737,4179794
2015-09-17,CHX (M),10245652,30932634,4037468,45215754,528674304.344600,4225336126.694399,302680040.444200,5056690471.483199,366,16155,2690,19211
2015-09-17,NYSE (N),1004627498,0,0,1004627498,34929473576.050439,0.000000,0.000000,34929473576.050439,3660637,0,0,3660637
2015-09-17,NYSE Arca (P),336054282,419196026,208454572,963704880,11806612968.421438,25992752782.293455,9952702480.868071,47752068231.582964,2317828,1235807,1635235,5188870
2015-09-17,NASDAQ (Q),592620172,235697928,486868371,1315186471,22954879634.127034,16320272572.014145,22094920212.007440,61370072418.148619,4786330,1034940,3293399,9114669
2015-09-17,NASDAQ PSX (X),46053025,24497576,24395019,94945620,1596119766.993002,1372753792.962500,1029089316.718299,3997962876.673801,331810,93572,164941,590323
2015-09-17,BATS BYX (Y),155679047,83370201,72538410,311587658,4470363578.675596,3379408800.346006,2570669859.573005,10420442238.594607,1259150,382541,630583,2272274
2015-09-17,BATS BZX (Z),283559444,192641021,136144729,612345194,9338502818.559262,12064799173.346578,5863182086.377747,27266484078.283587,2190790,793755,1175081,4159626
2015-09-16,NYSE MKT (A),0,8256439,3274988,11531427,0.000000,62841294.659200,72836103.871000,135677398.530200,0,23397,14324,37721
2015-09-16,NASDAQ BX (B),74275192,36571860,34797572,145644624,2407232866.401890,1506060683.332299,1427338278.785998,5340631828.520187,634620,147252,308015,1089887
2015-09-16,NYSE (DN),134425194,49238371,65477378,249140943,4461666359.126415,1801622720.947905,2721118769.318195,8984407849.392515,527163,122652,257305,907120
2015-09-16,NASDAQ (DQ),1031844442,447208785,539102858,2018156085,30785212434.464336,20495739092.763482,18427798085.806885,69708749613.034703,3472587,836477,1780743,6089807
2015-09-16,EDGA (J),95316765,48978275,41907725,186202765,2749982831.088395,2050088388.896798,1458836939.907693,6258908159.892886,760189,221627,334559,1316375
2015-09-16,EDGX (K),257719471,131508309,195862612,585090392,7748433547.558338,5950701866.157392,7123457752.958686,20822593166.674416,1581842,487423,1138083,3207348
2015-09-16,CHX (M),15879227,17509632,5063973,38452832,490632726.513800,1433415441.364999,193337631.802000,2117385799.680799,394,5209,1438,7041
2015-09-16,NYSE (N),885343949,0,0,885343949,30592641373.353885,0.000000,0.000000,30592641373.353885,2933841,0,0,2933841
2015-09-16,NYSE Arca (P),279100015,268900050,183738971,731739036,10130067191.184280,13460323237.631326,8008133496.581487,31598523925.397093,1943961,762620,1393776,4100357
2015-09-16,NASDAQ (Q),471246544,122173343,405726365,999146252,18730126059.853974,7197137730.324600,16786348526.316600,42713612316.495174,3870995,528701,2623080,7022776
2015-09-16,NASDAQ PSX (X),36202552,14109193,17987015,68298760,1249669458.616799,740718789.569000,675087315.610496,2665475563.796295,275223,58094,124559,457876
2015-09-16,BATS BYX (Y),136394987,65529629,64337469,266262085,3804288296.736306,2448343057.168094,2134895856.976890,8387527210.881290,1121906,272578,539109,1933593
2015-09-16,BATS BZX (Z),219759321,109680388,111943500,441383209,7197480022.175094,6031514981.192217,4470927770.718254,17699922774.085565,1700336,452843,914645,3067824
2015-09-15,NYSE MKT (A),0,7123374,3851154,10974528,0.000000,49202254.366100,80921494.916900,130123749.283000,0,20523,16520,37043
2015-09-15,NASDAQ BX (B),65747923,27891390,33807761,127447074,2171292805.515294,1333978169.485700,1391390594.580397,4896661569.581391,577099,120920,295635,993654
2015-09-15,NYSE (DN),117074233,34898151,64427851,216400235,4097108731.184709,1739999439.800299,2576243534.823899,8413351705.808907,461832,95163,255868,812863
2015-09-15,NASDAQ (DQ),927790940,351541161,527767469,1807099570,29311760765.538424,19910414742.781261,18270287160.320056,67492462668.639741,3377152,725467,1783064,5885683
2015-09-15,EDGA (J),86217974,41189663,41156484,168564121,2587527788.935894,2020859241.157499,1537518963.171400,6145905993.264793,705141,195565,335495,1236201
2015-09-15,EDGX (K),226020703,108833593,186200621,521054917,7198754264.901263,5493242425.043899,6869576274.016033,19561572963.961195,1455067,427056,1113887,2996010
2015-09-15,CHX (M),14061894,16270179,4640152,34972225,529673606.014300,1695525703.159999,311585256.989600,2536784566.163899,681,4853,1623,7157
2015-09-15,NYSE (N),778615768,0,0,778615768,27355122188.620604,0.000000,0.000000,27355122188.620604,2663769,0,0,2663769
2015-09-15,NYSE Arca (P),242870949,206013255,168095799,616980003,8903532545.610055,12309027888.493936,7603438500.785133,28815998934.889124,1761742,659113,1278876,3699731
2015-09-15,NASDAQ (Q),418852247,96806567,376592891,892251705,16944023180.387309,6464354557.332201,16129077336.887637,39537455074.607147,3474070,448748,2395440,6318258
2015-09-15,NASDAQ PSX (X),32570906,10518492,17208157,60297555,1134253765.076602,612370790.370300,676035556.217699,2422660111.664601,253565,44486,119984,418035
2015-09-15,BATS BYX (Y),128371862,52645470,61055600,242072932,3599228659.627592,2265239393.991898,2132495561.641896,7996963615.261386,1053237,234769,519762,1807768
2015-09-15,BATS BZX (Z),204345813,90500441,106771746,401618000,7019549912.120595,5786712381.631806,4454563987.896008,17260826281.648409,1621698,398035,874827,2894560
2015-09-14,NYSE MKT (A),0,6867043,2651600,9518643,0.000000,58789253.104800,71200946.615000,129990199.719800,0,19136,13970,33106
2015-09-14,NASDAQ BX (B),69306430,25629159,32060167,126995756,2135702861.690799,1042844755.736698,1249900941.475902,4428448558.903399,599090,109792,283863,992745
2015-09-14,NYSE (DN),110460231,31431474,55335290,197226995,3432970939.599626,1245748599.857902,2164299000.860410,6843018540.317938,422118,84117,227467,733702
2015-09-14,NASDAQ (DQ),786570397,312709291,463480496,1562760184,22797533042.508161,14673661266.436986,15961229488.333721,53432423797.278868,2977229,622365,1610491,5210085
2015-09-14,EDGA (J),83654268,37299016,38521900,159475184,2428566386.065713,1549762180.041101,1453298753.079904,5431627319.186718,677221,172615,316759,1166595
2015-09-14,EDGX (K),200268632,96794503,167624345,464687480,6221213156.851695,4591452067.448606,6169932200.713646,16982597425.013947,1317907,384384,1018585,2720876
2015-09-14,CHX (M),24367185,8970992,3571707,36909884,616950349.260000,1160269067.800000,223291987.380000,2000511404.440000,339,4275,1215,5829
2015-09-14,NYSE (N),783199992,0,0,783199992,27366051385.611589,0.000000,0.000000,27366051385.611589,2449346,0,0,2449346
2015-09-14,NYSE Arca (P),223122657,189347175,157835506,570305338,7784453019.130827,9723401128.598919,6891655405.919459,24399509553.649205,1586071,547623,1211406,3345100
2015-09-14,NASDAQ (Q),387836368,82369654,375495133,845701155,15034082782.308113,4874766636.248991,16140995577.473137,36049844996.030241,3235693,396620,2284301,5916614
2015-09-14,NASDAQ PSX (X),31776072,9301202,16977621,58054895,1059655469.982001,449997627.644000,629465846.748398,2139118944.374399,246085,45386,121160,412631
2015-09-14,BATS BYX (Y),120617218,46054387,57362668,224034273,3356686783.439998,1718166741.131702,1900799834.536789,6975653359.108489,993002,202748,483955,1679705
2015-09-14,BATS BZX (Z),181426854,75708723,98617948,355753525,5975057524.723558,4493527422.214603,4092185705.861208,14560770652.799369,1406601,337055,799551,2543207
2015-09-11,NYSE MKT (A),0,7766325,4564864,12331189,0.000000,73995813.893700,92133210.159000,166129024.052700,0,22905,18291,41196
2015-09-11,NASDAQ BX (B),63176776,28686085,31961986,123824847,2044670766.444292,1155873073.030799,1283668684.469698,4484212523.944789,546877,121199,279080,947156
2015-09-11,NYSE (DN),125711800,38806388,67010711,231528899,4138577170.754915,1618712139.502995,2491632656.326904,8248921966.584814,503160,101379,259782,864321
2015-09-11,NASDAQ (DQ),888643432,388451232,555244207,1832338871,26979840750.758829,19354822508.447070,17900498472.356378,64235161731.562277,3133648,727875,1719472,5580995
2015-09-11,EDGA (J),84809419,42074451,41882281,168766151,2375227497.244810,1840722578.266298,1404339502.627105,5620289578.138213,669171,193370,328646,1191187
2015-09-11,EDGX (K),225680410,124265281,194752921,544698612,7057118060.957584,5689028314.547513,6610053757.720863,19356200133.225960,1450275,471914,1129863,3052052
2015-09-11,CHX (M),19968887,15893576,4475336,40337799,772198456.537000,1457598899.113000,285148161.320000,2514945516.970000,305,5743,1736,7784
2015-09-11,NYSE (N),833037853,0,0,833037853,29656041686.189133,0.000000,0.000000,29656041686.189133,2695678,0,0,2695678
2015-09-11,NYSE Arca (P),232606674,224360558,177897396,634864628,8248306391.604455,12601554515.269516,7347474676.613751,28197335583.487722,1651372,680075,1283052,3614499
2015-09-11,NASDAQ (Q),405811830,110510013,422757747,939079590,16029463525.615509,7087151775.789012,17383269198.628221,40499884500.032742,3423939,516794,2514235,6454968
2015-09-11,NASDAQ PSX (X),30886063,12924101,20093373,63903537,1089442796.537997,656024329.409600,661018237.332801,2406485363.280398,238534,51491,119609,409634
2015-09-11,BATS BYX (Y),120590615,52445238,57925218,230961071,3289305140.215325,1925744106.530803,1889782110.683596,7104831357.429724,972735,228214,482668,1683617
2015-09-11,BATS BZX (Z),191262100,96491528,111278170,399031798,6231324885.414208,5600396115.315784,4280354509.559941,16112075510.289933,1485640,414599,860511,2760750
2015-09-10,NYSE MKT (A),0,7985528,5194345,13179873,0.000000,60699151.070400,105864634.694000,166563785.764400,0,21870,20134,42004
2015-09-10,NASDAQ BX (B),70193990,40477155,35702785,146373930,2355354227.761908,1709697997.676799,1509087165.154695,5574139390.593402,594487,171517,308945,1074949
2015-09-10,NYSE (DN),123740893,44001432,67816833,235559158,4045054692.504527,2101931441.326900,2936266456.816796,9083252590.648223,513111,111341,262031,886483
2015-09-10,NASDAQ (DQ),934490618,425018147,573937749,1933446514,28861085639.103477,23052006475.979087,20642261751.611467,72555353866.694031,3349076,789502,1818939,5957517
2015-09-10,EDGA (J),94952782,55384351,47927765,198264898,2662044540.091892,2420463199.395600,1659432167.834487,6741939907.321979,735810,251051,368349,1355210
2015-09-10,EDGX (K),264568576,146174666,218516516,629259758,8261567925.867764,7198649213.295500,7739101339.125942,23199318478.289206,1723463,567872,1296728,3588063
2015-09-10,CHX (M),11775111,20511781,7767256,40054148,461717269.050000,2224928421.277501,578676542.426000,3265322232.753501,311,9217,3249,12777
2015-09-10,NYSE (N),953975752,0,0,953975752,33081390320.607501,0.000000,0.000000,33081390320.607501,3249032,0,0,3249032
2015-09-10,NYSE Arca (P),281109545,287083288,203744361,771937194,10020839399.679327,17544368655.491434,9046335657.114340,36611543712.285101,2013951,897254,1530512,4441717
2015-09-10,NASDAQ (Q),495911969,144330948,473623967,1113866884,19637204769.585581,9187217305.720620,20076311507.725149,48900733583.031350,4140165,670214,2900888,7711267
2015-09-10,NASDAQ PSX (X),38929719,15540245,22572172,77042136,1333381254.549799,899146867.300700,839575980.236700,3072104102.087199,277296,62680,144721,484697
2015-09-10,BATS BYX (Y),136696581,70910274,64390205,271997060,3864767446.134345,2732507200.075095,2336898042.017007,8934172688.226447,1108740,307064,548489,1964293
2015-09-10,BATS BZX (Z),224942983,128524892,128266177,481734052,7492543614.498200,8332758732.359192,5447133696.954185,21272436043.811577,1739154,536757,1025864,3301775
2015-09-09,NYSE MKT (A),0,7358573,4028594,11387167,0.000000,98140690.752900,83101060.189100,181241750.942000,0,21770,16937,38707
2015-09-09,NASDAQ BX (B),68784921,43981939,37597031,150363891,2211557672.785406,1936093748.628601,1579268036.032991,5726919457.446998,578710,170541,324042,1073293
2015-09-09,NYSE (DN),122325788,56096842,74277423,252700053,4065599242.815295,2211906618.301895,3233534809.441514,9511040670.558704,528258,134429,296292,958979
2015-09-09,NASDAQ (DQ),1020477189,556003727,634409175,2210890091,31332694657.327123,26148055402.531915,24517303230.094860,81998053289.953898,3492970,929692,2022787,6445449
2015-09-09,EDGA (J),88176905,60798740,47225807,196201452,2509449219.981299,2505622583.639604,1729279554.498598,6744351358.119501,699044,255629,382023,1336696
2015-09-09,EDGX (K),268141854,185978488,234920875,689041217,8297821594.993474,7642334900.312805,8599117185.131625,24539273680.437904,1745832,619450,1416016,3781298
2015-09-09,CHX (M),9847575,19056173,5413325,34317073,461379277.566900,2133334402.760004,343691746.394900,2938405426.721804,394,7936,2744,11074
2015-09-09,NYSE (N),928836786,0,0,928836786,33259886069.751055,0.000000,0.000000,33259886069.751055,3244397,0,0,3244397
2015-09-09,NYSE Arca (P),281115795,305593027,218853216,805562038,10004103133.085048,17063568867.567311,9779267927.303214,36846939927.955573,2045139,933944,1634873,4613956
2015-09-09,NASDAQ (Q),486721160,154394728,491300817,1132416705,19146664458.371389,9425628386.470913,20850690248.458706,49422983093.301008,4129541,693768,3168880,7992189
2015-09-09,NASDAQ PSX (X),35455976,17102773,22875745,75434494,1241234779.589898,1032610351.749700,870236329.020401,3144081460.359999,267473,62267,142554,472294
2015-09-09,BATS BYX (Y),134580335,88348487,67943367,290872189,3776042642.458877,2933727905.230913,2409922607.642396,9119693155.332186,1113115,320931,586495,2020541
2015-09-09,BATS BZX (Z),212983130,134397674,128989782,476370586,7201069638.194590,7980594562.482797,5572494019.190615,20754158219.868002,1715980,561192,1050822,3327994
2015-09-08,NYSE MKT (A),0,7584327,4068335,11652662,0.000000,47675216.960900,103793134.822000,151468351.782900,0,19867,17699,37566
2015-09-08,NASDAQ BX (B),70381059,37433497,35088080,142902636,2292262390.507893,1598779800.594396,1548213912.866497,5439256103.968786,596374,152376,319493,1068243
2015-09-08,NYSE (DN),121630156,50225446,67622924,239478526,4030185890.727809,1864764160.611202,3009469310.243713,8904419361.582724,516773,118534,276407,911714
2015-09-08,NASDAQ (DQ),996030228,515870215,553547085,2065447528,31495177277.476109,20101568110.976107,21110944336.096739,72707689724.548955,3662695,875950,1973727,6512372
2015-09-08,EDGA (J),86423004,52031549,43306147,181760700,2606329483.302308,2048680749.738301,1707068628.958008,6362078861.998617,698249,225540,364983,1288772
2015-09-08,EDGX (K),246926152,156532615,198507242,601966009,7976303323.779482,6385986351.114376,7649775375.401362,22012065050.295220,1606084,527857,1243707,3377648
2015-09-08,CHX (M),14000168,17091550,4582908,35674626,505917245.660000,1718282662.170001,242210274.427800,2466410182.257801,453,5374,1780,7607
2015-09-08,NYSE (N),918683076,0,0,918683076,34259453018.678912,0.000000,0.000000,34259453018.678912,2984771,0,0,2984771
2015-09-08,NYSE Arca (P),265917970,288082004,189078046,743078020,9584023026.790394,16382301198.666424,8480039461.086924,34446363686.543742,1943748,789781,1461281,4194810
2015-09-08,NASDAQ (Q),456938589,130088657,472724087,1059751333,18588740786.587302,7856801716.534285,20987447129.886867,47432989633.008454,3783546,566111,2824508,7174165
2015-09-08,NASDAQ PSX (X),35170487,14393949,20143552,69707988,1237120551.587600,756214480.500000,777783952.197102,2771118984.284702,268540,54428,138666,461634
2015-09-08,BATS BYX (Y),130932568,73901023,62565348,267398939,3813030583.941698,2569827311.901212,2213575769.831096,8596433665.674006,1092172,282908,552526,1927606
2015-09-08,BATS BZX (Z),211114333,114434712,118905691,444454736,7222515937.199797,6455319517.814398,5023900538.355297,18701735993.369492,1678358,487377,989907,3155642
2015-09-04,NYSE MKT (A),0,6917719,3789587,10707306,0.000000,60173618.152200,67489025.033000,127662643.185200,0,21019,15239,36258
2015-09-04,NASDAQ BX (B),63079392,43554059,31752725,138386176,2052431052.960891,1846840236.598901,1307071250.566999,5206342540.126791,532541,174322,274888,981751
2015-09-04,NYSE (DN),110890491,51841417,62973725,225705633,3949710363.014362,2282035950.931598,2571017477.509507,8802763791.455467,479585,125839,248138,853562
2015-09-04,NASDAQ (DQ),793037451,588943452,467820452,1849801355,25341781167.107755,31214435787.729966,17908324845.968860,74464541800.806581,3157048,909361,1646078,5712487
2015-09-04,EDGA (J),74728398,61434166,40214192,176376756,2283690533.947705,2495623419.661601,1489908155.561298,6269222109.170604,604558,261046,320584,1186188
2015-09-04,EDGX (K),220191528,166893206,180490487,567575221,6953155267.684560,7151641111.140480,6748520782.829248,20853317161.654288,1443331,565742,1091931,3101004
2015-09-04,CHX (M),14765926,28816498,8229858,51812282,651092849.319800,3878438619.760003,269077572.878500,4798609041.958303,498,10028,2229,12755
2015-09-04,NYSE (N),849462887,0,0,849462887,31727392255.504000,0.000000,0.000000,31727392255.504000,3002446,0,0,3002446
2015-09-04,NYSE Arca (P),239638861,323109134,177328167,740076162,8778679643.141297,17930421565.588678,7994530383.480281,34703631592.210256,1771017,904300,1320594,3995911
2015-09-04,NASDAQ (Q),436173650,154884360,406611176,997669186,17654373180.515610,9973552463.964908,18030415578.372543,45658341222.853061,3672131,703611,2537647,6913389
2015-09-04,NASDAQ PSX (X),32376409,16849596,18838674,68064679,1151600750.246303,962470791.553000,692661965.466800,2806733507.266103,237740,58864,118203,414807
2015-09-04,BATS BYX (Y),132304432,91371053,62366256,286041741,3822497389.764367,3097481474.339302,2141059947.029794,9061038811.133463,1107306,359223,523936,1990465
2015-09-04,BATS BZX (Z),206255796,140228909,116866345,463351050,7286295767.973455,8712977264.317100,4911876790.138512,20911149822.429067,1678437,578794,948569,3205800
2015-09-03,NYSE MKT (A),0,8622780,4057279,12680059,0.000000,55144320.179000,89627102.601000,144771422.780000,0,21971,17466,39437
2015-09-03,NASDAQ BX (B),64402691,46298085,36711137,147411913,2203923255.245403,1879150919.714301,1489213989.745696,5572288164.705400,554179,177902,303943,1036024
2015-09-03,NYSE (DN),125627104,57643648,76751613,260022365,4307389053.284202,2210828811.729999,3114995935.468495,9633213800.482696,517787,124819,291536,934142
2015-09-03,NASDAQ (DQ),938912467,627541552,555758522,2122212541,28806767982.458814,25011095210.037902,19933143303.004372,73751006495.501088,3405453,902546,1844085,6152084
2015-09-03,EDGA (J),83175551,65514108,43367577,192057236,2411434642.031299,2496356416.779403,1540639303.077506,6448430361.888208,678491,261348,345547,1285386
2015-09-03,EDGX (K),245469819,186641613,205730533,637841965,7463247419.931653,6818195564.145362,7525854190.276128,21807297174.353143,1586116,562574,1239710,3388400
2015-09-03,CHX (M),32878527,25404552,4443683,62726762,1270556870.788400,2393725886.149003,304197089.499300,3968479846.436703,645,8186,2580,11411
2015-09-03,NYSE (N),888427932,0,0,888427932,31686058914.447474,0.000000,0.000000,31686058914.447474,3259653,0,0,3259653
2015-09-03,NYSE Arca (P),268711744,326620440,193873973,789206157,9337329417.375973,18113586767.530636,8466624556.545072,35917540741.451681,1965371,970428,1442171,4377970
2015-09-03,NASDAQ (Q),483604888,169662887,464954808,1118222583,18891326628.494664,10536897203.010901,19381196337.825927,48809420169.331492,4068231,744577,2964283,7777091
2015-09-03,NASDAQ PSX (X),34586257,19744370,22162396,76493023,1182418883.288400,1049316120.732499,836508867.691799,3068243871.712698,254055,68253,131727,454035
2015-09-03,BATS BYX (Y),141703289,97858282,74620044,314181615,4005358958.187407,3133422586.934999,2470039086.804618,9608820631.927024,1184288,338373,617199,2139860
2015-09-03,BATS BZX (Z),220134541,150593651,123698129,494426321,7362297722.532576,9182141273.831478,5146419157.768815,21690858154.132869,1762936,621949,1025680,3410565
2015-09-02,NYSE MKT (A),0,10867969,4685551,15553520,0.000000,74276271.429800,82042597.187100,156318868.616900,0,26007,19177,45184
2015-09-02,NASDAQ BX (B),66523921,45972276,37391688,149887885,2288736410.793609,1858089112.065403,1555987395.495596,5702812918.354608,569927,168758,319204,1057889
2015-09-02,NYSE (DN),118000249,58683046,71415046,248098341,3966205736.566476,2288069782.281602,3009693740.879792,9263969259.727870,501434,130064,289438,920936
2015-09-02,NASDAQ (DQ),976805634,630228929,604416915,2211451478,31417467858.864896,25356057276.067742,23341311633.510685,80114836768.443323,3474712,941602,2001841,6418155
2015-09-02,EDGA (J),88273738,70532975,49245960,208052673,2648656195.797486,2674043456.463704,1789979776.817296,7112679429.078486,722782,285179,395424,1403385
2015-09-02,EDGX (K),243722117,194656231,222629342,661007690,7657705047.782816,7128747308.668811,8172900536.150776,22959352892.602403,1651498,559346,1317693,3528537
2015-09-02,CHX (M),29175873,22517574,5993664,57687111,1267852572.661000,2276766845.322800,352605628.006700,3897225045.990500,496,7924,1951,10371
2015-09-02,NYSE (N),1069583571,0,0,1069583571,39281773929.010970,0.000000,0.000000,39281773929.010970,3466237,0,0,3466237
2015-09-02,NYSE Arca (P),268348000,347096068,208366894,823810962,9579889728.666266,20114310059.003695,9095269404.483511,38789469192.153472,1996764,1015302,1552210,4564276
2015-09-02,NASDAQ (Q),477930576,171500855,504066645,1153498076,18577393766.708889,10464119262.740041,21353162401.100718,50394675430.549648,4112667,753476,3106447,7972590
2015-09-02,NASDAQ PSX (X),36844543,20281463,20665528,77791534,1233164992.900100,884100149.413101,754285383.205900,2871550525.519101,266827,73345,133304,473476
2015-09-02,BATS BYX (Y),146834878,102206336,74469977,323511191,4232694723.388117,3412113205.904895,2609293719.184637,10254101648.477649,1240195,369940,637570,2247705
2015-09-02,BATS BZX (Z),224515496,155058424,130494509,510068429,7817102315.237100,8800125416.878261,5418829650.878039,22036057382.993400,1855458,622834,1049370,3527662
2015-09-01,NYSE MKT (A),0,10302889,4862882,15165771,0.000000,76554157.242700,102089728.597800,178643885.840500,0,32204,20758,52962
2015-09-01,NASDAQ BX (B),85730185,58519597,46684390,190934172,3000685220.446980,2644674226.380497,2018308064.036701,7663667510.864178,742433,240141,412617,1395191
2015-09-01,NYSE (DN),147135063,72030005,87652667,306817735,5220257527.154269,3148149602.801699,3827699307.846089,12196106437.802057,641119,189281,365201,1195601
2015-09-01,NASDAQ (DQ),1063288242,801508523,648520122,2513316887,33504033249.606152,40248428172.482463,25518135197.430515,99270596619.519130,4121737,1295388,2309349,7726474
2015-09-01,EDGA (J),106404431,89245163,58159794,253809388,3282673248.390894,3608282844.923298,2227145914.437999,9118102007.752191,894778,375530,472985,1743293
2015-09-01,EDGX (K),322250716,228790174,244484907,795525797,10109005576.831823,9785036643.226088,9476346634.662486,29370388854.720397,2102885,773520,1532283,4408688
2015-09-01,CHX (M),10328516,28123582,4470607,42922705,410994934.362900,3958258871.566409,364159703.160400,4733413509.089709,590,14526,1775,16891
2015-09-01,NYSE (N),1154312750,0,0,1154312750,42731412341.098236,0.000000,0.000000,42731412341.098236,4478673,0,0,4478673
2015-09-01,NYSE Arca (P),345319190,478009673,252628415,1075957278,12461278361.855352,27931466135.481973,11732142619.232138,52124887116.569463,2617714,1388616,1972017,5978347
2015-09-01,NASDAQ (Q),627606341,239661152,623239825,1490507318,24922173762.345675,15610403747.822492,27127049287.165535,67659626797.333702,5362606,1067530,3958587,10388723
2015-09-01,NASDAQ PSX (X),47160281,24893546,26432701,98486528,1567454301.063898,1130438369.417298,936665581.539901,3634558252.021097,329751,96563,165245,591559
2015-09-01,BATS BYX (Y),177184400,124119308,92413724,393717432,5294819393.990786,4538489009.793188,3232974076.404119,13066282480.188093,1542587,479875,812228,2834690
2015-09-01,BATS BZX (Z),290161952,221063344,168991564,680216860,10091830327.645877,13674952072.936649,7517491753.562489,31284274154.145015,2380197,928648,1356737,4665582
2015-08-31,NYSE MKT (A),0,11211135,3797934,15009069,0.000000,82767871.818300,84562537.927000,167330409.745300,0,24316,19275,43591
2015-08-31,NASDAQ BX (B),70126237,53873803,36150633,160150673,2416632194.950898,2236241256.387999,1486884045.752604,6139757497.091501,610624,204743,319527,1134894
2015-08-31,NYSE (DN),129236168,66628802,70347609,266212579,4225812334.068292,2408592813.403705,2980860481.602899,9615265629.074896,543643,151102,280662,975407
2015-08-31,NASDAQ (DQ),1047869403,726172599,563758481,2337800483,32008666886.884531,29151723388.825848,20739105989.537530,81899496265.247909,3525876,995810,1784371,6306057
2015-08-31,EDGA (J),97665136,79030930,44178930,220874996,2859556738.177006,2998909740.124794,1617122443.557100,7475588921.858900,789368,303412,368382,1461162
2015-08-31,EDGX (K),247016856,209141695,188350246,644508797,7312239681.715889,7087825758.394078,7076762336.521924,21476827776.631891,1636142,575141,1149544,3360827
2015-08-31,CHX (M),8352448,12405844,3959387,24717679,395207281.845000,1478941949.240000,237666774.810000,2111816005.895000,1919,5584,1570,9073
2015-08-31,NYSE (N),1105699802,0,0,1105699802,40036956400.391103,0.000000,0.000000,40036956400.391103,3510897,0,0,3510897
2015-08-31,NYSE Arca (P),284945604,416052527,192218715,893216846,9679266718.979080,21577833773.383411,8280146305.984628,39537246798.347119,2154352,1028203,1488880,4671435
2015-08-31,NASDAQ (Q),486277151,171934207,524355986,1182567344,18769353561.872409,10094173538.318605,22999923687.486865,51863450787.677879,4158837,707584,2941976,7808397
2015-08-31,NASDAQ PSX (X),35409806,22833335,17080321,75323462,1216290165.694302,941176870.995401,600354300.514599,2757821337.204302,262438,79591,112342,454371
2015-08-31,BATS BYX (Y),162433757,109238258,73274229,344946244,4646648911.684453,3861863107.840586,2492797639.218104,11001309658.743143,1396869,400912,666493,2464274
2015-08-31,BATS BZX (Z),253076017,170713190,127584637,551373844,8152152481.791552,9894480552.509461,5278388202.178594,23325021236.479607,2067221,673097,1061546,3801864
2015-08-28,NYSE MKT (A),0,9988100,6214551,16202651,0.000000,63522002.461600,134902578.901700,198424581.363300,0,26053,24762,50815
2015-08-28,NASDAQ BX (B),69719293,52582481,36189183,158490957,2510172267.821991,2064802831.516403,1594229555.535403,6169204654.873797,585108,215826,304717,1105651
2015-08-28,NYSE (DN),142024609,63562995,76286054,281873658,4298686721.332792,2411164346.950186,3008072473.638413,9717923541.921391,569980,156128,292533,1018641
2015-08-28,NASDAQ (DQ),1027983629,672648693,584561977,2285194299,29346337443.387976,27515993649.907728,21248010342.260576,78110341435.556280,3535932,960434,1820141,6316507
2015-08-28,EDGA (J),98065820,79734956,46242833,224043609,2882003722.152013,2854419482.856297,1642858045.673906,7379281250.682216,789676,341143,370906,1501725
2015-08-28,EDGX (K),263465755,219332606,202561733,685360094,7557038173.414944,7372613191.630622,7388155021.327905,22317806386.373471,1643837,657194,1216899,3517930
2015-08-28,CHX (M),10048438,14975434,3490442,28514314,332292188.712200,1499759268.651400,302789183.504000,2134840640.867600,475,6523,2054,9052
2015-08-28,NYSE (N),1029339277,0,0,1029339277,37540982069.581008,0.000000,0.000000,37540982069.581008,3649746,0,0,3649746
2015-08-28,NYSE Arca (P),310748530,389054767,209392384,909195681,10158445070.816547,20099612333.042385,8849305023.446796,39107362427.305728,2221438,1180931,1585752,4988121
2015-08-28,NASDAQ (Q),539481924,189588356,539413824,1268484104,20226629835.800165,11887241645.958044,22686335985.749176,54800207467.507385,4452113,887893,3148934,8488940
2015-08-28,NASDAQ PSX (X),38069211,22877981,19548474,80495666,1292705896.700598,916202029.940001,704322833.404699,2913230760.045298,267819,83744,121710,473273
2015-08-28,BATS BYX (Y),149292684,109377663,72828264,331498611,4256189880.035706,3762445545.485001,2525699767.463564,10544335192.984271,1220671,431545,614412,2266628
2015-08-28,BATS BZX (Z),274079734,174945949,142211088,591236771,8731623641.958360,9584277752.295878,5709943040.195126,24025844434.449364,2146085,784723,1117843,4048651
2015-08-27,NYSE MKT (A),0,9613298,8502368,18115666,0.000000,65277177.395900,182361576.756900,247638754.152800,0,24841,34755,59596
2015-08-27,NASDAQ BX (B),90174893,70501463,47327162,208003518,3334605080.117998,3329625029.916498,2178088543.086497,8842318653.120993,756161,299663,397324,1453148
2015-08-27,NYSE (DN),177799157,82702760,89510005,350011922,6111396200.624087,3387775826.817700,4300240247.676506,13799412275.118293,718574,200375,359542,1278491
2015-08-27,NASDAQ (DQ),1318170025,870957914,705021314,2894149253,42052137828.573293,36338519374.413595,29140695192.913555,107531352395.900443,4431879,1299555,2306225,8037659
2015-08-27,EDGA (J),117948223,99882882,56340756,274171861,3456635031.780599,4191960222.024589,2152668350.956602,9801263604.761790,928496,427807,449997,1806300
2015-08-27,EDGX (K),338144604,246255547,248669112,833069263,10392512693.803963,11099289180.587954,10226881452.376582,31718683326.768499,2133208,796859,1556867,4486934
2015-08-27,CHX (M),10524206,27710550,5625093,43859849,468413415.828000,3313348142.015104,411949686.320000,4193711244.163104,381,13188,1548,15117
2015-08-27,NYSE (N),1256575674,0,0,1256575674,45463875018.135293,0.000000,0.000000,45463875018.135293,4550912,0,0,4550912
2015-08-27,NYSE Arca (P),420901115,581283615,275901904,1278086634,14853075413.600001,32747047963.613437,12976532936.602377,60576656313.815815,2973893,1583906,2072355,6630154
2015-08-27,NASDAQ (Q),705066509,275489027,635453026,1616008562,27745243593.828453,20632516389.034925,29593273824.220589,77971033807.083967,5744620,1177245,4137012,11058877
2015-08-27,NASDAQ PSX (X),49473285,29997162,25512694,104983141,1730994219.823496,1498247903.994703,969278943.642496,4198521067.460695,340413,112556,160181,613150
2015-08-27,BATS BYX (Y),187987362,131031917,92098899,411118178,5420628535.426400,5007241006.506024,3217408941.747416,13645278483.679840,1538077,542943,790040,2871060
2015-08-27,BATS BZX (Z),335603507,255370873,177561701,768536081,11126162649.586348,16237980450.170618,7733685080.467187,35097828180.224153,2580711,1015601,1433000,5029312
2015-08-26,NYSE MKT (A),0,10954616,9430045,20384661,0.000000,112584473.721400,182150682.660200,294735156.381600,0,26117,34049,60166
2015-08-26,NASDAQ BX (B),94573000,67357465,51753172,213683637,3407389731.908894,3402687841.889992,2238244137.712597,9048321711.511483,797513,328256,452354,1578123
2015-08-26,NYSE (DN),179872433,76548579,102066537,358487549,6595778725.853769,3808844557.290105,4590493117.221839,14995116400.365713,778915,206071,417893,1402879
2015-08-26,NASDAQ (DQ),1390031786,812469432,792967098,2995468316,46748035917.464308,43238666941.264848,31846300156.647941,121833003015.377097,5112303,1423545,2660014,9195862
2015-08-26,EDGA (J),125239449,109940902,66728868,301909219,3759036466.301397,5128056164.455237,2718996797.828483,11606089428.585117,1019464,551300,553340,2124104
2015-08-26,EDGX (K),346110132,242050869,260629160,848790161,11261327032.603674,12031415208.171713,10376732163.867730,33669474404.643117,2373240,976012,1698586,5047838
2015-08-26,CHX (M),17820506,38722728,10613892,67157126,910778021.483700,4512374419.384990,595246385.523500,6018398826.392190,806,17105,3196,21107
2015-08-26,NYSE (N),1312357974,0,0,1312357974,48267412018.158101,0.000000,0.000000,48267412018.158101,5009246,0,0,5009246
2015-08-26,NYSE Arca (P),460878858,591571677,315112286,1367562821,16541600784.520326,34929103124.504708,14466955701.923412,65937659610.948446,3377824,1904809,2381303,7663936
2015-08-26,NASDAQ (Q),797062451,324460425,684945417,1806468293,32033927409.890345,22620787977.007358,31329710485.989906,85984425872.887609,6729601,1478384,4504810,12712795
2015-08-26,NASDAQ PSX (X),54508967,33894818,31436121,119839906,1858433344.012500,1804358397.975602,1129993089.940699,4792784831.928801,371067,132302,183596,686965
2015-08-26,BATS BYX (Y),206753704,136930426,105927082,449611212,6288274132.993433,5591954392.837586,3854038014.216198,15734266540.047217,1777567,631784,939921,3349272
2015-08-26,BATS BZX (Z),366580416,291209975,207211988,865002379,12389056545.835318,19085665671.322502,8934346069.365625,40409068286.523445,2879514,1325646,1653189,5858349
2015-08-25,NYSE MKT (A),0,9260969,5607621,14868590,0.000000,72221788.629300,135338093.547099,207559882.176399,0,23343,27532,50875
2015-08-25,NASDAQ BX (B),105181552,67939267,57597450,230718269,3815462275.984494,3834829933.839815,2664544473.666061,10314836683.490370,928198,332571,519652,1780421
2015-08-25,NYSE (DN),197808652,76861659,107586615,382256926,7166289198.588918,3793329990.870594,4872440651.959267,15832059841.418779,830362,218021,459262,1507645
2015-08-25,NASDAQ (DQ),1413863691,873694492,801307152,3088865335,46544262265.197122,48944574866.936565,31976714444.949145,127465551577.082832,5316698,1531442,2830624,9678764
2015-08-25,EDGA (J),128406868,100290529,63252946,291950343,3939224370.908484,4943132083.601691,2488909624.627403,11371266079.137578,1046735,486141,532801,2065677
2015-08-25,EDGX (K),314101813,223537256,243688876,781327945,10556853409.353077,11373326407.868481,9665382651.861016,31595562469.082574,2164973,841682,1581333,4587988
2015-08-25,CHX (M),14376658,25129543,7163485,46669686,573019301.704500,3431179852.480005,639585626.315900,4643784780.500405,1049,13327,2438,16814
2015-08-25,NYSE (N),1270321478,0,0,1270321478,48512523739.701239,0.000000,0.000000,48512523739.701239,4632682,0,0,4632682
2015-08-25,NYSE Arca (P),428984768,570563692,296692962,1296241422,15777820430.431584,36727006334.713132,13926200467.700597,66431027232.845313,3129523,1717296,2276177,7122996
2015-08-25,NASDAQ (Q),720824435,284362705,704387757,1709574897,30090070100.218159,22225280049.502067,32813317528.869204,85128667678.589430,6157012,1239483,4539653,11936148
2015-08-25,NASDAQ PSX (X),45565433,28185003,24075192,97825628,1654547396.686600,1617954395.655200,886473656.094398,4158975448.436198,321868,109234,159752,590854
2015-08-25,BATS BYX (Y),210845908,133116678,105296075,449258661,6205398780.786776,5860948536.006175,3750540975.274498,15816888292.067449,1785839,618922,918815,3323576
2015-08-25,BATS BZX (Z),366120738,272450021,207572120,846142879,12706149673.060158,19571882902.389328,8820682342.725914,41098714918.175400,2906670,1197364,1680820,5784854
2015-08-24,NYSE MKT (A),0,18049075,6809081,24858156,0.000000,206279271.898000,150856120.718600,357135392.616600,0,36990,31409,68399
2015-08-24,NASDAQ BX (B),128192586,98981381,76659042,303833009,5239820247.000189,5160058945.696967,3882670062.715815,14282549255.412971,1172782,509418,714911,2397111
2015-08-24,NYSE (DN),243170507,109656772,142108390,494935669,9350780853.377111,5071944070.441693,7317515307.791938,21740240231.610742,1061085,304319,611391,1976795
2015-08-24,NASDAQ (DQ),1659605798,1178863715,987121951,3825591464,57413583070.740963,63703031305.173497,44111626670.554081,165228241046.468541,6637433,2281140,3750404,12668977
2015-08-24,EDGA (J),157600992,133891249,85934523,377426764,5265804877.874976,6185719984.908849,3657879217.301976,15109404080.085801,1310165,656640,742919,2709724
2015-08-24,EDGX (K),435383805,367156787,336414548,1138955140,14824335986.863499,17383723702.295957,14029040492.734892,46237100181.894348,3005831,1412845,2189710,6608386
2015-08-24,CHX (M),14213693,43812934,17039030,75065657,608738603.366800,5857097131.030002,1223651191.701900,7689486926.098702,1667,26491,5427,33585
2015-08-24,NYSE (N),1662193410,0,0,1662193410,61594980622.131223,0.000000,0.000000,61594980622.131223,6391235,0,0,6391235
2015-08-24,NYSE Arca (P),547844277,958275606,410680847,1916800730,20720529136.576782,59248544168.239401,20330604701.403808,100299678006.219991,4005828,2783846,2985366,9775040
2015-08-24,NASDAQ (Q),983823413,491961776,1008308603,2484093792,40707347131.853394,32474684834.300776,47851684876.636020,121033716842.790190,8043818,2261197,6288269,16593284
2015-08-24,NASDAQ PSX (X),63759320,54941068,36642051,155342439,2279325512.504494,2826580922.650200,1437583470.801600,6543489905.956294,424579,200794,228940,854313
2015-08-24,BATS BYX (Y),259386970,179391976,132058181,570837127,7978688379.734835,7584843899.799021,4821850576.905131,20385382856.438987,2254195,864292,1188786,4307273
2015-08-24,BATS BZX (Z),479524459,420616044,271212999,1171353502,16592149739.533600,26960113972.304318,11766693564.654244,55318957276.492162,3693451,1846560,2216560,7756571
2015-08-21,NYSE MKT (A),0,13006011,6185006,19191017,0.000000,87681950.096800,150435092.607000,238117042.703800,0,26705,25847,52552
2015-08-21,NASDAQ BX (B),93220224,71105432,56410024,220735680,3499633206.358681,3889041585.202594,2670769112.474187,10059443904.035462,810684,307795,491664,1610143
2015-08-21,NYSE (DN),176079700,79503125,106070304,361653129,6739332922.795473,4142914321.628706,5227728531.352393,16109975775.776572,764565,218154,430341,1413060
2015-08-21,NASDAQ (DQ),1345357199,917225305,857279979,3119862483,45863236273.501994,50415178642.142383,37845636790.924475,134124051706.568852,5080093,1609199,3026423,9715715
2015-08-21,EDGA (J),125311287,109082545,70622748,305016580,4012503922.762087,5604572759.130282,2893512656.739001,12510589338.631370,1012455,466450,578081,2056986
2015-08-21,EDGX (K),315834296,255423736,263295703,834553735,10853410607.148994,12529747355.914283,11389075900.725488,34772233863.788765,2100140,873656,1718679,4692475
2015-08-21,CHX (M),9723294,29736573,8997952,48457819,383832040.284800,3570259789.521000,688933425.553000,4643025255.358800,887,14113,4017,19017
2015-08-21,NYSE (N),1337888002,0,0,1337888002,52931720621.755182,0.000000,0.000000,52931720621.755182,4431931,0,0,4431931
2015-08-21,NYSE Arca (P),392909853,572786008,309238045,1274933906,15138999604.294764,35811271830.742091,15169162172.785352,66119433607.822207,2835354,1571500,2298409,6705263
2015-08-21,NASDAQ (Q),692984148,306741716,770738475,1770464339,29169149722.971824,21964579115.129157,37308988724.539133,88442717562.640114,5657266,1251533,4511607,11420406
2015-08-21,NASDAQ PSX (X),43052542,30328062,26025301,99405905,1597799531.475401,1642922135.600899,1006755193.176202,4247476860.252502,305743,113419,163042,582204
2015-08-21,BATS BYX (Y),201523431,139621464,106691482,447836377,6265196058.017315,5982268136.238823,3866156997.988216,16113621192.244354,1640937,596711,903052,3140700
2015-08-21,BATS BZX (Z),298045772,255913144,200147204,754106120,10699479075.801789,17912899160.913251,9538339454.805877,38150717691.520917,2359738,1023883,1578912,4962533
2015-08-20,NYSE MKT (A),0,9738388,4600469,14338857,0.000000,66168619.216600,109019750.502000,175188369.718600,0,22837,20626,43463
2015-08-20,NASDAQ BX (B),74059703,50141361,44309526,168510590,2749714638.018901,2552663775.751004,1954857722.242804,7257236136.012709,643298,198582,380766,1222646
2015-08-20,NYSE (DN),150771478,60504727,88619127,299895332,5594775926.193211,2654825830.441000,4032342937.505878,12281944694.140089,607378,165221,348221,1120820
2015-08-20,NASDAQ (DQ),1143914709,688623550,684983977,2517522236,37755425702.800862,32863176859.380444,27540186110.009862,98158788672.191168,4172702,1125654,2368632,7666988
2015-08-20,EDGA (J),99403267,75081389,52871016,227355672,3034115118.353015,3653406262.637504,2097392340.450080,8784913721.440599,785435,304127,423407,1512969
2015-08-20,EDGX (K),260434857,182328108,210979038,653742003,8508871170.027099,8189961124.366180,8401874250.735619,25100706545.128898,1633742,571791,1294197,3499730
2015-08-20,CHX (M),15964958,22867373,9630012,48462343,510385553.311000,2979542584.846001,608827904.995000,4098756043.152001,505,7779,2360,10644
2015-08-20,NYSE (N),927580429,0,0,927580429,34760238825.666249,0.000000,0.000000,34760238825.666249,3189031,0,0,3189031
2015-08-20,NYSE Arca (P),309479098,382677703,233111346,925268147,11508776871.786708,22642132131.098471,10517452377.797675,44668361380.682854,2186155,1002719,1717978,4906852
2015-08-20,NASDAQ (Q),515123345,188246651,508775797,1212145793,21633024075.962757,12443214861.950551,23228992818.886765,57305231756.800073,4178436,725440,3219613,8123489
2015-08-20,NASDAQ PSX (X),35251627,22406235,22617373,80275235,1295625089.427803,1062179090.115901,842151533.948801,3199955713.492505,250970,89828,138677,479475
2015-08-20,BATS BYX (Y),161137008,100404355,86361179,347902542,4893078292.516819,4194263370.335810,3189164350.839804,12276506013.692433,1286833,395905,699234,2381972
2015-08-20,BATS BZX (Z),235024978,164971122,144600010,544596110,8173729733.268788,10700540083.507132,6376928711.493806,25251198528.269726,1807530,622007,1123097,3552634
2015-08-19,NYSE MKT (A),0,8062372,3951022,12013394,0.000000,46568591.755300,97314704.554200,143883296.309500,0,20195,20019,40214
2015-08-19,NASDAQ BX (B),63388827,47690175,38651601,149730603,2339074735.934597,2388357006.768192,1561680850.386789,6289112593.089578,570203,185144,324503,1079850
2015-08-19,NYSE (DN),131990014,57818917,74093389,263902320,4757656688.971914,2474773686.078496,3113802776.758910,10346233151.809320,530776,138407,285184,954367
2015-08-19,NASDAQ (DQ),1006042790,615973397,579117839,2201134026,33231704994.881031,25638163174.713554,20639203216.086868,79509071385.681453,3583213,935148,1911940,6430301
2015-08-19,EDGA (J),84701041,66374405,45131125,196206571,2618316924.826710,3151012026.069991,1654031500.398910,7423360451.295611,684955,267676,345467,1298098
2015-08-19,EDGX (K),224322672,168938253,186094416,579355341,7198902507.779682,7123131738.510710,6663486071.947693,20985520318.238085,1403898,479205,1081703,2964806
2015-08-19,CHX (M),20607996,21501557,4472424,46581977,695776317.579800,2399815970.081998,338124528.305300,3433716815.967098,518,7624,1335,9477
2015-08-19,NYSE (N),844116557,0,0,844116557,30677760708.968443,0.000000,0.000000,30677760708.968443,2966001,0,0,2966001
2015-08-19,NYSE Arca (P),294054692,352897399,212884853,859836944,10289767890.877662,20674266905.778913,8975214967.955298,39939249764.611873,1976212,867844,1494617,4338673
2015-08-19,NASDAQ (Q),466092266,163659551,425114404,1054866221,19452518670.540112,11052343278.267657,18619541362.969222,49124403311.776991,3864778,636870,2726901,7228549
2015-08-19,NASDAQ PSX (X),29180370,19033682,17985063,66199115,1042099338.901700,965216458.661100,624420288.922202,2631736086.485002,203695,76220,105957,385872
2015-08-19,BATS BYX (Y),135209147,85388015,75861591,296458753,4016486866.721582,3727037120.089690,2477906931.536583,10221430918.347855,1090936,333667,586671,2011274
2015-08-19,BATS BZX (Z),216063160,156152780,126372362,498588302,7133819192.054491,10299952120.601186,5328551251.123705,22762322563.779382,1637353,559925,974177,3171455
2015-08-18,NYSE MKT (A),0,9055118,4346168,13401286,0.000000,61445539.788400,111130851.963800,172576391.752200,0,18309,18067,36376
2015-08-18,NASDAQ BX (B),57442232,25056260,32172850,114671342,2076682534.341498,1214616248.980302,1348303217.291303,4639602000.613103,510993,103377,286617,900987
2015-08-18,NYSE (DN),116299209,33367820,64996649,214663678,4229859252.234112,1245942587.450204,2515139679.528605,7990941519.212921,453271,82767,255344,791382
2015-08-18,NASDAQ (DQ),878625149,393195259,506877692,1778698100,29460230636.228942,13927630559.842563,17777723586.768630,61165584782.840135,3153442,679374,1733124,5565940
2015-08-18,EDGA (J),71927865,36869031,38418730,147215626,2298015471.068507,1480378569.183401,1499293072.985410,5277687113.237318,591333,142717,302545,1036595
2015-08-18,EDGX (K),186838248,98262853,153502066,438603167,6055105954.787112,3714752011.803806,5628441181.825252,15398299148.416170,1154523,274678,894606,2323807
2015-08-18,CHX (M),8582630,13078008,4507608,26168246,342876719.423000,1203449313.100000,194100959.673900,1740426992.196900,376,2287,522,3185
2015-08-18,NYSE (N),691758089,0,0,691758089,25319715536.924217,0.000000,0.000000,25319715536.924217,2386287,0,0,2386287
2015-08-18,NYSE Arca (P),240290280,203387722,168433151,612111153,8475656548.295748,10731225678.237276,7025146449.856665,26232028676.389689,1629044,525160,1288953,3443157
2015-08-18,NASDAQ (Q),374804891,89681359,361236197,825722447,15375586853.089759,5640538589.566010,15168677586.620117,36184803029.275886,3004387,344163,2309422,5657972
2015-08-18,NASDAQ PSX (X),25574108,10164558,14506255,50244921,928804888.002600,445427889.294800,534639048.336199,1908871825.633599,183861,37988,93907,315756
2015-08-18,BATS BYX (Y),124200878,51785891,63736612,239723381,3683145708.959709,2015386040.932500,2129288097.886383,7827819847.778592,1002266,207100,530540,1739906
2015-08-18,BATS BZX (Z),176170086,76809897,94553340,347533323,5696606315.060589,4583958125.678907,3683285227.051322,13963849667.790818,1303584,304251,751592,2359427
2015-08-17,NYSE MKT (A),0,8279931,3471087,11751018,0.000000,82836090.589600,99481609.408400,182317699.998000,0,20288,18367,38655
2015-08-17,NASDAQ BX (B),57781845,27513396,30210767,115506008,2070244637.372699,1240727623.991398,1254515297.224609,4565487558.588706,507506,103467,271756,882729
2015-08-17,NYSE (DN),106577969,35703494,63150649,205432112,3880550341.208302,1298647482.494103,2450128215.289211,7629326038.991616,424682,97069,253832,775583
2015-08-17,NASDAQ (DQ),842217446,451340116,498120877,1791678439,28569159392.678660,14372661084.799657,17325218477.677178,60267038955.155495,3080382,656768,1749096,5486246
2015-08-17,EDGA (J),76453249,44779222,38636457,159868928,2539237018.842501,1606838545.152296,1380501324.512587,5526576888.507384,624720,151912,304822,1081454
2015-08-17,EDGX (K),182886199,112781865,157476005,453144069,5912646156.674496,4062818473.287095,5729065888.353429,15704530518.315020,1131642,297778,909919,2339339
2015-08-17,CHX (M),9473047,13191769,5998772,28663588,495959977.289100,1160977184.925000,327948223.788500,1984885386.002600,372,3834,786,4992
2015-08-17,NYSE (N),701927327,0,0,701927327,26172531999.771276,0.000000,0.000000,26172531999.771276,2303502,0,0,2303502
2015-08-17,NYSE Arca (P),230338120,227298274,172236507,629872901,8285225992.043945,12043305943.774811,7048095468.510899,27376627404.329655,1631600,520106,1295609,3447315
2015-08-17,NASDAQ (Q),356324841,89246085,378702444,824273370,14658779750.928336,5406266746.989310,16047270119.422010,36112316617.339656,2944586,337625,2276149,5558360
2015-08-17,NASDAQ PSX (X),20331957,11715181,13248813,45295951,684793680.419100,442463189.959000,470175889.299000,1597432759.677100,142399,38644,88003,269046
2015-08-17,BATS BYX (Y),121299295,53572459,59049059,233920813,3698708737.477098,2007153708.857303,2044924121.064006,7750786567.398407,974612,205408,502420,1682440
2015-08-17,BATS BZX (Z),167462168,78200823,94667173,340330164,5668889559.904213,4918620566.557518,3900988068.606360,14488498195.068091,1289814,307758,764402,2361974
2015-08-14,NYSE MKT (A),0,7093873,3735529,10829402,0.000000,45367439.848500,87377935.341900,132745375.190400,0,18814,17665,36479
2015-08-14,NASDAQ BX (B),56198404,22222212,31729366,110149982,1986034599.038005,1095331004.424902,1324328458.009412,4405694061.472319,497897,91774,276461,866132
2015-08-14,NYSE (DN),103750840,27871081,56519270,188141191,3711541858.500718,1059144754.054301,2226424409.705110,6997111022.260129,407711,73754,229714,711179
2015-08-14,NASDAQ (DQ),814828677,366679867,497410108,1678918652,26336981638.294219,14249326164.155572,16953997133.424867,57540304935.874658,2918850,560333,1628584,5107767
2015-08-14,EDGA (J),74294424,34567120,37651048,146512592,2322792345.404208,1478355949.187298,1407190716.721508,5208339011.313014,600340,142726,290623,1033689
2015-08-14,EDGX (K),175570147,87816683,158130117,421516947,5565768631.923805,3519351374.300600,5466188263.894633,14551308270.119038,1098792,270729,892499,2262020
2015-08-14,CHX (M),8028351,12321319,3464326,23813996,312577834.172800,1025212667.040000,316293287.509000,1654083788.721800,285,2131,742,3158
2015-08-14,NYSE (N),671636595,0,0,671636595,25262640063.293116,0.000000,0.000000,25262640063.293116,2283701,0,0,2283701
2015-08-14,NYSE Arca (P),231463716,180508958,171266952,583239626,8084402609.516994,10865119032.306578,6931418182.101164,25880939823.924736,1601357,492103,1264496,3357956
2015-08-14,NASDAQ (Q),365636604,78376460,358443323,802456387,15066730183.101682,5136040872.408502,14889610845.154512,35092381900.664696,3003567,319942,2204674,5528183
2015-08-14,NASDAQ PSX (X),20176632,9586682,14454950,44218264,674601869.802300,462377758.568300,561546133.642900,1698525762.013500,144090,39258,91496,274844
2015-08-14,BATS BYX (Y),116700237,46443572,59895414,223039223,3483979352.111883,1880710480.905904,2108529998.924195,7473219831.941982,942327,194080,488292,1624699
2015-08-14,BATS BZX (Z),160312697,69437643,96859708,326610048,5279564368.243920,4388097363.759902,3852819308.723225,13520481040.727047,1220902,289469,778666,2289037
2015-08-13,NYSE MKT (A),0,9186551,4609027,13795578,0.000000,44660359.727100,131628836.298000,176289196.025100,0,21695,20710,42405
2015-08-13,NASDAQ BX (B),63552508,32945387,35470422,131968317,2273410567.042101,1493583001.774300,1445215812.039386,5212209380.855787,547563,127089,309990,984642
2015-08-13,NYSE (DN),114272031,40065599,61880708,216218338,4211246779.736697,1436855978.335400,2545169631.276383,8193272389.348480,480127,103484,257464,841075
2015-08-13,NASDAQ (DQ),944620868,495526803,542903768,1983051439,31293119989.849618,16639894535.683281,19585859711.721904,67518874237.254803,3266195,723878,1812262,5802335
2015-08-13,EDGA (J),81032565,47885572,40510825,169428962,2485600228.950404,1959018110.833400,1437904072.684796,5882522412.468600,642112,191388,319940,1153440
2015-08-13,EDGX (K),201884482,120206501,170511802,492602785,6671823019.849524,4130032749.889703,6115509517.853876,16917365287.593103,1286566,330637,990862,2608065
2015-08-13,CHX (M),12634571,12854158,4401978,29890707,482965185.735000,959803100.440000,451950028.860000,1894718315.035000,621,3694,943,5258
2015-08-13,NYSE (N),768465354,0,0,768465354,28263124107.486166,0.000000,0.000000,28263124107.486166,2670721,0,0,2670721
2015-08-13,NYSE Arca (P),271564308,277783072,195722255,745069635,9492823811.982990,13572193649.428570,8189309699.802317,31254327161.213877,1869413,659647,1453844,3982904
2015-08-13,NASDAQ (Q),425204655,113568635,393456322,932229612,17607116200.105214,7433062306.738744,17046596840.603431,42086775347.447389,3509033,449613,2526392,6485038
2015-08-13,NASDAQ PSX (X),27032361,13225480,14481752,54739593,1012201174.119502,560307014.766500,541372910.675699,2113881099.561701,204514,47386,94930,346830
2015-08-13,BATS BYX (Y),129178927,65611109,64930385,259720421,3934920694.840080,2288119452.771603,2186918124.998219,8409958272.609902,1046887,248895,529212,1824994
2015-08-13,BATS BZX (Z),190619200,101605021,106634632,398858853,6341367516.060104,5977435755.469809,4494102632.920170,16812905904.450083,1454640,402529,853027,2710196
2015-08-12,NYSE MKT (A),0,10888173,4457855,15346028,0.000000,65271774.924100,113736645.945600,179008420.869700,0,27380,19152,46532
2015-08-12,NASDAQ BX (B),82893386,48356394,44842423,176092203,2977962988.448302,2286951232.172504,2047823888.255707,7312738108.876513,721890,187926,394912,1304728
2015-08-12,NYSE (DN),171242586,62100173,87523914,320866673,6172130758.362967,2488104870.836797,3974695708.427014,12634931337.626778,662794,150352,354805,1167951
2015-08-12,NASDAQ (DQ),1270619691,707342112,687014245,2664976048,42511583091.953182,29990629345.003135,27640470512.980762,100142682949.937079,4195239,1039023,2322197,7556459
2015-08-12,EDGA (J),109841695,68144755,52690041,230676491,3273484987.888597,2919633995.019693,2133857917.366927,8326976900.275217,865136,276206,419228,1560570
2015-08-12,EDGX (K),273764171,170589199,207534241,651887611,9108396726.333831,7149591224.171680,8249512291.121778,24507500241.627289,1747991,501461,1279256,3528708
2015-08-12,CHX (M),11802442,15263755,5932690,32998887,349892087.007900,1977751515.280002,407153430.204000,2734797032.491902,549,7831,1420,9800
2015-08-12,NYSE (N),938363473,0,0,938363473,33767579972.731880,0.000000,0.000000,33767579972.731880,3413746,0,0,3413746
2015-08-12,NYSE Arca (P),362001132,383541322,248826033,994368487,12728659947.425959,21033914786.548607,11186714101.833770,44949288835.808336,2435824,964102,1839999,5239925
2015-08-12,NASDAQ (Q),574999714,176026975,504581433,1255608122,23123602435.681499,11424155917.516730,22687448242.572340,57235206595.770569,4573515,678386,3319509,8571410
2015-08-12,NASDAQ PSX (X),39325498,20722365,21676847,81724710,1404610620.998600,890933680.455001,897617219.149900,3193161520.603501,282926,72485,138525,493936
2015-08-12,BATS BYX (Y),176656421,92006337,84373612,353036370,5212400617.710684,3562770080.575788,3046756041.602419,11821926739.888891,1428833,355969,711692,2496494
2015-08-12,BATS BZX (Z),262425203,158683485,143065019,564173707,8640269788.386499,9538106829.362108,6190595452.852276,24368972070.600883,1982610,585012,1140812,3708434
2015-08-11,NYSE MKT (A),0,10336184,4787511,15123695,0.000000,61274319.185100,120916143.394400,182190462.579500,0,26811,20129,46940
2015-08-11,NASDAQ BX (B),72431999,39214313,38645067,150291379,2478951506.705601,2099994032.458802,1763646506.940989,6342592046.105392,644373,156888,347553,1148814
2015-08-11,NYSE (DN),147258518,46313808,78373592,271945918,5089396984.924787,1968240656.468395,3794148471.175859,10851786112.569041,571249,124175,306948,1002372
2015-08-11,NASDAQ (DQ),1076298864,549243330,627227203,2252769397,34386248004.323323,24205236375.476022,25717898250.382395,84309382630.181740,3656164,829320,2106074,6591558
2015-08-11,EDGA (J),94626448,53596605,46088277,194311330,2846979016.129789,2331674614.170697,1835186564.786484,7013840195.086970,767065,223940,367654,1358659
2015-08-11,EDGX (K),229886016,138735511,189198712,557820239,7297468551.782058,5424304901.373684,7763270768.165544,20485044221.321286,1473534,392133,1130265,2995932
2015-08-11,CHX (M),21236714,12975963,7206702,41419379,610968063.336000,1463005635.315000,582586364.740000,2656560063.391000,1031,5194,1369,7594
2015-08-11,NYSE (N),857787664,0,0,857787664,31011670342.707192,0.000000,0.000000,31011670342.707192,3057759,0,0,3057759
2015-08-11,NYSE Arca (P),307368926,286758156,229610838,823737920,10470646372.485737,15551114709.590434,10529084952.233134,36550846034.309305,2117145,764446,1718057,4599648
2015-08-11,NASDAQ (Q),496532770,129712322,475087087,1101332179,19472835015.846171,8016980289.129007,22044065869.977111,49533881174.952289,4015012,508301,3066520,7589833
2015-08-11,NASDAQ PSX (X),33721099,17108556,18851171,69680826,1190686518.079599,716104993.338200,745207186.009201,2651998697.427000,244635,58522,127742,430899
2015-08-11,BATS BYX (Y),153829185,80019293,75842886,309691364,4563703355.761307,3299832056.612498,2864495811.287773,10728031223.661578,1280776,309243,640156,2230175
2015-08-11,BATS BZX (Z),225751274,117743774,127280311,470775359,7214038341.527907,7068173284.078624,5656236561.892410,19938448187.498941,1712407,460301,1023955,3196663
2015-08-10,NYSE MKT (A),0,11320723,4776915,16097638,0.000000,75014688.121000,123513206.690000,198527894.811000,0,27984,20009,47993
2015-08-10,NASDAQ BX (B),66731247,32736041,35616270,135083558,2347035088.309896,1629243403.455201,1470632052.790801,5446910544.555898,553928,126621,299443,979992
2015-08-10,NYSE (DN),131202718,39438516,75440796,246082030,4576424960.627711,1539617882.962802,3339101184.578620,9455144028.169133,519644,108979,304020,932643
2015-08-10,NASDAQ (DQ),1048700746,432666340,614463937,2095831023,34396406606.767466,14711332001.721475,21803833854.956043,70911572463.444984,3564584,691346,1989678,6245608
2015-08-10,EDGA (J),87608765,40161032,43201933,170971730,2719021406.166214,1759113544.263702,1630106271.108606,6108241221.538522,717787,172056,348559,1238402
2015-08-10,EDGX (K),224832069,113121620,176444444,514398133,6997589065.989297,4148674521.946501,6344207349.905877,17490470937.841675,1393281,322620,1025032,2740933
2015-08-10,CHX (M),10430812,7751158,4030658,22212628,562980796.957000,572563050.812000,375608248.744000,1511152096.513000,671,2425,914,4010
2015-08-10,NYSE (N),868673660,0,0,868673660,31286463536.846039,0.000000,0.000000,31286463536.846039,2801651,0,0,2801651
2015-08-10,NYSE Arca (P),281786567,262145656,194340329,738272552,9875770227.139237,13978847882.778147,8247827185.133095,32102445295.050479,1941666,627648,1451697,4021011
2015-08-10,NASDAQ (Q),436692418,105958243,452499918,995150579,17232677958.345286,6336207885.093294,18761837730.997042,42330723574.435622,3505136,403092,2725053,6633281
2015-08-10,NASDAQ PSX (X),30097783,13474470,16081260,59653513,1050654967.645101,566005710.551300,629998723.974801,2246659402.171202,225069,48637,107469,381175
2015-08-10,BATS BYX (Y),138140062,57636360,67146888,262923310,4174562328.191370,2255673845.130199,2380300437.654516,8810536610.976085,1149272,232729,564251,1946252
2015-08-10,BATS BZX (Z),193962513,92853575,104776591,391592679,6283676400.187384,5087363158.213593,4188034764.944722,15559074323.345699,1485097,355073,853027,2693197
2015-08-07,NYSE MKT (A),0,9498165,4759241,14257406,0.000000,80498539.332900,99821662.416500,180320201.749400,0,25500,19275,44775
2015-08-07,NASDAQ BX (B),68844025,35154009,39467898,143465932,2362807899.868298,1792171493.084100,1667669587.580493,5822648980.532891,568197,140271,334614,1043082
2015-08-07,NYSE (DN),143891355,35057703,87220788,266169846,5062522907.134558,1752801437.530898,3473213126.495456,10288537471.160912,562124,105858,344870,1012852
2015-08-07,NASDAQ (DQ),1060130450,436160205,689832219,2186122874,33296401049.126020,20255285653.343832,23547807053.745018,77099493756.214870,3724297,745982,2184148,6654427
2015-08-07,EDGA (J),92064465,46390846,48583227,187038538,2669174915.733300,2208319445.515801,1633761238.495998,6511255599.745099,730597,195138,379478,1305213
2015-08-07,EDGX (K),228299811,114787875,200363728,543451414,7057806312.797704,4987955774.107593,7156578865.199802,19202340952.105099,1481173,355165,1176376,3012714
2015-08-07,CHX (M),11580039,11597462,4473521,27651022,602003324.923700,1476668430.640000,346903211.884200,2425574967.447900,549,4451,1115,6115
2015-08-07,NYSE (N),831603307,0,0,831603307,28903880545.368542,0.000000,0.000000,28903880545.368542,2867850,0,0,2867850
2015-08-07,NYSE Arca (P),295785034,232057786,228675527,756518347,9843619537.211663,14430464676.463323,9315901683.986831,33589985897.661817,2057205,680687,1680653,4418545
2015-08-07,NASDAQ (Q),485523324,117038493,484349730,1086911547,18828011975.640653,7896701847.601499,20666150947.351454,47390864770.593606,3888065,489309,3111633,7489007
2015-08-07,NASDAQ PSX (X),31311968,14054552,17817043,63183563,1029903405.762400,724148841.128200,637462021.662999,2391514268.553599,223652,56059,119340,399051
2015-08-07,BATS BYX (Y),141319839,63485713,72857817,277663369,4099805787.579607,2837011210.823003,2407991320.944227,9344808319.346837,1154605,273650,612198,2040453
2015-08-07,BATS BZX (Z),212887708,100634242,132196387,445718337,6967707396.813149,6445534646.585017,5133392931.698058,18546634975.096224,1654394,413353,1045881,3113628
2015-08-06,NYSE MKT (A),0,9354533,5104039,14458572,0.000000,56041491.225400,110901568.990400,166943060.215800,0,24444,20823,45267
2015-08-06,NASDAQ BX (B),76123390,35728996,48156836,160009222,2710412553.973393,1729897969.463201,2182032630.807671,6622343154.244265,624829,137164,391632,1153625
2015-08-06,NYSE (DN),178747481,38088382,107915576,324751439,6676198688.683099,1788225315.232298,5040239933.988294,13504663937.903691,696359,108732,405690,1210781
2015-08-06,NASDAQ (DQ),1321606620,461495790,785587112,2568689522,44012822968.105553,19784109035.456066,31507543877.886559,95304475881.448178,4490978,820939,2580170,7892087
2015-08-06,EDGA (J),108290886,47134574,57533630,212959090,3183547469.114178,2153830623.945804,2277511802.750701,7614889895.810683,837388,199784,444773,1481945
2015-08-06,EDGX (K),271714994,128729066,218210453,618654513,8814165389.560204,5196283185.778896,8877647276.029071,22888095851.368171,1775712,372892,1348648,3497252
2015-08-06,CHX (M),13260183,12369100,5683674,31312957,437331780.543600,1247245643.378000,366312223.537100,2050889647.458700,536,4328,1108,5972
2015-08-06,NYSE (N),956670250,0,0,956670250,33937386650.127411,0.000000,0.000000,33937386650.127411,3375331,0,0,3375331
2015-08-06,NYSE Arca (P),347425040,256886235,273410128,877721403,11936737872.963346,16090153402.242983,12074908277.390409,40101799552.596738,2377847,722364,1979834,5080045
2015-08-06,NASDAQ (Q),553492281,120949141,537732889,1212174311,21906568496.816621,7488127943.428291,24251785939.730964,53646482379.975876,4396444,485051,3486570,8368065
2015-08-06,NASDAQ PSX (X),34759313,15722525,21995275,72477113,1180616788.424899,710550766.159800,851282355.475098,2742449910.059797,251105,56243,138720,446068
2015-08-06,BATS BYX (Y),160156929,68037924,83097362,311292215,4687953681.476410,2672387821.148404,3073381455.861529,10433722958.486343,1308599,275302,691025,2274926
2015-08-06,BATS BZX (Z),245624389,105633900,151583826,502842115,7954988848.196171,6251117498.809608,6452860711.495466,20658967058.501245,1882650,417637,1188667,3488954
2015-08-05,NYSE MKT (A),0,7596938,3638189,11235127,0.000000,54090543.500600,86695226.166900,140785769.667500,0,20600,18406,39006
2015-08-05,NASDAQ BX (B),77855698,33846036,40700174,152401908,2774085419.080101,1788740220.978299,1827677071.614202,6390502711.672602,631143,138816,342925,1112884
2015-08-05,NYSE (DN),160127608,36295092,87868208,284290908,5939956559.325525,1490690803.334294,4259320859.099779,11689968221.759598,646144,101352,346692,1094188
2015-08-05,NASDAQ (DQ),1206702212,432040295,699086478,2337828985,40546331998.797129,16454635525.416347,28822763597.909949,85823731122.123425,4232516,701821,2303818,7238155
2015-08-05,EDGA (J),102283557,44758654,51098099,198140310,3197469421.684695,2154219333.233403,1977738365.128904,7329427120.047002,817837,182890,401228,1401955
2015-08-05,EDGX (K),252667108,114987325,202840140,570494573,8261540158.012654,4704009489.519284,8495161758.265023,21460711405.796961,1613059,333877,1219894,3166830
2015-08-05,CHX (M),12966937,10112403,9624801,32704141,646686061.116000,1053095723.178800,777406391.423300,2477188175.718100,501,3204,1008,4713
2015-08-05,NYSE (N),913513999,0,0,913513999,32591183259.478536,0.000000,0.000000,32591183259.478536,3059529,0,0,3059529
2015-08-05,NYSE Arca (P),331662141,228841543,248317362,808821046,11957520775.191581,12933071720.001825,11831392316.063046,36721984811.256452,2281365,615966,1813981,4711312
2015-08-05,NASDAQ (Q),500496239,105670636,480987232,1087154107,20645821622.628121,6640372718.467115,22358095657.082489,49644289998.177725,4013649,409179,3065635,7488463
2015-08-05,NASDAQ PSX (X),32692797,13315419,17911676,63919892,1153031368.158199,595383043.775500,702306704.281597,2450721116.215296,238648,49146,121647,409441
2015-08-05,BATS BYX (Y),164463685,63779886,75090707,303334278,4827600302.364511,2516769467.490904,2760825394.673595,10105195164.529010,1346419,254308,649777,2250504
2015-08-05,BATS BZX (Z),233126880,91187079,133514185,457828144,7827822749.863794,5386577523.955595,5968221990.229886,19182622264.049275,1803148,344709,1067222,3215079
2015-08-04,NYSE MKT (A),0,7957553,3652703,11610256,0.000000,41236795.821100,111789272.087100,153026067.908200,0,19318,16936,36254
2015-08-04,NASDAQ BX (B),74831009,31414836,40334564,146580409,2628987510.953497,1725574110.553500,1875377989.116093,6229939610.623090,595811,126444,331418,1053673
2015-08-04,NYSE (DN),171211446,32744868,92617112,296573426,6295452693.015527,1576925854.836997,4759604115.621671,12631982663.474195,675480,97867,369757,1143104
2015-08-04,NASDAQ (DQ),969684031,392159505,576083618,1937927154,32335748653.606570,13162674842.973897,24962631963.203249,70461055459.783716,3337479,587122,1899417,5824018
2015-08-04,EDGA (J),99536137,43503090,48327466,191366693,3035390329.779286,2103141383.900998,2035486777.576903,7174018491.257187,773573,177944,380363,1331880
2015-08-04,EDGX (K),229516285,104165281,185260386,518941952,7793529427.464318,4588929819.071696,8169731088.491043,20552190335.027057,1495854,317040,1119067,2931961
2015-08-04,CHX (M),13545189,8115785,8137550,29798524,668353043.202500,792696686.355200,470023120.143000,1931072849.700700,864,2664,805,4333
2015-08-04,NYSE (N),817668338,0,0,817668338,29078078467.836054,0.000000,0.000000,29078078467.836054,2822474,0,0,2822474
2015-08-04,NYSE Arca (P),306355450,220426163,221691245,748472858,10779505108.562466,12645736066.789996,10533082127.258204,33958323302.610666,2094781,584504,1653998,4333283
2015-08-04,NASDAQ (Q),476765654,96921752,438989267,1012676673,19693963762.559435,6097313859.782618,20813478830.987951,46604756453.330004,3783762,395794,2841762,7021318
2015-08-04,NASDAQ PSX (X),31577340,12399341,17283793,61260474,1159964880.646699,567141118.890000,735708448.896600,2462814448.433299,234109,47509,118384,400002
2015-08-04,BATS BYX (Y),151641352,66876720,71381311,289899383,4519147068.626698,2737782305.748298,2711940955.721273,9968870330.096269,1244105,254184,606100,2104389
2015-08-04,BATS BZX (Z),214540026,88766294,124981915,428288235,7178468870.549208,5758047325.937598,5741702471.711835,18678218668.198641,1677979,348611,1004731,3031321
2015-08-03,NYSE MKT (A),0,7777775,4594374,12372149,0.000000,53190796.839800,122668179.490000,175858976.329800,0,19736,17867,37603
2015-08-03,NASDAQ BX (B),71494084,37653775,39748951,148896810,2480622544.715991,1996451748.150299,1701202032.790993,6178276325.657283,582352,150723,334194,1067269
2015-08-03,NYSE (DN),129229757,38899769,71943414,240072940,4740585322.983612,1744559285.633601,3082623454.800206,9567768063.417419,534643,122203,287742,944588
2015-08-03,NASDAQ (DQ),1000494128,532968383,601288964,2134751475,33216695157.846912,22133631048.758643,22059994180.462229,77410320387.067784,3735889,824032,2060354,6620275
2015-08-03,EDGA (J),89754498,47954138,46278228,183986864,2816663520.626488,2491953069.667608,1734616335.773697,7043232926.067793,738021,201298,365502,1304821
2015-08-03,EDGX (K),215048814,118076030,178721370,511846214,7193991080.495138,5252176382.966106,6850871475.980976,19297038939.442220,1426233,359846,1071739,2857818
2015-08-03,CHX (M),14185074,9757891,3924947,27867912,572650739.895600,1017335517.144400,276853601.955400,1866839858.995400,562,3140,1365,5067
2015-08-03,NYSE (N),832458643,0,0,832458643,30093777969.154268,0.000000,0.000000,30093777969.154268,2837050,0,0,2837050
2015-08-03,NYSE Arca (P),274567372,272048245,208713386,755329003,9789814717.023364,16206187913.206946,9037924257.296230,35033926887.526540,1969961,718159,1584299,4272419
2015-08-03,NASDAQ (Q),456847288,120013049,431644166,1008504503,18668312769.793646,7993724107.952500,19243548616.803309,45905585494.549455,3785822,481738,2813029,7080589
2015-08-03,NASDAQ PSX (X),32468129,15013159,16789392,64270680,1178814144.678198,769439285.717000,654297882.269101,2602551312.664299,244368,58822,118737,421927
2015-08-03,BATS BYX (Y),157719984,73105527,74847784,305673295,4637757921.502492,3080616263.517108,2555668497.236314,10274042682.255914,1306735,298016,634934,2239685
2015-08-03,BATS BZX (Z),206292410,100378584,117941618,424612612,6982624305.677578,6483679587.771108,4925108377.862698,18391412271.311384,1647712,394660,957598,2999970
2015-07-31,NYSE MKT (A),0,9094238,4473910,13568148,0.000000,67430723.817700,127565707.016400,194996430.834100,0,19717,20057,39774
2015-07-31,NASDAQ BX (B),77233299,35323193,38872597,151429089,2721275576.682594,1869231144.535999,1734976219.891909,6325482941.110502,600984,132022,322580,1055586
2015-07-31,NYSE (DN),132034098,35665182,70130454,237829734,5058699523.973902,1541434770.576595,3196003163.068720,9796137457.619217,550023,109370,276371,935764
2015-07-31,NASDAQ (DQ),1067939541,435001933,641973502,2144914976,37391979517.924752,18663915556.085637,24112575048.855532,80168470122.865921,3641459,727590,1925323,6294372
2015-07-31,EDGA (J),93098529,46436380,46674860,186209769,3008240626.047108,2334310230.416297,1708196088.945493,7050746945.408898,728291,178569,352692,1259552
2015-07-31,EDGX (K),193032213,117061866,161811627,471905706,6862278994.023825,5453489214.544204,6507888592.969526,18823656801.537555,1278773,318951,955379,2553103
2015-07-31,CHX (M),12543404,7920651,3512410,23976465,499662501.227200,831924092.889999,277519636.528000,1609106230.645199,466,2588,869,3923
2015-07-31,NYSE (N),978038720,0,0,978038720,36734272443.920752,0.000000,0.000000,36734272443.920752,2773578,0,0,2773578
2015-07-31,NYSE Arca (P),275494841,253013509,209913127,738421477,10280091661.628703,14597942367.928944,9211448186.581434,34089482216.139081,1952303,666717,1502526,4121546
2015-07-31,NASDAQ (Q),456970139,119325049,545315142,1121610330,19007522331.323140,7411051721.301212,22775630612.262920,49194204664.887272,3703334,439822,2686541,6829697
2015-07-31,NASDAQ PSX (X),28996045,13048851,17571077,59615973,1086413445.383501,604847160.424500,644974308.479498,2336234914.287499,222665,49532,111993,384190
2015-07-31,BATS BYX (Y),161862675,71830425,72858436,306551536,4856559563.472218,2975507722.609010,2516688018.917594,10348755304.998822,1285093,268341,601313,2154747
2015-07-31,BATS BZX (Z),218910097,106146866,121731020,446787983,7474875754.629485,6626029308.569477,4946873935.535519,19047778998.734481,1669104,390529,928131,2987764
2015-07-30,NYSE MKT (A),0,8295315,5208863,13504178,0.000000,56283811.674100,146752896.322200,203036707.996300,0,22420,19129,41549
2015-07-30,NASDAQ BX (B),73254291,29374247,39092425,141720963,2628538167.878593,1482051883.299701,1725460015.507699,5836050066.685993,583953,115756,318574,1018283
2015-07-30,NYSE (DN),144123084,30749944,79097744,253970772,5485430136.444525,1271453645.591497,3697491307.810305,10454375089.846327,582291,95777,310367,988435
2015-07-30,NASDAQ (DQ),1066812318,361355288,658293517,2086461123,35891914974.737875,14854127613.839380,26584870294.758652,77330912883.335907,3726844,645164,2174133,6546141
2015-07-30,EDGA (J),97925383,40928295,48746156,187599834,2920784344.259499,1887083906.549199,1794563855.029493,6602432105.838191,756110,169368,368325,1293803
2015-07-30,EDGX (K),204919296,101792329,175106501,481818126,7145296902.021195,4503987950.966209,7196799729.710346,18846084582.697750,1332796,302413,1053571,2688780
2015-07-30,CHX (M),14439556,7593876,6737503,28770935,503457086.133400,750464383.430000,285962583.305900,1539884052.869300,880,3057,613,4550
2015-07-30,NYSE (N),795634013,0,0,795634013,28218814500.161708,0.000000,0.000000,28218814500.161708,2790352,0,0,2790352
2015-07-30,NYSE Arca (P),291613642,225574034,226410265,743597941,10716535890.967684,12864195384.896416,10305179089.566816,33885910365.430916,2023788,604571,1632915,4261274
2015-07-30,NASDAQ (Q),468113183,108263146,453311459,1029687788,19331665621.513090,6445393631.941106,20708979257.056094,46486038510.510290,3773184,415286,2862453,7050923
2015-07-30,NASDAQ PSX (X),31310796,12785797,17689147,61785740,1103358324.709298,582369075.085000,694469610.086402,2380197009.880700,232595,47824,119573,399992
2015-07-30,BATS BYX (Y),155230552,60559503,72239019,288029074,4500400074.497575,2335008924.037001,2522672286.711069,9358081285.245645,1236576,239219,593348,2069143
2015-07-30,BATS BZX (Z),240965946,92254484,131330756,464551186,8000221962.441365,5653351200.777707,5656856089.619668,19310429252.838740,1796803,361880,1023253,3181936
2015-07-29,NYSE MKT (A),0,9045854,6337101,15382955,0.000000,49457834.103500,117661746.682600,167119580.786100,0,23836,27874,51710
2015-07-29,NASDAQ BX (B),76580514,36566801,39003902,152151217,2787249154.871806,1790485649.207606,1721622909.638004,6299357713.717416,623578,141248,330617,1095443
2015-07-29,NYSE (DN),161706151,34912419,80348446,276967016,6248303357.198939,1560371398.357003,3868088714.256795,11676763469.812737,651145,105050,317404,1073599
2015-07-29,NASDAQ (DQ),1223063756,468328753,634768456,2326160965,42827094684.049692,19904998728.423850,25101908631.831272,87834002044.304814,4101595,759572,2137215,6998382
2015-07-29,EDGA (J),105790986,51000324,50093038,206884348,3548821487.551989,2393092504.580604,1932379638.977112,7874293631.109705,848864,207984,396831,1453679
2015-07-29,EDGX (K),239330439,125383130,176732215,541445784,8147019230.282917,5669192854.664298,7237896630.612579,21054108715.559794,1530582,393076,1041971,2965629
2015-07-29,CHX (M),11660670,15946013,7456371,35063054,408964504.156900,1366102684.443400,666644433.315200,2441711621.915500,609,4198,867,5674
2015-07-29,NYSE (N),880853077,0,0,880853077,32298084172.090436,0.000000,0.000000,32298084172.090436,3090481,0,0,3090481
2015-07-29,NYSE Arca (P),339125002,274854688,225113382,839093072,12324878548.279336,15521153058.117598,10290225505.709969,38136257112.106903,2321006,752925,1630590,4704521
2015-07-29,NASDAQ (Q),546123150,141110093,461992261,1149225504,22584171647.088828,8382606914.592317,21336584561.581605,52303363123.262750,4325261,529746,2946041,7801048
2015-07-29,NASDAQ PSX (X),35359900,17278916,17417446,70056262,1264055584.745999,751851876.847500,698196340.547101,2714103802.140600,250311,61456,118092,429859
2015-07-29,BATS BYX (Y),161781799,73495336,71189100,306466235,4801764455.273499,2880872620.387394,2475166124.234910,10157803199.895803,1304243,288931,600129,2193303
2015-07-29,BATS BZX (Z),263695737,124728395,134453728,522877860,8989192848.045901,7396456630.226871,5446512533.933482,21832162012.206254,1996644,476284,1032734,3505662
2015-07-28,NYSE MKT (A),0,9603983,4517777,14121760,0.000000,59257763.174600,81306521.182200,140564284.356800,0,22883,18699,41582
2015-07-28,NASDAQ BX (B),79043568,33008849,42758962,154811379,2757779134.187799,1798180594.730101,1856882746.187600,6412842475.105500,642977,141371,353359,1137707
2015-07-28,NYSE (DN),173817106,37023723,86655857,297496686,6416148122.050122,1832795095.943298,4037054882.319707,12285998100.313127,700239,112275,347692,1160206
2015-07-28,NASDAQ (DQ),1230654930,455469647,686339916,2372464493,42070006086.524087,22543802449.980287,26214835814.511251,90828644351.015625,4143542,806438,2167085,7117065
2015-07-28,EDGA (J),108749557,47388393,50960041,207097991,3513901389.987100,2471431927.237300,1997613224.221806,7982946541.446206,859563,211555,400871,1471989
2015-07-28,EDGX (K),239077861,122824425,178841017,540743303,8091283092.956213,6150709436.924700,7193141447.375783,21435133977.256696,1515413,396318,1045868,2957599
2015-07-28,CHX (M),12849141,19188110,5351005,37388256,343346477.353500,1516707318.708000,343417557.596400,2203471353.657900,516,4199,1072,5787
2015-07-28,NYSE (N),931457443,0,0,931457443,34582255033.550276,0.000000,0.000000,34582255033.550276,3014010,0,0,3014010
2015-07-28,NYSE Arca (P),335330174,261517922,229836309,826684405,12116663640.150560,16375577173.278517,10288912058.363527,38781152871.792604,2270362,763363,1602804,4636529
2015-07-28,NASDAQ (Q),539939523,139699330,502225231,1181864084,21402714058.470229,9177591972.194092,22613318703.169203,53193624733.833524,4056235,533414,2916107,7505756
2015-07-28,NASDAQ PSX (X),35352098,16112150,23162640,74626888,1224714923.068102,834559584.558999,717361415.800401,2776635923.427502,256082,64844,126273,447199
2015-07-28,BATS BYX (Y),171206477,74777283,77415658,323399418,4926707138.239322,3059891136.055301,2624221577.353886,10610819851.648509,1353181,322608,654117,2329906
2015-07-28,BATS BZX (Z),271653613,117599864,140859159,530112636,9027779094.474020,7645618024.774516,5610330732.489049,22283727851.737585,1969237,461741,1057159,3488137
2015-07-27,NYSE MKT (A),0,9956610,4986649,14943259,0.000000,60924478.035500,102386253.853800,163310731.889300,0,23357,18778,42135
2015-07-27,NASDAQ BX (B),76033609,41286674,41520603,158840886,2710104429.456209,2181858747.980002,1976443118.184208,6868406295.620419,606126,162417,339887,1108430
2015-07-27,NYSE (DN),152118624,44530116,79430390,276079130,6151539466.364883,1869424371.021798,4335230009.622953,12356193847.009634,615330,124793,314399,1054522
2015-07-27,NASDAQ (DQ),1125457089,544455962,649853555,2319766606,37905789406.536787,24518350026.628301,25998088003.062101,88422227436.227189,3869163,942066,2112022,6923251
2015-07-27,EDGA (J),101853893,57728045,50204068,209786006,3267727793.767794,2634286898.274699,2147637989.286589,8049652681.329082,790079,233913,395908,1419900
2015-07-27,EDGX (K),214725375,129358035,181509663,525593073,7371930512.804903,6091044265.817308,7671073736.589449,21134048515.211660,1381259,410490,1067661,2859410
2015-07-27,CHX (M),16280490,13441991,6360303,36082784,619595865.183300,1113839351.861300,400223925.026100,2133659142.070700,1000,3107,1261,5368
2015-07-27,NYSE (N),922437330,0,0,922437330,34321550907.563559,0.000000,0.000000,34321550907.563559,2886571,0,0,2886571
2015-07-27,NYSE Arca (P),301189685,316860634,220584103,838634422,11444253407.615461,18361025889.188411,10447659795.250280,40252939092.054152,2035087,826242,1585008,4446337
2015-07-27,NASDAQ (Q),492339156,146330382,476769481,1115439019,20706178462.636073,9405865618.761796,22926678864.650505,53038722946.048374,3828974,565901,2879637,7274512
2015-07-27,NASDAQ PSX (X),32218562,18067576,20131024,70417162,1166334137.234600,826971689.455000,765114675.735500,2758420502.425100,239119,66185,130551,435855
2015-07-27,BATS BYX (Y),163925236,87001016,75536149,326462401,4781420276.125599,3490414422.753598,2783898476.311512,11055733175.190709,1254012,348771,614598,2217381
2015-07-27,BATS BZX (Z),241237046,131019524,133036887,505293457,8052800272.600825,7934263778.625989,5667202012.196850,21654266063.423664,1772849,497050,1014212,3284111
2015-07-24,NYSE MKT (A),0,12542171,4442336,16984507,0.000000,122089921.431500,110472440.995600,232562362.427100,0,26228,19802,46030
2015-07-24,NASDAQ BX (B),78457556,38011409,40783495,157252460,2641858683.716597,1922845142.681198,2120712484.383300,6685416310.781095,614407,150046,336915,1101368
2015-07-24,NYSE (DN),145759440,39130627,78616824,263506891,5370871708.912985,1741849604.796098,4869406573.252546,11982127886.961629,602333,105716,326958,1035007
2015-07-24,NASDAQ (DQ),1188654786,521013492,684537801,2394206079,38717542998.276936,20489677987.675909,31577828331.963232,90785049317.916077,3910661,834850,2192842,6938353
2015-07-24,EDGA (J),99665802,51087126,47535187,198288115,2932336099.803593,2424932453.224700,2020596133.473382,7377864686.501675,749502,211519,366078,1327099
2015-07-24,EDGX (K),224345751,128506330,187601305,540453386,7453947027.375718,5729997004.655679,8756916607.598193,21940860639.629590,1393124,395730,1108814,2897668
2015-07-24,CHX (M),16829726,6637452,5827830,29295008,438525469.707200,668723372.452400,463381054.143400,1570629896.303000,993,3128,920,5041
2015-07-24,NYSE (N),892208187,0,0,892208187,32326570568.351509,0.000000,0.000000,32326570568.351509,2828460,0,0,2828460
2015-07-24,NYSE Arca (P),297808970,300837702,225341735,823988407,10716815493.969541,16019203119.268831,12504892415.299726,39240911028.538098,2042814,737556,1645457,4425827
2015-07-24,NASDAQ (Q),491092209,136683302,501178180,1128953691,20057567808.468643,8484009645.133388,27241651910.097233,55783229363.699264,3770908,523824,2955578,7250310
2015-07-24,NASDAQ PSX (X),33936949,15797389,18967572,68701910,1157801110.260100,710917542.119999,754167132.877998,2622885785.258097,240386,59587,128521,428494
2015-07-24,BATS BYX (Y),164082180,78397426,76320850,318800456,4622945972.242294,2971208705.719199,2968244624.096110,10562399302.057603,1276133,310290,638754,2225177
2015-07-24,BATS BZX (Z),245655347,117258166,139531771,502445284,8048043932.708658,7248960637.594927,6395994897.724378,21692999468.027963,1783100,448436,1068861,3300397
2015-07-23,NYSE MKT (A),0,8826450,5623805,14450255,0.000000,57797929.551700,97990165.720000,155788095.271700,0,22095,21992,44087
2015-07-23,NASDAQ BX (B),73272662,33613257,39266157,146152076,2554921771.346295,1528468188.404600,1758687301.359798,5842077261.110693,588741,131040,323490,1043271
2015-07-23,NYSE (DN),142980425,34790510,83242951,261013886,5502708407.652797,1450160841.418302,3856411653.584609,10809280902.655708,574781,99947,327640,1002368
2015-07-23,NASDAQ (DQ),1163841680,465426252,708528818,2337796750,39603722643.576499,17551142718.216837,28270017637.762260,85424882999.555596,3953210,758011,2196206,6907427
2015-07-23,EDGA (J),94276463,42966473,46792320,184035256,2798465394.681010,1959579710.859803,1769076167.035794,6527121272.576607,724506,188047,362257,1274810
2015-07-23,EDGX (K),220518198,118207330,183623773,522349301,7511863501.842485,4573035153.071391,7918139433.146272,20003038088.060148,1388429,349227,1080829,2818485
2015-07-23,CHX (M),9955704,11025274,10314737,31295715,298751426.454200,1138845989.816000,752452507.385000,2190049923.655200,525,3196,868,4589
2015-07-23,NYSE (N),858176484,0,0,858176484,31597950997.644656,0.000000,0.000000,31597950997.644656,2886287,0,0,2886287
2015-07-23,NYSE Arca (P),305016780,259233396,226003477,790253653,11232118815.944318,13133510820.559851,11030088602.595090,35395718239.099259,2096986,662089,1623616,4382691
2015-07-23,NASDAQ (Q),481560381,129853505,464775040,1076188926,20096601736.670960,7351335554.488795,22720592405.980379,50168529697.140134,3764560,488211,2862740,7115511
2015-07-23,NASDAQ PSX (X),33864230,14842081,20410022,69116333,1234277772.248400,615660426.105000,745440664.428101,2595378862.781501,246103,55359,128249,429711
2015-07-23,BATS BYX (Y),157121270,68953707,75000620,301075597,4582339142.996219,2611501556.244805,2633470034.660528,9827310733.901552,1237698,279817,620769,2138284
2015-07-23,BATS BZX (Z),240918926,112990965,146349521,500259412,8097294118.868208,6291486341.002882,5988158182.743510,20376938642.614600,1812167,416864,1104999,3334030
2015-07-22,NYSE MKT (A),0,8710034,4317941,13027975,0.000000,51378207.221400,128117094.141600,179495301.363000,0,21527,17788,39315
2015-07-22,NASDAQ BX (B),73294664,31620419,40318719,145233802,2605059801.865295,1518426343.860903,1943875187.508696,6067361333.234894,592630,126414,337069,1056113
2015-07-22,NYSE (DN),128687838,22066767,72300756,223055361,5048105945.745818,990305045.849900,3713714914.367193,9752125905.962911,552381,74119,311276,937776
2015-07-22,NASDAQ (DQ),1178501047,433550482,750939975,2362991504,39680104169.264162,17074154604.225674,32888420188.082672,89642678961.572508,3886345,711881,2314094,6912320
2015-07-22,EDGA (J),91543263,38409861,49975847,179928971,3047188064.619094,1867067333.301801,2041780808.299584,6956036206.220479,728263,160819,383277,1272359
2015-07-22,EDGX (K),204476370,113279958,181900530,499656858,7005715483.285696,4659918010.256380,8081168192.930295,19746801686.472371,1253201,311363,1039557,2604121
2015-07-22,CHX (M),19572797,10168528,5718485,35459810,456554570.090000,926277072.560000,316224717.017800,1699056359.667800,458,2070,1087,3615
2015-07-22,NYSE (N),840578559,0,0,840578559,31494213843.838468,0.000000,0.000000,31494213843.838468,2635087,0,0,2635087
2015-07-22,NYSE Arca (P),293242696,223968480,232581735,749792911,10774520870.953634,12250036848.736611,11869421818.136173,34893979537.826418,1957825,567874,1605264,4130963
2015-07-22,NASDAQ (Q),451882172,108845674,474485794,1035213640,19453030639.968899,6290703466.559763,23719037795.293319,49462771901.821981,3510010,403357,2746373,6659740
2015-07-22,NASDAQ PSX (X),32368020,14970516,19031963,66370499,1203729953.608498,604472946.320100,765220419.037301,2573423318.965899,238196,52286,127738,418220
2015-07-22,BATS BYX (Y),153138944,66442021,76422831,296003796,4603954818.470192,2519064661.607497,2884169500.620329,10007188980.698018,1229777,256254,636652,2122683
2015-07-22,BATS BZX (Z),231095362,98689244,132129710,461914316,7840925055.248383,5488022656.531310,6089899178.082845,19418846889.862538,1682608,362247,1006887,3051742
2015-07-21,NYSE MKT (A),0,9547187,3570712,13117899,0.000000,65936901.378400,103242137.590000,169179038.968400,0,21774,16839,38613
2015-07-21,NASDAQ BX (B),67737037,28067423,36158787,131963247,2447102548.499091,1461644604.804601,1711386241.578807,5620133394.882499,559952,119434,308683,988069
2015-07-21,NYSE (DN),133989388,31122235,74561899,239673522,5011185780.376821,1250151887.951599,3543488730.880405,9804826399.208825,539837,94322,288232,922391
2015-07-21,NASDAQ (DQ),1038416663,412833460,628456429,2079706552,35843117459.141326,15948824726.178087,26865567137.252766,78657509322.572179,3640573,720359,2051044,6411976
2015-07-21,EDGA (J),89857361,35112638,44925114,169895113,2995030434.371966,1799661891.424899,1837465430.513195,6632157756.310060,727313,159466,349142,1235921
2015-07-21,EDGX (K),187083859,100971214,158446497,446501570,6369578745.885024,4657256301.290391,7436134615.544463,18462969662.719878,1177787,303523,936836,2418146
2015-07-21,CHX (M),7830464,7104770,9705817,24641051,328799540.540100,640760367.780000,747907005.158000,1717466913.478100,492,2072,721,3285
2015-07-21,NYSE (N),780651695,0,0,780651695,29593247286.009576,0.000000,0.000000,29593247286.009576,2484155,0,0,2484155
2015-07-21,NYSE Arca (P),260695659,208897654,205829864,675423177,9874760664.671989,10854974725.239057,10576719707.453951,31306455097.364997,1815611,550290,1465868,3831769
2015-07-21,NASDAQ (Q),407316492,97568013,415810114,920694619,17238392922.507016,6066401447.014381,21407629541.938706,44712423911.460103,3225661,385952,2544810,6156423
2015-07-21,NASDAQ PSX (X),29590089,11413752,17464890,58468731,1100158156.791201,528229149.700000,702567672.340101,2330954978.831302,215290,42687,115584,373561
2015-07-21,BATS BYX (Y),139941920,58466335,71660053,270068308,4315521072.620996,2441702936.794296,2656921912.162927,9414145921.578219,1157717,246900,579583,1984200
2015-07-21,BATS BZX (Z),206944925,86436096,119512331,412893352,7126160082.066597,5477859137.502412,5188820054.888869,17792839274.457878,1574680,340486,923477,2838643
2015-07-20,NYSE MKT (A),0,12122774,4175014,16297788,0.000000,59277953.640099,101676058.231700,160954011.871799,0,24699,17065,41764
2015-07-20,NASDAQ BX (B),65366790,31301939,36232371,132901100,2256315679.339398,1387320317.442201,1774623565.225689,5418259562.007288,532580,126217,313712,972509
2015-07-20,NYSE (DN),125818830,31746210,76245299,233810339,4548642885.708812,1203076849.260299,3776775418.487804,9528495153.456915,510821,90954,297005,898780
2015-07-20,NASDAQ (DQ),1071209770,509467540,659898517,2240575827,34711485346.266173,17732871785.109369,29218782004.852982,81663139136.228524,3522054,773928,2126173,6422155
2015-07-20,EDGA (J),81797996,35927070,43974481,161699547,2678421584.110286,1620710206.972201,1778954987.394397,6078086778.476884,654299,153567,343130,1150996
2015-07-20,EDGX (K),177609556,112229780,166753586,456592922,5671483320.021268,4241759108.313085,7398700852.501723,17311943280.836076,1060125,318289,930994,2309408
2015-07-20,CHX (M),14503950,5827540,5603189,25934679,443805035.328600,436969803.328000,610184868.317400,1490959706.974000,549,2153,1088,3790
2015-07-20,NYSE (N),740038381,0,0,740038381,26733912371.802395,0.000000,0.000000,26733912371.802395,2295379,0,0,2295379
2015-07-20,NYSE Arca (P),248022194,267396539,206443522,721862255,8905025777.397901,11882978127.397027,9502654096.006066,30290658000.800994,1680358,587593,1416110,3684061
2015-07-20,NASDAQ (Q),373207527,105555859,418284496,897047882,15454519958.879054,5628485941.582008,20426164446.734783,41509170347.195845,2902681,390640,2466845,5760166
2015-07-20,NASDAQ PSX (X),27739846,11829543,17277071,56846460,1026178932.559602,498039203.532300,679295772.483701,2203513908.575603,204324,41998,111882,358204
2015-07-20,BATS BYX (Y),131535086,58643288,68137389,258315763,3842804433.994611,2155296547.675298,2580770703.636586,8578871685.306495,1029884,229756,557944,1817584
2015-07-20,BATS BZX (Z),199520126,91374265,118554740,409449131,6543532906.263032,4875387597.239789,5069377987.760746,16488298491.263567,1459493,354049,896847,2710389
2015-07-17,NYSE MKT (A),0,9436934,3498744,12935678,0.000000,61922226.373300,68737909.315600,130660135.688900,0,20417,15399,35816
2015-07-17,NASDAQ BX (B),65933179,25238951,35154123,126326253,2286189807.148296,1377198853.868402,1992627948.546398,5656016609.563096,529829,105627,307145,942601
2015-07-17,NYSE (DN),121648758,30972194,74939983,227560935,4491819001.859319,1307588114.937401,4368279989.108755,10167687105.905475,493995,93368,302680,890043
2015-07-17,NASDAQ (DQ),1042446623,411397052,634917483,2088761158,33296221608.705465,19109868979.109805,29490964619.647058,81897055207.462328,3427193,698880,2034535,6160608
2015-07-17,EDGA (J),80243438,34925448,42828722,157997608,2419837224.793592,1731639804.159999,1855341838.308203,6006818867.261794,612458,150029,331797,1094284
2015-07-17,EDGX (K),175941810,94130958,158658330,428731098,5700911571.624974,4187058841.284001,8550814550.039050,18438784962.948025,1051373,281465,919007,2251845
2015-07-17,CHX (M),15157679,8443200,7312964,30913843,605842897.887000,915557187.500000,476114433.371800,1997514518.758800,545,2288,1018,3851
2015-07-17,NYSE (N),874783666,0,0,874783666,32670125291.235344,0.000000,0.000000,32670125291.235344,2476211,0,0,2476211
2015-07-17,NYSE Arca (P),255454249,206654504,198757121,660865874,9232996492.158813,11073124691.698482,10877925568.137776,31184046751.995071,1702015,538867,1448212,3689094
2015-07-17,NASDAQ (Q),386850171,99714582,492213484,978778237,15991870996.302578,6307295899.224235,27168955491.343130,49468122386.869943,2991669,392881,2563295,5947845
2015-07-17,NASDAQ PSX (X),28679237,11198002,18255855,58133094,1023285470.699101,527608514.172600,728471233.951701,2279365218.823402,206977,44439,119968,371384
2015-07-17,BATS BYX (Y),131071611,53830788,70976624,255879023,3844960688.778096,2267258967.533706,2763011601.949176,8875231258.260978,1032149,222576,571177,1825902
2015-07-17,BATS BZX (Z),198397265,85928233,122472483,406797981,6551999992.459696,5001207573.645798,5633696943.416717,17186904509.522211,1457403,334540,920093,2712036
2015-07-16,NYSE MKT (A),0,9770779,4564224,14335003,0.000000,57217549.343100,95479973.119200,152697522.462300,0,22146,18281,40427
2015-07-16,NASDAQ BX (B),67434275,28669847,37396206,133500328,2460909240.120994,1600322812.045000,1835357249.186013,5896589301.352007,566257,117458,342817,1026532
2015-07-16,NYSE (DN),133005198,29173317,79593777,241772292,5133570978.036125,1339360272.773703,3606955353.088811,10079886603.898639,551120,85953,317296,954369
2015-07-16,NASDAQ (DQ),1027547571,448483551,649940662,2125971784,35979852661.329183,21874148163.384332,26612860872.851311,84466861697.564826,3598190,724204,2112602,6434996
2015-07-16,EDGA (J),80312789,35735620,43958794,160007203,2671850720.150315,1875079066.453398,1704648999.687909,6251578786.291622,647805,150354,346858,1145017
2015-07-16,EDGX (K),175884192,100259110,164902928,441046230,6106878884.636478,4446383767.431606,7315031009.937945,17868293662.006029,1073568,287773,948295,2309636
2015-07-16,CHX (M),14632108,15052285,7773774,37458167,743358255.231400,1126131640.333701,810884857.147000,2680374752.712101,1002,2510,890,4402
2015-07-16,NYSE (N),744259832,0,0,744259832,29090119297.036705,0.000000,0.000000,29090119297.036705,2492301,0,0,2492301
2015-07-16,NYSE Arca (P),251113434,208056543,208070899,667240876,9946807258.318833,12785467738.562738,10536200843.459628,33268475840.341199,1753064,552920,1508681,3814665
2015-07-16,NASDAQ (Q),381563446,97454239,421438368,900456053,17005334213.541603,6418896287.178663,20664408965.444338,44088639466.164604,3013955,394867,2604723,6013545
2015-07-16,NASDAQ PSX (X),30199786,11698874,19450249,61348909,1127877182.256301,560949670.757500,754940077.886701,2443766930.900502,226412,45310,126295,398017
2015-07-16,BATS BYX (Y),132312669,59215229,68708593,260236491,4179408986.454241,2505834147.280496,2612731402.390099,9297974536.124836,1102426,241265,596920,1940611
2015-07-16,BATS BZX (Z),196287535,82857698,121824276,400969509,7067051591.216725,5022368908.511983,5292629877.784326,17382050377.513034,1512875,325248,954824,2792947
2015-07-15,NYSE MKT (A),0,9454662,3641409,13096071,0.000000,67336018.354000,95496206.563000,162832224.917000,0,23510,16783,40293
2015-07-15,NASDAQ BX (B),63635693,30547731,35140542,129323966,2301814161.991002,1624877603.172901,1656673282.526603,5583365047.690506,532665,126725,311980,971370
2015-07-15,NYSE (DN),124069253,31000132,75639040,230708425,4857299496.490522,1431599366.740298,3635520013.627395,9924418876.858215,534566,90023,302828,927417
2015-07-15,NASDAQ (DQ),998345320,425147852,577872735,2001365907,34765249437.032774,17229945672.447668,23774387620.833698,75769582730.314140,3488633,699033,1956300,6143966
2015-07-15,EDGA (J),85200951,41478798,42508812,169188561,2889590710.313618,1983550002.687995,1743488755.945996,6616629468.947609,686162,171870,342113,1200145
2015-07-15,EDGX (K),185753565,124154901,150539143,460447609,6149748608.663228,4747895990.708404,6376062521.955018,17273707121.326650,1079864,312246,874925,2267035
2015-07-15,CHX (M),16910740,13802056,9584738,40297534,799220874.770800,945426421.410000,463052117.084800,2207699413.265600,1070,2217,721,4008
2015-07-15,NYSE (N),769193911,0,0,769193911,29128264412.144256,0.000000,0.000000,29128264412.144256,2460556,0,0,2460556
2015-07-15,NYSE Arca (P),261731746,256605428,195288577,713625751,9806446606.377327,14169588555.950126,9462466858.732755,33438502021.060208,1755306,625880,1389406,3770592
2015-07-15,NASDAQ (Q),396640782,112085926,408652561,917379269,16891433280.589478,6844828613.447691,19843269483.946186,43579531377.983355,3078063,436759,2519050,6033872
2015-07-15,NASDAQ PSX (X),29589989,14573387,17512414,61675790,1011582220.990500,630228649.702400,661564083.727398,2303374954.420298,199677,52572,112816,365065
2015-07-15,BATS BYX (Y),129320136,66305866,64617748,260243750,4140260430.854017,2621773612.427104,2469957845.386500,9231991888.667621,1070407,260837,549568,1880812
2015-07-15,BATS BZX (Z),207033114,98296996,116067367,421397477,7049062760.951938,6011609258.319801,4898318329.763747,17958990349.035486,1521450,368487,900618,2790555
2015-07-14,NYSE MKT (A),0,8100904,3243656,11344560,0.000000,52948990.309000,87695435.194900,140644425.503900,0,20241,16305,36546
2015-07-14,NASDAQ BX (B),60248226,27573433,33806251,121627910,2169317745.294696,1453050787.605296,1666746590.927403,5289115123.827395,504670,108926,300291,913887
2015-07-14,NYSE (DN),118719847,26115313,69894466,214729626,4663871071.580194,1269542394.894498,3264569677.493631,9197983143.968323,486351,85729,280661,852741
2015-07-14,NASDAQ (DQ),955332246,371383863,595249493,1921965602,33652720515.485875,16013606057.230320,23905471188.781536,73571797761.497731,3278903,674366,1864032,5817301
2015-07-14,EDGA (J),76986210,33306245,42721046,153013501,2631487736.122606,1600864702.351402,1681277580.193904,5913630018.667912,634408,138242,333911,1106561
2015-07-14,EDGX (K),155890291,90923532,145913965,392727788,5440445991.322509,4070999341.068905,5892975050.453924,15404420382.845338,966950,265249,849423,2081622
2015-07-14,CHX (M),20827441,11059748,4018357,35905546,1348503603.045300,1324685026.122500,205734635.784600,2878923264.952400,857,2282,747,3886
2015-07-14,NYSE (N),696544562,0,0,696544562,26910700690.233131,0.000000,0.000000,26910700690.233131,2217865,0,0,2217865
2015-07-14,NYSE Arca (P),232159246,193183231,193532761,618875238,8799904897.324287,11235110980.823024,8559302981.245760,28594318859.393071,1612732,525751,1345713,3484196
2015-07-14,NASDAQ (Q),355417234,92169157,404301810,851888201,15370427076.530495,6072020317.898000,19141005791.172061,40583453185.600556,2827538,363863,2312521,5503922
2015-07-14,NASDAQ PSX (X),26916070,11542813,18193594,56652477,1014181643.853300,528856950.614800,671503104.528100,2214541698.996200,204251,45556,117074,366881
2015-07-14,BATS BYX (Y),120630080,51776374,64316386,236722840,3749166493.649506,2239762316.441291,2340785234.094098,8329714044.184895,1002433,218828,535179,1756440
2015-07-14,BATS BZX (Z),187031364,79143725,113719991,379895080,6315618511.043898,4847160672.313888,4677016577.708379,15839795761.066165,1446149,312140,891101,2649390
2015-07-13,NYSE MKT (A),0,9997603,3134655,13132258,0.000000,131777502.200500,67521168.679200,199298670.879700,0,22942,15758,38700
2015-07-13,NASDAQ BX (B),66000741,32341934,35879699,134222374,2333364740.997803,1796946421.765003,1621472072.103299,5751783234.866105,540784,131151,309754,981689
2015-07-13,NYSE (DN),82871849,18440800,41889056,143201705,3002694785.414299,936922003.059100,1867052718.652401,5806669507.125800,410730,72110,223137,705977
2015-07-13,NASDAQ (DQ),986156241,491464891,637624511,2115245643,33617533028.437056,21130047737.086930,25427075198.923143,80174655964.447129,3434755,786097,1973746,6194598
2015-07-13,EDGA (J),77766353,40877135,42889884,161533372,2619504580.230001,2160983872.067397,1690748265.397906,6471236717.695304,640807,175108,332434,1148349
2015-07-13,EDGX (K),163320728,117732981,147134797,428188506,5444410699.857852,5136160230.953013,5757126041.925916,16337696972.736781,996618,325353,824649,2146620
2015-07-13,CHX (M),9135357,11044256,4844326,25023939,483163215.530000,1150124856.071000,295313684.020000,1928601755.621000,709,3511,996,5216
2015-07-13,NYSE (N),753429802,0,0,753429802,29045885128.433508,0.000000,0.000000,29045885128.433508,2384475,0,0,2384475
2015-07-13,NYSE Arca (P),246053533,237605813,184892839,668552185,9149787025.098351,13393170831.595224,8414650038.265080,30957607894.958655,1680412,620276,1334522,3635210
2015-07-13,NASDAQ (Q),370173551,111518577,404820013,886512141,15848687645.685779,7243382456.644145,19171013367.154897,42263083469.484821,2899152,430869,2410057,5740078
2015-07-13,NASDAQ PSX (X),27045948,14370652,17654418,59071018,993167113.029999,618128424.605100,668401499.478799,2279697037.113898,203973,55560,116981,376514
2015-07-13,BATS BYX (Y),126743686,67161980,66728832,260634498,3902192326.444901,2840907864.495406,2484497428.297912,9227597619.238219,1047673,259998,561700,1869371
2015-07-13,BATS BZX (Z),193086119,97440716,112389664,402916499,6554067490.556265,6249243091.710890,4648825933.265222,17452136515.532377,1475842,387363,889826,2753031
2015-07-10,NYSE MKT (A),0,7656192,2859815,10516007,0.000000,52656660.848500,81867967.699000,134524628.547500,0,20679,14066,34745
2015-07-10,NASDAQ BX (B),67330895,37889890,35923016,141143801,2342002547.349798,2109762099.182105,1602901059.815299,6054665706.347202,555757,154944,321063,1031764
2015-07-10,NYSE (DN),104104119,25059878,52035641,181199638,4111004826.877619,1267426214.282700,2404468521.946509,7782899563.106828,463162,96297,257139,816598
2015-07-10,NASDAQ (DQ),936541969,497584464,560248579,1994375012,30795710812.141055,22926728744.894602,22754585409.485687,76477024966.521344,3210771,817803,1832534,5861108
2015-07-10,EDGA (J),76728657,51657503,39415181,167801341,2335606059.481496,2500833162.786192,1457562137.966500,6294001360.234188,599291,219699,303439,1122429
2015-07-10,EDGX (K),166514933,120134644,141300998,427950575,5438081263.434686,5753586946.236180,6040509407.821842,17232177617.492708,1011457,363987,815713,2191157
2015-07-10,CHX (M),10528201,13609575,4528345,28666121,503843133.180500,1770364432.434001,284706962.404100,2558914528.018601,576,4214,962,5752
2015-07-10,NYSE (N),738846670,0,0,738846670,28161937499.939223,0.000000,0.000000,28161937499.939223,2481280,0,0,2481280
2015-07-10,NYSE Arca (P),246216692,286683879,175394459,708295030,9164683565.997489,16888661202.522512,8548197285.177778,34601542053.697779,1709537,750557,1322331,3782425
2015-07-10,NASDAQ (Q),371638450,127921499,391830655,891390604,15990048527.194718,8961995681.761730,18884562595.922771,43836606804.879219,2993655,497878,2430854,5922387
2015-07-10,NASDAQ PSX (X),26979323,15558671,17160801,59698795,990323217.466898,718817246.131200,680475973.764898,2389616437.362996,203682,57362,111195,372239
2015-07-10,BATS BYX (Y),130530116,81362295,65491046,277383457,3894237140.530110,3449814614.092703,2338539945.132390,9682591699.755203,1063378,321126,551994,1936498
2015-07-10,BATS BZX (Z),196534005,115391745,114677574,426603324,6715563223.073184,7085805464.423669,5066866113.831299,18868234801.328152,1500160,440444,924204,2864808
2015-07-09,NYSE MKT (A),0,9078756,3489182,12567938,0.000000,60915316.952300,82494736.555000,143410053.507300,0,22704,13974,36678
2015-07-09,NASDAQ BX (B),69253996,34445991,37808229,141508216,2468853578.968100,1960316649.431597,1678476789.994193,6107647018.393890,596951,153856,337506,1088313
2015-07-09,NYSE (DN),140990400,38456977,81342876,260790253,5594045453.141815,1850374472.753808,3650018371.132612,11094438297.028235,572493,113673,316325,1002491
2015-07-09,NASDAQ (DQ),1056520092,488846206,650963707,2196330005,34663311309.030972,22188159589.724289,24773898486.816130,81625369385.571391,3640854,817687,2019402,6477943
2015-07-09,EDGA (J),83575644,48890840,44094978,176561462,2427408981.963596,2482885667.278300,1630938956.363095,6541233605.604991,631072,212675,337090,1180837
2015-07-09,EDGX (K),180073753,116598955,153837567,450510275,5909556337.507079,5737909265.580934,6467597126.389516,18115062729.477529,1107155,380303,899604,2387062
2015-07-09,CHX (M),9440269,17523210,7944555,34908034,363431612.238000,1648598653.025200,301201707.442000,2313231972.705200,728,4822,1135,6685
2015-07-09,NYSE (N),827416024,0,0,827416024,31049379442.969418,0.000000,0.000000,31049379442.969418,2724641,0,0,2724641
2015-07-09,NYSE Arca (P),275276328,285607697,211188174,772072199,10212439721.968306,17621501674.839328,9748513864.925910,37582455261.733544,1924639,771271,1510749,4206659
2015-07-09,NASDAQ (Q),426691871,129054949,445702178,1001448998,18442041662.404293,9556548485.960792,19902479756.402191,47901069904.767276,3400219,540515,2688109,6628843
2015-07-09,NASDAQ PSX (X),29982141,15545038,20758233,66285412,1055229364.508002,834846764.450000,753680250.079796,2643756379.037798,213673,57994,121879,393546
2015-07-09,BATS BYX (Y),135610340,75298675,73661972,284570987,3998045528.867097,3272791527.630501,2467536992.420509,9738374048.918107,1096388,314192,592250,2002830
2015-07-09,BATS BZX (Z),218204560,111647518,135221613,465073691,7337593524.322563,7649177585.370084,5637914442.772659,20624685552.465306,1647108,448310,1022244,3117662
2015-07-08,NYSE MKT (A),0,6106530,1575330,7681860,0.000000,37614621.311300,34856573.208000,72471194.519300,0,12418,8392,20810
2015-07-08,NASDAQ BX (B),82784919,46817157,40581128,170183204,2949819299.784200,2524226685.388497,1828455911.434996,7302501896.607693,742627,207496,387980,1338103
2015-07-08,NYSE (DN),156776720,52471010,76437740,285685470,5883737596.003880,2516452723.986091,3433993818.233423,11834184138.223394,659765,151637,318226,1129628
2015-07-08,NASDAQ (DQ),1113565332,590526170,645514088,2349605590,37870881676.987349,26582262991.016548,24865205395.634752,89318350063.638649,3687490,1027338,2049677,6764505
2015-07-08,EDGA (J),103582025,69921182,50687535,224190742,3334233734.144599,3475752371.336494,1917988475.069994,8727974580.551087,835396,310000,415219,1560615
2015-07-08,EDGX (K),224498575,149610265,166722677,540831517,7412759644.327302,7201442758.888412,6604771401.302172,21218973804.517886,1484475,487999,997727,2970201
2015-07-08,CHX (M),13909464,17679178,4166619,35755261,429629549.114000,1506345007.253000,301664643.930400,2237639200.297400,637,6310,1706,8653
2015-07-08,NYSE (N),444426604,0,0,444426604,17436584614.189883,0.000000,0.000000,17436584614.189883,1168140,0,0,1168140
2015-07-08,NYSE Arca (P),348504215,356856105,214070623,919430943,12685721171.175535,20863965166.592141,9580715677.758631,43130402015.526307,2490376,1009595,1630736,5130707
2015-07-08,NASDAQ (Q),601692198,181574496,478135797,1261402491,24853910062.714810,12566242492.595143,20848877642.953958,58269030198.263911,4958104,751638,3017765,8727507
2015-07-08,NASDAQ PSX (X),38446005,20247219,22678394,81371618,1323855044.176603,1051088760.019100,857541186.787800,3232484990.983503,274418,85631,145618,505667
2015-07-08,BATS BYX (Y),170087877,105147716,80030353,355265946,5160795706.203482,4562657239.156593,2833872611.579620,12557325556.939695,1422317,446728,691118,2560163
2015-07-08,BATS BZX (Z),313481918,158027223,153618293,625127434,11003738186.409829,10332881776.746623,6582196062.697090,27918816025.853542,2415116,614118,1225049,4254283
2015-07-07,NYSE MKT (A),0,11449874,3883535,15333409,0.000000,82668578.588100,91561337.542300,174229916.130400,0,33972,19376,53348
2015-07-07,NASDAQ BX (B),87675724,58999722,45324585,192000031,3102717203.494590,3179200203.360313,1973527675.424589,8255445082.279492,757192,239285,404562,1401039
2015-07-07,NYSE (DN),166537013,57282609,86371581,310191203,6203650640.839126,2742709612.700992,3656171641.772023,12602531895.312141,711138,168333,357597,1237068
2015-07-07,NASDAQ (DQ),1339500522,738629112,699489010,2777618644,43857123221.277943,28384824811.085136,25321651348.498037,97563599380.861116,4465218,1161931,2288810,7915959
2015-07-07,EDGA (J),114907547,81843585,54194657,250945789,3692979847.542110,4140401971.257306,2019872105.252814,9853253924.052230,932603,337576,444870,1715049
2015-07-07,EDGX (K),237703801,184667790,185968783,608340374,8082548449.927484,8636469405.507965,7112008016.669803,23831025872.105252,1527071,560782,1114252,3202105
2015-07-07,CHX (M),17942715,15371199,9106344,42420258,640397926.394000,1692480024.624999,993154464.365000,3326032415.383999,867,5827,1297,7991
2015-07-07,NYSE (N),992727700,0,0,992727700,36264335391.229574,0.000000,0.000000,36264335391.229574,3543288,0,0,3543288
2015-07-07,NYSE Arca (P),373709581,427643066,252426907,1053779554,13513004841.757746,23823309776.954324,10912652200.153341,48248966818.865411,2583487,1204101,1835241,5622829
2015-07-07,NASDAQ (Q),608299400,215296538,527314176,1350910114,24894549500.294371,13800438213.937253,22564761970.947644,61259749685.179268,4743473,850765,3418783,9013021
2015-07-07,NASDAQ PSX (X),39959175,26184034,24070633,90213842,1420443715.208000,1236244994.756800,937727833.298098,3594416543.262898,291088,100433,155119,546640
2015-07-07,BATS BYX (Y),182060203,112833138,89155051,384048392,5580720501.907501,5028668589.322076,3126325460.218420,13735714551.447997,1521343,456561,756703,2734607
2015-07-07,BATS BZX (Z),310706855,186386098,158866820,655959773,10092868263.188476,12282793494.788458,6446136371.431239,28821798129.408173,2304790,711077,1247521,4263388
2015-07-06,NYSE MKT (A),0,10959014,3345541,14304555,0.000000,58396832.476300,93008167.990400,151405000.466700,0,22073,17101,39174
2015-07-06,NASDAQ BX (B),69652175,36955919,37477478,144085572,2533999162.837983,2015261402.327698,1574491080.845597,6123751646.011278,618993,156704,334377,1110074
2015-07-06,NYSE (DN),121710241,37005547,65021989,223737777,4656855251.250010,1589092067.513297,2649074546.692008,8895021865.455315,526612,105677,269382,901671
2015-07-06,NASDAQ (DQ),1013966418,571325163,564445650,2149737231,34453746302.726736,22313397673.583248,19753152576.182088,76520296552.492072,3546435,911892,1825551,6283878
2015-07-06,EDGA (J),82951589,52847131,44585204,180383924,2723459914.212197,2568942678.439695,1521746239.423603,6814148832.075495,692017,215420,339423,1246860
2015-07-06,EDGX (K),104914416,96968330,86882223,288764969,3587123706.195199,4331174836.833796,3211352076.189566,11129650619.218561,681155,274272,524887,1480314
2015-07-06,CHX (M),12784240,9853056,6071762,28709058,496663920.720000,956038481.397400,254869706.904200,1707572109.021600,520,4151,873,5544
2015-07-06,NYSE (N),936598220,0,0,936598220,36711071761.839971,0.000000,0.000000,36711071761.839971,2726101,0,0,2726101
2015-07-06,NYSE Arca (P),291385025,333756701,207324103,832465829,11056942394.785973,17346965604.522397,8727201205.941808,37131109205.250178,2013853,842078,1501061,4356992
2015-07-06,NASDAQ (Q),451219602,144042098,515539419,1110801119,19460285016.906808,8709837849.776530,21645309954.945746,49815432821.629084,3635854,560183,2714571,6910608
2015-07-06,NASDAQ PSX (X),28117860,17941965,17217066,63276891,1085678511.348100,767908030.960000,607079048.700700,2460665591.008800,212421,69086,108699,390206
2015-07-06,BATS BYX (Y),146183882,82636773,72832406,301653061,4676488338.911899,3447974671.067706,2423916507.637583,10548379517.617188,1267364,328004,608732,2204100
2015-07-06,BATS BZX (Z),231136195,120078854,128052192,479267241,7956063289.229312,7045680578.040415,4944643102.597431,19946386969.867158,1736713,472137,999470,3208320
2015-07-02,NYSE MKT (A),0,9432420,3727638,13160058,0.000000,56589108.311400,105239003.728200,161828112.039600,0,21060,16965,38025
2015-07-02,NASDAQ BX (B),60936474,28457557,31435958,120829989,2172180727.119494,1570347534.287099,1309249432.102786,5051777693.509379,530139,121815,277675,929629
2015-07-02,NYSE (DN),114699555,30690540,61588297,206978392,4125772775.249287,1490575166.247699,2446354604.857398,8062702546.354384,477994,88837,246601,813432
2015-07-02,NASDAQ (DQ),905028768,430245433,496854601,1832128802,29616334620.788904,18626243582.458566,17689724354.055730,65932302557.303200,3287213,711226,1670843,5669282
2015-07-02,EDGA (J),68500503,40089223,36252586,144842312,2184229249.219200,2112783926.807399,1247145895.395601,5544159071.422200,551632,164116,265832,981580
2015-07-02,EDGX (K),162479044,106687749,129342235,398509028,5509316238.983779,4584956910.414388,4655433319.518378,14749706468.916545,1012073,296144,727152,2035369
2015-07-02,CHX (M),7115388,10918368,5314534,23348290,294455007.190000,1082830250.970900,233687421.981600,1610972680.142500,362,3304,662,4328
2015-07-02,NYSE (N),725585919,0,0,725585919,27896697061.949813,0.000000,0.000000,27896697061.949813,2299276,0,0,2299276
2015-07-02,NYSE Arca (P),237419662,231794827,166070767,635285256,8877526751.090001,13743362421.783014,7106497512.620332,29727386685.493347,1658512,607617,1203379,3469508
2015-07-02,NASDAQ (Q),377510498,102822775,380647421,860980694,16239985810.243397,6711019496.198499,16515690235.450114,39466695541.892010,3034935,414151,2221944,5671030
2015-07-02,NASDAQ PSX (X),25251944,14087380,15971633,55310957,944526813.323599,643806378.469200,586894844.174099,2175228035.966898,188151,54663,103942,346756
2015-07-02,BATS BYX (Y),122306163,64784867,61278712,248369742,3873049287.440134,2816896679.602301,2057418446.287503,8747364413.329938,1020563,262461,501920,1784944
2015-07-02,BATS BZX (Z),192282808,86275782,104872791,383431381,6624603257.514208,5364441054.233717,4063203315.586718,16052247627.334643,1463269,346862,814507,2624638
2015-07-01,NYSE MKT (A),0,8451447,3301362,11752809,0.000000,65767804.455000,78547933.102100,144315737.557100,0,22584,17133,39717
2015-07-01,NASDAQ BX (B),72418829,35120932,37564605,145104366,2501102316.420996,2007662765.034100,1488311501.380913,5997076582.836009,622589,146867,329048,1098504
2015-07-01,NYSE (DN),146635395,36476126,70044823,253156344,5526715177.920788,1687898481.316602,2881502300.651904,10096115959.889294,564780,106018,273292,944090
2015-07-01,NASDAQ (DQ),1192173582,624811158,627762947,2444747687,41012942932.641360,32945815262.631176,22113338496.588562,96072096691.861098,3990171,868264,2020093,6878528
2015-07-01,EDGA (J),84724593,44812143,42672607,172209343,2862087873.667688,2482247931.868396,1467710826.132997,6812046631.669081,702005,197527,329534,1229066
2015-07-01,EDGX (K),188916347,133840558,154445984,477202889,6516072958.641907,5847708409.541900,5452001531.135973,17815782899.319780,1199944,380247,874085,2454276
2015-07-01,CHX (M),15467337,11970143,5683372,33120852,737100917.630000,1583971536.362400,447323764.359500,2768396218.351900,588,4158,894,5640
2015-07-01,NYSE (N),862367794,0,0,862367794,32165036509.488369,0.000000,0.000000,32165036509.488369,2645139,0,0,2645139
2015-07-01,NYSE Arca (P),292506873,290557222,203149207,786213302,11643003948.244673,17062519143.508966,8394962313.206052,37100485404.959691,2077020,725591,1485507,4288118
2015-07-01,NASDAQ (Q),470701995,124774112,452356279,1047832386,20850525906.875162,8505575488.481349,18723369456.973237,48079470852.329748,3857680,504465,2694118,7056263
2015-07-01,NASDAQ PSX (X),29369690,15675088,17813529,62858307,1118581293.156198,727904757.137500,642995162.750899,2489481213.044597,211779,63067,116122,390968
2015-07-01,BATS BYX (Y),156767958,76637714,78276032,311681704,5097737798.255408,3528040677.210292,2644958618.525197,11270737093.990897,1330758,314421,669650,2314829
2015-07-01,BATS BZX (Z),227169875,106010307,123653536,456833718,8234160503.821178,7126269407.847734,4746734240.341738,20107164152.010650,1776724,429964,978484,3185172
2015-06-30,NYSE MKT (A),0,11859219,5246449,17105668,0.000000,96157493.901400,128248352.604200,224405846.505600,0,23424,26779,50203
2015-06-30,NASDAQ BX (B),74528227,41561667,38969862,155059756,2559366310.338800,2379069636.116502,1634976791.161886,6573412737.617188,639898,160335,345542,1145775
2015-06-30,NYSE (DN),138258901,40800150,77601031,256660082,4769484656.309622,2087016692.571200,3152970260.731431,10009471609.612253,571113,121510,298018,990641
2015-06-30,NASDAQ (DQ),1179108322,550553904,683899138,2413561364,39443975463.765115,28560852108.501831,25041471881.575064,93046299453.842010,3906043,902525,2075664,6884232
2015-06-30,EDGA (J),91287551,56368964,49341802,196998317,3039022417.359904,3226265156.771597,1823455827.339400,8088743401.470901,734881,240114,378854,1353849
2015-06-30,EDGX (K),192435779,144592600,151772136,488800515,6608851387.328596,7146688939.250197,5519661983.544110,19275202310.122903,1220883,425655,876913,2523451
2015-06-30,CHX (M),12581246,12355624,11806275,36743145,611463595.272200,1825978823.214001,394797406.728200,2832239825.214401,645,5474,1276,7395
2015-06-30,NYSE (N),1181258386,0,0,1181258386,44001270276.254974,0.000000,0.000000,44001270276.254974,2895527,0,0,2895527
2015-06-30,NYSE Arca (P),296133146,355376480,210513578,862023204,11225203258.937089,21370008143.345187,8977293604.056894,41572505006.339170,2065714,879674,1484456,4429844
2015-06-30,NASDAQ (Q),471606047,165172304,568762917,1205541268,20182052718.071852,11921344174.707830,24654859149.249300,56758256042.028982,3737029,650211,2886268,7273508
2015-06-30,NASDAQ PSX (X),29851813,19722657,19056767,68631237,1138965141.638802,972598552.334400,701522548.388799,2813086242.362001,218024,78016,118259,414299
2015-06-30,BATS BYX (Y),165296993,89263226,84942961,339503180,5494188087.128268,4203001970.411392,3165318641.665314,12862508699.204974,1454785,389196,762932,2606913
2015-06-30,BATS BZX (Z),246757640,140474960,136476604,523709204,8466041512.461147,9529454242.002020,5309675260.677878,23305171015.141045,1847233,541354,1041250,3429837
2015-06-29,NYSE MKT (A),0,12325671,3775603,16101274,0.000000,73106602.993700,97478349.896000,170584952.889700,0,28055,18972,47027
2015-06-29,NASDAQ BX (B),69958500,42449735,38214903,150623138,2451728613.394902,2656545759.760308,1601722689.276291,6709997062.431501,610897,168127,335999,1115023
2015-06-29,NYSE (DN),143067761,43044720,80508920,266621401,5159569296.015505,2204322443.901298,3233772105.170523,10597663845.087326,587173,122971,312605,1022749
2015-06-29,NASDAQ (DQ),1055727876,589480082,662801229,2308009187,35202888061.673565,33189354407.188360,24377133228.886732,92769375697.748657,3839132,1068931,2128832,7036895
2015-06-29,EDGA (J),88429389,55061300,48939456,192430145,2940190934.377497,3282845305.924998,1847133286.123996,8070169526.426491,720778,236481,371086,1328345
2015-06-29,EDGX (K),205965253,161837459,170129470,537932182,6932262236.832863,7785556176.155905,6228898261.545170,20946716674.533938,1252320,472016,928701,2653037
2015-06-29,CHX (M),18881655,11372878,20660548,50915081,997348672.971100,1648222213.794700,1249320104.323000,3894890991.088800,622,6381,1526,8529
2015-06-29,NYSE (N),875506459,0,0,875506459,33282811550.446917,0.000000,0.000000,33282811550.446917,2795891,0,0,2795891
2015-06-29,NYSE Arca (P),293758345,350967843,221326773,866052961,10883665315.089418,22279202208.558762,9831966468.378463,42994833992.026643,2016536,898861,1591253,4506650
2015-06-29,NASDAQ (Q),495157399,184115610,526141049,1205414058,20668452489.301660,12985140800.531888,22150161356.943947,55803754646.777495,3765438,693960,3009609,7469007
2015-06-29,NASDAQ PSX (X),30652084,20772784,20756696,72181564,1152078326.367199,981950442.288900,752398604.911199,2886427373.567298,216759,79638,130460,426857
2015-06-29,BATS BYX (Y),158550566,86167755,85556443,330274764,5208379540.992366,4191157872.016600,3070697692.456170,12470235105.465136,1382553,369669,720479,2472701
2015-06-29,BATS BZX (Z),244282968,149877600,148909541,543070109,8465114899.214221,10075971173.787301,6032043570.747590,24573129643.749112,1817572,568092,1106635,3492299
2015-06-26,NYSE MKT (A),0,98471906,4109513,102581419,0.000000,525001255.342800,105226785.681200,630228041.024000,0,40271,18101,58372
2015-06-26,NASDAQ BX (B),65364831,29023997,38938272,133327100,2286434583.164403,1821804060.701503,1537506816.328497,5645745460.194403,550344,115867,335905,1002116
2015-06-26,NYSE (DN),140996466,27065905,82228226,250290597,5133431992.262490,1396824594.927801,3087731937.402687,9617988524.592978,556492,86094,322549,965135
2015-06-26,NASDAQ (DQ),1617534160,386861516,1766817770,3771213446,63136139394.358333,17992671182.840266,53471954784.482601,134600765361.681200,3476009,693367,2085385,6254761
2015-06-26,EDGA (J),80738952,39808149,49643423,170190524,2580600322.733391,2201308600.938602,1631466149.076505,6413375072.748498,630094,165911,359741,1155746
2015-06-26,EDGX (K),174076651,104007652,159779181,437863484,5939351232.419574,5001302423.761490,5749829756.190542,16690483412.371606,1052115,294238,871062,2217415
2015-06-26,CHX (M),17684803,9306403,5603537,32594743,1050759170.066800,832988409.223700,298550889.295000,2182298468.585500,572,2925,1234,4731
2015-06-26,NYSE (N),1852177236,0,0,1852177236,63861225464.702202,0.000000,0.000000,63861225464.702202,2830155,0,0,2830155
2015-06-26,NYSE Arca (P),244969198,207185325,208757458,660911981,9549767278.783315,12836253190.182523,8618639018.601729,31004659487.567567,1697850,578816,1440423,3717089
2015-06-26,NASDAQ (Q),440659200,114563856,1283098432,1838321488,18840566690.643809,8090839336.804021,40198510552.695499,67129916580.143329,3330383,447634,3087302,6865319
2015-06-26,NASDAQ PSX (X),26773115,12969577,19539534,59282226,1091592410.278801,628004807.634700,714335349.034001,2433932566.947502,203304,50396,130364,384064
2015-06-26,BATS BYX (Y),160635572,58896176,89232908,308764656,5348275672.521008,2889235908.033702,3031126722.826220,11268638303.380930,1330721,254688,745811,2331220
2015-06-26,BATS BZX (Z),217661138,94987514,140686246,453334898,7897953704.558785,6390973946.739097,5387671764.998083,19676599416.295965,1624732,378957,1020347,3024036
2015-06-25,NYSE MKT (A),0,11786479,3564637,15351116,0.000000,82274548.484700,107894052.390800,190168600.875500,0,26605,17845,44450
2015-06-25,NASDAQ BX (B),59692392,24158835,29478608,113329835,2143741631.739000,1389961043.369300,1255093047.681402,4788795722.789702,512511,96077,265504,874092
2015-06-25,NYSE (DN),127363243,24286492,62566943,214216678,5146197249.431911,1102679675.544900,2734951301.235394,8983828226.212205,537445,77498,262547,877490
2015-06-25,NASDAQ (DQ),1026784132,377547791,567369707,1971701630,35785192248.059117,17723472140.712324,20914382929.043268,74423047317.814709,3560032,635048,1795265,5990345
2015-06-25,EDGA (J),72747693,32615561,36459956,141823210,2380051130.061710,1755411063.369702,1189025438.010198,5324487631.441610,577467,134951,270987,983405
2015-06-25,EDGX (K),165530745,100525767,133203967,399260479,5872877462.230966,4054806291.289587,4947301966.077122,14874985719.597675,1004000,251082,720501,1975583
2015-06-25,CHX (M),11312706,8065748,5977607,25356061,478489747.028400,1006403166.800000,206340544.856000,1691233458.684400,1443,2167,860,4470
2015-06-25,NYSE (N),773958584,0,0,773958584,30503091685.359987,0.000000,0.000000,30503091685.359987,2385322,0,0,2385322
2015-06-25,NYSE Arca (P),250623629,212957779,172322090,635903498,9895975045.813132,12241341904.037884,7378262221.680841,29515579171.531857,1691740,509040,1222337,3423117
2015-06-25,NASDAQ (Q),410772955,98533248,421359566,930665769,18213371013.200580,6229899584.896688,18370502930.145298,42813773528.242566,3134346,366273,2368480,5869099
2015-06-25,NASDAQ PSX (X),25619456,11032283,15223585,51875324,1033986021.738799,475678370.830000,568112406.137899,2077776798.706698,196821,41546,105041,343408
2015-06-25,BATS BYX (Y),135327278,51443342,64573656,251344276,4419629903.564123,2305522936.743002,2225552494.612914,8950705334.920039,1158351,208827,554508,1921686
2015-06-25,BATS BZX (Z),207587021,83279242,107908947,398775210,7372066207.277073,5221227790.515290,4219515492.236303,16812809490.028666,1523566,315116,804928,2643610
2015-06-24,NYSE MKT (A),0,12307331,2811175,15118506,0.000000,123718308.614100,78787889.547300,202506198.161400,0,24133,12983,37116
2015-06-24,NASDAQ BX (B),56034461,23440598,30019543,109494602,2015779136.354097,1416863039.298600,1438663659.340717,4871305834.993414,490232,101852,273114,865198
2015-06-24,NYSE (DN),110591471,25122223,57595253,193308947,4190622553.730796,1235442996.112301,3099671594.417807,8525737144.260904,453897,80939,252659,787495
2015-06-24,NASDAQ (DQ),983881197,394900883,583578375,1962360455,35728663934.876765,19649650096.818057,23153231767.747345,78531545799.442167,3346164,645971,1888263,5880398
2015-06-24,EDGA (J),72639517,35221095,39554997,147415609,2613478168.716487,1935814555.222200,1529390280.139196,6078683004.077883,605026,145174,306507,1056707
2015-06-24,EDGX (K),156430777,92899374,137240692,386570843,5561995513.047900,4324425538.320487,5755740659.824462,15642161711.192849,967947,273266,758844,2000057
2015-06-24,CHX (M),14978345,14749866,4478900,34207111,517850795.202400,1333521383.656800,232628726.022000,2084000904.881200,1228,2279,661,4168
2015-06-24,NYSE (N),740986445,0,0,740986445,29766732957.038827,0.000000,0.000000,29766732957.038827,2250416,0,0,2250416
2015-06-24,NYSE Arca (P),242765255,202405437,175179584,620350276,9474021158.539038,11338413203.042539,8843336892.447310,29655771254.028887,1661760,538546,1275389,3475695
2015-06-24,NASDAQ (Q),384991772,98213058,411550704,894755534,17284808156.007978,6314504088.048408,19691049738.373809,43290361982.430195,3018263,379656,2294609,5692528
2015-06-24,NASDAQ PSX (X),23425131,10830189,14889575,49144895,924657955.586301,552287127.562300,606188863.759100,2083133946.907701,176562,43712,102246,322520
2015-06-24,BATS BYX (Y),127545339,52766478,66147041,246458858,4305022024.068470,2412768519.375900,2503774047.162798,9221564590.607168,1116140,228717,572996,1917853
2015-06-24,BATS BZX (Z),190291367,85087623,108212198,383591188,7017412682.069299,5567968577.452084,4598557442.835327,17183938702.356710,1441929,337469,825830,2605228
2015-06-23,NYSE MKT (A),0,12817945,4022938,16840883,0.000000,89121271.094700,112787091.285000,201908362.379700,0,27492,15567,43059
2015-06-23,NASDAQ BX (B),55762119,22290006,29294301,107346426,2017000226.121995,1192248081.428699,1250585859.385799,4459834166.936493,476748,89817,257504,824069
2015-06-23,NYSE (DN),117103484,24397460,62262783,203763727,4691868403.195404,1126817766.871702,2713447772.540606,8532133942.607712,477141,78623,264105,819869
2015-06-23,NASDAQ (DQ),1048885686,389843497,600119759,2038848942,37000579684.697473,15452777077.774801,21272297458.232629,73725654220.704903,3346219,667120,1830746,5844085
2015-06-23,EDGA (J),71624326,34721151,38107287,144452764,2504543654.790294,1665634959.390301,1338588556.575491,5508767170.756086,587635,141258,289664,1018557
2015-06-23,EDGX (K),166534498,98231667,144252769,409018934,5829217992.935795,3694912586.422090,5286707338.708439,14810837918.066324,987478,257455,745725,1990658
2015-06-23,CHX (M),11738654,17186519,6501725,35426898,502763919.536000,1336925775.434000,288189294.224600,2127878989.194600,527,1979,661,3167
2015-06-23,NYSE (N),690490550,0,0,690490550,27271470549.869675,0.000000,0.000000,27271470549.869675,2135731,0,0,2135731
2015-06-23,NYSE Arca (P),230312008,184731954,168788654,583832616,9011966596.152850,9751191252.610310,7248600659.350487,26011758508.113647,1567725,477946,1205408,3251079
2015-06-23,NASDAQ (Q),358909207,88283694,379732314,826925215,15914835034.633327,5479314696.662018,17151447113.090870,38545596844.386215,2784462,344839,2179175,5308476
2015-06-23,NASDAQ PSX (X),23530657,11148638,14945709,49625004,941433972.422400,508926463.559300,562774580.606100,2013135016.587800,173463,40807,102045,316315
2015-06-23,BATS BYX (Y),127390144,48676425,66224393,242290962,4384059641.389778,2150868623.501300,2372635213.995206,8907563478.886284,1091025,206007,572739,1869771
2015-06-23,BATS BZX (Z),193340717,76963765,103209363,373513845,6898738861.944658,4619757615.378675,4152379062.040290,15670875539.363623,1434580,300757,809849,2545186
2015-06-22,NYSE MKT (A),0,12980842,3391355,16372197,0.000000,93072922.880300,92313034.381600,185385957.261900,0,25955,16482,42437
2015-06-22,NASDAQ BX (B),59879694,24814305,30049867,114743866,2170092616.593608,1353422216.479300,1330363163.169099,4853877996.242007,499958,101005,275867,876830
2015-06-22,NYSE (DN),106880816,26301085,60202079,193383980,4181474521.997302,1285165153.398902,2551076703.161109,8017716378.557313,462673,87060,256022,805755
2015-06-22,NASDAQ (DQ),956384432,390202604,573340630,1919927666,34963820268.196298,15000751811.330189,21013674372.546411,70978246452.072898,3350062,683820,1846646,5880528
2015-06-22,EDGA (J),78624506,34065800,39058957,151749263,2809392425.330598,1793649678.590499,1457472020.131507,6060514124.052604,644178,150127,309450,1103755
2015-06-22,EDGX (K),160592492,95546292,139346497,395485281,5866706017.041681,4099604566.672595,5152377800.977729,15118688384.692005,983079,270014,749416,2002509
2015-06-22,CHX (M),15646311,12212609,5225635,33084555,917960142.268302,950480472.635400,285202431.464500,2153643046.368202,515,2462,688,3665
2015-06-22,NYSE (N),714497221,0,0,714497221,28420976906.883714,0.000000,0.000000,28420976906.883714,2213296,0,0,2213296
2015-06-22,NYSE Arca (P),243480316,216628648,175864832,635973796,9919009161.177180,11954831002.660613,7686186693.567564,29560026857.405357,1638181,545392,1242949,3426522
2015-06-22,NASDAQ (Q),360835465,100342922,411730050,872908437,16271136551.416373,6251213684.876285,18530129289.715248,41052479526.007906,2857608,387548,2303033,5548189
2015-06-22,NASDAQ PSX (X),23275621,12238541,14346879,49861041,932877626.889697,558730598.781400,567358264.503798,2058966490.174895,177349,46442,98713,322504
2015-06-22,BATS BYX (Y),130276700,52864841,67241584,250383125,4568868564.268222,2375416705.129397,2468233052.203593,9412518321.601212,1121065,224104,587010,1932179
2015-06-22,BATS BZX (Z),190090959,82352958,106427553,378871470,7027359069.650552,5174220463.970998,4303003711.600726,16504583245.222276,1468445,325774,845634,2639853
2015-06-19,NYSE MKT (A),0,62980195,3686019,66666214,0.000000,246844826.503700,69336274.411200,316181100.914900,0,30601,17464,48065
2015-06-19,NASDAQ BX (B),67851801,26837310,35714352,130403463,2357858395.695698,1613261180.814899,1508149607.314802,5479269183.825399,548523,107118,295388,951029
2015-06-19,NYSE (DN),114435267,29103688,62909537,206448492,3979592763.870511,1412416415.872997,2620832737.929099,8012841917.672607,504334,91472,276903,872709
2015-06-19,NASDAQ (DQ),1105360780,476702124,745733519,2327796423,37006419450.457406,21705089816.076495,28114782229.480000,86826291496.013901,3399255,706082,1839932,5945269
2015-06-19,EDGA (J),81356285,38084677,42650163,162091125,2564942211.369298,2173054868.979604,1447802581.080296,6185799661.429198,635538,163404,309615,1108557
2015-06-19,EDGX (K),169572029,107126705,140559319,417258053,5709562055.431302,4890834808.034186,5147111475.976710,15747508339.442198,1008642,296319,745036,2049997
2015-06-19,CHX (M),10021318,18754151,10434854,39210323,472245524.890800,2060959700.970001,901258951.357400,3434464177.218201,603,3020,919,4542
2015-06-19,NYSE (N),1880869277,0,0,1880869277,75854375220.342902,0.000000,0.000000,75854375220.342902,2557926,0,0,2557926
2015-06-19,NYSE Arca (P),251047617,255378580,187660192,694086389,9496392929.017386,15662519149.330011,8207873078.425813,33366785156.773210,1679209,574139,1266490,3519838
2015-06-19,NASDAQ (Q),386934431,110179999,1031802939,1528917369,16438287553.800739,7702371125.903592,42913390860.010147,67054049539.714478,2930006,412650,2621956,5964612
2015-06-19,NASDAQ PSX (X),27702428,11049914,17001903,55754245,1105216518.357001,513150659.569100,626956413.552203,2245323591.478304,210435,44398,115445,370278
2015-06-19,BATS BYX (Y),164458811,59855186,82764725,307078722,5430851947.720333,2861088406.575396,2964239764.516901,11256180118.812630,1322671,254200,652846,2229717
2015-06-19,BATS BZX (Z),207312823,95786580,115396671,418496074,7238135676.499585,6542029651.341718,4636420097.216906,18416585425.058209,1538974,365923,872304,2777201
2015-06-18,NYSE MKT (A),0,14760460,4229895,18990355,0.000000,109152880.635300,111532155.900700,220685036.536000,0,28404,15073,43477
2015-06-18,NASDAQ BX (B),67802895,32987820,34165468,134956183,2449527586.851096,2138085404.758801,1545720651.766788,6133333643.376685,574861,136754,308605,1020220
2015-06-18,NYSE (DN),127879089,33083978,67551102,228514169,4579284522.009703,1720213653.471401,2837375264.201300,9136873439.682404,531714,102223,288769,922706
2015-06-18,NASDAQ (DQ),1078724112,507029078,666837337,2252590527,36779777402.839166,28042121680.453982,23842394288.648493,88664293371.941641,3595321,804998,1955818,6356137
2015-06-18,EDGA (J),90674772,49229469,46374645,186278886,2969686739.975297,2813369352.602595,1676182533.541900,7459238626.119792,718380,201994,345573,1265947
2015-06-18,EDGX (K),200175070,127177116,169882769,497234955,7015690313.241917,6192044439.515494,6221318621.892414,19429053374.649825,1166713,372668,858840,2398221
2015-06-18,CHX (M),8872182,26683893,4324059,39880134,451212599.093200,2594633042.640000,242824676.002800,3288670317.736000,585,7136,1519,9240
2015-06-18,NYSE (N),852531236,0,0,852531236,32641654695.077145,0.000000,0.000000,32641654695.077145,2645094,0,0,2645094
2015-06-18,NYSE Arca (P),285833403,271023301,201175139,758031843,11032500880.073911,17495149754.036123,8951601004.477736,37479251638.587770,1915893,704216,1392970,4013079
2015-06-18,NASDAQ (Q),435798796,137891697,459042020,1032732513,19247326369.530421,9860672835.953543,20378849107.346344,49486848312.830308,3380996,542700,2668344,6592040
2015-06-18,NASDAQ PSX (X),32920303,15984468,20356500,69261271,1310303864.110200,773049086.701400,800399781.969696,2883752732.781296,243808,61471,124610,429889
2015-06-18,BATS BYX (Y),161874666,74899961,81703322,318477949,5603377023.582753,3839629044.131501,3117953944.043000,12560960011.757254,1380461,307556,688503,2376520
2015-06-18,BATS BZX (Z),228145990,125784709,126277682,480208381,8265655031.486207,8426861013.261321,5344809564.403592,22037325609.151120,1726699,476697,962541,3165937
2015-06-17,NYSE MKT (A),0,11881404,4322178,16203582,0.000000,83478480.583200,139225853.244100,222704333.827300,0,25666,17252,42918
2015-06-17,NASDAQ BX (B),60218354,30340227,29436391,119994972,2118825499.779294,1829147899.688499,1236301461.892798,5184274861.360591,499794,125464,252975,878233
2015-06-17,NYSE (DN),113136463,31003242,63471197,207610902,4205997603.497211,1754395173.115701,2505487171.602805,8465879948.215717,470107,91489,250987,812583
2015-06-17,NASDAQ (DQ),997249216,436745887,599527906,2033523009,33912281006.375294,22606372041.631933,20542180551.166192,77060833599.173419,3264577,751502,1791249,5807328
2015-06-17,EDGA (J),78852761,44136868,42339718,165329347,2621141369.927791,2324702174.455797,1439631460.226797,6385475004.610385,620717,182549,301578,1104844
2015-06-17,EDGX (K),186173892,119013355,160891870,466079117,6534093836.176533,5284310335.888893,5321666392.755301,17140070564.820727,1108683,343057,793825,2245565
2015-06-17,CHX (M),9621036,10006428,6704256,26331720,322357878.243400,1267584058.920000,273531845.821500,1863473782.984900,535,5914,1185,7634
2015-06-17,NYSE (N),716676123,0,0,716676123,27280853677.703843,0.000000,0.000000,27280853677.703843,2336576,0,0,2336576
2015-06-17,NYSE Arca (P),263021610,262642077,191125920,716789607,10154169827.080559,15021391866.929673,8090035436.479376,33265597130.489608,1780375,689001,1306018,3775394
2015-06-17,NASDAQ (Q),419579184,132484546,415612923,967676653,17703323915.930482,8772856730.016267,17834635391.349225,44310816037.295974,3233110,522162,2367681,6122953
2015-06-17,NASDAQ PSX (X),28724800,13942788,18008243,60675831,1063730540.940997,640874520.146800,600870589.135800,2305475650.223597,198280,52636,106584,357500
2015-06-17,BATS BYX (Y),140010888,69445294,69612757,279068939,4646462835.282683,3169036546.835599,2573139038.220071,10388638420.338353,1142265,291522,569136,2002923
2015-06-17,BATS BZX (Z),213056101,114213458,114833513,442103072,7507132332.136804,7214295543.479407,4583782605.823113,19305210481.439324,1617402,440156,877165,2934723
2015-06-16,NYSE MKT (A),0,12756459,4255308,17011767,0.000000,94175013.407400,130682745.932000,224857759.339400,0,25630,16588,42218
2015-06-16,NASDAQ BX (B),56589314,20888151,29141368,106618833,1975952925.356704,1271859199.264098,1136108862.079302,4383920986.700104,472793,91640,245497,809930
2015-06-16,NYSE (DN),105425760,22955610,58148869,186530239,4021761167.700222,1116994118.842300,2267084729.731617,7405840016.274139,462011,74232,239728,775971
2015-06-16,NASDAQ (DQ),949473128,356995220,597073542,1903541890,31844053787.566029,18391944995.710340,17516655541.756660,67752654325.033029,3260262,626711,1736864,5623837
2015-06-16,EDGA (J),71399922,30285998,42693060,144378980,2397198275.479505,1674771764.867904,1294948494.755601,5366918535.103010,569488,133076,281977,984541
2015-06-16,EDGX (K),152428087,89194667,158003047,399625801,5503232376.518091,3886400491.336101,4670967988.620461,14060600856.474653,940713,252559,710512,1903784
2015-06-16,CHX (M),10985808,11223953,4063991,26273752,432659813.058200,1100472179.547200,309173967.455700,1842305960.061100,848,3844,915,5607
2015-06-16,NYSE (N),652815621,0,0,652815621,24751975709.556500,0.000000,0.000000,24751975709.556500,2073517,0,0,2073517
2015-06-16,NYSE Arca (P),231358432,179171039,182823345,593352816,9202567060.038471,10274890356.651718,7052830831.718574,26530288248.408763,1559746,493548,1206358,3259652
2015-06-16,NASDAQ (Q),356135018,86832461,389192035,832159514,15537634824.585310,5851818470.411799,15356614365.427127,36746067660.424236,2778350,356832,2171816,5306998
2015-06-16,NASDAQ PSX (X),24525094,9847060,16613441,50985595,972630421.844999,485084304.737100,595706033.450499,2053420760.032598,182118,41955,102918,326991
2015-06-16,BATS BYX (Y),124955953,47788862,65731280,238476095,4251144228.619417,2231221101.085402,2284537074.157291,8766902403.862110,1043352,207439,539604,1790395
2015-06-16,BATS BZX (Z),185532620,76739432,109461768,371733820,6595355382.864083,4980471869.422286,3945603486.424043,15521430738.710412,1415837,301064,810800,2527701
2015-06-15,NYSE MKT (A),0,13762842,3717272,17480114,0.000000,143297127.709100,118380716.742000,261677844.451100,0,29714,14671,44385
2015-06-15,NASDAQ BX (B),58361745,27883749,31062401,117307895,2091123273.203895,1650863827.887601,1294808240.797104,5036795341.888600,495279,117243,267858,880380
2015-06-15,NYSE (DN),110828482,28366115,67977846,207172443,4281900549.475611,1419236683.526300,2612135899.291187,8313273132.293098,478687,87385,251698,817770
2015-06-15,NASDAQ (DQ),926578176,387957148,623474996,1938010320,31438822716.606659,20139151981.335075,21227363121.287909,72805337819.229643,3352802,720186,1790639,5863627
2015-06-15,EDGA (J),73566679,39092756,47499354,160158789,2492902759.612999,2091083215.767396,1483716014.749796,6067701990.130191,592022,156027,310919,1058968
2015-06-15,EDGX (K),155572352,97057160,161806095,414435607,5637615152.049910,4551189720.543389,5100307082.114997,15289111954.708296,987954,306639,761442,2056035
2015-06-15,CHX (M),6913543,11446069,6363548,24723160,307999700.317200,1377002522.159002,552608486.500000,2237610708.976202,761,5616,1413,7790
2015-06-15,NYSE (N),734270661,0,0,734270661,28363598591.694293,0.000000,0.000000,28363598591.694293,2251162,0,0,2251162
2015-06-15,NYSE Arca (P),238984574,222919826,193231505,655135905,9578809215.635458,14340440123.330876,7970312767.479309,31889562106.445643,1665861,608860,1323389,3598110
2015-06-15,NASDAQ (Q),398622462,112709546,454001641,965333649,17280591833.262965,8085735697.598738,18636798287.366793,44003125818.228496,3131317,469580,2404425,6005322
2015-06-15,NASDAQ PSX (X),25980094,12060467,16990181,55030742,968053427.588201,572151145.895900,610060249.677901,2150264823.162002,193928,50069,114179,358176
2015-06-15,BATS BYX (Y),134952108,61043785,73577072,269572965,4649797236.458486,2903136812.233594,2642938801.256589,10195872849.948669,1140889,266741,613499,2021129
2015-06-15,BATS BZX (Z),201038256,97356998,116668162,415063416,7209471968.211746,6596170717.849092,4727260622.036184,18532903308.097022,1531222,382927,902218,2816367
2015-06-12,NYSE MKT (A),0,12573543,2663226,15236769,0.000000,90836732.472300,65874318.781600,156711051.253900,0,24138,12377,36515
2015-06-12,NASDAQ BX (B),49675649,23197837,25867920,98741406,1721608899.929096,1518549711.718902,1082520498.009305,4322679109.657303,420772,97966,225562,744300
2015-06-12,NYSE (DN),95887517,24112874,50670586,170670977,3543031207.842889,1362152966.018400,2231253571.748097,7136437745.609386,391634,77025,222603,691262
2015-06-12,NASDAQ (DQ),845271459,371862289,488717339,1705851087,28595903506.410652,23016125801.385387,17653474953.412258,69265504261.208297,2906241,610997,1569672,5086910
2015-06-12,EDGA (J),61571977,32022169,33834616,127428762,2001065148.176998,1817931584.275701,1175939450.989804,4994936183.442503,494227,130076,253797,878100
2015-06-12,EDGX (K),149191118,85045534,123029955,357266607,5055535089.857000,4150073240.994105,4712783038.675056,13918391369.526161,902992,265446,693888,1862326
2015-06-12,CHX (M),9470198,16058745,4700182,30229125,441357897.827000,1986172079.779000,316573276.404000,2744103254.010000,605,6145,1189,7939
2015-06-12,NYSE (N),659673645,0,0,659673645,25729970213.673144,0.000000,0.000000,25729970213.673144,2037934,0,0,2037934
2015-06-12,NYSE Arca (P),207671630,193814971,155820692,557307293,8107602584.859224,11875283743.162926,6722724009.459476,26705610337.481626,1450249,528432,1141744,3120425
2015-06-12,NASDAQ (Q),333118239,95273453,369960967,798352659,14422537189.266971,7144351483.310803,16458311920.022507,38025200592.600281,2584176,388428,2066188,5038792
2015-06-12,NASDAQ PSX (X),20262274,9849151,13181921,43293346,790627798.598198,504010805.007100,507596803.226700,1802235406.831998,154816,37843,86875,279534
2015-06-12,BATS BYX (Y),113714950,51658813,58172258,223546021,3848167359.945606,2521419687.557596,2147073942.852202,8516660990.355404,967271,219069,495622,1681962
2015-06-12,BATS BZX (Z),176171909,85338818,104742602,366253329,6359643037.470698,6174677172.843019,4276810533.565737,16811130743.879454,1360463,333616,813706,2507785
2015-06-11,NYSE MKT (A),0,9370319,4743359,14113678,0.000000,91719022.616000,148341332.134500,240060354.750500,0,21820,19026,40846
2015-06-11,NASDAQ BX (B),54326412,23992661,27062637,105381710,1974739360.192401,1253580926.771697,1176414088.208803,4404734375.172901,449631,97333,230343,777307
2015-06-11,NYSE (DN),109620727,26963232,62380618,198964577,4133535605.613918,1243797074.005603,2566474574.009611,7943807253.629132,458843,87881,253693,800417
2015-06-11,NASDAQ (DQ),972125418,419033062,573080378,1964238858,32351626460.731036,17211917965.138403,21185788352.349547,70749332778.218986,3143022,658381,1697290,5498693
2015-06-11,EDGA (J),71064148,34908229,36429871,142402248,2344450496.249502,1778939409.990201,1239113465.136600,5362503371.376303,555372,144581,269861,969814
2015-06-11,EDGX (K),166511807,86102549,128030027,380644383,5576054918.587402,3886513451.102004,4827571392.716811,14290139762.406217,959670,267681,695935,1923286
2015-06-11,CHX (M),9848178,16312947,5356316,31517441,257123657.058000,1445840779.262800,304942530.796000,2007906967.116800,540,3872,799,5211
2015-06-11,NYSE (N),785728283,0,0,785728283,31204921633.197597,0.000000,0.000000,31204921633.197597,2120034,0,0,2120034
2015-06-11,NYSE Arca (P),252128253,198850755,171889254,622868262,9496076585.620556,11304324104.192412,7475912122.913698,28276312812.726666,1604703,524885,1193931,3323519
2015-06-11,NASDAQ (Q),372065914,90769771,428076607,890912292,15760559390.367964,6015959711.626700,19480036720.339831,41256555822.334495,2760078,367376,2150510,5277964
2015-06-11,NASDAQ PSX (X),26722751,9105196,14834922,50662869,946750782.818800,430743104.218000,534106942.947900,1911600829.984700,184377,35415,96149,315941
2015-06-11,BATS BYX (Y),133198019,54035721,66322401,253556141,4580776918.680799,2437721030.788198,2433761547.085395,9452259496.554392,1111445,225530,538907,1875882
2015-06-11,BATS BZX (Z),194239224,84115249,109762196,388116669,6799022622.629565,5309286439.498388,4453671430.614666,16561980492.742619,1436213,328267,830470,2594950
2015-06-10,NYSE MKT (A),0,11226063,4295775,15521838,0.000000,85135575.153700,146984375.170000,232119950.323700,0,25736,20151,45887
2015-06-10,NASDAQ BX (B),59543118,31351195,31107164,122001477,2127492851.833002,1905418994.106899,1445664265.761597,5478576111.701498,489257,121873,266578,877708
2015-06-10,NYSE (DN),129496204,32127288,70272768,231896260,5251891715.211034,1626887608.892304,3248862930.931706,10127642255.035044,501411,102950,281788,886149
2015-06-10,NASDAQ (DQ),1083633708,504624311,634351483,2222609502,37880187250.839831,24810453345.880483,25098863788.068398,87789504384.788712,3478005,817049,1908897,6203951
2015-06-10,EDGA (J),82502983,44814936,44366864,171684783,2884722406.339901,2387761798.351905,1714306827.493103,6986791032.184909,657412,173268,342038,1172718
2015-06-10,EDGX (K),180702743,117582555,147785419,446070717,6208656407.986892,5083816877.712599,6050454669.568604,17342927955.268095,1075122,332828,828911,2236861
2015-06-10,CHX (M),9050701,11669178,5678514,26398393,296626428.010000,1269332038.910000,286943511.426500,1852901978.346500,1049,4607,988,6644
2015-06-10,NYSE (N),782534598,0,0,782534598,29563353234.959299,0.000000,0.000000,29563353234.959299,2344729,0,0,2344729
2015-06-10,NYSE Arca (P),275159616,272445875,191295039,738900530,10816828757.246520,16336424794.594563,9006563021.039167,36159816572.880250,1831054,682319,1357517,3870890
2015-06-10,NASDAQ (Q),425844496,120334455,451883461,998062412,18399577808.851318,8763009086.050673,20474378895.841853,47636965790.743844,3219240,454423,2535373,6209036
2015-06-10,NASDAQ PSX (X),26372209,14167371,16792558,57332138,1024219401.093203,610840618.142300,671021021.420699,2306081040.656202,200250,46928,114089,361267
2015-06-10,BATS BYX (Y),147717506,69067119,76202657,292987282,5039740064.382123,3290413340.180198,2882829274.010807,11212982678.573128,1239854,276536,640221,2156611
2015-06-10,BATS BZX (Z),214467396,110552630,122988884,448008910,7703336291.727071,6915262630.587493,5181630147.484523,19800229069.799087,1613120,397976,949794,2960890
2015-06-09,NYSE MKT (A),0,11914823,4257862,16172685,0.000000,87518357.711900,105767267.801900,193285625.513800,0,26971,15354,42325
2015-06-09,NASDAQ BX (B),52613069,24524504,30379284,107516857,1916923063.465300,1414085093.136600,1288491729.158201,4619499885.760101,440063,102838,252778,795679
2015-06-09,NYSE (DN),112981461,28527017,69916304,211424782,4274183305.284895,1555712808.697404,2890747391.080819,8720643505.063118,461085,86555,260252,807892
2015-06-09,NASDAQ (DQ),938396123,418776745,626999561,1984172429,32363050163.406429,18976911317.413140,22552845386.434415,73892806867.253984,3210994,719366,1876924,5807284
2015-06-09,EDGA (J),72267206,36194389,41771332,150232927,2537408721.964201,1924588517.061397,1525724211.701304,5987721450.726902,582577,151302,310965,1044844
2015-06-09,EDGX (K),163819593,108043274,149244365,421107232,5639308796.134824,4482575697.197692,5725012252.282260,15846896745.614776,994257,303384,813642,2111283
2015-06-09,CHX (M),9105351,12518252,5623326,27246929,329072181.709200,961096459.789999,251219902.319200,1541388543.818399,566,2913,1079,4558
2015-06-09,NYSE (N),718224159,0,0,718224159,27557023250.891171,0.000000,0.000000,27557023250.891171,2175112,0,0,2175112
2015-06-09,NYSE Arca (P),242887757,221579355,197214813,661681925,9458145183.599871,13388790019.088913,8703197782.803699,31550132985.492483,1683942,599458,1363603,3647003
2015-06-09,NASDAQ (Q),374399443,102440230,416853560,893693233,16222562424.004041,7177579130.712561,18025979213.708498,41426120768.425100,2892557,409123,2404948,5706628
2015-06-09,NASDAQ PSX (X),23708845,11739900,16432508,51881253,888598925.192901,485845511.837900,595494843.656700,1969939280.687501,168741,42741,107564,319046
2015-06-09,BATS BYX (Y),131429198,60813448,71677120,263919766,4429318085.192522,2702304838.562706,2570025387.000629,9701648310.755857,1073280,241953,582194,1897427
2015-06-09,BATS BZX (Z),199804997,88848308,129074693,417727998,7083614712.342677,5806847758.144089,5140415908.944947,18030878379.431713,1500381,350799,963239,2814419
2015-06-08,NYSE MKT (A),0,12157776,3495032,15652808,0.000000,82428045.374700,75672526.574000,158100571.948700,0,26080,13864,39944
2015-06-08,NASDAQ BX (B),53875773,21777371,31317960,106971104,2065884281.593601,1386758186.985200,1335918485.596603,4788560954.175404,451782,95074,264101,810957
2015-06-08,NYSE (DN),103710167,24061958,65345025,193117150,3971923242.986849,1289977607.954801,2779838011.072081,8041738862.013731,474888,72430,267203,814521
2015-06-08,NASDAQ (DQ),897305974,349573222,617838742,1864717938,31909549333.277944,15634111284.809721,21773927584.599078,69317588202.686743,3246616,646660,1913862,5807138
2015-06-08,EDGA (J),71485925,31362141,41147559,143995625,2556768290.945200,1721498885.388102,1573935363.610094,5852202539.943396,583801,131809,317578,1033188
2015-06-08,EDGX (K),153750039,90362659,146506980,390619678,5722098450.623595,4031306851.708903,5549797441.635269,15303202743.967767,982719,270193,803231,2056143
2015-06-08,CHX (M),8276046,6542217,4425477,19243740,293488673.098100,733690632.900400,286662982.193600,1313842288.192100,394,2762,1256,4412
2015-06-08,NYSE (N),698248660,0,0,698248660,27150092171.138682,0.000000,0.000000,27150092171.138682,2109470,0,0,2109470
2015-06-08,NYSE Arca (P),224196103,205573826,183768741,613538670,9123416314.237876,11914028306.254379,8159529212.216647,29196973832.708902,1580189,536257,1300072,3416518
2015-06-08,NASDAQ (Q),362148674,91689347,408737244,862575265,15986773458.826170,6372771499.845692,18076778116.198235,40436323074.870097,2807226,382090,2335563,5524879
2015-06-08,NASDAQ PSX (X),23376214,9405016,17052544,49833774,928658539.272501,457463317.600000,662245495.227799,2048367352.100300,180193,38040,112476,330709
2015-06-08,BATS BYX (Y),134200750,53460280,71711747,259372777,4609971394.560808,2501879555.512702,2689282403.871798,9801133353.945308,1116700,223017,592368,1932085
2015-06-08,BATS BZX (Z),188539673,80744700,124524914,393809287,6978626977.975789,5346098715.788400,5003475649.520412,17328201343.284601,1456373,319564,951099,2727036
2015-06-05,NYSE MKT (A),0,12863717,3746618,16610335,0.000000,85065980.533700,101707852.000400,186773832.534100,0,27042,17358,44400
2015-06-05,NASDAQ BX (B),57876709,30085581,34985553,122947843,2148474466.504194,1647407073.424401,1298623719.598804,5094505259.527399,470838,120284,261539,852661
2015-06-05,NYSE (DN),114882420,29646391,73868230,218397041,4514651389.447108,1571602123.127705,2700890756.702117,8787144269.276930,485590,87561,277010,850161
2015-06-05,NASDAQ (DQ),979840894,484760751,624151767,2088753412,34681527009.958653,22778869554.363696,19990685681.055581,77451082245.377930,3337580,770474,1881500,5989554
2015-06-05,EDGA (J),83536132,44466871,45470412,173473415,2762218570.564291,2273100040.038200,1413047375.761594,6448365986.364085,647409,174285,305921,1127615
2015-06-05,EDGX (K),177410717,116135560,151519186,445065463,6437346993.095414,5365155740.557994,5628091077.985548,17430593811.638956,1073456,344648,796721,2214825
2015-06-05,CHX (M),9496893,11253503,4738747,25489143,303026274.292400,1495421215.521000,280470135.584000,2078917625.397400,659,3820,740,5219
2015-06-05,NYSE (N),783928172,0,0,783928172,30010663850.267408,0.000000,0.000000,30010663850.267408,2418546,0,0,2418546
2015-06-05,NYSE Arca (P),256297532,255153825,216238953,727690310,10128691859.860669,14699203188.363113,8304438027.369998,33132333075.593780,1728079,699511,1305695,3733285
2015-06-05,NASDAQ (Q),407600483,126077917,448213005,981891405,17874197205.490706,8722300162.923578,18516592135.511240,45113089503.925524,3096820,505282,2432325,6034427
2015-06-05,NASDAQ PSX (X),25407667,13377292,20747252,59532211,969700417.509802,603165215.711800,622905015.612100,2195770648.833702,188267,46414,111055,345736
2015-06-05,BATS BYX (Y),146413868,64360547,89939768,300714183,5010915169.497133,2927667529.623802,2675554846.661791,10614137545.782726,1211708,260072,618040,2089820
2015-06-05,BATS BZX (Z),219187502,108030145,133427930,460645577,7985862835.361570,6875203139.495524,5169875686.465365,20030941661.322459,1656847,423584,980982,3061413
2015-06-04,NYSE MKT (A),0,11860834,3537226,15398060,0.000000,102992317.174500,94145173.541000,197137490.715500,0,27954,14445,42399
2015-06-04,NASDAQ BX (B),57214402,31622065,30593444,119429911,2092544347.352292,1965056562.281899,1310100089.419297,5367700999.053488,477384,127794,262544,867722
2015-06-04,NYSE (DN),111266951,30878578,67879259,210024788,4419390063.610684,1684037722.783297,2754647925.036288,8858075711.430269,480801,96213,276640,853654
2015-06-04,NASDAQ (DQ),1003758477,454801967,641534292,2100094736,36084828287.218137,23976938414.485296,21750346084.820305,81812112786.523738,3310166,779561,1896966,5986693
2015-06-04,EDGA (J),78171384,44130818,43769750,166071952,2600113663.778999,2457211514.310099,1577560148.283601,6634885326.372699,608204,175006,320697,1103907
2015-06-04,EDGX (K),175531059,114569102,161421132,451521293,6389690299.646497,5332866578.603012,5660641298.051139,17383198176.300648,1061670,333534,838081,2233285
2015-06-04,CHX (M),18833783,11214516,5053930,35102229,606282974.419000,1422201386.278400,338384192.855000,2366868553.552400,686,5058,903,6647
2015-06-04,NYSE (N),729973843,0,0,729973843,29230562558.717384,0.000000,0.000000,29230562558.717384,2390586,0,0,2390586
2015-06-04,NYSE Arca (P),262877502,252480448,201161376,716519326,10839592283.173220,15715603704.930216,8503121504.072519,35058317492.175955,1783149,697315,1357968,3838432
2015-06-04,NASDAQ (Q),400085968,123915496,434437103,958438567,18313045488.359827,8908211225.529806,18519081306.207454,45740338020.097087,3152341,500375,2534319,6187035
2015-06-04,NASDAQ PSX (X),24583604,11826956,17487572,53898132,978580144.137001,526875219.850000,636553887.578002,2142009251.565003,181057,41903,105548,328508
2015-06-04,BATS BYX (Y),139244820,67657845,73409101,280311766,4952738197.386398,3430740039.140896,2741221668.839669,11124699905.366963,1159454,276419,601430,2037303
2015-06-04,BATS BZX (Z),210934114,105864070,140208935,457007119,8038134348.814489,7439264899.001171,5730555072.028616,21207954319.844276,1658112,424281,1061315,3143708
2015-06-03,NYSE MKT (A),0,9869628,2871924,12741552,0.000000,85477061.720900,87393196.471000,172870258.191900,0,24699,13290,37989
2015-06-03,NASDAQ BX (B),56260640,27514604,31683510,115458754,2018712759.618091,1691859769.399401,1282241227.606403,4992813756.623895,466421,119039,264586,850046
2015-06-03,NYSE (DN),106505175,27399558,75966647,209871380,4125993752.728199,1341398444.252503,2904309866.989367,8371702063.970069,450642,82880,278356,811878
2015-06-03,NASDAQ (DQ),1013712802,412342187,697305236,2123360225,36050026723.741775,18968362739.388473,23156916010.360138,78175305473.490386,3268830,712505,1962421,5943756
2015-06-03,EDGA (J),75048403,39476461,43359968,157884832,2430718320.710099,2219235219.663003,1479455843.479297,6129409383.852399,590923,158903,321112,1070938
2015-06-03,EDGX (K),165412105,99817939,157618413,422848457,5942672714.606911,4731349651.030795,5361689339.665352,16035711705.303058,985628,294296,823694,2103618
2015-06-03,CHX (M),8284935,8799905,5710017,22794857,255307810.306000,906336210.015500,259120553.778500,1420764574.100000,738,3478,925,5141
2015-06-03,NYSE (N),684717105,0,0,684717105,26267667480.575223,0.000000,0.000000,26267667480.575223,2233885,0,0,2233885
2015-06-03,NYSE Arca (P),239927171,225960575,193251610,659139356,9440302889.401260,13305173719.259109,7798639186.781463,30544115795.441832,1628391,610804,1302146,3541341
2015-06-03,NASDAQ (Q),392338702,113069431,429852187,935260320,16965578106.468591,7773649031.686196,17502698944.668835,42241926082.823622,2943810,447064,2461092,5851966
2015-06-03,NASDAQ PSX (X),25685769,10672514,17096025,53454308,964699486.497001,573067980.736000,633805804.216698,2171573271.449699,181828,42946,112142,336916
2015-06-03,BATS BYX (Y),131863166,57573938,72807932,262245036,4444071909.356092,2788045037.994898,2581558935.775408,9813675883.126398,1089067,247059,590738,1926864
2015-06-03,BATS BZX (Z),201898886,100451007,129538970,431888863,7255477462.036294,6660559984.223103,4956130737.364290,18872168183.623687,1523547,391167,978993,2893707
2015-06-02,NYSE MKT (A),0,9798709,3889097,13687806,0.000000,91010044.746800,107962854.083400,198972898.830200,0,25917,16252,42169
2015-06-02,NASDAQ BX (B),55142913,28352261,29781972,113277146,1961302197.804998,1755482654.912703,1279092372.163295,4995877224.880996,455964,121193,257065,834222
2015-06-02,NYSE (DN),105987837,27396918,66976114,200360869,4075061975.816592,1431044017.596401,2903678727.325504,8409784720.738497,450764,84797,269996,805557
2015-06-02,NASDAQ (DQ),904741544,403564314,612370856,1920676714,31783631832.710876,17519909856.864211,20713187975.430838,70016729665.005925,3203303,688767,1869955,5762025
2015-06-02,EDGA (J),73099236,37493485,42562331,153155052,2537516513.028789,2083871409.380800,1621802637.042992,6243190559.452581,592849,155011,326801,1074661
2015-06-02,EDGX (K),168067009,96107142,151537313,415711464,5992310139.456291,4342763372.525901,5486390098.364867,15821463610.347059,1017513,272371,811247,2101131
2015-06-02,CHX (M),9546688,11207740,3422553,24176981,445805924.515200,1161926449.360000,209388846.469300,1817121220.344500,649,3478,857,4984
2015-06-02,NYSE (N),728287497,0,0,728287497,27561483071.441728,0.000000,0.000000,27561483071.441728,2188219,0,0,2188219
2015-06-02,NYSE Arca (P),252805655,230863356,185536965,669205976,9942472501.119979,13571796633.813504,8095858325.081320,31610127460.014803,1720208,599319,1294721,3614248
2015-06-02,NASDAQ (Q),398872234,106224720,428791756,933888710,17326536019.673159,7043611594.238194,17954959006.207634,42325106620.118987,3045454,427457,2387936,5860847
2015-06-02,NASDAQ PSX (X),25727449,10625650,16069142,52422241,1023428324.512301,526512089.224600,630010113.471799,2179950527.208700,191138,41163,108915,341216
2015-06-02,BATS BYX (Y),128495095,56146626,71454427,256096148,4411307154.427125,2734342375.796104,2674798670.094004,9820448200.317233,1077360,246488,591172,1915020
2015-06-02,BATS BZX (Z),202619805,89556245,121667522,413843572,7241732042.902492,5883013107.576590,4931226412.526823,18055971563.005905,1541101,360107,951040,2852248
2015-06-01,NYSE MKT (A),0,9833400,4066927,13900327,0.000000,75195680.679300,90770504.572800,165966185.252100,0,24599,16182,40781
2015-06-01,NASDAQ BX (B),54475960,28044468,33828046,116348474,2126241370.767599,1795907500.163496,1466777113.256800,5388925984.187895,482974,119361,288254,890589
2015-06-01,NYSE (DN),106279035,26296233,73865486,206440754,4173611074.225115,1372065527.160003,2983746948.629719,8529423550.014837,467938,85187,297963,851088
2015-06-01,NASDAQ (DQ),903249388,404456306,660662705,1968368399,32450478125.616336,19875141168.942110,23257242573.059833,75582861867.618279,3338084,715871,2107236,6161191
2015-06-01,EDGA (J),72342966,37681075,47035239,157059280,2683266121.155697,2130245909.511502,1845138715.401992,6658650746.069191,611354,155563,361196,1128113
2015-06-01,EDGX (K),161802987,89919971,166229812,417952770,5865691291.147393,4600046351.738502,5997530549.816322,16463268192.702217,1042508,297247,903357,2243112
2015-06-01,CHX (M),9251530,9631734,6227999,25111263,318290474.926900,1067732504.575000,390564316.801600,1776587296.303500,791,4829,1117,6737
2015-06-01,NYSE (N),682704563,0,0,682704563,26444130505.633336,0.000000,0.000000,26444130505.633336,2297451,0,0,2297451
2015-06-01,NYSE Arca (P),241978170,234872642,209055018,685905830,9839025675.359986,14818463807.894525,9125914229.814663,33783403713.069174,1733263,651486,1452310,3837059
2015-06-01,NASDAQ (Q),409268992,106191097,464177951,979638040,18271229008.568084,7409095654.739093,19422505002.169313,45102829665.476490,3289772,439742,2747808,6477322
2015-06-01,NASDAQ PSX (X),24179470,10951078,18262403,53392951,957188782.743901,553567273.530400,679807074.359700,2190563130.634001,189883,45196,119049,354128
2015-06-01,BATS BYX (Y),145308504,59834890,87203709,292347103,5122287492.151314,3003276578.812898,3187182650.094189,11312746721.058401,1265927,255281,699377,2220585
2015-06-01,BATS BZX (Z),200982279,96782312,133360034,431124625,7293095202.539716,6549868777.702622,5513444472.617166,19356408452.859504,1563304,396925,1042954,3003183
2015-05-29,NYSE MKT (A),0,15957975,3189059,19147034,0.000000,113691302.926000,97232962.795400,210924265.721400,0,26259,16191,42450
2015-05-29,NASDAQ BX (B),59772987,30762724,32308162,122843873,2326338774.324106,1907287164.632003,1499100322.782296,5732726261.738405,495806,122303,274448,892557
2015-05-29,NYSE (DN),116874370,29450594,72607248,218932212,4789035668.568588,1545871090.765102,3115118941.392200,9450025700.725890,504983,92079,273060,870122
2015-05-29,NASDAQ (DQ),1150971682,480755479,722012228,2353739389,42758940839.134211,22375806393.436004,28631616851.450945,93766364084.021160,3520640,733587,1920208,6174435
2015-05-29,EDGA (J),85258278,46586597,44780947,176625822,3197335138.926404,2494499717.989704,1872021126.912202,7563855983.828310,711413,180919,355760,1248092
2015-05-29,EDGX (K),179114524,117805237,155411445,452331206,6872326096.310080,5194200073.450589,5950026268.551473,18016552438.312142,1167783,321669,854098,2343550
2015-05-29,CHX (M),10664009,10284807,5534125,26482941,330633221.809200,1399797902.950000,368863922.795000,2099295047.554200,621,3860,710,5191
2015-05-29,NYSE (N),1182316256,0,0,1182316256,46934707950.775967,0.000000,0.000000,46934707950.775967,2559037,0,0,2559037
2015-05-29,NYSE Arca (P),266766576,254495332,194940775,716202683,11573985181.208540,15362427223.598820,9062480120.255496,35998892525.062856,1918406,682390,1365946,3966742
2015-05-29,NASDAQ (Q),461950609,125961326,566348687,1154260622,21205556635.087412,8349480707.716999,25848245480.387661,55403282823.192072,3598624,456417,2671896,6726937
2015-05-29,NASDAQ PSX (X),27091203,11069767,16722188,54883158,1115492473.968000,520332655.833600,664521333.264801,2300346463.066401,214960,46536,111572,373068
2015-05-29,BATS BYX (Y),167952977,75671802,81142126,324766905,5867039055.347798,3508685348.226003,3142747268.965299,12518471672.539100,1397644,290781,673344,2361769
2015-05-29,BATS BZX (Z),225983048,101980545,134804591,462768184,8741191229.403470,6927283289.951904,5690089977.671376,21358564497.026750,1777910,392482,1040094,3210486
2015-05-28,NYSE MKT (A),0,8803567,4656404,13459971,0.000000,86354143.771400,114194271.819300,200548415.590700,0,23449,19412,42861
2015-05-28,NASDAQ BX (B),51783997,24114569,28141335,104039901,1976931660.202193,1334216522.839697,1226079001.804999,4537227184.846889,439252,99149,238896,777297
2015-05-28,NYSE (DN),98115405,24322348,67242650,189680403,3805994786.686386,1103688424.414001,2752721139.887502,7662404350.987889,441408,71221,266509,779138
2015-05-28,NASDAQ (DQ),918438306,382421905,624876038,1925736249,33139497800.327904,14869955109.777517,21957618001.484839,69967070911.590260,3095436,626270,1834637,5556343
2015-05-28,EDGA (J),70720895,34925769,40346901,145993565,2479926436.853600,1735493045.890402,1399915944.697700,5615335427.441702,585015,143845,307368,1036228
2015-05-28,EDGX (K),155863296,89011300,154290385,399164981,5616853635.500304,3586902730.236614,5250492700.391687,14454249066.128605,956005,265810,793775,2015590
2015-05-28,CHX (M),24053804,7141777,7426638,38622219,699252697.592000,844883142.860000,319954972.891000,1864090813.343000,354,2159,625,3138
2015-05-28,NYSE (N),690296548,0,0,690296548,25874071983.075882,0.000000,0.000000,25874071983.075882,2120177,0,0,2120177
2015-05-28,NYSE Arca (P),235529836,215907292,193315647,644752775,9547278003.768340,12072771138.527204,8263279316.507976,29883328458.803520,1616505,585818,1285754,3488077
2015-05-28,NASDAQ (Q),382903550,100007658,415733371,898644579,16978118053.761819,6046263977.206417,17853162037.928177,40877544068.896413,3026904,381496,2399872,5808272
2015-05-28,NASDAQ PSX (X),22582474,9641617,15948359,48172450,881625265.045200,407162887.391100,567417312.038602,1856205464.474902,174393,35704,96773,306870
2015-05-28,BATS BYX (Y),139321717,56888459,71529710,267739886,4699384939.622261,2472075070.967295,2583819811.419721,9755279822.009277,1177012,226781,581201,1984994
2015-05-28,BATS BZX (Z),192998295,86264225,120542360,399804880,6974687976.337204,5125194480.546503,4879091240.707116,16978973697.590823,1472915,339773,934516,2747204
2015-05-27,NYSE MKT (A),0,9370898,3870318,13241216,0.000000,76217765.892200,97837085.932900,174054851.825100,0,21883,16284,38167
2015-05-27,NASDAQ BX (B),51348290,21176590,29208060,101732940,1989299684.947096,1321176558.562801,1327275101.797686,4637751345.307583,431636,94490,249155,775281
2015-05-27,NYSE (DN),110592996,26195835,73590429,210379260,4238796751.823600,1368330406.944299,3134513970.811226,8741641129.579125,469474,78840,276566,824880
2015-05-27,NASDAQ (DQ),985777719,380091471,632310810,1998180000,36919173465.955902,18036065220.251391,22423569817.711386,77378808503.918679,3252646,647351,1902778,5802775
2015-05-27,EDGA (J),73755323,34048768,43761649,151565740,2728514150.973093,1796318610.028898,1754063080.976198,6278895841.978189,614600,144504,336447,1095551
2015-05-27,EDGX (K),164336393,83545643,162449399,410331435,6104486191.336299,3927490142.291308,5730309744.195580,15762286077.823187,1013017,271923,813510,2098450
2015-05-27,CHX (M),11684547,8663556,6284349,26632452,574841851.792300,978200272.269999,483176886.378800,2036219010.441099,1506,2813,1319,5638
2015-05-27,NYSE (N),722070053,0,0,722070053,28128156953.993557,0.000000,0.000000,28128156953.993557,2114450,0,0,2114450
2015-05-27,NYSE Arca (P),253376800,209655317,198671780,661703897,10375150542.969620,13242596165.923388,8507841524.910536,32125588233.803544,1739776,567743,1316859,3624378
2015-05-27,NASDAQ (Q),396523459,99791253,444885222,941199934,17424154364.390156,6839009659.930119,19294797990.651994,43557962014.972269,3044684,360307,2391517,5796508
2015-05-27,NASDAQ PSX (X),24186484,8953076,15844995,48984555,967475724.243200,460247341.127800,644054768.998800,2071777834.369800,185109,34322,103337,322768
2015-05-27,BATS BYX (Y),142630625,53704265,76056281,272391171,4998647146.621480,2614818725.050301,2859535175.344952,10473001047.016733,1191139,229497,623198,2043834
2015-05-27,BATS BZX (Z),196026768,83897481,126053366,405977615,7188273783.841617,5580777853.451495,5214997273.277499,17984048910.570611,1495977,339385,958513,2793875
2015-05-26,NYSE MKT (A),0,12607201,3808187,16415388,0.000000,115522164.277900,108795836.887800,224318001.165700,0,28548,15488,44036
2015-05-26,NASDAQ BX (B),51213243,28053943,27521254,106788440,1956886788.602103,1558476645.526502,1269696726.261791,4785060160.390396,439792,119162,241575,800529
2015-05-26,NYSE (DN),107922103,32836567,66432103,207190773,4426789773.003404,1667734594.653993,3178451450.911937,9272975818.569334,456458,98825,252945,808228
2015-05-26,NASDAQ (DQ),1023757147,487319119,580605063,2091681329,36145227376.809010,25093400290.033382,22453507821.922793,83692135488.765185,3468480,820765,1871208,6160453
2015-05-26,EDGA (J),77229927,45316455,38820285,161366667,2714844207.330296,2213039746.796499,1587565899.774196,6515449853.900991,638307,189462,312373,1140142
2015-05-26,EDGX (K),178787975,110626859,146884072,436298906,6345126169.759206,4654932797.894013,5506718779.714073,16506777747.367292,1075670,335424,792309,2203403
2015-05-26,CHX (M),8627854,12608319,3186550,24422723,398801437.982400,1604516687.321801,260463846.905000,2263781972.209201,518,4493,920,5931
2015-05-26,NYSE (N),811751481,0,0,811751481,30878786749.571425,0.000000,0.000000,30878786749.571425,2356232,0,0,2356232
2015-05-26,NYSE Arca (P),266251994,288007845,193079745,747339584,11185316361.137206,16095932333.150188,8764442271.150309,36045690965.437703,1841982,720443,1353419,3915844
2015-05-26,NASDAQ (Q),440411937,127929324,468386385,1036727646,19771239992.893342,8692702986.873828,21631201262.137653,50095144241.904823,3414733,475281,2559249,6449263
2015-05-26,NASDAQ PSX (X),25900909,11028985,14141356,51071250,987773200.462699,528689155.695400,599341497.517402,2115803853.675501,192098,40136,98502,330736
2015-05-26,BATS BYX (Y),146328917,68217721,70309521,284856159,4942191772.165834,3089117525.112600,2692558847.372002,10723868144.650436,1236905,280827,607235,2124967
2015-05-26,BATS BZX (Z),212587329,102794326,122691847,438073502,7759649674.102997,6410905647.127595,5327146722.430737,19497702043.661329,1633645,410342,981714,3025701
2015-05-22,NYSE MKT (A),0,9787632,4063332,13850964,0.000000,78466465.586300,98308976.454400,176775442.040700,0,21509,16479,37988
2015-05-22,NASDAQ BX (B),41629714,17627050,24412250,83669014,1633071036.953998,939876898.527202,1105047181.181999,3677995116.663199,361068,76119,209121,646308
2015-05-22,NYSE (DN),85232893,19758516,59703639,164695048,3525194760.103995,979139680.556698,2523697095.651289,7028031536.311982,367800,62425,214977,645202
2015-05-22,NASDAQ (DQ),802033292,295172785,549647371,1646853448,29606839316.315775,13034023651.876408,18718762107.754994,61359625075.947177,2818772,565609,1709586,5093967
2015-05-22,EDGA (J),55565839,28994006,34125149,118684994,1882104368.359005,1362655965.433000,1199941866.250195,4444702200.042200,452763,113662,256593,823018
2015-05-22,EDGX (K),145448559,70629716,139436516,355514791,5405912327.503112,2815570398.505696,4817993917.196886,13039476643.205694,864222,210808,704284,1779314
2015-05-22,CHX (M),5425304,11715167,6855712,23996183,270471677.249000,1130747031.720000,327786385.250600,1729005094.219600,470,1642,354,2466
2015-05-22,NYSE (N),617878455,0,0,617878455,24540534521.132124,0.000000,0.000000,24540534521.132124,1883196,0,0,1883196
2015-05-22,NYSE Arca (P),205120412,170426516,169561049,545107977,8606950216.781627,9574486621.749676,6989325820.461032,25170762658.992335,1419471,464284,1140058,3023813
2015-05-22,NASDAQ (Q),320348459,81206215,379279983,780834657,14616659996.222093,5164356971.220594,16801025306.997642,36582042274.440329,2534053,299662,2046002,4879717
2015-05-22,NASDAQ PSX (X),19397579,6648173,12371340,38417092,785196165.734101,314571147.756000,497616505.976100,1597383819.466201,149412,25030,85456,259898
2015-05-22,BATS BYX (Y),112325223,43726720,63405642,219457585,3883763087.366983,1961413355.216001,2302786026.809004,8147962469.391988,939490,181884,528263,1649637
2015-05-22,BATS BZX (Z),166862201,68229201,106108391,341199793,6253284539.057860,4070262501.393496,4314528946.184196,14638075986.635552,1286283,273333,838476,2398092
2015-05-21,NYSE MKT (A),0,13764972,4545823,18310795,0.000000,69810245.248700,149414480.659000,219224725.907700,0,27480,19085,46565
2015-05-21,NASDAQ BX (B),49314122,18986741,26785332,95086195,1915002797.989896,1031988894.315900,1230661984.585796,4177653676.891592,417366,83889,227962,729217
2015-05-21,NYSE (DN),117691720,22197533,66075000,205964253,4657475602.956211,1023038257.778103,2924079416.990395,8604593277.724709,464015,65195,259308,788518
2015-05-21,NASDAQ (DQ),1014359869,338011776,610806990,1963178635,37066701545.082313,12524033212.096375,21567099418.824365,71157834176.003053,3230926,608808,1791651,5631385
2015-05-21,EDGA (J),66996564,28888396,37092321,132977281,2325306735.284403,1362091803.379797,1281222098.915692,4968620637.579892,528750,120170,275341,924261
2015-05-21,EDGX (K),170637945,93001148,156731898,420370991,6362353301.180202,3063194937.759298,5028628625.293039,14454176864.232539,1004613,237141,757804,1999558
2015-05-21,CHX (M),9308970,5246374,11958794,26514138,505540829.066300,594803753.805000,824564211.237400,1924908794.108700,476,1889,517,2882
2015-05-21,NYSE (N),708016933,0,0,708016933,28181635457.276382,0.000000,0.000000,28181635457.276382,2079932,0,0,2079932
2015-05-21,NYSE Arca (P),247267987,175181229,173717839,596167055,10602279143.949045,9899031997.636838,7466396352.751011,27967707494.336894,1674289,502629,1207490,3384408
2015-05-21,NASDAQ (Q),366232061,96254057,406253271,868739389,16556621271.782920,6079331283.821702,17607364244.155899,40243316799.760521,2812762,350625,2208021,5371408
2015-05-21,NASDAQ PSX (X),24396655,7586298,14165749,46148702,944583797.170000,356892108.108000,552334003.322901,1853809908.600901,180538,29064,94627,304229
2015-05-21,BATS BYX (Y),127828431,46097865,64805828,238732124,4439823508.612715,2016174938.494594,2453201163.801785,8909199610.909094,1043728,197763,535958,1777449
2015-05-21,BATS BZX (Z),195764642,73450603,114447862,383663107,7245292743.356918,4438607414.558187,4688558882.808917,16372459040.724022,1461561,296900,891568,2650029
2015-05-20,NYSE MKT (A),0,11812680,5520613,17333293,0.000000,69633448.925700,158297335.978900,227930784.904600,0,26278,21550,47828
2015-05-20,NASDAQ BX (B),49248016,21618340,27969068,98835424,1910750674.425499,1236848013.770700,1249881065.310492,4397479753.506691,425001,96390,244301,765692
2015-05-20,NYSE (DN),102732718,24100813,65649959,192483490,4278484715.977703,1251262891.717701,2917650267.094097,8447397874.789501,423542,70858,246325,740725
2015-05-20,NASDAQ (DQ),944606195,384128919,623370128,1952105242,34814670929.092875,18166671410.617797,21169544255.802032,74150886595.512704,3160627,648351,1866715,5675693
2015-05-20,EDGA (J),70561825,32760570,41170991,144493386,2547039375.479995,1717869153.592001,1545917593.144001,5810826122.215997,572217,139773,324031,1036021
2015-05-20,EDGX (K),175465617,95651507,176434001,447551125,6564209269.435880,3777214223.347301,5866569319.354537,16207992812.137718,1071520,278792,890698,2241010
2015-05-20,CHX (M),8797346,8335736,8789839,25922921,412494791.048200,1040732005.100001,367676222.222600,1820903018.370801,477,2398,784,3659
2015-05-20,NYSE (N),692212015,0,0,692212015,26827190717.783840,0.000000,0.000000,26827190717.783840,2218608,0,0,2218608
2015-05-20,NYSE Arca (P),255195289,202559042,202661545,660415876,10861646823.034110,11409772532.270794,8195752981.504595,30467172336.809499,1800643,584387,1368770,3753800
2015-05-20,NASDAQ (Q),402314955,107899099,430493404,940707458,17976895293.213744,6890488393.005581,18376341445.220724,43243725131.440049,3175622,418232,2440585,6034439
2015-05-20,NASDAQ PSX (X),25442415,9561314,17345573,52349302,990708994.955900,513903789.173500,633511874.343302,2138124658.472702,195340,38495,104721,338556
2015-05-20,BATS BYX (Y),124802061,54507586,66513483,245823130,4326793650.383304,2472279885.868400,2502506750.991070,9301580287.242774,1051321,222796,556728,1830845
2015-05-20,BATS BZX (Z),194483334,84566061,126419412,405468807,7374199108.814949,5225594552.276401,5033600967.828399,17633394628.919749,1527037,346828,974502,2848367
2015-05-19,NYSE MKT (A),0,11860071,4194029,16054100,0.000000,93507122.627600,115300065.681000,208807188.308600,0,25470,18490,43960
2015-05-19,NASDAQ BX (B),53117653,24821388,27573212,105512253,1938092349.557393,1118641229.249300,1185608066.374502,4242341645.181195,444801,100818,237208,782827
2015-05-19,NYSE (DN),112515596,28402018,64775929,205693543,4283291016.717505,1256365722.173903,2729181637.434526,8268838376.325934,453753,85808,247386,786947
2015-05-19,NASDAQ (DQ),1065588696,442289876,614958245,2122836817,36296265348.204342,17121908218.399822,22008101376.657063,75426274943.261227,3446577,722507,1889468,6058552
2015-05-19,EDGA (J),74975779,37005942,37087914,149069635,2579230509.755909,1513231632.143703,1397139787.187402,5489601929.087014,596795,149529,295209,1041533
2015-05-19,EDGX (K),190750581,111916736,159348512,462015829,6642706675.979323,3643369380.712206,5634999447.237484,15921075503.929013,1089599,291853,825846,2207298
2015-05-19,CHX (M),13077258,9101260,5783760,27962278,534262031.239000,1155990371.695000,334754445.384400,2025006848.318400,841,2114,442,3397
2015-05-19,NYSE (N),739401628,0,0,739401628,28165881869.042824,0.000000,0.000000,28165881869.042824,2228181,0,0,2228181
2015-05-19,NYSE Arca (P),267938573,226389197,200985030,695312800,10575997823.676847,11729124640.219180,8286563119.387814,30591685583.283841,1797303,586312,1336981,3720596
2015-05-19,NASDAQ (Q),405784483,110066005,434512390,950362878,17688352824.819991,6412829476.809822,18356649534.821355,42457831836.451168,3138918,409939,2391208,5940065
2015-05-19,NASDAQ PSX (X),27319604,10812017,16029587,54161208,1028202043.094700,479711600.159500,569395047.191101,2077308690.445301,203641,38913,101747,344301
2015-05-19,BATS BYX (Y),138189933,63983978,67775110,269949021,4499009497.889387,2375088280.778203,2359761798.465702,9233859577.133292,1119779,242331,561152,1923262
2015-05-19,BATS BZX (Z),212234000,92001787,125829621,430065408,7624250944.549760,4708688387.586405,4978263371.495413,17311202703.631578,1616162,346497,965853,2928512
2015-05-18,NYSE MKT (A),0,12248520,3330535,15579055,0.000000,71936558.345700,104632919.612100,176569477.957800,0,24306,15257,39563
2015-05-18,NASDAQ BX (B),49585803,19553844,25939956,95079603,1810240827.453492,1071999067.119103,1204040033.587803,4086279928.160398,408365,81563,221712,711640
2015-05-18,NYSE (DN),101316009,21461460,60833267,183610736,3828260949.084608,1062644671.555200,2603305017.293807,7494210637.933615,446726,65523,253246,765495
2015-05-18,NASDAQ (DQ),897651679,347319238,590568723,1835539640,30570323983.310706,17060947392.258904,20843461042.710997,68474732418.280607,3110405,639440,1846340,5596185
2015-05-18,EDGA (J),67352845,30884203,35622754,133859802,2397872151.524002,1449867289.557698,1381536983.858499,5229276424.940199,543791,122642,279322,945755
2015-05-18,EDGX (K),158370964,79704579,142372110,380447653,5557629597.060170,3212181539.171102,5120417353.349214,13890228489.580486,956544,228331,765369,1950244
2015-05-18,CHX (M),9005218,6578762,4037353,19621333,440663376.838800,784575316.338800,253641605.928600,1478880299.106200,844,2237,481,3562
2015-05-18,NYSE (N),669313808,0,0,669313808,25704725410.577411,0.000000,0.000000,25704725410.577411,2109982,0,0,2109982
2015-05-18,NYSE Arca (P),243517867,180882912,182559500,606960279,9785175871.823213,11746461115.628774,7845100824.998782,29376737812.450769,1705675,510308,1329608,3545591
2015-05-18,NASDAQ (Q),359719837,90678155,411049491,861447483,15904300288.944586,6110891426.244624,17677429686.574420,39692621401.763630,2884267,340475,2370995,5595737
2015-05-18,NASDAQ PSX (X),24354854,8540191,14840815,47735860,955100788.117498,422498778.931700,590878417.843199,1968477984.892397,191372,32633,99105,323110
2015-05-18,BATS BYX (Y),125963989,47490496,62596781,236051266,4329437929.806537,2096429560.870501,2334857969.448985,8760725460.126023,1045111,195395,528854,1769360
2015-05-18,BATS BZX (Z),187627888,72322654,116065339,376015881,6768061763.995492,4344671212.500391,4707960790.531279,15820693767.027162,1447515,287156,933102,2667773
2015-05-15,NYSE MKT (A),0,12875238,3570155,16445393,0.000000,70049021.679400,90437898.253000,160486919.932400,0,23677,14427,38104
2015-05-15,NASDAQ BX (B),50430396,22817261,26537389,99785046,1792302145.447501,1180525019.605900,1253939244.813602,4226766409.867003,416551,94144,219866,730561
2015-05-15,NYSE (DN),100519216,24959181,61152790,186631187,3843055125.394487,1275619633.683803,2709998334.739091,7828673093.817381,418981,74395,236674,730050
2015-05-15,NASDAQ (DQ),913772184,376202843,557902539,1847877566,30921444473.154113,17026427140.366048,20495082984.500741,68442954598.020902,3100844,637022,1722746,5460612
2015-05-15,EDGA (J),68295364,35168324,37781430,141245118,2211473987.336000,1721619462.825900,1348128884.328496,5281222334.490396,536892,141553,276665,955110
2015-05-15,EDGX (K),168559883,87876778,139163759,395600420,5865975771.101684,3411681501.083401,5453114044.304086,14730771316.489171,986711,247016,739899,1973626
2015-05-15,CHX (M),9070586,8802708,10715608,28588902,474832095.729000,852969681.241800,603786949.917600,1931588726.888400,395,2106,656,3157
2015-05-15,NYSE (N),828954090,0,0,828954090,33824092608.764994,0.000000,0.000000,33824092608.764994,2199393,0,0,2199393
2015-05-15,NYSE Arca (P),239459579,202016080,180526107,622001766,9747251902.178532,11646557019.489158,8305917400.605557,29699726322.273247,1682804,554084,1252732,3489620
2015-05-15,NASDAQ (Q),376140169,97381215,453129276,926650660,16539187111.183039,6374056444.947677,20690569643.698041,43603813199.828757,2969348,372893,2329463,5671704
2015-05-15,NASDAQ PSX (X),25416436,9943580,15632485,50992501,981933627.449201,517212967.929000,585952374.950700,2085098970.328901,195632,36476,98905,331013
2015-05-15,BATS BYX (Y),128242120,55534626,63199394,246976140,4317418495.394801,2373851934.025204,2291408266.435202,8982678695.855207,1061315,215082,507664,1784061
2015-05-15,BATS BZX (Z),189515609,82773407,122051766,394340782,6920817801.940838,4975904687.966201,5056642869.849301,16953365359.756340,1471195,324871,919146,2715212
2015-05-14,NYSE MKT (A),0,10650696,3630608,14281304,0.000000,52574856.114200,102058915.873000,154633771.987200,0,22250,14269,36519
2015-05-14,NASDAQ BX (B),54501184,25403434,29576351,109480969,1946889111.239798,1374434194.213501,1361659046.476404,4682982351.929703,443327,102681,239520,785528
2015-05-14,NYSE (DN),102353454,17738075,57213001,177304530,4109194595.190606,1016388155.119899,2650995568.603698,7776578318.914203,440980,63995,241978,746953
2015-05-14,NASDAQ (DQ),1019102577,424898941,623890539,2067892057,35740721463.750373,20310134332.484168,22070112607.688447,78120968403.922988,3388417,712742,1885179,5986338
2015-05-14,EDGA (J),75212077,37894453,41901857,155008387,2465109782.578598,1858365844.722902,1613157188.427301,5936632815.728801,591091,152947,311551,1055589
2015-05-14,EDGX (K),173619069,94288236,145163781,413071086,6216007546.913940,3926987356.449698,5559050295.297867,15702045198.661505,1028312,256990,763337,2048639
2015-05-14,CHX (M),15463900,9628331,5346083,30438314,995427234.795400,1027947167.320000,236842266.890000,2260216669.005400,468,2975,507,3950
2015-05-14,NYSE (N),713576204,0,0,713576204,27840382888.060010,0.000000,0.000000,27840382888.060010,2270171,0,0,2270171
2015-05-14,NYSE Arca (P),271645860,217336100,192480913,681462873,11320255376.217513,12455040705.569872,8345362211.231128,32120658293.018513,1865549,579888,1328299,3773736
2015-05-14,NASDAQ (Q),417088133,111615890,429529213,958233236,18592919294.474055,7208080902.208707,18822819970.960725,44623820167.643487,3234847,412952,2438531,6086330
2015-05-14,NASDAQ PSX (X),28883759,10959892,16840341,56683992,1103463920.171901,576065486.906900,683611787.977797,2363141195.056598,215962,39208,108404,363574
2015-05-14,BATS BYX (Y),141079875,56715563,70575199,268370637,4696414611.045584,2552230292.193796,2652929551.688808,9901574454.928188,1190923,233178,585898,2009999
2015-05-14,BATS BZX (Z),215108116,91196836,129688707,435993659,8058651590.703707,5530193452.427097,5509719086.369680,19098564129.500484,1695286,356672,996074,3048032
2015-05-13,NYSE MKT (A),0,11963313,4469417,16432730,0.000000,104051596.004600,113680847.380800,217732443.385400,0,23566,16606,40172
2015-05-13,NASDAQ BX (B),52649670,25589874,26088237,104327781,1840887595.708501,1301167404.530300,1103559460.334600,4245614460.573401,423557,102886,207816,734259
2015-05-13,NYSE (DN),123140667,26934377,65973747,216048791,5136886649.616983,1298297959.177099,2722518901.362696,9157703510.156778,502825,79665,250035,832525
2015-05-13,NASDAQ (DQ),1056146104,464451128,582656983,2103254215,39668888429.946890,20749434664.275128,19228286285.937310,79646609380.159328,3449413,707283,1771399,5928095
2015-05-13,EDGA (J),80938881,39124148,40740035,160803064,2837846756.646399,1846325013.818001,1465391230.145394,6149563000.609794,647134,156054,306715,1109903
2015-05-13,EDGX (K),182387334,104747515,139219042,426353891,6693904719.574393,4067823582.937504,4846899212.805500,15608627515.317397,1130269,289745,751237,2171251
2015-05-13,CHX (M),17349883,9450011,5711131,32511025,707504403.135100,1026314118.595000,399331206.128500,2133149727.858600,679,2838,650,4167
2015-05-13,NYSE (N),719978586,0,0,719978586,28025102324.807071,0.000000,0.000000,28025102324.807071,2377464,0,0,2377464
2015-05-13,NYSE Arca (P),295868148,238135029,190194233,724197410,12266042039.556647,13967934483.714343,7781900016.537189,34015876539.808179,2004912,646343,1308675,3959930
2015-05-13,NASDAQ (Q),437854160,123190557,404613091,965657808,19681784517.560163,7716636486.754314,16335179338.254407,43733600342.568884,3432651,467988,2334159,6234798
2015-05-13,NASDAQ PSX (X),31035842,13018061,17283434,61337337,1187009283.429999,636769401.005600,601887890.513701,2425666574.949300,233850,47727,103869,385446
2015-05-13,BATS BYX (Y),147815585,62341388,69595539,279752512,5012318745.364209,2729556329.761497,2471543631.179682,10213418706.305388,1231834,262521,560958,2055313
2015-05-13,BATS BZX (Z),237087435,102772698,135333567,475193700,8895521070.970126,6208286785.335485,5230575820.474514,20334383676.780125,1827581,403932,1013921,3245434
2015-05-12,NYSE MKT (A),0,9166144,4522462,13688606,0.000000,69083310.722600,119049839.135000,188133149.857600,0,23722,16190,39912
2015-05-12,NASDAQ BX (B),50240094,23539636,27998487,101778217,1881445610.708898,1408673546.666398,1289570056.878990,4579689214.254286,414446,102106,228166,744718
2015-05-12,NYSE (DN),105853637,25895653,60316147,192065437,3996349463.891199,1445331239.845805,2562150729.446807,8003831433.183811,456862,83682,242915,783459
2015-05-12,NASDAQ (DQ),928498326,403015385,566379337,1897893048,32144580882.432318,20255092697.284267,19853696321.638907,72253369901.355492,3170690,688988,1755837,5615515
2015-05-12,EDGA (J),73670457,37683899,40912035,152266391,2504466119.583703,1942992642.786098,1615479287.615298,6062938049.985099,595196,151408,317562,1064166
2015-05-12,EDGX (K),182480013,101288867,154520556,438289436,6623086455.102584,4314499028.715106,5596953693.185838,16534539177.003528,1134840,292556,824331,2251727
2015-05-12,CHX (M),10373647,10302310,5350377,26026334,464088071.952900,1074658159.720000,332055272.962200,1870801504.635100,363,2969,675,4007
2015-05-12,NYSE (N),710293790,0,0,710293790,27372603762.578198,0.000000,0.000000,27372603762.578198,2405545,0,0,2405545
2015-05-12,NYSE Arca (P),282426992,226751679,199446873,708625544,11957516004.208910,14380925667.435922,8408739554.769638,34747181226.414470,2001432,679045,1423238,4103715
2015-05-12,NASDAQ (Q),426970716,123876777,427970982,978818475,18952028565.902775,8997772071.262511,18067093525.646245,46016894162.811531,3452449,488095,2564702,6505246
2015-05-12,NASDAQ PSX (X),29579976,12333626,17670560,59584162,1172396541.952201,687055362.658600,703125823.325800,2562577727.936601,223172,46195,114590,383957
2015-05-12,BATS BYX (Y),136688044,58441432,67818365,262947841,4512163723.909198,2867926548.411101,2485178850.528094,9865269122.848393,1143651,255869,551635,1951155
2015-05-12,BATS BZX (Z),225493561,102192378,138639190,466325129,8411606200.867400,6848809590.968095,5575282689.863159,20835698481.698654,1796440,418547,1084098,3299085
2015-05-11,NYSE MKT (A),0,9808363,3200614,13008977,0.000000,65076863.817900,83772988.045000,148849851.862900,0,23305,14399,37704
2015-05-11,NASDAQ BX (B),48399109,22336796,27415046,98150951,1867209168.785599,1279496838.519198,1207924644.315294,4354630651.620091,405184,95423,224437,725044
2015-05-11,NYSE (DN),97261929,22717721,62596353,182576003,3881042570.720794,1189273169.980398,2476819211.866779,7547134952.567971,452112,78950,258358,789420
2015-05-11,NASDAQ (DQ),895366200,336808797,611539651,1843714648,32513767857.648477,16255700113.586252,20452763584.827694,69222231556.062423,3081329,685688,1792031,5559048
2015-05-11,EDGA (J),76076712,35538086,41304379,152919177,2738329077.484295,1714939867.655002,1480637752.919395,5933906698.058692,620381,145321,318624,1084326
2015-05-11,EDGX (K),166089605,85796462,150361740,402247807,6355332416.377021,3882022881.627692,5020056585.018256,15257411883.022969,1045690,258163,795220,2099073
2015-05-11,CHX (M),6177611,14521968,6220468,26920047,268807491.886800,1042094905.040000,474880248.661600,1785782645.588400,406,2088,468,2962
2015-05-11,NYSE (N),696385068,0,0,696385068,27893472494.143398,0.000000,0.000000,27893472494.143398,2247664,0,0,2247664
2015-05-11,NYSE Arca (P),247513645,197252132,189174130,633939907,10720683997.230432,12205006006.269645,7821105416.538032,30746795420.038109,1785604,564830,1342507,3692941
2015-05-11,NASDAQ (Q),397989401,108327769,430134251,936451421,18251663086.581541,7221504636.301915,17555097047.504803,43028264770.388259,3299325,440163,2465041,6204529
2015-05-11,NASDAQ PSX (X),27585802,10140700,16315486,54041988,1105148118.722999,604412998.964200,612829469.086301,2322390586.773500,219243,41189,107986,368418
2015-05-11,BATS BYX (Y),136004759,55107399,70019092,261131250,4673794080.607108,2536104561.739897,2370743173.304300,9580641815.651305,1152637,237281,568962,1958880
2015-05-11,BATS BZX (Z),200948880,88275505,129988069,419212454,7668555349.208978,5610026176.393010,4993790667.600193,18272372193.202181,1639135,366958,1015951,3022044
2015-05-08,NYSE MKT (A),0,9979602,4073106,14052708,0.000000,70602019.594500,75141423.655000,145743443.249500,0,23425,16515,39940
2015-05-08,NASDAQ BX (B),57308806,30889156,32701471,120899433,2214839838.724297,1817039103.487702,1490170530.612793,5522049472.824792,459434,114267,265728,839429
2015-05-08,NYSE (DN),120366099,28082242,77902829,226351170,4921222415.755384,1488711282.912905,3201016462.554193,9610950161.222482,506182,83092,290831,880105
2015-05-08,NASDAQ (DQ),1031826213,477900170,689561660,2199288043,37693167099.920436,26550406843.910802,23823732550.276705,88067306494.107943,3497645,761319,2091858,6350822
2015-05-08,EDGA (J),82150614,42486444,46390773,171027831,2742544231.963906,2239627286.214007,1648207561.470300,6630379079.648213,640393,169320,346709,1156422
2015-05-08,EDGX (K),186303727,109145118,169710468,465159313,7057530772.053139,4847173182.175604,6057769766.290724,17962473720.519467,1115766,302412,892155,2310333
2015-05-08,CHX (M),8695909,15362099,14363117,38421125,305132772.324400,2533129661.680000,1239102603.088400,4077365037.092800,573,6335,774,7682
2015-05-08,NYSE (N),776099887,0,0,776099887,30488761950.166466,0.000000,0.000000,30488761950.166466,2405008,0,0,2405008
2015-05-08,NYSE Arca (P),280937003,256860822,214488383,752286208,11845168832.835923,16737534178.210056,9194159480.832841,37776862491.878820,1931691,681053,1459818,4072562
2015-05-08,NASDAQ (Q),441705738,131874973,478475559,1052056270,19981007508.210658,9802363504.147071,21087210408.275804,50870581420.633533,3487691,495503,2749962,6733156
2015-05-08,NASDAQ PSX (X),33392564,12936786,19218669,65548019,1342797721.658000,771578166.456200,700065210.449000,2814441098.563200,258798,49635,124556,432989
2015-05-08,BATS BYX (Y),150810809,67494375,80663802,298968986,5239466609.122277,3093660206.815399,2860990203.548409,11194117019.486085,1239426,257124,636811,2133361
2015-05-08,BATS BZX (Z),235717086,115106036,154714864,505537986,8962551097.510432,7457874818.892305,6332761976.754575,22753187893.157312,1839385,442388,1184010,3465783
2015-05-07,NYSE MKT (A),0,9516006,4273299,13789305,0.000000,62900836.065200,98103544.271400,161004380.336600,0,24410,16679,41089
2015-05-07,NASDAQ BX (B),54517186,27641766,31661652,113820604,2064337736.111403,1459075787.252899,1444253905.304602,4967667428.668904,447585,104453,258381,810419
2015-05-07,NYSE (DN),136929233,29551756,81027511,247508500,4915924793.469814,1530511300.862603,3435378322.783021,9881814417.115438,545409,86805,302583,934797
2015-05-07,NASDAQ (DQ),1147478630,434624949,716254292,2298357871,38789763525.589839,18996738413.714948,25659403706.513473,83445905645.818260,3632501,746198,2076011,6454710
2015-05-07,EDGA (J),80272201,41471843,45669167,167413211,2589313560.266304,1914374338.143202,1582818152.769991,6086506051.179497,631819,165989,340426,1138234
2015-05-07,EDGX (K),209269925,109604519,169561378,488435822,7625561590.763884,4304799329.880196,6100194955.947019,18030555876.591099,1281648,303840,925193,2510681
2015-05-07,CHX (M),14285904,10150617,4534005,28970526,731502442.998000,1170569172.990400,303737619.232400,2205809235.220800,555,3274,669,4498
2015-05-07,NYSE (N),807153958,0,0,807153958,30540209567.192723,0.000000,0.000000,30540209567.192723,2648679,0,0,2648679
2015-05-07,NYSE Arca (P),318619759,260174140,228914970,807708869,12774044882.628142,14063960818.896356,10112175640.461058,36950181341.985556,2179631,673606,1597083,4450320
2015-05-07,NASDAQ (Q),489054255,135680326,498458365,1123192946,21088392219.032865,8821679139.765186,21686319190.834826,51596390549.632877,3859736,511225,2974993,7345954
2015-05-07,NASDAQ PSX (X),32086034,16184007,19435994,67706035,1193812848.578800,840808141.642600,747246273.615900,2781867263.837300,241982,57631,130462,430075
2015-05-07,BATS BYX (Y),154845540,69932033,82241240,307018813,5115992055.810016,3060513789.186700,2852057487.145320,11028563332.142036,1299348,275520,671885,2246753
2015-05-07,BATS BZX (Z),263842702,119806030,166123771,549772503,9349655162.125686,7083554996.421872,6525335869.084372,22958546027.631930,2030653,462062,1282701,3775416
2015-05-06,NYSE MKT (A),0,12184507,4612360,16796867,0.000000,91732338.459300,92887815.335000,184620153.794300,0,28658,18653,47311
2015-05-06,NASDAQ BX (B),58883047,32342090,35984449,127209586,2174873485.082095,1902661869.645601,1632771701.740999,5710307056.468695,477888,125575,293280,896743
2015-05-06,NYSE (DN),135628465,33134092,78426879,247189436,4840547104.125730,1719562150.180894,3690264494.730422,10250373749.037046,553855,95444,312473,961772
2015-05-06,NASDAQ (DQ),1115303722,487984779,708000378,2311288879,36973663465.698948,24331049141.698574,26504764167.133925,87809476774.531447,3709257,861034,2147679,6717970
2015-05-06,EDGA (J),93879943,48812318,54541822,197234083,3035051135.055098,2392624838.188000,2084469720.916305,7512145694.159403,733771,200640,406958,1341369
2015-05-06,EDGX (K),218077411,130520541,182367628,530965580,7302295902.698659,5607981946.912105,6717905751.734873,19628183601.345637,1329983,364405,996645,2691033
2015-05-06,CHX (M),14777539,11258578,8193048,34229165,562663791.006200,1524450407.137500,591733203.511600,2678847401.655300,541,4590,986,6117
2015-05-06,NYSE (N),823594539,0,0,823594539,30212398047.752592,0.000000,0.000000,30212398047.752592,2743918,0,0,2743918
2015-05-06,NYSE Arca (P),338472163,283015040,249389832,870877035,13153412386.085852,16455130723.295000,10973350325.953165,40581893435.334017,2331476,794078,1672649,4798203
2015-05-06,NASDAQ (Q),507416710,153840474,541635103,1202892287,21207563794.696162,10762844524.713060,23525159553.830428,55495567873.239650,3977759,625920,3142893,7746572
2015-05-06,NASDAQ PSX (X),36158986,17553548,21293087,75005621,1322539537.325900,947941799.233699,875364811.068100,3145846147.627699,272412,66544,142074,481030
2015-05-06,BATS BYX (Y),165398946,77082505,86013411,328494862,5382648444.829374,3493684129.807997,3046828283.878517,11923160858.515888,1353489,304944,672539,2330972
2015-05-06,BATS BZX (Z),284957524,136951089,176798386,598706999,10118798455.958620,8638099319.763981,7208046613.294532,25964944389.017133,2172305,548017,1309499,4029821
2015-05-05,NYSE MKT (A),0,11018469,4617292,15635761,0.000000,82985384.540400,114676257.605000,197661642.145400,0,27154,19468,46622
2015-05-05,NASDAQ BX (B),61107158,29954084,34341937,125403179,2263129214.996409,1743300656.882398,1542879927.884100,5549309799.762907,504669,121363,283429,909461
2015-05-05,NYSE (DN),137276243,31469420,75002984,243748647,5162125998.539916,1723870668.413200,3281191342.774489,10167188009.727605,531885,87508,293025,912418
2015-05-05,NASDAQ (DQ),1135282185,498571330,696782232,2330635747,39184841151.506089,24766951111.984329,23765390590.052115,87717182853.542533,3809502,817737,2073481,6700720
2015-05-05,EDGA (J),93530368,46184016,53068139,192782523,3175583493.612506,2356401519.134002,1986041562.775489,7518026575.521997,764420,193472,405654,1363546
2015-05-05,EDGX (K),220308664,116480749,183707241,520496654,7674554093.083591,5171665361.744516,6408673460.796955,19254892915.625062,1327589,345988,988163,2661740
2015-05-05,CHX (M),14247721,8865729,8603268,31716718,635775269.146200,1313528431.554200,600729186.441000,2550032887.141400,397,4306,1152,5855
2015-05-05,NYSE (N),792925730,0,0,792925730,29836031696.222168,0.000000,0.000000,29836031696.222168,2643678,0,0,2643678
2015-05-05,NYSE Arca (P),337297375,265483355,230136449,832917179,13119310574.407107,16011135849.486259,9685702843.707213,38816149267.600579,2310251,767140,1655686,4733077
2015-05-05,NASDAQ (Q),522658845,142573149,517204598,1182436592,22474791964.870572,9889009594.544096,21961143446.717816,54324945006.132484,4152545,564876,3103115,7820536
2015-05-05,NASDAQ PSX (X),35101271,16573800,20311347,71986418,1270839125.843899,984449191.271100,810791004.500600,3066079321.615599,272139,63492,141383,477014
2015-05-05,BATS BYX (Y),166605672,78303547,87284104,332193323,5529390174.422592,3532094789.178999,3185097161.231782,12246582124.833373,1417584,312463,709858,2439905
2015-05-05,BATS BZX (Z),282230921,130271375,165325935,577828231,10296738238.329851,8680140220.282002,6731224372.417787,25708102831.029640,2154476,511824,1275311,3941611
2015-05-04,NYSE MKT (A),0,9761321,3850290,13611611,0.000000,68408716.792900,89717805.432000,158126522.224900,0,24528,18052,42580
2015-05-04,NASDAQ BX (B),51408976,24545562,28729225,104683763,1950800255.728704,1258399743.937401,1284112446.503513,4493312446.169618,427247,96432,244310,767989
2015-05-04,NYSE (DN),105770216,24621732,63294120,193686068,4060798498.998806,1140786136.319504,2725187273.241587,7926771908.559897,441546,73394,250026,764966
2015-05-04,NASDAQ (DQ),928341075,350990884,560996635,1840328594,33265981344.027295,17012681868.030087,19859753806.168852,70138417018.226234,3321732,695888,1806364,5823984
2015-05-04,EDGA (J),74165938,33865470,41567895,149599303,2523817434.398402,1605579814.437898,1568554704.699800,5697951953.536100,615022,147382,319197,1081601
2015-05-04,EDGX (K),174460982,81029686,146454466,401945134,6506524840.072720,3419898420.784692,5443605122.420944,15370028383.278356,1085695,243671,825002,2154368
2015-05-04,CHX (M),6783298,7118587,9758664,23660549,324688493.213400,773748062.040000,786415737.557200,1884852292.810600,363,2291,647,3301
2015-05-04,NYSE (N),697111377,0,0,697111377,27310025985.905361,0.000000,0.000000,27310025985.905361,2426416,0,0,2426416
2015-05-04,NYSE Arca (P),265063518,212525464,183283085,660872067,10809095107.759907,12836249582.339677,7914871518.689701,31560216208.789285,1903528,582773,1324079,3810380
2015-05-04,NASDAQ (Q),431291594,111908634,436537866,979738094,19012117816.041961,7352991107.560800,18717798808.762215,45082907732.364976,3531796,448608,2656522,6636926
2015-05-04,NASDAQ PSX (X),26655329,12306066,15252798,54214193,1034259332.117699,649693762.185000,600691497.020799,2284644591.323498,221973,46807,109451,378231
2015-05-04,BATS BYX (Y),134129722,51176201,68367189,253673112,4562737103.407666,2331372331.140900,2538308248.975974,9432417683.524540,1141000,215445,564734,1921179
2015-05-04,BATS BZX (Z),200130785,84340187,114350818,398821790,7611759712.048202,5488893565.550998,4666469798.106222,17767123075.705422,1638294,345936,931558,2915788
2015-05-01,NYSE MKT (A),0,9421300,4266375,13687675,0.000000,74117607.127500,129200513.127000,203318120.254500,0,24243,19269,43512
2015-05-01,NASDAQ BX (B),54266975,27555120,32678621,114500716,2126914217.698499,1700442165.058902,1487744409.646505,5315100792.403906,459648,110132,272397,842177
2015-05-01,NYSE (DN),129173151,24828779,66460666,220462596,5115045515.764496,1373481432.628502,2913191165.562900,9401718113.955898,503852,70482,276952,851286
2015-05-01,NASDAQ (DQ),1025319653,421898666,611211334,2058429653,37970243446.655054,22531798752.917337,23130313138.479363,83632355338.051754,3545400,687520,2007027,6239947
2015-05-01,EDGA (J),76776475,38821579,43997782,159595836,2544154263.683199,2199124471.013801,1597921224.311001,6341199959.008001,615727,159888,341209,1116824
2015-05-01,EDGX (K),187421402,94702191,161465553,443589146,7064098775.825673,4518792161.962098,6337114921.114054,17920005858.901825,1186272,277652,936672,2400596
2015-05-01,CHX (M),12599163,10269932,4161094,27030189,463064426.827700,1446187698.622800,442479607.497600,2351731732.948100,471,3493,762,4726
2015-05-01,NYSE (N),743263059,0,0,743263059,29273138603.050937,0.000000,0.000000,29273138603.050937,2567549,0,0,2567549
2015-05-01,NYSE Arca (P),296180507,235383070,209908594,741472171,12526653706.732923,15153309076.040064,9546842360.079392,37226805142.852379,2113315,633480,1493130,4239925
2015-05-01,NASDAQ (Q),471885096,123643484,484420245,1079948825,21052338414.175024,8474584611.401185,21294105064.624889,50821028090.201098,3882065,479806,2965365,7327236
2015-05-01,NASDAQ PSX (X),37300754,15738977,19736360,72776091,1448107702.040403,913777673.662900,812393284.947199,3174278660.650502,297344,59963,142853,500160
2015-05-01,BATS BYX (Y),143531942,56645885,79235418,279413245,5105311504.955893,2892846095.860899,2957871768.785475,10956029369.602267,1266914,236828,678011,2181753
2015-05-01,BATS BZX (Z),241933484,104284562,147527004,493745050,9067890065.930696,7108015633.933393,6187777423.585774,22363683123.449863,1918779,411049,1160943,3490771
2015-04-30,NYSE MKT (A),0,12033049,5502715,17535764,0.000000,96368155.727500,126273963.908000,222642119.635500,0,28810,23837,52647
2015-04-30,NASDAQ BX (B),67522749,42672660,37051290,147246699,2541885203.857200,2310939451.022201,1756065956.764510,6608890611.643911,553366,157051,316750,1027167
2015-04-30,NYSE (DN),155835346,38041370,83480813,277357529,5570148402.102800,1989424976.851602,3645147915.076809,11204721294.031211,598562,111110,340456,1050128
2015-04-30,NASDAQ (DQ),1323802468,625305485,729613128,2678721081,43626005342.833845,32046285246.124884,29085755562.632282,104758046151.591011,4110740,915393,2250483,7276616
2015-04-30,EDGA (J),108617811,59195047,56024833,223837691,3613509885.763222,2966428596.313905,2203178343.813488,8783116825.890615,879993,247057,456482,1583532
2015-04-30,EDGX (K),230178730,137281113,189145802,556605645,8328231135.661179,6070911756.747680,7639450312.059198,22038593204.468057,1410129,375473,1108607,2894209
2015-04-30,CHX (M),13753109,15105776,5203722,34062607,404360105.432800,2136642084.657698,309322966.673600,2850325156.764098,1321,6765,1230,9316
2015-04-30,NYSE (N),1078575999,0,0,1078575999,40896687642.465115,0.000000,0.000000,40896687642.465115,3191648,0,0,3191648
2015-04-30,NYSE Arca (P),396800116,353765741,254157479,1004723336,15426783420.547008,21222820209.059968,11521011181.734034,48170614811.341010,2647441,902296,1783083,5332820
2015-04-30,NASDAQ (Q),598373881,182599429,623532124,1404505434,25304232733.327222,12808404034.064294,27087260054.449630,65199896821.841146,4741191,711781,3514614,8967586
2015-04-30,NASDAQ PSX (X),46284503,20071368,24037196,90393067,1649215511.596000,1130191529.429999,974651851.848699,3754058892.874698,348011,72996,171355,592362
2015-04-30,BATS BYX (Y),187187788,90369600,93299509,370856897,6083998669.975434,4181043014.586102,3484878840.245960,13749920524.807496,1552872,333954,767102,2653928
2015-04-30,BATS BZX (Z),319157933,157642215,179436033,656236181,11486919165.678514,10194114310.930039,7714275623.524503,29395309100.133056,2405317,583009,1413053,4401379
2015-04-29,NYSE MKT (A),0,10824345,5836267,16660612,0.000000,80985798.083700,142487499.202000,223473297.285700,0,28567,22663,51230
2015-04-29,NASDAQ BX (B),63139452,31635852,32163687,126938991,2458568682.554489,1739063951.672800,1542907428.389902,5740540062.617191,511950,131390,271297,914637
2015-04-29,NYSE (DN),141500951,31230953,68204378,240936282,5867100474.040538,1580075779.130998,3461444149.678786,10908620402.850322,557303,88263,266804,912370
2015-04-29,NASDAQ (DQ),1202284394,463940304,606455211,2272679909,43973748311.638986,21034080900.580695,25079793568.191490,90087622780.411171,3945594,785933,1974026,6705553
2015-04-29,EDGA (J),100387377,46716679,49101193,196205249,3555228095.318111,2302564479.337599,1935261178.211393,7793053752.867103,811239,209483,390138,1410860
2015-04-29,EDGX (K),233152020,127236522,161159961,521548503,8383046136.011897,5124068808.069181,6729351178.287616,20236466122.368694,1342919,349374,947298,2639591
2015-04-29,CHX (M),19123532,12958348,9149055,41230935,907345773.041400,1739844593.360000,1028836188.833600,3676026555.235000,518,5617,1046,7181
2015-04-29,NYSE (N),868976983,0,0,868976983,32915690381.237830,0.000000,0.000000,32915690381.237830,2790585,0,0,2790585
2015-04-29,NYSE Arca (P),393972034,290595060,217994283,902561377,15872197778.092278,16732958046.958428,10241360450.503085,42846516275.553791,2583532,811591,1551706,4946829
2015-04-29,NASDAQ (Q),566766289,169200445,471453752,1207420486,25125681281.429777,11160413017.781121,21075074884.061983,57361169183.272881,4483187,656874,2961511,8101572
2015-04-29,NASDAQ PSX (X),40710579,17455626,19165523,77331728,1551914147.070701,898411729.020000,768407619.180001,3218733495.270702,315749,63430,136374,515553
2015-04-29,BATS BYX (Y),161700176,70391769,77552358,309644303,5734367435.392884,3121948194.812903,2935911797.214782,11792227427.420569,1353504,278916,629418,2261838
2015-04-29,BATS BZX (Z),298024141,141704628,156385519,596114288,11190810416.056675,8874220496.881338,6803855247.143520,26868886160.081533,2271297,525262,1211109,4007668
2015-04-28,NYSE MKT (A),0,11768192,4381434,16149626,0.000000,65525084.342100,137888869.532000,203413953.874100,0,26530,18397,44927
2015-04-28,NASDAQ BX (B),58187234,27419745,33448186,119055165,2227618758.237597,1425870873.563898,1619085286.806406,5272574918.607901,471246,111227,277073,859546
2015-04-28,NYSE (DN),129513670,29046120,81968486,240528276,5137420255.134321,1419057377.662103,3879238169.836871,10435715802.633295,538303,87344,322548,948195
2015-04-28,NASDAQ (DQ),1028616996,382529123,693073838,2104219957,36717054771.655605,18430535327.171805,28433519929.171290,83581110027.998700,3540436,702915,2114556,6357907
2015-04-28,EDGA (J),91180440,39095332,51786619,182062391,3237694312.449401,1992841479.747398,2053773994.512205,7284309786.709004,726807,174089,395299,1296195
2015-04-28,EDGX (K),194451094,95517852,168140517,458109463,7301638061.732487,3999928643.620498,7207255838.349080,18508822543.702065,1163319,282368,951477,2397164
2015-04-28,CHX (M),19825424,10327566,4248882,34401872,664993421.016300,1116987663.255000,295283066.899400,2077264151.170700,479,3983,1201,5663
2015-04-28,NYSE (N),786641365,0,0,786641365,29648556243.503990,0.000000,0.000000,29648556243.503990,2478806,0,0,2478806
2015-04-28,NYSE Arca (P),328056629,227354253,233066927,788477809,13001272072.113962,12738763192.091417,10920571963.695154,36660607227.900533,2166463,653895,1551569,4371927
2015-04-28,NASDAQ (Q),474782893,127168696,501102781,1103054370,21164272331.867463,8217279918.042382,23481887171.098277,52863439421.008122,3806292,520667,3035932,7362891
2015-04-28,NASDAQ PSX (X),34209080,12311593,20997808,67518481,1334100738.841198,673648128.345000,847090799.408000,2854839666.594198,273317,51573,146305,471195
2015-04-28,BATS BYX (Y),154321333,56894848,83339296,294555477,5407173096.688539,2674807884.178093,3157334772.376570,11239315753.243202,1285443,247851,669770,2203064
2015-04-28,BATS BZX (Z),253263705,109910658,163071899,526246262,9379399514.638588,6955506808.819805,7329313225.391533,23664219548.849926,1950336,445002,1245631,3640969
2015-04-27,NYSE MKT (A),0,13050328,4169940,17220268,0.000000,147088615.313500,141928388.691000,289017004.004500,0,27938,18572,46510
2015-04-27,NASDAQ BX (B),53106773,29128839,34718690,116954302,2110022306.123798,1409409931.232998,1689749423.107398,5209181660.464194,443920,113034,284583,841537
2015-04-27,NYSE (DN),121485372,29590965,83985712,235062049,5099186714.642838,1321853283.629898,3771620784.995915,10192660783.268651,488910,90248,318286,897444
2015-04-27,NASDAQ (DQ),1060440747,440814011,789862849,2291117607,37187894438.836523,18520180628.668765,31999206331.157955,87707281398.663243,3456234,772084,2223726,6452044
2015-04-27,EDGA (J),81796368,41369753,50309055,173475176,2866239825.323806,2021316260.131898,2088001012.764412,6975557098.220116,668672,180154,391811,1240637
2015-04-27,EDGX (K),178391973,103587351,185403677,467383001,6611901191.609605,3987328265.875694,8336267489.332766,18935496946.818065,1059593,283393,1010242,2353228
2015-04-27,CHX (M),20351954,6816062,6293093,33461109,566611859.858000,811390280.180000,309598911.220600,1687601051.258600,1115,3226,811,5152
2015-04-27,NYSE (N),800157615,0,0,800157615,31762561832.359128,0.000000,0.000000,31762561832.359128,2421472,0,0,2421472
2015-04-27,NYSE Arca (P),289307869,258492805,242599992,790400666,11535096031.546402,13874578486.055694,11654828418.041065,37064502935.643161,1932667,632222,1539424,4104313
2015-04-27,NASDAQ (Q),430346262,125630011,528053537,1084029810,19484054414.006944,7581815943.192206,24687467427.296700,51753337784.495850,3490168,479020,2957238,6926426
2015-04-27,NASDAQ PSX (X),33456369,15022706,20824920,69303995,1298232963.311499,713660999.900100,858575817.859301,2870469781.070900,265475,55649,145193,466317
2015-04-27,BATS BYX (Y),138118857,63610591,77583295,279312743,4661062166.098997,2815527474.252100,2856570001.000005,10333159641.351102,1133249,245451,606292,1984992
2015-04-27,BATS BZX (Z),236207277,111776587,155113485,503097349,8703628320.885227,6793421957.459506,6613242603.761180,22110292882.105913,1805966,416056,1185905,3407927
2015-04-24,NYSE MKT (A),0,11341029,4221996,15563025,0.000000,107238159.852700,130902764.994000,238140924.846700,0,24901,19360,44261
2015-04-24,NASDAQ BX (B),54023613,21774962,30293934,106092509,2000378013.197591,1125568902.430700,1651064674.990999,4777011590.619290,426237,92448,244997,763682
2015-04-24,NYSE (DN),121393135,23000999,73406342,217800476,4736788347.986019,1001897128.057998,3879328145.421593,9618013621.465610,469892,71509,283388,824789
2015-04-24,NASDAQ (DQ),1051615951,341382240,657504160,2050502351,35844566553.746891,13826322265.975450,28355595671.767653,78026484491.489994,3289911,617323,2003425,5910659
2015-04-24,EDGA (J),77967955,30395477,43603813,151967245,2547622213.553204,1403295824.705098,1842366162.934909,5793284201.193211,603784,133652,333135,1070571
2015-04-24,EDGX (K),179676393,84021613,156030484,419728490,6218859005.773412,3064298766.281193,7163336599.853391,16446494371.907996,1023099,220121,835968,2079188
2015-04-24,CHX (M),12127265,8347263,5967863,26442391,545626120.582000,914266975.854000,370634987.281000,1830528083.717000,557,1966,812,3335
2015-04-24,NYSE (N),767413597,0,0,767413597,29050994582.512331,0.000000,0.000000,29050994582.512331,2148060,0,0,2148060
2015-04-24,NYSE Arca (P),282585145,185093768,199983086,667661999,11038179530.525602,9803876082.000498,10662354722.843323,31504410335.369423,1793091,493460,1313055,3599606
2015-04-24,NASDAQ (Q),429479541,95327268,493900096,1018706905,18811147136.156884,5692240688.396210,24706261260.169270,49209649084.722364,3283427,377406,2621786,6282619
2015-04-24,NASDAQ PSX (X),30435782,11006122,18231424,59673328,1174275369.052100,549858253.012600,799860100.656900,2523993722.721600,234709,43816,125062,403587
2015-04-24,BATS BYX (Y),143567106,49195026,74882242,267644374,4654497285.206407,2067261669.362599,2995168948.110299,9716927902.679305,1155589,210541,598034,1964164
2015-04-24,BATS BZX (Z),227282006,89819944,140005048,457106998,8106492662.624385,5386204203.146793,6625854913.133390,20118551778.904568,1680317,332168,1057735,3070220
2015-04-23,NYSE MKT (A),0,9346462,4345782,13692244,0.000000,60521914.201200,157626332.781200,218148246.982400,0,24050,19557,43607
2015-04-23,NASDAQ BX (B),56706623,24267634,28887375,109861632,2118197208.648092,1265386185.064400,1466588018.233796,4850171411.946288,453381,100061,234205,787647
2015-04-23,NYSE (DN),144651409,26381214,82220473,253253096,5569713106.925850,1372042217.780100,3630331172.529901,10572086497.235851,575817,81561,294760,952138
2015-04-23,NASDAQ (DQ),1150413380,408154889,664188198,2222756467,39969674691.403301,17723600185.638879,25949387456.528921,83642662333.571101,3603903,693239,1947826,6244968
2015-04-23,EDGA (J),87829105,39159403,44325205,171313713,3185067448.399996,1801911533.374002,1920490053.034098,6907469034.808096,704544,161446,349993,1215983
2015-04-23,EDGX (K),191681462,97435960,154874159,443991581,7055440013.366313,3564821619.580637,6914384036.108065,17534645669.055015,1082067,249814,814921,2146802
2015-04-23,CHX (M),19691887,12458304,7526088,39676279,774979300.105600,1123123404.837199,627829155.886700,2525931860.829499,569,2474,742,3785
2015-04-23,NYSE (N),797596977,0,0,797596977,30592352758.424447,0.000000,0.000000,30592352758.424447,2253358,0,0,2253358
2015-04-23,NYSE Arca (P),315657368,219921517,193617997,729196882,12436416683.918458,13304726468.848238,9860945973.458439,35602089126.225135,1955458,553463,1262508,3771429
2015-04-23,NASDAQ (Q),451503532,113317152,458015298,1022835982,20140069165.080102,7524663946.405010,22916902328.434638,50581635439.919750,3458726,434036,2604390,6497152
2015-04-23,NASDAQ PSX (X),34243014,12781578,17512324,64536916,1301023820.520001,654411233.423200,792738564.639800,2748173618.583001,256060,44401,128008,428469
2015-04-23,BATS BYX (Y),156230109,58161408,72238170,286629687,5157299875.463989,2406712057.227302,2862490816.281987,10426502748.973278,1234953,236502,575231,2046686
2015-04-23,BATS BZX (Z),244514120,103095512,139190337,486799969,9003299176.446701,6598741073.534394,6262976374.104398,21865016624.085493,1819629,385627,1062186,3267442
2015-04-22,NYSE MKT (A),0,10347153,5548427,15895580,0.000000,64362361.598100,153508977.357000,217871338.955100,0,24857,23535,48392
2015-04-22,NASDAQ BX (B),53549364,21422868,29098386,104070618,2094548407.937406,1112694516.888199,1365363306.187198,4572606231.012803,430512,86287,232748,749547
2015-04-22,NYSE (DN),122511109,23848919,65752845,212112873,5133877391.547933,1185370619.305801,2819062823.639227,9138310834.492961,481657,74180,252742,808579
2015-04-22,NASDAQ (DQ),1020769357,353944775,594557933,1969272065,36947207587.376051,15215137722.348833,21185582589.359245,73347927899.084129,3326539,662825,1769370,5758734
2015-04-22,EDGA (J),82576876,32496028,41650291,156723195,3084564124.597202,1616316924.957000,1577691304.875901,6278572354.430103,666948,143346,321050,1131344
2015-04-22,EDGX (K),176471810,87792536,153618000,417882346,6579822167.494284,3441713607.634993,5756739712.674246,15778275487.803523,1011782,241789,769677,2023248
2015-04-22,CHX (M),9677851,13143719,8918735,31740305,488331810.383800,1281034378.655000,511544605.153000,2280910794.191800,519,3051,601,4171
2015-04-22,NYSE (N),753961818,0,0,753961818,29750401575.318705,0.000000,0.000000,29750401575.318705,2257486,0,0,2257486
2015-04-22,NYSE Arca (P),290871650,202735400,181359024,674966074,11870975748.643178,11164257221.232268,8003964199.894718,31039197169.770164,1864208,556911,1169351,3590470
2015-04-22,NASDAQ (Q),437998835,106169737,417276886,961445458,20016542272.204111,6574404403.673898,18464351422.364804,45055298098.242813,3479262,426809,2379135,6285206
2015-04-22,NASDAQ PSX (X),32857036,10387369,16701392,59945797,1296741484.580001,561113910.304400,638797319.007101,2496652713.891502,251475,40828,109770,402073
2015-04-22,BATS BYX (Y),138794079,49479989,64290830,252564898,4709380820.926989,2210267520.563500,2335932703.885090,9255581045.375579,1114395,215170,515816,1845381
2015-04-22,BATS BZX (Z),232342699,94296480,123257968,449897147,8759596790.041276,5812341156.071301,5028954458.683974,19600892404.796551,1757550,369481,950901,3077932
2015-04-21,NYSE MKT (A),0,9367254,4396933,13764187,0.000000,48300654.433400,115932475.259600,164233129.693000,0,19982,18596,38578
2015-04-21,NASDAQ BX (B),48454545,20764041,28452902,97671488,1916749484.208404,1100973539.922200,1323051199.228801,4340774223.359405,390917,84761,229349,705027
2015-04-21,NYSE (DN),122031014,23089819,75896073,221016906,4999403722.292419,1116396106.638999,3124583728.000197,9240383556.931615,461960,65444,260344,787748
2015-04-21,NASDAQ (DQ),1051730861,367513016,624046458,2043290335,37885179826.279932,16989299562.887291,22676675126.495404,77551154515.662627,3254695,630873,1794417,5679985
2015-04-21,EDGA (J),78097219,32629613,40697046,151423878,2805488073.433702,1460047001.584000,1501351800.907189,5766886875.924891,619772,132093,315340,1067205
2015-04-21,EDGX (K),171047422,77951821,151608708,400607951,6260575717.329916,2959623891.232000,5589021783.322045,14809221391.883961,988920,210774,737688,1937382
2015-04-21,CHX (M),14313069,7971036,7880605,30164710,579312700.227400,744155363.878200,479635354.721200,1803103418.826800,548,1964,510,3022
2015-04-21,NYSE (N),689976190,0,0,689976190,26878966758.046886,0.000000,0.000000,26878966758.046886,2165484,0,0,2165484
2015-04-21,NYSE Arca (P),268311397,177973858,181241554,627526809,11547735567.399376,9840556478.615603,7921011333.707776,29309303379.722755,1781526,512920,1157362,3451808
2015-04-21,NASDAQ (Q),426438874,94983893,402267276,923690043,19735902623.567752,5899158455.491704,18139924429.804742,43774985508.864198,3372835,376976,2348702,6098513
2015-04-21,NASDAQ PSX (X),31097248,9752658,15513020,56362926,1206924593.812400,511413881.813200,618282062.628201,2336620538.253801,231837,37136,106721,375694
2015-04-21,BATS BYX (Y),127553377,52525471,67503543,247582391,4490320829.297890,2243301542.244401,2427005768.005304,9160628139.547595,1066373,206160,537566,1810099
2015-04-21,BATS BZX (Z),222177834,84804066,126841881,433823781,8479055061.913632,5109823921.347896,5203824134.150587,18792703117.412115,1699677,331796,953579,2985052
2015-04-20,NYSE MKT (A),0,11266966,5255237,16522203,0.000000,92905221.197900,145979848.617700,238885069.815600,0,24924,21122,46046
2015-04-20,NASDAQ BX (B),49605819,21777357,27047147,98430323,1954580284.213900,1207201659.491700,1304007893.392997,4465789837.098597,413836,89097,223133,726066
2015-04-20,NYSE (DN),118389171,25731433,72671193,216791797,4765262141.984916,1271787727.054401,3025048233.528346,9062098102.567663,483498,73763,277653,834914
2015-04-20,NASDAQ (DQ),926211633,373902620,579804140,1879918393,33746048272.161624,17835971026.468706,21343653561.802538,72925672860.432868,3043543,662349,1722399,5428291
2015-04-20,EDGA (J),72026616,33348115,39748849,145123580,2631087612.210008,1579443168.398202,1511435434.384193,5721966214.992403,605654,143520,314629,1063803
2015-04-20,EDGX (K),155766996,87928072,138325517,382020585,5835237906.485777,3327958020.840098,5198302902.648895,14361498829.974770,925246,233298,695701,1854245
2015-04-20,CHX (M),10875904,8370987,6604753,25851644,420304555.981600,1083304494.010000,430311287.514900,1933920337.506500,644,3341,992,4977
2015-04-20,NYSE (N),683508336,0,0,683508336,27555818336.039404,0.000000,0.000000,27555818336.039404,2103875,0,0,2103875
2015-04-20,NYSE Arca (P),251116075,200916275,165544775,617577125,10536436830.521484,11884423151.363926,7170366124.995803,29591226106.881213,1688897,535459,1103950,3328306
2015-04-20,NASDAQ (Q),370792829,106837671,407231982,884862482,16963118703.596836,6573588003.264229,18201777802.687684,41738484509.548749,2977041,400123,2269845,5647009
2015-04-20,NASDAQ PSX (X),28763577,11128942,14713923,54606442,1141936069.767600,542594967.796100,590740273.767599,2275271311.331299,225827,43441,106816,376084
2015-04-20,BATS BYX (Y),127631498,51321445,66682044,245634987,4436470330.701291,2109648906.613795,2359828753.965410,8905947991.280496,1074821,210867,540009,1825697
2015-04-20,BATS BZX (Z),207608953,92628367,125804939,426042259,7782581466.567711,5630176826.966191,5320951553.310094,18733709846.843996,1577581,361294,959261,2898136
2015-04-17,NYSE MKT (A),0,10025566,5205779,15231345,0.000000,70743057.469200,127015913.264400,197758970.733600,0,22701,24339,47040
2015-04-17,NASDAQ BX (B),58984749,35130207,35189395,129304351,2288395026.598493,2208201169.372804,1686925780.022409,6183521975.993706,480605,149546,274132,904283
2015-04-17,NYSE (DN),131989042,36976626,72350198,241315866,5317534703.659995,2038581104.085380,3200481647.111733,10556597454.857108,519356,106680,288948,914984
2015-04-17,NASDAQ (DQ),1055435407,583052967,661305914,2299794288,37806343928.902572,33899394642.399740,25275932799.265221,96981671370.567533,3520654,921990,1947270,6389914
2015-04-17,EDGA (J),85530095,50098842,48556493,184185430,2990809078.911598,2714370533.949003,1785565251.401307,7490744864.261908,679883,223695,363782,1267360
2015-04-17,EDGX (K),186156633,115863413,161933120,463953166,6844057382.105698,5472534941.486309,6249591672.572901,18566183996.164908,1068321,354845,810680,2233846
2015-04-17,CHX (M),12358483,18725073,8578656,39662212,773520023.262000,2554060373.066001,847054002.153200,4174634398.481201,515,4686,909,6110
2015-04-17,NYSE (N),892943469,0,0,892943469,36069061285.887382,0.000000,0.000000,36069061285.887382,2509531,0,0,2509531
2015-04-17,NYSE Arca (P),308402212,307162254,206091722,821656188,12752919762.612275,19916859780.999022,9543773414.173504,42213552957.784801,1991334,819284,1330698,4141316
2015-04-17,NASDAQ (Q),461112809,164450383,536658560,1162221752,21061731263.347372,11397367014.575066,24830640184.926342,57289738462.848780,3642582,639152,2815336,7097070
2015-04-17,NASDAQ PSX (X),34398295,16597050,19848667,70844012,1346438728.450002,879465018.178000,801936990.473700,3027840737.101702,263230,63154,136132,462516
2015-04-17,BATS BYX (Y),155043902,86312267,80406749,321762918,5370421553.914447,4420490179.754299,3031940808.518194,12822852542.186940,1275234,357143,645989,2278366
2015-04-17,BATS BZX (Z),253505902,149786484,155857858,559150244,9619854011.373575,10733217268.180724,6785680981.228186,27138752260.782485,1903662,568918,1169555,3642135
2015-04-16,NYSE MKT (A),0,11540574,5318370,16858944,0.000000,54034866.181500,119083794.580600,173118660.762100,0,23837,21507,45344
2015-04-16,NASDAQ BX (B),58419167,25414758,28863248,112697173,2131524062.668695,1333767482.098599,1418716486.533506,4884008031.300800,474440,105501,241272,821213
2015-04-16,NYSE (DN),136225208,31495085,69234905,236955198,4816542802.172278,1395591740.302895,3101592296.536909,9313726839.012082,524090,87171,273942,885203
2015-04-16,NASDAQ (DQ),1093662277,466315452,581494571,2141472300,35940037557.871730,18154062394.748424,21358863609.329672,75452963561.949826,3528420,745085,1850710,6124215
2015-04-16,EDGA (J),84653673,40399587,41930873,166984133,2805543789.724093,1782902991.727099,1535478858.752492,6123925640.203684,667230,164789,328123,1160142
2015-04-16,EDGX (K),185980893,105801855,142921392,434704140,6122487301.394969,3392301100.937095,5655496189.708170,15170284592.040234,1006713,253348,737693,1997754
2015-04-16,CHX (M),11686196,9207748,4677998,25571942,611119450.388900,816923676.300000,297624944.677000,1725668071.365900,613,2252,467,3332
2015-04-16,NYSE (N),755347007,0,0,755347007,28073513773.870289,0.000000,0.000000,28073513773.870289,2285350,0,0,2285350
2015-04-16,NYSE Arca (P),291467942,231750373,174908262,698126577,11086837440.153348,11646354327.252313,7719226559.152018,30452418326.557679,1828740,616289,1140142,3585171
2015-04-16,NASDAQ (Q),435925904,121060223,417013420,973999547,18699309267.893287,7028015248.518790,18442811661.360025,44170136177.772102,3408984,450464,2379900,6239348
2015-04-16,NASDAQ PSX (X),33758632,11930630,14884643,60573905,1217771847.078000,552035471.615200,570103970.246699,2339911288.939899,252488,46635,104301,403424
2015-04-16,BATS BYX (Y),147105617,60518654,65975442,273599713,4705347212.375304,2534137145.557195,2408312597.903195,9647796955.835694,1228913,259828,548614,2037355
2015-04-16,BATS BZX (Z),227421833,107235085,122629443,457286361,8054987142.687129,6124260253.586511,5031915262.599490,19211162658.873130,1700228,397815,936045,3034088
2015-04-15,NYSE MKT (A),0,14588248,5437873,20026121,0.000000,70888710.952200,133878015.475100,204766726.427300,0,28533,23594,52127
2015-04-15,NASDAQ BX (B),69285771,28316743,33106881,130709395,2458309520.317898,1322762149.741499,1459978349.449820,5241050019.509217,521996,106374,267054,895424
2015-04-15,NYSE (DN),144101551,31184888,66802014,242088453,4987177398.427992,1404971553.479902,2638495898.156293,9030644850.064187,531451,86207,254388,872046
2015-04-15,NASDAQ (DQ),1325708766,502686055,624630565,2453025386,40090857722.126140,20087909686.906869,20843451615.292848,81022219024.325857,3796422,789352,1844047,6429821
2015-04-15,EDGA (J),100219407,43143557,44838254,188201218,3213473272.293206,1825769614.417303,1570210994.553701,6609453881.264210,755355,176860,343577,1275792
2015-04-15,EDGX (K),217560287,133603704,155684835,506848826,6946055345.501484,4006008807.427980,5564360298.861005,16516424451.790469,1128056,296757,786108,2210921
2015-04-15,CHX (M),11290682,11572866,5885054,28748602,424382112.135100,1118723519.813000,185770198.413000,1728875830.361100,590,2758,495,3843
2015-04-15,NYSE (N),877052616,0,0,877052616,31928063075.192228,0.000000,0.000000,31928063075.192228,2371634,0,0,2371634
2015-04-15,NYSE Arca (P),332920325,267411231,188735093,789066649,11925932115.274375,14544842212.940649,7847691275.892355,34318465604.107379,1968972,639778,1207847,3816597
2015-04-15,NASDAQ (Q),474096617,130280099,449729584,1054106300,20039571829.895356,7680513609.588190,18974603090.727111,46694688530.210657,3538651,465175,2441211,6445037
2015-04-15,NASDAQ PSX (X),37123165,14544076,17143141,68810382,1302050203.098799,736969736.810900,630661066.881999,2669681006.791698,269277,50774,114765,434816
2015-04-15,BATS BYX (Y),170184574,70197196,71018903,311400673,5191496250.317515,2799512390.318199,2483230328.312919,10474238968.948633,1304365,279560,579142,2163067
2015-04-15,BATS BZX (Z),258939234,117937009,139519042,516395285,8851117991.804769,6640952228.028606,5360436699.510016,20852506919.343391,1803926,414347,1020931,3239204
2015-04-14,NYSE MKT (A),0,8898159,4705864,13604023,0.000000,57747578.017700,102761843.624500,160509421.642200,0,21419,19881,41300
2015-04-14,NASDAQ BX (B),58311443,21595669,28890918,108798030,2182157136.693294,1172968316.171200,1338711497.044003,4693836949.908497,462630,92693,237752,793075
2015-04-14,NYSE (DN),123612972,22644266,65769568,212026806,4686986664.983300,1140804166.778700,2570917481.975830,8398708313.737830,466044,65100,245089,776233
2015-04-14,NASDAQ (DQ),1063630846,344199271,556547507,1964377624,34387753088.315634,15779983995.254032,18865941610.951636,69033678694.521302,3271287,655782,1673068,5600137
2015-04-14,EDGA (J),82675880,34574020,40608318,157858218,2679968960.670402,1609962846.709497,1392615649.401897,5682547456.781796,643971,148132,302149,1094252
2015-04-14,EDGX (K),178753809,93556117,135418179,407728105,6023934233.135693,3491494932.848903,4977243772.843369,14492672938.827965,982178,247959,704930,1935067
2015-04-14,CHX (M),10132219,8129528,3618531,21880278,433148003.835500,859524451.950000,154303388.281000,1446975844.066500,639,2709,490,3838
2015-04-14,NYSE (N),691344507,0,0,691344507,26053794330.306339,0.000000,0.000000,26053794330.306339,2057322,0,0,2057322
2015-04-14,NYSE Arca (P),287440756,199576018,165397490,652414264,10598784248.595166,11133825048.056706,7053237924.095651,28785847220.747523,1759842,566203,1078751,3404796
2015-04-14,NASDAQ (Q),402611944,104971073,382884835,890467852,17228162471.763442,6535210557.804102,16641140320.355022,40404513349.922566,3078849,419021,2159897,5657767
2015-04-14,NASDAQ PSX (X),32638740,11198948,16827526,60665214,1185764306.597797,574796771.406200,600516237.442098,2361077315.446095,237079,43700,107284,388063
2015-04-14,BATS BYX (Y),141665743,51694703,64335459,257695905,4490600536.751317,2327315903.275101,2269749134.378999,9087665574.405417,1132408,220454,528754,1881616
2015-04-14,BATS BZX (Z),232692750,95328170,121025109,449046029,8021168053.587706,5850972367.925495,4808741842.739237,18680882264.252438,1672657,370206,918422,2961285
2015-04-13,NYSE MKT (A),0,9518476,3571846,13090322,0.000000,88021677.849100,96118695.506000,184140373.355100,0,20860,16078,36938
2015-04-13,NASDAQ BX (B),48814890,23244695,27360908,99420493,1828113556.503097,1121528017.433799,1280252529.620509,4229894103.557405,403463,93118,226173,722754
2015-04-13,NYSE (DN),112769867,28501468,68435445,209706780,4141059996.987310,1380442966.918197,2821791594.582483,8343294558.487990,432367,78775,253938,765080
2015-04-13,NASDAQ (DQ),922761286,362928591,540395568,1826085445,30751652888.956871,17110774360.478562,18986548984.352666,66848976233.788099,3014673,676645,1700832,5392150
2015-04-13,EDGA (J),69371396,31339066,38050747,138761209,2249647900.239405,1369482057.380204,1353283883.354706,4972413840.974315,540292,137572,291546,969410
2015-04-13,EDGX (K),144462767,82844772,132692745,360000284,5061538273.435210,2929558265.825003,4803804107.349759,12794900646.609972,820976,230050,661210,1712236
2015-04-13,CHX (M),11259212,13313563,3236584,27809359,502543410.626800,1392016340.339200,138966847.633000,2033526598.599000,920,1690,447,3057
2015-04-13,NYSE (N),670444539,0,0,670444539,26161670663.243851,0.000000,0.000000,26161670663.243851,1853186,0,0,1853186
2015-04-13,NYSE Arca (P),228125138,218020178,155211013,601356329,8815584719.646146,11746392875.675087,6911996335.402474,27473973930.723707,1452863,543652,1016902,3013417
2015-04-13,NASDAQ (Q),354914853,96814165,389173155,840902173,15335655437.481301,5802480083.707886,17569508231.474038,38707643752.663225,2721737,382545,2102530,5206812
2015-04-13,NASDAQ PSX (X),26956870,11219629,14464675,52641174,1022656469.062000,560437046.678000,552937542.553600,2136031058.293600,196446,42902,100428,339776
2015-04-13,BATS BYX (Y),123426320,62097512,60917605,246441437,3868739413.824596,2245736063.670205,2152000964.160288,8266476441.655089,976560,227973,490691,1695224
2015-04-13,BATS BZX (Z),200772460,89041588,114471312,404285360,7067221793.247594,4949359372.043788,4607066465.413401,16623647630.704783,1423050,349655,872095,2644800
2015-04-10,NYSE MKT (A),0,8230096,5789804,14019900,0.000000,43134962.489200,145959014.895600,189093977.384800,0,18542,21780,40322
2015-04-10,NASDAQ BX (B),56998263,23103388,28949588,109051239,2220117535.528802,1155017136.761697,1301887224.494494,4677021896.784993,461248,98105,233191,792544
2015-04-10,NYSE (DN),130294813,27743750,64186550,222225113,4948941969.080222,1216191456.714303,2583310036.835013,8748443462.629538,468828,80133,237817,786778
2015-04-10,NASDAQ (DQ),992435893,372505555,539830007,1904771455,33560660793.529576,16701978629.769056,17916605986.542526,68179245409.841158,3079839,651200,1581841,5312880
2015-04-10,EDGA (J),76554117,31092466,38712145,146358728,2657264448.965503,1396163660.938001,1323521706.437396,5376949816.340900,609826,137223,280477,1027526
2015-04-10,EDGX (K),155836062,79652491,120506555,355995108,5512716718.088596,2926058375.857396,4376532763.325631,12815307857.271623,857207,219434,611522,1688163
2015-04-10,CHX (M),11203249,9148078,3644843,23996170,489854129.803000,1126313944.220800,226213445.647500,1842381519.671300,743,2057,453,3253
2015-04-10,NYSE (N),671567096,0,0,671567096,25417570705.753194,0.000000,0.000000,25417570705.753194,1975933,0,0,1975933
2015-04-10,NYSE Arca (P),270208773,206446177,156285999,632940949,10257588173.414228,11085783434.695436,6517043775.350622,27860415383.460286,1589732,521021,972484,3083237
2015-04-10,NASDAQ (Q),383214641,97787401,360363619,841365661,16347507908.220625,5719366782.862684,15630275196.318961,37697149887.402270,2805116,388443,2008309,5201868
2015-04-10,NASDAQ PSX (X),30347273,10657200,14578512,55582985,1110269682.504999,575451776.968100,547849412.464999,2233570871.938098,218755,45746,96019,360520
2015-04-10,BATS BYX (Y),124641314,53072195,62820700,240534209,4141133925.741601,2219442698.064397,2176696468.309875,8537273092.115873,998492,208274,485197,1691963
2015-04-10,BATS BZX (Z),209800443,90397142,116060518,416258103,7479045775.706689,5357331943.940296,4668239837.366741,17504617557.013726,1489366,356794,845297,2691457
2015-04-09,NYSE MKT (A),0,9324492,6544823,15869315,0.000000,56061100.229600,117935598.616200,173996698.845800,0,22021,21083,43104
2015-04-09,NASDAQ BX (B),60255426,26068268,31940970,118264664,2283481577.560598,1403192954.297802,1382305193.367201,5068979725.225601,494427,115878,252743,863048
2015-04-09,NYSE (DN),131181442,29131014,76875614,237188070,5115771805.196990,1461403662.857504,2977666989.980604,9554842458.035098,484590,87440,270814,842844
2015-04-09,NASDAQ (DQ),957791345,435698778,614761332,2008251455,32603039651.133217,18292457506.443405,20381875974.856810,71277373132.433432,3113965,715226,1674268,5503459
2015-04-09,EDGA (J),80713138,39243056,42925474,162881668,2704036792.444200,1863351665.732199,1493255866.715293,6060644324.891692,644438,172582,316596,1133616
2015-04-09,EDGX (K),166005477,98701628,145279243,409986348,5851464068.287713,3866470557.171799,5318367175.275194,15036301800.734706,939920,284071,759606,1983597
2015-04-09,CHX (M),10204173,11313207,3569041,25086421,451946246.224200,1111910967.290000,161507693.963800,1725364907.478000,1048,2864,569,4481
2015-04-09,NYSE (N),725251738,0,0,725251738,26803131898.131937,0.000000,0.000000,26803131898.131937,2296157,0,0,2296157
2015-04-09,NYSE Arca (P),257575719,236033073,182996379,676605171,10468856041.630497,12921718886.901292,7647693924.269472,31038268852.801261,1760590,644987,1172190,3577767
2015-04-09,NASDAQ (Q),396846539,120351621,409748086,926946246,17475547800.383005,7864523653.547709,17129495313.567110,42469566767.497824,3146319,477680,2350691,5974690
2015-04-09,NASDAQ PSX (X),35153980,13626971,17182540,65963491,1256381582.632802,745847919.080100,664015302.056200,2666244803.769102,257194,54860,114276,426330
2015-04-09,BATS BYX (Y),131244176,61679061,69738512,262661749,4262631346.595333,2817544041.538103,2406496327.222375,9486671715.355811,1072648,248919,525373,1846940
2015-04-09,BATS BZX (Z),223646814,106686977,131074379,461408170,7950609966.224594,6181673126.555491,5099717756.072868,19232000848.852953,1650311,427208,953079,3030598
2015-04-08,NYSE MKT (A),0,9666295,6066827,15733122,0.000000,67034658.950100,98511471.571000,165546130.521100,0,22339,20271,42610
2015-04-08,NASDAQ BX (B),59419304,27462849,33355520,120237673,2328030209.460803,1505094010.405903,1552528198.199494,5385652418.066200,508726,121777,279326,909829
2015-04-08,NYSE (DN),117352305,30499784,70464264,218316353,5055761944.115311,1479153051.821600,2967419910.599220,9502334906.536131,463078,85505,268918,817501
2015-04-08,NASDAQ (DQ),962698479,417388281,580077700,1960164460,34341451496.139370,17895190191.707530,21572779203.356712,73809420891.203612,3273359,745472,1739552,5758383
2015-04-08,EDGA (J),80035314,43470337,42803797,166309448,2693496981.789099,1949555765.624799,1652039699.254399,6295092446.668297,650115,182295,336924,1169334
2015-04-08,EDGX (K),180744491,109573203,147778226,438095920,6292638272.984813,4030455836.068007,5776069387.208144,16099163496.260964,1029209,300971,816228,2146408
2015-04-08,CHX (M),10222834,12411733,11747389,34381956,664844849.288100,1152514195.608100,454908757.777000,2272267802.673200,733,3087,608,4428
2015-04-08,NYSE (N),765589506,0,0,765589506,28950054273.670392,0.000000,0.000000,28950054273.670392,2352126,0,0,2352126
2015-04-08,NYSE Arca (P),276364279,259093332,176955331,712412942,11222611048.460593,13837406658.971832,7958576095.995161,33018593803.427586,1863354,695738,1209822,3768914
2015-04-08,NASDAQ (Q),419628226,132555798,431471451,983655475,18478004528.733637,8249792695.751989,19158504870.688558,45886302095.174184,3335508,534542,2470790,6340840
2015-04-08,NASDAQ PSX (X),34225631,15206563,16315076,65747270,1210521595.129702,792158609.214500,656426814.648302,2659107018.992504,255879,60345,116531,432755
2015-04-08,BATS BYX (Y),129471781,63133461,69017482,261622724,4162305393.646105,2811542237.026300,2488601566.858809,9462449197.531214,1075731,270827,549802,1896360
2015-04-08,BATS BZX (Z),232278771,118264564,132113291,482656626,8510619160.781941,6727940023.584515,5391168930.204484,20629728114.570940,1757196,467773,1006466,3231435
2015-04-07,NYSE MKT (A),0,9631214,6433482,16064696,0.000000,54196976.414000,173421665.938700,227618642.352700,0,22062,25380,47442
2015-04-07,NASDAQ BX (B),53271311,23198194,29447907,105917412,2066484190.140306,1201357926.423799,1284446920.229702,4552289036.793807,465851,102498,245860,814209
2015-04-07,NYSE (DN),110600413,28270812,64445685,203316910,4141661681.800105,1355488533.796400,2603195181.927502,8100345397.524007,458710,85244,257838,801792
2015-04-07,NASDAQ (DQ),996322548,427447224,537941408,1961711180,32332752592.458607,18394280559.350874,18644149423.431233,69371182575.240714,3286270,701986,1713113,5701369
2015-04-07,EDGA (J),72259404,36575637,40021441,148856482,2395553897.345505,1602288474.226901,1450511236.534805,5448353608.107211,603043,157229,314103,1074375
2015-04-07,EDGX (K),157052208,98645274,127755809,383453291,5540518814.913488,3268708976.513096,4811038731.837885,13620266523.264469,930464,249324,709145,1888933
2015-04-07,CHX (M),17834882,7348402,4847021,30030305,824173036.150000,1017543947.525000,243745527.797000,2085462511.472000,809,2311,526,3646
2015-04-07,NYSE (N),663018018,0,0,663018018,25270398608.463661,0.000000,0.000000,25270398608.463661,2137623,0,0,2137623
2015-04-07,NYSE Arca (P),252145259,224031130,162075510,638251899,9892088077.342743,11206605617.177889,6941176682.378591,28039870376.899223,1716094,560991,1103790,3380875
2015-04-07,NASDAQ (Q),374921474,108204659,393079924,876206057,16111345552.713511,6556204724.137594,16768632364.654745,39436182641.505850,2947167,422871,2259790,5629828
2015-04-07,NASDAQ PSX (X),30910205,13602390,16209941,60722536,1138840666.235001,674559533.427700,610680142.909301,2424080342.572002,244658,51564,112756,408978
2015-04-07,BATS BYX (Y),129328114,57817981,66921733,254067828,4105877755.377600,2410634902.064301,2289907452.138004,8806420109.579905,1082116,231261,542725,1856102
2015-04-07,BATS BZX (Z),211904366,95239615,127541077,434685058,7601599678.152143,5233976322.332003,4983542100.032564,17819118100.516710,1621281,365702,962567,2949550
2015-04-06,NYSE MKT (A),0,12000889,5895234,17896123,0.000000,72718763.057800,127745292.239900,200464055.297700,0,24651,23705,48356
2015-04-06,NASDAQ BX (B),56995097,25596210,29504892,112096199,2126740846.228596,1459041279.092896,1338442962.494697,4924225087.816189,488367,114801,245146,848314
2015-04-06,NYSE (DN),113946440,29458007,66270852,209675299,4103553198.337221,1333068852.411400,2751765568.443299,8188387619.191920,456433,90844,258778,806055
2015-04-06,NASDAQ (DQ),981100048,432043208,613725891,2026869147,33720532528.985048,21703848854.801265,20542907104.072675,75967288487.858988,3299501,793124,1716933,5809558
2015-04-06,EDGA (J),79279224,41442751,40730195,161452170,2660417128.438996,1911762711.437798,1461891623.600705,6034071463.477499,663842,181976,316574,1162392
2015-04-06,EDGX (K),157820128,110617470,126512072,394949670,5417114582.184904,4356832957.411299,4938587074.616933,14712534614.213136,946579,297398,706958,1950935
2015-04-06,CHX (M),6418872,11200274,3617298,21236444,291137872.492900,1528897615.689600,271399889.794000,2091435377.976500,703,4159,672,5534
2015-04-06,NYSE (N),905035963,0,0,905035963,34551823881.220589,0.000000,0.000000,34551823881.220589,2238211,0,0,2238211
2015-04-06,NYSE Arca (P),242665448,263193133,157804138,663662719,9782493630.238640,14653674902.331048,6971819620.228291,31407988152.797979,1713257,658494,1098443,3470194
2015-04-06,NASDAQ (Q),373331051,127452623,486991373,987775047,15874844206.420299,8208214201.961268,20210444185.087960,44293502593.469527,2988516,497954,2245802,5732272
2015-04-06,NASDAQ PSX (X),33411460,15784766,15640357,64836583,1254658555.455001,848158067.912300,587521374.415399,2690337997.782700,263830,59718,108225,431773
2015-04-06,BATS BYX (Y),132212704,58999325,68453249,259665278,4200674541.499563,2684737756.303599,2364509099.817016,9249921397.620178,1100236,252777,537512,1890525
2015-04-06,BATS BZX (Z),224202820,112614428,126332292,463149540,7992241487.480612,6693900483.481610,5017481597.222124,19703623568.184346,1722607,436799,969183,3128589
2015-04-02,NYSE MKT (A),0,9776040,4877853,14653893,0.000000,69631973.524800,113400875.181200,183032848.706000,0,24135,20386,44521
2015-04-02,NASDAQ BX (B),54081573,27178300,28299133,109559006,2102053350.127904,1288138631.168899,1323097853.583706,4713289834.880509,468371,114146,245505,828022
2015-04-02,NYSE (DN),115638741,27664504,65050888,208354133,4281170952.632524,1280047189.322302,2635881274.641894,8197099416.596720,472133,80858,261120,814111
2015-04-02,NASDAQ (DQ),908740317,430952361,513544675,1853237353,30749634707.353274,16660857310.114962,18122137704.926061,65532629722.394297,3230368,748632,1685025,5664025
2015-04-02,EDGA (J),75602046,38055606,38295477,151953129,2518455107.171808,1711878725.157600,1385559262.927201,5615893095.256609,621137,160896,304531,1086564
2015-04-02,EDGX (K),162810571,101105702,132713835,396630108,5663741967.214085,3756513956.607289,4912527168.211335,14332783092.032709,976573,261995,748111,1986679
2015-04-02,CHX (M),8393580,13514326,4684257,26592163,390786375.223800,1313793124.443500,242928482.164100,1947507981.831400,382,2320,473,3175
2015-04-02,NYSE (N),716609758,0,0,716609758,27229182209.846962,0.000000,0.000000,27229182209.846962,2271773,0,0,2271773
2015-04-02,NYSE Arca (P),264247347,253738379,166244049,684229775,10529274448.161330,13883759537.153218,7138601597.097476,31551635582.412024,1825980,631675,1161826,3619481
2015-04-02,NASDAQ (Q),402547934,128570304,404527905,935646143,17311783068.208384,7592656369.342997,17480399539.040277,42384838976.591658,3181343,490262,2365089,6036694
2015-04-02,NASDAQ PSX (X),33479125,15247890,16939092,65666107,1205705717.878801,716573286.398400,627439619.737301,2549718624.014502,251990,56413,116469,424872
2015-04-02,BATS BYX (Y),129430515,61366531,65012354,255809400,4168919371.614102,2516876262.282001,2243943064.672601,8929738698.568704,1067820,245687,524400,1837907
2015-04-02,BATS BZX (Z),227657216,116394977,128445199,472497392,8051254050.086198,6525466896.326606,5154620709.537028,19731341655.949832,1764867,419150,1007061,3191078
2015-04-01,NYSE MKT (A),0,10526810,7038346,17565156,0.000000,85525558.511300,179449885.974000,264975444.485300,0,27832,30622,58454
2015-04-01,NASDAQ BX (B),66542829,33949501,36192461,136684791,2607904241.382193,1844164068.845003,1690633240.101294,6142701550.328490,605920,149119,325181,1080220
2015-04-01,NYSE (DN),133741898,36209989,74640434,244592321,5107034026.286273,1764609876.781608,3113459538.661310,9985103441.729191,553888,106812,295713,956413
2015-04-01,NASDAQ (DQ),1022543338,578456595,597339389,2198339322,34988500630.139406,28087467162.545114,22805364155.680048,85881331948.364568,3642908,908742,1987563,6539213
2015-04-01,EDGA (J),93720009,59423375,49938091,203081475,3292829998.966908,2733354628.442007,1910212922.767013,7936397550.175928,806387,242213,409937,1458537
2015-04-01,EDGX (K),189077542,125398397,158091140,472567079,6983156214.810698,5742296592.039702,6304813452.766078,19030266259.616478,1238428,374866,959748,2573042
2015-04-01,CHX (M),12793320,9418952,10712951,32925223,560757532.293400,1261913384.070000,496622628.712000,2319293545.075400,440,3761,733,4934
2015-04-01,NYSE (N),802056987,0,0,802056987,30950026872.792092,0.000000,0.000000,30950026872.792092,2638131,0,0,2638131
2015-04-01,NYSE Arca (P),316311290,329937154,212017633,858266077,12757249535.988208,19553955215.492602,9566894228.825029,41878098980.305839,2324062,840407,1497062,4661531
2015-04-01,NASDAQ (Q),476710042,169191107,483592039,1129493188,21175449523.261394,11055168681.221985,21771274827.032595,54001893031.515974,3960227,674320,2963083,7597630
2015-04-01,NASDAQ PSX (X),41039685,17590414,21837544,80467643,1512564764.479600,934869653.453300,788741383.146700,3236175801.079600,317511,71823,144207,533541
2015-04-01,BATS BYX (Y),152269341,83221610,74991818,310482769,4923834356.141775,3620906182.499208,2714430581.559821,11259171120.200804,1249500,314712,615082,2179294
2015-04-01,BATS BZX (Z),266425112,142113471,153137431,561676014,9839525653.430887,9191389467.148605,6282424044.179388,25313339164.758880,2156332,562815,1219528,3938675
2015-03-31,NYSE MKT (A),0,14755786,5957740,20713526,0.000000,112111436.502900,127833634.369000,239945070.871900,0,26316,23097,49413
2015-03-31,NASDAQ BX (B),61598901,31509730,35900897,129009528,2374867384.081804,1801386620.945002,1653312202.736102,5829566207.762908,524149,128756,301251,954156
2015-03-31,NYSE (DN),110447932,24638920,65416693,200503545,3941328290.830681,1306386204.223298,2941003247.758790,8188717742.812769,450955,72554,246540,770049
2015-03-31,NASDAQ (DQ),958944479,372952613,630630269,1962527361,33352419077.057811,19949559397.121632,23502889338.300908,76804867812.480351,3259632,662578,1794340,5716550
2015-03-31,EDGA (J),81049769,43511611,44925158,169486538,2641302672.277601,2239055525.691997,1627662563.943697,6508020761.913295,657548,179626,356676,1193850
2015-03-31,EDGX (K),161506259,99869938,143487234,404863431,5893617549.016116,4692270966.591797,5678388820.036356,16264277335.644269,1030129,287754,815495,2133378
2015-03-31,CHX (M),12303052,11154995,4144459,27602506,581515385.914900,1272348196.260000,245954970.900200,2099818553.075100,620,3085,667,4372
2015-03-31,NYSE (N),966766987,0,0,966766987,38156916043.717749,0.000000,0.000000,38156916043.717749,2405442,0,0,2405442
2015-03-31,NYSE Arca (P),203670064,181538647,132981445,518190156,8243005124.721307,12636256132.083832,5650925022.836617,26530186279.641756,1471441,405132,871189,2747762
2015-03-31,NASDAQ (Q),408125966,145237694,536092592,1089456252,18204688210.313055,10338492089.021891,23337123577.188423,51880303876.523369,3311103,532921,2647594,6491618
2015-03-31,NASDAQ PSX (X),30374779,13561591,16043596,59979966,1151281919.670900,716981268.494900,603103776.568900,2471366964.734700,238380,47835,112166,398381
2015-03-31,BATS BYX (Y),140528339,59635241,72072079,272235659,4545898527.621807,2859699046.880197,2538864740.307785,9944462314.809789,1146287,229185,575174,1950646
2015-03-31,BATS BZX (Z),241587874,118441321,152097629,512126824,8932877003.946972,7602324659.257989,6092503097.667364,22627704760.872325,1891136,449204,1153842,3494182
2015-03-30,NYSE MKT (A),0,10419314,5381021,15800335,0.000000,54681309.208300,130813254.045000,185494563.253300,0,23987,22742,46729
2015-03-30,NASDAQ BX (B),63145460,31771999,37496488,132413947,2394831337.647306,1636385033.955198,1709771905.607801,5740988277.210305,540249,128834,304828,973911
2015-03-30,NYSE (DN),100678714,27774172,73410457,201863343,3796635828.627303,1295304685.838900,3166669250.436691,8258609764.902894,432069,82084,283166,797319
2015-03-30,NASDAQ (DQ),857908917,467009438,614790516,1939708871,29308881808.765437,22333023738.949777,22897729133.397871,74539634681.113085,3127979,713152,1855196,5696327
2015-03-30,EDGA (J),71657387,41173519,44589589,157420495,2398825901.569299,1902020886.162604,1682518279.122698,5983365066.854601,591605,171648,347203,1110456
2015-03-30,EDGX (K),138258605,85495831,124954029,348708465,5051729497.099940,3778818865.093196,4891229453.979294,13721777816.172430,871084,247054,670425,1788563
2015-03-30,CHX (M),8520993,12055659,9435008,30011660,235090211.844700,1174753267.519700,804974053.967000,2214817533.331400,1222,2578,821,4621
2015-03-30,NYSE (N),676413985,0,0,676413985,26023411178.326409,0.000000,0.000000,26023411178.326409,2223470,0,0,2223470
2015-03-30,NYSE Arca (P),253026102,255482826,203826915,712335843,10070064682.651804,14199573079.119068,9210258528.231281,33479896290.002153,1765124,636446,1369929,3771499
2015-03-30,NASDAQ (Q),386899600,120564769,440242831,947707200,16840940882.455103,7494482991.807296,19200937731.647690,43536361605.910089,3150862,470635,2562952,6184449
2015-03-30,NASDAQ PSX (X),32046369,14317139,18578908,64942416,1153648534.485598,724500903.807300,685486294.057700,2563635732.350598,251867,59802,124109,435778
2015-03-30,BATS BYX (Y),109686159,52218193,62735359,224639711,3551541837.772199,2313343039.808801,2276988628.762714,8141873506.343714,938344,218221,498086,1654651
2015-03-30,BATS BZX (Z),221457460,110284519,145462079,477204058,7954936107.672847,6586496860.823897,5761990518.873834,20303423487.370578,1730455,422432,1086163,3239050
2015-03-27,NYSE MKT (A),0,9059759,5504507,14564266,0.000000,63542638.843400,145397433.531900,208940072.375300,0,23252,25500,48752
2015-03-27,NASDAQ BX (B),51891240,24886189,32723009,109500438,1875111362.580907,1405449463.646799,1476627605.750899,4757188431.978605,437254,112078,258499,807831
2015-03-27,NYSE (DN),99852022,24463850,61318578,185634450,3604174796.147588,1209680709.610099,2534014236.780998,7347869742.538685,422811,69055,250006,741872
2015-03-27,NASDAQ (DQ),886979490,373635866,545177404,1805792760,29864842743.659556,18252559769.629616,21055302623.111252,69172705136.400424,2991555,626752,1731555,5349862
2015-03-27,EDGA (J),75814050,37255372,43508558,156577980,2413946531.733605,1723204276.306902,1535092532.638801,5672243340.679308,606517,154164,330795,1091476
2015-03-27,EDGX (K),146473817,95651685,130156512,372282014,5155753105.649110,4914395536.943699,5241353107.577835,15311501750.170644,900168,245401,730698,1876267
2015-03-27,CHX (M),7378651,7199925,3528214,18106790,321207512.302200,951260119.465000,229864442.204000,1502332073.971200,2270,2992,831,6093
2015-03-27,NYSE (N),742080060,0,0,742080060,27650950582.497814,0.000000,0.000000,27650950582.497814,2234304,0,0,2234304
2015-03-27,NYSE Arca (P),247633951,230734877,183493493,661862321,9501673112.035193,13634858851.651843,8231964548.209538,31368496511.896574,1718191,595129,1221796,3535116
2015-03-27,NASDAQ (Q),377976463,117316485,449529489,944822437,16194514526.049276,7810254188.788672,19769493417.335739,43774262132.173687,3044147,458717,2519037,6021901
2015-03-27,NASDAQ PSX (X),30284333,13331884,18520117,62136334,1094620730.356100,688750176.208400,693426465.847300,2476797372.411800,225581,53575,120164,399320
2015-03-27,BATS BYX (Y),118123305,54426213,65848476,238397994,3635642087.276303,2444762942.220598,2375107014.378716,8455512043.875617,954627,219327,508061,1682015
2015-03-27,BATS BZX (Z),228755624,105605464,143272400,477633488,8209832603.111944,6466828602.072100,5780157878.322739,20456819083.506783,1774533,415242,1084000,3273775
2015-03-26,NYSE MKT (A),0,11340994,7221152,18562146,0.000000,231007479.545600,212361982.023600,443369461.569200,0,24792,31601,56393
2015-03-26,NASDAQ BX (B),67313668,34987443,39458849,141759960,2607184974.665098,1807135890.274802,1849339159.946092,6263660024.885992,609507,147415,343986,1100908
2015-03-26,NYSE (DN),113294092,35556719,75328313,224179124,4467420341.134367,1757806237.099699,3535012796.412428,9760239374.646494,470784,97551,300294,868629
2015-03-26,NASDAQ (DQ),999732940,529137600,660968150,2189838690,33933569251.873159,24372108306.626107,25895725703.239494,84201403261.738760,3363586,827777,2079258,6270621
2015-03-26,EDGA (J),91035141,52623554,54187478,197846173,3103502435.465703,2442452079.422500,2043034244.553291,7588988759.441494,750749,229766,436609,1417124
2015-03-26,EDGX (K),171576501,124694292,152389096,448659889,6180983725.419999,6275280546.077002,6291828566.351687,18748092837.848688,1072500,333114,895588,2301202
2015-03-26,CHX (M),10987015,12083014,4354886,27424915,417915357.485500,1358688680.755000,240235750.257400,2016839788.497900,777,4046,1073,5896
2015-03-26,NYSE (N),828596564,0,0,828596564,31940404667.214272,0.000000,0.000000,31940404667.214272,2547651,0,0,2547651
2015-03-26,NYSE Arca (P),316962132,319449124,219702076,856113332,12153350788.426439,18444338613.784933,10003759781.363121,40601449183.574493,2091402,839384,1479559,4410345
2015-03-26,NASDAQ (Q),472041436,161163223,523206443,1156411102,20282110757.868301,10524744259.187555,23662951955.322312,54469806972.378168,3779790,634700,3033818,7448308
2015-03-26,NASDAQ PSX (X),35734053,18536289,23907761,78178103,1284431313.378599,931396132.697900,907288959.886301,3123116405.962800,259144,70741,147635,477520
2015-03-26,BATS BYX (Y),133076259,68170863,73667243,274914365,4146216796.476634,3152558827.730999,2633538020.441601,9932313644.649234,1097320,276169,578781,1952270
2015-03-26,BATS BZX (Z),274538999,145227412,173903734,593670145,9938629032.244829,8940868319.780220,7176602803.032177,26056100155.057226,2138332,554083,1301560,3993975
2015-03-25,NYSE MKT (A),0,10337940,6842055,17179995,0.000000,91252985.585300,221205252.350799,312458237.936099,0,24370,28739,53109
2015-03-25,NASDAQ BX (B),66285520,33390514,44155009,143831043,2485152414.140798,1916028280.722702,2033061808.207896,6434242503.071396,550300,143334,348470,1042104
2015-03-25,NYSE (DN),122412201,32154807,87954475,242521483,4724660851.668579,1804082125.100496,4126831356.511727,10655574333.280802,511405,93094,345919,950418
2015-03-25,NASDAQ (DQ),1041496347,443322081,750363937,2235182365,36646978195.591789,23956068107.897117,29140076687.410967,89743122990.899873,3483970,803081,2276916,6563967
2015-03-25,EDGA (J),91244697,45252897,61812390,198309984,3063464334.621690,2270830696.049200,2417137134.527405,7751432165.198295,742239,203036,480081,1425356
2015-03-25,EDGX (K),188690770,123514384,187685772,499890926,6546992473.704123,6852768357.627388,7528322833.808223,20928083665.139734,1119467,338897,1028235,2486599
2015-03-25,CHX (M),11648800,19577661,5342980,36569441,535213436.499000,1932845095.457801,377673401.140000,2845731933.096801,472,4853,858,6183
2015-03-25,NYSE (N),791127130,0,0,791127130,30109951281.610143,0.000000,0.000000,30109951281.610143,2488606,0,0,2488606
2015-03-25,NYSE Arca (P),298756461,290092453,236189404,825038318,12293938549.186854,18625243704.353866,11289844282.128277,42209026535.668997,2120486,759657,1548675,4428818
2015-03-25,NASDAQ (Q),464956177,145601816,547745559,1158303552,20586201310.200604,10453084969.278518,25640654096.868071,56679940376.347193,3755349,577555,3206140,7539044
2015-03-25,NASDAQ PSX (X),31529966,14695985,22267683,68493634,1131639524.386003,785669876.572999,872160746.591101,2789470147.550103,235197,55624,142600,433421
2015-03-25,BATS BYX (Y),142846746,66706431,86019423,295572600,4439964361.687319,3272149757.830298,3094474136.196010,10806588255.713627,1133824,275477,646752,2056053
2015-03-25,BATS BZX (Z),272883953,135631467,186539920,595055340,10283972332.839286,8962344112.777725,7830373925.455485,27076690371.072496,2130334,537200,1389661,4057195
2015-03-24,NYSE MKT (A),0,8889106,6345339,15234445,0.000000,100763432.392200,158603442.367700,259366874.759900,0,21375,23860,45235
2015-03-24,NASDAQ BX (B),57348765,23450396,31324682,112123843,2153797433.439398,1279226693.693798,1388088749.294799,4821112876.427995,482989,104928,270152,858069
2015-03-24,NYSE (DN),98467546,24125122,58762583,181355251,3855859175.608112,1178030654.001101,2418892583.493104,7452782413.102317,423658,70779,229832,724269
2015-03-24,NASDAQ (DQ),974529380,381434221,566338156,1922301757,33172527739.985195,18887853068.283803,20405400227.808012,72465781036.077010,3263776,669856,1762898,5696530
2015-03-24,EDGA (J),79018626,37446688,40918223,157383537,2636437449.521395,1653079109.485896,1516370233.614408,5805886792.621699,649388,153001,327257,1129646
2015-03-24,EDGX (K),165479618,80266625,135183243,380929486,5963706164.062296,3220697526.910809,5204616559.788721,14389020250.761826,990875,231001,736598,1958474
2015-03-24,CHX (M),18718244,11901361,8204310,38823915,750026079.907000,1287951831.792200,842411226.644000,2880389138.343200,756,2584,528,3868
2015-03-24,NYSE (N),749720555,0,0,749720555,29446264955.968159,0.000000,0.000000,29446264955.968159,2166059,0,0,2166059
2015-03-24,NYSE Arca (P),274566640,213770321,161724562,650061523,10681049985.330188,11952385841.949817,7168080468.587275,29801516295.867280,1822601,544831,1111778,3479210
2015-03-24,NASDAQ (Q),399643409,110702666,403630008,913976083,17188041542.253295,7073283057.843701,17979110446.115536,42240435046.212532,3150756,433589,2278680,5863025
2015-03-24,NASDAQ PSX (X),32212637,13091767,16663090,61967494,1136138701.455900,651247375.520600,629703694.199599,2417089771.176099,244753,49503,116681,410937
2015-03-24,BATS BYX (Y),120873928,45095195,64208672,230177795,3842302091.264001,2147058506.895498,2197182382.925183,8186542981.084682,1007726,198754,507542,1714022
2015-03-24,BATS BZX (Z),228984450,98698885,123889004,451572339,8470180810.935662,5935324796.732298,4969486937.303265,19374992544.971225,1794275,385155,945358,3124788
2015-03-23,NYSE MKT (A),0,10125036,4846477,14971513,0.000000,91104267.221900,125404989.339800,216509256.561700,0,24096,23285,47381
2015-03-23,NASDAQ BX (B),63585103,22373495,31543948,117502546,2552561370.186292,1178317982.809001,1445140668.107703,5176020021.102996,592827,106537,283709,983073
2015-03-23,NYSE (DN),103705752,18621039,54035977,176362768,3997733000.609528,913227837.051702,2237645307.071831,7148606144.733061,435958,66389,225954,728301
2015-03-23,NASDAQ (DQ),1059876402,411214599,574673364,2045764365,35817131355.480307,16278784024.297170,21455085881.320893,73551001261.098370,3504620,721474,1853424,6079518
2015-03-23,EDGA (J),79607663,33602921,39809970,153020554,2760133578.052892,1440992732.489298,1405926163.704695,5607052474.246885,668524,148297,317080,1133901
2015-03-23,EDGX (K),175994620,81800834,136674330,394469784,6083864310.100105,3071276380.701596,5149160137.233326,14304300828.035027,1036117,239450,747177,2022744
2015-03-23,CHX (M),9181338,9255557,8422991,26859886,502217009.353000,1053248232.803000,611111190.354400,2166576432.510400,615,1359,541,2515
2015-03-23,NYSE (N),733819781,0,0,733819781,28936518221.862514,0.000000,0.000000,28936518221.862514,2168240,0,0,2168240
2015-03-23,NYSE Arca (P),258987527,210716463,153908417,623612407,10202274854.765982,11711369693.254724,6831433706.915036,28745078254.935742,1778078,539986,1091727,3409791
2015-03-23,NASDAQ (Q),408142548,105755128,413423328,927321004,17670296095.088072,5987176881.371395,18307115595.596070,41964588572.055537,3263964,426657,2343921,6034542
2015-03-23,NASDAQ PSX (X),32396069,11260369,16232755,59889193,1194035142.445498,520461674.977600,628320055.566999,2342816872.990097,250987,44047,114533,409567
2015-03-23,BATS BYX (Y),125517912,45523786,61960483,233002181,4077516056.078795,1984077454.488497,2237577930.858994,8299171441.426286,1047463,201869,509889,1759221
2015-03-23,BATS BZX (Z),226382535,92379435,117791405,436553375,8237659899.726292,5139498501.824702,4605801215.824806,17982959617.375800,1751497,360093,901685,3013275
2015-03-20,NYSE MKT (A),0,51368833,6788317,58157150,0.000000,252183872.746900,206598940.999000,458782813.745900,0,29375,30399,59774
2015-03-20,NASDAQ BX (B),73826120,34983236,37622602,146431958,2801801396.091198,1940600902.467200,1841129555.862794,6583531854.421192,578262,152532,297623,1028417
2015-03-20,NYSE (DN),138511458,33019970,72078356,243609784,4996008216.750732,1643620711.898099,3246062004.624319,9885690933.273150,540397,94491,282680,917568
2015-03-20,NASDAQ (DQ),1484609755,544530547,905510504,2934650806,50079679272.002805,30691476698.490988,38458003385.504281,119229159355.998074,3721527,867904,1976512,6565943
2015-03-20,EDGA (J),98790682,50998686,51153301,200942669,3200378049.643986,2505953928.359703,1890714256.893797,7597046234.897486,772020,213681,377197,1362898
2015-03-20,EDGX (K),199106454,114717325,159837710,473661489,6947010580.469846,5278158037.416023,6463968076.824303,18689136694.710172,1141941,328764,860393,2331098
2015-03-20,CHX (M),12238275,19832788,5972732,38043795,611674226.660000,2353436814.820000,291676452.442000,3256787493.922000,681,4373,784,5838
2015-03-20,NYSE (N),2254160744,0,0,2254160744,90496262478.060611,0.000000,0.000000,90496262478.060611,2560030,0,0,2560030
2015-03-20,NYSE Arca (P),308649302,318775737,190320431,817745470,12420090914.675498,19193332870.024833,9495724081.716106,41109147866.416437,2001277,734988,1271141,4007406
2015-03-20,NASDAQ (Q),500736516,154002537,1148781547,1803520600,21766235658.082661,10562498302.484779,52421194859.038048,84749928819.605488,3756159,570447,2809846,7136452
2015-03-20,NASDAQ PSX (X),43161695,16627138,21257144,81045977,1640220103.276003,836713098.131400,821463010.605400,3298396212.012803,329571,62479,145321,537371
2015-03-20,BATS BYX (Y),165780938,71078119,79753868,316612925,5486505851.875796,3468018587.402110,3086546191.064921,12041070630.342827,1267491,275882,614900,2158273
2015-03-20,BATS BZX (Z),287399603,137912640,151380430,576692673,10696550199.584522,8655588060.374197,6620974890.906186,25973113150.864905,2094184,511613,1109599,3715396
2015-03-19,NYSE MKT (A),0,8969555,6650551,15620106,0.000000,67477986.447100,204424409.153400,271902395.600500,0,24039,28187,52226
2015-03-19,NASDAQ BX (B),56859386,27003820,30259564,114122770,2161726961.995592,1420577141.953698,1406214690.055101,4988518794.004391,474674,117935,252736,845345
2015-03-19,NYSE (DN),117898586,28086866,63942463,209927915,4381212853.190697,1411044753.352497,2640744914.380027,8433002520.923221,450162,84958,253191,788311
2015-03-19,NASDAQ (DQ),1007835939,451483664,581092326,2040411929,32831556541.472384,22766151577.907745,22133176858.282866,77730884977.662995,3453579,786270,1850555,6090404
2015-03-19,EDGA (J),84120484,43742383,44169472,172032339,2802534858.132395,2123067892.234697,1684416689.153503,6610019439.520595,673280,186240,340848,1200368
2015-03-19,EDGX (K),176401027,95983380,145673939,418058346,6239323533.984393,4133850464.346904,5744804705.554892,16117978703.886189,1035782,304291,791734,2131807
2015-03-19,CHX (M),10240201,13842323,4452974,28535498,420309837.109200,1262460846.462000,270850255.250000,1953620938.821200,608,3517,894,5019
2015-03-19,NYSE (N),738620069,0,0,738620069,28385339755.400873,0.000000,0.000000,28385339755.400873,2163903,0,0,2163903
2015-03-19,NYSE Arca (P),271019482,267144317,169167141,707330940,10510989753.905809,16060652253.491929,7564386200.927181,34136028208.324919,1843531,669344,1148458,3661333
2015-03-19,NASDAQ (Q),431439745,139484739,414025939,984950423,18479122021.297006,9189839434.795506,18814839797.439477,46483801253.531989,3378096,527545,2340567,6246208
2015-03-19,NASDAQ PSX (X),37495663,16834836,18561555,72892054,1372780405.111901,851228768.937100,708693669.006801,2932702843.055802,281343,56803,128980,467126
2015-03-19,BATS BYX (Y),133476574,60680263,68151808,262308645,4387039167.134294,2819555906.602098,2458117316.465695,9664712390.202087,1100280,250412,535802,1886494
2015-03-19,BATS BZX (Z),248798864,127675402,133458756,509933022,8732551493.457951,7430405885.179383,5455254521.274701,21618211899.912035,1815465,471136,986114,3272715
2015-03-18,NYSE MKT (A),0,11457006,8201466,19658472,0.000000,76176261.868700,243993995.867100,320170257.735800,0,29324,35072,64396
2015-03-18,NASDAQ BX (B),74564635,43595959,36402348,154562942,2945737318.747103,2612713562.691494,1625900351.690694,7184351233.129291,637773,195167,307051,1139991
2015-03-18,NYSE (DN),140630774,44808219,73557098,258996091,5475673013.082104,2270226982.276810,3219472463.780419,10965372459.139333,567058,128511,286854,982423
2015-03-18,NASDAQ (DQ),1193932782,637138306,660792599,2491863687,41065046866.967928,33704918222.228720,24761017567.866161,99530982657.062809,4031618,1037724,2007464,7076806
2015-03-18,EDGA (J),117294104,73330553,53367917,243992574,4193913451.932498,3466284724.538497,1916271831.078309,9576470007.549304,941733,306749,418497,1666979
2015-03-18,EDGX (K),230611327,160819490,173449369,564880186,8123283217.085004,8738500711.698287,6729812241.059347,23591596169.842638,1354290,459917,971864,2786071
2015-03-18,CHX (M),22035219,20314012,6258238,48607469,802611233.176000,2865104755.850001,454188503.277000,4121904492.303001,459,11019,1566,13044
2015-03-18,NYSE (N),883280157,0,0,883280157,35065138394.899148,0.000000,0.000000,35065138394.899148,2807174,0,0,2807174
2015-03-18,NYSE Arca (P),362779015,426930342,203075256,992784613,14376436555.702807,25303170941.877168,9196081812.013938,48875689309.593913,2440718,1053344,1390136,4884198
2015-03-18,NASDAQ (Q),564885591,231675014,504181818,1300742423,24315753470.618065,15692099869.851884,23004137546.606169,63011990887.076118,4400540,859806,2874911,8135257
2015-03-18,NASDAQ PSX (X),46541370,24697928,23058950,94298248,1681217771.041802,1263292523.092100,907808351.115001,3852318645.248903,329814,86193,152002,568009
2015-03-18,BATS BYX (Y),158849642,86362800,78296962,323509404,5328207388.904324,4085527202.883797,2850702340.624879,12264436932.413000,1342226,352285,631673,2326184
2015-03-18,BATS BZX (Z),338886432,201413873,166565069,706865374,12292361688.848819,12827299808.883783,6984930905.074618,32104592402.807220,2489481,740374,1249064,4478919
2015-03-17,NYSE MKT (A),0,10535971,6888526,17424497,0.000000,62922833.468100,172036464.618000,234959298.086100,0,24551,25339,49890
2015-03-17,NASDAQ BX (B),56393394,27406596,32035505,115835495,2057718345.878104,1439218689.881403,1332967936.395203,4829904972.154710,473708,123526,264923,862157
2015-03-17,NYSE (DN),117404484,31660329,67122543,216187356,4292892835.595901,1512161051.872503,2739664503.319001,8544718390.787405,480975,96884,260460,838319
2015-03-17,NASDAQ (DQ),969731889,436520464,594812336,2001064689,32487797188.236271,18279549701.466416,22072422141.125626,72839769030.828313,3408657,806910,1819816,6035383
2015-03-17,EDGA (J),80943304,40784964,46323768,168052036,2636036207.567002,1788138304.508201,1600713142.351296,6024887654.426499,665302,172791,351043,1189136
2015-03-17,EDGX (K),165912345,88521493,142150400,396584238,6125464243.204397,3485181152.734294,5351799710.854757,14962445106.793448,1063079,263827,783823,2110729
2015-03-17,CHX (M),16930019,19621230,4307620,40858869,829832978.209100,1604467595.435000,532709630.380800,2967010204.024900,526,4194,735,5455
2015-03-17,NYSE (N),716104479,0,0,716104479,27327371521.773922,0.000000,0.000000,27327371521.773922,2199666,0,0,2199666
2015-03-17,NYSE Arca (P),264078665,248122922,171347284,683548871,10422824615.867651,13942758395.600017,7591580096.043586,31957163107.511254,1822210,658331,1166600,3647141
2015-03-17,NASDAQ (Q),426020844,125914624,439931855,991867323,18064129104.666776,8258118484.955479,18995852040.753031,45318099630.375286,3347773,475441,2368155,6191369
2015-03-17,NASDAQ PSX (X),34888044,13736039,18653897,67277980,1244432584.069299,714986181.132900,748441129.101198,2707859894.303397,262114,56512,125875,444501
2015-03-17,BATS BYX (Y),132919357,58806362,70749602,262475321,4159938413.061183,2521257464.191106,2364045381.204024,9045241258.456313,1094202,250547,552600,1897349
2015-03-17,BATS BZX (Z),241910412,108322507,132625991,482858910,8366820123.368216,6643865254.390192,5265846132.508318,20276531510.266726,1802211,421364,997565,3221140
2015-03-16,NYSE MKT (A),0,9922543,6424546,16347089,0.000000,65173427.947200,136982997.860800,202156425.808000,0,26727,24137,50864
2015-03-16,NASDAQ BX (B),58225481,26632170,32116206,116973857,2296152827.260700,1466365408.901299,1428073580.857607,5190591817.019606,488546,121140,260537,870223
2015-03-16,NYSE (DN),121249646,30579052,64509215,216337913,4669168916.474251,1376079572.704305,2519830445.536905,8565078934.715461,490827,88959,262770,842556
2015-03-16,NASDAQ (DQ),999060365,472760779,588721724,2060542868,34461676997.573619,22371489902.056868,20561624101.762257,77394791001.392744,3611596,824242,1921696,6357534
2015-03-16,EDGA (J),82672653,43050404,44535336,170258393,2927334350.354403,1863276286.140597,1540951866.943211,6331562503.438211,687192,178758,341411,1207361
2015-03-16,EDGX (K),166932123,98607424,146708775,412248322,6190558715.932225,3872741204.878796,5447747307.112339,15511047227.923360,1058672,288736,783141,2130549
2015-03-16,CHX (M),8605901,12337671,5125849,26069421,348587975.007200,1604792481.787999,593741458.221000,2547121915.016199,432,5166,731,6329
2015-03-16,NYSE (N),755801131,0,0,755801131,31349077199.071521,0.000000,0.000000,31349077199.071521,2263859,0,0,2263859
2015-03-16,NYSE Arca (P),265317121,267231484,170974789,703523394,10824527095.802935,16242326377.257925,7730036742.439315,34796890215.500175,1853283,683423,1171478,3708184
2015-03-16,NASDAQ (Q),425514813,132125798,438310171,995950782,19309986158.960348,9310281745.960687,19246477496.540838,47866745401.461873,3385851,479920,2416915,6282686
2015-03-16,NASDAQ PSX (X),36622216,13889038,17029364,67540618,1376060165.882499,736727743.503500,702749006.780901,2815536916.166900,284467,56612,120828,461907
2015-03-16,BATS BYX (Y),138139848,56877824,69920000,264937672,4661790077.662521,2589052787.378298,2405727887.200600,9656570752.241419,1154995,241763,558261,1955019
2015-03-16,BATS BZX (Z),239020473,112432378,131652204,483105055,8768052803.708918,6901575775.315298,5168891645.214196,20838520224.238412,1829596,430525,988117,3248238
2015-03-13,NYSE MKT (A),0,11001358,9298115,20299473,0.000000,66301221.023400,182211699.956700,248512920.980100,0,26676,26114,52790
2015-03-13,NASDAQ BX (B),60187278,32600380,33538746,126326404,2234910169.470905,1775868073.990598,1435174043.128993,5445952286.590496,491366,141451,261796,894613
2015-03-13,NYSE (DN),130835974,35187753,74244927,240268654,4781621063.222988,1659326680.989898,2713160264.772707,9154108008.985593,505729,100064,259194,864987
2015-03-13,NASDAQ (DQ),1048328382,515683240,612292007,2176303629,34844273507.715142,25212693638.847974,20530884868.651264,80587852015.214380,3525284,855031,1806018,6186333
2015-03-13,EDGA (J),87852049,47425618,51448655,186726322,2882022930.895898,2066118789.578800,1667157614.033096,6615299334.507794,699807,202782,367555,1270144
2015-03-13,EDGX (K),189770097,109194744,156584788,455549629,6657108235.183752,4519358595.843815,5647361339.444656,16823828170.472223,1134816,328701,828498,2292015
2015-03-13,CHX (M),8305908,14519466,11427688,34253062,295501209.778600,1958999595.637000,900293990.012400,3154794795.428000,776,7529,1439,9744
2015-03-13,NYSE (N),806115463,0,0,806115463,30062361029.090820,0.000000,0.000000,30062361029.090820,2392747,0,0,2392747
2015-03-13,NYSE Arca (P),299027008,296370359,191670365,787067732,11469310736.495951,17126901701.838113,8380418570.965009,36976631009.299073,2021856,788072,1264633,4074561
2015-03-13,NASDAQ (Q),444002606,157750845,464602970,1066356421,18719147371.456256,10633171304.096719,19726805525.500853,49079124201.053828,3434778,604390,2541464,6580632
2015-03-13,NASDAQ PSX (X),35396861,16725272,20497888,72620021,1267251366.114700,984472759.280300,746429020.635799,2998153146.030799,260528,64232,126688,451448
2015-03-13,BATS BYX (Y),133768716,66888372,74665343,275322431,4214356404.651499,3060454488.711200,2483933700.215874,9758744593.578573,1085642,283155,558547,1927344
2015-03-13,BATS BZX (Z),259748445,130320876,154011671,544080992,9183438165.291817,8141035834.449512,6084275981.916134,23408749981.657463,1946690,518699,1099990,3565379
2015-03-12,NYSE MKT (A),0,12282461,6226930,18509391,0.000000,62069414.376000,153884471.069000,215953885.445000,0,27615,23153,50768
2015-03-12,NASDAQ BX (B),57065309,27564420,32456831,117086560,2187468779.420003,1408871458.693194,1390296332.521904,4986636570.635101,460912,112539,255164,828615
2015-03-12,NYSE (DN),130002120,32529693,79914171,242445984,4876827953.346088,1535394362.187003,2935694646.908416,9347916962.441507,492133,94611,280429,867173
2015-03-12,NASDAQ (DQ),1063700179,463868987,633913811,2161482977,37022973171.428638,20616152706.012882,21479560525.869575,79118686403.311095,3527976,778755,1929283,6236014
2015-03-12,EDGA (J),86555756,42239774,48112336,176907866,3005715771.161894,1822402694.380702,1644626174.778105,6472744640.320701,701165,169734,359800,1230699
2015-03-12,EDGX (K),178994795,99477252,152103504,430575551,6591373202.229478,3815869558.071705,5475103256.863687,15882346017.164870,1090107,279798,809469,2179374
2015-03-12,CHX (M),11345446,10960066,7682071,29987583,693072602.954400,1390188442.873600,785188193.549500,2868449239.377500,555,3866,1036,5457
2015-03-12,NYSE (N),747839293,0,0,747839293,28625152332.647464,0.000000,0.000000,28625152332.647464,2250057,0,0,2250057
2015-03-12,NYSE Arca (P),286767944,265474033,187233750,739475727,11311039368.520081,15199160519.487608,8073298474.930291,34583498362.937980,1888136,656789,1235630,3780555
2015-03-12,NASDAQ (Q),440897743,136736199,472149178,1049783120,18811655663.542392,8644173305.647642,19369169097.604719,46824998066.794753,3362326,499099,2570590,6432015
2015-03-12,NASDAQ PSX (X),33356370,14563571,19843745,67763686,1205371253.320397,772408055.549700,708342791.226799,2686122100.096896,238486,57762,118695,414943
2015-03-12,BATS BYX (Y),134432442,57449325,73807121,265688888,4258565973.580352,2535080247.002307,2421546136.593484,9215192357.176143,1062244,233128,557192,1852564
2015-03-12,BATS BZX (Z),252824040,113314213,146724361,512862614,8905842971.851040,6741622063.616512,5620812303.425471,21268277338.893023,1840102,428056,1056358,3324516
2015-03-11,NYSE MKT (A),0,12079443,6404385,18483828,0.000000,79188565.730000,164003613.878000,243192179.608000,0,28257,22087,50344
2015-03-11,NASDAQ BX (B),59406426,31067249,32138495,122612170,2315387190.327789,1461080709.667602,1453108883.375695,5229576783.371086,500587,128201,269094,897882
2015-03-11,NYSE (DN),115379894,32317549,68736638,216434081,4510498558.882001,1527673838.246900,3105031551.730918,9143203948.859819,490895,95379,270734,857008
2015-03-11,NASDAQ (DQ),1015923734,491849404,643097762,2150870900,35274864492.254845,18484692673.981252,25099547467.865503,78859104634.101600,3550649,797965,1870423,6219037
2015-03-11,EDGA (J),87359375,43341763,49618674,180319812,3012695144.639395,1795937090.321195,1720198894.799304,6528831129.759894,726684,187449,373174,1287307
2015-03-11,EDGX (K),179507268,106329333,155369464,441206065,6503640213.356372,3757770353.844697,6101362519.727274,16362773086.928343,1104759,296306,872680,2273745
2015-03-11,CHX (M),15125168,13332884,3297599,31755651,591392279.265000,1088268350.960000,336899110.830000,2016559741.055000,533,3063,817,4413
2015-03-11,NYSE (N),785389792,0,0,785389792,30115439559.637008,0.000000,0.000000,30115439559.637008,2366543,0,0,2366543
2015-03-11,NYSE Arca (P),290390586,281005985,183819129,755215700,11722712379.261760,15627693444.947072,8420311077.979134,35770716902.187966,2009381,728863,1243203,3981447
2015-03-11,NASDAQ (Q),455686150,147678462,476297618,1079662230,19551835588.197589,9576860264.596946,21011936709.564327,50140632562.358862,3557119,543978,2527616,6628713
2015-03-11,NASDAQ PSX (X),34192290,14740265,17929505,66862060,1227059573.830602,769412139.061500,675486324.042000,2671958036.934102,252485,59162,118480,430127
2015-03-11,BATS BYX (Y),128654844,66715634,71687145,267057623,4135143976.882203,2637975589.261199,2526985098.052199,9300104664.195601,1063922,264253,555667,1883842
2015-03-11,BATS BZX (Z),247376116,121925244,144242808,513544168,8980338939.294024,7082160273.007193,6076393601.758843,22138892814.060060,1894124,474634,1072578,3441336
2015-03-10,NYSE MKT (A),0,11678922,5344116,17023038,0.000000,73684414.953100,132879027.503000,206563442.456100,0,26679,21094,47773
2015-03-10,NASDAQ BX (B),74634606,38951728,39049562,152635896,2797577829.565899,2028516956.794999,1682810031.636397,6508904817.997295,639214,165147,328659,1133020
2015-03-10,NYSE (DN),133255961,36988158,70752158,240996277,4996320504.128994,1834260491.904991,2954007893.389800,9784588889.423785,526708,107190,268813,902711
2015-03-10,NASDAQ (DQ),1080793348,540701565,626327177,2247822090,36652362168.216133,27619691970.143928,23004856106.072317,87276910244.432378,3786351,959194,1962311,6707856
2015-03-10,EDGA (J),97767406,51270775,53442229,202480410,3332539042.072101,2348427107.102010,1938596721.757795,7619562870.931906,796759,222386,416115,1435260
2015-03-10,EDGX (K),189425433,122782782,157303389,469511604,6787506522.164501,5062947663.538495,6304094833.274190,18154549018.977186,1192926,369508,907242,2469676
2015-03-10,CHX (M),8645003,18627875,6094546,33367424,321298031.821000,1990716249.720701,464775772.284600,2776790053.826301,555,6478,1213,8246
2015-03-10,NYSE (N),852298493,0,0,852298493,32825831252.686651,0.000000,0.000000,32825831252.686651,2577328,0,0,2577328
2015-03-10,NYSE Arca (P),309320677,342521556,195699390,847541623,11684716287.795241,19469465085.702111,8648609738.253808,39802791111.751160,2106165,868771,1332960,4307896
2015-03-10,NASDAQ (Q),487671766,168163688,485168051,1141003505,20850963245.660302,11343183929.823567,21046104683.815048,53240251859.298917,3802093,624933,2663721,7090747
2015-03-10,NASDAQ PSX (X),35272135,16799008,18551667,70622810,1237118051.193601,959644447.739000,745792211.415301,2942554710.347902,247985,66168,119050,433203
2015-03-10,BATS BYX (Y),135354022,70068722,69244310,274667054,4073005166.549102,3334262010.137805,2394677884.287114,9801945060.974021,1081013,288354,539641,1909008
2015-03-10,BATS BZX (Z),267422793,143278128,153212535,563913456,9646099800.897634,8987728377.838495,6442241220.093159,25076069398.829288,2029511,545693,1132791,3707995
2015-03-09,NYSE MKT (A),0,12836453,4336733,17173186,0.000000,110931964.439700,84365343.195000,195297307.634700,0,26657,16173,42830
2015-03-09,NASDAQ BX (B),67128653,27871378,32153923,127153954,2470122610.529009,1358408621.766801,1425159520.032602,5253690752.328412,552210,129481,262093,943784
2015-03-09,NYSE (DN),120052367,29213190,66310838,215576395,4426519673.306329,1255232788.647898,2706360360.990987,8388112822.945214,480577,89614,244644,814835
2015-03-09,NASDAQ (DQ),1024555868,407061906,583707438,2015325212,34477394686.115733,16780222428.391207,21205189747.176388,72462806861.683328,3582842,772083,1823954,6178879
2015-03-09,EDGA (J),91160019,38340925,45305155,174806099,3140131469.773710,1621542304.445100,1569075601.317493,6330749375.536303,752935,182247,354948,1290130
2015-03-09,EDGX (K),179074144,92402393,153275879,424752416,6343066565.294772,3405138392.283892,5702633724.770411,15450838682.349075,1075560,268689,794781,2139030
2015-03-09,CHX (M),9069344,9096950,3779253,21945547,485484265.174000,964802348.454001,243311485.965200,1693598099.593201,756,2882,855,4493
2015-03-09,NYSE (N),742621707,0,0,742621707,27507770007.045405,0.000000,0.000000,27507770007.045405,2298969,0,0,2298969
2015-03-09,NYSE Arca (P),282084424,248911053,175305574,706301051,10571186195.342408,14425816925.323775,7652925426.376286,32649928547.042469,1897647,653158,1167055,3717860
2015-03-09,NASDAQ (Q),438012171,123445289,422526514,983983974,18444659726.763887,7886214356.878331,18003016922.906729,44333891006.548947,3372777,466975,2371456,6211208
2015-03-09,NASDAQ PSX (X),34232677,12440931,16824668,63498276,1190695291.233402,601744205.402000,664924987.303801,2457364483.939203,247901,50785,109544,408230
2015-03-09,BATS BYX (Y),119489023,46590502,59915857,225995382,3634947481.555327,2051196916.041201,2036707296.003005,7722851693.599533,947664,212094,463257,1623015
2015-03-09,BATS BZX (Z),245764135,103728593,136830482,486323210,8865132570.419982,6125229768.944898,5904221335.084044,20894583674.448924,1866151,419687,1016837,3302675
2015-03-06,NYSE MKT (A),0,13444577,4875632,18320209,0.000000,73005350.608100,108962028.462100,181967379.070200,0,28466,17177,45643
2015-03-06,NASDAQ BX (B),77461542,44375104,38380384,160217030,3076782428.433296,2299926656.346405,1581488300.010895,6958197384.790596,650156,183864,301801,1135821
2015-03-06,NYSE (DN),130467740,45778517,74088875,250335132,5114321527.957689,2417799450.032890,3005979276.171085,10538100254.161664,506317,126114,265704,898135
2015-03-06,NASDAQ (DQ),1116731527,591028581,656052089,2363812197,38660200484.436653,32989802539.884095,22932473036.582815,94582476060.903563,3864666,1027012,1971868,6863546
2015-03-06,EDGA (J),94630562,55014371,50323464,199968397,3107923398.766206,2396181661.703497,1648560588.624000,7152665649.093703,740608,238031,370876,1349515
2015-03-06,EDGX (K),202138852,135950383,166427309,504516544,7247940217.405437,5403539159.406710,6171278784.248564,18822758161.060711,1179438,379868,865898,2425204
2015-03-06,CHX (M),12452996,15533658,7877002,35863656,468450885.896000,2194758008.900001,353404256.743800,3016613151.539801,646,6773,893,8312
2015-03-06,NYSE (N),903172883,0,0,903172883,35058325376.081340,0.000000,0.000000,35058325376.081340,2711328,0,0,2711328
2015-03-06,NYSE Arca (P),337741952,367818898,197945944,903506794,13176305143.293683,20844262710.369723,8805059385.253735,42825627238.917141,2251547,915473,1320825,4487845
2015-03-06,NASDAQ (Q),532806192,194091452,487812840,1214710484,22944264077.823349,12939278640.491123,21104532724.734154,56988075443.048626,4055749,699609,2664837,7420195
2015-03-06,NASDAQ PSX (X),37542581,19797949,18140441,75480971,1356382791.295002,1007732149.222000,680521020.246301,3044635960.763303,269054,70010,115855,454919
2015-03-06,BATS BYX (Y),133824108,72640101,69613641,276077850,4157818611.777505,3352566937.196709,2361205214.207201,9871590763.181415,1059539,304409,530722,1894670
2015-03-06,BATS BZX (Z),283269736,160928993,150472045,594670774,10549782961.099891,10260783255.295785,6342454308.822389,27153020525.218065,2160923,613095,1101989,3876007
2015-03-05,NYSE MKT (A),0,10983088,4570076,15553164,0.000000,59919059.144600,121965655.313000,181884714.457600,0,24167,19647,43814
2015-03-05,NASDAQ BX (B),60504857,22031503,33905886,116442246,2385423043.788203,1207387957.028400,1604806823.659712,5197617824.476315,507013,97394,277151,881558
2015-03-05,NYSE (DN),112728033,23754498,67801120,204283651,4233868729.695516,1076020710.540501,2976950371.893018,8286839812.129035,442541,66789,256919,766249
2015-03-05,NASDAQ (DQ),974618154,396804536,613658196,1985080886,33685962988.343102,16538729319.727986,23284448789.415596,73509141097.486684,3438898,652475,1925913,6017286
2015-03-05,EDGA (J),76028828,31843285,44164333,152036446,2723226329.120003,1387875588.413898,1595012751.208608,5706114668.742509,634023,139766,341485,1115274
2015-03-05,EDGX (K),159876526,76865511,153406588,390148625,5799112925.784320,2768301662.588502,5909062547.976505,14476477136.349327,956836,208865,799597,1965298
2015-03-05,CHX (M),8770459,7833641,4837899,21441999,326228892.658800,663588152.875000,293996707.822400,1283813753.356200,540,2202,683,3425
2015-03-05,NYSE (N),686707288,0,0,686707288,26881231093.552428,0.000000,0.000000,26881231093.552428,2168701,0,0,2168701
2015-03-05,NYSE Arca (P),270248207,197868254,172183365,640299826,10503083168.940619,11762746443.630638,7982703296.616226,30248532909.187483,1806464,535638,1157043,3499145
2015-03-05,NASDAQ (Q),411494296,104248513,434487128,950229937,17748665977.430060,6636702073.343595,18682309339.181979,43067677389.955634,3193629,394739,2421476,6009844
2015-03-05,NASDAQ PSX (X),27823146,9896074,14161623,51880843,1036110422.383798,511936022.666100,567598330.282201,2115644775.332099,210541,38286,96829,345656
2015-03-05,BATS BYX (Y),110734667,43570931,59004182,213309780,3440659282.463301,1914272168.579401,2120925612.492825,7475857063.535527,893001,184671,460202,1537874
2015-03-05,BATS BZX (Z),209321554,84599383,126149008,420069945,7676523468.733856,4997256031.804806,5155364889.504855,17829144390.043517,1607314,341468,947432,2896214
2015-03-04,NYSE MKT (A),0,11965505,4450640,16416145,0.000000,68579778.716700,97367090.329600,165946869.046300,0,25932,17287,43219
2015-03-04,NASDAQ BX (B),61792217,27346162,31460772,120599151,2433792875.860593,1485971416.533500,1363412903.205691,5283177195.599784,530732,125008,261118,916858
2015-03-04,NYSE (DN),122353896,30346594,70959137,223659627,4911959030.587190,1468916098.760697,2694870526.743609,9075745656.091496,470616,85986,260429,817031
2015-03-04,NASDAQ (DQ),1066761002,425514263,651866776,2144142041,38685573355.153304,21037577205.591596,20615350359.059765,80338500919.804665,3640602,756528,1943884,6341014
2015-03-04,EDGA (J),87006389,38514195,48071819,173592403,3147004001.159600,1718123076.978002,1613018191.014607,6478145269.152209,732515,180345,373221,1286081
2015-03-04,EDGX (K),175161213,96521518,158014915,429697646,6363552616.182513,3490534028.464093,5385486104.000913,15239572748.647519,1058622,257752,813779,2130153
2015-03-04,CHX (M),8066817,11856659,3416183,23339659,320681775.393100,1160462936.692500,232870801.864500,1714015513.950100,600,3738,832,5170
2015-03-04,NYSE (N),723961519,0,0,723961519,28051874009.161631,0.000000,0.000000,28051874009.161631,2353060,0,0,2353060
2015-03-04,NYSE Arca (P),295383102,251414649,185951725,732749476,11749636999.967977,14317870080.552931,7479747674.953980,33547254755.474888,2026525,675418,1231972,3933915
2015-03-04,NASDAQ (Q),486897108,137520800,452339297,1076757205,20987240782.239932,9053848753.242475,18180832905.964454,48221922441.446861,3762505,514132,2556908,6833545
2015-03-04,NASDAQ PSX (X),30884125,13050769,16533679,60468573,1117934964.295005,697455369.795400,594156558.033100,2409546892.123505,229431,50822,105541,385794
2015-03-04,BATS BYX (Y),128262542,54246558,66828701,249337801,4234638303.227795,2391082223.665589,2252688397.132187,8878408924.025571,1064687,233836,521429,1819952
2015-03-04,BATS BZX (Z),239559255,108811576,140436208,488807039,8723908725.789175,6482138688.186716,5193333927.725990,20399381341.701881,1823438,439107,1025187,3287732
2015-03-03,NYSE MKT (A),0,11391459,6357904,17749363,0.000000,150449497.084500,124528586.357600,274978083.442100,0,24701,20616,45317
2015-03-03,NASDAQ BX (B),55366646,26437090,31961728,113765464,2156340355.074201,1421142234.488901,1302326749.529702,4879809339.092804,462183,111595,258327,832105
2015-03-03,NYSE (DN),124839907,29711841,75741638,230293386,4938522906.020768,1483244278.481499,2796910869.724504,9218678054.226771,469240,83974,278609,831823
2015-03-03,NASDAQ (DQ),971854342,412071637,729704175,2113630154,35475910653.510026,21457262054.103725,22471899592.358934,79405072299.972685,3651203,751484,2058566,6461253
2015-03-03,EDGA (J),79415541,37210057,49957008,166582606,2716733705.188085,1667512559.725098,1590973283.370010,5975219548.283193,654307,166251,378379,1198937
2015-03-03,EDGX (K),171382388,84184283,172888124,428454795,6324263235.029903,3410606651.269797,5430227576.904820,15165097463.204520,1033297,245931,842202,2121430
2015-03-03,CHX (M),12787901,9755730,4624197,27167828,634205998.853000,1240033999.168400,271788433.018000,2146028431.039400,446,2489,626,3561
2015-03-03,NYSE (N),743939056,0,0,743939056,28898588623.228598,0.000000,0.000000,28898588623.228598,2279251,0,0,2279251
2015-03-03,NYSE Arca (P),281724419,237232061,204028283,722984763,11246241162.023452,15606026721.100162,7566913434.782181,34419181317.905795,1892254,633703,1279280,3805237
2015-03-03,NASDAQ (Q),441824635,125730483,502386429,1069941547,19726938384.082334,8665264748.087888,18887535164.273288,47279738296.443510,3468148,478711,2596715,6543574
2015-03-03,NASDAQ PSX (X),31298468,13822847,18956489,64077804,1135389376.245001,722382560.177600,591804056.547300,2449575992.969901,229983,51847,113243,395073
2015-03-03,BATS BYX (Y),122383585,50877646,71086778,244348009,4042150689.589883,2346883405.622500,2276718147.698406,8665752242.910789,1016955,222468,547143,1786566
2015-03-03,BATS BZX (Z),230550088,107383347,156338414,494271849,8628332539.091260,6435119860.860986,5511847044.929527,20575299444.881773,1771126,425432,1111703,3308261
2015-03-02,NYSE MKT (A),0,12649467,5619435,18268902,0.000000,71483403.983900,130172810.123100,201656214.107000,0,26316,20778,47094
2015-03-02,NASDAQ BX (B),54538615,27836662,30555237,112930514,2142422397.165300,1507796403.658602,1351985551.759400,5002204352.583302,462880,112551,246836,822267
2015-03-02,NYSE (DN),150938093,35666482,86162527,272767102,5840592320.972643,1718830872.002696,3506454375.644193,11065877568.619532,557428,107383,307757,972568
2015-03-02,NASDAQ (DQ),1050110814,512419564,688718598,2251248976,37883707910.970316,26055578488.282260,23539495174.144877,87478781573.397453,3867040,799926,2107000,6773966
2015-03-02,EDGA (J),80466060,36868902,48421988,165756950,2872264130.680205,1772436589.167903,1636928086.538703,6281628806.386811,682424,172247,359153,1213824
2015-03-02,EDGX (K),173212845,94297294,152111882,419622021,6254850321.858196,3915945611.631497,5414329336.375594,15585125269.865287,1063227,264862,814842,2142931
2015-03-02,CHX (M),6651167,9036543,7084052,22771762,319271529.335000,943912643.080000,247439716.868300,1510623889.283300,490,2790,705,3985
2015-03-02,NYSE (N),756737098,0,0,756737098,29879438192.442420,0.000000,0.000000,29879438192.442420,2357276,0,0,2357276
2015-03-02,NYSE Arca (P),288098650,251533692,192869022,732501364,11842680113.405217,15704082201.449642,8124382103.100967,35671144417.955826,2016250,649096,1253040,3918386
2015-03-02,NASDAQ (Q),452355111,126430124,488906762,1067691997,19888154184.472328,8430149745.446008,20371934508.829586,48690238438.747922,3559547,483592,2600902,6644041
2015-03-02,NASDAQ PSX (X),34333591,13925087,18445352,66704030,1299482479.653100,756731214.497300,708726860.433201,2764940554.583601,266993,54253,120367,441613
2015-03-02,BATS BYX (Y),123262110,53251912,70297204,246811226,4240823577.072726,2566593266.568700,2419969416.381972,9227386260.023398,1039629,228696,532319,1800644
2015-03-02,BATS BZX (Z),242530732,109281914,144836558,496649204,9260136345.981211,6518969929.655701,5670472963.496699,21449579239.133611,1922717,436281,1051371,3410369
2015-02-27,NYSE MKT (A),0,17624284,5583107,23207391,0.000000,100252721.061000,163958832.139200,264211553.200200,0,28346,22400,50746
2015-02-27,NASDAQ BX (B),56663152,24225840,30146210,111035202,2106815864.185498,1293234415.610998,1373416396.413104,4773466676.209600,467813,104470,251299,823582
2015-02-27,NYSE (DN),139985675,33318277,88722406,262026358,5346811240.351103,1505466225.392997,3531589128.909577,10383866594.653677,511833,85552,292830,890215
2015-02-27,NASDAQ (DQ),1125280343,391257799,704025602,2220563744,39087861461.447861,19979405810.647117,24624915875.624451,83692183147.719429,3521442,672369,1959988,6153799
2015-02-27,EDGA (J),81578650,36842054,47421664,165842368,2652166344.138607,1669161261.561101,1638394358.094400,5959721963.794108,650413,160975,356646,1168034
2015-02-27,EDGX (K),172809618,82737832,158744031,414291481,5669574279.051018,3198501252.678905,5161296064.254903,14029371595.984826,993049,237974,781825,2012848
2015-02-27,CHX (M),10028866,9692211,6807679,26528756,565037974.239800,814089056.110000,258303533.090000,1637430563.439800,626,2634,623,3883
2015-02-27,NYSE (N),864682054,0,0,864682054,34333995816.747585,0.000000,0.000000,34333995816.747585,2295422,0,0,2295422
2015-02-27,NYSE Arca (P),273343355,252938882,184671786,710954023,10506660419.940026,15663074635.732947,7915235864.944039,34084970920.617012,1887937,634303,1216979,3739219
2015-02-27,NASDAQ (Q),423762474,116525453,509012696,1049300623,17972077112.919547,7745696269.077400,21356734350.084935,47074507732.081882,3318979,459919,2479890,6258788
2015-02-27,NASDAQ PSX (X),30919877,12007285,15485232,58412394,1178320296.824999,651176466.706100,672156538.229198,2501653301.760297,241281,50501,112068,403850
2015-02-27,BATS BYX (Y),126471004,50758730,66141468,243371202,4162095220.588407,2394268025.112400,2389079728.323995,8945442974.024802,1045800,223273,534514,1803587
2015-02-27,BATS BZX (Z),246869739,104296935,143954140,495120814,8993677090.029807,6559228903.112604,5875587908.884393,21428493902.026804,1880300,408751,1066981,3356032
2015-02-26,NYSE MKT (A),0,16565141,5539523,22104664,0.000000,86401265.323400,197024586.023800,283425851.347200,0,27654,23560,51214
2015-02-26,NASDAQ BX (B),55765980,24270713,30213900,110250593,2250517322.343504,1168962512.057000,1390019226.447690,4809499060.848194,468741,103315,250163,822219
2015-02-26,NYSE (DN),138470273,37988602,92645207,269104082,5445457505.443303,1470367144.598299,4124750493.077035,11040575143.118637,521901,86612,303249,911762
2015-02-26,NASDAQ (DQ),1077171521,447767769,690450021,2215389311,39613755322.417322,16058383983.788379,24716657024.784771,80388796330.990472,3651685,711792,1994819,6358296
2015-02-26,EDGA (J),78757802,35540003,42178561,156476366,2689004749.226792,1472885308.095004,1402566990.787598,5564457048.109394,621283,153346,315249,1089878
2015-02-26,EDGX (K),187255268,96731384,168709369,452696021,6791964969.395576,3203985725.625602,5877810883.550207,15873761578.571385,1072742,242532,818104,2133378
2015-02-26,CHX (M),12524936,11573957,5108807,29207700,584394633.900000,827820199.050000,224477154.375600,1636691987.325600,473,2621,498,3592
2015-02-26,NYSE (N),719531429,0,0,719531429,28679930369.747172,0.000000,0.000000,28679930369.747172,2323055,0,0,2323055
2015-02-26,NYSE Arca (P),291950291,238822013,196332777,727105081,11882080151.412069,12304597160.053626,8745818465.061933,32932495776.527628,1953128,610246,1253772,3817146
2015-02-26,NASDAQ (Q),459175826,121003328,461290382,1041469536,20672410060.363378,7314147095.238708,19859334082.717525,47845891238.319611,3583565,465288,2575236,6624089
2015-02-26,NASDAQ PSX (X),32158283,13304913,16207206,61670402,1209679026.535000,683828835.950000,686481403.809899,2579989266.294899,236645,53202,111424,401271
2015-02-26,BATS BYX (Y),120507603,53275441,62225112,236008156,4112932370.700883,2106422898.989000,2192820394.045502,8412175663.735385,983428,221548,484928,1689904
2015-02-26,BATS BZX (Z),242716136,103656860,144053333,490426329,9343111807.091808,5919198673.182876,6125708352.488638,21388018832.763322,1879975,386820,1060305,3327100
2015-02-25,NYSE MKT (A),0,14766380,5721359,20487739,0.000000,118504164.137200,168253124.290000,286757288.427200,0,31221,23879,55100
2015-02-25,NASDAQ BX (B),57686232,25003359,31187587,113877178,2341052050.018508,1285068766.039799,1445107782.884603,5071228598.942910,525350,116197,278886,920433
2015-02-25,NYSE (DN),128497867,32231925,82329182,243058974,5359431615.886005,1425646173.318404,3499660749.074058,10284738538.278467,493695,87367,279983,861045
2015-02-25,NASDAQ (DQ),1008194902,451801074,660510321,2120506297,37570028601.890601,19366507702.506547,23994059338.947507,80930595643.344655,3543015,685351,1968289,6196655
2015-02-25,EDGA (J),75476642,34416138,42564736,152457516,2428490158.951602,1490460093.705299,1459063123.549400,5378013376.206301,605258,153676,322104,1081038
2015-02-25,EDGX (K),181180295,90351973,157741506,429273774,6523317479.222618,3050915095.012603,5825118270.135849,15399350844.371070,1067430,249699,828940,2146069
2015-02-25,CHX (M),14237081,8122756,3653014,26012851,722728512.652800,754594423.920000,195539459.620500,1672862396.193300,356,2045,485,2886
2015-02-25,NYSE (N),704778483,0,0,704778483,27222876152.323510,0.000000,0.000000,27222876152.323510,2340262,0,0,2340262
2015-02-25,NYSE Arca (P),284327359,243692009,190145085,718164453,12153598447.427903,13136120210.795006,8203542598.631894,33493261256.854803,1972753,647118,1234173,3854044
2015-02-25,NASDAQ (Q),456483880,117963395,448008625,1022455900,20311577336.183118,6858060859.260794,19791754082.943164,46961392278.387076,3563428,478086,2595542,6637056
2015-02-25,NASDAQ PSX (X),32828361,12757499,17537894,63123754,1176120877.505001,652730968.895000,733324073.772099,2562175920.172100,239015,52005,118625,409645
2015-02-25,BATS BYX (Y),120484030,51620218,63090579,235194827,4110054968.624023,2208331122.867900,2271754159.278591,8590140250.770514,1004005,225127,494528,1723660
2015-02-25,BATS BZX (Z),254989836,107625928,151272201,513887965,9693019427.368069,6016783520.702194,6438391694.732511,22148194642.802774,1961259,410970,1133764,3505993
2015-02-24,NYSE MKT (A),0,12939708,5601075,18540783,0.000000,81407528.135000,162415281.208300,243822809.343300,0,27320,19240,46560
2015-02-24,NASDAQ BX (B),51146652,25229351,29113533,105489536,2086337854.778005,1363044721.224202,1224997188.245096,4674379764.247303,437878,110050,240549,788477
2015-02-24,NYSE (DN),122267074,32207848,80139533,234614455,5447596978.206221,1490963959.518603,3212927892.620282,10151488830.345106,441844,84841,252438,779123
2015-02-24,NASDAQ (DQ),987249654,372097887,647808370,2007155911,37154360030.868959,15946556504.783972,22832897214.720884,75933813750.373815,3477784,727585,1943519,6148888
2015-02-24,EDGA (J),72778812,33500173,42287798,148566783,2455465522.682906,1575431732.928500,1357329031.530702,5388226287.142108,583211,137262,310710,1031183
2015-02-24,EDGX (K),170542952,84108853,153892586,408544391,6218153988.731612,3355747787.692896,5230129652.654815,14804031429.079323,1009980,243891,773895,2027766
2015-02-24,CHX (M),12718395,10252062,6576056,29546513,505387178.121000,1013569324.002200,459573127.312000,1978529629.435200,653,2809,605,4067
2015-02-24,NYSE (N),715759531,0,0,715759531,28798172602.526534,0.000000,0.000000,28798172602.526534,2306443,0,0,2306443
2015-02-24,NYSE Arca (P),268108397,239262883,193761204,701132484,11268726880.423631,13535573901.690373,8078525559.039296,32882826341.153300,1888334,661323,1232451,3782108
2015-02-24,NASDAQ (Q),424817353,118829041,453844443,997490837,18917940550.874107,7623058958.693074,18618469873.970244,45159469383.537425,3310555,480126,2470272,6260953
2015-02-24,NASDAQ PSX (X),31001201,12587838,16039220,59628259,1172407225.625002,664329410.139000,608528016.623200,2445264652.387202,236970,49442,109601,396013
2015-02-24,BATS BYX (Y),111588132,47698049,62595221,221881402,3853112493.782797,2160547359.305100,2097713920.578989,8111373773.666886,934564,206195,476341,1617100
2015-02-24,BATS BZX (Z),242665484,106621283,147577872,496864639,9503079536.383948,6559734965.399388,6146997724.898771,22209812226.682107,1928283,421474,1095198,3444955
2015-02-23,NYSE MKT (A),0,12967147,5374921,18342068,0.000000,90881612.409200,170604852.965800,261486465.375000,0,26268,21911,48179
2015-02-23,NASDAQ BX (B),48140989,22301459,27801711,98244159,1988699621.821094,1139511724.412202,1358243883.246902,4486455229.480198,418675,95344,243601,757620
2015-02-23,NYSE (DN),121385089,30993230,79391375,231769694,5461057055.665245,1281284805.806299,3566558713.724516,10308900575.196060,458245,80478,281750,820473
2015-02-23,NASDAQ (DQ),924286067,406561484,616397431,1947244982,34098663724.507449,17124172266.680648,24333809147.930750,75556645139.118847,3342208,692866,1943580,5978654
2015-02-23,EDGA (J),71374121,29866101,39735422,140975644,2498296471.325797,1296965856.775603,1592249725.370602,5387512053.472002,593952,132301,319413,1045666
2015-02-23,EDGX (K),159902390,87647908,141071643,388621941,5712663531.904110,2896815964.790108,5320394860.790972,13929874357.485190,941232,222348,735960,1899540
2015-02-23,CHX (M),8788040,8251001,4071921,21110962,467172680.224000,797013545.700000,312622275.295000,1576808501.219000,1891,2779,733,5403
2015-02-23,NYSE (N),735278156,0,0,735278156,29279888735.043072,0.000000,0.000000,29279888735.043072,2220468,0,0,2220468
2015-02-23,NYSE Arca (P),243604249,238942325,162330355,644876929,10181750252.225220,13466010811.232994,7512976547.880451,31160737611.338665,1720725,588264,1090206,3399195
2015-02-23,NASDAQ (Q),403805618,111832570,469279499,984917687,17933604895.434675,6741186817.908717,20670236191.414623,45345027904.758015,3173400,432453,2454801,6060654
2015-02-23,NASDAQ PSX (X),29766785,12228110,14863260,56858155,1159268490.979199,608013693.266000,669457457.417001,2436739641.662200,231019,49379,105272,385670
2015-02-23,BATS BYX (Y),105400112,43296761,59643858,208340731,3675167959.201607,1837261816.857699,2240495242.372094,7752925018.431400,887117,179704,469622,1536443
2015-02-23,BATS BZX (Z),230950813,94008463,137712425,462671701,9140974458.792924,5214404824.540207,6075461350.194127,20430840633.527258,1849434,366536,1055940,3271910
2015-02-20,NYSE MKT (A),0,15844535,5631820,21476355,0.000000,89674188.179800,161245021.923800,250919210.103600,0,32693,20076,52769
2015-02-20,NASDAQ BX (B),48319937,27681125,25353038,101354100,1955961364.357706,1726929181.741001,1166942270.458693,4849832816.557400,408126,123574,216044,747744
2015-02-20,NYSE (DN),122907190,35779688,76711511,235398389,4791671247.864447,1782740953.464000,3161016446.747309,9735428648.075756,471165,95469,253454,820088
2015-02-20,NASDAQ (DQ),951661751,422184716,600101543,1973948010,34173402572.763749,22440508346.303277,20959207255.435604,77573118174.502630,3364556,743220,1812646,5920422
2015-02-20,EDGA (J),73446506,38829953,39885300,152161759,2547663820.612001,1994164746.024395,1433404329.565804,5975232896.202200,594386,172555,313153,1080094
2015-02-20,EDGX (K),169901373,96716628,140237003,406855004,6155771318.528470,4138842446.587006,5019337228.082383,15313950993.197859,989257,278143,696330,1963730
2015-02-20,CHX (M),11010578,10904973,6512440,28427991,783092623.399500,1185091136.668000,552556665.370000,2520740425.437500,595,3463,741,4799
2015-02-20,NYSE (N),830633998,0,0,830633998,34676313846.232707,0.000000,0.000000,34676313846.232707,2341803,0,0,2341803
2015-02-20,NYSE Arca (P),268264740,273456914,177491250,719212904,11415741411.801988,18177995660.794069,7616961183.895911,37210698256.491968,1896180,750925,1131283,3778388
2015-02-20,NASDAQ (Q),427848685,149062017,480801304,1057712006,19127249520.361455,10852316289.595892,21073996676.270263,51053562486.227610,3345455,598095,2427774,6371324
2015-02-20,NASDAQ PSX (X),29213412,14585097,16292318,60090827,1127945296.515001,934135060.312300,588214802.658800,2650295159.486101,227025,57737,104492,389254
2015-02-20,BATS BYX (Y),108455870,50985554,56629491,216070915,3671344487.984995,2615712134.546299,1967679261.264011,8254735883.795305,878530,222083,434574,1535187
2015-02-20,BATS BZX (Z),254252333,120374598,141574006,516200937,10075445392.517486,8448993552.542301,5974135035.151087,24498573980.210874,1998991,480863,1064267,3544121
2015-02-19,NYSE MKT (A),0,13807232,5825905,19633137,0.000000,70778755.757800,165144614.738400,235923370.496200,0,31387,19617,51004
2015-02-19,NASDAQ BX (B),50407878,25886287,25946420,102240585,2092922680.645805,1317930573.082798,1219395496.727396,4630248750.455999,430268,115500,222427,768195
2015-02-19,NYSE (DN),126344720,36199502,71329899,233874121,4934252469.634454,1437849372.952502,3160197115.986972,9532298958.573928,459084,92598,238055,789737
2015-02-19,NASDAQ (DQ),1002881778,421309906,562104279,1986295963,36123678271.298369,16833668515.178297,20339353961.457840,73296700747.934506,3482823,704808,1771652,5959283
2015-02-19,EDGA (J),77222208,34524075,37914371,149660654,2738051990.908392,1468858858.368100,1474280814.758010,5681191664.034502,644914,152620,310921,1108455
2015-02-19,EDGX (K),167932784,84956538,129828390,382717712,6012902676.101808,3155077175.725008,4672169149.572886,13840149001.399702,1012943,244929,681955,1939827
2015-02-19,CHX (M),11790357,11019804,4435528,27245689,611119997.195000,921765982.635000,304763956.579600,1837649936.409600,405,2421,550,3376
2015-02-19,NYSE (N),693179478,0,0,693179478,26721728216.233911,0.000000,0.000000,26721728216.233911,2333223,0,0,2333223
2015-02-19,NYSE Arca (P),281797049,253435560,167189898,702422507,11607599422.690950,13814365921.112920,7247909129.820415,32669874473.624285,1959365,653575,1119753,3732693
2015-02-19,NASDAQ (Q),453697055,125397796,399531276,978626127,19450241756.163299,7729216919.159726,17386706687.394039,44566165362.717064,3520577,494439,2330631,6345647
2015-02-19,NASDAQ PSX (X),32207254,15896457,15500698,63604409,1190094858.449598,825652315.955600,616138046.129999,2631885220.535197,244820,73553,106900,425273
2015-02-19,BATS BYX (Y),107833606,46680233,52605992,207119831,3697184668.653819,2051871146.851702,1999910011.569718,7748965827.075239,886552,193818,418313,1498683
2015-02-19,BATS BZX (Z),244213867,106701441,128687908,479603216,9620228434.902618,6181959672.714293,5390593676.741002,21192781784.357913,1957537,416657,987592,3361786
2015-02-18,NYSE MKT (A),0,14387831,4824199,19212030,0.000000,65952462.092101,150130851.821000,216083313.913101,0,28617,19094,47711
2015-02-18,NASDAQ BX (B),52506993,25710595,26068438,104286026,2053654680.700500,1377259797.983998,1134652993.285405,4565567471.969903,476855,115365,237234,829454
2015-02-18,NYSE (DN),127307247,35515303,77697815,240520365,4876478461.610838,1526761712.887403,3040793146.933624,9444033321.431865,471639,93183,260032,824854
2015-02-18,NASDAQ (DQ),1034712437,397232681,601638645,2033583763,36213737122.477322,18390897016.509394,20431081174.046160,75035715313.032876,3542535,709325,1822584,6074444
2015-02-18,EDGA (J),82106354,33979353,39636332,155722039,2870310008.384588,1565479686.931698,1435204946.167097,5870994641.483383,695899,156838,332612,1185349
2015-02-18,EDGX (K),173545511,85813768,137507717,396866996,5844051244.628114,3352740618.244508,4662672486.105040,13859464348.977662,1040752,260103,721649,2022504
2015-02-18,CHX (M),7093979,7800646,4139493,19034118,302174863.548000,881436253.267600,262361586.197000,1445972703.012600,424,2982,570,3976
2015-02-18,NYSE (N),733946377,0,0,733946377,28398442955.475398,0.000000,0.000000,28398442955.475398,2415820,0,0,2415820
2015-02-18,NYSE Arca (P),288869031,260076626,176171369,725117026,11307648767.481473,13336683039.434768,7098189394.539165,31742521201.455406,2009680,683444,1177632,3870756
2015-02-18,NASDAQ (Q),464486734,129633063,428012393,1022132190,19921087265.230925,8169923150.814781,17335094162.998673,45426104579.044379,3753486,520430,2479974,6753890
2015-02-18,NASDAQ PSX (X),32461953,14637493,15260243,62359689,1160464031.501601,785971930.947200,552066767.903800,2498502730.352601,250417,59943,111061,421421
2015-02-18,BATS BYX (Y),113774547,46888777,56650763,217314087,3796436785.650597,2077213733.785195,1897192846.069099,7770843365.504891,966490,199316,454447,1620253
2015-02-18,BATS BZX (Z),264983145,112289584,130166918,507439647,9877505744.639177,6805503393.154705,5209125204.667595,21892134342.461477,2099568,443126,1022950,3565644
2015-02-17,NYSE MKT (A),0,18111619,8696046,26807665,0.000000,128057971.830200,285551094.187999,413609066.018199,0,32427,24488,56915
2015-02-17,NASDAQ BX (B),52691318,26057607,27428861,106177786,2020531335.529595,1399447173.571603,1211649277.696101,4631627786.797299,441022,125311,227781,794114
2015-02-17,NYSE (DN),125075456,36466131,72996841,234538428,4477707468.530215,1557841945.628501,2993070193.830430,9028619607.989146,428996,102572,236304,767872
2015-02-17,NASDAQ (DQ),1014150234,418909058,605560758,2038620050,35967314545.280215,18559966172.219595,21481979103.517373,76009259821.017183,3604920,800044,1928248,6333212
2015-02-17,EDGA (J),86258856,35324096,41098331,162681283,3048303870.763194,1618943273.097400,1578819473.217097,6246066617.077691,708606,164060,334382,1207048
2015-02-17,EDGX (K),172143483,90444738,147273707,409861928,5924923932.218780,3448026130.073203,4970637250.087978,14343587312.379961,1020687,266429,735758,2022874
2015-02-17,CHX (M),8438402,9875126,3804822,22118350,393636019.837700,935162636.208800,189165266.400200,1517963922.446700,738,2783,1027,4548
2015-02-17,NYSE (N),780196863,0,0,780196863,31332659856.170263,0.000000,0.000000,31332659856.170263,2385491,0,0,2385491
2015-02-17,NYSE Arca (P),270771224,256393955,176376590,703541769,10797203464.957734,13497736670.154145,7255378037.641083,31550318172.752962,1918959,702143,1146160,3767262
2015-02-17,NASDAQ (Q),461371009,127267269,469275252,1057913530,20066970171.753448,7888562003.754585,19564985300.265558,47520517475.773591,3650268,528904,2471979,6651151
2015-02-17,NASDAQ PSX (X),33741689,14077701,16522592,64341982,1280902879.520001,727723387.520500,670768051.683402,2679394318.723903,262115,57758,116897,436770
2015-02-17,BATS BYX (Y),118089157,47885998,58316878,224292033,3935800937.543621,2090546089.393903,2049708046.292697,8076055073.230221,970770,210402,460707,1641879
2015-02-17,BATS BZX (Z),243881318,108898332,132381848,485161498,9503879569.266570,6361257603.417014,5343331816.555264,21208468989.238848,1978055,434974,1019461,3432490
2015-02-13,NYSE MKT (A),0,14252759,5170651,19423410,0.000000,73626375.517300,154887997.540100,228514373.057400,0,27425,20699,48124
2015-02-13,NASDAQ BX (B),53669758,23806645,30512691,107989094,2114397907.151591,1323998607.909900,1296548938.796499,4734945453.857990,460595,109572,252613,822780
2015-02-13,NYSE (DN),132178441,29826813,78375632,240380886,5082999567.684053,1361352177.585299,2954704332.689925,9399056077.959277,520839,83367,253204,857410
2015-02-13,NASDAQ (DQ),1084908925,419104841,706016582,2210030348,38263399672.163355,18455555235.394133,23312119363.497028,80031074271.054516,3738829,745227,1973161,6457217
2015-02-13,EDGA (J),87701197,35112881,46280518,169094596,3208869454.779714,1670575020.795002,1625554684.343900,6504999159.918616,735211,161790,348531,1245532
2015-02-13,EDGX (K),180512288,85988916,151311252,417812456,6169197379.678789,3536853689.476913,5123034229.551821,14829085298.707523,1034134,252324,728150,2014608
2015-02-13,CHX (M),10701720,9977373,8075168,28754261,386200842.440000,887493728.058800,407261572.482000,1680956142.980800,446,3092,985,4523
2015-02-13,NYSE (N),760047431,0,0,760047431,28672639418.244819,0.000000,0.000000,28672639418.244819,2347587,0,0,2347587
2015-02-13,NYSE Arca (P),309258897,241305390,206334842,756899129,12538432548.494289,13794539081.762662,8147076098.387663,34480047728.644614,2146655,695320,1232045,4074020
2015-02-13,NASDAQ (Q),491763203,137050364,479755113,1108568680,21010274017.779888,9102392178.881988,19302088678.584329,49414754875.246205,3808329,528157,2520507,6856993
2015-02-13,NASDAQ PSX (X),34445920,12982745,17881272,65309937,1286622438.947498,779348145.516500,628918826.610100,2694889411.074098,266021,50546,120632,437199
2015-02-13,BATS BYX (Y),123079204,43628779,64104022,230812005,3998021377.415221,2023073546.688499,2060206454.212611,8081301378.316331,1010732,197289,481918,1689939
2015-02-13,BATS BZX (Z),267412931,112739603,154454074,534606608,10231749379.257545,6918577044.317389,6079428494.414648,23229754917.989582,2095827,436462,1100132,3632421
2015-02-12,NYSE MKT (A),0,13045912,7255931,20301843,0.000000,73504849.657400,182497626.244200,256002475.901600,0,24878,23979,48857
2015-02-12,NASDAQ BX (B),56021249,29202155,33277878,118501282,2186085288.568199,1578500512.116001,1564293908.777804,5328879709.462004,476464,126837,274557,877858
2015-02-12,NYSE (DN),139257145,33399919,84713022,257370086,5432367410.987013,1459151017.257808,3646371942.377832,10537890370.622653,516013,92698,289858,898569
2015-02-12,NASDAQ (DQ),1198132585,538151425,734095690,2470379700,41098548415.905918,22822668887.441264,26612176106.085976,90533393409.433158,3732331,792840,2119118,6644289
2015-02-12,EDGA (J),98653202,39619785,52631010,190903997,3568108996.669203,1869361687.003798,2051735508.111597,7489206191.784598,785650,177044,407384,1370078
2015-02-12,EDGX (K),186668529,97536439,170587785,454792753,6553764037.107488,4209360077.216607,6229249270.112149,16992373384.436244,1056188,287165,802586,2145939
2015-02-12,CHX (M),12077604,10627167,8436321,31141092,458511365.361800,1099397212.819999,403462197.965600,1961370776.147399,827,3673,747,5247
2015-02-12,NYSE (N),803019822,0,0,803019822,30577730170.382815,0.000000,0.000000,30577730170.382815,2429230,0,0,2429230
2015-02-12,NYSE Arca (P),339794205,282723599,218117784,840635588,13247821236.706093,15767577558.145030,9595160596.975631,38610559391.826754,2194332,754679,1331163,4280174
2015-02-12,NASDAQ (Q),505254604,142018680,514356030,1161629314,21346590809.122262,9275699708.216786,22204502675.068564,52826793192.407612,3777416,564232,2734356,7076004
2015-02-12,NASDAQ PSX (X),37847548,15583611,20874992,74306151,1328536049.314998,929479046.222300,780269917.522000,3038285013.059298,268065,61870,131958,461893
2015-02-12,BATS BYX (Y),129092589,52743806,69569223,251405618,4277002341.723597,2393372311.567196,2466558442.382319,9136933095.673112,1037425,233829,516296,1787550
2015-02-12,BATS BZX (Z),295653606,127402679,169412412,592468697,11123835395.734264,7388820462.068705,6817750117.283904,25330405975.086873,2230367,499182,1209057,3938606
2015-02-11,NYSE MKT (A),0,12514943,9148751,21663694,0.000000,86310922.292900,298879537.979200,385190460.272100,0,27804,25131,52935
2015-02-11,NASDAQ BX (B),58421375,29780644,31282443,119484462,2150641633.384394,1576625616.338000,1314692119.812891,5041959369.535285,502407,131042,261656,895105
2015-02-11,NYSE (DN),128056524,32028725,74676669,234761918,4574955301.622625,1449344633.153398,3074261654.036602,9098561588.812625,448284,91336,249981,789601
2015-02-11,NASDAQ (DQ),1095132757,427286865,609547753,2131967375,35940734846.082094,18145966960.774825,21837770416.566162,75924472223.423081,3499029,742344,1796944,6038317
2015-02-11,EDGA (J),88363139,39728028,45425230,173516397,2993855183.423197,1847238243.969901,1678857180.072492,6519950607.465590,736290,176104,364126,1276520
2015-02-11,EDGX (K),186191835,92408468,145035273,423635576,6059689586.886715,3888211493.966004,5269589199.327141,15217490280.179860,1057328,282401,728199,2067928
2015-02-11,CHX (M),14399872,8791831,8032379,31224082,592639139.435000,849761143.062000,473154724.139800,1915555006.636800,467,3362,761,4590
2015-02-11,NYSE (N),749676346,0,0,749676346,27602440704.891476,0.000000,0.000000,27602440704.891476,2483128,0,0,2483128
2015-02-11,NYSE Arca (P),336268346,257928691,191708375,785905412,12722516784.722240,14231403555.723924,8254762931.176888,35208683271.623052,2244470,788600,1244022,4277092
2015-02-11,NASDAQ (Q),502856936,145891114,456741700,1105489750,20360797413.377739,9465137825.894872,19066389098.347266,48892324337.619877,3777390,596746,2561356,6935492
2015-02-11,NASDAQ PSX (X),37524957,16912283,18673552,73110792,1206213751.554997,1055531009.560000,646843445.235602,2908588206.350599,261752,70530,115613,447895
2015-02-11,BATS BYX (Y),117472280,50652462,59696407,227821149,3774249278.404396,2394126518.711199,2032663517.713902,8201039314.829497,941521,219369,450786,1611676
2015-02-11,BATS BZX (Z),290262085,126478036,150414227,567154348,10562161385.823287,7459169265.482402,6047074583.964719,24068405235.270408,2211889,505800,1105444,3823133
2015-02-10,NYSE MKT (A),0,12232294,7483379,19715673,0.000000,66252465.125200,177552602.226200,243805067.351400,0,27112,25099,52211
2015-02-10,NASDAQ BX (B),57136137,25161064,30768400,113065601,2175274700.779697,1395073545.571701,1280203653.276199,4850551899.627597,487681,120293,251784,859758
2015-02-10,NYSE (DN),133758662,30823729,72418317,237000708,5087310459.780719,1547331197.992104,2976744655.396491,9611386313.169314,486507,88939,251170,826616
2015-02-10,NASDAQ (DQ),1145810743,411354876,607289356,2164454975,39982781048.195084,19094393697.196730,21140849135.832308,80218023881.224122,3774474,754419,1814826,6343719
2015-02-10,EDGA (J),90750683,35890885,45990006,172631574,3169462520.512200,1693099821.936704,1694387540.919803,6556949883.368707,775324,172914,372282,1320520
2015-02-10,EDGX (K),191865938,92946115,135739083,420551136,6505640835.632587,3952770049.411794,4887202728.099564,15345613613.143945,1101920,284105,707167,2093192
2015-02-10,CHX (M),12582812,8051287,5690717,26324816,462022076.691400,800037227.078000,553268282.397600,1815327586.167000,476,3179,876,4531
2015-02-10,NYSE (N),785215045,0,0,785215045,29798637837.195094,0.000000,0.000000,29798637837.195094,2449257,0,0,2449257
2015-02-10,NYSE Arca (P),316447440,248875058,177438821,742761319,12486395091.500080,13682257991.954118,7293212464.620657,33461865548.074855,2171665,735386,1169893,4076944
2015-02-10,NASDAQ (Q),500917203,132649683,464854201,1098421087,20729284726.349956,8755263057.844729,19246494370.714242,48731042154.908927,3805078,564140,2516402,6885620
2015-02-10,NASDAQ PSX (X),33985500,14601245,17963786,66550531,1271428984.097000,868991367.185800,650055488.382701,2790475839.665501,263780,61071,117657,442508
2015-02-10,BATS BYX (Y),118487075,48729160,61485723,228701958,3953351111.881295,2234127125.616501,2112650905.953784,8300129143.451580,971384,218306,470140,1659830
2015-02-10,BATS BZX (Z),287441489,113784714,151180162,552406365,11083433998.409205,6710152676.519906,5987171515.777153,23780758190.706264,2272348,467768,1123666,3863782
2015-02-09,NYSE MKT (A),0,14659265,7724105,22383370,0.000000,237456184.690100,173200483.037100,410656667.727200,0,25564,25439,51003
2015-02-09,NASDAQ BX (B),52943751,23345435,27453754,103742940,2004410873.529508,1385692086.995297,1078784387.518194,4468887348.042999,460982,110557,223636,795175
2015-02-09,NYSE (DN),126366807,31690597,67089161,225146565,4597860059.690212,1492506894.302497,2451685642.236502,8542052596.229211,471991,91162,238744,801897
2015-02-09,NASDAQ (DQ),1092966653,362089864,568227850,2023284367,36375888825.331730,17244442766.901713,18178180449.817208,71798512042.050651,3632648,735260,1725823,6093731
2015-02-09,EDGA (J),88318933,32820473,42550542,163689948,3102660578.291992,1610710799.815602,1472295038.806488,6185666416.914082,758722,157179,345604,1261505
2015-02-09,EDGX (K),181225333,82443547,124589312,388258192,6139326932.205781,3475495048.426903,4276474728.305813,13891296708.938497,1053267,257250,665150,1975667
2015-02-09,CHX (M),6815708,12262859,4908100,23986667,309586124.257800,1583209016.459000,264778177.742400,2157573318.459200,609,3119,861,4589
2015-02-09,NYSE (N),776047691,0,0,776047691,29082987211.477809,0.000000,0.000000,29082987211.477809,2512076,0,0,2512076
2015-02-09,NYSE Arca (P),300645178,228887429,161232515,690765122,11747463043.441100,13105651485.661247,6275803318.789450,31128917847.891797,2079905,684268,1076205,3840378
2015-02-09,NASDAQ (Q),496508407,131370739,435284858,1063164004,20655045718.659897,8153680694.453491,17115978630.162398,45924705043.275786,3845545,574033,2487002,6906580
2015-02-09,NASDAQ PSX (X),35666542,13554457,19046600,68267599,1265653922.259998,774481195.481399,588948675.630498,2629083793.371895,272649,58821,118216,449686
2015-02-09,BATS BYX (Y),115744276,46381100,56927463,219052839,3866096449.023878,2196116245.171802,1812306226.684896,7874518920.880576,955295,212211,432554,1600060
2015-02-09,BATS BZX (Z),288609508,108302453,150396515,547308476,10959151099.208330,6493914639.146592,5699095923.774581,23152161662.129503,2281509,453479,1115850,3850838
2015-02-06,NYSE MKT (A),0,15863025,7344749,23207774,0.000000,101447251.983800,116367788.698700,217815040.682500,0,35167,25635,60802
2015-02-06,NASDAQ BX (B),61521218,33824453,33435297,128780968,2415827247.180498,1834838629.115199,1402278135.573095,5652944011.868792,520372,144056,271377,935805
2015-02-06,NYSE (DN),161562158,41273244,89273469,292108871,6302160643.392506,2044070184.790896,3302157117.817318,11648387946.000720,584102,118614,287021,989737
2015-02-06,NASDAQ (DQ),1282091071,475340581,688398576,2445830228,44685789744.918822,22572752903.249225,22811681366.373645,90070224014.541692,4107425,921199,1981834,7010458
2015-02-06,EDGA (J),106481413,46239229,51205021,203925663,3827098780.473799,2107296756.720002,1804022749.765195,7738418286.958996,878743,208157,390101,1477001
2015-02-06,EDGX (K),217934343,112187633,147255427,477377403,7391568595.470720,4720076658.827091,5258591326.785111,17370236581.082922,1194688,344914,779164,2318766
2015-02-06,CHX (M),9703406,14808197,5207353,29718956,379182835.039500,1464450333.801500,336165584.755000,2179798753.596000,418,4646,1497,6561
2015-02-06,NYSE (N),927117433,0,0,927117433,34875893716.170846,0.000000,0.000000,34875893716.170846,2867901,0,0,2867901
2015-02-06,NYSE Arca (P),375806298,354534290,215387296,945727884,14773819678.669456,19095183139.610428,8562352084.456141,42431354902.736025,2480050,996622,1328822,4805494
2015-02-06,NASDAQ (Q),598141208,185664783,523322210,1307128201,24972776844.900099,12333393844.912747,20605714363.584485,57911885053.397331,4462568,774438,2859132,8096138
2015-02-06,NASDAQ PSX (X),40247057,19508817,23604812,83360686,1399879611.990998,1110421775.538800,744457772.648699,3254759160.178497,284779,71298,136351,492428
2015-02-06,BATS BYX (Y),139475063,59439889,70343056,269258008,4556397716.444332,2749186228.557803,2219421009.566499,9525004954.568634,1075824,260449,510710,1846983
2015-02-06,BATS BZX (Z),353894234,157629652,183947144,695471030,13354524321.283371,9244597380.711676,6731624465.360166,29330746167.355213,2693548,635938,1283190,4612676
2015-02-05,NYSE MKT (A),0,12914872,7925658,20840530,0.000000,66535847.276700,148832849.270000,215368696.546700,0,29721,26737,56458
2015-02-05,NASDAQ BX (B),56899665,25915609,34216336,117031610,2339613021.733401,1377789003.775999,1351111083.007311,5068513108.516711,490699,114238,268074,873011
2015-02-05,NYSE (DN),152344477,37329038,95631924,285305439,6187396578.903721,1782578488.856909,3414098359.455710,11384073427.216340,588443,102479,322782,1013704
2015-02-05,NASDAQ (DQ),1177500048,419658132,692872301,2290030481,44143535373.138559,19155322238.894693,22654401207.770892,85953258819.804144,3896829,765952,2020767,6683548
2015-02-05,EDGA (J),96673542,36931589,51304697,184909828,3664339604.761408,1785832294.181598,1753262409.518896,7203434308.461902,828226,171680,391784,1391690
2015-02-05,EDGX (K),193298905,90827607,148447941,432574453,7064928522.207015,3960245745.649995,5084430364.914566,16109604632.771576,1111559,274344,728016,2113919
2015-02-05,CHX (M),8063041,9130907,6960998,24154946,398585674.610000,1006584390.900000,351162368.124200,1756332433.634200,869,4300,864,6033
2015-02-05,NYSE (N),793787398,0,0,793787398,30572081704.592041,0.000000,0.000000,30572081704.592041,2642047,0,0,2642047
2015-02-05,NYSE Arca (P),340437553,275337881,213507535,829282969,13957092079.294159,16136919924.199574,8325896907.760075,38419908911.253808,2242938,783025,1302271,4328234
2015-02-05,NASDAQ (Q),542581938,147875373,524694051,1215151362,23833702003.635319,9622987652.470624,20317865495.861110,53774555151.967053,4194276,605448,2866673,7666397
2015-02-05,NASDAQ PSX (X),33945654,13629570,20576161,68151385,1235582245.724999,847091389.372501,595532345.265398,2678205980.362898,247657,53006,115804,416467
2015-02-05,BATS BYX (Y),126908160,49808447,69990406,246707013,4359287130.200800,2351316940.565497,2132316134.928199,8842920205.694496,1024859,214692,500194,1739745
2015-02-05,BATS BZX (Z),307211066,126401844,178675775,612288685,12173691332.536674,7719863371.365112,6523054585.779295,26416609289.681081,2429403,527634,1273795,4230832
2015-02-04,NYSE MKT (A),0,12925904,7850352,20776256,0.000000,72962038.094300,169493304.271900,242455342.366200,0,30344,29129,59473
2015-02-04,NASDAQ BX (B),61937243,30711660,36799124,129448027,2508132568.510487,1803276878.661402,1596665304.968686,5908074752.140575,530714,144395,292331,967440
2015-02-04,NYSE (DN),119350826,30693585,79386433,229430844,4561429317.003108,1513944572.472802,3247240462.858834,9322614352.334744,453168,82414,257052,792634
2015-02-04,NASDAQ (DQ),1171564178,433595389,727997921,2333157488,42278244637.372870,20743011172.839640,26401446442.865847,89422702253.078357,4120109,836405,2177337,7133851
2015-02-04,EDGA (J),102404306,43501687,53546162,199452155,3584980225.118599,2152717238.123905,1836192778.258392,7573890241.500896,855763,209010,400926,1465699
2015-02-04,EDGX (K),213259066,105185557,160048287,478492910,7413394742.318794,4673284224.041981,5991433743.056241,18078112709.417016,1242885,339370,822487,2404742
2015-02-04,CHX (M),9601192,9964177,15919640,35485009,413768275.813200,1113985946.290000,466223041.120000,1993977263.223200,514,4588,1030,6132
2015-02-04,NYSE (N),899959691,0,0,899959691,34487930727.947783,0.000000,0.000000,34487930727.947783,3032659,0,0,3032659
2015-02-04,NYSE Arca (P),387547881,334044552,254806992,976399425,15274445984.325734,20219110270.779321,10717369978.855629,46210926233.960684,2584527,986570,1532840,5103937
2015-02-04,NASDAQ (Q),650211505,193682599,580205725,1424099829,27877239242.109816,13109898784.045923,24919990809.787266,65907128835.943005,5074247,830161,3325737,9230145
2015-02-04,NASDAQ PSX (X),39335670,17264772,21988835,78589277,1399250720.683600,1027260889.728400,789104684.433600,3215616294.845600,274374,62989,129491,466854
2015-02-04,BATS BYX (Y),137373789,62493177,79081391,278948357,4697617222.399410,2997287460.349697,2620687167.295892,10315591850.044999,1104112,274471,559940,1938523
2015-02-04,BATS BZX (Z),354502511,154753351,199636225,708892087,13682043648.118814,9368321358.495407,7972741646.999406,31023106653.613627,2765845,655447,1393498,4814790
2015-02-03,NYSE MKT (A),0,16304680,8691765,24996445,0.000000,113273469.051200,141545634.223900,254819103.275100,0,34213,28731,62944
2015-02-03,NASDAQ BX (B),75476870,35441157,39327376,150245403,3004445510.733508,1875537427.638996,1673906939.389902,6553889877.762406,677857,156315,331788,1165960
2015-02-03,NYSE (DN),173553817,47999201,90144900,311697918,6188424691.706478,2263001630.792892,3626267477.542603,12077693800.041973,641505,126353,313979,1081837
2015-02-03,NASDAQ (DQ),1312443816,538982210,696324643,2547750669,43285777090.393101,25144750310.559583,24871398887.229613,93301926288.182297,4517987,965543,2154068,7637598
2015-02-03,EDGA (J),124526031,58340453,56537107,239403591,4407402799.851701,2807753622.308298,2058579276.114898,9273735698.274897,1066812,266566,457500,1790878
2015-02-03,EDGX (K),244298733,126982424,156230205,527511362,7821851899.430125,5506751019.763205,5610311144.295841,18938914063.489171,1362076,396558,823014,2581648
2015-02-03,CHX (M),9604889,10225518,7797561,27627968,378544888.371900,1201102406.291399,338742321.166200,1918389615.829499,653,5460,1204,7317
2015-02-03,NYSE (N),981263911,0,0,981263911,36047700182.670130,0.000000,0.000000,36047700182.670130,3249677,0,0,3249677
2015-02-03,NYSE Arca (P),420303796,381024071,229712881,1031040748,15748338173.647771,21467179936.275313,9893039269.745280,47108557379.668364,2798452,1090990,1509415,5398857
2015-02-03,NASDAQ (Q),702599688,204288896,585667549,1492556133,29577622649.828817,12912615117.197325,24781617322.475702,67271855089.501844,5521026,866234,3455699,9842959
2015-02-03,NASDAQ PSX (X),42955162,19724619,21970489,84650270,1469182031.760999,1121244377.061199,681238213.264599,3271664622.086797,302062,70382,127637,500081
2015-02-03,BATS BYX (Y),146371516,66753427,74938398,288063341,4717646421.475895,3128275314.043096,2530493533.483383,10376415269.002374,1173290,287534,563214,2024038
2015-02-03,BATS BZX (Z),387194913,167331235,190448124,744974272,14344534016.183093,9705024461.070196,7389116506.110839,31438674983.364128,3012014,702610,1401193,5115817
2015-02-02,NYSE MKT (A),0,15188364,10608850,25797214,0.000000,83619304.470000,218739225.386000,302358529.856000,0,33219,37006,70225
2015-02-02,NASDAQ BX (B),62765336,35168114,34979779,132913229,2497229046.020492,2238289628.063001,1631625415.444497,6367144089.527990,608265,166752,324273,1099290
2015-02-02,NYSE (DN),131924130,51595861,81573851,265093842,4859667297.263210,2778233375.495003,3441660383.681990,11079561056.440203,548542,134177,299410,982129
2015-02-02,NASDAQ (DQ),1030787106,586827492,600230062,2217844660,34745512894.827380,35796655061.259247,23052836974.923748,93595004931.010375,3882151,949003,1999198,6830352
2015-02-02,EDGA (J),111283925,53685462,53718970,218688357,4014544088.029401,2834630485.054901,2085118575.434316,8934293148.518618,1008060,271288,460267,1739615
2015-02-02,EDGX (K),192413593,115644331,143966370,452024294,6580516230.833604,5819661745.797981,5697181531.598521,18097359508.230106,1219394,396616,822809,2438819
2015-02-02,CHX (M),9493995,11220379,16953227,37667601,501034059.187800,1254487277.277300,1136118593.565300,2891639930.030400,605,6748,2173,9526
2015-02-02,NYSE (N),911697507,0,0,911697507,34328387819.621472,0.000000,0.000000,34328387819.621472,3235511,0,0,3235511
2015-02-02,NYSE Arca (P),375772396,369070089,222320924,967163409,14094725924.721017,23250197307.933119,9838243790.377807,47183167023.031943,2632482,1179608,1541621,5353711
2015-02-02,NASDAQ (Q),648533096,211335651,562119119,1421987866,27266784294.084052,14602238075.343801,24291368137.557436,66160390506.985289,5386729,960218,3516220,9863167
2015-02-02,NASDAQ PSX (X),42207720,23315566,23029371,88552657,1453358549.574204,1358606934.983601,822691449.468798,3634656934.026603,314526,96832,142102,553460
2015-02-02,BATS BYX (Y),143068865,73219931,74137259,290426055,4766836312.111524,3732618535.999405,2631373472.162590,11130828320.273519,1227229,327330,593806,2148365
2015-02-02,BATS BZX (Z),348880430,169789886,185060017,703730333,13118396222.492569,10988926141.047324,7500392183.920995,31607714547.460888,2819939,759526,1409266,4988731
2015-01-30,NYSE MKT (A),0,12868506,7714863,20583369,0.000000,85150651.615900,212560175.425000,297710827.040900,0,29862,31006,60868
2015-01-30,NASDAQ BX (B),77678840,44543907,42199743,164422490,2808430102.316114,2383664644.529702,1932582319.925500,7124677066.771316,612981,190735,315408,1119124
2015-01-30,NYSE (DN),163389082,51209430,100217334,314815846,6636094465.222105,2777270948.534202,4706545888.855686,14119911302.611993,636671,133638,338735,1109044
2015-01-30,NASDAQ (DQ),1192186200,534118270,694588204,2420892674,42622221955.415639,32131749433.948989,29911684438.182784,104665655827.547412,3980968,916366,2059509,6956843
2015-01-30,ADF (D),13881763,9219793,9093804,32195360,418128805.792600,327824744.522500,290767240.560000,1036720790.875100,88237,29297,50470,168004
2015-01-30,EDGA (J),111591510,56633622,55869841,224094973,3841639097.348812,2785758576.293500,2139927262.383104,8767324936.025416,943100,272076,438800,1653976
2015-01-30,EDGX (K),191284220,120091976,143672631,455048827,6825239531.106088,6131146187.975581,6356193928.614988,19312579647.696657,1181612,411715,784009,2377336
2015-01-30,CHX (M),17164467,14364351,5829229,37358047,895592626.315300,1779392726.410000,522396143.876000,3197381496.601300,1056,8101,1568,10725
2015-01-30,NYSE (N),1216206352,0,0,1216206352,48536880594.603156,0.000000,0.000000,48536880594.603156,3237541,0,0,3237541
2015-01-30,NYSE Arca (P),372557345,417856880,229004704,1019418929,14218238990.438557,27469971490.306280,12084479349.900551,53772689830.645388,2529120,1222272,1558785,5310177
2015-01-30,NASDAQ (Q),650963979,221316258,685917154,1558197391,27726506883.269974,15401905832.801879,31962647069.830749,75091059785.902602,5114180,961340,3512187,9587707
2015-01-30,NASDAQ PSX (X),40933641,21731637,21918524,84583802,1464135639.724601,1296282798.171300,810096875.491301,3570515313.387202,300457,92665,132746,525868
2015-01-30,BATS BYX (Y),148777772,73160712,75268750,297207234,5090554132.901988,3699249992.353693,2869978333.423888,11659782458.679569,1223552,321274,569618,2114444
2015-01-30,BATS BZX (Z),376637051,191007960,197466206,765111217,14483633658.612068,12502252605.768434,8815274689.760569,35801160954.141071,2905312,808657,1463113,5177082
2015-01-29,NYSE MKT (A),0,14336128,9095306,23431434,0.000000,116475717.770300,203000015.647400,319475733.417700,0,29337,27175,56512
2015-01-29,NASDAQ BX (B),73149694,39899363,37760982,150810039,2633787196.736509,2157575812.019897,1661180715.306687,6452543724.063093,601932,177522,298248,1077702
2015-01-29,NYSE (DN),160524540,47420212,92311377,300256129,6390304257.528328,2410934776.686297,4022460298.846207,12823699333.060832,596088,127777,315334,1039199
2015-01-29,NASDAQ (DQ),1207035731,486772681,681081830,2374890242,43287854920.956098,25721595956.141312,26569998884.069586,95579449761.166996,4083971,945280,2071992,7101243
2015-01-29,ADF (D),17686349,9954371,11042575,38683295,515125706.392000,417762137.739100,343623968.037400,1276511812.168500,99876,34417,54128,188421
2015-01-29,EDGA (J),117939750,51016239,57396820,226352809,4377973414.952106,2483906131.624402,2288564257.463495,9150443804.040003,1015177,247613,466674,1729464
2015-01-29,EDGX (K),183476193,102893205,144306575,430675973,6715933724.920703,5075393048.465810,5794453151.223602,17585779924.610115,1139783,355943,761796,2257522
2015-01-29,CHX (M),14737510,14411230,9125392,38274132,491408672.173800,1677952648.245999,562438458.640400,2731799779.060199,852,6523,1606,8981
2015-01-29,NYSE (N),863074191,0,0,863074191,33008723781.971186,0.000000,0.000000,33008723781.971186,2895916,0,0,2895916
2015-01-29,NYSE Arca (P),355601814,331061915,224984325,911648054,13963527753.358772,20983358084.121447,10532299894.429866,45479185731.910085,2354505,1053890,1456721,4865116
2015-01-29,NASDAQ (Q),613309305,188380883,570215380,1371905568,27019000175.342132,12986556681.765033,25234186872.946574,65239743730.053739,4878157,837531,3347793,9063481
2015-01-29,NASDAQ PSX (X),36159215,20610132,20899587,77668934,1352005191.509896,1117499003.943800,803176293.476000,3272680488.929696,270701,88867,129961,489529
2015-01-29,BATS BYX (Y),137853195,64629682,71235544,273718421,4664092198.227927,3379360656.114898,2532735926.177696,10576188780.520521,1103104,287312,526144,1916560
2015-01-29,BATS BZX (Z),350920576,162018448,186195999,699135023,13902844777.064775,10437487397.217606,7887819891.179213,32228152065.461594,2764683,702950,1387718,4855351
2015-01-28,NYSE MKT (A),0,13591454,12340602,25932056,0.000000,87786984.926100,625330756.556600,713117741.482700,0,29792,42225,72017
2015-01-28,NASDAQ BX (B),70336131,40423490,36277528,147037149,2533404525.167596,2244577693.160696,1560084773.866502,6338066992.194794,574257,171886,287773,1033916
2015-01-28,NYSE (DN),141321280,39631971,87714732,268667983,5422477508.568013,2192197010.698794,4049502320.443044,11664176839.709851,539269,123856,308425,971550
2015-01-28,NASDAQ (DQ),1167324849,470674486,665573182,2303572517,39910340155.748797,24906733848.479355,27843854298.900701,92660928303.128853,3896534,900723,2106058,6903315
2015-01-28,ADF (D),25523753,16393778,16597468,58514999,741971751.400500,564163758.580500,576840275.644500,1882975785.625500,116752,42738,71601,231091
2015-01-28,EDGA (J),113589253,53049530,57907599,224546382,4054236420.122986,2538600482.548402,2354949123.893281,8947786026.564669,972081,254146,466133,1692360
2015-01-28,EDGX (K),196364308,110918415,149579941,456862664,6754360827.335692,5253521516.084693,6233163263.940596,18241045607.360981,1122611,359639,789987,2272237
2015-01-28,CHX (M),9834727,16233824,9482538,35551089,600971980.700000,2305594058.429999,660941311.997500,3567507351.127499,1722,7943,1734,11399
2015-01-28,NYSE (N),856711834,0,0,856711834,32367666260.287793,0.000000,0.000000,32367666260.287793,2975653,0,0,2975653
2015-01-28,NYSE Arca (P),347422834,355517529,228079055,931019418,13169643282.525665,21518785199.543083,10867575305.029909,45556003787.098657,2350655,1043667,1504555,4898877
2015-01-28,NASDAQ (Q),622929455,197433743,574361153,1394724351,26803278625.291286,13552501932.395589,26151046854.688353,66506827412.375228,4886661,886007,3407438,9180106
2015-01-28,NASDAQ PSX (X),33838150,21256288,21603418,76697856,1241140014.470000,1249113677.335000,837361340.318999,3327615032.123999,251964,84266,128761,464991
2015-01-28,BATS BYX (Y),134874537,65219330,68825418,268919285,4421955727.048823,3407815327.404803,2496580638.644105,10326351693.097731,1106667,298964,524458,1930089
2015-01-28,BATS BZX (Z),356636610,178490467,196208296,731335373,13671971670.705237,11405490376.387696,8520027600.592794,33597489647.685727,2767602,744242,1457132,4968976
2015-01-27,NYSE MKT (A),0,9944342,9012965,18957307,0.000000,59860235.645600,288877840.516001,348738076.161601,0,22230,28319,50549
2015-01-27,NASDAQ BX (B),57550167,31820079,35970705,125340951,2189826555.407397,1905391738.850498,1546696556.912700,5641914851.170595,497453,149455,278923,925831
2015-01-27,NYSE (DN),121210043,35160679,83443360,239814082,4850949687.093693,2034089854.583700,3484006438.634253,10369045980.311646,488692,106577,278041,873310
2015-01-27,NASDAQ (DQ),953063318,373333408,645980938,1972377664,34458013089.412043,18741172558.445937,23690819079.249868,76890004727.107848,3529367,832504,1953774,6315645
2015-01-27,ADF (D),26544371,15507402,17814445,59866218,776155819.589100,558300933.253600,582935221.296601,1917391974.139301,107644,41104,72234,220982
2015-01-27,EDGA (J),97552316,43976164,53946480,195474960,3678699488.098385,2192284759.874899,2040277770.112112,7911262018.085396,872873,217049,420705,1510627
2015-01-27,EDGX (K),157110136,93005451,142447438,392563025,5594432725.566825,4484381871.182201,6148889814.798949,16227704411.547975,919933,308365,709284,1937582
2015-01-27,CHX (M),5374762,12957412,5871806,24203980,202315566.918200,1591804116.180000,395118622.076000,2189238305.174200,675,6349,1664,8688
2015-01-27,NYSE (N),711241379,0,0,711241379,27351802210.831843,0.000000,0.000000,27351802210.831843,2487111,0,0,2487111
2015-01-27,NYSE Arca (P),279511231,283047470,208274185,770832886,11322507839.237648,18167603055.587949,9416077941.768644,38906188836.594241,1975134,881243,1291447,4147824
2015-01-27,NASDAQ (Q),491805015,158778099,503232210,1153815324,21719752590.471228,10880400449.081018,22091215952.496595,54691368992.048841,3961590,700787,2853074,7515451
2015-01-27,NASDAQ PSX (X),27513158,18649594,21358118,67520870,1017990401.389001,1036751607.689800,717244590.044400,2771986599.123201,211980,76762,113688,402430
2015-01-27,BATS BYX (Y),112385610,57565610,62933097,232884317,3669912781.828357,3141066121.519594,2298431627.312480,9109410530.660431,936545,264028,486272,1686845
2015-01-27,BATS BZX (Z),290516255,145058391,169858076,605432722,11116077923.876426,9799648212.391193,6705908342.568514,27621634478.836133,2279650,614661,1230036,4124347
2015-01-26,NYSE MKT (A),0,15235528,5369088,20604616,0.000000,108814862.734200,164335185.615400,273150048.349600,0,26188,21614,47802
2015-01-26,NASDAQ BX (B),53029428,26843513,28829403,108702344,2018686305.093396,1416285261.462701,1188747471.105705,4623719037.661802,449588,125443,225963,800994
2015-01-26,NYSE (DN),130276650,30460356,66945279,227682285,5141452692.824446,1508514680.851404,2787286923.595926,9437254297.271776,500416,91922,247327,839665
2015-01-26,NASDAQ (DQ),1070745646,385526707,587635756,2043908109,39744814463.876403,18830664478.003944,21847473185.172636,80422952127.052983,3573395,773903,1808127,6155425
2015-01-26,ADF (D),22391735,12975118,14837171,50204024,681132762.632701,396689787.670400,486485473.044701,1564308023.347802,94437,34150,58540,187127
2015-01-26,EDGA (J),93725863,39950507,45167904,178844274,3515380686.968396,1775758974.079997,1676480979.037010,6967620640.085403,822641,189715,366887,1379243
2015-01-26,EDGX (K),147139424,76002184,115618564,338760172,5092419585.852193,3305975633.743299,4081571032.977405,12479966252.572897,853011,241535,581346,1675892
2015-01-26,CHX (M),9162989,7956398,4399521,21518908,353256086.997400,753825033.020000,377293276.491000,1484374396.508400,401,3238,961,4600
2015-01-26,NYSE (N),796079726,0,0,796079726,32725100627.924405,0.000000,0.000000,32725100627.924405,2405132,0,0,2405132
2015-01-26,NYSE Arca (P),273928503,249208429,159897337,683034269,11038428878.198699,15379039374.418972,6814086031.032299,33231554283.649970,1898099,705405,1083193,3686697
2015-01-26,NASDAQ (Q),465771051,120087122,483638152,1069496325,21016572082.462260,7689418441.058192,20467399575.414185,49173390098.934637,3733183,519107,2548770,6801060
2015-01-26,NASDAQ PSX (X),27167368,13305966,15658158,56131492,1036194518.204998,749482114.435000,527116490.274999,2312793122.914997,212020,54258,93157,359435
2015-01-26,BATS BYX (Y),119731054,45245182,58824148,223800384,3934832805.275701,2248045374.845801,2050531222.865195,8233409402.986697,1000427,221846,456827,1679100
2015-01-26,BATS BZX (Z),257271061,107168104,134832290,499271455,9918828560.392582,6607474468.971492,5253753394.772707,21780056424.136781,2099599,451727,1044289,3595615
2015-01-23,NYSE MKT (A),0,12725121,5866580,18591701,0.000000,79708925.592800,142755930.700500,222464856.293300,0,25723,25085,50808
2015-01-23,NASDAQ BX (B),60618052,31331674,30318043,122267769,2128542260.364707,1808102784.132696,1322902515.654095,5259547560.151498,491834,149432,238859,880125
2015-01-23,NYSE (DN),135575939,32562239,71439537,239577715,5177275221.546638,1694282947.072495,2909236355.241730,9780794523.860863,508384,99485,257892,865761
2015-01-23,NASDAQ (DQ),1120303786,396718457,556179318,2073201561,37086591503.203016,19861969473.076098,19871766650.678362,76820327626.957476,3594521,830737,1755119,6180377
2015-01-23,ADF (D),31070119,13309675,14994260,59374054,836059024.512200,448218388.013800,553306362.834800,1837583775.360800,116582,37792,62702,217076
2015-01-23,EDGA (J),96423017,42768791,43116531,182308339,3175291143.709394,2039390883.771501,1519959164.065809,6734641191.546704,791300,208971,345144,1345415
2015-01-23,EDGX (K),175423310,85934701,115937923,377295934,5613866658.794285,4069244451.040791,4751692879.044356,14434803988.879432,949018,275233,627395,1851646
2015-01-23,CHX (M),7387690,10554172,6249078,24190940,348477415.435000,995373993.507301,455147859.953400,1798999268.895701,533,4305,1278,6116
2015-01-23,NYSE (N),784807694,0,0,784807694,29971774424.617614,0.000000,0.000000,29971774424.617614,2466885,0,0,2466885
2015-01-23,NYSE Arca (P),294741592,270211082,159370656,724323330,10930222311.326532,16688399695.223894,7144819752.193281,34763441758.743707,1974703,838345,1120580,3933628
2015-01-23,NASDAQ (Q),488530442,147218445,440196437,1075945324,20696916408.152536,10008941347.132712,19112906863.275022,49818764618.560270,3789283,612015,2550239,6951537
2015-01-23,NASDAQ PSX (X),29935926,16958514,14186139,61080579,1102317591.145202,985092912.629300,548860553.311000,2636271057.085502,222819,66859,92507,382185
2015-01-23,BATS BYX (Y),124873289,54719243,59969957,239562489,4004501845.908109,2847650558.698604,2263810034.284118,9115962438.890831,1007251,259080,461051,1727382
2015-01-23,BATS BZX (Z),280317490,131662351,141520006,553499847,10566319735.586571,8215631488.350705,5638071603.481394,24420022827.418670,2160041,538961,1054881,3753883
2015-01-22,NYSE MKT (A),0,11949294,6578822,18528116,0.000000,108470493.536600,146633695.578300,255104189.114900,0,28352,29079,57431
2015-01-22,NASDAQ BX (B),70162184,37994863,36507272,144664319,2619326393.704189,2177044704.469399,1549110500.656307,6345481598.829895,611101,174900,306699,1092700
2015-01-22,NYSE (DN),152863698,39206376,87382595,279452669,5774198371.135185,2046748474.368308,3681606321.606926,11502553167.110419,580393,112431,317639,1010463
2015-01-22,NASDAQ (DQ),1280116578,525847351,654513678,2460477607,43361755390.231623,26437321743.494851,24584960848.361500,94384037982.087974,3951804,904980,2020191,6876975
2015-01-22,ADF (D),43627491,24136978,19302346,87066815,1046878306.609201,685735492.050399,663597420.242302,2396211218.901902,138840,54967,75699,269506
2015-01-22,EDGA (J),115399686,55023278,51757022,222179986,3885704299.885412,2553160899.689798,1850991436.308699,8289856635.883909,961018,254650,415489,1631157
2015-01-22,EDGX (K),191560799,101270734,127102918,419934451,6162359817.628193,4914505809.938802,4978711398.064459,16055577025.631454,1053038,332012,707527,2092577
2015-01-22,CHX (M),9399588,18447439,6224062,34071089,441803310.821300,1899347165.680000,329527838.896000,2670678315.397300,447,9074,1837,11358
2015-01-22,NYSE (N),890434677,0,0,890434677,33395963002.166206,0.000000,0.000000,33395963002.166206,2792579,0,0,2792579
2015-01-22,NYSE Arca (P),343853485,356023792,196143522,896020799,12673822088.277799,24584820777.458749,8896888339.894660,46155531205.631208,2288741,1012902,1341246,4642889
2015-01-22,NASDAQ (Q),575356039,198208261,549567495,1323131795,24154173675.861545,13855593947.843956,23965494745.773138,61975262369.478639,4377405,794832,3125363,8297600
2015-01-22,NASDAQ PSX (X),34534335,20002888,17096241,71633464,1218776806.679999,1208774202.628301,631690372.174999,3059241381.483299,248491,79404,105651,433546
2015-01-22,BATS BYX (Y),135563294,65692138,70309951,271565383,4549736905.073988,3288071401.691796,2498172907.202989,10335981213.968773,1112309,288743,540624,1941676
2015-01-22,BATS BZX (Z),339936877,183853246,178064191,701854314,12756380751.418437,11656998605.922026,7191303387.283291,31604682744.623754,2604377,723699,1311653,4639729
2015-01-21,NYSE MKT (A),0,15006916,6822062,21828978,0.000000,81904477.911000,183963525.624800,265868003.535800,0,30320,29635,59955
2015-01-21,NASDAQ BX (B),63716453,35399479,34843487,133959419,2206144200.961391,1886763061.184495,1520508001.936398,5613415264.082284,524625,158991,274944,958560
2015-01-21,NYSE (DN),128984334,37941708,76758391,243684433,4754283208.031008,1968000372.920113,3313348798.154621,10035632379.105742,491577,119886,274412,885875
2015-01-21,NASDAQ (DQ),1152451957,406875455,608266857,2167594269,37990817585.633860,18448060779.316242,22415080255.291078,78853958620.241180,3646726,849314,1865687,6361727
2015-01-21,ADF (D),36086387,21154066,17949468,75189921,890577258.083199,668345546.856900,600030671.307201,2158953476.247300,124278,49898,72217,246393
2015-01-21,EDGA (J),105943591,55109055,50464010,211516656,3496160643.323004,2654566062.703998,1903075094.949704,8053801800.976706,875108,252298,390089,1517495
2015-01-21,EDGX (K),165048190,89894551,118920883,373863624,5460595702.206600,4273144801.666893,4476255893.028714,14209996396.902207,971187,318169,640082,1929438
2015-01-21,CHX (M),8013940,13930276,4702447,26646663,332831961.642800,1333717050.998800,308649970.604400,1975198983.246000,428,6276,1590,8294
2015-01-21,NYSE (N),770550312,0,0,770550312,28643544105.881910,0.000000,0.000000,28643544105.881910,2664435,0,0,2664435
2015-01-21,NYSE Arca (P),310390901,314503011,185537650,810431562,11325976994.664777,20556165012.778878,8571817780.491719,40453959787.935374,2102470,976690,1249900,4329060
2015-01-21,NASDAQ (Q),519044727,177234169,495926419,1192205315,21474869666.120184,11522643149.676793,22192285953.895689,55189798769.692666,4029911,776790,2870917,7677618
2015-01-21,NASDAQ PSX (X),31736667,18259027,17640977,67636671,1107566195.930001,1002290816.210000,593055004.505899,2702912016.645900,234164,71520,107254,412938
2015-01-21,BATS BYX (Y),128435541,64096154,68889873,261421568,4127063548.025587,3244103961.096606,2464281158.108989,9835448667.231182,1055882,280317,523267,1859466
2015-01-21,BATS BZX (Z),316490774,158802966,166910055,642203795,11527828862.643497,9206407299.158894,6578235729.238008,27312471891.040399,2414395,673536,1215707,4303638
2015-01-20,NYSE MKT (A),0,17296591,6937840,24234431,0.000000,188969044.081300,158446015.872000,347415059.953300,0,32949,27586,60535
2015-01-20,NASDAQ BX (B),67033811,35108572,33355507,135497890,2308378951.479992,1868059477.992398,1313326099.716300,5489764529.188690,545713,155182,266665,967560
2015-01-20,NYSE (DN),145792751,40769963,80595193,267157907,5245579107.050495,2072450219.858791,3076095585.385130,10394124912.294416,565616,121553,289310,976479
2015-01-20,NASDAQ (DQ),1165278831,502876147,605018182,2273173160,38462489873.977861,24221222087.323474,20796590658.322159,83480302619.623494,3910572,929990,1931088,6771650
2015-01-20,ADF (D),30908895,18935111,16869157,66713163,814516114.504201,602783208.054800,517034138.907800,1934333461.466801,126753,49733,68400,244886
2015-01-20,EDGA (J),106558596,52122362,48006310,206687268,3488296906.121303,2293317564.128196,1596220656.647283,7377835126.896782,876289,237226,381121,1494636
2015-01-20,EDGX (K),182025785,103317090,126227554,411570429,5741170272.898887,4266850625.724197,4623906833.321065,14631927731.944149,1036762,337019,670488,2044269
2015-01-20,CHX (M),10756342,12773133,6958724,30488199,422833727.583900,1367622331.355300,376236018.544500,2166692077.483700,596,5547,1113,7256
2015-01-20,NYSE (N),861094587,0,0,861094587,32721124251.256177,0.000000,0.000000,32721124251.256177,2727948,0,0,2727948
2015-01-20,NYSE Arca (P),344622630,338627937,176111030,859361597,12218455299.035959,20819765302.142544,7703276924.154856,40741497525.333359,2292274,960894,1231771,4484939
2015-01-20,NASDAQ (Q),546423778,171085705,501416011,1218925494,22647432793.608889,10988159321.608885,21521916005.622912,55157508120.840686,4246870,740553,2831190,7818613
2015-01-20,NASDAQ PSX (X),35897447,18227046,16375741,70500234,1288804829.159999,1069616616.772200,583052029.525200,2941473475.457399,261950,73075,101318,436343
2015-01-20,BATS BYX (Y),134900616,63752723,67014100,265667439,4404457815.221889,3026119886.007301,2375765018.619706,9806342719.848896,1075844,262043,506646,1844533
2015-01-20,BATS BZX (Z),322737510,151127319,154966170,628830999,11673636236.908971,8654962404.399494,5954772768.186239,26283371409.494704,2471668,642688,1165805,4280161
2015-01-16,NYSE MKT (A),0,13882141,7062536,20944677,0.000000,94793779.513500,175339493.853500,270133273.367000,0,29775,27845,57620
2015-01-16,NASDAQ BX (B),65696640,40431941,34390232,140518813,2402853464.467794,2276808386.990201,1409793792.285792,6089455643.743787,550649,182602,285725,1018976
2015-01-16,NYSE (DN),138278095,39911106,77069000,255258201,5459356396.520908,2070801047.228798,3031267200.412598,10561424644.162304,547380,123376,283862,954618
2015-01-16,NASDAQ (DQ),1081551330,531664622,603750171,2216966123,37871532283.723327,31243766143.631483,20620558782.073356,89735857209.428166,3797538,875306,1878810,6551654
2015-01-16,ADF (D),28386105,19170664,15908498,63465267,820150953.169901,655005388.778200,499292295.280700,1974448637.228801,122922,49644,70513,243079
2015-01-16,EDGA (J),109143427,58283016,55320002,222746445,3754811100.316689,2687793741.966602,1942004815.218614,8384609657.501905,919859,258809,426941,1605609
2015-01-16,EDGX (K),183581854,109901209,126332577,419815640,6134988137.204788,5146881092.723700,4547166922.001967,15829036151.930455,1091144,368230,670057,2129431
2015-01-16,CHX (M),21053509,16506776,16656696,54216981,695552322.259500,2397049813.866603,1473630810.628401,4566232946.754504,628,5994,1090,7712
2015-01-16,NYSE (N),975573456,0,0,975573456,38338409857.124163,0.000000,0.000000,38338409857.124163,2945473,0,0,2945473
2015-01-16,NYSE Arca (P),348938232,394623853,194557185,938119270,12949302972.109349,26973810475.945989,8511526005.966315,48434639454.021653,2357228,1094972,1312712,4764912
2015-01-16,NASDAQ (Q),585411981,209265452,582434377,1377111810,24230913214.177966,14198482412.275397,24233459796.078034,62662855422.531397,4516940,891989,3051835,8460764
2015-01-16,NASDAQ PSX (X),32286653,20892080,16806751,69985484,1123281190.114999,1241742413.735601,596361755.797199,2961385359.647799,232910,83383,100915,417208
2015-01-16,BATS BYX (Y),142000323,68129557,68935064,279064944,4544336481.489579,3672331891.317004,2367074856.599305,10583743229.405888,1134951,309803,530621,1975375
2015-01-16,BATS BZX (Z),352419373,189556521,174293981,716269875,12781222954.192898,11334066810.217505,6712010795.349968,30827300559.760371,2690101,776511,1272865,4739477
2015-01-15,NYSE MKT (A),0,14679250,9710512,24389762,0.000000,102857912.624500,204735506.250600,307593418.875100,0,37021,36148,73169
2015-01-15,NASDAQ BX (B),70890145,38624133,35879296,145393574,2448247521.405607,2054647988.055499,1406335321.780402,5909230831.241508,571837,179208,283259,1034304
2015-01-15,NYSE (DN),147678684,42915899,75166218,265760801,5417236642.674903,2302596066.188395,3091278641.408720,10811111350.272018,555366,126582,272720,954668
2015-01-15,NASDAQ (DQ),1234969938,473091407,614378318,2322439663,40499049118.797226,24648403308.784500,21453063362.250357,86600515789.832083,3897483,918503,1881703,6697689
2015-01-15,ADF (D),32188191,21655546,21870825,75714562,868693042.065999,707428308.985200,641080457.177399,2217201808.228598,133231,56741,82654,272626
2015-01-15,EDGA (J),112551095,57650905,52609261,222811261,3520566246.986210,2645882599.748999,1674934161.984705,7841383008.719914,906605,268980,400914,1576499
2015-01-15,EDGX (K),202346933,113640425,139041734,455029092,6599326675.143167,5188899556.716788,4970028111.534879,16758254343.394834,1216374,396027,749575,2361976
2015-01-15,CHX (M),14712656,13532615,7210425,35455696,521778915.960600,1568039641.431200,425560555.248600,2515379112.640400,961,8091,1592,10644
2015-01-15,NYSE (N),879882833,0,0,879882833,31095283424.053177,0.000000,0.000000,31095283424.053177,2981594,0,0,2981594
2015-01-15,NYSE Arca (P),391048236,387556106,203362977,981967319,14159792256.947454,25006836817.266342,8740117802.791182,47906746877.004978,2580579,1201627,1388897,5171103
2015-01-15,NASDAQ (Q),641917525,232698300,559035552,1433651377,26109469691.949185,15730833281.939979,22767363030.090986,64607666003.980150,4947502,1037585,3268680,9253767
2015-01-15,NASDAQ PSX (X),33492858,25292854,17605495,76391207,1141385537.179999,1374277295.008001,641501156.227101,3157163988.415101,232261,105089,107382,444732
2015-01-15,BATS BYX (Y),150215863,73309929,72680162,296205954,4665039074.722283,3675723562.247700,2534760833.123304,10875523470.093287,1170250,344708,552596,2067554
2015-01-15,BATS BZX (Z),370129182,201356014,173566317,745051513,12641739941.998610,12075165325.936203,6631265591.460466,31348170859.395279,2729468,859824,1261203,4850495
2015-01-14,NYSE MKT (A),0,14905639,9847172,24752811,0.000000,174418523.927499,231365851.292600,405784375.220099,0,35972,36725,72697
2015-01-14,NASDAQ BX (B),75303335,43145169,37993625,156442129,2619180824.269290,2372418093.638004,1629853742.942700,6621452660.849994,639798,194881,311060,1145739
2015-01-14,NYSE (DN),158162608,43565734,82627802,284356144,5449277796.728724,2441839228.242299,3100139563.480550,10991256588.451573,573253,125328,283301,981882
2015-01-14,NASDAQ (DQ),1223644462,484227028,648691770,2356563260,39814542126.418034,25402082423.319781,21785154273.888616,87001778823.626431,4060481,941188,1901903,6903572
2015-01-14,ADF (D),37236718,21236851,23985455,82459024,985372101.534899,729314279.642299,690565195.581600,2405251576.758798,147183,60200,83569,290952
2015-01-14,EDGA (J),129539575,59588845,57882801,247011221,4406275124.765106,2739201209.964400,1965358580.879897,9110834915.609403,1072350,267147,439746,1779243
2015-01-14,EDGX (K),186577930,106134695,132113628,424826253,6275541255.287002,5303424308.019413,4812219112.687090,16391184675.993505,1162466,374358,701945,2238769
2015-01-14,CHX (M),16244849,12198613,5333209,33776671,626692276.310000,1327941450.733600,266017659.082500,2220651386.126100,824,6752,1395,8971
2015-01-14,NYSE (N),928606101,0,0,928606101,33568718534.805929,0.000000,0.000000,33568718534.805929,3078139,0,0,3078139
2015-01-14,NYSE Arca (P),410298746,397363578,239842349,1047504673,14719280343.020386,26840050374.331210,9566220472.419385,51125551189.770981,2744399,1220711,1494842,5459952
2015-01-14,NASDAQ (Q),654275635,227139258,568955039,1450369932,26497167474.611963,15556691497.206136,22939096391.964144,64992955363.782243,5058887,957128,3251319,9267334
2015-01-14,NASDAQ PSX (X),34165464,27838055,22287453,84290972,1111380789.879999,1398363057.052996,723367779.320299,3233111626.253294,244982,111007,118938,474927
2015-01-14,BATS BYX (Y),152838978,75172987,72148319,300160284,4752169585.442881,3657974203.556605,2421448360.074611,10831592149.074097,1213815,335349,538312,2087476
2015-01-14,BATS BZX (Z),382900765,189174993,188440387,760516145,13396490986.996855,12113571422.427522,6913649380.052586,32423711789.476963,2909403,810249,1345846,5065498
2015-01-13,NYSE MKT (A),0,15073314,8033740,23107054,0.000000,95398776.122400,243103158.806799,338501934.929199,0,33575,28924,62499
2015-01-13,NASDAQ BX (B),68223917,39567059,39534502,147325478,2411084648.800608,2244073015.011700,1625904153.458997,6281061817.271305,577406,178014,308888,1064308
2015-01-13,NYSE (DN),139482396,41833348,85635534,266951278,5105568049.510057,2513766774.129509,3727093592.491553,11346428416.131119,539843,125621,294969,960433
2015-01-13,NASDAQ (DQ),1134603726,469532804,688787884,2292924414,37543659490.495416,28386036548.787869,24476613697.446823,90406309736.730108,3880398,906578,2072731,6859707
2015-01-13,ADF (D),35294734,19076285,24741121,79112140,970474707.356700,692766367.339499,735317444.433699,2398558519.129898,135948,52455,91793,280196
2015-01-13,EDGA (J),118550006,52606459,56189950,227346415,3942568646.728093,2682303392.219896,2004419676.182099,8629291715.130088,997292,248251,446704,1692247
2015-01-13,EDGX (K),171029842,88462268,125469187,384961297,5730168703.783972,4663034271.740895,4776298668.799248,15169501644.324115,1087367,329958,700994,2118319
2015-01-13,CHX (M),15324625,11528569,6671182,33524376,533430137.104100,1165904168.937200,369942741.080000,2069277047.121300,762,5415,1266,7443
2015-01-13,NYSE (N),876291475,0,0,876291475,31866478939.401074,0.000000,0.000000,31866478939.401074,3135174,0,0,3135174
2015-01-13,NYSE Arca (P),371642530,374499206,230464430,976606166,13489301686.968392,26626032793.074854,10259426723.632382,50374761203.675628,2578985,1180669,1532047,5291701
2015-01-13,NASDAQ (Q),645166075,221602544,606271073,1473039692,26422872151.762063,15155262262.199966,25501522083.433552,67079656497.395581,5058026,956518,3575870,9590414
2015-01-13,NASDAQ PSX (X),33953368,21265389,21021195,76239952,1105214160.385001,1177821792.609701,728845616.345397,3011881569.340099,244501,90229,121650,456380
2015-01-13,BATS BYX (Y),140761571,66019525,79470263,286251359,4396544252.704011,3406367888.518796,2760793091.114314,10563705232.337121,1154348,292879,588355,2035582
2015-01-13,BATS BZX (Z),358448753,196639567,194287385,749375705,12768900009.866693,13735742526.113024,7733408141.376377,34238050677.356094,2798788,830334,1411541,5040663
2015-01-12,NYSE MKT (A),0,14783200,8741470,23524670,0.000000,86096206.605900,262976855.073400,349073061.679300,0,28340,34955,63295
2015-01-12,NASDAQ BX (B),58635930,31864424,34957827,125458181,2090943113.385700,1866360302.054001,1486970492.768295,5444273908.207996,505829,145897,271415,923141
2015-01-12,NYSE (DN),120611728,33091887,77614695,231318310,4537377362.901804,1653691907.402699,3307388834.555290,9498458104.859793,470158,101137,279891,851186
2015-01-12,NASDAQ (DQ),989483924,417085031,615541077,2022110032,33030274530.006873,21703766043.964758,22492514544.651482,77226555118.623113,3526696,806263,1894678,6227637
2015-01-12,ADF (D),32610407,19711777,26846385,79168569,851617353.338398,643143598.813199,738872154.345800,2233633106.497397,123299,48485,86669,258453
2015-01-12,EDGA (J),84567589,36075688,44191928,164835205,2946044659.330497,1800831748.269400,1653058228.733102,6399934636.332999,726876,163268,338934,1229078
2015-01-12,EDGX (K),114175034,52762610,84252031,251189675,4013790428.705004,2583602124.816196,3340541636.669597,9937934190.190797,764608,192410,505270,1462288
2015-01-12,CHX (M),12535372,6148546,3607752,22291670,431645808.639500,547797346.120000,258603497.550000,1238046652.309500,380,3142,1145,4667
2015-01-12,NYSE (N),778514604,0,0,778514604,29069010083.587354,0.000000,0.000000,29069010083.587354,2552121,0,0,2552121
2015-01-12,NYSE Arca (P),309491900,323413504,204340974,837246378,11517279464.165320,21760715047.346536,8852492828.258572,42130487339.770428,2166787,868785,1339210,4374782
2015-01-12,NASDAQ (Q),519544235,161059475,520861120,1201464830,21510258008.118906,10411640739.866324,21747506131.290512,53669404879.275742,4117656,679047,2934399,7731102
2015-01-12,NASDAQ PSX (X),30511713,16784102,20275886,67571701,1017452224.344999,968517243.650001,699938993.322802,2685908461.317802,228614,72572,110105,411291
2015-01-12,BATS BYX (Y),120956897,55626433,65290601,241873931,3928222141.558009,2831000145.184807,2358175494.618869,9117397781.361685,1006020,250564,491786,1748370
2015-01-12,BATS BZX (Z),293969666,137502241,158482594,589954501,10292434118.202428,7996930428.041310,6110677820.308809,24400042366.552547,2283161,587457,1161556,4032174
2015-01-09,NYSE MKT (A),0,10711876,7863559,18575435,0.000000,83746152.580500,268739562.906199,352485715.486699,0,23981,31191,55172
2015-01-09,NASDAQ BX (B),63339174,28284676,31720120,123343970,2206323104.798404,1768747449.410797,1325872597.787695,5300943151.996896,507773,138410,254773,900956
2015-01-09,NYSE (DN),124887467,33671417,67907936,226466820,4762918251.810680,1831131228.917097,2915365586.655608,9509415067.383385,462241,109157,252409,823807
2015-01-09,NASDAQ (DQ),974971586,368142849,567802909,1910917344,32613242778.969772,20411872919.107202,19602719616.551849,72627835314.628823,3308910,766118,1753465,5828493
2015-01-09,ADF (D),26951651,15113461,21564930,63630042,730357749.666700,524619240.259100,671695381.607100,1926672371.532900,110975,42043,81130,234148
2015-01-09,EDGA (J),89967834,44809758,45454187,180231779,2855390469.555306,2363283925.752003,1611522705.586808,6830197100.894117,741550,223203,361616,1326369
2015-01-09,EDGX (K),157292064,79125993,126702797,363120854,5317467818.119204,4087747698.126394,4598701072.583205,14003916588.828803,933565,273593,667159,1874317
2015-01-09,CHX (M),10527708,6619076,3938862,21085646,456945854.021400,723275004.136000,198120478.222000,1378341336.379400,374,3852,1648,5874
2015-01-09,NYSE (N),732141918,0,0,732141918,27668259089.141935,0.000000,0.000000,27668259089.141935,2471289,0,0,2471289
2015-01-09,NYSE Arca (P),290547967,286065473,169516006,746129446,10954984742.488689,19757679372.109007,7525098148.086149,38237762262.683845,2055024,884687,1192585,4132296
2015-01-09,NASDAQ (Q),479737397,159385271,460886809,1100009477,20587352332.711814,11806116525.611787,19938321445.666842,52331790303.990443,3834627,696943,2761737,7293307
2015-01-09,NASDAQ PSX (X),29306632,18161471,15057186,62525289,1031071493.920000,1114115844.400000,534716816.340099,2679904154.660099,213852,78257,94223,386332
2015-01-09,BATS BYX (Y),119177193,50367995,59276232,228821420,3817575205.966514,2804919812.540398,2110899673.708802,8733394692.215714,956296,230726,461310,1648332
2015-01-09,BATS BZX (Z),270929524,138626053,141679730,551235307,9177383317.719008,9245544152.586656,5575231344.517802,23998158814.823466,2076744,612374,1065879,3754997
2015-01-08,NYSE MKT (A),0,13048919,8307093,21356012,0.000000,80132856.696100,213783910.387600,293916767.083700,0,28278,32478,60756
2015-01-08,NASDAQ BX (B),74092171,31070779,40032561,145195511,2623014438.693502,1963355849.606101,1648933138.011602,6235303426.311205,620524,152167,327903,1100594
2015-01-08,NYSE (DN),145027536,34985562,85524652,265537750,5758982882.876688,1754931073.560803,3527487731.828431,11041401688.265922,548238,110659,302583,961480
2015-01-08,NASDAQ (DQ),1230107767,404624546,710357341,2345089654,42798635380.488505,23063778034.036122,24544185425.118126,90406598839.642753,3868268,832066,2062842,6763176
2015-01-08,ADF (D),30644506,17405514,24505351,72555371,789191470.633202,574477246.018999,686489619.152897,2050158335.805098,122787,47749,85916,256452
2015-01-08,EDGA (J),107985507,45117737,58082361,211185605,3858809076.608702,2513301825.083797,2083022891.859395,8455133793.551894,899956,216215,446378,1562549
2015-01-08,EDGX (K),177900881,85839647,149530859,413271387,6202956068.176594,4517902735.591086,5213156074.086895,15934014877.854575,1042860,285527,754279,2082666
2015-01-08,CHX (M),16449421,7714623,7119448,31283492,676320349.493000,573109270.745300,393009225.224000,1642438845.462300,481,2421,590,3492
2015-01-08,NYSE (N),848164336,0,0,848164336,32353720975.966386,0.000000,0.000000,32353720975.966386,2556622,0,0,2556622
2015-01-08,NYSE Arca (P),307583721,280398122,195986927,783968770,11944740163.385028,18696579679.911110,8253771841.618053,38895091684.914191,2167414,825817,1320032,4313263
2015-01-08,NASDAQ (Q),535205068,153252120,578130486,1266587674,23488659939.763360,11072056631.446700,24459887108.467358,59020603679.677418,4251599,641194,3075875,7968668
2015-01-08,NASDAQ PSX (X),31487867,17261286,18369203,67118356,1110433954.525000,999099150.726600,603535231.228400,2713068336.480000,228376,67417,105778,401571
2015-01-08,BATS BYX (Y),143105156,52420037,72447771,267972964,4615085903.840088,2946964197.359002,2489192944.537487,10051243045.736577,1125796,237440,543642,1906878
2015-01-08,BATS BZX (Z),290736386,136657274,161180033,588573693,10083857551.893616,9036816827.333009,6051810667.430756,25172485046.657381,2209590,572866,1189240,3971696
2015-01-07,NYSE MKT (A),0,12460817,9344027,21804844,0.000000,104525723.103900,218605979.672299,323131702.776199,0,30824,39375,70199
2015-01-07,NASDAQ BX (B),75074319,33905615,40573414,149553348,2671669501.860111,1872352346.346397,1481423693.178400,6025445541.384908,653565,167013,328258,1148836
2015-01-07,NYSE (DN),150118985,37901468,89149271,277169724,5628260103.696704,1972170889.118209,3084840781.232527,10685271774.047440,576621,111519,287893,976033
2015-01-07,NASDAQ (DQ),1130964574,396752191,641307211,2169023976,37507148924.065029,19810823204.098894,20501828459.657615,77819800587.821538,3743171,827686,1893951,6464808
2015-01-07,ADF (D),29913830,16083547,24507937,70505314,816560093.657799,515806506.129800,626644279.012200,1959010878.799799,123491,47488,83168,254147
2015-01-07,EDGA (J),105588627,47886837,56691261,210166725,3503853589.144206,2293840436.779500,1822995224.043592,7620689249.967298,884997,236649,433146,1554792
2015-01-07,EDGX (K),181074379,92902616,147076363,421053358,6013359942.636499,4765635814.283404,4692586322.916860,15471582079.836763,1083374,322049,746741,2152164
2015-01-07,CHX (M),13454370,7946252,6314609,27715231,547990612.789000,662067838.128200,347876838.528100,1557935289.445300,468,3374,921,4763
2015-01-07,NYSE (N),777650596,0,0,777650596,28615399120.459369,0.000000,0.000000,28615399120.459369,2682362,0,0,2682362
2015-01-07,NYSE Arca (P),321919861,309067353,194995077,825982291,11807999301.714175,19062612482.613920,7732539371.324795,38603151155.652890,2260441,954073,1302681,4517195
2015-01-07,NASDAQ (Q),557404255,168878435,508753568,1235036258,23777135380.819860,11223224751.033378,19951194636.616174,54951554768.469412,4436481,745811,2994185,8176477
2015-01-07,NASDAQ PSX (X),31880003,17936934,19198188,69015125,1121209560.964002,955330698.398100,600228968.264401,2676769227.626503,234444,78602,104844,417890
2015-01-07,BATS BYX (Y),130846372,58089616,68810153,257746141,4247194071.614580,2925822112.707103,2253692987.964905,9426709172.286588,1065192,262606,516237,1844035
2015-01-07,BATS BZX (Z),304134755,151732189,158820278,614687222,10414809081.788712,9228239982.818378,5572298082.243673,25215347146.850763,2346783,653831,1173588,4174202
2015-01-06,NYSE MKT (A),0,16146905,8596420,24743325,0.000000,107432019.256100,229302598.748599,336734618.004699,0,34353,33402,67755
2015-01-06,NASDAQ BX (B),82965949,42595040,45181618,170742607,3011875436.567111,2605469393.647201,1962319181.137301,7579664011.351613,709623,201663,365925,1277211
2015-01-06,NYSE (DN),159182625,49638975,86467478,295289078,6135525279.456676,2922796891.557399,3666864566.160378,12725186737.174453,625534,148278,300296,1074108
2015-01-06,NASDAQ (DQ),1279449516,530694304,674665222,2484809042,44076652595.434347,31079144302.144706,24772605579.383782,99928402476.962835,4333999,1063201,2147358,7544558
2015-01-06,ADF (D),34980202,21448902,23670884,80099988,944936158.326301,752401385.871100,748960357.891499,2446297902.088900,149432,64123,99034,312589
2015-01-06,EDGA (J),130495834,65914760,65781202,262191796,4377730502.018698,3378307519.702896,2392327618.298807,10148365640.020401,1095048,323025,519593,1937666
2015-01-06,EDGX (K),218236547,120127658,153532268,491896473,7365177510.335992,6059365497.907162,5629798642.214534,19054341650.457688,1322590,412033,833686,2568309
2015-01-06,CHX (M),9072614,11773700,4819479,25665793,406920545.710800,1155459345.082400,249569491.644000,1811949382.437200,847,5459,1081,7387
2015-01-06,NYSE (N),942439232,0,0,942439232,34043393024.078623,0.000000,0.000000,34043393024.078623,3183986,0,0,3183986
2015-01-06,NYSE Arca (P),389726928,391556457,222550405,1003833790,14726594611.816861,26219455257.343192,9939174886.183396,50885224755.343449,2790065,1272239,1556916,5619220
2015-01-06,NASDAQ (Q),665686153,227490733,599086429,1492263315,28179898514.034143,16249261823.319198,24924638650.306850,69353798987.660191,5470768,1038077,3615953,10124798
2015-01-06,NASDAQ PSX (X),37588126,21838166,21051989,80478281,1339851099.496900,1287445200.349000,764464849.612901,3391761149.458801,281114,89483,128767,499364
2015-01-06,BATS BYX (Y),160360217,71291734,84222163,315874114,5213988882.315220,3810688925.636513,2993021847.897603,12017699655.849336,1326282,330683,631114,2288079
2015-01-06,BATS BZX (Z),357755396,198401781,185042478,741199655,12667034974.787463,13842709807.056070,7230690928.825055,33740435710.668588,2827810,872011,1376344,5076165
2015-01-05,NYSE MKT (A),0,14985208,7479354,22464562,0.000000,193550687.118900,206168190.626500,399718877.745400,0,34095,29583,63678
2015-01-05,NASDAQ BX (B),73036671,37677505,36040482,146754658,2658504074.375599,2128371249.330295,1482525683.277887,6269401006.983781,640315,177003,311525,1128843
2015-01-05,NYSE (DN),132983082,39948859,70085594,243017535,5077822169.573299,2314330910.335197,3098029510.619036,10490182590.527532,524377,126739,261567,912683
2015-01-05,NASDAQ (DQ),1087335168,538750072,568621701,2194706941,36620617537.601565,31508362341.842822,21257961106.659705,89386940986.104092,3917233,1016932,1921263,6855428
2015-01-05,ADF (D),26896172,17013256,17178982,61088410,769537914.403100,640368918.587400,559914730.060800,1969821563.051300,122683,50644,75837,249164
2015-01-05,EDGA (J),110929586,55141242,52266514,218337342,3926485507.007795,2895345991.261898,1978976130.224907,8800807628.494600,962238,268564,432068,1662870
2015-01-05,EDGX (K),199161329,106324287,139803213,445288829,6700898238.094595,5246511864.111495,5201447414.988171,17148857517.194261,1145451,353647,742505,2241603
2015-01-05,CHX (M),6545582,9618435,2417557,18581574,383170706.378800,928005283.582400,147465008.699500,1458640998.660700,726,4471,746,5943
2015-01-05,NYSE (N),844819500,0,0,844819500,31557007746.228566,0.000000,0.000000,31557007746.228566,2747973,0,0,2747973
2015-01-05,NYSE Arca (P),313701846,351105399,175745572,840552817,12230067646.087001,22516650743.366039,7950084939.007955,42696803328.460995,2301502,1042228,1285098,4628828
2015-01-05,NASDAQ (Q),544535055,185747257,504969621,1235251933,23721680914.901158,12845320922.021944,22024082186.254050,58591084023.177152,4466616,797165,2986778,8250559
2015-01-05,NASDAQ PSX (X),31440921,18779518,14961429,65181868,1153330841.565000,1123756768.422400,579301409.357999,2856389019.345399,240580,79280,97687,417547
2015-01-05,BATS BYX (Y),138926187,67992282,66292996,273211465,4502237026.039805,3461245038.759794,2314183056.595401,10277665121.395000,1148659,287715,520250,1956624
2015-01-05,BATS BZX (Z),294471105,163946463,143802524,602220092,10339705824.747032,10969941215.116229,5610696187.743745,26920343227.607006,2331846,674877,1119935,4126658
2015-01-02,NYSE MKT (A),0,10801819,5938931,16740750,0.000000,66125212.993100,144259815.546000,210385028.539100,0,26188,23399,49587
2015-01-02,NASDAQ BX (B),52908412,32183424,28802230,113894066,1875999702.803709,1755367885.529200,1122873745.547804,4754241333.880713,478329,150751,242781,871861
2015-01-02,NYSE (DN),83301519,33513242,56639882,173454643,3130640858.314814,1855334577.720307,2216160201.584828,7202135637.619949,345920,100379,205021,651320
2015-01-02,NASDAQ (DQ),704335251,384828113,448131396,1537294760,23798677786.020162,21931786729.038978,15371067800.962109,61101532316.021249,2661536,772777,1490563,4924876
2015-01-02,ADF (D),18728285,13043690,14265642,46037617,507458378.184300,507260312.477700,419693392.283700,1434412082.945700,80904,43617,55511,180032
2015-01-02,EDGA (J),71781841,43852989,39778402,155413232,2235555591.755197,2236743907.777495,1326000501.618298,5798300001.150990,611414,210347,315690,1137451
2015-01-02,EDGX (K),142051349,81056276,117311184,340418809,4671482794.088584,4246308792.842200,4052891036.044505,12970682622.975289,815303,275649,579447,1670399
2015-01-02,CHX (M),3293025,4708853,1781373,9783251,192749296.240000,585510223.217400,119362905.671200,897622425.128600,623,2757,709,4089
2015-01-02,NYSE (N),645852677,0,0,645852677,24187440459.022139,0.000000,0.000000,24187440459.022139,2209508,0,0,2209508
2015-01-02,NYSE Arca (P),239768755,298710997,142806420,681286172,8915568977.665364,19210447409.728996,6203020264.847387,34329036652.241747,1759951,858838,1010183,3628972
2015-01-02,NASDAQ (Q),398505468,155627593,400988629,955121690,16571053207.663544,10829210067.767943,17009917023.987844,44410180299.419331,3267835,698086,2364083,6330004
2015-01-02,NASDAQ PSX (X),22115445,13463186,12223911,47802542,736943769.145101,805592107.683300,407191033.845201,1949726910.673602,169370,60393,73962,303725
2015-01-02,BATS BYX (Y),98700957,51450185,52581497,202732639,3215748437.998711,2608699977.080795,1781692050.690515,7606140465.770021,838640,241601,406282,1486523
2015-01-02,BATS BZX (Z),229553122,133596552,116136862,479286536,7562904463.143762,8620480617.917901,4392490046.795871,20575875127.857534,1745698,593542,887925,3227165
