Day,Market Participant,Tape A Shares,Tape B Shares,Tape C Shares,Total Shares,Tape A Notional,Tape B Notional,Tape C Notional,Total Notional,Tape A Trade Count,Tape B Trade Count,Tape C Trade Count,Total Trade Count
2009-01-02,AMEX (A),0,13971152,0,13971152,0.0,42709388.76,0.0,42709388.76,0,22505,0,22505
2009-01-02,NSX (C),28065630,9192024,11269932,48527586,575147252.741,308425792.11,234117095.213,1117690140.06,126559,17491,53606,197656
2009-01-02,NYSE (DN),8273504,1104932,7137599,16516035,174043225.29,34103464.8246,101542033.384,309688723.499,21366,1864,18578,41808
2009-01-02,NASDAQ (DQ),903716232,326848691,470658084,1701223007,15986203478.9,10976558917.5,7554188059.83,34516950456.2,2439967,544212,1055833,4040012
2009-01-02,ADF (D),33316584,3472271,9147514,45936369,824219824.75,146164247.375,176075108.086,1146459180.21,146966,11190,36507,194663
2009-01-02,ISE (I),51485469,10744201,21367101,83596771,796892856.621,330972476.85,302529554.629,1430394888.1,170268,26933,78925,276126
2009-01-02,CHX (M),15598269,6685591,3627549,25911409,445081029.435,516833467.77,92307674.085,1054222171.29,32525,6387,7521,46433
2009-01-02,NYSE (N),1046855177,0,0,1046855177,23962931861.1,0.0,0.0,23962931861.1,3577976,0,0,3577976
2009-01-02,NYSE Arca (P),504024132,381839418,239831980,1125695530,11662694010.3,16412675437.9,4889232094.55,32964601542.8,3134147,1248293,1179997,5562437
2009-01-02,NASDAQ (Q),668480545,434835241,544326515,1647642301,15609484048.3,19455926912.1,11063185471.0,46128596431.4,3949145,1509697,2232925,7691767
2009-01-02,CBOE (W),1082800,6531100,1519000,9132900,24377122.8,368407268.0,38689306.0,431473696.8,1404,9622,6182,17208
2009-01-02,BATS (Z),307899122,213592396,166207517,687699035,7540630099.11,9583129060.7,3284595805.11,20408354964.9,2159625,971709,951153,4082487
2009-01-05,AMEX (A),0,16908362,0,16908362,0.0,54999348.35,0.0,54999348.35,0,25695,0,25695
2009-01-05,NSX (C),36394960,9157927,14177233,59730120,692059675.001,307497040.688,307279405.378,1306836121.07,139926,17403,63435,220764
2009-01-05,NYSE (DN),12398974,1277830,9083916,22760720,252365352.398,45140051.94,134106329.122,431611733.46,33384,2144,24130,59658
2009-01-05,NASDAQ (DQ),1255440826,423598380,597701046,2276740252,22870593939.0,15193357237.2,9855586868.03,47919538044.2,3380960,623671,1405188,5409819
2009-01-05,ADF (D),33191439,5340200,11100643,49632282,826348658.264,191628731.085,206447499.985,1224424889.33,141676,15450,42819,199945
2009-01-05,ISE (I),70665629,13584073,26749830,110999532,1029158079.89,379935348.974,390268376.2,1799361805.06,237497,32928,99661,370086
2009-01-05,CHX (M),16956214,12902044,5891350,35749608,546799911.265,941751061.285,161377892.162,1649928864.71,50898,9784,11609,72291
2009-01-05,NYSE (N),1323406968,0,0,1323406968,30629930809.0,0.0,0.0,30629930809.0,4623265,0,0,4623265
2009-01-05,NYSE Arca (P),694836260,452859214,286094236,1433789710,16323625039.4,18710459186.9,6298007203.72,41332091430.0,4306999,1521281,1510965,7339245
2009-01-05,NASDAQ (Q),965428024,514752498,675935219,2156115741,22226205676.4,22734685183.1,14270351181.3,59231242040.7,5749232,1920036,3078376,10747644
2009-01-05,CBOE (W),1701000,5938700,1400400,9040100,37953016.0,331648224.0,38198248.0,407799488.0,2094,7441,7368,16903
2009-01-05,BATS (Z),443728659,261447424,208317300,913493383,10892471842.3,11408033782.0,4274899961.53,26575405585.9,3027335,1211272,1243762,5482369
2009-01-06,AMEX (A),0,15900218,0,15900218,0.0,58295441.1,0.0,58295441.1,0,27122,0,27122
2009-01-06,NSX (C),41364431,10616927,16361796,68343154,874490518.72,358060766.102,357274087.977,1589825372.8,176938,20517,76370,273825
2009-01-06,NYSE (DN),12818741,1180138,10952720,24951599,272141212.537,38377431.1005,158832183.76,469350827.398,31559,1798,24860,58217
2009-01-06,NASDAQ (DQ),1433221518,453693217,720384943,2607299678,27437889200.9,16226795544.7,11652064877.1,55316749622.7,3638434,729723,1557041,5925198
2009-01-06,ADF (D),52677592,3990469,19606253,76274314,1281698941.5,179427764.905,362211668.351,1823338374.75,220904,13885,80724,315513
2009-01-06,ISE (I),84727669,18467155,35325074,138519898,1395248435.48,504302267.322,502902615.996,2402453318.8,299132,38564,125037,462733
2009-01-06,CHX (M),27219934,9366105,7218055,43804094,664915853.982,600192247.35,156873747.69,1421981849.02,56205,7323,13713,77241
2009-01-06,NYSE (N),1335278477,0,0,1335278477,31421143943.6,0.0,0.0,31421143943.6,5031447,0,0,5031447
2009-01-06,NYSE Arca (P),777840776,492239125,357451680,1627531581,19227102019.6,22333507424.5,7553725409.51,49114334853.6,4876868,1674496,1796815,8348179
2009-01-06,NASDAQ (Q),1134340143,612561000,788815908,2535717051,27437431634.0,28671535037.7,16707121290.2,72816087961.9,6812788,2364708,3623321,12800817
2009-01-06,CBOE (W),1046100,9226000,2660100,12932200,27556890.0,628734089.5,73558998.8,729849978.3,2222,8724,7899,18845
2009-01-06,BATS (Z),494233313,289073915,238048941,1021356169,12968370112.4,12975138586.9,4915163116.7,30858671816.0,3550421,1398186,1439893,6388500
2009-01-07,AMEX (A),0,16208898,0,16208898,0.0,57467244.31,0.0,57467244.31,0,24333,0,24333
2009-01-07,NSX (C),34620430,9791131,14245004,58656565,733810097.727,307124777.808,272896515.851,1313831391.39,150789,20227,67764,238780
2009-01-07,NYSE (DN),11149694,1261344,8841082,21252120,235744337.471,38826286.16,129740065.971,404310689.601,28396,1896,21645,51937
2009-01-07,NASDAQ (DQ),1234130370,415445576,643288250,2292864196,23468908265.9,14872797174.5,10091269515.5,48432974955.9,3132023,691317,1393331,5216671
2009-01-07,ADF (D),30791790,4883108,14256074,49930972,755798100.635,176360754.095,254597630.705,1186756485.44,128425,13661,49901,191987
2009-01-07,ISE (I),67076043,17242993,32810366,117129402,1154254065.83,478002016.825,449121007.283,2081377089.94,248886,42382,106111,397379
2009-01-07,CHX (M),28958839,9998963,5431182,44388984,713216883.278,723033599.03,112093719.37,1548344201.68,39352,6732,10195,56279
2009-01-07,NYSE (N),1235559045,0,0,1235559045,28594297401.0,0.0,0.0,28594297401.0,4354964,0,0,4354964
2009-01-07,NYSE Arca (P),678409202,452689213,338541857,1469640272,16324254136.3,19510345157.7,6589716093.62,42424315387.6,4180034,1492190,1614849,7287073
2009-01-07,NASDAQ (Q),967637814,534887948,810617745,2313143507,22576445141.8,24462829586.1,15730680795.0,62769955522.9,5716393,1935144,3353002,11004539
2009-01-07,CBOE (W),1805700,5410200,2220700,9436600,42813604.3,310425340.0,53695090.0,406934034.3,2398,6873,8081,17352
2009-01-07,BATS (Z),415424678,245020926,218092963,878538567,9996771521.55,10661686738.6,4143629649.38,24802087909.5,2879038,1136977,1250125,5266140
2009-01-08,AMEX (A),0,13586891,0,13586891,0.0,59506991.8,0.0,59506991.8,0,24350,0,24350
2009-01-08,NSX (C),31519867,2663041,12479396,46662304,570487755.402,92242938.3136,239875537.462,902606231.178,122256,6064,53266,181586
2009-01-08,NYSE (DN),13846097,868657,7610649,22325403,274552149.262,30646663.02,114933212.086,420132024.368,31348,1500,19030,51878
2009-01-08,NASDAQ (DQ),1129274391,381191761,649874368,2160340520,21169684217.7,13681752650.5,9874817819.31,44726254687.5,3016963,609554,1315260,4941777
2009-01-08,ADF (D),30950043,3144432,12382718,46477193,804104087.395,141507889.3,217925938.631,1163537915.33,122945,10765,45466,179176
2009-01-08,ISE (I),59740795,17251430,33847389,110839614,1070422000.94,471310032.07,436759958.474,1978491991.49,235910,39183,103501,378594
2009-01-08,CHX (M),20815844,7987832,6543163,35346839,518226060.729,538489097.27,203485665.71,1260200823.71,34916,5783,9586,50285
2009-01-08,NYSE (N),1196663368,0,0,1196663368,27032741612.0,0.0,0.0,27032741612.0,4255181,0,0,4255181
2009-01-08,NYSE Arca (P),687366768,392535199,348006703,1427908670,16429015766.0,17173795608.7,6491191040.46,40094002415.2,4297114,1338079,1678994,7314187
2009-01-08,NASDAQ (Q),950314416,494432629,756296453,2201043498,22507978558.7,23140419030.2,14521488895.3,60169886484.3,5684976,1854675,3370578,10910229
2009-01-08,CBOE (W),2683500,7800300,1780400,12264200,73365669.2,486770492.0,50215829.35,610351990.55,1622,8424,8040,18086
2009-01-08,BATS (Z),389979111,229721525,206535372,826236008,9668347852.05,10237593914.1,3932021077.81,23837962844.0,2769714,1125222,1238928,5133864
2009-01-09,AMEX (A),0,10202812,0,10202812,0.0,47104385.34,0.0,47104385.34,0,22365,0,22365
2009-01-09,NSX (C),27925809,2209297,12248919,42384025,492814954.56,81773116.8812,233547109.67,808135181.112,109475,5675,48845,163995
2009-01-09,NYSE (DN),9608905,925049,7824727,18358681,217209962.544,31735741.26,118237670.463,367183374.267,22622,1601,19513,43736
2009-01-09,NASDAQ (DQ),1050891495,377569537,593631516,2022092548,19626391058.4,14165469524.7,9227669530.98,43019530114.1,2827995,624883,1306110,4758988
2009-01-09,ADF (D),30603286,3299952,12469568,46372806,759723483.993,159690772.755,216660431.74,1136074688.49,130802,10447,48878,190127
2009-01-09,ISE (I),60758463,17052821,29524185,107335469,1077888042.79,454930374.621,404697720.771,1937516138.19,245430,41991,99520,386941
2009-01-09,CHX (M),17353248,7049648,7427035,31829931,476627355.988,465287122.25,106386276.95,1048300755.19,30555,4454,5509,40518
2009-01-09,NYSE (N),1158588100,0,500,1158588600,25528869982.1,0.0,22460.0,25528892442.1,4096880,0,1,4096881
2009-01-09,NYSE Arca (P),614588460,440891838,325364405,1380844703,14169720012.7,19759354756.0,6197500556.11,40126575324.7,3846407,1403837,1620485,6870729
2009-01-09,NASDAQ (Q),876124236,558462151,778022908,2212609295,19696511552.1,26608528958.7,14953343549.1,61258384059.8,5196874,1917816,3285542,10400232
2009-01-09,CBOE (W),3275800,10576800,1621700,15474300,88079531.7,723619977.14,45871663.0,857571171.84,8382,9358,6758,24498
2009-01-09,BATS (Z),373911064,234951282,199044191,807906537,9110628803.44,10634516265.4,3847074521.87,23592219590.7,2691407,1098533,1211354,5001294
2009-01-12,AMEX (A),0,14288244,0,14288244,0.0,51717140.85,0.0,51717140.85,0,25548,0,25548
2009-01-12,NSX (C),38723293,2528589,11858239,53110121,720945025.247,79673829.0313,224454507.628,1025073361.91,148238,5830,53432,207500
2009-01-12,NYSE (DN),11308701,952098,8550780,20811579,233538260.619,27967224.4712,118760961.197,380266446.287,26348,1847,21462,49657
2009-01-12,NASDAQ (DQ),1215509938,402665921,568480810,2186656669,21031184049.1,13214785567.3,8413379656.26,42659349272.7,3099745,658313,1264912,5022970
2009-01-12,ADF (D),37495567,2685142,11513099,51693808,865288832.564,114918912.225,201140868.52,1181348613.31,148288,9319,44791,202398
2009-01-12,ISE (I),70330565,21569423,27886118,119786106,1089463191.72,485117469.742,382946698.394,1957527359.86,261739,43906,98163,403808
2009-01-12,CHX (M),19255615,8239682,5056214,32551511,487683170.477,490442367.83,131263727.535,1109389265.84,31012,4631,7547,43190
2009-01-12,NYSE (N),1305613653,0,0,1305613653,27296500034.3,0.0,0.0,27296500034.3,4125606,0,0,4125606
2009-01-12,NYSE Arca (P),697229534,446437086,295899116,1439565736,14852798429.0,19447987879.6,5458011238.46,39758797547.0,4016785,1316830,1461760,6795375
2009-01-12,NASDAQ (Q),927526420,485655675,690441239,2103623334,19396501256.2,21715837263.6,12686075133.1,53798413652.9,5146523,1636906,2932195,9715624
2009-01-12,CBOE (W),3301200,5598000,2055900,10955100,74854211.0,289133544.2,51136790.0,415124545.2,3066,6895,7712,17673
2009-01-12,BATS (Z),399845598,237638397,196427802,833911797,9270131405.26,10494609498.8,3718887201.11,23483628105.1,2728677,1087383,1194494,5010554
2009-01-13,AMEX (A),0,10370453,0,10370453,0.0,47128488.48,0.0,47128488.48,0,19856,0,19856
2009-01-13,NSX (C),36891788,4837235,13210835,54939858,623885619.581,144210089.699,278498602.559,1046594311.84,143000,9963,55942,208905
2009-01-13,NYSE (DN),10253623,925411,7050213,18229247,222343518.834,31364577.77,105140813.95,358848910.553,24796,1681,17012,43489
2009-01-13,NASDAQ (DQ),1293393703,440019510,586788850,2320202063,22702563394.5,15234157472.1,9488077075.57,47424797942.2,3388416,729296,1402790,5520502
2009-01-13,ADF (D),50065660,6110578,17077791,73254029,1147986152.01,200361436.57,364636825.118,1712984413.7,210237,14311,71248,295796
2009-01-13,ISE (I),64069651,19130825,26105255,109305731,1097517686.16,550677268.655,379669034.76,2027863989.57,252757,46228,93488,392473
2009-01-13,CHX (M),24056987,8360764,4366076,36783827,650634538.038,576429747.585,118632238.19,1345696523.81,40744,5320,9114,55178
2009-01-13,NYSE (N),1305672493,0,100,1305672593,28518880890.7,0.0,420.5,28518881311.2,4594069,0,1,4594070
2009-01-13,NYSE Arca (P),750599701,495109819,322297586,1568007106,16305235572.2,20456915646.5,6496203039.82,43258354258.6,4548662,1684875,1676239,7909776
2009-01-13,NASDAQ (Q),1048731474,612451151,802788404,2463971029,22477002960.5,28602319286.6,15886672239.7,66965994486.8,6105226,2249450,3502035,11856711
2009-01-13,CBOE (W),4125700,15743200,1990200,21859100,114513895.0,944926580.92,53563294.0,1113003769.92,19394,14127,9686,43207
2009-01-13,BATS (Z),432377802,308994593,233823618,975196013,10093105486.3,13944817622.9,4670109962.63,28708033071.8,3041494,1479051,1352877,5873422
2009-01-14,AMEX (A),0,12000715,0,12000715,0.0,47652285.63,0.0,47652285.63,0,21448,0,21448
2009-01-14,NSX (C),44818291,8642424,12002102,65462817,705118662.083,237825392.97,252408727.409,1195352782.46,155453,16033,53371,224857
2009-01-14,NYSE (DN),12758697,1078869,7736259,21573825,243966256.357,34008420.3596,112631549.537,390606226.253,27613,1781,18394,47788
2009-01-14,NASDAQ (DQ),1311711765,507452361,575030581,2394194707,21742321860.8,19225977507.7,9212826821.29,50181126189.9,3561936,786106,1403698,5751740
2009-01-14,ADF (D),34481260,4507677,11444283,50433220,777111537.7,171675089.335,203868775.54,1152655402.58,144230,13930,44777,202937
2009-01-14,ISE (I),75466400,23612886,26603121,125682407,1245443658.44,635262125.557,380470382.079,2261176166.08,308763,57554,101722,468039
2009-01-14,CHX (M),21837051,13235110,6201860,41274021,465850901.244,808817021.34,135280468.555,1409948391.14,38600,6083,11519,56202
2009-01-14,NYSE (N),1418353086,0,1200,1418354286,29070133457.5,0.0,43854.0,29070177311.5,4606006,0,4,4606010
2009-01-14,NYSE Arca (P),858005937,560042180,323475638,1741523755,17508697643.8,24240318828.1,6424848149.47,48173864621.3,4910925,1798299,1714143,8423367
2009-01-14,NASDAQ (Q),1131367002,674297733,801288934,2606953669,23235551822.7,32069571035.0,15393285197.0,70698408054.8,6444245,2399549,3507697,12351491
2009-01-14,CBOE (W),2510000,10565900,2481800,15557700,34153850.5,585610331.4,69189513.9,688953695.8,2876,9677,8330,20883
2009-01-14,BATS (Z),508657486,341410081,231902900,1081970467,11613700718.6,15680153668.3,4371192408.44,31665046795.3,3533808,1641923,1415255,6590986
2009-01-15,AMEX (A),0,12022332,0,12022332,0.0,52855486.07,0.0,52855486.07,0,22260,0,22260
2009-01-15,NSX (C),52643095,10474328,29916840,93034263,872466754.531,295821568.727,341934303.645,1510222626.9,187198,19004,64592,270794
2009-01-15,NYSE (DN),15523901,1563517,10331438,27418856,297937315.607,59352157.23,179230195.368,536519668.205,33407,2966,24432,60805
2009-01-15,NASDAQ (DQ),1671925196,669113566,738844943,3079883705,25896388822.0,23278513177.5,11765748693.3,60940650692.8,4263901,980858,1598376,6843135
2009-01-15,ADF (D),53668501,11220000,14809630,79698131,1073365402.02,364393151.475,285362456.566,1723121010.06,205921,22527,57257,285705
2009-01-15,ISE (I),95161768,27611010,38658663,161431441,1473500785.87,787641414.786,516922616.637,2778064817.3,356157,68666,120967,545790
2009-01-15,CHX (M),22694589,12277091,6721931,41693611,544772621.754,696549917.37,198559946.212,1439882485.34,36621,6630,9418,52669
2009-01-15,NYSE (N),1645597634,0,0,1645597634,33396251329.1,0.0,0.0,33396251329.1,5420227,0,0,5420227
2009-01-15,NYSE Arca (P),1184739456,708471279,408541928,2301752663,22041817788.6,29089028239.6,7889120049.65,59019966077.9,6552485,2181652,2084703,10818840
2009-01-15,NASDAQ (Q),1498208167,877173592,1001407036,3376788795,27932878716.7,41107949025.3,19016322475.0,88057150217.1,8116620,3046258,4283176,15446054
2009-01-15,CBOE (W),2342900,14850500,2971700,20165100,44768670.0,843769223.6,80360723.07,968898616.67,4137,10891,11726,26754
2009-01-15,BATS (Z),665277801,393268328,275876935,1334423064,13787358315.2,17565051661.2,5498164519.93,36850574496.3,4553721,1804825,1701813,8060359
2009-01-16,AMEX (A),0,11261650,0,11261650,0.0,49140641.89,0.0,49140641.89,0,19992,0,19992
2009-01-16,BEX (B),1060911,1324773,375620,2761304,17616824.42,44792317.33,15720139.22,78129280.97,4512,5117,1722,11351
2009-01-16,NSX (C),32947840,8477289,14125394,55550523,593318957.45,233653147.144,273787841.561,1100759946.16,125947,14597,57414,197958
2009-01-16,NYSE (DN),8468202,1396588,7575897,17440687,173856186.379,51422489.6868,118400647.523,343679323.589,19705,2490,16005,38200
2009-01-16,NASDAQ (DQ),1478438345,519459002,662222762,2660120109,24153610376.1,17371348186.5,10958060863.7,52483019426.2,3807163,891125,1446876,6145164
2009-01-16,ADF (D),44067897,4716730,12646995,61431622,866328842.397,240436988.825,243124449.15,1349890280.37,156505,14154,46979,217638
2009-01-16,ISE (I),80103398,22337336,29325571,131766305,1274484875.16,639403480.89,423601038.795,2337489394.85,307294,54786,99927,462007
2009-01-16,CHX (M),21571195,14559237,6525885,42656317,500282412.132,734752103.171,196881475.56,1431915990.86,32946,5884,10327,49157
2009-01-16,NYSE (N),1617793862,0,1000,1617794862,34144242585.4,0.0,14522.5,34144257107.9,4891952,0,5,4891957
2009-01-16,NYSE Arca (P),970533234,552097355,355165703,1877796292,19179071637.2,22732394268.0,6936318545.01,48847784450.1,5546299,1850517,1861775,9258591
2009-01-16,NASDAQ (Q),1297154039,759383651,1005605484,3062143174,25537827627.3,35307935442.6,18671328298.2,79517091368.1,7314569,2725978,3944503,13985050
2009-01-16,CBOE (W),3492700,10559400,2759600,16811700,47500639.0,605254018.0,83957835.0,736712492.0,2659,13542,11345,27546
2009-01-16,BATS (Z),501488195,304159312,216529742,1022177249,10728367782.3,13242854923.8,4187207927.44,28158430633.5,3504183,1383028,1340788,6227999
2009-01-20,AMEX (A),0,12677119,0,12677119,0.0,47195277.28,0.0,47195277.28,0,21592,0,21592
2009-01-20,BEX (B),1487163,2687013,671068,4845244,12205512.68,130049685.72,20055007.87,162310206.27,4292,11761,2326,18379
2009-01-20,NSX (C),40614199,12563701,12357750,65535650,694452281.348,289004070.539,258810138.118,1242266490.01,155709,18725,56352,230786
2009-01-20,NYSE (DN),7449288,1099093,6115267,14663648,126363588.371,34031299.7609,92520852.8133,252915740.945,17839,1919,15629,35387
2009-01-20,NASDAQ (DQ),1553929861,632852414,578493726,2765276001,24345431021.9,19614397098.7,9334168056.56,53293996177.1,3849185,930271,1439582,6219038
2009-01-20,ADF (D),47608939,5494015,14028226,67131180,955669805.09,202049863.873,280596164.865,1438315833.83,174069,16239,57730,248038
2009-01-20,ISE (I),89083813,25537105,28512579,143133497,1308610426.49,647756916.069,418653389.3,2375020731.86,329328,60774,112505,502607
2009-01-20,CHX (M),19272461,15977632,6797694,42047787,484795197.821,754226726.455,214485435.625,1453507359.9,41911,5228,8116,55255
2009-01-20,NYSE (N),1720303570,0,0,1720303570,33975690161.1,0.0,0.0,33975690161.1,5305214,0,0,5305214
2009-01-20,NYSE Arca (P),1025698493,714268891,322252885,2062220269,19582811448.1,26683156418.9,6196192858.1,52462160725.1,5872284,2058772,1782083,9713139
2009-01-20,NASDAQ (Q),1308590443,788363171,874539328,2971492942,25294422581.0,33899180875.4,16345340677.1,75538944133.4,7453053,2712899,3854946,14020898
2009-01-20,CBOE (W),2159300,14397100,2886600,19443000,56990167.76,858692586.8,78477059.5,994159814.06,3303,16592,10659,30554
2009-01-20,BATS (Z),563674035,358407161,219548126,1141629322,11669629507.4,15568913686.6,4085587975.05,31324131169.1,3930658,1599726,1407213,6937597
2009-01-21,AMEX (A),0,12838256,0,12838256,0.0,53578142.38,0.0,53578142.38,0,20502,0,20502
2009-01-21,BEX (B),797847,7608180,410650,8816677,8310051.32,174233058.67,14732565.14,197275675.13,3023,13864,1516,18403
2009-01-21,NSX (C),43269872,10428656,13680470,67378998,762043468.662,262850597.848,294752114.054,1319646180.56,172496,16091,66841,255428
2009-01-21,NYSE (DN),7671658,1030733,6668305,15370696,123985743.433,34111205.3092,85508561.4497,243605510.192,15714,1873,14554,32141
2009-01-21,NASDAQ (DQ),1573463972,559715787,595143700,2728323459,25319869565.6,16958677640.4,9544966470.71,51823513676.7,3923791,890591,1492438,6306820
2009-01-21,ADF (D),47581636,4656282,12336387,64574305,1009316339.08,158122673.435,234219637.676,1401658650.19,180368,11988,49541,241897
2009-01-21,ISE (I),77761626,27407085,25307923,130476634,1173472561.53,691600878.409,369572256.922,2234645696.86,288660,58603,103317,450580
2009-01-21,CHX (M),21416192,16022749,6700562,44139503,525022584.645,725346545.68,149748002.05,1400117132.38,43917,7393,9424,60734
2009-01-21,NYSE (N),1739427827,0,900,1739428727,35109539686.3,0.0,9217.0,35109548903.3,5499104,0,6,5499110
2009-01-21,NYSE Arca (P),1044669695,658708918,354041917,2057420530,20470290770.2,24161980609.1,6948490875.01,51580762254.3,5983160,1955771,1839641,9778572
2009-01-21,NASDAQ (Q),1340416154,769589842,894921664,3004927660,26208850542.9,31401878790.7,16864812236.6,74475541570.2,7590096,2561763,3915354,14067213
2009-01-21,CBOE (W),2436200,9846500,2329500,14612200,106175659.82,497043217.45,59462422.34,662681299.61,2864,11310,6628,20802
2009-01-21,BATS (Z),570286160,368267127,236450191,1175003478,11935542547.8,15340096492.1,4289130067.25,31564769107.2,3911633,1619317,1459990,6990940
2009-01-22,AMEX (A),0,9452945,0,9452945,0.0,43850523.09,0.0,43850523.09,0,18492,0,18492
2009-01-22,BEX (B),733229,4278145,621250,5632624,7431467.91,216169637.81,15166915.61,238768021.33,2009,15926,2584,20519
2009-01-22,NSX (C),36775128,12290483,12957057,62022668,684364145.924,322016218.181,271204634.745,1277584998.85,154772,19992,55232,229996
2009-01-22,NYSE (DN),6777229,1406591,6261372,14445192,114980127.507,51887715.5808,98577988.7991,265445831.887,15724,2549,13980,32253
2009-01-22,NASDAQ (DQ),1375524987,572788503,618338362,2566651852,22267056299.4,18006084837.9,10394154139.3,50667295276.7,3638460,913880,1487892,6040232
2009-01-22,ADF (D),36619602,3117052,11600059,51336713,760314717.664,131379045.05,228771544.425,1120465307.14,134995,11378,43202,189575
2009-01-22,ISE (I),78453891,29392064,26035858,133881813,1144933025.25,685619156.62,409370531.309,2239922713.18,281281,56100,97471,434852
2009-01-22,CHX (M),19021978,13892108,12068818,44982904,461073102.168,839897771.2,271945335.28,1572916208.65,26912,8564,8843,44319
2009-01-22,NYSE (N),1557903238,0,1900,1557905138,32465381694.3,0.0,7201.0,32465388895.3,5354881,0,3,5354884
2009-01-22,NYSE Arca (P),922267780,637203815,369848952,1929320547,18549644135.2,24412826625.0,7719162588.28,50681633348.5,5493010,2031967,1856933,9381910
2009-01-22,NASDAQ (Q),1248811579,815424153,1005856084,3070091816,25423262160.2,35351044188.6,19844874225.2,80619180574.0,7452878,2983441,4277417,14713736
2009-01-22,CBOE (W),5450500,17738600,8465000,31654100,112805831.0,805215199.5,190830257.0,1108851287.5,4159,23489,12097,39745
2009-01-22,BATS (Z),558448142,381922162,265161079,1205531383,11831997481.5,16008529571.6,4993522326.27,32834049379.4,4049492,1766756,1603039,7419287
2009-01-23,AMEX (A),0,10672508,0,10672508,0.0,41274472.29,0.0,41274472.29,0,23366,0,23366
2009-01-23,BEX (B),1721227,4991433,884605,7597265,14502477.46,204269255.36,24836534.6428,243608267.463,3050,15786,3254,22090
2009-01-23,NSX (C),37952360,11499312,10560590,60012262,698373125.191,323338900.887,226140861.556,1247852887.63,147837,18376,49894,216107
2009-01-23,NYSE (DN),7235563,954845,6859803,15050211,126758523.53,25725325.6478,96441002.2386,248924851.417,15112,1589,13598,30299
2009-01-23,NASDAQ (DQ),1526666745,547624111,664205126,2738495982,24960674286.0,16727886921.3,10014337968.7,51702899176.0,3764526,884655,1539040,6188221
2009-01-23,ADF (D),52846502,5393847,16667493,74907842,975214554.305,183719403.93,269687362.323,1428621320.56,175612,16393,60590,252595
2009-01-23,ISE (I),75603172,27137474,26167056,128907702,1177549238.82,762106492.46,364532441.785,2304188173.06,284708,64588,102580,451876
2009-01-23,CHX (M),16510402,17646800,7344981,41502183,381219279.52,1177808015.18,158016209.765,1717043504.47,31698,10207,8663,50568
2009-01-23,NYSE (N),1420235553,0,0,1420235553,28954699775.1,0.0,0.0,28954699775.1,5011764,0,0,5011764
2009-01-23,NYSE Arca (P),960891599,615294312,327321110,1903507021,19503894181.0,23846099417.7,6611720454.02,49961714052.7,5584424,2051907,1774754,9411085
2009-01-23,NASDAQ (Q),1210529826,738893830,897002629,2846426285,24268992314.3,31940284987.1,17107888438.4,73317165739.7,7006484,2668673,4062195,13737352
2009-01-23,CBOE (W),1957800,16222600,5957200,24137600,62299996.6,874358392.95,169467123.0,1106125512.55,3266,24586,10891,38743
2009-01-23,BATS (Z),520659993,358578747,238261340,1117500080,11112768084.4,15293690743.2,4397029830.15,30803488657.8,3733698,1675784,1528760,6938242
2009-01-26,AMEX (A),0,11808491,0,11808491,0.0,38694272.57,0.0,38694272.57,0,21194,0,21194
2009-01-26,BEX (B),1662623,3716274,1029492,6408389,18852054.24,157901247.78,23886431.78,200639733.8,2677,12390,3472,18539
2009-01-26,NSX (C),31572567,8455910,9336218,49364695,645208046.719,234542829.984,217574260.062,1097325136.76,127880,13412,46643,187935
2009-01-26,NYSE (DN),5740561,714326,6020481,12475368,90344946.1082,17212163.2274,84411683.5179,191968792.854,13079,1194,12511,26784
2009-01-26,NASDAQ (DQ),1390735949,498645183,579229602,2468610734,24742320652.3,14331975600.4,8833665837.5,47907962090.2,3418602,813392,1277634,5509628
2009-01-26,ADF (D),38156602,2975479,10214550,51346631,846219006.343,135642722.72,183015040.775,1164876769.84,135767,10969,39061,185797
2009-01-26,ISE (I),69528795,25163314,21292509,115984618,1184658966.8,601803559.562,301113782.829,2087576309.19,275360,52475,86534,414369
2009-01-26,CHX (M),17602681,16800291,6480164,40883136,466865396.286,1000366077.46,184957113.9,1652188587.65,25042,7262,6214,38518
2009-01-26,NYSE (N),1270385767,0,200,1270385967,27328877563.2,0.0,1492.0,27328879055.2,4558182,0,2,4558184
2009-01-26,NYSE Arca (P),865498431,500491692,266636552,1632626675,18764700946.7,18700480991.9,5184566363.64,42649748302.3,5190058,1670586,1498147,8358791
2009-01-26,NASDAQ (Q),1133147498,637924088,768726067,2539797653,24096951843.1,27604896651.6,14517383653.7,66219232148.4,6736753,2322703,3540856,12600312
2009-01-26,CBOE (W),2349900,10661000,3682500,16693400,70759192.56,525981646.25,103892734.32,700633573.13,3148,18765,9305,31218
2009-01-26,BATS (Z),495718597,330766432,203280826,1029765855,11214096347.5,13673906119.5,3814421418.21,28702423885.2,3647018,1510052,1354018,6511088
2009-01-27,AMEX (A),0,10606579,0,10606579,0.0,52332799.75,0.0,52332799.75,0,19964,0,19964
2009-01-27,BEX (B),1018607,3284518,540886,4844011,10218621.31,142186421.61,14417596.75,166822639.67,1850,10881,2413,15144
2009-01-27,NSX (C),27099718,6270446,10023944,43394108,511810206.663,189741320.439,220263623.182,921815150.284,112932,11500,46343,170775
2009-01-27,NYSE (DN),4918050,660989,5179423,10758462,78383746.7172,14368255.3,77642549.1201,170394551.137,9882,1156,10845,21883
2009-01-27,NASDAQ (DQ),1256165863,416028690,572452368,2244646921,22335715988.4,12929594651.4,8709884369.76,43975195009.5,3184098,692709,1254861,5131668
2009-01-27,ADF (D),35942501,3195578,10347497,49485576,782757472.874,140595096.56,199994988.34,1123347557.77,139423,10711,38969,189103
2009-01-27,ISE (I),58736179,21248521,23371795,103356495,1007321594.9,602070381.36,309152912.207,1918544888.46,242980,53735,86324,383039
2009-01-27,CHX (M),20585533,13411326,6453300,40450159,541743010.04,774470747.305,144353575.657,1460567333.0,23465,5813,5671,34949
2009-01-27,NYSE (N),1171739547,100,3700,1171743347,24863958363.5,649.5,21951.5,24863980964.5,4159708,1,2,4159711
2009-01-27,NYSE Arca (P),762818740,440790546,279269315,1482878601,16327585330.7,16673122993.8,5367346091.04,38368054415.5,4659595,1475073,1499112,7633780
2009-01-27,NASDAQ (Q),969430332,540928604,735296033,2245654969,20442119577.2,23276543786.9,13824112149.7,57542775513.9,5689271,1928556,3250692,10868519
2009-01-27,CBOE (W),3101100,10256400,2374700,15732200,73447427.0,515797857.5,66865474.0,656110758.5,2570,13598,8367,24535
2009-01-27,BATS (Z),453218493,274202291,193354431,920775215,10592171843.3,11258033951.1,3750333596.72,25600539391.2,3346313,1293355,1280397,5920065
2009-01-28,AMEX (A),0,10164414,0,10164414,0.0,51485828.38,0.0,51485828.38,0,20294,0,20294
2009-01-28,BEX (B),556525,4602019,513164,5671708,6031200.65,162101384.04,17776591.75,185909176.44,1754,12419,2513,16686
2009-01-28,NSX (C),40974698,8710256,12384266,62069220,849423527.931,230723418.134,284710665.428,1364857611.49,167706,14237,51914,233857
2009-01-28,NYSE (DN),5355463,805306,6476595,12637364,97946012.422,22442758.8847,95300957.4006,215689728.707,12566,1263,13201,27030
2009-01-28,NASDAQ (DQ),1591382866,570252914,672567369,2834203149,27634606906.1,15638547615.6,10502438905.2,53775593426.9,3874091,804629,1521632,6200352
2009-01-28,ADF (D),47660071,4006278,14051600,65717949,954902156.655,167917402.915,240637701.535,1363457261.11,162851,11313,53849,228013
2009-01-28,ISE (I),87412576,31944843,32364892,151722311,1451744106.9,810717370.105,429890734.083,2692352211.09,329542,61642,113673,504857
2009-01-28,CHX (M),19994346,14244920,6458208,40697474,509916739.438,848224040.9,249360175.29,1607500955.63,34339,6869,5971,47179
2009-01-28,NYSE (N),1550259543,0,3100,1550262643,33163830261.1,0.0,61955.5,33163892216.6,5030273,0,11,5030284
2009-01-28,NYSE Arca (P),1046709300,616142134,330321601,1993173035,22175530832.2,21507380049.6,6798016239.91,50480927121.7,5929853,1817983,1776631,9524467
2009-01-28,NASDAQ (Q),1232703936,743150388,863204626,2839058950,25816608324.2,30594013935.9,16889919508.9,73300541769.1,6860613,2373227,3701055,12934895
2009-01-28,CBOE (W),3843600,8702300,2694200,15240100,95968400.4,416973961.0,73852628.0,586794989.4,4310,15498,10029,29837
2009-01-28,BATS (Z),573793619,353557962,234061625,1161413206,13317690778.8,13386865626.8,4652079862.75,31356636268.3,4127170,1536205,1535239,7198614
2009-01-29,AMEX (A),0,10459426,0,10459426,0.0,46227626.93,0.0,46227626.93,0,20670,0,20670
2009-01-29,BEX (B),250603,3098528,563411,3912542,3257790.62,104298155.49,17047766.04,124603712.15,796,8906,2426,12128
2009-01-29,NSX (C),32157976,7967986,12111035,52236997,671096666.78,227849115.838,265278394.431,1164224177.05,141175,12677,57920,211772
2009-01-29,NYSE (DN),6414959,620022,5836189,12871170,117793049.611,13553833.9265,91686296.7297,223033180.267,12561,1086,11903,25550
2009-01-29,NASDAQ (DQ),1247160838,471847499,582578451,2301586788,21936760370.3,14396749746.0,9605095080.33,45938605196.6,3170436,692185,1323145,5185766
2009-01-29,ADF (D),34669324,3471246,12365156,50505726,802693206.83,176246211.92,233561447.13,1212500865.88,133741,10138,48508,192387
2009-01-29,ISE (I),67032186,22025438,24238020,113295644,1137954316.49,513460175.927,365960593.634,2017375086.05,271828,44663,99045,415536
2009-01-29,CHX (M),15317133,11080757,7327751,33725641,372827779.502,711601204.575,174874267.459,1259303251.54,23723,6537,5869,36129
2009-01-29,NYSE (N),1438747907,200,7200,1438755307,28823550668.2,1223.0,130958.0,28823682849.2,4475288,2,22,4475312
2009-01-29,NYSE Arca (P),812876343,458058257,308147232,1579081832,17635305756.0,17671774280.6,6080701760.36,41387781796.9,4892949,1432192,1638627,7963768
2009-01-29,NASDAQ (Q),945884691,573601417,794471002,2313957110,20322692749.9,25291648137.8,15425541098.0,61039881985.7,5546805,2007764,3343599,10898168
2009-01-29,CBOE (W),1951200,7808100,3499200,13258500,45768245.0,449074878.94,95233108.96,590076232.9,3506,10550,7918,21974
2009-01-29,BATS (Z),470843225,293883876,217641012,982368113,11280121502.7,12206519584.8,4241162461.44,27727803548.9,3511010,1397990,1411322,6320322
2009-01-30,AMEX (A),0,12320246,0,12320246,0.0,56652369.07,0.0,56652369.07,0,20140,0,20140
2009-01-30,BEX (B),426146,3192695,415718,4034559,5812926.99,129363869.14,9866339.89,145043136.02,2043,11387,1517,14947
2009-01-30,NSX (C),33184966,8296200,11821035,53302201,703279169.759,255656312.352,265118902.477,1224054384.59,147191,14140,53030,214361
2009-01-30,NYSE (DN),5682772,640406,6005285,12328463,101840504.062,19146627.1548,91948198.8602,212935330.077,11166,1162,12046,24374
2009-01-30,NASDAQ (DQ),1314546137,563546581,641485376,2519578094,23208242819.7,17095497126.4,10243061919.2,50546801865.3,3300399,764556,1418649,5483604
2009-01-30,ADF (D),34776231,2599384,13874502,51250117,759853688.948,109170419.445,265782349.505,1134806457.9,134845,7922,50843,193610
2009-01-30,ISE (I),69073896,23852781,28127633,121054310,1085610240.5,619207520.668,412987218.947,2117804980.12,268981,52520,107572,429073
2009-01-30,CHX (M),18612084,22813986,6839606,48265676,474604675.973,1575991980.14,230368706.68,2280965362.79,36171,6534,5685,48390
2009-01-30,NYSE (N),1513815403,0,9700,1513825103,31813421772.1,0.0,230446.0,31813652218.1,4872576,0,16,4872592
2009-01-30,NYSE Arca (P),849708762,531082953,315386293,1696178008,18969336680.1,20727358710.8,6055438290.84,45752133681.7,5296855,1699971,1701917,8698743
2009-01-30,NASDAQ (Q),1010863268,664330838,875305256,2550499362,21542607019.6,28849767196.7,16455882618.6,66848256834.9,6010027,2305770,3572548,11888345
2009-01-30,CBOE (W),2414000,9252600,2781300,14447900,53455207.77,493313169.0,79507162.0,626275538.77,3559,13985,10649,28193
2009-01-30,BATS (Z),511570882,344762207,242944215,1099277304,11735126512.4,13821995829.8,4752539054.31,30309661396.5,3821685,1598560,1566752,6986997
2009-02-02,AMEX (A),0,11124042,0,11124042,0.0,39975100.6,0.0,39975100.6,0,21362,0,21362
2009-02-02,BEX (B),479875,2916287,497516,3893678,5029850.94,119618154.46,11180130.06,135828135.46,1464,10652,2013,14129
2009-02-02,NSX (C),35977783,7445347,13060535,56483665,705483754.89,241296396.575,269499390.63,1216279542.09,158434,12751,63005,234190
2009-02-02,NYSE (DN),6440164,641571,6670823,13752558,114197942.656,17955968.0074,90815820.7352,222969731.399,15429,1003,14799,31231
2009-02-02,NASDAQ (DQ),1266492684,429381047,595744054,2291617785,20727189601.5,13432568353.9,8883924394.33,43043682349.7,3398095,687685,1479965,5565745
2009-02-02,ADF (D),45617338,2693177,16549977,64860492,871689173.019,102798049.41,283254363.049,1257741585.48,161218,10729,63209,235156
2009-02-02,ISE (I),58476801,21228059,24107411,103812271,942953788.902,502171944.311,335827969.372,1780953702.58,238065,46931,99069,384065
2009-02-02,CHX (M),14078651,8940517,7848219,30867387,365639871.258,619077161.78,116730740.91,1101447773.95,24897,6501,6092,37490
2009-02-02,NYSE (N),1327763578,0,6200,1327769778,26525398479.7,0.0,79212.5,26525477692.2,4632883,0,21,4632904
2009-02-02,NYSE Arca (P),808541915,424831140,304989377,1538362432,16345870388.0,16908798557.3,5621773428.17,38876442373.5,4943311,1501798,1647638,8092747
2009-02-02,NASDAQ (Q),964890149,546985385,824633837,2336509371,19116916618.0,23515700043.1,15158226825.5,57790843486.6,5641324,1956725,3657532,11255581
2009-02-02,CBOE (W),3236200,8018000,2427300,13681500,45493275.84,445693429.0,61874166.5,553060871.34,3036,11598,8698,23332
2009-02-02,BATS (Z),508875470,295981396,243920974,1048777840,11171267297.6,12067640243.9,4425870404.23,27664777945.7,3772749,1426989,1547374,6747112
2009-02-03,AMEX (A),0,9272266,0,9272266,0.0,43366722.45,0.0,43366722.45,0,20480,0,20480
2009-02-03,BEX (B),317438,3289182,572858,4179478,3004580.22,131687626.76,12586192.81,147278399.79,1238,11574,2434,15246
2009-02-03,NSX (C),34654496,8452118,14108351,57214965,640700620.961,264567147.252,293653306.715,1198921074.93,146927,14272,62757,223956
2009-02-03,NYSE (DN),6187625,553007,6041153,12781785,113914912.932,14020465.26,87620524.4035,215555902.596,12340,882,12629,25851
2009-02-03,NASDAQ (DQ),1398962431,448061275,650870436,2497894142,23509408807.2,12974160198.1,10168887261.0,46652456266.3,3472590,667511,1462267,5602368
2009-02-03,ADF (D),36939650,2167089,12666065,51772804,769820912.979,76099253.105,240288757.445,1086208923.53,132679,7089,47958,187726
2009-02-03,ISE (I),71390323,19150729,28490637,119031689,1182418471.58,502894747.677,413414365.125,2098727584.38,300203,47158,110074,457435
2009-02-03,CHX (M),22670983,11507508,3996157,38174648,544460625.977,544288102.645,90999681.32,1179748409.94,29745,5318,7019,42082
2009-02-03,NYSE (N),1354192001,0,9500,1354201501,27552911721.4,0.0,173731.5,27553085452.9,4572921,0,29,4572950
2009-02-03,NYSE Arca (P),837792948,448252348,318474942,1604520238,16926506973.3,17109967289.9,6129639511.81,40166113775.0,4985228,1483427,1710469,8179124
2009-02-03,NASDAQ (Q),1004048518,541075582,835476591,2380600691,20278679078.9,23061100688.1,15773582820.8,59113362587.8,5862838,1974041,3629114,11465993
2009-02-03,CBOE (W),3257200,9682600,3214500,16154300,41300768.5,444407815.4,79438287.0,565146870.9,3228,11992,8535,23755
2009-02-03,BATS (Z),509881067,285270585,252193083,1047344735,11101151248.6,11644792018.1,4710069324.73,27456012591.4,3776471,1373097,1638695,6788263
2009-02-04,AMEX (A),0,12293973,0,12293973,0.0,44869052.85,0.0,44869052.85,0,28497,0,28497
2009-02-04,BEX (B),614763,6523522,772762,7911047,10047252.84,155302749.62,17900971.26,183250973.72,2816,12824,3445,19085
2009-02-04,NSX (C),35707403,7807234,13105504,56620141,641981914.795,226195868.349,283318533.673,1151496316.82,144998,14051,60629,219678
2009-02-04,NYSE (DN),6080042,508274,6449994,13038310,118212066.15,14711824.73,98005699.8153,230929590.695,13634,836,13128,27598
2009-02-04,NASDAQ (DQ),1469989008,505832498,661316680,2637138186,24024957013.4,15995375483.5,11094784724.6,51115117221.4,3843957,771236,1484462,6099655
2009-02-04,ADF (D),43845740,2500741,15735465,62081946,830297202.72,97916288.715,271412125.66,1199625617.09,142148,8454,56247,206849
2009-02-04,ISE (I),80967018,23418038,27474985,131860041,1284212046.75,567381351.238,411551584.607,2263144982.6,310443,53601,96568,460612
2009-02-04,CHX (M),21517879,14617956,7691931,43827766,539442240.177,877333893.63,216155517.345,1632931651.15,23376,6224,6339,35939
2009-02-04,NYSE (N),1393772405,0,9300,1393781705,27225804706.1,0.0,247748.0,27226052454.1,4814102,0,28,4814130
2009-02-04,NYSE Arca (P),978051838,516297121,367619238,1861968197,19502453833.4,20044076207.7,7404728482.69,46951258523.8,5633561,1736958,1950699,9321218
2009-02-04,NASDAQ (Q),1142204125,586673915,889825072,2618703112,22468995000.9,25115607108.1,17626895788.9,65211497897.9,6366098,2147434,3890515,12404047
2009-02-04,CBOE (W),2264900,9934300,3714700,15913900,63064605.0,528825682.58,103996236.2,695886523.78,4442,11570,10020,26032
2009-02-04,BATS (Z),552956604,324090836,277507758,1154555198,12048894728.0,13294675764.6,5276179262.84,30619749755.4,3984570,1555525,1716811,7256906
2009-02-05,AMEX (A),0,11600395,0,11600395,0.0,46341724.56,0.0,46341724.56,0,20594,0,20594
2009-02-05,BEX (B),2089603,5988790,953620,9032013,17955176.13,207370543.87,23238807.11,248564527.11,4542,16454,3389,24385
2009-02-05,NSX (C),42110483,10332305,14666216,67109004,788197188.595,305536823.329,288163936.434,1381897948.36,173904,15991,64081,253976
2009-02-05,NYSE (DN),6529531,670097,7326829,14526457,124215775.196,17021735.1296,105962000.812,247199511.138,15899,1130,15358,32387
2009-02-05,NASDAQ (DQ),1711392385,730393604,752242823,3194028812,26704703622.6,21190373468.8,11150769981.0,59045847072.3,4137962,921576,1628538,6688076
2009-02-05,ADF (D),55425307,4444465,18258844,78128616,949392569.55,189268738.898,291699037.27,1430360345.72,185373,14407,64206,263986
2009-02-05,ISE (I),84816237,27215178,32879884,144911299,1293182862.82,711752680.06,429561218.75,2434496761.63,308559,60812,105823,475194
2009-02-05,CHX (M),17926697,16404128,5815747,40146572,422531468.785,980110885.52,110953320.78,1513595675.09,16112,7623,6045,29780
2009-02-05,NYSE (N),1628590259,0,6900,1628597159,32860093043.0,0.0,108238.0,32860201281.0,5546815,0,21,5546836
2009-02-05,NYSE Arca (P),1152773845,678176495,411217557,2242167897,22386082650.5,25174674041.1,7804534179.86,55365290871.4,6605250,2094382,2129471,10829103
2009-02-05,NASDAQ (Q),1291694591,712288900,1026256140,3030239631,25227367023.2,30242760542.7,19337113977.8,74807241543.8,7187469,2588210,4358901,14134580
2009-02-05,CBOE (W),2911200,7331300,2934100,13176600,69375789.6,434385378.96,89922158.0,593683326.56,4388,8934,10671,23993
2009-02-05,BATS (Z),631947893,375345374,305732788,1313026055,13657851090.5,14811362545.1,5772849633.65,34242063269.2,4619386,1790110,1975943,8385439
2009-02-06,AMEX (A),0,10434688,0,10434688,0.0,51641222.48,0.0,51641222.48,0,19457,0,19457
2009-02-06,BEX (B),1126653,5022813,835674,6985140,12353744.06,174254377.74,21069424.39,207677546.19,3479,14564,3422,21465
2009-02-06,NSX (C),38681758,9351576,12716630,60749964,725259336.23,349899779.935,251462867.533,1326621983.7,143278,18897,55443,217618
2009-02-06,NYSE (DN),5954203,720044,6694754,13369001,114827336.143,18538888.0528,100052394.808,233418619.003,14361,1140,13460,28961
2009-02-06,NASDAQ (DQ),1755542187,552402441,776447109,3084391737,27723108380.9,16589277935.9,11359952347.5,55672338664.2,4155054,876595,1652082,6683731
2009-02-06,ADF (D),67663982,5293165,18989687,91946834,1177635923.25,204432355.81,323000756.359,1705069035.42,222017,16770,70722,309509
2009-02-06,ISE (I),89441261,27593439,34296789,151331489,1396803647.03,689009462.07,440482260.334,2526295369.43,308688,58439,111345,478472
2009-02-06,CHX (M),22601353,13312926,5755425,41669704,584218170.348,726216857.406,158768246.045,1469203273.8,18985,6301,6610,31896
2009-02-06,NYSE (N),1612808519,0,12200,1612820719,32626591205.0,0.0,368763.5,32626959968.5,5219917,0,30,5219947
2009-02-06,NYSE Arca (P),1091141969,624515640,396130809,2111788418,21896169434.9,24143927388.1,7651550752.37,53691647575.3,6036447,1890063,1995826,9922336
2009-02-06,NASDAQ (Q),1215050245,668297406,926242352,2809590003,24734741515.7,28280262070.0,17273548728.5,70288552314.2,6637240,2275660,3759449,12672349
2009-02-06,CBOE (W),2818200,7843500,1973600,12635300,71369984.98,515199555.0,50066546.0,636636085.98,3228,4807,8339,16374
2009-02-06,BATS (Z),585324416,346518782,274449406,1206292604,13113255386.6,13028552269.4,5230352998.16,31372160654.2,4205445,1561935,1718786,7486166
2009-02-09,AMEX (A),0,9672376,0,9672376,0.0,41706704.57,0.0,41706704.57,0,16325,0,16325
2009-02-09,BEX (B),915644,4246150,744222,5906016,9288758.3,149821942.59,18503043.15,177613744.04,2432,11679,2591,16702
2009-02-09,NSX (C),39485751,8363326,13497930,61347007,777156896.451,280315178.747,280894508.62,1338366583.82,145214,16800,57347,219361
2009-02-09,NYSE (DN),5750612,584522,6106059,12441193,115866770.101,12579926.86,94873346.8186,223320043.779,13871,865,13049,27785
2009-02-09,NASDAQ (DQ),1380929247,428035499,630939960,2439904706,22782895052.1,12583923622.4,9541991392.77,44908810067.3,3512619,664425,1443912,5620956
2009-02-09,ADF (D),44303388,3901181,12011331,60215900,823398487.394,201942765.23,198050982.705,1223392235.33,135593,13503,44416,193512
2009-02-09,ISE (I),77700028,20192424,38558807,136451259,1303627974.91,519480215.494,500989474.277,2324097664.69,269974,46645,120275,436894
2009-02-09,CHX (M),19213026,9145956,3915544,32274526,476259872.719,579404002.086,106696626.52,1162360501.33,21304,5521,5177,32002
2009-02-09,NYSE (N),1257726552,0,8000,1257734552,25838712788.9,0.0,135137.5,25838847926.4,4220297,0,27,4220324
2009-02-09,NYSE Arca (P),814530408,450034902,290217926,1554783236,16924338439.0,17284694351.2,5730592346.02,39939625136.2,4677399,1373501,1549324,7600224
2009-02-09,NASDAQ (Q),929246487,481248014,702583774,2113078275,19881925608.1,20220571733.9,13187161079.3,53289658421.3,5239954,1743110,3064842,10047906
2009-02-09,CBOE (W),1371900,4097500,1917200,7386600,35303516.0,260996955.0,52882595.0,349183066.0,2335,3798,8208,14341
2009-02-09,BATS (Z),433604183,250938702,212598310,897141195,9810315039.9,9885928368.1,3954061754.55,23650305162.6,3110170,1195170,1366520,5671860
2009-02-10,AMEX (A),0,12601385,0,12601385,0.0,52258914.89,0.0,52258914.89,0,20099,0,20099
2009-02-10,BEX (B),1245972,8702978,800972,10749922,12633011.33,256922882.8,19895204.91,289451099.04,4163,21162,2539,27864
2009-02-10,NSX (C),40582083,13720757,12666654,66969494,716625333.731,456369426.016,256830118.895,1429824878.64,145223,28410,54106,227739
2009-02-10,NYSE (DN),6868651,892582,7266226,15027459,131138821.618,25045896.13,109696162.757,265880880.505,16155,1483,16717,34355
2009-02-10,NASDAQ (DQ),1678049302,776185529,693138827,3147373658,25847207507.5,24492368112.1,11396417538.8,61735993158.3,4444506,1126649,1729123,7300278
2009-02-10,ADF (D),51781380,5275059,15685041,72741480,940181891.212,241451943.545,278169474.728,1459803309.48,183847,16743,59979,260569
2009-02-10,ISE (I),99474212,37758636,32098170,169331018,1489797129.6,874538892.962,492505174.73,2856841197.29,369077,75171,118700,562948
2009-02-10,CHX (M),20611474,13837287,5762299,40211060,549741276.333,861419227.64,126796831.913,1537957335.89,19253,8099,7606,34958
2009-02-10,NYSE (N),1757254708,0,14600,1757269308,35139636251.3,0.0,161881.5,35139798132.8,5920265,0,25,5920290
2009-02-10,NYSE Arca (P),1135966060,764317902,408989706,2309273668,22564804285.7,29068666737.2,8270564228.56,59904035251.5,6666757,2457962,2200954,11325673
2009-02-10,NASDAQ (Q),1336693824,943218096,1025287442,3305199362,26390388010.2,40226212755.6,20074177534.7,86690778300.4,7636731,3390504,4429929,15457164
2009-02-10,CBOE (W),3162500,8775900,1707200,13645600,86436654.0,573348368.0,49189654.0,708974676.0,3297,6839,9087,19223
2009-02-10,BATS (Z),643470757,490849634,312638273,1446958664,14130337122.0,18860874765.2,5890733153.03,38881945040.2,4735588,2224025,1987278,8946891
2009-02-11,AMEX (A),0,11335603,0,11335603,0.0,52543877.09,0.0,52543877.09,0,19999,0,19999
2009-02-11,BEX (B),612611,6200310,1902027,8714948,17265169.07,292164098.06,82072781.86,391502048.99,3598,27850,11056,42504
2009-02-11,NSX (C),31236177,10608787,21655405,63500369,562143464.246,394196201.51,249392014.124,1205731679.88,126242,23578,53685,203505
2009-02-11,NYSE (DN),5342230,686412,6355358,12384000,103520330.627,18022991.6238,97723054.932,219266377.183,13683,1134,13886,28703
2009-02-11,NASDAQ (DQ),1318682911,496923586,666914674,2482521171,21486523575.4,14986010644.4,9344645528.99,45817179748.8,3453741,764579,1403674,5621994
2009-02-11,ADF (D),41890659,8031573,14581808,64504040,825561878.55,266562646.335,262712222.268,1354836747.15,149279,17817,56641,223737
2009-02-11,ISE (I),72910903,24052314,40096457,137059674,1106634907.59,602678827.533,387733336.295,2097047071.42,266398,53444,96628,416470
2009-02-11,CHX (M),15015878,10507390,4378456,29901724,352094252.459,623510870.34,151923803.846,1127528926.65,16542,6101,4733,27376
2009-02-11,NYSE (N),1358901285,0,7400,1358908685,27260387059.0,0.0,117075.0,27260504134.0,4770279,0,19,4770298
2009-02-11,NYSE Arca (P),863452318,526637762,370133725,1760223805,17634592879.3,21695228552.0,6832633796.61,46162455227.8,5222821,1782202,1812419,8817442
2009-02-11,NASDAQ (Q),996613332,612507834,890434469,2499555635,20853061223.9,27145654285.9,16148571129.2,64147286639.0,6057909,2381291,3676626,12115826
2009-02-11,CBOE (W),4158100,5984400,2689300,12831800,89557850.95,436824157.17,72186970.0,598568978.12,2178,6492,7690,16360
2009-02-11,BATS (Z),514752854,329752995,249320422,1093826271,11472858610.5,13570202156.9,4591478182.02,29634538949.3,3814223,1582270,1576814,6973307
2009-02-12,AMEX (A),0,11844999,0,11844999,0.0,52917096.37,0.0,52917096.37,0,18228,0,18228
2009-02-12,BEX (B),2120888,7283568,2511711,11916167,44101999.0202,329557846.0,99198719.34,472858564.36,12267,35780,11365,59412
2009-02-12,NSX (C),36586969,13922061,18684087,69193117,640201297.622,534766770.533,251162622.579,1426130690.73,149567,30874,62063,242504
2009-02-12,NYSE (DN),5579633,676045,7291664,13547342,103698412.853,17086978.5,107162285.409,227947676.762,14224,1232,15377,30833
2009-02-12,NASDAQ (DQ),1448750902,621114357,710580940,2780446199,23922505770.3,18696796011.0,10223169029.1,52842470810.4,3757009,991017,1597158,6345184
2009-02-12,ADF (D),42929542,6808091,15567204,65304837,836732204.304,250152524.68,256890508.967,1343775237.95,147395,18124,57035,222554
2009-02-12,ISE (I),79270002,33040901,47625943,159936846,1307449001.06,826128064.706,451120443.222,2584697508.99,324812,69033,115157,509002
2009-02-12,CHX (M),17067090,12374938,4509950,33951978,376718269.213,819360266.737,124409849.971,1320488385.92,15911,7936,5536,29383
2009-02-12,NYSE (N),1480257129,0,5200,1480262329,29858571361.6,0.0,93738.5,29858665100.1,5431820,0,27,5431847
2009-02-12,NYSE Arca (P),939606774,642857149,408271335,1990735258,19643598855.5,26718433741.8,7337167288.61,53699199885.9,5819011,2207487,1958707,9985205
2009-02-12,NASDAQ (Q),1122829613,814457872,970893780,2908181265,22911897978.3,36151106130.0,18006523912.9,77069528021.2,6774413,3060397,4112027,13946837
2009-02-12,CBOE (W),3836800,7915700,3590500,15343000,74595679.1,410767708.0,86962914.28,572326301.38,4166,8336,8823,21325
2009-02-12,BATS (Z),567869502,427652218,295954564,1291476284,12520158310.3,17592036556.2,5293024143.96,35405219010.4,4226516,2038465,1796466,8061447
2009-02-13,AMEX (A),0,11090676,0,11090676,0.0,56288214.19,0.0,56288214.19,0,18604,0,18604
2009-02-13,BEX (B),1167050,5403941,1713246,8284237,27896856.126,246734841.51,64620642.33,339252339.966,8362,25555,6881,40798
2009-02-13,NSX (C),35081898,9504527,13039527,57625952,637323758.132,330932937.732,241707830.941,1209964526.8,145578,20312,48278,214168
2009-02-13,NYSE (DN),4487914,528568,6034706,11051188,83137638.8842,15458598.308,85332179.5592,183928416.751,11780,924,13073,25777
2009-02-13,NASDAQ (DQ),1179104960,458984977,659585682,2297675619,20097600026.4,12912179971.6,8147724002.59,41157504000.6,3263696,755564,1319245,5338505
2009-02-13,ADF (D),30116487,4444306,11543168,46103961,663126594.681,139784856.67,169085482.365,971996933.716,128382,16551,47030,191963
2009-02-13,ISE (I),66047110,22499067,39295317,127841494,1068101219.5,509082574.536,324557074.483,1901740868.52,255893,48299,89612,393804
2009-02-13,CHX (M),13141552,13224207,4020487,30386246,288487058.951,849533364.78,94671832.9732,1232692256.7,17718,6074,4715,28507
2009-02-13,NYSE (N),1241234020,0,10500,1241244520,25252667438.0,0.0,200976.5,25252868414.5,4500254,0,33,4500287
2009-02-13,NYSE Arca (P),725253312,453491085,311814565,1490558962,15030208813.7,17740247720.7,5318393887.84,38088850422.2,4594789,1626166,1525493,7746448
2009-02-13,NASDAQ (Q),848164166,568030616,772828968,2189023750,17929359707.9,24348154145.9,13093179971.3,55370693825.1,5263438,2217257,3135979,10616674
2009-02-13,CBOE (W),1683800,6828000,2218600,10730400,52509781.5,488088343.0,62387995.0,602986119.5,2694,4587,8248,15529
2009-02-13,BATS (Z),441603515,302468053,211957500,956029068,9887229335.65,12135041258.6,3889475116.09,25911745710.4,3350561,1539435,1340247,6230243
2009-02-17,AMEX (A),0,13438662,0,13438662,0.0,55789607.42,0.0,55789607.42,0,25763,0,25763
2009-02-17,BEX (B),1462710,7362510,1533903,10359123,33463007.62,296070594.67,56298816.51,385832418.8,8954,31009,6743,46706
2009-02-17,NSX (C),40700474,13835430,13595132,68131036,708856433.065,511206586.527,252996755.721,1473059775.31,162597,33942,53111,249650
2009-02-17,NYSE (DN),10666427,1150039,8634586,20451052,216554771.211,29358328.399,122409350.389,368322449.999,27516,1718,21342,50576
2009-02-17,NASDAQ (DQ),1442879452,662968811,744935867,2850784130,22638136769.9,19386481388.1,8930219056.47,50954837214.5,3998552,1000079,1549526,6548157
2009-02-17,ADF (D),43676282,6434203,13127896,63238381,835645700.034,264098765.655,217507677.5,1317252143.19,159962,22196,47770,229928
2009-02-17,ISE (I),87670572,28264983,40083616,156019171,1384873345.2,728799106.482,405748495.072,2519420946.76,354215,68194,114772,537181
2009-02-17,CHX (M),11995313,11323573,4030562,27349448,214325179.569,573712334.703,99525176.5,887562690.771,19321,6643,5891,31855
2009-02-17,NYSE (N),1605660857,0,11500,1605672357,30993146251.7,0.0,226993.0,30993373244.7,5504848,0,28,5504876
2009-02-17,NYSE Arca (P),956994223,704696229,351508382,2013198834,19839028227.7,26437821903.7,6250945057.74,52527795189.2,5889246,2141972,1743872,9775090
2009-02-17,NASDAQ (Q),1081627641,804953598,967524057,2854105296,22110209756.6,35098596367.1,16044257207.1,73253063330.8,6506734,2830590,3720291,13057615
2009-02-17,CBOE (W),1492600,10019600,2595700,14107900,51533727.34,647340547.9,73258649.0,772132924.24,2224,9271,8979,20474
2009-02-17,BATS (Z),624202429,403151702,259325074,1286679205,13700438426.4,16373764761.7,4645719471.46,34719922659.6,4560707,1948568,1581472,8090747
2009-02-18,AMEX (A),0,10428380,0,10428380,0.0,46725929.6,0.0,46725929.6,0,21666,0,21666
2009-02-18,BEX (B),1484274,7452271,1938408,10874953,36663444.73,335362290.12,68165089.01,440190823.86,10962,33086,8736,52784
2009-02-18,NSX (C),43057125,12206943,13157561,68421629,657996657.798,510137030.105,219824056.973,1387957744.88,162995,29655,53412,246062
2009-02-18,NYSE (DN),10105021,882861,8848654,19836536,178900879.129,23259210.5,122791988.214,324952077.843,24345,1644,18924,44913
2009-02-18,NASDAQ (DQ),1510369330,593137812,639498494,2743005636,22910656382.9,16442208244.2,8933874258.44,48286738885.5,4043651,953384,1484732,6481767
2009-02-18,ADF (D),55136753,8714552,19069838,82921143,1075984911.2,255361715.29,310280262.585,1641626889.08,252214,33418,83408,369040
2009-02-18,ISE (I),76474770,25237883,31713662,133426315,1166102101.23,695931702.81,353993335.995,2216027140.03,318317,66797,105476,490590
2009-02-18,CHX (M),13782532,14340404,4534389,32657325,321534094.936,878069164.249,94948056.9318,1294551316.12,20261,8390,5273,33924
2009-02-18,NYSE (N),1434967710,1800,7000,1434976510,27485336535.0,36229.0,63204.5,27485435968.5,5241470,2,16,5241488
2009-02-18,NYSE Arca (P),926849221,578606523,328694070,1834149814,17859742420.2,21921455915.6,6070309673.08,45851508008.9,5582035,1987992,1653516,9223543
2009-02-18,NASDAQ (Q),1130073007,720074829,817607368,2667755204,21695212106.8,30447941863.8,14943401639.1,67086555609.7,6722355,2700822,3596213,13019390
2009-02-18,CBOE (W),2614000,9350600,1796900,13761500,70232118.0,659328534.0,53790722.0,783351374.0,3284,5699,7828,16811
2009-02-18,BATS (Z),538578737,376125236,231818380,1146522353,11319927743.5,14499872331.7,4294924735.23,30114724810.4,3961008,1787884,1468015,7216907
2009-02-19,AMEX (A),0,11758470,0,11758470,0.0,52230902.23,0.0,52230902.23,0,22080,0,22080
2009-02-19,BEX (B),2204748,7556143,1837042,11597933,41064636.756,326578834.63,62410609.94,430054081.326,10631,28356,7428,46415
2009-02-19,NSX (C),42701013,9032005,12001835,63734853,634108098.273,345394257.067,261616474.42,1241118829.76,151538,21778,51736,225052
2009-02-19,NYSE (DN),9458581,815056,8169638,18443275,166115034.313,21512075.2015,128569569.603,316196679.118,21694,1445,17479,40618
2009-02-19,NASDAQ (DQ),1564325803,551900464,657000257,2773226524,22597165248.3,15611183160.8,10211851132.9,48420199542.0,3766500,867424,1428265,6062189
2009-02-19,ADF (D),39379187,3916847,15044481,58340515,792794196.736,173266129.14,247293398.5,1213353724.38,156068,11990,53824,221882
2009-02-19,ISE (I),73744397,24168455,28399764,126312616,1046432917.17,643565069.61,385246131.486,2075244118.26,270052,59227,100376,429655
2009-02-19,CHX (M),15236780,14190666,4239196,33666642,302867135.622,738905489.968,178080966.565,1219853592.15,19177,7339,4508,31024
2009-02-19,NYSE (N),1485575391,0,5600,1485580991,27006437561.0,0.0,98702.0,27006536263.0,4820108,0,22,4820130
2009-02-19,NYSE Arca (P),917166609,516754486,312446018,1746367113,17051859565.6,19439584068.6,6098230880.21,42589674514.5,5255377,1800032,1605667,8661076
2009-02-19,NASDAQ (Q),1056482247,604521924,787299894,2448304065,20171996105.2,24640315609.3,14641643443.7,59453955158.2,6066249,2264151,3396688,11727088
2009-02-19,CBOE (W),1973000,9282600,1524000,12779600,49047275.0,668445078.96,31035239.0,748527592.96,2337,5375,4843,12555
2009-02-19,BATS (Z),548701062,331674772,236308553,1116684387,11355261516.7,13911110207.2,4541038627.36,29807410351.3,3951241,1653706,1464646,7069593
2009-02-20,AMEX (A),0,14518628,0,14518628,0.0,72072720.05,0.0,72072720.05,0,25928,0,25928
2009-02-20,BEX (B),3975674,11349358,1742511,17067543,64987198.8,555199220.61,45680855.11,665867274.52,19314,47554,4989,71857
2009-02-20,NSX (C),51996459,15108466,13376822,80481747,710171723.354,526242855.915,284813139.437,1521227718.71,173594,32392,63434,269420
2009-02-20,NYSE (DN),13371225,1238821,10156980,24767026,211316961.302,42134170.77,148233458.104,401684590.176,30118,2359,22887,55364
2009-02-20,NASDAQ (DQ),2188741122,763604406,720058739,3672404267,26065967604.7,21028722912.3,10267971516.1,57362662033.1,5104353,1227139,1776751,8108243
2009-02-20,ADF (D),46665810,7636213,13880170,68182193,773429385.99,298921626.635,237807275.371,1310158288.0,159025,18025,53300,230350
2009-02-20,ISE (I),119832841,37548308,35889592,193270741,1434239637.09,924899127.73,449173507.031,2808312271.85,411524,81682,129687,622893
2009-02-20,CHX (M),21592931,17455397,6698595,45746923,356764650.427,1092106371.86,166498298.99,1615369321.27,19054,10747,5729,35530
2009-02-20,NYSE (N),2117660839,300,8800,2117669939,35991109692.9,1518.0,130194.5,35991241405.4,6082006,1,24,6082031
2009-02-20,NYSE Arca (P),1342751320,814702524,394300007,2551753851,22178143103.5,29893776328.8,7579796623.89,59651716056.2,7294393,2667938,2131135,12093466
2009-02-20,NASDAQ (Q),1545650261,985076797,1060163012,3590890070,25349257881.5,38932095997.1,19086909889.0,83368263767.6,8444608,3506853,4448604,16400065
2009-02-20,CBOE (W),2951400,13458100,2169600,18579100,50559839.0,869379644.61,49603245.0,969542728.61,2699,7413,8354,18466
2009-02-20,BATS (Z),764020490,484916213,315279918,1564216621,14519669104.3,19259897548.5,5806842459.87,39586409112.7,5398807,2339900,1989713,9728420
2009-02-23,AMEX (A),0,12086054,0,12086054,0.0,51095617.32,0.0,51095617.32,0,24139,0,24139
2009-02-23,BEX (B),2883675,9617169,1282321,13783165,48082207.57,496434851.35,31154389.59,575671448.51,14466,40689,4629,59784
2009-02-23,NSX (C),39682707,10953795,10279766,60916268,610449439.946,393595790.264,215529337.424,1219574567.63,150284,26111,51754,228149
2009-02-23,NYSE (DN),11920399,829377,8878719,21628495,203603566.655,24881737.76,121888369.226,350373673.642,27866,1571,19502,48939
2009-02-23,NASDAQ (DQ),1772905289,591220619,620759607,2984885515,23704240548.8,16747520861.7,9224149551.48,49675910962.0,4424867,1082673,1528394,7035934
2009-02-23,ADF (D),41549846,4188279,11277897,57016022,760542575.385,212431521.798,174077132.345,1147051229.53,151806,15782,44298,211886
2009-02-23,ISE (I),86704954,25927827,26625662,139258443,1106898823.86,696480183.69,346906543.678,2150285551.23,314572,66416,102784,483772
2009-02-23,CHX (M),15048253,11567037,4916849,31532139,285518387.378,674880085.62,123801848.444,1084200321.44,19959,9079,5700,34738
2009-02-23,NYSE (N),1613036697,0,35300,1613071997,27486255363.3,0.0,842177.5,27487097540.8,5130801,0,15,5130816
2009-02-23,NYSE Arca (P),1074926876,667827099,334562935,2077316910,18707190884.2,25254602078.1,6142910812.98,50104703775.3,6176652,2344913,1787344,10308909
2009-02-23,NASDAQ (Q),1233228761,781527193,799445497,2814201451,21650227775.9,31513356132.3,14573780213.9,67737364122.0,6982955,3007215,3577197,13567367
2009-02-23,CBOE (W),3877300,6673800,3214800,13765900,60451193.45,384414106.4,62203028.0,507068327.85,3028,5480,10374,18882
2009-02-23,BATS (Z),625116276,394795330,260995473,1280907079,12150087395.3,15443494945.3,4684339492.11,32277921832.7,4541855,1993102,1707509,8242466
2009-02-24,AMEX (A),0,14409114,0,14409114,0.0,61014167.94,0.0,61014167.94,0,28221,0,28221
2009-02-24,BEX (B),3430358,12910128,1482251,17822737,55236628.25,547006583.55,35415873.47,637659085.27,15185,45220,5075,65480
2009-02-24,NSX (C),49044422,11264456,11950820,72259698,731535514.703,367989301.045,261093781.109,1360618596.86,186959,28364,63363,278686
2009-02-24,NYSE (DN),12348632,1042926,8701798,22093356,190598543.581,27268703.763,116341917.651,334209164.995,29548,1905,19762,51215
2009-02-24,NASDAQ (DQ),1978260292,669195771,721428095,3368884158,26727158076.9,18692224491.2,10750991931.2,56170374499.3,4619778,1040092,1700352,7360222
2009-02-24,ADF (D),48253400,3861504,13344839,65459743,839485699.299,150476265.312,224215352.938,1214177317.55,168119,11622,50356,230097
2009-02-24,ISE (I),91862354,31267534,30022790,153152678,1219334855.56,742652285.308,435675824.033,2397662964.9,330140,69340,120183,519663
2009-02-24,CHX (M),20207299,12403241,7622042,40232582,416768544.304,749181974.245,158370105.147,1324320623.7,29684,8333,6974,44991
2009-02-24,NYSE (N),1842101634,0,16200,1842117834,31900473056.3,0.0,214008.5,31900687064.8,5525646,0,47,5525693
2009-02-24,NYSE Arca (P),1163099926,689097193,377116250,2229313369,21065527424.5,25523252384.1,7149128480.01,53737908288.6,6675581,2220810,2012588,10908979
2009-02-24,NASDAQ (Q),1338670155,830237756,954665190,3123573101,24077323215.1,33057247788.0,17487033186.1,74621604189.2,7451517,2950633,4039039,14441189
2009-02-24,CBOE (W),3446300,7685400,3078800,14210500,60697039.0,482566422.18,69958397.0,613221858.18,1967,5723,9513,17203
2009-02-24,BATS (Z),687924485,427086169,290849283,1405859937,13396160206.5,15878912051.1,5195047004.85,34470119262.4,4829332,1943963,1841969,8615264
2009-02-25,AMEX (A),0,17044758,0,17044758,0.0,58011226.94,0.0,58011226.94,0,24210,0,24210
2009-02-25,BEX (B),7259402,13976092,2692587,23928081,145254522.84,676914740.19,60799806.2,882969069.23,52315,63737,9672,125724
2009-02-25,NSX (C),61221575,13781007,15196173,90198755,1145561425.52,473675933.086,333859980.874,1953097339.48,250250,32142,70082,352474
2009-02-25,NYSE (DN),11577946,734335,8792836,21105117,192349570.113,24319233.4366,124738888.529,341407692.079,30385,1505,20243,52133
2009-02-25,NASDAQ (DQ),2030089123,721943550,732759675,3484792348,28558120204.6,20039292066.5,11404330236.3,60001742507.4,4863267,1136964,1683249,7683480
2009-02-25,ADF (D),38527823,5193669,14750790,58472282,736671059.827,256131226.23,270706552.063,1263508838.12,137306,16642,53542,207490
2009-02-25,ISE (I),100428799,33415317,29590835,163434951,1342187526.7,792808850.492,421891570.053,2556887947.25,367588,74149,113937,555674
2009-02-25,CHX (M),20516896,13200907,5157230,38875033,408462243.999,762157588.015,121328070.302,1291947902.32,21437,7328,5482,34247
2009-02-25,NYSE (N),1800731804,0,6100,1800737904,32177119387.3,0.0,91339.0,32177210726.3,5614470,0,20,5614490
2009-02-25,NYSE Arca (P),1214835161,717458195,391043933,2323337289,22422903866.9,26159504420.1,7449278421.94,56031686708.9,7138493,2423420,2098847,11660760
2009-02-25,NASDAQ (Q),1423722549,952128468,944484770,3320335787,25963396063.4,36889981363.9,17586892301.7,80440269729.0,7959976,3449180,4123580,15532736
2009-02-25,CBOE (W),2059700,5946600,4670500,12676800,33881591.56,348881100.0,125655283.0,508417974.56,2457,4548,9180,16185
2009-02-25,BATS (Z),777166665,483637139,307722598,1568526402,15701790307.3,17917726314.1,5606064162.32,39225580783.8,5559680,2262886,1967442,9790008
2009-02-26,AMEX (A),0,10784564,0,10784564,0.0,47757346.17,0.0,47757346.17,0,25420,0,25420
2009-02-26,BEX (B),5834674,10462872,2048836,18346382,123761550.105,485993882.61,42240673.46,651996106.175,45608,44730,8444,98782
2009-02-26,NSX (C),46412383,12517486,11947635,70877504,716223048.635,375981292.673,236829727.512,1329034068.82,173884,26949,57041,257874
2009-02-26,NYSE (DN),14477351,945407,9022220,24444978,238596858.081,27179758.908,131961446.206,397738063.195,26499,1466,19473,47438
2009-02-26,NASDAQ (DQ),1808646605,628253985,747300473,3184201063,26350518573.1,16387826622.3,11323788416.1,54062133611.5,4513792,950047,1699777,7163616
2009-02-26,ADF (D),42971394,4090207,13692099,60753700,849908322.402,165348229.66,231767592.4,1247024144.46,159098,15517,52103,226718
2009-02-26,ISE (I),95017492,36357717,33338193,164713402,1360993779.97,778232254.15,466324702.098,2605550736.21,360482,63288,120193,543963
2009-02-26,CHX (M),18312361,14489402,5757112,38558875,322216075.817,853428487.706,136774702.357,1312419265.88,20022,8147,7194,35363
2009-02-26,NYSE (N),1487991066,0,12800,1488003866,26976638305.2,0.0,247643.5,26976885948.7,5044248,0,44,5044292
2009-02-26,NYSE Arca (P),1132009658,601530445,375870318,2109410421,21402574785.2,21276066017.4,7059029183.45,49737669986.1,6636405,1995935,1989979,10622319
2009-02-26,NASDAQ (Q),1273465135,802908026,906742829,2983115990,23973578840.7,29943015010.9,17046342327.6,70962936179.2,7289020,2790308,3943584,14022912
2009-02-26,CBOE (W),2414100,3960700,3009000,9383800,52863226.0,220455242.0,81531739.78,354850207.78,1937,3261,8657,13855
2009-02-26,BATS (Z),657539111,387405230,279153640,1324097981,13639931910.6,13411997690.0,5181822620.11,32233752220.7,4763593,1756642,1765751,8285986
2009-02-27,AMEX (A),0,10389505,0,10389505,0.0,47765880.82,0.0,47765880.82,0,21142,0,21142
2009-02-27,BEX (B),7467963,10817442,2828984,21114389,154571131.786,566058433.17,55885377.929,776514942.885,53915,52803,11502,118220
2009-02-27,NSX (C),57384604,13124049,14347341,84855994,855661141.774,428800410.43,279934983.985,1564396536.19,205714,32057,73061,310832
2009-02-27,NYSE (DN),16398789,812356,9286139,26497284,280506739.14,24539768.0925,144919692.465,449966199.697,35525,1513,21126,58164
2009-02-27,NASDAQ (DQ),2354865210,588076832,736463660,3679405702,27789110772.1,18458974260.6,11172045232.5,57420130265.2,4547395,993252,1645057,7185704
2009-02-27,ADF (D),32217150,3648562,10138105,46003817,593115019.765,181761447.213,173917606.94,948794073.918,116109,13403,38554,168066
2009-02-27,ISE (I),128833070,31568331,35955889,196357290,1335307431.44,804910396.484,415468912.648,2555686740.57,367842,72528,117807,558177
2009-02-27,CHX (M),20896374,13816056,5390774,40103204,376513265.354,852128106.196,162207744.084,1390849115.63,18893,9901,6650,35444
2009-02-27,NYSE (N),2249775315,0,5800,2249781115,36328635649.3,0.0,75480.0,36328711129.3,5963428,0,24,5963452
2009-02-27,NYSE Arca (P),1606865291,625098350,376207290,2608170931,22142241814.7,23734239159.7,6973207476.87,52849688451.3,7136674,2152335,2070904,11359913
2009-02-27,NASDAQ (Q),1598817123,865048409,1056872482,3520738014,25839420798.3,35627937472.1,18588577909.4,80055936179.8,7988605,3230513,4208329,15427447
2009-02-27,CBOE (W),16719600,15085600,2535300,34340500,71062124.33,1070115830.0,56209599.7,1197387554.03,2569,5502,10762,18833
2009-02-27,BATS (Z),840313229,400856883,296961274,1538131386,15041008828.9,14449611579.1,5467722422.58,34958342830.6,5385172,1892750,1918598,9196520
2009-03-02,AMEX (A),0,12427002,0,12427002,0.0,57065764.62,0.0,57065764.62,0,25547,0,25547
2009-03-02,BEX (B),9221233,13295330,3660151,26176714,146600048.79,622386290.22,66048264.3406,835034603.351,47428,60001,12778,120207
2009-03-02,NSX (C),47807041,9097526,11428505,68333072,742326682.199,338793599.495,246111428.297,1327231709.99,193055,27607,62425,283087
2009-03-02,NYSE (DN),14918231,1277097,9550171,25745499,253221205.959,38102295.2056,141128832.741,432452333.906,35936,2387,22369,60692
2009-03-02,NASDAQ (DQ),2247028238,685548694,731717955,3664294887,27275004518.4,19769143662.1,10854429625.0,57898577805.5,5212292,1220846,1836473,8269611
2009-03-02,ADF (D),50867048,4379478,17541678,72788204,903549467.949,164083165.363,301790549.35,1369423182.66,202878,13909,70776,287563
2009-03-02,ISE (I),125191810,44470940,33933172,203595922,1506235825.71,930116133.919,452032222.359,2888384181.99,437247,88321,137957,663525
2009-03-02,CHX (M),23892083,17045733,5579455,46517271,471430286.394,951063582.19,166405725.922,1588899594.51,18415,10224,6461,35100
2009-03-02,NYSE (N),1979239199,0,14700,1979253899,30940870596.3,0.0,297732.0,30941168328.3,5573198,0,47,5573245
2009-03-02,NYSE Arca (P),1258532304,667795480,357225340,2283553124,19744530050.2,25387498341.4,6556339027.3,51688367418.9,6358845,2328980,1927809,10615634
2009-03-02,NASDAQ (Q),1351017372,777937236,905706929,3034661537,22255176882.4,30583500029.5,15878478426.3,68717155338.2,7020945,2766654,3916741,13704340
2009-03-02,CBOE (W),4685500,4970500,4064800,13720800,40342568.4,289664660.0,121321108.44,451328336.84,2924,3754,8499,15177
2009-03-02,BATS (Z),766740248,416226596,295766830,1478733674,14085334251.2,16367800381.4,5340490944.87,35793625577.5,5059299,2018805,1901943,8980047
2009-03-03,AMEX (A),0,12721944,0,12721944,0.0,62187758.83,0.0,62187758.83,0,25640,0,25640
2009-03-03,BEX (B),8945412,15088310,7109062,31142784,185893547.339,747350296.286,114510316.97,1047754160.6,70193,69915,39444,179552
2009-03-03,NSX (C),55734470,8233552,14375350,78343372,840290189.734,313634676.127,304736621.517,1458661487.38,218842,28211,76559,323612
2009-03-03,NYSE (DN),18648648,981339,8996883,28626870,260931281.97,29881065.0793,123651773.194,414464120.243,35025,2043,20661,57729
2009-03-03,NASDAQ (DQ),2130590806,601283648,725571167,3457445621,27385336829.8,16889604393.6,10180344138.5,54455285362.0,5078414,1067053,1819178,7964645
2009-03-03,ADF (D),47626842,4656337,15233480,67516659,835829373.35,158781927.487,240183214.948,1234794515.78,172273,12762,61548,246583
2009-03-03,ISE (I),103902727,36760269,32189256,172852252,1215838222.74,738247774.183,430358339.769,2384444336.7,359105,80257,127049,566411
2009-03-03,CHX (M),19407268,20453041,5426202,45286511,424764253.877,1085961106.11,113149091.493,1623874451.48,25357,9931,5744,41032
2009-03-03,NYSE (N),1901840432,0,11800,1901852232,30539419518.9,0.0,149101.5,30539568620.4,5771041,0,29,5771070
2009-03-03,NYSE Arca (P),1042191854,573245318,302228855,1917666027,17701046976.2,22162055075.6,5286607743.63,45149709795.4,6025817,2045458,1646166,9717441
2009-03-03,NASDAQ (Q),1473801800,818488657,1008308865,3300599322,24571652024.5,32024022484.6,17183785162.8,73779459671.9,7965488,2870957,4295299,15131744
2009-03-03,CBOE (W),3508800,7033100,2053900,12595800,57514784.2,403252394.0,39112158.0,499879336.2,3240,4322,8906,16468
2009-03-03,BATS (Z),813279207,417072550,329591458,1559943215,14981337329.6,15727082752.9,5899638173.27,36608058255.8,5641619,1984068,2151186,9776873
2009-03-04,AMEX (A),0,11087374,0,11087374,0.0,49918478.06,0.0,49918478.06,0,20849,0,20849
2009-03-04,BEX (B),10620691,15177735,5747408,31545834,182963640.822,685007987.964,92936732.3502,960908361.137,71000,62427,28577,162004
2009-03-04,NSX (C),54306828,6094552,12345949,72747329,826120708.056,288260782.817,274685055.022,1389066545.89,202509,24563,65781,292853
2009-03-04,NYSE (DN),18291986,998699,9827017,29117702,277289137.685,30384977.7198,149446821.356,457120936.76,35048,1650,22436,59134
2009-03-04,NASDAQ (DQ),2193072252,708375429,708535765,3609983446,28162404986.3,19810969130.0,10854509550.8,58827883667.1,5140330,1086522,1838507,8065359
2009-03-04,ADF (D),49488122,5406783,13607988,68502893,849909339.248,109234381.15,221200494.437,1180344214.84,177256,10298,53802,241356
2009-03-04,ISE (I),104779257,35642301,31390012,171811570,1380940119.23,720643908.737,436685974.545,2538270002.51,391697,75561,127116,594374
2009-03-04,CHX (M),22426430,16035429,6446052,44907911,472296137.684,850923606.094,135138795.436,1458358539.21,28721,9066,5730,43517
2009-03-04,NYSE (N),1797400789,0,7800,1797408589,29511289381.8,0.0,122430.0,29511411811.8,5405580,0,19,5405599
2009-03-04,NYSE Arca (P),1264280238,708958770,378725656,2351964664,22138359197.9,25671333490.7,7048407010.13,54858099698.8,7060566,2290568,2106341,11457475
2009-03-04,NASDAQ (Q),1402491823,766387885,899971912,3068851620,23851846014.5,29848721744.1,16415370875.5,70115938634.0,7373311,2598011,3982850,13954172
2009-03-04,CBOE (W),8806000,12692000,2499700,23997700,108210015.31,740945227.0,55816311.0,904971553.31,2327,4185,8523,15035
2009-03-04,BATS (Z),751606093,413973746,296109605,1461689444,13998780563.4,15585427665.8,5324644937.16,34908853166.4,5112088,1900021,1943222,8955331
2009-03-05,AMEX (A),0,11511074,0,11511074,0.0,51994840.24,0.0,51994840.24,0,20370,0,20370
2009-03-05,BEX (B),8928424,17147119,6295445,32370988,157561507.74,806908359.68,101824575.119,1066294442.54,59459,64852,29425,153736
2009-03-05,NSX (C),55326352,5873719,13598763,74798834,732547594.635,257823880.121,238579929.482,1228951404.24,196781,22783,66240,285804
2009-03-05,NYSE (DN),16505304,814935,8847901,26168140,238595892.815,23808602.079,125208646.035,387613140.929,35419,1438,22020,58877
2009-03-05,NASDAQ (DQ),2121457446,811441716,724583957,3657483119,26436747346.7,21146227683.6,10941324847.3,58524299877.6,5204099,1108863,1867516,8180478
2009-03-05,ADF (D),39044084,3511736,12065900,54621720,621441488.371,115061120.385,181876250.433,918378859.189,128818,6681,43949,179448
2009-03-05,ISE (I),114497668,38999517,32135700,185632885,1302092794.54,701248091.98,449094661.668,2452435548.19,401897,71748,131889,605534
2009-03-05,CHX (M),22014471,15587928,5964699,43567098,395454585.515,881174641.345,117367843.428,1393997070.29,21142,10628,6802,38572
2009-03-05,NYSE (N),1878576478,0,12400,1878588878,29779043774.6,0.0,179203.0,29779222977.6,5298830,0,26,5298856
2009-03-05,NYSE Arca (P),1189433642,681728897,359247935,2230410474,20090368464.2,25288240858.6,6639501847.48,52018111170.3,6603940,2195435,1981057,10780432
2009-03-05,NASDAQ (Q),1336553038,789484271,899153121,3025190430,21193753970.9,30506600828.7,15797901150.0,67498255949.6,6981002,2633653,3830083,13444738
2009-03-05,CBOE (W),5340800,5592900,2721000,13654700,43860516.8,305556028.4,70456023.96,419872569.16,2045,4126,5666,11837
2009-03-05,BATS (Z),733292075,432599737,296037316,1461929128,13443194836.6,17214281878.3,5359153354.79,36016630069.7,5119101,2031346,1918518,9068965
2009-03-06,AMEX (A),0,10890930,0,10890930,0.0,51109569.84,0.0,51109569.84,0,21813,0,21813
2009-03-06,BEX (B),10486663,17717437,7751131,35955231,186779045.407,883708066.159,120941390.199,1191428501.77,70647,69648,37705,178000
2009-03-06,NSX (C),52103187,8094814,15167868,75365869,773771043.643,397751308.897,305819021.919,1477341374.46,215320,31924,74363,321607
2009-03-06,NYSE (DN),15298301,749998,9028623,25076922,242993154.359,30135031.5287,124724309.115,397852495.002,32792,1431,19660,53883
2009-03-06,NASDAQ (DQ),1968773138,746783573,746703850,3462260561,25568295169.0,21181885138.7,11079161620.8,57829341928.5,4955142,1129448,1848967,7933557
2009-03-06,ADF (D),45198098,2798139,14010297,62006534,795696455.685,96205640.27,217679775.045,1109581871.0,162460,6880,52130,221470
2009-03-06,ISE (I),98563743,42223120,32034485,172821348,1145319232.01,836907610.916,422623948.358,2404850791.29,343160,79455,118733,541348
2009-03-06,CHX (M),18586265,18683580,5699861,42969706,399975334.562,981904069.15,108257358.773,1490136762.49,23921,10757,7627,42305
2009-03-06,NYSE (N),1771049180,0,11100,1771060280,28527824406.4,0.0,126716.5,28527951122.9,5530321,0,55,5530376
2009-03-06,NYSE Arca (P),1191708866,684763176,394859436,2271331478,21515030169.2,26069743299.5,7216566209.16,54801339677.9,6936395,2184090,2122769,11243254
2009-03-06,NASDAQ (Q),1358767384,805983972,959079745,3123831101,22482131151.8,30238592229.3,16658821056.6,69379544437.7,7443198,2655014,4108856,14207068
2009-03-06,CBOE (W),2772200,9697600,1585000,14054800,59979161.0,430430507.0,39220383.0,529630051.0,2392,7276,7471,17139
2009-03-06,BATS (Z),800867807,437434833,322899885,1561202525,14610850371.4,16651356847.1,5556561365.67,36818768584.2,5552756,1980568,2079965,9613289
2009-03-09,AMEX (A),0,8668587,0,8668587,0.0,35632842.0,0.0,35632842.0,0,17420,0,17420
2009-03-09,BEX (B),11868701,15107373,6965707,33941781,208366595.409,726846967.847,109847303.404,1045060866.66,79651,61402,31217,172270
2009-03-09,NSX (C),42862910,4084404,11348089,58295403,664416367.947,187643120.201,221959751.131,1074019239.28,171584,19021,53713,244318
2009-03-09,NYSE (DN),15036846,777435,8442986,24257267,232982465.159,24082303.139,102244498.305,359309266.603,29111,1473,18961,49545
2009-03-09,NASDAQ (DQ),1733314064,681271089,650544562,3065129715,23524505006.5,17618222360.8,9132375097.49,50275102464.9,4483843,1008505,1621785,7114133
2009-03-09,ADF (D),53676857,1895240,14579924,70152021,909646496.255,74050517.43,200398763.513,1184095777.2,206294,4489,54748,265531
2009-03-09,ISE (I),88320770,35774897,28486167,152581834,1124603461.57,636128923.245,357097494.67,2117829879.48,340564,62772,107568,510904
2009-03-09,CHX (M),15761172,14727252,4342341,34830765,378944585.968,760954162.274,86404010.58,1226302758.82,26493,10642,6939,44074
2009-03-09,NYSE (N),1556542157,100,3700,1556545957,25882149001.6,1621.5,23768.0,25882174391.1,5131157,1,12,5131170
2009-03-09,NYSE Arca (P),1015198565,602559508,323055991,1940814064,18548875164.6,20311862664.8,5818147015.85,44678884845.2,5941443,1931994,1732901,9606338
2009-03-09,NASDAQ (Q),1118143476,708943826,769970165,2597057467,19057195882.5,24568493792.6,13236375372.9,56862065048.0,6215331,2309902,3326920,11852153
2009-03-09,CBOE (W),2880200,11356600,1589200,15826000,57407432.19,582181040.1,38424410.56,678012882.85,1991,4752,6540,13283
2009-03-09,BATS (Z),654999491,378129798,266571897,1299701186,12291962526.1,13509102099.3,4454642468.75,30255707094.2,4642686,1715962,1689633,8048281
2009-03-10,AMEX (A),0,14821286,0,14821286,0.0,69866361.02,0.0,69866361.02,0,23237,0,23237
2009-03-10,BEX (B),13438377,24277850,7841582,45557809,209733975.803,797147979.423,123512692.069,1130394647.3,79310,63703,32749,175762
2009-03-10,NSX (C),58585193,6298743,13299615,78183551,893747605.298,245701103.332,307247117.386,1446695826.02,205118,24435,66316,295869
2009-03-10,NYSE (DN),14611753,842231,10473554,25927538,232016023.825,24224837.0925,143437943.539,399678804.457,30347,1598,21896,53841
2009-03-10,NASDAQ (DQ),2632788200,839603006,808682833,4281074039,31812387845.1,19272240913.3,11756381744.7,62841010503.1,5407080,1167353,1882649,8457082
2009-03-10,ADF (D),50183324,3440213,15150640,68774177,820520709.18,105394875.18,224721613.865,1150637198.23,171452,7147,56896,235495
2009-03-10,ISE (I),119867193,51085897,35012254,205965344,1475630977.2,757658657.84,452073375.156,2685363010.19,403262,70917,131545,605724
2009-03-10,CHX (M),22484050,22399236,5547541,50430827,522577863.41,1156499982.09,102052053.755,1781129899.26,25305,10145,6432,41882
2009-03-10,NYSE (N),2186757150,0,7000,2186764150,34309412704.3,0.0,120971.0,34309533675.3,5534119,0,22,5534141
2009-03-10,NYSE Arca (P),1325436829,745188195,387614635,2458239659,22233889984.0,23473038528.0,7440837580.61,53147766092.6,6904198,2169562,2105704,11179464
2009-03-10,NASDAQ (Q),1391348927,766270313,909252905,3066872145,22450017774.6,27266074299.6,15642140755.8,65358232830.0,6864854,2358799,3610323,12833976
2009-03-10,CBOE (W),3946600,5985900,1595400,11527900,41448061.44,297875354.0,42556931.4,381880346.84,2679,5043,7359,15081
2009-03-10,BATS (Z),808471758,433381434,305728450,1547581642,15036440441.0,15209822644.8,5480815960.15,35727079045.9,5415455,1907444,1962838,9285737
2009-03-11,AMEX (A),0,10450648,0,10450648,0.0,52179226.5,0.0,52179226.5,0,20188,0,20188
2009-03-11,BEX (B),12225860,20025886,7161840,39413586,212644965.103,734205290.216,120950998.784,1067801254.1,78703,62634,31595,172932
2009-03-11,NSX (C),53479585,5775221,14409383,73664189,865558445.054,240644240.591,293277269.556,1399479955.2,188548,23480,64586,276614
2009-03-11,NYSE (DN),14174216,1067293,9789011,25030520,246899538.83,29124216.809,150923606.324,426947361.963,31598,1411,21934,54943
2009-03-11,NASDAQ (DQ),2249239610,815932262,707324558,3772496430,28813394435.3,17325332166.2,10951561506.1,57090288107.6,4958384,1119756,1815689,7893829
2009-03-11,ADF (D),43213048,3186545,14818106,61217699,776845642.723,103427331.93,234849343.365,1115122318.02,165326,8466,56409,230201
2009-03-11,ISE (I),108459917,44880657,30867612,184208186,1334534998.12,661102605.929,449437505.659,2445075109.71,367731,64275,122207,554213
2009-03-11,CHX (M),21034109,15274840,8804741,45113690,458357610.357,723722239.825,206420060.565,1388499910.75,23550,8109,7294,38953
2009-03-11,NYSE (N),1745564036,0,19900,1745583936,28078803873.1,0.0,265887.5,28079069760.6,5153946,0,31,5153977
2009-03-11,NYSE Arca (P),1150300793,677705054,357713564,2185719411,20507354885.8,20884648235.8,6992843290.03,48384846411.7,6359181,1958543,1922471,10240195
2009-03-11,NASDAQ (Q),1187002630,745129598,808035769,2740167997,20413775785.1,24575039970.5,14939654952.6,59928470708.2,6238602,2224089,3511269,11973960
2009-03-11,CBOE (W),2839100,5914700,1717100,10470900,40618608.29,266386296.4,43702202.0,350707106.69,2570,4293,8330,15193
2009-03-11,BATS (Z),702461854,409489101,286760154,1398711109,13521384661.0,13472648294.1,5237748255.23,32231781210.4,4825604,1727284,1881281,8434169
2009-03-12,AMEX (A),0,8993554,0,8993554,0.0,39243065.73,0.0,39243065.73,0,20264,0,20264
2009-03-12,BEX (B),17203847,19911533,10204012,47319392,295076043.598,664015442.02,169852549.285,1128944034.9,107006,51948,51676,210630
2009-03-12,NSX (C),52042127,5745797,14822766,72610690,882120716.24,209206038.211,286332056.388,1377658810.84,197603,20941,67940,286484
2009-03-12,NYSE (DN),15062712,941608,11045792,27050112,272784508.47,30228400.7259,153558888.277,456571797.473,35684,1798,24353,61835
2009-03-12,NASDAQ (DQ),2180145210,834167697,896352030,3910664937,30674372436.4,20446638918.0,11738253592.5,62859264946.9,5012556,1141300,1778722,7932578
2009-03-12,ADF (D),48716615,2657842,13590551,64965008,929466601.375,82594366.295,240493217.255,1252554184.93,160391,6291,46906,213588
2009-03-12,ISE (I),115827637,42081160,35872451,193781248,1450380131.32,689930585.55,430986481.344,2571297198.21,376488,62446,120204,559138
2009-03-12,CHX (M),21476812,21066441,5794599,48337852,393677580.4,1197001551.03,165090370.811,1755769502.24,21552,13166,6006,40724
2009-03-12,NYSE (N),1806680882,0,4300,1806685182,30983844669.4,0.0,69291.0,30983913960.4,5111587,0,17,5111604
2009-03-12,NYSE Arca (P),1161094640,660698089,379084366,2200877095,21910620827.8,21329958928.9,7066733010.32,50307312767.0,6384227,2058401,2003460,10446088
2009-03-12,NASDAQ (Q),1208566183,702788303,887232489,2798586975,21573760876.4,23480262309.7,15407325849.7,60461349035.8,6165345,2086653,3555936,11807934
2009-03-12,CBOE (W),2162100,7356300,1644200,11162600,34064211.0,372696413.72,39329772.0,446090396.72,2763,5314,7971,16048
2009-03-12,BATS (Z),704428022,407994447,295918127,1408340596,14025506762.9,13915439473.9,5369352704.26,33310298941.1,4726415,1750022,1861689,8338126
2009-03-13,AMEX (A),0,8629626,0,8629626,0.0,37609617.16,0.0,37609617.16,0,16735,0,16735
2009-03-13,BEX (B),18152378,14458539,8617974,41228891,333074459.109,568827650.24,147987070.385,1049889179.73,116971,52772,49582,219325
2009-03-13,NSX (C),54175747,6242998,11933814,72352559,885524304.668,234276791.798,253903815.175,1373704911.64,194660,22425,59651,276736
2009-03-13,NYSE (DN),11567224,1000208,9511315,22078747,194809518.997,33988068.6154,144411683.449,373209271.062,30284,1856,22095,54235
2009-03-13,NASDAQ (DQ),2125098343,807513164,673087808,3605699315,27485495024.5,18614717815.5,9541006394.81,55641219234.8,4585964,1094622,1576381,7256967
2009-03-13,ADF (D),41473999,2478050,10992517,54944566,851276771.092,84435409.82,179181648.822,1114893829.73,143790,6694,39732,190216
2009-03-13,ISE (I),108916853,38244261,29819534,176980648,1264437811.21,699447589.825,382374650.185,2346260051.22,319306,64714,106867,490887
2009-03-13,CHX (M),18551373,16595503,3461500,38608376,343086177.208,754203192.041,86307388.242,1183596757.49,18479,7403,4421,30303
2009-03-13,NYSE (N),1611219123,0,8500,1611227623,27387075348.6,0.0,71197.5,27387146546.1,4697039,0,39,4697078
2009-03-13,NYSE Arca (P),1043484254,544382906,315426164,1903293324,19088207827.3,17915619885.4,5957398844.21,42961226556.8,5690915,1828870,1737360,9257145
2009-03-13,NASDAQ (Q),1116619441,631938941,770374001,2518932383,19179298704.4,21547475795.6,13427510613.5,54154285113.4,5667739,2032847,3207099,10907685
2009-03-13,CBOE (W),3870300,6212200,2077900,12160400,25566798.6,354648565.0,56312132.0,436527495.6,2775,5501,6324,14600
2009-03-13,BATS (Z),636368810,364049741,251603990,1252022541,12458586478.4,12365332751.9,4604841684.34,29428760914.6,4269295,1682882,1628087,7580264
2009-03-16,AMEX (A),0,9171154,0,9171154,0.0,38661230.45,0.0,38661230.45,0,18099,0,18099
2009-03-16,BEX (B),19362736,15777452,8936360,44076548,285108518.688,571076836.275,157552019.926,1013737374.89,100552,49864,46634,197050
2009-03-16,NSX (C),65583671,5127155,14994662,85705488,898173411.281,176208437.739,313292692.348,1387674541.37,208445,17781,66656,292882
2009-03-16,NYSE (DN),11760922,876585,9799203,22436710,196318344.125,29383135.1735,153134518.769,378835998.068,28429,1761,22634,52824
2009-03-16,NASDAQ (DQ),2624239108,744686493,742112245,4111037846,29032499940.5,18842914860.0,10626942426.8,58502357227.4,4873223,1132076,1607625,7612924
2009-03-16,ADF (D),40275054,2657946,10987253,53920253,764867245.453,79875224.37,183404416.044,1028146885.87,132176,5983,36887,175046
2009-03-16,ISE (I),150747692,41460091,35561013,227768796,1393970088.93,693605493.447,387258074.486,2474833656.86,353252,67938,105745,526935
2009-03-16,CHX (M),30532526,17903911,5554349,53990786,531992490.274,984855222.08,131325042.036,1648172754.39,23677,8583,4805,37065
2009-03-16,NYSE (N),1898380617,0,11100,1898391717,30100175278.0,0.0,252939.5,30100428217.5,4635125,0,32,4635157
2009-03-16,NYSE Arca (P),1159611140,592703478,323415656,2075730274,19016511595.1,20634878124.0,6386209496.28,46037599215.4,5561883,1824893,1694903,9081679
2009-03-16,NASDAQ (Q),1212133696,622068577,770823835,2605026108,19284011730.0,22373985158.7,13992195412.7,55650192301.4,5627929,1943076,3158668,10729673
2009-03-16,CBOE (W),13937800,7092800,1577800,22608400,77325219.63,402501146.0,37311480.0,517137845.63,3731,4736,6824,15291
2009-03-16,BATS (Z),661577681,355272326,254572255,1271422262,12290269084.4,12804160385.9,4613474898.2,29707904368.6,4109086,1629445,1606888,7345419
2009-03-17,AMEX (A),0,8978369,0,8978369,0.0,41052065.32,0.0,41052065.32,0,18250,0,18250
2009-03-17,BEX (B),16453277,12369822,8642568,37465667,267046806.525,527889297.591,147613268.48,942549372.597,93890,42505,42488,178883
2009-03-17,NSX (C),53980930,4666870,13248786,71896586,803114566.287,197849751.33,298413086.833,1299377404.45,186510,17649,62885,267044
2009-03-17,NYSE (DN),10770115,962481,9441770,21174366,177300849.134,34508046.9963,134543231.841,346352127.972,27085,1754,21363,50202
2009-03-17,NASDAQ (DQ),1876447062,660525231,712431550,3249403843,23763086216.7,18230747802.9,9875954713.21,51869788732.8,4128026,983140,1507660,6618826
2009-03-17,ADF (D),35492806,2782742,11334956,49610504,710847050.468,108735183.51,197708790.255,1017291024.23,127361,7438,39883,174682
2009-03-17,ISE (I),100284183,40332472,37801959,178418614,1082003898.66,696628179.738,406918128.387,2185550206.78,296279,63839,101272,461390
2009-03-17,CHX (M),34792480,16522588,3979187,55294255,416332735.096,809341631.65,106378187.587,1332052554.33,17603,6387,4100,28090
2009-03-17,NYSE (N),1492182994,0,8500,1492191494,26310296453.9,0.0,188696.0,26310485149.9,4435651,0,23,4435674
2009-03-17,NYSE Arca (P),955569317,510702276,321318632,1787590225,17410137792.3,19196998914.6,6572917042.72,43180053749.6,5098556,1646612,1651256,8396424
2009-03-17,NASDAQ (Q),1007775285,548220831,770460730,2326456846,17400932696.9,20442589273.1,13832066854.0,51675588823.9,5108158,1712920,3073237,9894315
2009-03-17,CBOE (W),10263100,6556000,2250900,19070000,47542769.66,422554242.45,58686200.27,528783212.38,2463,4445,6789,13697
2009-03-17,BATS (Z),566781908,313643737,242292803,1122718448,11288766885.7,11473234076.5,4690993736.14,27452994698.4,3757766,1440515,1510427,6708708
2009-03-18,AMEX (A),0,12032396,0,12032396,0.0,56955781.98,0.0,56955781.98,0,24435,0,24435
2009-03-18,BEX (B),13692756,17698247,8073458,39464461,264618120.753,696535776.412,182082979.324,1143236876.49,99615,61220,48028,208863
2009-03-18,NSX (C),73894042,9299681,15009893,98203616,939498124.11,356907751.59,284790171.351,1581196047.05,200565,27915,58945,287425
2009-03-18,NYSE (DN),13245270,2255656,10500597,26001523,235331472.931,83459470.9788,176249789.695,495040733.605,32764,3718,24099,60581
2009-03-18,NASDAQ (DQ),2790243569,941068032,950231828,4681543429,31005403315.2,24735531361.6,11952638983.4,67693573660.2,5343172,1333178,1918676,8595026
2009-03-18,ADF (D),50272919,4132780,14898607,69304306,857414151.358,137406134.76,210243656.94,1205063943.06,149658,8549,45546,203753
2009-03-18,ISE (I),175524385,62500439,55730635,293755459,1709051128.45,1114078168.3,516706876.699,3339836173.45,427496,91927,136188,655611
2009-03-18,CHX (M),29284419,13737491,5768052,48789962,392604546.572,755622852.707,149200717.248,1297428116.53,19490,8774,7665,35929
2009-03-18,NYSE (N),2077410705,0,14100,2077424805,35464549180.7,0.0,328678.5,35464877859.2,5818708,0,36,5818744
2009-03-18,NYSE Arca (P),1445098323,800024915,455426391,2700549629,24423013438.7,28222976045.3,8749238126.18,61395227610.2,7143380,2482965,2300158,11926503
2009-03-18,NASDAQ (Q),1567348704,921831176,989275102,3478454982,25457655897.3,33239573425.0,17361834242.7,76059063565.1,7393439,2746292,4020102,14159833
2009-03-18,CBOE (W),15225400,7526900,4055100,26807400,119890641.8,462301723.0,115269347.06,697461711.86,5232,7418,9430,22080
2009-03-18,BATS (Z),865961369,532681143,318852266,1717494778,16640678839.7,18368693620.4,5812113839.57,40821486299.7,5476757,2249018,1983699,9709474
2009-03-19,AMEX (A),0,14717964,0,14717964,0.0,52512691.62,0.0,52512691.62,0,26163,0,26163
2009-03-19,BEX (B),17224816,19110475,7813267,44148558,334895355.842,823164862.33,239878799.56,1397939017.73,127924,81741,52863,262528
2009-03-19,NSX (C),80517853,7959442,15044991,103522286,1079309972.76,303161250.78,287017146.396,1669488369.94,246798,22513,74752,344063
2009-03-19,NYSE (DN),16194893,1651165,9934371,27780429,307493135.783,50777028.4509,151162372.417,509432536.65,42377,3098,23832,69307
2009-03-19,NASDAQ (DQ),3021991062,908653028,843455690,4774099780,33775389485.9,23623498020.6,10781695906.3,68180583412.7,5774593,1282077,1791142,8847812
2009-03-19,ADF (D),50518133,4745064,12173289,67436486,886750415.925,204500780.52,203126962.23,1294378158.67,150957,14614,42845,208416
2009-03-19,ISE (I),168010430,50775134,42058711,260844275,1728489441.75,845758294.39,419426313.789,2993674049.93,416319,84052,123962,624333
2009-03-19,CHX (M),26755371,19094980,7632394,53482745,497143856.694,1024559778.45,216439916.84,1738143551.98,26619,9327,5022,40968
2009-03-19,NYSE (N),1952162872,0,10600,1952173472,32444787738.3,0.0,119470.5,32444907208.8,5218051,0,18,5218069
2009-03-19,NYSE Arca (P),1426830636,728868426,362250025,2517949087,23471281200.5,24353089711.4,7054841009.24,54879211921.1,6680797,2143069,1906520,10730386
2009-03-19,NASDAQ (Q),1484817280,811494223,809534700,3105846203,23406516056.2,27736792288.6,13843031304.8,64986339649.5,6727808,2379253,3309214,12416275
2009-03-19,CBOE (W),11374900,21123300,1974200,34472400,117992342.6,1493165381.4,42085663.0,1653243387.0,3722,6615,6691,17028
2009-03-19,BATS (Z),785332693,438270670,264902232,1488505595,14729862520.7,15016591808.8,4813136677.24,34559591006.8,4830316,1873882,1663040,8367238
2009-03-20,AMEX (A),0,19672586,0,19672586,0.0,76883333.6,0.0,76883333.6,0,23185,0,23185
2009-03-20,BEX (B),14772871,14683052,7196576,36652499,347901605.305,647107405.38,222332965.014,1217341975.7,114059,64082,47731,225872
2009-03-20,NSX (C),63862166,6723255,17363398,87948819,774646163.424,205106228.524,287696007.21,1267448399.16,187787,17415,62930,268132
2009-03-20,NYSE (DN),11422567,895024,9300301,21617892,209278561.111,29304961.9764,144821133.861,383404656.948,27323,1659,21545,50527
2009-03-20,NASDAQ (DQ),2237842651,688865838,791414542,3718123031,27206556429.0,19593369284.8,10826198631.2,57626124345.1,4506376,1080133,1637125,7223634
2009-03-20,ADF (D),40675952,2850083,14181332,57707367,782105904.534,89961025.0,236172507.881,1108239437.42,148056,7756,52999,208811
2009-03-20,ISE (I),125183797,41797359,33941271,200922427,1305839428.76,727142834.99,378007451.721,2410989715.48,339071,70315,107443,516829
2009-03-20,CHX (M),23255080,13162938,8314694,44732712,461587908.431,725550952.085,303106837.425,1490245697.94,14208,8637,4384,27229
2009-03-20,NYSE (N),2466888854,1700,7500,2466898054,44982780029.3,12799.0,104019.0,44982896847.3,4559363,2,21,4559386
2009-03-20,NYSE Arca (P),1029735591,598193931,316011894,1943941416,17832929574.0,20281795563.5,6061160294.61,44175885432.1,5242655,1838960,1701618,8783233
2009-03-20,NASDAQ (Q),1053232488,652792042,1084563799,2790588329,17946222860.5,22514019023.0,18696847309.6,59157089193.1,5215307,1921616,3041426,10178349
2009-03-20,CBOE (W),3582100,7783200,2839000,14204300,45557625.26,466207833.8,96538029.0,608303488.06,2208,5444,7769,15421
2009-03-20,BATS (Z),576905206,375750254,235661009,1188316469,11196138754.4,13898055805.6,4264392671.36,29358587231.4,3757481,1691396,1518807,6967684
2009-03-23,AMEX (A),0,13559618,0,13559618,0.0,65191093.67,0.0,65191093.67,0,24578,0,24578
2009-03-23,BEX (B),12850761,13274596,7243867,33369224,341580492.03,636969485.79,265006727.962,1243556705.78,102733,68472,47624,218829
2009-03-23,NSX (C),56226599,8136015,15439250,79801864,796888166.455,254320510.028,303699412.235,1354908088.72,185538,21052,62730,269320
2009-03-23,NYSE (DN),12707769,1274464,11030235,25012468,242169394.961,41902552.353,166878886.118,450950833.432,32636,2378,24227,59241
2009-03-23,NASDAQ (DQ),2476735074,902878359,767441630,4147055063,31930065283.9,24393094375.3,11724727478.6,68047887137.8,5268962,1373227,1841978,8484167
2009-03-23,ADF (D),43199202,4377736,12635235,60212173,824632862.795,161496892.88,224905728.19,1211035483.87,143503,9949,45063,198515
2009-03-23,ISE (I),133272005,55219022,40375192,228866219,1735527099.46,1047346398.85,523713449.654,3306586947.96,416563,94338,130493,641394
2009-03-23,CHX (M),19786571,10987475,7359875,38133921,439277291.366,637634972.108,113444335.42,1190356598.89,15915,7851,4788,28554
2009-03-23,NYSE (N),1914859822,0,3000,1914862822,34905157569.9,0.0,51311.5,34905208881.4,4818400,0,14,4818414
2009-03-23,NYSE Arca (P),1201238879,741740946,358904561,2301884386,22385446883.1,25565134346.9,7271799101.02,55222380331.1,6051312,2100741,1929008,10081061
2009-03-23,NASDAQ (Q),1182059822,758006999,821311171,2761377992,21094371366.2,26661892637.6,15186403851.1,62942667855.0,5854177,2150955,3383165,11388297
2009-03-23,CBOE (W),6510300,9494800,3982800,19987900,70248877.82,548357199.05,108031482.12,726637558.99,3951,6049,8985,18985
2009-03-23,BATS (Z),660545332,404140954,256425450,1321111736,13780210509.7,14486827103.2,4822913613.24,33089951226.2,4358774,1725444,1651377,7735595
2009-03-24,AMEX (A),0,14074474,0,14074474,0.0,65103743.15,0.0,65103743.15,0,22660,0,22660
2009-03-24,BEX (B),15126088,14045924,7386411,36558423,398628530.562,600688894.011,300095949.379,1299413373.95,123555,62099,52745,238399
2009-03-24,NSX (C),56925373,7489088,16875342,81289803,873686604.656,272902541.895,306212659.472,1452801806.02,204767,19476,70616,294859
2009-03-24,NYSE (DN),11903473,1209890,9527676,22641039,220676663.607,36564362.5144,149229173.849,406470199.97,32319,2221,22234,56774
2009-03-24,NASDAQ (DQ),2123175198,798878062,734131020,3656184280,29912237174.8,20183186798.8,10297950582.8,60393374556.5,4953163,1249567,1719365,7922095
2009-03-24,ADF (D),47410150,3282185,13699212,64391547,896712580.182,94676913.41,238777587.655,1230167081.25,173408,8475,55539,237422
2009-03-24,ISE (I),126280361,52166661,38928035,217375057,1554474233.5,868079453.762,436455168.73,2859008855.99,376416,81642,115687,573745
2009-03-24,CHX (M),18376976,10885731,6141527,35404234,424770688.299,622084907.872,142215429.82,1189071025.99,13486,7402,4583,25471
2009-03-24,NYSE (N),1646185574,100,12100,1646197774,29651124909.2,719.5,229569.5,29651355198.2,4743658,1,25,4743684
2009-03-24,NYSE Arca (P),1051157084,579656297,316753936,1947567317,20680997963.2,19071058663.9,6388045684.31,46140102311.4,5760037,1808701,1757150,9325888
2009-03-24,NASDAQ (Q),1070596495,652653447,672023000,2395272942,19731698430.8,23349688652.7,12144520142.1,55225907225.6,5674976,2035733,3136140,10846849
2009-03-24,CBOE (W),5174000,8658400,3077500,16909900,104628576.8,396573337.0,86540393.17,587742306.97,3030,5613,6681,15324
2009-03-24,BATS (Z),603241894,359271376,232325815,1194839085,12395825319.0,12503868948.3,4296862977.31,29196557244.6,4093651,1618059,1561111,7272821
2009-03-25,AMEX (A),0,12119231,0,12119231,0.0,48226692.61,0.0,48226692.61,0,23938,0,23938
2009-03-25,BEX (B),17003855,18238399,9351187,44593441,454813238.566,854137444.0,343290592.617,1652241275.18,137141,88770,63469,289380
2009-03-25,NSX (C),55212137,7963893,19977494,83153524,868519923.402,333340597.398,304679093.848,1506539614.65,192668,22918,77187,292773
2009-03-25,NYSE (DN),13084605,1575172,10883299,25543076,251174656.042,49718102.4944,175713326.575,476606085.112,33668,3287,24156,61111
2009-03-25,NASDAQ (DQ),2458567744,998570550,852308777,4309447071,32799754822.1,24369462393.1,12077133107.0,69246350322.2,5356045,1582859,1967018,8905922
2009-03-25,ADF (D),47195563,2785199,16204870,66185632,909362882.24,110809468.6,274098509.966,1294270860.81,160845,6957,59356,227158
2009-03-25,ISE (I),143497734,59299013,45140956,247937703,1712695906.21,987578304.181,519366732.833,3219640943.23,412292,95436,139600,647328
2009-03-25,CHX (M),21355417,13216095,5560395,40131907,465510178.165,855110042.901,126960878.215,1447581099.28,18465,9728,6671,34864
2009-03-25,NYSE (N),1773644659,0,7600,1773652259,32561658331.8,0.0,100287.5,32561758619.3,5284571,0,24,5284595
2009-03-25,NYSE Arca (P),1214184307,750695489,381174650,2346054446,23204634130.0,25348924844.6,7498704507.02,56052263481.6,6632033,2330571,2085957,11048561
2009-03-25,NASDAQ (Q),1224783626,851964318,869706753,2946454697,22562924784.4,30753152891.4,15882284720.5,69198362396.3,6547702,2686870,3686594,12921166
2009-03-25,CBOE (W),9255000,7314400,1814100,18383500,79351662.12,372643833.5,44019582.0,496015077.62,3928,7403,8507,19838
2009-03-25,BATS (Z),713512841,461825983,289100597,1464439421,14708834765.3,15772438482.6,5375609754.85,35856883002.7,4799459,2026262,1886091,8711812
2009-03-26,AMEX (A),0,17256453,0,17256453,0.0,59475668.82,0.0,59475668.82,0,22934,0,22934
2009-03-26,BEX (B),19570321,19760952,12213259,51544532,477572704.88,876970056.1,443584392.201,1798127153.18,135472,80623,71383,287478
2009-03-26,NSX (C),54933502,8451630,20511959,83897091,973366796.884,300777347.896,345445157.076,1619589301.86,215488,24074,81198,320760
2009-03-26,NYSE (DN),11918133,1360312,10280658,23559103,242940537.467,43489804.257,173814877.501,460245219.225,33815,2839,24232,60886
2009-03-26,NASDAQ (DQ),2111987451,853404918,925216329,3890608698,31449259506.7,23093989081.7,13610193385.3,68153441973.6,4801703,1343714,1936835,8082252
2009-03-26,ADF (D),38911432,3111938,17132276,59155646,780868265.405,86523930.5317,289279788.61,1156671984.55,131414,7725,57301,196440
2009-03-26,ISE (I),125522483,53909476,53564912,232996871,1586876005.8,894385208.597,561635569.114,3042896783.51,370043,92190,139059,601292
2009-03-26,CHX (M),19286044,23595614,7421503,50303161,354778521.683,1326009631.96,180405803.034,1861193956.68,18330,8576,5616,32522
2009-03-26,NYSE (N),1810001126,0,4000,1810005126,35965316820.4,0.0,97140.5,35965413960.9,5595962,0,21,5595983
2009-03-26,NYSE Arca (P),1057869702,621515002,380899073,2060283777,21965100275.0,22184913073.9,7650280663.34,51800294012.2,6206602,2022878,2082384,10311864
2009-03-26,NASDAQ (Q),1104536206,750239323,938937855,2793713384,21940317814.6,29594397173.5,17612870962.2,69147585950.2,6303623,2488193,3773336,12565152
2009-03-26,CBOE (W),8014500,7127500,3761500,18903500,87743137.6,358354595.0,110179683.1,556277415.7,2847,6448,9098,18393
2009-03-26,BATS (Z),641130002,389851294,280895773,1311877069,14257109948.7,13672070484.5,5425809435.07,33354989868.3,4576986,1811786,1838336,8227108
2009-03-27,AMEX (A),0,12512822,0,12512822,0.0,42360873.74,0.0,42360873.74,0,21933,0,21933
2009-03-27,BEX (B),15266590,14246238,11464669,40977497,337967449.767,644979894.4,324083429.451,1307030773.62,100266,51291,66459,218016
2009-03-27,NSX (C),42786965,6882721,15711908,65381594,675479936.534,271154766.433,242802414.558,1189437117.52,149771,18407,60396,228574
2009-03-27,NYSE (DN),9369519,923612,8391229,18684360,182089193.484,29340902.8327,129624571.314,341054667.631,27377,1811,20857,50045
2009-03-27,NASDAQ (DQ),1755696625,692924463,771086337,3219707425,24876191070.3,19588392743.3,10000893090.2,54465476903.8,4092529,1127543,1662579,6882651
2009-03-27,ADF (D),37830694,2198029,14235171,54263894,794562079.439,80546968.565,216612330.448,1091721378.45,141980,6423,53668,202071
2009-03-27,ISE (I),119293368,45415362,55783779,220492509,1408549721.48,895803800.946,501087205.178,2805440727.61,316678,89442,138385,544505
2009-03-27,CHX (M),15219097,10504918,4935783,30659798,344337258.847,626748428.91,99621126.5076,1070706814.26,13435,6664,4432,24531
2009-03-27,NYSE (N),1443414657,0,9400,1443424057,26312924472.2,0.0,140368.5,26313064840.7,4491878,0,35,4491913
2009-03-27,NYSE Arca (P),840465825,490248602,311992558,1642706985,17021806875.9,17198817588.2,5543541176.22,39764165640.3,4875400,1672325,1588643,8136368
2009-03-27,NASDAQ (Q),833633830,559654617,703308398,2096596845,15842185416.7,21592999499.2,12323030669.9,49758215585.8,4708979,1874360,3011278,9594617
2009-03-27,CBOE (W),5129500,5664100,2211500,13005100,120859386.4,313076066.0,56576675.29,490512127.69,2702,4629,7008,14339
2009-03-27,BATS (Z),486897409,327081831,225234757,1039213997,10539252556.1,11665709993.7,4164215870.21,26369178420.0,3449039,1528479,1458730,6436248
2009-03-30,AMEX (A),0,14444157,0,14444157,0.0,56472812.5,0.0,56472812.5,0,22317,0,22317
2009-03-30,BEX (B),17265913,22490668,13494474,53251055,366433633.98,1003599100.95,380733620.8,1750766355.73,110810,93565,74336,278711
2009-03-30,NSX (C),47042669,5810330,17272739,70125738,787976616.706,233527769.498,275498376.558,1297002762.76,188762,16416,67187,272365
2009-03-30,NYSE (DN),10892654,1237696,8546534,20676884,205404471.444,39944448.375,136212970.225,381561890.044,33555,2115,21785,57455
2009-03-30,NASDAQ (DQ),1849210700,742935852,715643063,3307789615,24281807698.1,18672679111.7,9961788456.31,52916275266.1,4578235,1162871,1652220,7393326
2009-03-30,ADF (D),31633751,2515245,10324091,44473087,594037777.734,76698086.27,177917786.779,848653650.782,112868,6165,36652,155685
2009-03-30,ISE (I),121617459,55532509,56859813,234009781,1520388904.27,1015189139.59,530690281.091,3066268324.95,383697,93729,144120,621546
2009-03-30,CHX (M),11408069,7884188,6118199,25410456,261707505.008,478893191.4,129503260.865,870103957.273,15212,8050,4495,27757
2009-03-30,NYSE (N),1511506887,0,3400,1511510287,26324691188.9,0.0,36600.5,26324727789.4,4014407,0,20,4014427
2009-03-30,NYSE Arca (P),901775827,508019884,301727707,1711523418,17258938358.5,17011841303.7,5618439974.17,39889219636.4,5074653,1599654,1599460,8273767
2009-03-30,NASDAQ (Q),927423186,556927360,728950553,2213301099,16873515403.8,21184967613.4,12567605205.1,50626088222.3,5029906,1755038,2898244,9683188
2009-03-30,CBOE (W),2378100,6322200,1170000,9870300,30412253.0,306237282.5,26550893.0,363200428.5,2553,5288,6024,13865
2009-03-30,BATS (Z),484393023,310334893,205759607,1000487523,9797673417.94,11308056259.5,3707833811.53,24813563489.0,3269490,1354327,1319040,5942857
2009-03-31,AMEX (A),0,16357926,0,16357926,0.0,59398778.5,0.0,59398778.5,0,22645,0,22645
2009-03-31,BEX (B),18197305,27771595,12706387,58675287,412113384.418,1334156076.04,372657795.059,2118927255.52,113658,112570,63855,290083
2009-03-31,NSX (C),48140982,6716013,16331276,71188271,827057978.857,226299942.639,262535921.184,1315893842.68,179786,15753,57147,252686
2009-03-31,NYSE (DN),9959677,1102656,9203467,20265800,193905863.511,34970486.3752,141382902.452,370259252.338,31466,2050,21520,55036
2009-03-31,NASDAQ (DQ),1885009319,757038549,765807463,3407855331,27137496381.0,19686789150.5,11506705343.2,58330990874.7,4461513,1114480,1682610,7258603
2009-03-31,ADF (D),40722522,2100577,12181417,55004516,741642550.632,67123718.576,198943404.218,1007709673.43,148410,5217,48206,201833
2009-03-31,ISE (I),123358163,57310834,60287868,240956865,1642993633.4,1092575621.37,664498901.163,3400068155.93,400776,99481,153891,654148
2009-03-31,CHX (M),15741621,7958984,5913295,29613900,387995488.489,504982842.36,227385036.07,1120363366.92,15798,6326,4594,26718
2009-03-31,NYSE (N),1638874842,0,4200,1638879042,30550081450.7,0.0,99399.0,30550180849.7,4231721,0,15,4231736
2009-03-31,NYSE Arca (P),894170714,562862612,328693997,1785727323,18048407764.5,18921291675.7,6380101779.6,43349801219.8,5195643,1701500,1709581,8606724
2009-03-31,NASDAQ (Q),883692565,583915843,771467836,2239076244,16760885585.7,22924357832.6,13913639075.5,53598882493.7,4939894,1797638,2977780,9715312
2009-03-31,CBOE (W),6116300,4638200,1224600,11979100,98347760.0,249692631.3,27277326.0,375317717.3,2238,3671,6625,12534
2009-03-31,BATS (Z),534575834,304890674,222496726,1061963234,11370255437.8,11364747950.7,4157127725.72,26892131114.3,3653862,1353406,1402638,6409906
2009-04-01,AMEX (A),0,14337691,0,14337691,0.0,43770957.77,0.0,43770957.77,0,21989,0,21989
2009-04-01,BEX (B),26356711,30772977,15781322,72911010,644361509.85,1598150052.25,458696887.36,2701208449.47,184708,145515,97950,428173
2009-04-01,NSX (C),46733352,11660595,17697776,76091723,830263202.684,394757293.203,312270184.097,1537290679.98,181449,27834,70071,279354
2009-04-01,NYSE (DN),11049601,1095179,10309700,22454480,220890468.959,31235848.9708,175677985.707,427804303.637,37207,1821,24019,63047
2009-04-01,NASDAQ (DQ),1895686085,807398813,779745143,3482830041,27472967023.9,20544355383.4,12149758719.5,60167081126.7,4534061,1140178,1824821,7499060
2009-04-01,ADF (D),39274558,2921387,15012034,57207979,764787728.669,153508837.42,271048233.046,1189344799.13,149154,8752,58140,216046
2009-04-01,ISE (I),128498027,64169413,59008853,251676293,1740538306.9,1205681006.5,745005273.668,3691224587.06,429221,116900,176796,722917
2009-04-01,CHX (M),15895362,9475781,5198909,30570052,401632557.952,562495609.56,111132295.655,1075260463.17,20855,8239,4766,33860
2009-04-01,NYSE (N),1502774836,0,6700,1502781536,28861002360.9,0.0,120072.0,28861122432.9,4489064,0,18,4489082
2009-04-01,NYSE Arca (P),927291393,567638054,371150860,1866080307,19141185557.2,20422114641.7,7615961382.36,47179261581.3,5458527,1791172,2003455,9253154
2009-04-01,NASDAQ (Q),931174359,571200488,785036231,2287411078,18003244418.2,22370840009.5,14835487683.7,55209572111.4,5291658,1897214,3402053,10590925
2009-04-01,CBOE (W),13872100,7630400,1344000,22846500,100312553.32,425267423.76,32368023.0,557948000.08,2003,2955,5870,10828
2009-04-01,BATS (Z),500834528,294966371,230299469,1026100368,10142026024.5,10936342118.1,4279502611.7,25357870754.3,3339342,1313524,1440959,6093825
2009-04-02,AMEX (A),0,16175888,0,16175888,0.0,59692722.35,0.0,59692722.35,0,25007,0,25007
2009-04-02,BEX (B),42164955,39381307,20606612,102152874,885314666.73,1843362961.42,573195689.844,3301873317.99,249661,161961,125492,537114
2009-04-02,NSX (C),55015442,13752961,22613842,91382245,1047045265.55,451011960.408,355648726.603,1853705952.56,221345,32565,78915,332825
2009-04-02,NYSE (DN),12791213,1378614,12219891,26389718,250519080.882,46881507.1195,209380388.955,506780976.956,36717,2561,28557,67835
2009-04-02,NASDAQ (DQ),2414401538,1012402461,980622269,4407426268,36421375497.0,28341967750.4,15862381783.3,80625725030.6,5779645,1496790,2278292,9554727
2009-04-02,ADF (D),48388743,2724022,17948137,69060902,1039384298.87,103189091.045,341276632.144,1483850022.06,185381,7196,64821,257398
2009-04-02,ISE (I),185365585,81015812,77573344,343954741,2599708347.15,1724866475.11,957106314.712,5281681136.97,612504,154897,226628,994029
2009-04-02,CHX (M),22745730,12918437,6612772,42276939,574611450.503,783181834.6,132347040.465,1490140325.57,21029,7018,5676,33723
2009-04-02,NYSE (N),1874519055,0,7400,1874526455,35795757282.1,0.0,127238.0,35795884520.1,5252950,0,23,5252973
2009-04-02,NYSE Arca (P),1148737696,743191053,442094185,2334022934,24111262056.3,26870862733.8,9631731543.62,60613856333.7,6329052,2124042,2293395,10746489
2009-04-02,NASDAQ (Q),1126694993,710078075,959322636,2796095704,22373550478.5,28194431066.2,18851868210.0,69419849754.7,6149643,2267813,3972772,12390228
2009-04-02,CBOE (W),5853100,6959300,1402300,14214700,56799107.16,310456191.44,42616951.0,409872249.6,3547,2870,6731,13148
2009-04-02,BATS (Z),612659966,387072818,300741136,1300473920,12927700803.2,14835563733.7,5795123325.32,33558387862.2,4088337,1720547,1863330,7672214
2009-04-03,AMEX (A),0,11641232,0,11641232,0.0,48956738.48,0.0,48956738.48,0,21045,0,21045
2009-04-03,BEX (B),28438895,23990735,14192042,66621672,648116767.546,1178389098.67,424381700.784,2250887567.0,188367,112496,97280,398143
2009-04-03,NSX (C),40004766,12895000,16408126,69307892,747118136.458,345991986.532,303262289.486,1396372412.48,164574,24844,71050,260468
2009-04-03,NYSE (DN),7798851,920985,8386659,17106495,145547011.503,28888282.723,134841944.061,309277238.287,21297,1492,17234,40023
2009-04-03,NASDAQ (DQ),1785894992,730299564,734404359,3250598915,27412337970.5,19367807534.9,11973888912.6,58754034418.0,4637302,1145531,1808654,7591487
2009-04-03,ADF (D),36621098,2070327,13292628,51984053,722840052.374,63634170.6348,243442098.075,1029916321.08,135284,5570,49081,189935
2009-04-03,ISE (I),156386525,57794227,55781177,269961929,2142516979.4,1210043183.28,789098344.531,4141658507.21,512832,118040,175643,806515
2009-04-03,CHX (M),18582283,12349737,7239621,38171641,418180244.537,618046049.136,284951459.515,1321177753.19,14083,7261,4255,25599
2009-04-03,NYSE (N),1484215866,0,8400,1484224266,28556333418.8,0.0,142138.0,28556475556.8,4302815,0,31,4302846
2009-04-03,NYSE Arca (P),896240062,509054394,326156265,1731450721,18856379157.9,18061992715.4,7238607118.77,44156978992.2,5154358,1631977,1742297,8528632
2009-04-03,NASDAQ (Q),903634114,506991785,721663969,2132289868,17908579962.0,20106818598.7,14806324173.4,52821722734.1,5111732,1730260,3141795,9983787
2009-04-03,CBOE (W),5820600,6456800,1529300,13806700,69693925.4,294262966.26,42190681.0,406147572.66,2802,1930,5098,9830
2009-04-03,BATS (Z),494563855,293614928,239227456,1027406239,10627250846.2,10565117995.5,4900704541.62,26093073383.3,3424593,1379820,1509697,6314110
2009-04-06,AMEX (A),0,12671402,0,12671402,0.0,39762639.16,0.0,39762639.16,0,19347,0,19347
2009-04-06,BEX (B),29569558,27804460,15385712,72759730,619352711.7,1189777850.63,438032739.63,2247163301.96,183812,119795,97296,400903
2009-04-06,NSX (C),45200995,14533987,17142019,76877001,769618863.666,305370833.063,297277641.004,1372267337.73,178807,26265,69250,274322
2009-04-06,NYSE (DN),13186153,1008226,8809090,23003469,247394802.972,26111615.8814,145617939.621,419124358.475,38554,1600,22065,62219
2009-04-06,NASDAQ (DQ),1716988949,635892978,716338491,3069220418,25791389465.0,16164095662.0,11474480057.9,53429965184.9,4536988,1056534,1708264,7301786
2009-04-06,ADF (D),29204350,2236911,10948603,42389864,582980411.199,57253029.6,199940023.986,840173464.785,109652,5724,43230,158606
2009-04-06,ISE (I),139439199,47329190,61574119,248342508,1959498394.36,1012746153.97,758569241.084,3730813789.42,488680,106478,171010,766168
2009-04-06,CHX (M),11691191,9322485,6120522,27134198,249793794.501,542941340.355,155099414.088,947834548.944,15915,7801,5316,29032
2009-04-06,NYSE (N),1295822604,0,7500,1295830104,24935171594.6,0.0,106914.5,24935278509.1,4056498,0,23,4056521
2009-04-06,NYSE Arca (P),794524010,472712518,293222682,1560459210,16669508323.0,16870627867.6,6284500145.68,39824636336.3,4646153,1457403,1603687,7707243
2009-04-06,NASDAQ (Q),838108698,495614842,712767886,2046491426,16144938713.1,18601744283.1,13657914829.8,48404597826.0,4793884,1679082,3010503,9483469
2009-04-06,CBOE (W),5211900,3671300,859000,9742200,44636408.0,166935898.25,28586449.0,240158755.25,2343,2377,4522,9242
2009-04-06,BATS (Z),434496705,287497141,213558336,935552182,9490715028.28,9735681356.31,4240840416.45,23467236801.0,3064995,1326420,1385936,5777351
2009-04-07,AMEX (A),0,11101386,0,11101386,0.0,41275947.94,0.0,41275947.94,0,21488,0,21488
2009-04-07,BEX (B),28450672,23375677,14766662,66593011,575872630.82,963449690.16,408599472.326,1947921793.31,172960,96904,88513,358377
2009-04-07,NSX (C),35199145,15260937,13333450,63793532,594476342.007,324542620.706,227204424.896,1146223387.61,135906,24157,52318,212381
2009-04-07,NYSE (DN),11992080,1008366,7874829,20875275,212023608.618,24842296.9042,129310288.809,366176194.331,30295,1381,19484,51160
2009-04-07,NASDAQ (DQ),1638321545,556588408,659519234,2854429187,24293826675.0,14251915078.7,10982421827.1,49528163580.9,4131152,894870,1607880,6633902
2009-04-07,ADF (D),35478229,2142520,11487654,49108403,721009591.277,63573760.3248,202338031.776,986921383.378,139235,5767,44080,189082
2009-04-07,ISE (I),138172200,38494497,54864923,231531620,1929411578.0,898273984.58,762821260.583,3590506823.16,462586,80817,168285,711688
2009-04-07,CHX (M),15681511,11269730,5649288,32600529,336280762.232,693907052.43,104768989.801,1134956804.46,15141,7189,4218,26548
2009-04-07,NYSE (N),1261882918,0,7800,1261890718,23657110955.5,0.0,206156.0,23657317111.5,3771162,0,26,3771188
2009-04-07,NYSE Arca (P),799657388,435817323,286216638,1521691349,16120393037.2,15989777791.7,6278778824.52,38388949653.5,4535338,1378138,1597583,7511059
2009-04-07,NASDAQ (Q),745312097,413829573,635229678,1794371348,14317391653.9,16090237416.8,12665491638.0,43073120708.7,4219423,1373637,2817137,8410197
2009-04-07,CBOE (W),10647400,3258000,2186900,16092300,53693234.32,181578702.0,63777764.0,299049700.32,2285,2788,4524,9597
2009-04-07,BATS (Z),445175790,247115154,209641532,901932476,9360069517.88,8958051741.51,4131387477.36,22449508736.7,3049369,1175396,1332442,5557207
2009-04-08,AMEX (A),0,11381772,0,11381772,0.0,56518632.2,0.0,56518632.2,0,21474,0,21474
2009-04-08,BEX (B),26819908,20369515,15746570,62935993,570595961.685,843128514.25,428106451.036,1841830926.97,179888,95900,93415,369203
2009-04-08,NSX (C),34375990,13447961,15903030,63726981,604538269.496,272538411.673,238930640.035,1116007321.2,136256,21413,57426,215095
2009-04-08,NYSE (DN),11490739,851916,7398507,19741162,224495944.538,25234795.955,122773086.734,372503827.227,31375,1386,17724,50485
2009-04-08,NASDAQ (DQ),1666029912,577998853,650774238,2894803003,23963053133.2,15136451963.7,10330058776.2,49429563873.1,3911544,882276,1551439,6345259
2009-04-08,ADF (D),43878954,1544970,14788149,60212073,951743022.39,57235187.98,293075984.885,1302054195.26,174935,4658,57299,236892
2009-04-08,ISE (I),132589733,34819966,53466424,220876123,1827613843.55,763631267.93,664022279.185,3255267390.66,450468,70941,149897,671306
2009-04-08,CHX (M),20074859,9492121,7384205,36951185,446107382.512,602581051.92,168801809.81,1217490244.24,11440,6707,5685,23832
2009-04-08,NYSE (N),1315610222,100,10700,1315621022,23575077038.2,418.0,125727.0,23575203183.2,3831814,1,30,3831845
2009-04-08,NYSE Arca (P),825664092,415533587,280690105,1521887784,16000245887.0,14926727816.5,5895960525.66,36822934229.2,4441763,1318237,1490371,7250371
2009-04-08,NASDAQ (Q),760423368,387908284,623584008,1771915660,14405558024.6,14738666903.8,12145941002.5,41290165930.9,4226632,1259778,2807447,8293857
2009-04-08,CBOE (W),5218300,6164400,1413700,12796400,53950283.9,261272459.0,36513465.0,351736207.9,3133,4746,5473,13352
2009-04-08,BATS (Z),430533055,243000833,190597999,864131887,8886169707.05,8654872139.44,3657095284.88,21198137131.4,2884250,1085681,1217684,5187615
2009-04-09,AMEX (A),0,14401562,0,14401562,0.0,64578509.76,0.0,64578509.76,0,24766,0,24766
2009-04-09,BEX (B),39479807,26296854,16349470,82126131,754483568.533,913549417.11,443720286.346,2111753271.99,236558,96250,101112,433920
2009-04-09,NSX (C),40563776,15690010,16225677,72479463,755051438.22,291580795.328,248042945.624,1294675179.17,154850,22833,58238,235921
2009-04-09,NYSE (DN),11530295,1187389,9321104,22038788,249574964.584,33413288.1049,156840015.277,439828267.965,33858,1761,22069,57688
2009-04-09,NASDAQ (DQ),2506398439,805774661,772189589,4084362689,35842211793.8,17736261632.8,12171612314.3,65750085740.9,5489336,1168536,1866258,8524130
2009-04-09,ADF (D),42711210,3418684,12493315,58623209,797571682.872,113559553.89,213722730.245,1124853967.01,130036,9143,44313,183492
2009-04-09,ISE (I),184319864,43757313,58568048,286645225,2616090815.09,888307449.625,704606907.423,4209005172.13,549915,80860,172835,803610
2009-04-09,CHX (M),25390487,10921195,8364547,44676229,538681681.03,659323943.01,199598592.165,1397604216.2,22950,6340,5134,34424
2009-04-09,NYSE (N),1836343038,0,12500,1836355538,34492048625.4,0.0,256404.5,34492305029.9,4747919,0,30,4747949
2009-04-09,NYSE Arca (P),1181231958,604439057,312367695,2098038710,22137565889.5,19215623303.5,6552668628.84,47905857821.9,5675460,1612231,1730365,9018056
2009-04-09,NASDAQ (Q),1146132682,581098370,750606541,2477837593,21170864390.7,19690595410.9,14432902427.2,55294362228.8,5540129,1572130,3210302,10322561
2009-04-09,CBOE (W),10311600,9471000,2395600,22178200,87186741.63,439569130.0,76527101.56,603282973.19,3457,5599,6416,15472
2009-04-09,BATS (Z),581052632,336453295,232990848,1150496775,12079897948.9,10984712314.1,4619390351.88,27684000614.8,3751984,1330215,1515997,6598196
2009-04-13,AMEX (A),0,12486228,0,12486228,0.0,52265579.83,0.0,52265579.83,0,23536,0,23536
2009-04-13,BEX (B),37650183,28251419,15000909,80902511,707892438.2,868037784.681,434215806.372,2010146029.25,222898,86409,92929,402236
2009-04-13,NSX (C),51347661,21260506,17969360,90577527,715228449.421,403934227.36,274695106.795,1393857783.58,147348,30160,53208,230716
2009-04-13,NYSE (DN),10632524,1349005,8703436,20684965,216923711.155,34785372.709,141946933.734,393656017.598,31438,1997,19486,52921
2009-04-13,NASDAQ (DQ),2190947375,735690838,661423365,3588061578,29571084107.6,15094646008.8,9669058496.46,54334788612.9,4915718,1153206,1577380,7646304
2009-04-13,ADF (D),22833906,2290377,7166316,32290599,467844259.4,75565813.15,135280274.81,678690347.36,75681,5541,26001,107223
2009-04-13,ISE (I),163728135,46746072,49454214,259928421,2154669514.21,801728073.414,576158346.523,3532555934.15,486785,84658,149110,720553
2009-04-13,CHX (M),21849355,6624742,4758400,33232497,428345081.243,386257353.366,99811829.6333,914414264.243,16093,5843,4254,26190
2009-04-13,NYSE (N),1483144147,0,10600,1483154747,26670007996.5,0.0,251140.5,26670259137.0,4238045,0,27,4238072
2009-04-13,NYSE Arca (P),936034007,524397661,257026213,1717457881,17984463789.4,16693653751.2,5241378938.08,39919496478.7,4844968,1498181,1437181,7780330
2009-04-13,NASDAQ (Q),997702420,515949024,631170244,2144821688,18564981327.7,17163562668.1,12069951793.3,47798495789.2,5107840,1593608,2845212,9546660
2009-04-13,CBOE (W),10693100,7356900,3159400,21209400,75123328.28,376951556.0,106886318.0,558961202.28,3355,5548,5793,14696
2009-04-13,BATS (Z),521316007,295372757,194396447,1011085211,10505768614.3,8818700410.29,3699277792.55,23023746817.2,3394846,1245455,1296920,5937221
2009-04-14,AMEX (A),0,14525350,0,14525350,0.0,50108951.4,0.0,50108951.4,0,23701,0,23701
2009-04-14,BEX (B),50258372,28442982,18953640,97654994,893015823.17,920453689.56,518475312.87,2331944825.6,278688,97729,111838,488255
2009-04-14,NSX (C),60327468,17424455,17519718,95271641,858547590.184,322449483.286,265000763.08,1445997836.55,176415,26072,62461,264948
2009-04-14,NYSE (DN),11585014,1209226,9725152,22519392,240449293.698,28436667.73,165216421.497,434102382.926,32005,1779,21016,54800
2009-04-14,NASDAQ (DQ),2606773374,864352348,833860620,4304986342,33652428684.9,19072077434.8,12080595982.5,64805102102.1,5191794,1196953,1904420,8293167
2009-04-14,ADF (D),32838251,2674878,12317643,47830772,627574004.144,87415454.51,201053661.648,916043120.302,109403,6747,42221,158371
2009-04-14,ISE (I),200534330,62680981,66342896,329558207,2518188569.6,1005901183.11,798018968.225,4322108720.94,556011,101714,190003,847728
2009-04-14,CHX (M),24208808,8887103,5478903,38574814,408477898.703,465834103.0,114986978.567,989298980.27,26422,6561,5819,38802
2009-04-14,NYSE (N),1749394654,0,9200,1749403854,32107206154.2,0.0,191902.5,32107398056.7,4689256,0,40,4689296
2009-04-14,NYSE Arca (P),1073581477,562108811,312714816,1948405104,20685294884.3,17569987414.9,6075678217.91,44330960517.1,5245250,1585717,1643832,8474799
2009-04-14,NASDAQ (Q),1142187744,617695846,777084650,2536968240,21431022632.6,21064786337.0,14699767723.5,57195576693.1,5720021,1806287,3408278,10934586
2009-04-14,CBOE (W),13339000,8219300,4058300,25616600,107036293.22,379152487.5,118275532.4,604464313.12,4194,7004,7086,18284
2009-04-14,BATS (Z),610045494,349256912,238393072,1197695478,11606388794.4,10065752166.3,4373152449.97,26045293410.7,3800944,1358400,1530234,6689578
2009-04-15,AMEX (A),0,12376760,0,12376760,0.0,44985753.95,0.0,44985753.95,0,21162,0,21162
2009-04-15,BEX (B),40580425,25124857,19285169,84990451,743265244.987,842981304.42,559192289.866,2145438839.27,232435,90683,114040,437158
2009-04-15,NSX (C),36469740,13822473,13917749,64209962,640058789.368,386394546.17,243447878.608,1269901214.15,135667,22193,54655,212515
2009-04-15,NYSE (DN),12084183,1330086,9579894,22994163,259877975.919,42729210.92,166160350.978,468767537.817,31952,1531,20103,53586
2009-04-15,NASDAQ (DQ),2069678164,692320099,746487839,3508486102,29530763359.3,15645415377.1,11775917110.2,56952095846.6,4442256,1046982,1661400,7150638
2009-04-15,ADF (D),25131343,2376975,9313137,36821455,505882885.015,75352146.92,175246442.03,756481473.965,87713,5238,35983,128934
2009-04-15,ISE (I),155634841,44296574,51976229,251907644,2109169371.08,864308512.48,705600842.16,3679078725.72,464733,86047,155603,706383
2009-04-15,CHX (M),20414512,9675527,6879395,36969434,341498926.024,538784326.98,140380842.638,1020664095.64,15323,5889,4385,25597
2009-04-15,NYSE (N),1480129019,100,6900,1480136019,28123894266.8,525.5,125187.5,28124019979.8,4453865,1,25,4453891
2009-04-15,NYSE Arca (P),903937845,499704283,295202103,1698844231,17510611966.0,16594270404.5,5939749076.67,40044631447.1,4814809,1528153,1614544,7957506
2009-04-15,NASDAQ (Q),959367734,509186106,698777738,2167331578,18789669023.6,18080301211.7,13670827712.2,50540797947.6,5164704,1605122,3085588,9855414
2009-04-15,CBOE (W),11382500,12830300,2929400,27142200,89518501.89,598279608.04,93204761.25,781002871.18,3763,7810,6455,18028
2009-04-15,BATS (Z),532680044,304006121,230125986,1066812151,10427432988.9,9390388254.95,4297862616.96,24115683860.8,3471223,1275969,1500074,6247266
2009-04-16,AMEX (A),0,12371753,0,12371753,0.0,47554208.73,0.0,47554208.73,0,24271,0,24271
2009-04-16,BEX (B),44708764,27828175,20911616,93448555,854857188.546,888655167.81,636796675.026,2380309031.38,252608,95401,120890,468899
2009-04-16,NSX (C),40386303,13733337,16553072,70672712,704342926.994,283631141.588,261402603.964,1249376672.55,153209,22827,55829,231865
2009-04-16,NYSE (DN),14123592,1247006,11097829,26468427,307850396.447,36857911.6193,207634704.514,552343012.58,35189,1691,22350,59230
2009-04-16,NASDAQ (DQ),2080085337,815657032,869157670,3764900039,30557396054.9,20684839079.3,13568230174.2,64810465308.5,4768706,1147963,1957236,7873905
2009-04-16,ADF (D),39716875,3167333,15449930,58334138,799948807.481,93611487.46,274843150.312,1168403445.25,152375,8309,55882,216566
2009-04-16,ISE (I),156683362,55327638,68718562,280729562,2353606764.02,930777829.24,856579466.602,4140964059.86,527527,90167,188192,805886
2009-04-16,CHX (M),22460402,12471075,8006390,42937867,391269868.445,696895935.81,205641959.673,1293807763.93,15660,6743,5366,27769
2009-04-16,NYSE (N),1604594300,0,5600,1604599900,30938028107.7,0.0,165644.5,30938193752.2,4815002,0,19,4815021
2009-04-16,NYSE Arca (P),984556990,605831265,324074377,1914462632,19143928201.8,21333843848.3,7358548167.78,47836320217.9,5106191,1680350,1689244,8475785
2009-04-16,NASDAQ (Q),1032319785,551527156,795240469,2379087410,20191581782.1,20611724354.0,16531001334.5,57334307470.6,5462315,1681223,3401194,10544732
2009-04-16,CBOE (W),12911700,8921400,2230500,24063600,118518568.9,387411512.0,55862890.6,561792971.5,4502,8770,6991,20263
2009-04-16,BATS (Z),572692104,346301173,246369538,1165362815,11525227788.6,10986507203.7,4752097216.05,27263832208.4,3700887,1398769,1572208,6671864
2009-04-17,AMEX (A),0,14334455,0,14334455,0.0,50482580.85,0.0,50482580.85,0,24905,0,24905
2009-04-17,BEX (B),48713741,26993281,16399115,92106137,814257898.778,830356035.735,572648931.22,2217262865.73,246780,84635,107855,439270
2009-04-17,NSX (C),40273649,15952055,17280494,73506198,661243216.22,312246804.546,265402493.374,1238892514.14,142697,26911,60989,230597
2009-04-17,NYSE (DN),16097006,1442102,12357340,29896448,352027832.726,46080975.2305,218398449.898,616507257.855,37160,2009,23209,62378
2009-04-17,NASDAQ (DQ),2385760113,809941886,902294820,4097996819,32547298806.8,18986919554.6,13533762620.9,65067980982.3,5008995,1166193,1947409,8122597
2009-04-17,ADF (D),36709285,3356172,15102042,55167499,723426865.323,103739287.824,208844884.02,1036011037.17,129073,7875,41621,178569
2009-04-17,ISE (I),190844265,51294350,77279017,319417632,2635691796.37,978358277.9,869585851.074,4483635925.34,589487,98235,189864,877586
2009-04-17,CHX (M),21284587,11624946,8407947,41317480,334297436.98,354446369.456,202257438.988,891001245.424,14823,3565,5885,24273
2009-04-17,NYSE (N),1953608854,100,13500,1953622454,39677823120.5,1443.5,167002.0,39677991566.0,4642881,1,44,4642926
2009-04-17,NYSE Arca (P),1007025484,546406671,304341050,1857773205,18505511447.7,19049877093.8,6409242217.08,43964630758.6,4905827,1589949,1528084,8023860
2009-04-17,NASDAQ (Q),1071203825,522362540,846838585,2440404950,20176590468.5,18686283182.0,16962045526.1,55824919176.5,5434950,1539713,3088215,10062878
2009-04-17,CBOE (W),10816400,5173400,1406000,17395800,109154970.45,282022910.75,43199717.0,434377598.2,4080,9221,7314,20615
2009-04-17,BATS (Z),573824078,350129259,225819998,1149773335,10700056592.9,10573942660.4,4096693689.73,25370692943.0,3520780,1326732,1427278,6274790
2009-04-20,AMEX (A),0,14594448,0,14594448,0.0,64503608.65,0.0,64503608.65,0,26949,0,26949
2009-04-20,BEX (B),42518622,26549955,17979286,87047863,716980657.462,743209505.01,504282277.727,1964472440.2,235326,80157,107347,422830
2009-04-20,NSX (C),34687309,12742244,17587049,65016602,498437580.791,253895470.421,249530207.923,1001863259.13,100836,23327,56811,180974
2009-04-20,NYSE (DN),13337897,1148754,11618717,26105368,270907054.304,34035703.7067,170921364.925,475864122.935,32035,1817,21581,55433
2009-04-20,NASDAQ (DQ),2339576329,926806459,1204322703,4470705491,31309043672.6,21020482149.4,14671963720.5,67001489542.6,5237739,1266480,1976036,8480255
2009-04-20,ADF (D),40303266,3111594,16072899,59487759,741929927.111,94902948.2376,226277849.484,1063110724.83,126797,8039,42565,177401
2009-04-20,ISE (I),195426660,52929167,96345330,344701157,2555921560.68,929515396.03,921372237.872,4406809194.58,589307,97978,192829,880114
2009-04-20,CHX (M),19354233,9078081,11433981,39866295,379315094.262,412548566.622,129983444.235,921847105.119,17979,6088,6653,30720
2009-04-20,NYSE (N),1761311648,0,13700,1761325348,32704574081.5,0.0,301823.0,32704875904.5,4743293,0,34,4743327
2009-04-20,NYSE Arca (P),946854456,628708923,478162966,2053726345,17339918485.6,20219992587.1,7356615651.09,44916526723.8,4698234,1618810,1554745,7871789
2009-04-20,NASDAQ (Q),1041599032,547683671,960225464,2549508167,19256832551.1,18794135546.3,15970858015.4,54021826112.8,5206984,1557056,3163263,9927303
2009-04-20,CBOE (W),13590100,7656400,3444200,24690700,105417086.68,263662068.64,89607157.9,458686313.22,4737,8796,6765,20298
2009-04-20,BATS (Z),533511979,333761710,268975011,1136248700,9784908483.25,9930023029.84,4406408998.66,24121340511.8,3342576,1275780,1423069,6041425
2009-04-21,AMEX (A),0,12388476,0,12388476,0.0,58509167.3,0.0,58509167.3,0,24193,0,24193
2009-04-21,BEX (B),50074112,40902370,21145757,112122239,881856022.188,1106100828.41,568644735.733,2556601586.33,300548,120509,129157,550214
2009-04-21,NSX (C),42625205,18090484,17782444,78498133,735582157.435,334688121.72,285035746.265,1355306025.42,162887,28512,65421,256820
2009-04-21,NYSE (DN),15852716,1385520,10723896,27962132,316631237.798,45633970.8743,182910426.3,545175634.973,42203,2219,24798,69220
2009-04-21,NASDAQ (DQ),2390700060,1049254502,891240070,4331194632,33609889655.4,21931617939.6,13261104214.8,68802611809.8,5621226,1460014,1991303,9072543
2009-04-21,ADF (D),40541664,3940432,12079728,56561824,748989532.48,115247226.15,214259073.2,1078495831.83,132077,8953,40736,181766
2009-04-21,ISE (I),176135391,64884740,71448054,312468185,2411730716.08,1107024887.32,799752043.963,4318507647.36,576169,116447,199935,892551
2009-04-21,CHX (M),16459452,6460902,5856445,28776799,365013663.435,368512975.68,152819798.023,886346437.138,12675,2933,2547,18155
2009-04-21,NYSE (N),1672084843,0,10700,1672095543,31805378136.9,0.0,201801.0,31805579937.9,4833567,0,25,4833592
2009-04-21,NYSE Arca (P),1123869898,695429010,347194155,2166493063,20525631287.1,21283534796.7,6554325864.17,48363491948.0,5772134,2004829,1758698,9535661
2009-04-21,NASDAQ (Q),1234308864,641016963,825664085,2700989912,22753519507.5,21466959568.9,15200878424.9,59421357501.3,6420221,1969277,3563005,11952503
2009-04-21,CBOE (W),8934300,13162500,2159300,24256100,97246432.3,534577257.3,62122774.0,693946463.6,5261,12274,7952,25487
2009-04-21,BATS (Z),670177933,422176617,251806493,1344161043,12084336719.9,11743823344.9,4589450531.17,28417610596.0,4191240,1645715,1608971,7445926
2009-04-22,AMEX (A),0,11221210,0,11221210,0.0,49718043.6,0.0,49718043.6,0,22463,0,22463
2009-04-22,BEX (B),56458740,38920558,23109839,118489137,1018372039.71,1235853706.85,661633742.795,2915859489.36,332949,131216,146538,610703
2009-04-22,NSX (C),43755294,12146969,24044244,79946507,862770989.37,318696098.321,348015156.752,1529482244.44,183428,25914,79556,288898
2009-04-22,NYSE (DN),16300910,1482088,12541666,30324664,345694276.83,56082083.7425,221940671.391,623717031.963,39519,2161,26175,67855
2009-04-22,NASDAQ (DQ),2276845927,964588124,941687975,4183122026,36195779406.4,21370731596.3,14671755836.5,72238266839.2,5327046,1443302,2129210,8899558
2009-04-22,ADF (D),45700534,2539330,15955229,64195093,878046574.135,86306269.615,295949822.139,1260302665.89,156030,6888,53530,216448
2009-04-22,ISE (I),194899771,67348208,77000974,339248953,2904926830.19,1112017888.36,939300327.842,4956245046.39,642535,115258,214337,972130
2009-04-22,CHX (M),20412539,12116411,8023151,40552101,487779130.289,642776470.24,179695848.327,1310251448.86,15377,6910,5535,27822
2009-04-22,NYSE (N),1770668683,0,4400,1770673083,35594464216.8,0.0,116705.0,35594580921.8,5692966,0,15,5692981
2009-04-22,NYSE Arca (P),1081925880,663775664,405676486,2151378030,21945578995.1,22010602464.2,8411663551.33,52367845010.7,5901771,2064790,2030015,9996576
2009-04-22,NASDAQ (Q),1217268463,662789903,892933833,2772992199,24810827369.7,24236802280.8,18180648435.4,67228278085.9,6696378,2085044,3923399,12704821
2009-04-22,CBOE (W),7217100,17719200,6870100,31806400,132625656.1,1106114854.8,213424152.96,1452164663.86,5237,13056,8784,27077
2009-04-22,BATS (Z),634570131,431935996,292657543,1359163670,12557295968.8,12954958520.5,5513598492.65,31025852981.9,4242144,1767723,1823347,7833214
2009-04-23,AMEX (A),0,11226721,0,11226721,0.0,45441066.82,0.0,45441066.82,0,25139,0,25139
2009-04-23,BEX (B),43589399,30558695,22310559,96458653,869548395.881,1032577390.72,605023690.122,2507149476.72,272754,108370,142601,523725
2009-04-23,NSX (C),32009632,7684173,14808076,54501881,702380232.679,275537267.524,275847072.439,1253764572.64,160536,21039,68863,250438
2009-04-23,NYSE (DN),16313196,1793023,11867147,29973366,368217585.386,58730690.4483,210009500.688,636957776.522,44564,2469,27467,74500
2009-04-23,NASDAQ (DQ),2040660305,827511087,846872880,3715044272,32848221218.1,20272196202.2,13990059770.8,67110477191.0,5152887,1198679,2064824,8416390
2009-04-23,ADF (D),39539060,2923865,13876641,56339566,788251452.461,95046946.56,253628801.765,1136927200.79,143489,5958,49066,198513
2009-04-23,ISE (I),161860378,49012971,67902334,278775683,2604023813.27,1018174184.97,902863462.691,4525061460.93,581650,98156,204834,884640
2009-04-23,CHX (M),19597475,11243457,6261678,37102610,322021664.06,631953472.228,121777911.494,1075753047.78,12799,5640,5588,24027
2009-04-23,NYSE (N),1566824109,0,11600,1566835709,32100396087.8,0.0,228617.5,32100624705.3,5247965,0,35,5248000
2009-04-23,NYSE Arca (P),968832497,541524322,372206489,1882563308,19951220073.8,19259773993.0,7756835906.23,46967829973.0,5377994,1651177,1892625,8921796
2009-04-23,NASDAQ (Q),1093165360,557221659,869341302,2519728321,22721921597.0,21683782135.8,18056407006.9,62462110739.7,6112542,1779644,3826390,11718576
2009-04-23,CBOE (W),5052500,11458200,1784100,18294800,78656925.36,497934302.1,62666542.55,639257770.01,2260,13835,2280,18375
2009-04-23,BATS (Z),583361043,337831479,271073707,1192266229,11597948210.4,10473218525.3,5123783821.64,27194950557.4,3880240,1391150,1708355,6979745
2009-04-24,AMEX (A),0,16142994,0,16142994,0.0,80818206.44,0.0,80818206.44,0,25125,0,25125
2009-04-24,BEX (B),50153258,36154671,21514874,107822803,933996407.53,1133820141.37,597941490.669,2665758039.57,315265,120181,137529,572975
2009-04-24,NSX (C),46992870,10219543,18549713,75762126,965134372.423,332449737.374,387295434.699,1684879544.5,199647,28777,84485,312909
2009-04-24,NYSE (DN),16296072,1631427,11191665,29119164,346097940.524,47053822.3313,205269031.224,598420794.079,40952,2453,23982,67387
2009-04-24,NASDAQ (DQ),2283131092,1005666623,891584748,4180382463,36101105553.0,20432257570.3,14589645257.0,71123008380.4,5562306,1529249,2121511,9213066
2009-04-24,ADF (D),42984181,3173847,15361875,61519903,849825712.923,85069653.72,312637795.279,1247533161.92,146125,6708,52240,205073
2009-04-24,ISE (I),173790899,61019861,63849155,298659915,2661905282.0,1110148949.36,936384490.644,4708438722.0,582698,117970,199683,900351
2009-04-24,CHX (M),18698125,10591725,7855587,37145437,409436789.632,626456784.656,172185912.325,1208079486.61,18287,6562,6519,31368
2009-04-24,NYSE (N),1733991330,0,10600,1734001930,35610975386.6,0.0,153126.0,35611128512.6,5401838,0,21,5401859
2009-04-24,NYSE Arca (P),1018195748,591773151,359316634,1969285533,20967775278.9,18492658672.1,7607728512.97,47068162464.0,5676948,1892017,1912747,9481712
2009-04-24,NASDAQ (Q),1118738381,615763017,878347862,2612849260,22684713967.2,22159401946.1,18172987158.0,63017103071.3,6258006,1943640,3829796,12031442
2009-04-24,CBOE (W),5821900,12963900,4042900,22828700,105832652.55,782386835.9,115132475.32,1003351963.77,3554,15379,8662,27595
2009-04-24,BATS (Z),612049452,419842936,276600065,1308492453,12293060450.4,11760385448.3,5349552659.52,29402998558.3,4123395,1737884,1762481,7623760
2009-04-27,AMEX (A),0,16813561,0,16813561,0.0,70274745.41,0.0,70274745.41,0,23633,0,23633
2009-04-27,BEX (B),38170759,26609309,19426343,84206411,722801293.595,897690524.566,525921622.663,2146413440.82,236828,92171,124342,453341
2009-04-27,NSX (C),32201656,8638742,21187568,62027966,675317586.954,225701344.203,321356776.746,1222375707.9,153960,18595,75621,248176
2009-04-27,NYSE (DN),12591320,1457386,9503104,23551810,278235109.198,43942139.4425,162744469.567,484921718.207,36696,2236,22632,61564
2009-04-27,NASDAQ (DQ),1800003825,808566798,807448405,3416019028,28650761813.2,18256851214.0,12237408329.0,59145021356.3,4810034,1302952,1910848,8023834
2009-04-27,ADF (D),41243554,2644769,15615802,59504125,802793255.331,93463293.76,269472610.147,1165729159.24,161054,5577,57686,224317
2009-04-27,ISE (I),121274848,40947172,63845650,226067670,1958284359.19,824446123.44,679223414.275,3461953896.91,470307,83924,173408,727639
2009-04-27,CHX (M),12634924,12062967,7572131,32270022,239590700.315,747714105.075,116237072.45,1103541877.84,13174,6517,6150,25841
2009-04-27,NYSE (N),1402328666,100,28900,1402357666,28846182434.6,310.0,465383.0,28846648127.6,4596429,1,48,4596478
2009-04-27,NYSE Arca (P),779695798,489270226,315194877,1584160901,16399022747.3,17490254764.8,6188924449.27,40078201961.3,4663259,1594802,1705130,7963191
2009-04-27,NASDAQ (Q),885964968,488727727,739824596,2114517291,18543167239.5,19890903439.0,14626790973.9,53060861652.4,5210951,1592505,3323367,10126823
2009-04-27,CBOE (W),5544700,5821300,2835100,14201100,55798886.81,266113601.0,85585193.99,407497681.8,3817,6518,8091,18426
2009-04-27,BATS (Z),483582401,333284632,235913146,1052780179,10012962504.5,10178573566.3,4452655068.66,24644191139.5,3401052,1427794,1529986,6358832
2009-04-28,AMEX (A),0,16030241,0,16030241,0.0,55091176.53,0.0,55091176.53,0,23368,0,23368
2009-04-28,BEX (B),33936940,23517709,17546697,75001346,631789163.65,790989717.515,528839087.991,1951617969.16,216373,85714,114410,416497
2009-04-28,NSX (C),31377938,15243818,18239314,64861070,642248685.022,365886717.597,311042484.401,1319177887.02,148552,26597,69595,244744
2009-04-28,NYSE (DN),12420305,1632639,10520264,24573208,262707946.753,51803607.3928,168620583.47,483132137.616,29471,2326,23287,55084
2009-04-28,NASDAQ (DQ),1732071635,701613934,784239067,3217924636,27185580240.6,16352815545.6,11637504711.6,55175900497.8,4339348,1120978,1727870,7188196
2009-04-28,ADF (D),27512803,2255347,10376640,40144790,528507068.907,72471092.51,212656435.231,813634596.649,95505,5106,34169,134780
2009-04-28,ISE (I),121487249,32221643,58645072,212353964,1932386964.03,794804153.797,679029494.854,3406220612.68,461629,75177,162043,698849
2009-04-28,CHX (M),23045814,10370058,6012823,39428695,380633247.108,574083936.076,108116855.37,1062834038.55,15365,5580,5741,26686
2009-04-28,NYSE (N),1251073780,0,4200,1251077980,25396039544.7,0.0,56306.5,25396095851.2,4217914,0,17,4217931
2009-04-28,NYSE Arca (P),775489607,421930316,305366622,1502786545,15675359860.1,15242646917.2,6161900067.13,37079906844.5,4425123,1325738,1596344,7347205
2009-04-28,NASDAQ (Q),888116420,428129366,693957093,2010202879,17655386982.8,17312593910.5,13793241127.2,48761222020.5,4940813,1391026,3094570,9426409
2009-04-28,CBOE (W),23038100,7516000,4827000,35381100,149310628.54,419576719.6,114581602.0,683468950.14,3559,10966,6907,21432
2009-04-28,BATS (Z),495087772,295065408,218979309,1009132489,9902285050.62,8940328384.18,4083303618.58,22925917053.4,3361466,1247552,1401572,6010590
2009-04-29,AMEX (A),0,16091894,0,16091894,0.0,69304827.89,0.0,69304827.89,0,24083,0,24083
2009-04-29,BEX (B),39809106,25822738,19632585,85264429,788213556.51,897684344.84,554604919.79,2240502821.14,254036,92588,119273,465897
2009-04-29,NSX (C),39567469,18394159,18873302,76834930,845543424.374,391455539.731,389468444.895,1626467409.0,174911,30132,79419,284462
2009-04-29,NYSE (DN),10589335,2041348,10858465,23489148,210652700.563,62961687.6823,187149401.44,460763789.685,20889,2789,23360,47038
2009-04-29,NASDAQ (DQ),1978196916,850229735,877528833,3705955484,33868886616.6,21392172726.0,13379439352.3,68640498695.0,4948949,1262913,2008363,8220225
2009-04-29,ADF (D),41547644,2851258,14836900,59235802,850402990.732,100745369.591,298066895.82,1249215256.14,141501,5733,51675,198909
2009-04-29,ISE (I),139384732,37697947,68347835,245430514,2382808096.31,894052140.316,883719514.487,4160579751.11,528939,79941,200990,809870
2009-04-29,CHX (M),17805346,13075494,9741887,40622727,326738129.601,847414241.604,233656612.2,1407808983.4,20935,7017,6464,34416
2009-04-29,NYSE (N),1476153529,0,4900,1476158429,31576470039.6,0.0,53136.0,31576523175.6,4829400,0,17,4829417
2009-04-29,NYSE Arca (P),850790528,524524607,356489368,1731804503,18279849488.7,18383866609.5,7423081657.13,44086797755.3,4835548,1542708,1818608,8196864
2009-04-29,NASDAQ (Q),968950460,514820128,795387724,2279158312,21119060300.8,20751950487.1,16187391258.0,58058402045.9,5539607,1626895,3526142,10692644
2009-04-29,CBOE (W),6421000,10999000,3915200,21335200,90409249.93,562250726.86,114674397.15,767334373.94,4726,9351,8651,22728
2009-04-29,BATS (Z),541715177,340177441,252571478,1134464096,11261287449.4,10534370278.0,4859109826.6,26654767554.0,3670213,1386111,1592568,6648892
2009-04-30,AMEX (A),0,14982493,0,14982493,0.0,56191399.25,0.0,56191399.25,0,25403,0,25403
2009-04-30,BEX (B),38298877,25723502,20127951,84150330,797760281.67,955032223.97,666094893.358,2418887399.0,252276,93699,127662,473637
2009-04-30,NSX (C),47342031,23592583,22558297,93492911,949920401.96,459639385.652,400850766.079,1810410553.69,197422,31693,92462,321577
2009-04-30,NYSE (DN),17090557,2364900,14994808,34450265,384351356.946,66635345.0468,289068081.123,740054783.116,44996,2909,35455,83360
2009-04-30,NASDAQ (DQ),2213999729,852379947,1043390734,4109770410,38126465119.6,21009974589.1,16330291662.4,75466731371.1,5397257,1309710,2302478,9009445
2009-04-30,ADF (D),51744243,2710125,21743825,76198193,1013930650.39,88176963.998,377662668.168,1479770282.56,190740,6671,75977,273388
2009-04-30,ISE (I),151788700,38630961,73836773,264256434,2619946430.85,918578049.098,1013940098.63,4552464578.58,578069,80589,226834,885492
2009-04-30,CHX (M),16646990,15542350,11430002,43619342,406302910.125,887808187.675,295269268.02,1589380365.82,15086,6570,6793,28449
2009-04-30,NYSE (N),1740618405,0,13800,1740632205,37708152764.4,0.0,221728.0,37708374492.4,5076219,0,34,5076253
2009-04-30,NYSE Arca (P),932162296,545512513,401802010,1879476819,20190553618.5,18708041151.6,8407193266.09,47305788036.2,5284417,1621571,2055767,8961755
2009-04-30,NASDAQ (Q),1054523118,551692644,968006833,2574222595,22898635111.0,22670002657.2,19739892804.4,65308530572.6,5928198,1757583,4026269,11712050
2009-04-30,CBOE (W),11358300,9601000,3495000,24454300,138815464.44,471894869.0,82894381.49,693604714.93,4088,10278,3146,17512
2009-04-30,BATS (Z),592452456,351720214,290440590,1234613260,12787134301.2,11256530294.7,5552502243.26,29596166839.1,4135526,1475553,1832681,7443760
2009-05-01,AMEX (A),0,12242754,0,12242754,0.0,47375377.18,0.0,47375377.18,0,23455,0,23455
2009-05-01,BEX (B),32373236,22318968,15413704,70105908,663057865.74,719894333.84,442087206.741,1825039406.32,207676,74459,103481,385616
2009-05-01,NSX (C),39062103,14919684,20806267,74788054,820631738.971,326029019.421,306981925.998,1453642684.39,179616,22276,74644,276536
2009-05-01,NYSE (DN),15484725,1500910,10335937,27321572,315119200.639,47791466.545,169805345.198,532716012.382,37070,2094,24795,63959
2009-05-01,NASDAQ (DQ),1733420366,647547263,807699068,3188666697,29261219288.4,16437837637.1,11615841784.2,57314898709.6,4364756,1010680,1814361,7189797
2009-05-01,ADF (D),32531243,1435366,15175702,49142311,680874723.015,49936508.6,261584647.906,992395879.521,121921,3565,49601,175087
2009-05-01,ISE (I),123955258,33750943,58076964,215783165,2043219724.28,757811541.94,656461857.027,3457493123.25,449314,65171,158834,673319
2009-05-01,CHX (M),14562007,9029600,7099836,30691443,371504025.634,630335954.71,152037028.353,1153877008.7,13131,4912,6394,24437
2009-05-01,NYSE (N),1289240037,0,15300,1289255337,27596500034.0,0.0,365705.0,27596865739.0,4312827,0,39,4312866
2009-05-01,NYSE Arca (P),726177037,424945592,295711332,1446833961,16263024499.5,15830281240.4,5693490348.42,37786796088.3,4324219,1269244,1569757,7163220
2009-05-01,NASDAQ (Q),830695066,396795328,696847855,1924338249,18521617123.5,16099337050.8,13638474538.0,48259428712.3,4829781,1283231,3100851,9213863
2009-05-01,CBOE (W),4843400,7505500,2690000,15038900,120407161.11,417635700.84,50393498.5,588436360.45,3444,7315,6914,17673
2009-05-01,BATS (Z),461232994,252472553,230827764,944533311,9867151047.02,8102183967.58,4239191220.67,22208526235.3,3241436,1048863,1479398,5769697
2009-05-04,AMEX (A),0,17016071,0,17016071,0.0,63207229.54,0.0,63207229.54,0,30195,0,30195
2009-05-04,BEX (B),45734867,23269777,16998929,86003573,842893200.51,756635233.033,524880221.565,2124408655.11,261386,76027,102917,440330
2009-05-04,NSX (C),45959314,23951596,18352744,88263654,938932587.974,396920751.539,339779209.228,1675632548.74,189816,30143,66707,286666
2009-05-04,NYSE (DN),17660701,2185092,11849023,31694816,400230309.384,66572558.6254,193628695.262,660431563.271,44613,3015,29855,77483
2009-05-04,NASDAQ (DQ),2323474417,940947056,1012466699,4276888172,39301546269.6,21833351488.2,16127801287.5,77262699045.4,5674218,1391205,2149970,9215393
2009-05-04,ADF (D),55793122,7401278,16823883,80018283,1139325471.31,174287461.005,361446301.816,1675059234.13,197915,12300,58575,268790
2009-05-04,ISE (I),174900156,47213830,67857080,289971066,2849445927.97,974655797.11,908315242.298,4732416967.38,602742,84664,199170,886576
2009-05-04,CHX (M),21536047,11735467,6999335,40270849,465526217.89,629661661.514,149110185.59,1244298064.99,19535,5861,6801,32197
2009-05-04,NYSE (N),1714302415,0,13900,1714316315,36500507202.1,0.0,281488.0,36500788690.1,5115243,0,20,5115263
2009-05-04,NYSE Arca (P),1007254876,610685285,337846513,1955786674,21802580257.8,20008725334.5,7131505546.5,48942811138.8,5383865,1621422,1761879,8767166
2009-05-04,NASDAQ (Q),1061621587,528505714,817126923,2407254224,23002506970.0,20352582277.2,16637246976.3,59992336223.5,5712254,1531061,3508141,10751456
2009-05-04,CBOE (W),4583300,8712900,1785700,15081900,82778280.38,441166363.28,50468029.0,574412672.66,3668,9607,6933,20208
2009-05-04,BATS (Z),572627089,370612821,266995170,1210235080,12472224134.8,10887878154.5,5303765602.32,28663867891.7,3819389,1336629,1665471,6821489
2009-05-05,AMEX (A),0,17685354,0,17685354,0.0,54581889.85,0.0,54581889.85,0,27098,0,27098
2009-05-05,BEX (B),45265877,23600568,16336228,85202673,783420179.677,716576224.78,485445813.21,1985442217.67,243011,69455,102385,414851
2009-05-05,NSX (C),49088393,18237392,20756714,88082499,854786875.55,317244152.063,280128214.826,1452159242.44,184664,25160,68193,278017
2009-05-05,NYSE (DN),17224083,2792646,11736965,31753694,365466721.244,102363086.175,212274589.778,680104397.196,46282,2707,29441,78430
2009-05-05,NASDAQ (DQ),2363848609,736973667,1003868354,4104690630,37183868727.3,18119910958.7,14430782529.3,69734562215.2,5428267,1168145,2142034,8738446
2009-05-05,ADF (D),49567613,5063379,18895296,73526288,930230920.72,132321102.035,342905268.901,1405457291.66,173186,11370,68762,253318
2009-05-05,ISE (I),164203217,38870120,77379874,280453211,2473660522.78,804791199.14,840859782.5,4119311504.42,536134,77169,210142,823445
2009-05-05,CHX (M),21305481,13685071,9343060,44333612,462499339.651,774189841.89,124286729.042,1360975910.58,16382,5115,7309,28806
2009-05-05,NYSE (N),1534299664,0,13600,1534313264,30865259682.3,0.0,307942.0,30865567624.3,4860238,0,43,4860281
2009-05-05,NYSE Arca (P),966902157,471532743,340511054,1778945954,19062621632.3,15667197441.8,6530365933.71,41260185007.9,4990741,1433807,1768502,8193050
2009-05-05,NASDAQ (Q),1068346286,477858042,813676316,2359880644,21448559312.5,18372833452.3,14946469821.9,54767862586.7,5509126,1441456,3478669,10429251
2009-05-05,CBOE (W),5298400,4602100,1860200,11760700,75902526.4,233982282.46,47733128.0,357617936.86,4133,6553,7870,18556
2009-05-05,BATS (Z),550840148,315086239,266989866,1132916253,11197203152.1,9656914106.6,4907024796.6,25761142055.3,3562391,1268955,1661216,6492562
2009-05-06,AMEX (A),0,17641795,0,17641795,0.0,67142821.85,0.0,67142821.85,0,30923,0,30923
2009-05-06,BEX (B),63725105,36811466,18729206,119265777,1090826460.63,1080501300.36,562302599.21,2733630360.2,351419,101083,113472,565974
2009-05-06,NSX (C),60976622,23810769,37992717,122780108,1108207874.71,446558387.966,351874154.824,1906640417.5,227901,33224,82538,343663
2009-05-06,NYSE (DN),19215237,2257753,14355053,35828043,443690142.581,76642035.9022,228647038.369,748979216.852,53693,3154,32792,89639
2009-05-06,NASDAQ (DQ),2928840205,1137587413,1190547740,5256975358,44478736862.3,23550317487.1,15518735609.8,83547789959.2,6212533,1528402,2241661,9982596
2009-05-06,ADF (D),65943938,8506694,25818434,100269066,1264335941.5,201570664.595,426259214.574,1892165820.67,213439,14791,77244,305474
2009-05-06,ISE (I),219130454,60364383,98452918,377947755,3204384186.48,1176277610.43,951290416.464,5331952213.37,618944,95691,219182,933817
2009-05-06,CHX (M),37593992,14333087,12109688,64036767,597324514.613,853089919.76,158298637.86,1608713072.23,19815,7229,8683,35727
2009-05-06,NYSE (N),1876348327,0,23500,1876371827,37891086156.1,0.0,325069.5,37891411225.6,5550647,0,44,5550691
2009-05-06,NYSE Arca (P),1262908279,683355265,421380253,2367643797,25129772369.3,21361108426.5,7959234072.42,54450114868.2,6261827,1809262,1994969,10066058
2009-05-06,NASDAQ (Q),1300798542,647476193,907674187,2855948922,26163807086.6,23913257855.6,16970941834.7,67048006776.9,6305918,1768508,3600157,11674583
2009-05-06,CBOE (W),8945100,11520100,3570100,24035300,181068869.96,447403407.25,97405169.93,725877447.14,4932,9205,8873,23010
2009-05-06,BATS (Z),724880312,428904820,300065747,1453850879,14789747409.3,12484156749.5,5647954382.07,32921858540.9,4523071,1566781,1836594,7926446
2009-05-07,AMEX (A),0,19101259,0,19101259,0.0,69380525.9,0.0,69380525.9,0,29516,0,29516
2009-05-07,BEX (B),62328812,43146388,19276424,124751624,1178604442.72,1212854718.6,596944191.6,2988403352.92,372985,116892,100462,590339
2009-05-07,NSX (C),57634587,24968525,30144315,112747427,1074738652.94,470356990.12,338052671.051,1883148314.11,220579,33463,75405,329447
2009-05-07,NYSE (DN),22104472,3548860,14621457,40274789,536013976.365,125417196.979,265701859.136,927133032.48,51813,4453,34400,90666
2009-05-07,NASDAQ (DQ),3120648303,1194297214,1294905379,5609850896,49660749471.2,25194363862.8,18279200660.3,93134313994.3,6706941,1671721,2509988,10888650
2009-05-07,ADF (D),63740691,8942760,24017798,96701249,1247672676.42,218666364.15,407892409.417,1874231449.99,209464,18238,79264,306966
2009-05-07,ISE (I),198270293,56612686,89940617,344823596,3271823963.92,1176213392.54,994220274.297,5442257630.76,696366,101771,236188,1034325
2009-05-07,CHX (M),34086760,13864892,14252400,62204052,601870357.722,934361659.592,260043512.993,1796275530.31,19908,6532,8068,34508
2009-05-07,NYSE (N),1972380095,0,6500,1972386595,40716115585.3,0.0,105517.0,40716221102.3,5932236,0,30,5932266
2009-05-07,NYSE Arca (P),1404089296,748360355,458294803,2610744454,27851792624.8,23255800217.5,8753599853.25,59861192695.5,6707052,1974029,2172882,10853963
2009-05-07,NASDAQ (Q),1440463647,713065368,1027074931,3180603946,28500709733.1,25233826438.2,19110204745.3,72844740916.6,6525962,2001669,3863190,12390821
2009-05-07,CBOE (W),7734900,9649000,4041300,21425200,112882665.7,446890551.14,130840954.71,690614171.55,4704,10132,9933,24769
2009-05-07,BATS (Z),771016074,472996419,323195221,1567207714,15294159433.9,13337645959.9,6056638349.14,34688443742.9,4713229,1726862,1902773,8342864
2009-05-08,AMEX (A),0,21441447,0,21441447,0.0,56390316.15,0.0,56390316.15,0,29301,0,29301
2009-05-08,BEX (B),57591919,31785108,17951884,107328911,1104044726.94,1016194849.64,511328737.48,2631568314.06,331787,97364,89997,519148
2009-05-08,NSX (C),55871611,26158700,26792732,108823043,1175469662.56,395463881.166,341179738.673,1912113282.4,220500,32144,74489,327133
2009-05-08,NYSE (DN),18757017,2836788,13795897,35389702,420733066.638,107230781.14,244994270.444,772958118.221,44073,3760,30922,78755
2009-05-08,NASDAQ (DQ),2701801243,1082707484,1221292289,5005801016,44441559230.5,23007800755.3,16575796137.0,84025156122.8,5948314,1460843,2373551,9782708
2009-05-08,ADF (D),59934929,9077483,24392420,93404832,1210820525.93,219848036.291,394011670.919,1824680233.14,209319,15317,78852,303488
2009-05-08,ISE (I),202128135,53836895,89680379,345645409,3467994187.16,1074326772.85,1022143194.0,5564464154.0,722494,94729,232732,1049955
2009-05-08,CHX (M),30959893,16992553,8922268,56874714,576496451.762,1006346520.46,150943945.345,1733786917.56,22570,6637,7764,36971
2009-05-08,NYSE (N),1897163970,0,43200,1897207170,41130068848.1,0.0,866419.0,41130935267.1,5596312,0,93,5596405
2009-05-08,NYSE Arca (P),1247900428,665951621,467113555,2380965604,26570796185.3,21201952339.5,8330449550.92,56103198075.7,6105502,1743345,2034894,9883741
2009-05-08,NASDAQ (Q),1171322122,603721705,976551064,2751594891,25711011334.0,22287877548.9,17759773580.5,65758662463.4,5864988,1698378,3578431,11141797
2009-05-08,CBOE (W),23078100,11991400,4398600,39468100,264276861.0,490920708.0,116889188.0,872086757.0,4755,11526,8127,24408
2009-05-08,BATS (Z),700962351,407118570,336045636,1444126557,14911146994.5,12418784699.5,5919345781.2,33249277475.2,4422582,1513429,1867637,7803648
2009-05-11,AMEX (A),0,22720384,0,22720384,0.0,57103857.07,0.0,57103857.07,0,28663,0,28663
2009-05-11,BEX (B),51819843,21234205,16148230,89202278,923721732.19,595998021.453,471609981.875,1991329735.52,278165,60555,83198,421918
2009-05-11,NSX (C),41006551,24866895,23143217,89016663,815408973.078,357156461.826,261557833.361,1434123268.26,170489,28654,64150,263293
2009-05-11,NYSE (DN),12341206,2250241,11066710,25658157,270361062.406,74177878.583,180425588.07,524964529.059,36487,2654,26742,65883
2009-05-11,NASDAQ (DQ),2021400589,829951310,971215031,3822566930,34135769168.0,18325870138.7,12429443193.3,64891082500.1,4854055,1164102,1987160,8005317
2009-05-11,ADF (D),42384568,5732243,18519224,66636035,876931592.55,133367717.185,288127581.507,1298426891.24,152331,10557,61146,224034
2009-05-11,ISE (I),144533245,42399286,80382234,267314765,2313691937.45,839073635.673,779351935.327,3932117508.45,488981,75748,185049,749778
2009-05-11,CHX (M),18167637,12441006,7917824,38526467,290737919.34,890115324.73,121364667.933,1302217912.0,12493,5122,6548,24163
2009-05-11,NYSE (N),1490441849,0,27000,1490468849,31910980910.1,0.0,571318.5,31911552228.6,4544370,0,60,4544430
2009-05-11,NYSE Arca (P),896296514,514661937,356337555,1767296006,19298819166.6,17081645595.9,6526755854.08,42907220616.6,4917249,1398619,1716831,8032699
2009-05-11,NASDAQ (Q),871739321,452635104,789932880,2114307305,19232994703.9,16709695622.6,14312048748.8,50254739075.4,4678144,1347651,3028086,9053881
2009-05-11,CBOE (W),9175000,14295500,1950400,25420900,123875292.0,520654521.0,50963410.57,695493223.57,3478,11229,6748,21455
2009-05-11,BATS (Z),557374118,316104906,266145033,1139624057,12241267240.7,9410611167.8,4608344429.9,26260222838.4,3811409,1251361,1608200,6670970
2009-05-12,AMEX (A),0,23212252,0,23212252,0.0,65752123.1,0.0,65752123.1,0,30781,0,30781
2009-05-12,BEX (B),58187218,31237683,14520277,103945178,1002656323.04,904709550.88,478210988.963,2385576862.88,297274,85060,80896,463230
2009-05-12,NSX (C),44767189,24372174,26847585,95986948,877806737.544,381746459.967,311567813.431,1571121010.94,183618,27753,70895,282266
2009-05-12,NYSE (DN),14795168,1648714,11222579,27666461,351062136.831,60878369.702,200085541.979,612026048.512,40708,2411,28169,71288
2009-05-12,NASDAQ (DQ),2246544113,1073548187,956930138,4277022438,37256577922.0,22194378921.2,13299142723.6,72750099566.9,5519011,1407505,2042151,8968667
2009-05-12,ADF (D),49355083,6710874,19329754,75395711,972725079.318,160331085.327,340471266.566,1473527431.21,174296,13050,70938,258284
2009-05-12,ISE (I),161265467,51888751,78982299,292136517,2631804124.85,1046156223.5,956244264.786,4634204613.13,563686,86887,208730,859303
2009-05-12,CHX (M),17149809,11344057,4076475,32570341,383792173.715,816645729.625,107095483.02,1307533386.36,12669,4875,4630,22174
2009-05-12,NYSE (N),1611200118,0,29100,1611229218,33688255578.3,0.0,657957.5,33688913535.8,4892584,0,61,4892645
2009-05-12,NYSE Arca (P),1045165895,584927270,360285127,1990378292,22373114847.9,18958296706.1,7026721136.55,48358132690.6,5576056,1620976,1774686,8971718
2009-05-12,NASDAQ (Q),1029619122,533027583,799743852,2362390557,22356195831.7,19147506897.7,15136859405.9,56640562135.3,5265858,1515182,3153178,9934218
2009-05-12,CBOE (W),6383900,11427500,2247000,20058400,94174719.2,490695073.9,59312735.75,644182528.85,4417,10847,8053,23317
2009-05-12,BATS (Z),593806830,381633078,266899617,1242339525,12869818783.5,10724387574.7,4777200742.75,28371407100.9,3915095,1358005,1597791,6870891
2009-05-13,AMEX (A),0,22423196,0,22423196,0.0,74987029.47,0.0,74987029.47,0,36050,0,36050
2009-05-13,BEX (B),46259680,25982811,13339964,85582455,794180992.12,869012403.07,467964530.04,2131157925.23,253414,80142,73689,407245
2009-05-13,NSX (C),37532776,26718850,18219922,82471548,644230938.901,381691064.848,244833864.94,1270755868.69,121974,30159,52430,204563
2009-05-13,NYSE (DN),17016661,1599940,11331572,29948173,392515130.526,51009796.9859,213284248.109,656809175.621,45885,2344,30932,79161
2009-05-13,NASDAQ (DQ),2288326658,985765170,901906420,4175998248,35493035960.4,21330719157.0,12998282393.7,69822037511.1,5499833,1437276,1995957,8933066
2009-05-13,ADF (D),46000818,7198556,17182477,70381851,897159228.215,165023427.315,290965197.762,1353147853.29,163274,13360,65300,241934
2009-05-13,ISE (I),150104662,47958203,63451333,261514198,2457510328.25,990470284.03,834113510.451,4282094122.73,553293,89248,186751,829292
2009-05-13,CHX (M),23316398,16748737,7137516,47202651,436712680.49,825011762.61,95662057.9528,1357386501.05,17745,6426,5472,29643
2009-05-13,NYSE (N),1766071469,1100,41500,1766114069,34262787255.2,21324.0,718959.5,34263527538.7,5024104,4,126,5024234
2009-05-13,NYSE Arca (P),1079216548,572265485,354730048,2006212081,21486977934.5,18900586842.8,6996340443.1,47383905220.5,5460807,1653892,1760881,8875580
2009-05-13,NASDAQ (Q),1036967001,555718175,783846832,2376532008,21766553531.7,20927960985.1,15014237882.0,57708752398.7,5196255,1636995,3063808,9897058
2009-05-13,CBOE (W),9998800,10877700,2243800,23120300,176386378.06,386439452.6,56253394.2,619079224.86,4938,9062,7997,21997
2009-05-13,BATS (Z),603462770,371583679,272309779,1247356228,12435358502.6,11381690097.6,4953850951.71,28770899551.9,3876622,1437254,1659615,6973491
2009-05-14,AMEX (A),0,16639706,0,16639706,0.0,51247813.1,0.0,51247813.1,0,31305,0,31305
2009-05-14,BEX (B),42310044,23661158,13362577,79333779,756522571.24,713600247.94,435879335.407,1906002154.59,241548,73257,72579,387384
2009-05-14,NSX (C),43131696,21744035,19378370,84254101,814593185.523,325105451.143,267372044.798,1407070681.46,179068,24258,68506,271832
2009-05-14,NYSE (DN),17751040,2026444,11464646,31242130,341049622.649,64278326.5975,214758534.501,620086483.747,40884,2664,27487,71035
2009-05-14,NASDAQ (DQ),2034125431,886948383,828597205,3749671019,31771040386.7,19941312407.5,12065235530.5,63777588324.6,4906324,1267441,1772733,7946498
2009-05-14,ADF (D),45647662,5927424,14984845,66559931,868584432.515,156193664.09,262995131.253,1287773227.86,163662,9809,59839,233310
2009-05-14,ISE (I),123657736,44594070,55051456,223303262,2120855272.27,898440578.283,684466163.243,3703762013.8,482571,76055,165466,724092
2009-05-14,CHX (M),13640970,10289746,5633715,29564431,300217434.054,670803574.23,112885341.82,1083906350.1,15528,3712,4100,23340
2009-05-14,NYSE (N),1525371503,0,43600,1525415103,30455877937.4,0.0,694054.0,30456571991.4,4561797,0,75,4561872
2009-05-14,NYSE Arca (P),895514781,498635275,315778961,1709929017,18140742395.2,16985379755.9,6275508578.76,41401630729.9,4819120,1411391,1595013,7825524
2009-05-14,NASDAQ (Q),868645847,466188370,715131845,2049966062,18365416066.6,17236190722.4,13668199763.2,49269806552.2,4551620,1364018,2865121,8780759
2009-05-14,CBOE (W),2739500,7876300,10109100,20724900,85503137.52,343358332.8,302614547.03,731476017.35,3956,7825,8421,20202
2009-05-14,BATS (Z),525897526,321949190,245825376,1093672092,11016356413.6,9792436261.04,4361788101.52,25170580776.2,3562050,1248730,1507590,6318370
2009-05-15,AMEX (A),0,16206021,0,16206021,0.0,50144315.32,0.0,50144315.32,0,25608,0,25608
2009-05-15,BEX (B),49960187,23758059,11636433,85354679,918062040.34,843039532.67,365753926.87,2126855499.88,286826,73066,65930,425822
2009-05-15,NSX (C),32834972,20704345,22582472,76121789,655254218.973,349218851.868,215073898.722,1219546969.56,145231,25397,61254,231882
2009-05-15,NYSE (DN),15354329,2351519,10876608,28582456,339241983.237,73422663.8295,164584868.097,577249515.163,38125,3034,26438,67597
2009-05-15,NASDAQ (DQ),1656616953,739635100,749807225,3146059278,28440401445.3,18375791113.7,10614784654.7,57430977213.6,4274783,1013667,1646936,6935386
2009-05-15,ADF (D),38060942,4760378,14597883,57419203,767479660.455,140039847.445,242815511.664,1150335019.56,145785,8459,52839,207083
2009-05-15,ISE (I),112924764,37258384,51921903,202105051,1975739975.49,814749076.403,621562794.989,3412051846.88,409449,65327,149183,623959
2009-05-15,CHX (M),17562398,10554658,9181731,37298787,412268836.842,629377538.84,155069067.325,1196715443.01,15400,4936,5452,25788
2009-05-15,NYSE (N),1480708319,0,13000,1480721319,31875707759.9,0.0,173886.0,31875881645.9,4314694,0,42,4314736
2009-05-15,NYSE Arca (P),779491930,489995158,310404719,1579891807,17011041367.6,17518998642.5,6011706524.22,40541746534.3,4430939,1393046,1566620,7390605
2009-05-15,NASDAQ (Q),787221792,456981693,702235691,1946439176,17523099067.1,17744160659.3,12847704059.8,48114963786.1,4252588,1318066,2604803,8175457
2009-05-15,CBOE (W),5359400,11870500,3249200,20479100,145623213.23,448857145.76,90830949.32,685311308.31,5408,9021,7552,21981
2009-05-15,BATS (Z),465217417,312565841,237891259,1015674517,10044092513.2,9463790480.55,4241685241.13,23749568234.9,3231541,1173133,1413818,5818492
2009-05-18,AMEX (A),0,17219464,0,17219464,0.0,53551340.17,0.0,53551340.17,0,27625,0,27625
2009-05-18,BEX (B),65147200,25687634,13302308,104137142,1263404846.98,850517724.32,398571612.322,2512494183.62,360222,85720,70201,516143
2009-05-18,NSX (C),36151238,21140471,22160397,79452106,762086611.561,311736385.374,262513100.692,1336336097.63,158570,25076,66705,250351
2009-05-18,NYSE (DN),20534089,2365463,11405578,34305130,405438288.198,73125357.4728,183143606.566,661707252.237,44412,3734,27188,75334
2009-05-18,NASDAQ (DQ),1914161634,786843107,766776518,3467781259,33931988314.1,18728981291.5,11420128392.0,64081097997.6,4492256,1095202,1655522,7242980
2009-05-18,ADF (D),36781727,5498946,13570050,55850723,779014224.838,183042821.52,262702940.57,1224759986.93,130635,9951,50914,191500
2009-05-18,ISE (I),123726499,35297641,52455865,211480005,2313039997.26,798623402.59,670775863.361,3782439263.21,460329,72930,152970,686229
2009-05-18,CHX (M),15674875,11452554,8007669,35135098,339910422.63,626516083.53,157526831.072,1123953337.23,16876,4624,5518,27018
2009-05-18,NYSE (N),1423512863,0,23100,1423535963,31089478567.9,0.0,390984.0,31089869551.9,4308500,0,48,4308548
2009-05-18,NYSE Arca (P),729960857,457426148,263539875,1450926880,15910001334.1,16584174321.8,5415354817.33,37909530473.3,3922897,1203129,1394788,6520814
2009-05-18,NASDAQ (Q),849813432,429738370,651405457,1930957259,18808196788.4,16538450366.5,12960027682.7,48306674837.5,4379862,1262505,2666193,8308560
2009-05-18,CBOE (W),6438600,7848000,2343400,16630000,123227278.74,331401535.6,72610553.54,527239367.88,6206,8987,7723,22916
2009-05-18,BATS (Z),502276371,289180348,240930766,1032387485,10780597337.5,8595626790.52,4344988283.98,23721212412.0,3350722,1066819,1510702,5928243
2009-05-19,AMEX (A),0,17721949,0,17721949,0.0,62659989.29,0.0,62659989.29,0,28729,0,28729
2009-05-19,BEX (B),66716156,27643291,14816620,109176067,1310493873.49,954115152.37,476529359.409,2741138385.27,353157,91131,80083,524371
2009-05-19,NSX (C),32956847,18882531,18050730,69890108,683901241.136,278061114.356,236212597.832,1198174953.32,145646,22297,60612,228555
2009-05-19,NYSE (DN),15659847,2442681,11959859,30062387,328711832.344,81636604.5551,188178445.011,598526881.91,37974,4302,27642,69918
2009-05-19,NASDAQ (DQ),1835583783,830829117,786604871,3453017771,32404897851.0,17914707367.8,11792311858.0,62111917076.8,4614980,1167790,1791194,7573964
2009-05-19,ADF (D),45684032,6091739,17135320,68911091,928906914.336,142524344.24,288406360.67,1359837619.25,156071,9461,57618,223150
2009-05-19,ISE (I),130178988,36009793,58186976,224375757,2349231052.68,771848328.874,680164417.07,3801243798.62,465954,74683,157394,698031
2009-05-19,CHX (M),17700227,15609090,5680553,38989870,461553631.526,800415606.54,84188150.62,1346157388.69,13561,4357,5766,23684
2009-05-19,NYSE (N),1347899759,300,40700,1347940759,29535352580.5,6615.5,917809.0,29536277005.0,4253661,3,62,4253726
2009-05-19,NYSE Arca (P),838543266,492312336,311695439,1642551041,18614131010.0,15572126096.7,6177041319.96,40363298426.7,4554089,1363012,1599802,7516903
2009-05-19,NASDAQ (Q),814837044,465375397,665017750,1945230191,18275567996.3,17254447678.4,12951711438.9,48481727113.7,4305462,1351933,2783771,8441166
2009-05-19,CBOE (W),6580100,7488900,2780200,16849200,135676425.88,294489678.0,84849702.41,515015806.29,6959,7793,7512,22264
2009-05-19,BATS (Z),489621579,294734123,250525454,1034881156,10771267743.0,8580606184.7,4448678128.97,23800552056.6,3360988,1096218,1571473,6028679
2009-05-20,AMEX (A),0,17624176,0,17624176,0.0,59481245.73,0.0,59481245.73,0,30822,0,30822
2009-05-20,BEX (B),79851791,33975011,16790030,130616832,1559774318.82,1121657557.79,509753918.07,3191185794.68,423954,110914,96466,631334
2009-05-20,NSX (C),36285555,24560345,19646803,80492703,754884916.159,401409134.07,285457075.881,1441751126.11,154788,28495,65150,248433
2009-05-20,NYSE (DN),19239461,4023030,13360546,36623037,428825810.209,121469508.997,225981735.676,776277054.882,47896,5146,32808,85850
2009-05-20,NASDAQ (DQ),2447685893,1025655762,890728813,4364070468,41321134570.4,22737757834.7,12631434822.7,76690327227.8,5473508,1432717,1997155,8903380
2009-05-20,ADF (D),25664,76581,6500,108745,624674.66,2147765.13,224461.0,2996900.79,25,356,5,386
2009-05-20,ISE (I),145894497,43752191,59538787,249185475,2661894031.29,944857958.117,737308578.67,4344060568.08,531572,85360,174702,791634
2009-05-20,CHX (M),15453801,20359362,6207229,42020392,303246244.049,3853342483.99,113545403.62,4270134131.66,12621,5426,6444,24491
2009-05-20,NYSE (N),1651361405,0,24200,1651385605,34341367971.3,0.0,452607.5,34341820578.8,4824891,0,64,4824955
2009-05-20,NYSE Arca (P),1040768867,590582102,335722541,1967073510,22488610140.7,19119212383.3,6616925072.88,48224747596.9,5273270,1686051,1777018,8736339
2009-05-20,NASDAQ (Q),996329036,564178460,728280526,2288788022,22203377244.8,22187789910.0,13965933819.8,58357100974.6,5027023,1662810,3064384,9754217
2009-05-20,CBOE (W),6601400,10585000,2478800,19665200,135207196.39,503430272.0,65089670.64,703727139.03,7924,8361,8626,24911
2009-05-20,BATS (Z),616670802,371908422,262385860,1250965084,13416809509.0,11198224538.5,4811722795.99,29426756843.6,4001131,1411476,1677112,7089719
2009-05-21,AMEX (A),0,15862160,0,15862160,0.0,57456038.0,0.0,57456038.0,0,28311,0,28311
2009-05-21,BEX (B),77424474,31767458,21300003,130491935,1569240125.88,1047431385.07,582265197.37,3198936708.32,421627,104599,129925,656151
2009-05-21,NSX (C),33092362,24432142,15426675,72951179,650295105.947,389733124.02,238045519.65,1278073749.62,142053,27543,59498,229094
2009-05-21,NYSE (DN),15913074,3413051,13194067,32520192,317003437.183,119774817.68,215197108.54,651975363.403,41396,5273,32960,79629
2009-05-21,NASDAQ (DQ),2009568926,893920676,824982916,3728472518,31941032676.4,20194686658.8,12600070036.2,64735789371.4,4658482,1265763,1955403,7879648
2009-05-21,ADF (D),2493,78721,0,81214,62833.53,2190386.38,0.0,2253219.91,13,298,0,311
2009-05-21,ISE (I),122717180,36292956,54162147,213172283,2036347697.4,803496830.62,720166884.616,3560011412.64,428025,74005,166277,668307
2009-05-21,CHX (M),18540212,12874948,5123519,36538679,350341136.044,795927820.585,104160860.003,1250429816.63,12934,5613,4788,23335
2009-05-21,NYSE (N),1437591608,0,50000,1437641608,29040593657.1,0.0,891334.0,29041484991.1,4284905,0,77,4284982
2009-05-21,NYSE Arca (P),896233538,530188611,328275679,1754697828,17421553570.5,17962432172.1,6584546307.55,41968532050.1,4450997,1512814,1710883,7674694
2009-05-21,NASDAQ (Q),908353197,516722382,746997847,2172073426,18283886969.5,19923093617.4,14540904236.3,52747884823.2,4419559,1550169,3111000,9080728
2009-05-21,CBOE (W),4564000,9516300,3974800,18055100,90981134.0,388527069.0,122320814.56,601829017.56,7212,8913,9848,25973
2009-05-21,BATS (Z),515867226,357517848,255759317,1129144391,10438890653.3,10102504069.2,4487187256.52,25028581979.1,3319198,1262099,1567357,6148654
2009-05-22,AMEX (A),0,11914651,0,11914651,0.0,45648987.33,0.0,45648987.33,0,24413,0,24413
2009-05-22,BEX (B),59399895,23134610,17412577,99947082,1186460548.19,777912900.04,468002792.11,2432376240.34,313063,78941,100938,492942
2009-05-22,NSX (C),28938938,20582807,15781946,65303691,494106717.709,292623476.49,177794782.239,964524976.439,110050,22406,47199,179655
2009-05-22,NYSE (DN),11889208,2614472,9442892,23946572,262559172.146,91024373.3806,147195224.202,500778769.729,30774,3849,24448,59071
2009-05-22,NASDAQ (DQ),1576051206,593273134,608067296,2777391636,24264815311.7,14207716503.7,8903668816.6,47376200632.0,3432481,832765,1424665,5689911
2009-05-22,ADF (D),28248,48944,0,77192,191127.52,1379691.45,0.0,1570818.97,133,252,0,385
2009-05-22,ISE (I),99196540,23563656,41998880,164759076,1594204295.13,539050225.04,528390041.331,2661644561.5,329910,51923,127162,508995
2009-05-22,CHX (M),10026219,8506192,4532325,23064736,171805291.593,610272949.57,143320444.775,925398685.938,7004,3156,3057,13217
2009-05-22,NYSE (N),1058107647,0,41800,1058149447,22086646882.7,0.0,761914.5,22087408797.2,3382485,0,59,3382544
2009-05-22,NYSE Arca (P),606006130,333022279,220226576,1159254985,12675262651.0,11454390088.5,4307694653.26,28437347392.8,3214307,1066978,1215229,5496514
2009-05-22,NASDAQ (Q),644191883,323545690,516630873,1484368446,13798237889.9,12631787324.0,10170404048.2,36600429262.1,3354643,1056207,2241805,6652655
2009-05-22,CBOE (W),4244500,5700200,1768900,11713600,76547539.63,301122519.0,52750341.08,430420399.71,5116,6158,7300,18574
2009-05-22,BATS (Z),377180849,219420305,187902130,784503284,7894538544.27,6721352309.98,3355416522.74,17971307377.0,2536160,878305,1216540,4631005
2009-05-26,AMEX (A),0,16254666,0,16254666,0.0,56242628.06,0.0,56242628.06,0,27408,0,27408
2009-05-26,BEX (B),71630969,29422128,20139167,121192264,1440264166.87,932195072.03,622949397.1,2995408636.0,391003,96668,122572,610243
2009-05-26,NSX (C),38575166,30075531,17133050,85783747,729879113.485,503302796.994,261949154.618,1495131065.1,155742,29337,63377,248456
2009-05-26,NYSE (DN),14966052,4119514,12142756,31228322,298581878.68,102083064.652,214956446.587,615621389.918,40483,5583,36190,82256
2009-05-26,NASDAQ (DQ),1884118659,833693676,758096789,3475909124,30415020390.4,19084857279.5,12650774183.4,62150651853.2,4609707,1236777,1892484,7738968
2009-05-26,ADF (D),6900,48222,0,55122,14724.0,1358188.11,0.0,1372912.11,8,246,0,254
2009-05-26,ISE (I),119098701,34066997,47096247,200261945,2027299160.3,713050313.211,769308755.28,3509658228.79,429033,72332,161921,663286
2009-05-26,CHX (M),16340683,8891302,5790309,31022294,265037268.076,641038152.66,122518645.05,1028594065.79,11538,5194,5421,22153
2009-05-26,NYSE (N),1377941622,0,29200,1377970822,29622757036.5,0.0,616110.0,29623373146.5,4218278,0,77,4218355
2009-05-26,NYSE Arca (P),785639693,518336165,282328616,1586304474,16793906663.4,17816292171.1,6345818226.0,40956017060.5,4388776,1473946,1579904,7442626
2009-05-26,NASDAQ (Q),843707960,483834903,715900430,2043443293,18688520224.5,18717440534.7,15473751586.3,52879712345.5,4578488,1459988,3100356,9138832
2009-05-26,CBOE (W),10044500,6672200,2727800,19444500,123192481.27,260527756.84,62357811.9,446078050.01,6273,6483,9129,21885
2009-05-26,BATS (Z),510106246,326160628,249399631,1085666505,11140543117.3,9852513243.71,4895300954.48,25888357315.5,3473535,1202419,1579702,6255656
2009-05-27,AMEX (A),0,13297307,0,13297307,0.0,53350688.82,0.0,53350688.82,0,25093,0,25093
2009-05-27,BEX (B),72733481,29805790,18002213,120541484,1464998054.62,972900092.732,525702221.28,2963600368.63,377422,97759,105781,580962
2009-05-27,NSX (C),37785441,25209703,20340572,83335716,767102728.036,361323449.198,249417300.993,1377843478.23,152014,25247,60893,238154
2009-05-27,NYSE (DN),15770908,4696962,13504556,33972426,351750628.517,139878612.84,242483916.538,734113157.894,42186,6054,31981,80221
2009-05-27,NASDAQ (DQ),1891141834,842137928,818943340,3552223102,32867770020.9,19361785224.5,13186582845.3,65416138090.8,4593875,1269470,1903537,7766882
2009-05-27,ADF (D),0,43407,0,43407,0.0,1276421.94,0.0,1276421.94,0,290,0,290
2009-05-27,ISE (I),118067088,32663573,55548024,206278685,2084237899.91,776496199.99,786424699.874,3647158799.78,424231,70473,168157,662861
2009-05-27,CHX (M),17554890,12409845,8007824,37972559,315497113.696,809812803.28,194898383.42,1320208300.4,11622,5088,5715,22425
2009-05-27,NYSE (N),1335882068,100,32000,1335914168,28947246774.5,692.5,936420.5,28948183887.5,4122793,1,64,4122858
2009-05-27,NYSE Arca (P),832208162,483339512,308106866,1623654540,18527919131.1,16726386954.3,6689213839.05,41943519924.5,4556860,1463898,1668058,7688816
2009-05-27,NASDAQ (Q),855132086,475189073,705160276,2035481435,19539490133.9,19335292535.4,14729337280.5,53604119949.8,4616299,1420225,3078235,9114759
2009-05-27,CBOE (W),7332400,7843500,2649100,17825000,183583851.94,366542280.66,71362943.8,621489076.4,14398,6522,9893,30813
2009-05-27,BATS (Z),517639283,321991432,247457087,1087087802,11554612362.1,9702035523.18,4720083369.82,25976731255.1,3561302,1172209,1586823,6320334
2009-05-28,AMEX (A),0,15898644,0,15898644,0.0,61925975.05,0.0,61925975.05,0,29803,0,29803
2009-05-28,BEX (B),73724602,32878492,18526362,125129456,1508138530.17,1118302018.42,539940533.493,3166381082.08,403879,108279,114329,626487
2009-05-28,NSX (C),35008643,31756264,22867009,89631916,726848797.826,470038798.518,260855298.892,1457742895.24,155179,31630,73437,260246
2009-05-28,NYSE (DN),18513924,5819727,12615775,36949426,366504356.636,156516752.773,218867172.116,741888281.525,44615,7087,31996,83698
2009-05-28,NASDAQ (DQ),1875489261,881158210,833988727,3590636198,30886167972.5,20460052244.2,12219695494.0,63565915710.7,4582688,1364095,1940351,7887134
2009-05-28,ADF (D),0,73306,0,73306,0.0,2161896.45,0.0,2161896.45,0,379,0,379
2009-05-28,ISE (I),132429795,42970784,65345905,240746484,2112269661.86,991637823.68,825412207.539,3929319693.08,445081,98780,196240,740101
2009-05-28,CHX (M),19776380,14230410,7507941,41514731,365566640.262,1068637724.3,137236023.667,1571440388.23,10168,6558,6430,23156
2009-05-28,NYSE (N),1368770511,0,20900,1368791411,28496334362.6,0.0,453593.0,28496787955.6,4212720,0,57,4212777
2009-05-28,NYSE Arca (P),822368347,523989869,304290067,1650648283,17458692505.0,18583028663.7,6036764143.7,42078485312.4,4377484,1542171,1639943,7559598
2009-05-28,NASDAQ (Q),883700169,542065272,728968436,2154733877,19514312259.6,22287689250.8,14574789666.5,56376791176.9,4695148,1639042,3173888,9508078
2009-05-28,CBOE (W),7862500,8847700,3123100,19833300,115942217.71,444739687.7,75045770.0,635727675.41,5080,7801,9631,22512
2009-05-28,BATS (Z),505489024,330248748,250878104,1086615876,11243782362.9,9743303168.2,4688922402.11,25676007933.2,3453022,1196055,1608469,6257546
2009-05-29,AMEX (A),0,26573311,0,26573311,0.0,96428251.43,0.0,96428251.43,0,33851,0,33851
2009-05-29,BEX (B),74570396,31226580,20470937,126267913,1370450162.13,1000660916.42,555270584.45,2926381663.0,377874,91549,125784,595207
2009-05-29,NSX (C),50229369,27090950,23359841,100680160,869101129.403,369843847.393,278163643.812,1517108620.61,191292,29570,71304,292166
2009-05-29,NYSE (DN),15226105,5018547,14460554,34705206,316193264.071,147071756.001,232999131.925,696264151.997,40917,6657,36671,84245
2009-05-29,NASDAQ (DQ),1834481255,789657351,912370538,3536509144,31888102919.8,18233078105.2,13326067247.4,63447248272.3,4306933,1151278,1845892,7304103
2009-05-29,ADF (D),0,97488,0,97488,0.0,2985973.26,0.0,2985973.26,0,434,0,434
2009-05-29,ISE (I),121259520,39077242,60377834,220714596,2039398883.46,874738025.23,773745837.763,3687882746.45,426267,86005,184417,696689
2009-05-29,CHX (M),22601376,14980821,10629830,48212027,505470053.772,1022152647.58,262138088.583,1789760789.94,10394,5464,6709,22567
2009-05-29,NYSE (N),1861277934,0,35200,1861313134,39015399323.7,0.0,443843.5,39015843167.2,4066391,0,38,4066429
2009-05-29,NYSE Arca (P),746669117,491880849,305873098,1544423064,16644652855.2,17192580410.0,6053985675.52,39891218940.7,4138254,1320829,1591767,7050850
2009-05-29,NASDAQ (Q),835368860,505277818,991544867,2332191545,18801574546.8,20911268948.7,18191472246.7,57904315742.2,4406009,1380376,3052482,8838867
2009-05-29,CBOE (W),5766700,9034800,5615600,20417100,87512029.9,415508715.32,117963997.0,620984742.22,4644,6048,9887,20579
2009-05-29,BATS (Z),489678580,292239884,256478457,1038396921,10897591543.7,8581203005.3,4627814849.89,24106609398.9,3342036,1016226,1556700,5914962
2009-06-01,AMEX (A),0,21329892,0,21329892,0.0,71618456.93,0.0,71618456.93,0,33259,0,33259
2009-06-01,BEX (B),76070990,35382726,24463041,135916757,1638569775.43,1154091934.42,707976257.84,3500637967.69,429821,101712,144675,676208
2009-06-01,NSX (C),55861920,29325304,24804150,109991374,902121605.587,426218994.723,298792336.089,1627132936.4,184214,32743,64728,281685
2009-06-01,NYSE (DN),19927366,6134628,18729502,44791496,457967734.52,189287058.335,304080401.114,951335193.968,53446,8161,47012,108619
2009-06-01,NASDAQ (DQ),2121929577,999007815,1005185934,4126123326,37781399400.7,23749407652.3,14763928015.6,76294735068.7,5056906,1408007,2150059,8614972
2009-06-01,ADF (D),48581930,8007023,19270600,75859553,1036563875.13,226293303.35,368019825.05,1630877003.53,166119,15035,61327,242481
2009-06-01,ISE (I),136257090,41662410,68297298,246216798,2543347490.37,1006877212.08,898359964.389,4448584666.84,496563,87734,199227,783524
2009-06-01,CHX (M),22824776,13230964,7926138,43981878,437303877.9,924999259.858,138013977.907,1500317115.66,16060,7615,7998,31673
2009-06-01,NYSE (N),1500511658,0,30800,1500542458,32778160424.6,0.0,608126.5,32778768551.1,4424733,0,63,4424796
2009-06-01,NYSE Arca (P),867438390,586073067,351419882,1804931339,20145844427.2,20525322689.6,7096642262.4,47767809379.2,4782670,1604109,1775932,8162711
2009-06-01,NASDAQ (Q),977475819,537744576,852828929,2368049324,23269195440.6,22279627274.9,17195669231.6,62744491947.0,5179174,1505085,3432640,10116899
2009-06-01,CBOE (W),8746300,10160800,3966700,22873800,127453415.68,456162292.15,88208524.0,671824231.83,6002,8034,10052,24088
2009-06-01,BATS (Z),543126219,341667410,288346916,1173140545,12940167843.8,10454805532.6,5382250615.21,28777223991.6,3788287,1168520,1732726,6689533
2009-06-02,AMEX (A),0,21011441,0,21011441,0.0,82338426.88,0.0,82338426.88,0,33514,0,33514
2009-06-02,BEX (B),78448190,28654747,21036105,128139042,1563028610.1,997146427.1,620436625.401,3180611662.6,414070,96394,124681,635145
2009-06-02,NSX (C),38125695,28206688,22362605,88694988,922541074.256,407336460.987,293737031.976,1623614567.22,187659,32229,71256,291144
2009-06-02,NYSE (DN),18905836,4741888,15239980,38887704,433681739.795,153606644.34,263424354.826,850712738.961,51517,6142,39970,97629
2009-06-02,NASDAQ (DQ),1955620929,819497761,908091775,3683210465,35909695695.5,19921659527.8,13901621294.9,69732976518.2,4877791,1205317,1951658,8034766
2009-06-02,ADF (D),37533000,5933609,15640600,59107209,932505878.83,168542268.9,307727299.41,1408775447.14,164790,11198,67344,243332
2009-06-02,ISE (I),136578483,37964365,70230535,244773383,2512609379.45,899188739.665,908594214.605,4320392333.72,485025,81899,213461,780385
2009-06-02,CHX (M),16331709,12340671,8846513,37518893,399278111.706,835036686.56,175940359.538,1410255157.8,12836,5441,6946,25223
2009-06-02,NYSE (N),1406354347,0,41200,1406395547,31900037390.2,0.0,721784.0,31900759174.2,4263662,0,95,4263757
2009-06-02,NYSE Arca (P),860734093,505335259,319975770,1686045122,20431874439.5,17829424476.1,6661049468.36,44922348384.0,4650165,1479632,1688132,7817929
2009-06-02,NASDAQ (Q),920380235,454218348,778478130,2153076713,22358071259.4,18846400887.4,16041513184.8,57245985331.6,4938134,1376972,3243368,9558474
2009-06-02,CBOE (W),8990700,11154400,3007700,23152800,120129788.0,451256333.46,90496152.25,661882273.71,6443,7816,10887,25146
2009-06-02,BATS (Z),511808886,291612596,259577172,1062998654,12181223704.2,9308501557.59,5024401043.51,26514126305.3,3511610,1102330,1594657,6208597
2009-06-03,AMEX (A),0,21227359,0,21227359,0.0,67637689.18,0.0,67637689.18,0,35866,0,35866
2009-06-03,BEX (B),77731350,31166842,20215095,129113287,1604138562.6,1140978126.96,607301843.961,3352418533.52,405984,102409,119899,628292
2009-06-03,NSX (C),32328510,25660680,23448269,81437459,772011882.159,378053702.358,290883264.043,1440948848.56,160511,29908,61276,251695
2009-06-03,NYSE (DN),16433897,4239424,15413731,36087052,387076431.098,130924296.645,261274971.908,779275699.651,44458,5582,35711,85751
2009-06-03,NASDAQ (DQ),1747707761,775251172,899390765,3422349698,32209604709.8,19914860238.2,13818948250.3,65943413198.3,4414516,1226041,1837856,7478413
2009-06-03,ADF (D),39693110,5631021,16769700,62093831,896009047.28,171524385.81,316917301.4,1384450734.49,155165,10786,60986,226937
2009-06-03,ISE (I),124699889,37305869,73239253,235245011,2396075146.96,905271260.47,948730339.16,4250076746.59,473149,88495,204906,766550
2009-06-03,CHX (M),16259673,11957695,9454436,37671804,400278765.337,665786908.259,148704994.222,1214770667.82,14152,5370,7298,26820
2009-06-03,NYSE (N),1326720694,0,56800,1326777494,30686849715.6,0.0,1047215.0,30687896930.6,3973922,0,92,3974014
2009-06-03,NYSE Arca (P),730165988,480674246,310856126,1521696360,17593067626.8,17676973069.2,6374919636.14,41644960332.2,4100864,1412332,1533500,7046696
2009-06-03,NASDAQ (Q),795738181,427064350,711085680,1933888211,19431949468.9,18420837180.5,14671823349.3,52524609998.8,4310629,1318259,2862426,8491314
2009-06-03,CBOE (W),6084700,7532600,4061500,17678800,113510314.72,365180649.0,94333038.53,573024002.25,6332,6085,9642,22059
2009-06-03,BATS (Z),417283326,273434931,232356103,923074360,9842271950.16,8917062282.64,4346292697.28,23105626930.1,2897195,1004615,1396397,5298207
2009-06-04,AMEX (A),0,19310719,0,19310719,0.0,71672461.2,0.0,71672461.2,0,30609,0,30609
2009-06-04,BEX (B),77414246,27902503,20921049,126237798,1695923302.52,1004159131.71,574489322.91,3274571757.14,410718,92535,119530,622783
2009-06-04,NSX (C),31638209,26122561,26179640,83940410,769521730.636,380787349.747,289698496.289,1440007576.67,151773,28821,63309,243903
2009-06-04,NYSE (DN),19347780,4399961,16867532,40615273,444684736.914,125081225.152,283039542.169,852805504.235,46456,5353,39061,90870
2009-06-04,NASDAQ (DQ),1793752734,773287137,952539587,3519579458,34752012394.1,17621066000.9,13518842149.1,65891920544.1,4147008,1123120,1844842,7114970
2009-06-04,ADF (D),44235600,6576844,19934700,70747144,996546721.37,206482503.87,368906706.52,1571935931.76,175052,10308,70011,255371
2009-06-04,ISE (I),115693202,38466739,81475904,235635845,2171042431.32,884680383.884,916701882.57,3972424697.77,408703,81246,206841,696790
2009-06-04,CHX (M),15909640,10167329,9784206,35861175,333531816.389,710269584.966,158836262.952,1202637664.31,10240,5022,8198,23460
2009-06-04,NYSE (N),1359412732,0,55700,1359468432,31960930312.4,0.0,982212.5,31961912524.9,3871187,0,134,3871321
2009-06-04,NYSE Arca (P),734753005,458719973,352618699,1546091677,17834302899.7,16192542438.7,6581555320.03,40608400658.5,4043359,1325601,1525607,6894567
2009-06-04,NASDAQ (Q),744664017,423109633,777498787,1945272437,18191498906.7,17383926365.2,14362710983.6,49938136255.5,4004161,1269500,2834267,8107928
2009-06-04,CBOE (W),7797800,7923000,2578100,18298900,140965731.01,406255071.8,56921910.0,604142712.81,5292,7719,9469,22480
2009-06-04,BATS (Z),411071536,265529401,247716607,924317544,9805937471.42,8445066030.5,4271563828.25,22522567330.2,2795738,992256,1400508,5188502
2009-06-05,AMEX (A),0,24710090,0,24710090,0.0,69429313.21,0.0,69429313.21,0,31989,0,31989
2009-06-05,BEX (B),64811051,28814788,20734004,114359843,1376711464.28,1033327255.87,665856843.407,3075895563.55,355676,100564,119708,575948
2009-06-05,NSX (C),32411493,31777714,29438651,93627858,785290098.281,422018192.082,307939953.511,1515248243.87,160212,35797,71163,267172
2009-06-05,NYSE (DN),16479393,5476453,12727911,34683757,392304802.645,172626388.603,249429729.352,814360920.601,42686,6669,30637,79992
2009-06-05,NASDAQ (DQ),1656046368,828179348,883683839,3367909555,31503318647.9,19257111754.2,13832346363.3,64592776765.3,4360869,1227163,1879891,7467923
2009-06-05,ADF (D),37543250,8518136,14411300,60472686,855046919.59,257774600.887,315548176.7,1428369697.18,153208,13565,52697,219470
2009-06-05,ISE (I),111891264,46894142,72861705,231647111,2075760516.85,989978004.209,957995599.698,4023734120.76,428725,93515,193320,715560
2009-06-05,CHX (M),20222437,13442873,7316508,40981818,459815942.731,1052953142.57,113824258.769,1626593344.07,13993,5191,4242,23426
2009-06-05,NYSE (N),1261973163,0,30300,1262003463,29751881406.6,0.0,534432.0,29752415838.6,4074741,0,79,4074820
2009-06-05,NYSE Arca (P),774411352,521160804,304021468,1599593624,18852475985.7,19886645080.0,6636691714.43,45375812780.1,4436009,1612050,1502569,7550628
2009-06-05,NASDAQ (Q),775949801,501955184,707884323,1985789308,18922169889.5,22271347763.5,15053234483.3,56246752136.4,4341447,1500761,2855672,8697880
2009-06-05,CBOE (W),12440200,7206900,2159600,21806700,290412484.45,326363327.75,69438808.95,686214621.15,5766,9299,8948,24013
2009-06-05,BATS (Z),529389747,312410389,260387001,1102187137,12430969947.4,10030452375.0,4934992384.24,27396414706.6,3715602,1225428,1558521,6499551
2009-06-08,AMEX (A),0,19860499,0,19860499,0.0,50511936.96,0.0,50511936.96,0,27226,0,27226
2009-06-08,BEX (B),63160419,28048806,20204405,111413630,1262555681.99,1076189023.06,597587501.46,2936332206.51,335584,94210,115739,545533
2009-06-08,NSX (C),29074054,24689273,21060364,74823691,667621028.99,379898851.272,289240521.009,1336760401.27,143948,26657,62195,232800
2009-06-08,NYSE (DN),14252945,3011662,12503481,29768088,327099280.99,89382867.6961,226499862.509,642982011.195,38643,4113,32363,75119
2009-06-08,NASDAQ (DQ),1389226028,659820535,742229540,2791276103,24975872943.7,17090127250.1,11721646578.5,53787646772.2,3653289,1042716,1680083,6376088
2009-06-08,ADF (D),28780730,4213624,14822100,47816454,643922908.1,157589553.25,289691595.19,1091204056.54,120826,8041,58504,187371
2009-06-08,ISE (I),98625578,31954422,63518395,194098395,1731763850.36,738301769.43,872869562.571,3342935182.36,360660,68855,177421,606936
2009-06-08,CHX (M),20923452,12084178,7105520,40113150,401323257.469,877482996.05,96869356.38,1375675609.9,10159,6300,6928,23387
2009-06-08,NYSE (N),1077242422,0,52600,1077295022,24327398950.3,0.0,785500.0,24328184450.3,3511718,0,134,3511852
2009-06-08,NYSE Arca (P),635384189,410846824,262399550,1308630563,15052882044.6,15647645001.6,6019669169.67,36720196215.8,3699435,1280373,1379038,6358846
2009-06-08,NASDAQ (Q),664726018,377164412,611596462,1653486892,15848521323.5,16426463834.7,13371194810.8,45646179969.0,3791838,1199061,2624682,7615581
2009-06-08,CBOE (W),7498400,4486600,2075400,14060400,65479260.05,240770960.5,62374570.1,368624790.65,3849,7531,7097,18477
2009-06-08,BATS (Z),464344682,250199016,243326813,957870511,10707327421.5,8174008257.17,4710526050.99,23591861729.7,3274514,1014474,1472454,5761442
2009-06-09,AMEX (A),0,19287936,0,19287936,0.0,50884857.52,0.0,50884857.52,0,26825,0,26825
2009-06-09,BEX (B),67707605,27738878,23323544,118770027,1369904446.32,1062225357.09,640263460.008,3072393263.42,359066,107142,132261,598469
2009-06-09,NSX (C),29721360,20694445,20890055,71305860,713550246.61,332501172.255,315656161.776,1361707580.64,145680,23510,64471,233661
2009-06-09,NYSE (DN),13044579,2792669,11149914,26987162,301826499.141,77155043.481,199247833.575,578229376.197,37596,3580,28531,69707
2009-06-09,NASDAQ (DQ),1446711769,596782540,831354362,2874848671,27090314111.4,15838020471.6,12900629392.5,55828963975.4,3637841,931602,1889811,6459254
2009-06-09,ADF (D),26075900,3166223,13828960,43071083,657047176.43,117260128.41,270026254.18,1044333559.02,109602,6258,55549,171409
2009-06-09,ISE (I),108462061,31700831,70059542,210222434,1901050329.25,688590908.31,904911527.005,3494552764.56,378615,61827,195192,635634
2009-06-09,CHX (M),15869038,13505255,9082779,38457072,333423786.874,1050206930.82,241050730.035,1624681447.73,7413,5808,7197,20418
2009-06-09,NYSE (N),1060305212,0,46900,1060352112,24670937008.7,0.0,729877.5,24671666886.2,3428061,0,81,3428142
2009-06-09,NYSE Arca (P),602868369,368594526,283270182,1254733077,14481328267.8,13743701959.3,5963686796.45,34188717023.5,3487986,1204516,1464931,6157433
2009-06-09,NASDAQ (Q),630567079,367759093,650001839,1648328011,15606696935.8,16403945706.8,13540480383.0,45551123025.7,3619391,1163547,2740366,7523304
2009-06-09,CBOE (W),8497700,5774000,2201100,16472800,115008510.13,262079165.92,46057534.5,423145210.55,4262,7205,7321,18788
2009-06-09,BATS (Z),436646033,246507069,262400408,945553510,10206530108.6,8195872704.89,4867435571.84,23269838385.4,3000685,985810,1559395,5545890
2009-06-10,AMEX (A),0,20008710,0,20008710,0.0,56445540.6,0.0,56445540.6,0,28018,0,28018
2009-06-10,BEX (B),74289075,35028448,24796640,134114163,1518560930.06,1266389919.66,689471533.601,3474422383.32,409727,120140,138788,668655
2009-06-10,NSX (C),37930850,25342503,22902741,86176094,846313721.66,453642265.414,335598648.801,1635554635.88,173550,28336,67605,269491
2009-06-10,NYSE (DN),17260523,4804262,14939720,37004505,412379216.313,159807764.421,258343295.413,830530276.146,41185,6460,36735,84380
2009-06-10,NASDAQ (DQ),1782719589,812110912,929779315,3524609816,32592672228.7,21904735646.1,14062003924.0,68559411798.9,4354212,1189226,2042305,7585743
2009-06-10,ADF (D),32804000,5900294,17352520,56056814,777520558.94,226760724.66,319515199.73,1323796483.33,131115,11648,60866,203629
2009-06-10,ISE (I),127623991,41735550,74458822,243818363,2200626318.38,1009482269.48,910592728.284,4120701316.15,446039,77299,203469,726807
2009-06-10,CHX (M),16248572,24444414,13164863,53857849,353907142.307,1667995645.32,290676965.889,2312579753.51,8348,7693,7637,23678
2009-06-10,NYSE (N),1220394502,0,32000,1220426502,27386943785.2,0.0,767139.0,27387710924.2,3907370,0,75,3907445
2009-06-10,NYSE Arca (P),767956541,491481343,322855549,1582293433,17862035221.2,18378447068.3,6665036209.99,42905518499.5,4273505,1464241,1630007,7367753
2009-06-10,NASDAQ (Q),786945956,480113319,720567277,1987626552,18656096692.2,21214871200.8,14873060132.4,54744028025.4,4327351,1494983,3064683,8887017
2009-06-10,CBOE (W),8128700,6973000,2422300,17524000,118463168.66,377800001.0,58806169.5,555069339.16,5088,6078,9034,20200
2009-06-10,BATS (Z),509363840,299002680,267323080,1075689600,11644350862.8,9870640004.85,5139955744.27,26654946611.9,3507304,1135292,1618914,6261510
2009-06-11,AMEX (A),0,22109151,0,22109151,0.0,72728239.06,0.0,72728239.06,0,32687,0,32687
2009-06-11,BEX (B),80901130,32078868,22733765,135713763,1626814260.8,1148501335.85,636919847.044,3412235443.69,412704,109155,124552,646411
2009-06-11,NSX (C),32105178,28032690,22404313,82542181,718733820.444,426141399.586,318311070.811,1463186290.84,145788,29913,65825,241526
2009-06-11,NYSE (DN),18367152,4578578,15196617,38142347,418413695.995,129612318.293,250921650.659,798947664.947,46383,5597,34909,86889
2009-06-11,NASDAQ (DQ),1849756495,795059163,992447008,3637262666,34008663732.4,21341050471.4,14346145447.2,69695859651.1,4473993,1199211,2094103,7767307
2009-06-11,ADF (D),39772890,4592920,20245700,64611510,923582291.7,145396287.3,348351045.42,1417329624.42,160472,9910,69405,239787
2009-06-11,ISE (I),124956152,41661787,75249276,241867215,2271869821.19,984582240.52,880731864.128,4137183925.83,440907,77700,198402,717009
2009-06-11,CHX (M),17287154,16088953,6860703,40236810,466341600.191,1189078275.28,173525583.81,1828945459.28,10347,5451,1788,17586
2009-06-11,NYSE (N),1223250363,0,33400,1223283763,27899694815.3,0.0,645085.0,27900339900.3,4007109,0,67,4007176
2009-06-11,NYSE Arca (P),770987805,485705709,326706977,1583400491,17701748322.7,18325235757.6,6376093097.0,42403077177.3,4177909,1451876,1568802,7198587
2009-06-11,NASDAQ (Q),827786820,443383197,734624639,2005794656,19705178511.4,20399796210.6,14696961267.3,54801935989.2,4408810,1383837,2981331,8773978
2009-06-11,CBOE (W),7001300,8887000,2447500,18335800,88222821.6,436366787.72,60857932.0,585447541.32,4755,7489,8593,20837
2009-06-11,BATS (Z),516703665,301376121,284232228,1102312014,11732371027.5,10193112570.8,5243969953.87,27169453552.1,3487451,1185318,1670098,6342867
2009-06-12,AMEX (A),0,14463420,0,14463420,0.0,54386547.72,0.0,54386547.72,0,24859,0,24859
2009-06-12,BEX (B),66833413,22173898,18457799,107465110,1290282891.3,864783719.14,523317381.802,2678383992.24,328801,85869,108592,523262
2009-06-12,NSX (C),34623418,16164730,23320562,74108710,898590480.06,250426408.499,308925497.68,1457942386.24,178789,21443,65771,266003
2009-06-12,NYSE (DN),14843562,2615972,11990814,29450348,366066892.245,85697169.0613,201768279.139,653532340.445,43944,3997,31005,78946
2009-06-12,NASDAQ (DQ),1568028121,558664207,835715071,2962407399,29408488737.7,15710539644.0,12485614384.8,57604642766.6,3910609,914892,1849105,6674606
2009-06-12,ADF (D),30869990,5385172,14636510,50891672,717936758.95,154736758.8,257091315.17,1129764832.92,121483,12340,52853,186676
2009-06-12,ISE (I),97490077,29505009,62712399,189707485,1878745498.53,731887697.26,810008407.846,3420641603.63,377832,60897,175649,614378
2009-06-12,CHX (M),20840014,14777603,5168427,40786044,390408198.202,1007920959.75,84792258.707,1483121416.66,8625,4525,5331,18481
2009-06-12,NYSE (N),858285985,0,37000,858322985,19350229750.0,0.0,499305.0,19350729055.0,2682812,0,89,2682901
2009-06-12,NYSE Arca (P),697619068,329684594,264237042,1291540704,16398041839.5,12531893986.5,5330817188.16,34260753014.2,3800811,1090082,1322768,6213661
2009-06-12,NASDAQ (Q),675658074,313405111,597653868,1586717053,16094032436.5,14329174812.7,12052718483.0,42475925732.2,3604220,981799,2452487,7038506
2009-06-12,CBOE (W),4288000,4352000,2229200,10869200,54081463.57,218668933.0,49914448.58,322664845.15,3886,5251,7290,16427
2009-06-12,BATS (Z),461311193,216334300,228857819,906503312,10525727141.5,7663250717.49,4352652154.24,22541630013.2,3032196,895410,1393125,5320731
2009-06-15,AMEX (A),0,17408629,0,17408629,0.0,69719156.0,0.0,69719156.0,0,29946,0,29946
2009-06-15,BEX (B),69973659,30692577,23059221,123725457,1373130596.05,1149262146.01,609366077.16,3131758819.22,376698,121637,127011,625346
2009-06-15,NSX (C),33145446,20094655,25817040,79057141,746190310.602,359014869.878,320072665.624,1425277846.1,147155,28776,60404,236335
2009-06-15,NYSE (DN),15744992,4249649,13327594,33322235,353383521.482,128824534.377,236659824.859,718867880.719,41564,5183,33797,80544
2009-06-15,NASDAQ (DQ),1538781031,698056053,854834528,3091671612,27960038278.6,18126039059.8,12920949177.8,59007026516.1,4048489,1159966,1956864,7165319
2009-06-15,ADF (D),28446620,6067796,14411120,48925536,629465427.9,235651046.9,246545838.18,1111662312.98,111786,13794,52677,178257
2009-06-15,ISE (I),90910844,35898870,56263385,183073099,1695863528.5,785894155.503,760571977.811,3242329661.81,360813,72350,166727,599890
2009-06-15,CHX (M),13375411,17004675,5067854,35447940,266019084.515,1223347524.82,100527198.385,1589893807.72,8723,7218,6573,22514
2009-06-15,NYSE (N),1150418949,0,47500,1150466449,25980834833.2,0.0,802617.5,25981637450.7,3625480,0,113,3625593
2009-06-15,NYSE Arca (P),644816802,432566845,285931509,1363315156,15087560551.6,15087609873.1,5789799189.1,35964969613.8,3739907,1298846,1441342,6480095
2009-06-15,NASDAQ (Q),664932351,380680530,677096278,1722709159,15808356820.3,16552834539.0,13785968093.8,46147159453.1,3710789,1167816,2716992,7595597
2009-06-15,CBOE (W),5087500,9086800,2250700,16425000,55368188.65,356241742.58,51391671.0,463001602.23,3984,4791,7371,16146
2009-06-15,BATS (Z),446036997,287565710,251816738,985419445,9929888426.84,9259834444.51,4696377589.75,23886100461.1,3007946,1072736,1497167,5577849
2009-06-16,AMEX (A),0,16272520,0,16272520,0.0,57420544.55,0.0,57420544.55,0,29072,0,29072
2009-06-16,BEX (B),67078378,28124538,23786867,118989783,1298019263.71,943284071.29,626102177.728,2867405512.73,353284,101017,132372,586673
2009-06-16,NSX (C),29728847,20262752,18943909,68935508,637720022.18,302058156.794,264735562.493,1204513741.47,142911,24942,58863,226716
2009-06-16,NYSE (DN),17702305,4416786,13693468,35812559,388043389.422,134336170.498,230238358.248,752617918.168,44172,5472,34365,84009
2009-06-16,NASDAQ (DQ),1620606063,704131909,874275128,3199013100,28920450157.9,18262062170.5,13550838375.1,60733350703.5,4176255,1153093,2046690,7376038
2009-06-16,ADF (D),31419510,4528040,15347830,51295380,684506155.57,146677695.75,277663992.83,1108847844.15,126639,10401,57463,194503
2009-06-16,ISE (I),97145425,34452218,61331077,192928720,1755422316.81,827529204.551,808163389.821,3391114911.19,373719,72267,180224,626210
2009-06-16,CHX (M),17093900,15191019,9919570,42204489,290424977.415,1028161096.71,184064874.185,1502650948.31,13179,5015,6448,24642
2009-06-16,NYSE (N),1176335896,0,60400,1176396296,25874828563.5,0.0,1032710.0,25875861273.5,3734426,0,147,3734573
2009-06-16,NYSE Arca (P),694972649,446725693,310690609,1452388951,16172985079.2,15955832658.7,6491030880.48,38619848618.3,3993028,1376487,1571025,6940540
2009-06-16,NASDAQ (Q),726019430,387791688,680078118,1793889236,17062838874.1,16801575592.2,14084321912.1,47948736378.4,4005599,1217557,2866095,8089251
2009-06-16,CBOE (W),9400700,9741800,2615000,21757500,85838333.27,568001645.75,65068867.6,718908846.62,4933,4915,7661,17509
2009-06-16,BATS (Z),469408393,290491180,275661439,1035561012,10590857555.6,9327701161.53,5199062438.85,25117621156.0,3260651,1137023,1657362,6055036
2009-06-17,AMEX (A),0,14337540,0,14337540,0.0,63968907.95,0.0,63968907.95,0,30667,0,30667
2009-06-17,BEX (B),82099668,38107953,27398698,147606319,1577982674.36,1218995654.17,723688376.255,3520666704.79,439825,132156,148046,720027
2009-06-17,NSX (C),34357215,23249419,28771832,86378466,814333552.571,395788855.301,363615169.906,1573737577.78,179004,30294,73855,283153
2009-06-17,NYSE (DN),12948671,3306872,13643840,29899383,287427796.055,107772850.145,221222841.868,616423488.068,32825,4587,26915,64327
2009-06-17,NASDAQ (DQ),1860194553,916171762,982654853,3759021168,32387434034.1,21589722802.1,15113365367.2,69090522203.4,4719228,1380391,2220256,8319875
2009-06-17,ADF (D),33569900,5194091,15765300,54529291,749173532.46,195685363.31,301277057.87,1246135953.64,134282,11424,57047,202753
2009-06-17,ISE (I),109756674,43341540,68793942,221892156,2008848304.36,1026834724.44,880483116.547,3916166145.34,422781,87122,190414,700317
2009-06-17,CHX (M),14328588,13327984,11677143,39333715,366959573.872,966218409.33,133261959.16,1466439942.36,14783,5688,6866,27337
2009-06-17,NYSE (N),1316301490,0,48500,1316349990,27956898193.1,0.0,902916.0,27957801109.1,4154877,0,105,4154982
2009-06-17,NYSE Arca (P),805682483,544373657,339653542,1689709682,18160171690.9,18255398642.0,7029965438.26,43445535771.1,4495677,1664999,1706658,7867334
2009-06-17,NASDAQ (Q),877095479,469679659,766917599,2113692737,19749821432.8,18676340253.2,15471213951.0,53897375636.9,4702581,1521601,3171851,9396033
2009-06-17,CBOE (W),5388800,10991100,8018900,24398800,80524043.92,585936086.75,189937863.26,856397993.93,4776,6030,7960,18766
2009-06-17,BATS (Z),560625632,375465162,307646257,1243737051,12061341310.9,11194882492.8,5697153582.91,28953377386.6,3746890,1395304,1837843,6980037
2009-06-18,AMEX (A),0,15608129,0,15608129,0.0,57937270.26,0.0,57937270.26,0,29442,0,29442
2009-06-18,BEX (B),65897994,23305770,21649976,110853740,1334700451.9,823010125.87,534327274.46,2692037852.23,359803,91324,116101,567228
2009-06-18,NSX (C),27778862,18692539,28476100,74947501,676187941.664,296599646.381,303930228.306,1276717816.35,154150,22254,63873,240277
2009-06-18,NYSE (DN),14510746,3185303,12427958,30124007,311701271.16,94241780.4859,200342378.993,606285430.639,38713,4949,29090,72752
2009-06-18,NASDAQ (DQ),1534024144,642312536,819783733,2996120413,27583424815.0,16427978286.7,12367160741.7,56378563843.4,3843376,991641,1814903,6649920
2009-06-18,ADF (D),30903220,3931397,11809800,46644417,677942541.09,93047459.35,213484997.0,984474997.44,118405,8744,45610,172759
2009-06-18,ISE (I),82853783,30030308,54715784,167599875,1530033347.41,743016077.713,673092537.036,2946141962.16,321665,67775,149690,539130
2009-06-18,CHX (M),18139990,17964448,10078999,46183437,401661619.073,1044817987.84,179564737.284,1626044344.2,10337,5594,5132,21063
2009-06-18,NYSE (N),1088439941,0,41900,1088481841,23628063151.4,0.0,884802.5,23628947953.9,3398869,0,92,3398961
2009-06-18,NYSE Arca (P),662934043,388665038,279081128,1330680209,14574315291.3,14023628085.7,5889169038.88,34487112415.9,3679926,1237054,1400659,6317639
2009-06-18,NASDAQ (Q),708531193,346793636,629989924,1685314753,15933196545.2,14600956480.6,12626309844.9,43160462870.7,3749288,1137658,2533257,7420203
2009-06-18,CBOE (W),5673700,8284800,4436700,18395200,89459404.52,539834185.16,104476976.9,733770566.58,3531,4529,6152,14212
2009-06-18,BATS (Z),453299414,280915341,253860063,988074818,9739234353.42,8614881730.57,4665977212.19,23020093296.2,3056134,1027325,1492435,5575894
2009-06-19,AMEX (A),0,34022175,0,34022175,0.0,134876388.44,0.0,134876388.44,0,27661,0,27661
2009-06-19,BEX (B),66864384,23561473,39504108,129929965,1313500343.2,823185943.965,735400481.72,2872086768.89,352610,89437,143550,585597
2009-06-19,NSX (C),29231549,15239030,24429680,68900259,688097689.513,261036742.493,344903812.97,1294038244.98,146526,20035,65884,232445
2009-06-19,NYSE (DN),17320842,3248939,17469481,38039262,390984024.196,103524134.517,274583216.072,769091374.785,47398,5155,40973,93526
2009-06-19,NASDAQ (DQ),1604273692,626953440,1026529296,3257756428,28837455752.6,15849729498.1,15451929820.6,60139115071.3,3834465,933156,1937463,6705084
2009-06-19,ADF (D),31862800,3672432,13660000,49195232,717059794.09,131906543.8,242253292.04,1091219629.93,120584,6932,46184,173700
2009-06-19,ISE (I),79955944,27868985,58303703,166128632,1481634398.78,709979303.472,816197716.857,3007811419.11,322753,58905,160836,542494
2009-06-19,CHX (M),14585969,18561470,8918480,42065919,329976173.622,1073829394.87,207538183.94,1611343752.43,8702,4737,5034,18473
2009-06-19,NYSE (N),2127859425,0,34400,2127893825,47664334318.2,0.0,839363.5,47665173681.7,3427825,0,78,3427903
2009-06-19,NYSE Arca (P),644320819,418323268,355707902,1418351989,14684081364.9,15575852345.4,6689772376.52,36949706086.8,3534904,1210028,1457727,6202659
2009-06-19,NASDAQ (Q),664562818,343381985,1170994383,2178939186,15282969813.1,13749115017.6,21933167462.4,50965252293.1,3452760,1047162,2690590,7190512
2009-06-19,CBOE (W),4837200,8041900,3470500,16349600,100798781.0,419530549.06,96891597.03,617220927.09,4139,4678,7078,15895
2009-06-19,BATS (Z),435024714,269191538,296860020,1001076272,9596788101.69,8485035352.48,5163618131.74,23245441585.9,2838981,972760,1498562,5310303
2009-06-22,AMEX (A),0,15963710,0,15963710,0.0,60106015.01,0.0,60106015.01,0,29567,0,29567
2009-06-22,BEX (B),80842064,33543446,29083054,143468564,1406300747.05,1077268004.05,705799161.77,3189367912.87,413052,113395,149073,675520
2009-06-22,NSX (C),22857760,18879594,24057357,65794711,441169437.522,320934557.272,309998672.487,1072102667.28,97743,24798,45463,168004
2009-06-22,NYSE (DN),15229196,4059304,13473490,32761990,331039785.001,114216295.473,225530726.875,670786807.349,44580,5968,35233,85781
2009-06-22,NASDAQ (DQ),1703373727,845250133,899855969,3448479829,30273836495.6,21256883391.9,14624409498.6,66155129386.2,4358011,1234055,2128161,7720227
2009-06-22,ADF (D),32253900,7075700,12463000,51792600,683967755.05,233458483.87,240550736.04,1157976974.96,124105,16367,45550,186022
2009-06-22,ISE (I),98390665,38009020,47945016,184344701,1737268697.16,890342951.883,727008570.877,3354620219.92,384374,75709,157438,617521
2009-06-22,CHX (M),17201501,19197270,7922496,44321267,334015887.328,1174534414.25,129819412.638,1638369714.22,10249,5922,6157,22328
2009-06-22,NYSE (N),1403277048,100,56100,1403333248,30162315717.3,795.0,908479.0,30163224991.3,3969861,1,94,3969956
2009-06-22,NYSE Arca (P),693388044,508751010,298788629,1500927683,15509330946.0,18132954165.9,6529458610.43,40171743722.3,3959944,1447541,1506132,6913617
2009-06-22,NASDAQ (Q),721615100,401675954,740516049,1863807103,16221463239.5,15764623441.8,15283844190.1,47269930871.4,3942057,1246326,2937510,8125893
2009-06-22,CBOE (W),5305600,7199800,2675300,15180700,144531301.74,242631401.0,81223511.72,468386214.46,7314,5808,7589,20711
2009-06-22,BATS (Z),503167162,317245140,286372203,1106784505,10692976047.3,9614344962.65,5233218583.85,25540539593.8,3373109,1137821,1654594,6165524
2009-06-23,AMEX (A),0,15714720,0,15714720,0.0,55825303.4,0.0,55825303.4,0,31236,0,31236
2009-06-23,BEX (B),72347551,28675475,28828101,129851127,1253672508.19,912479966.74,663827178.63,2829979653.56,369108,98146,144023,611277
2009-06-23,NSX (C),37179470,18872870,22473950,78526290,819988149.256,309410282.723,359581431.244,1488979863.22,193527,26381,74959,294867
2009-06-23,NYSE (DN),22622310,3726421,15949248,42297979,489353594.261,99347118.6582,277852113.479,866552826.398,58895,5623,38572,103090
2009-06-23,NASDAQ (DQ),1668099642,763185470,810530588,3241815700,28957693751.2,17159018745.3,12740748511.1,58857461007.7,4255160,1144402,1915612,7315174
2009-06-23,ADF (D),38491550,5153377,13551300,57196227,826366445.59,156176149.41,257680685.27,1240223280.27,159666,9708,54382,223756
2009-06-23,ISE (I),91868544,38375690,48945472,179189706,1652831612.08,999266169.63,735619975.366,3387717757.07,381553,80923,158724,621200
2009-06-23,CHX (M),16413939,16610994,9062548,42087481,321892096.708,1222114749.64,185700041.125,1729706887.48,11405,6010,4652,22067
2009-06-23,NYSE (N),1210420200,4300,43100,1210467600,25251324273.1,178313.0,790038.0,25252292624.1,3801749,4,106,3801859
2009-06-23,NYSE Arca (P),698351091,473630181,294676793,1466658065,14801590763.8,15979885649.7,6082171171.09,36863647584.6,3974098,1453836,1516691,6944625
2009-06-23,NASDAQ (Q),725861301,382241409,667927858,1776030568,15696909416.5,14073832328.6,13318156523.3,43088898268.3,3980062,1200337,2804734,7985133
2009-06-23,CBOE (W),6786600,7626700,7332800,21746100,98792333.65,307507308.92,213946678.73,620246321.3,4193,6363,6891,17447
2009-06-23,BATS (Z),491017367,324677263,270541984,1086236614,10028788342.2,9257740013.59,4877691086.32,24164219442.1,3275998,1146387,1579137,6001522
2009-06-24,AMEX (A),0,12534662,0,12534662,0.0,51298810.3,0.0,51298810.3,0,26634,0,26634
2009-06-24,BEX (B),62743056,23335884,25294216,111373156,1100334744.05,745416107.17,545760769.24,2391511620.46,326471,67588,119738,513797
2009-06-24,NSX (C),38423737,19317808,26477814,84219359,917222647.001,288050402.542,357911211.974,1563184261.52,203577,26391,80428,310396
2009-06-24,NYSE (DN),21044832,4362123,14074639,39481594,465673070.948,135864632.611,250026930.685,851564634.244,51174,5797,33010,89981
2009-06-24,NASDAQ (DQ),1596384705,689463030,855477991,3141325726,28545641984.4,17381810806.5,13365810879.3,59293263670.2,4376454,1100962,2006595,7484011
2009-06-24,ADF (D),0,2093,0,2093,0.0,61343.51,0.0,61343.51,0,9,0,9
2009-06-24,ISE (I),90677968,32391439,47624636,170694043,1698241103.87,867231771.707,702279785.372,3267752660.95,358723,71933,149267,579923
2009-06-24,CHX (M),18178534,15005518,9997336,43181388,393212477.471,1085358541.96,105527429.46,1584098448.89,17539,5174,4771,27484
2009-06-24,NYSE (N),1101556413,0,32900,1101589313,24183261471.6,0.0,600935.5,24183862407.1,3776928,0,86,3777014
2009-06-24,NYSE Arca (P),683105934,443311519,297950316,1424367769,15604284669.8,16259976461.0,6166545089.54,38030806220.3,3983857,1380788,1504014,6868659
2009-06-24,NASDAQ (Q),674870554,328615588,631775889,1635262031,15212753316.4,13087448412.9,12338725052.7,40638926782.0,3789373,1075013,2657313,7521699
2009-06-24,CBOE (W),6055200,8475800,1951300,16482300,102887723.62,261959106.64,46277506.33,411124336.59,5765,5567,7017,18349
2009-06-24,BATS (Z),514508252,308511976,275079037,1098099265,10885017923.1,9649164820.16,5135397777.25,25669580520.5,3430278,1152232,1636246,6218756
2009-06-25,AMEX (A),0,14690432,0,14690432,0.0,57328888.93,0.0,57328888.93,0,28903,0,28903
2009-06-25,BEX (B),84764014,29240585,28938033,142942632,1526136095.71,989658486.3,703403384.07,3219197966.08,467275,114414,160348,742037
2009-06-25,NSX (C),39035844,19357001,39389332,97782177,866205057.968,303931502.214,428109937.243,1598246497.43,201565,25882,95094,322541
2009-06-25,NYSE (DN),18438440,3175833,15048403,36662676,428043992.57,103478180.645,245514878.059,777037051.274,50070,4733,35476,90279
2009-06-25,NASDAQ (DQ),1628692099,702786546,871789759,3203268404,30014043570.2,19534076095.6,12966243959.2,62514363625.0,4114453,1119450,1905650,7139553
2009-06-25,ADF (D),0,1983,0,1983,0.0,83895.88,0.0,83895.88,0,10,0,10
2009-06-25,ISE (I),91217659,32144665,57952548,181314872,1643636897.25,943155700.339,765720096.175,3352512693.77,360182,70578,161519,592279
2009-06-25,CHX (M),26523756,31469796,12852728,70846280,558355518.56,1625411379.95,157947250.07,2341714148.58,11570,6548,6719,24837
2009-06-25,NYSE (N),1228649914,0,55500,1228705414,27014952277.9,0.0,588384.5,27015540662.4,3871247,0,81,3871328
2009-06-25,NYSE Arca (P),697494465,485495542,295273561,1478263568,15887463224.0,19111653611.9,6078960673.71,41078077509.6,4006500,1464803,1480163,6951466
2009-06-25,NASDAQ (Q),749899536,387275905,694865760,1832041201,17349536287.6,16465418672.2,14081548419.2,47896503379.0,4171492,1310415,2832668,8314575
2009-06-25,CBOE (W),11244400,6398100,2305600,19948100,142676510.2,344276187.12,57123252.15,544075949.47,4486,6642,7082,18210
2009-06-25,BATS (Z),511182691,317158478,262097125,1090438294,11402080808.8,10379710643.8,4902359796.94,26684151249.5,3451400,1179927,1555538,6186865
2009-06-26,AMEX (A),0,132781617,0,132781617,0.0,413330321.95,0.0,413330321.95,0,61329,0,61329
2009-06-26,BEX (B),66195729,23039380,27175008,116410117,1227434224.01,798877707.71,601632666.98,2627944598.7,355297,93382,140147,588826
2009-06-26,NSX (C),46588231,14792243,39327419,100707893,870218553.107,196084431.969,344626640.819,1410929625.9,199847,22110,89935,311892
2009-06-26,NYSE (DN),16456814,2808301,15253519,34518634,342269688.02,71889563.7419,219322287.988,633481539.75,40648,4054,34364,79066
2009-06-26,NASDAQ (DQ),1893265441,518639997,2662062874,5073968312,36660077040.4,12624331834.2,26942932545.7,76227341420.3,3563876,825609,2136776,6526261
2009-06-26,ADF (D),718700,26263,0,744963,13043094.735,1915788.28,0.0,14958883.015,3361,184,0,3545
2009-06-26,ISE (I),78727668,25469574,73847940,178045182,1364275174.74,606509918.193,761781009.659,2732566102.59,321839,61405,211126,594370
2009-06-26,CHX (M),17346130,10310217,10417766,38074113,288873096.984,736471086.15,110343937.906,1135688121.04,13186,4513,5796,23495
2009-06-26,NYSE (N),2347889266,0,58700,2347947966,43051910828.8,0.0,816359.0,43052727187.8,3610252,0,107,3610359
2009-06-26,NYSE Arca (P),593069247,347944480,330672840,1271686567,12872158871.9,12659964697.8,5637346239.49,31169469809.2,3295425,1091591,1504577,5891593
2009-06-26,NASDAQ (Q),623771317,305788576,1896195078,2825754971,13851572023.3,12848877485.2,22675809004.3,49376258512.8,3359030,1019167,3159319,7537516
2009-06-26,CBOE (W),6456900,4056100,5736400,16249400,126214144.39,197654398.0,169290554.45,493159096.84,4756,4815,9994,19565
2009-06-26,BATS (Z),390116410,241640387,255871845,887628642,8361736571.3,7778063091.24,4296355035.62,20436154698.2,2629014,902082,1466930,4998026
2009-06-29,AMEX (A),0,20117197,0,20117197,0.0,71648588.64,0.0,71648588.64,0,36125,0,36125
2009-06-29,BEX (B),64455189,21732757,28510410,114698356,1186670975.11,729117554.25,621607815.59,2537396344.95,355375,84176,145335,584886
2009-06-29,NSX (C),35310511,14114670,25859185,75284366,635169897.642,187338388.972,312083774.317,1134592060.93,144949,18775,80879,244603
2009-06-29,NYSE (DN),16086677,2478597,14859919,33425193,328777672.609,74509675.1559,222219937.014,625507284.779,39306,3249,35567,78122
2009-06-29,NASDAQ (DQ),1436145277,555301603,807861651,2799308531,26038755695.2,13854648639.0,12975125529.1,52868529863.3,3527489,870058,1785249,6182796
2009-06-29,ADF (D),0,29309,0,29309,0.0,2244156.4,0.0,2244156.4,0,225,0,225
2009-06-29,ISE (I),76363497,20991115,43850786,141205398,1209236223.75,519581132.144,575824461.088,2304641816.98,277846,49090,144560,471496
2009-06-29,CHX (M),14349107,12565295,7157890,34072292,318090662.754,744540472.78,99550389.3488,1162181524.88,8032,3985,5177,17194
2009-06-29,NYSE (N),1065350411,0,64300,1065414711,22670336987.3,0.0,624923.0,22670961910.3,3121132,0,95,3121227
2009-06-29,NYSE Arca (P),538944604,339594530,264610000,1143149134,12037980578.6,12363897059.9,5259621591.64,29661499230.2,2985219,1009686,1298373,5293278
2009-06-29,NASDAQ (Q),588569962,279451705,636133504,1504155171,13348813400.5,11363507846.8,12514531454.5,37226852701.8,3176587,917477,2525022,6619086
2009-06-29,CBOE (W),4454500,6866100,3746600,15067200,78828790.79,197960545.68,119185497.35,395974833.82,3909,4812,6505,15226
2009-06-29,BATS (Z),380255670,225184816,239518209,844958695,8400061847.29,7183683510.16,4309708711.85,19893454069.3,2529264,847642,1361609,4738515
2009-06-30,AMEX (A),0,13830054,0,13830054,0.0,63985632.73,0.0,63985632.73,0,28197,0,28197
2009-06-30,BEX (B),80192422,26180021,27416030,133788473,1444911685.25,878415950.74,655255078.63,2978582714.62,434160,105328,148300,687788
2009-06-30,NSX (C),45999606,18384922,27672521,92057049,899201531.473,255073013.216,340374990.259,1494649534.95,210179,20982,90300,321461
2009-06-30,NYSE (DN),17080595,2676287,12342519,32099401,330633832.592,96491621.3204,221083123.282,648208577.194,39827,3695,28475,71997
2009-06-30,NASDAQ (DQ),1740369463,601261909,830137846,3171769218,30709024494.9,17633260319.8,13884176243.6,62226461058.4,4089085,952067,1854902,6896054
2009-06-30,ADF (D),0,82543,0,82543,0.0,6400399.35,0.0,6400399.35,0,532,0,532
2009-06-30,ISE (I),87957991,22674967,41123590,151756548,1352890254.91,577097166.725,538250230.461,2468237652.09,304732,51844,130691,487267
2009-06-30,CHX (M),13144359,16209219,6631003,35984581,324346169.023,951543323.629,160043992.63,1435933485.28,9130,4472,4727,18329
2009-06-30,NYSE (N),1328019252,0,19400,1328038652,28756281891.8,0.0,369244.0,28756651135.8,3500126,0,52,3500178
2009-06-30,NYSE Arca (P),637916749,420275303,270250599,1328442651,13717662564.2,15753688155.4,5700454246.14,35171804965.7,3361323,1216904,1351293,5929520
2009-06-30,NASDAQ (Q),676943471,352152769,677001111,1706097351,15225218912.4,15607110776.2,14246892798.5,45079222487.0,3615580,1162310,2638046,7415936
2009-06-30,CBOE (W),3405200,6869100,2450400,12724700,50088619.41,349398796.0,76164387.3,475651802.71,3606,5783,6398,15787
2009-06-30,BATS (Z),458175099,291975773,238081414,988232286,9694380450.97,9619237544.41,4423625094.87,23737243090.2,2916328,1112212,1390650,5419190
2009-07-01,AMEX (A),0,11151456,0,11151456,0.0,51220445.88,0.0,51220445.88,0,24016,0,24016
2009-07-01,BEX (B),74587095,24201964,28903083,127692142,1489479172.74,844949130.72,650620906.942,2985049210.4,425779,98005,157072,680856
2009-07-01,NSX (C),26008814,13400599,27654726,67064139,565598991.154,197659168.654,202513657.819,965771817.627,137791,17662,67321,222774
2009-07-01,NYSE (DN),14284036,2600963,13018395,29903394,323131771.483,79889939.5174,223732615.622,626754326.623,39874,3434,29534,72842
2009-07-01,NASDAQ (DQ),1416647428,519762860,786181266,2722591554,27640884765.8,15344316001.2,12865279684.5,55850480451.5,3643323,842883,1773909,6260115
2009-07-01,ADF (D),29000140,3660100,11136600,43796840,710928094.4,117345627.59,238125512.52,1066399234.51,111263,8244,44164,163671
2009-07-01,ISE (I),77048759,16229232,48407289,141685280,1385230500.88,506184349.84,626725704.111,2518140554.83,317026,44319,148212,509557
2009-07-01,CHX (M),16866637,12186979,10369364,39422980,352353213.538,765400945.852,120891161.606,1238645321.0,12075,3871,5415,21361
2009-07-01,NYSE (N),951126595,0,49900,951176495,21461568857.2,0.0,913043.0,21462481900.2,3107654,0,151,3107805
2009-07-01,NYSE Arca (P),524840614,339848162,253010821,1117699597,12234366296.8,12635165750.6,5168251642.3,30037783689.7,3023943,1078663,1249469,5352075
2009-07-01,NASDAQ (Q),598419581,307212701,617433215,1523065497,14354142901.0,13358080560.5,12598222991.3,40310446452.8,3404677,1019279,2535970,6959926
2009-07-01,CBOE (W),4264600,4359800,1322000,9946400,71862835.0,213363834.0,33515259.48,318741928.48,3050,4230,5977,13257
2009-07-01,BATS (Z),381263902,232131991,221868154,835264047,8437031797.23,8181936426.15,4156582144.99,20775550368.4,2526448,947931,1292740,4767119
2009-07-02,AMEX (A),0,9640780,0,9640780,0.0,36067744.57,0.0,36067744.57,0,17520,0,17520
2009-07-02,BEX (B),83669209,24054615,27740684,135464508,1457864688.56,755743897.653,566259264.452,2779867850.66,418548,78841,132280,629669
2009-07-02,NSX (C),19043643,15717986,17222580,51984209,412315686.654,213981300.342,158335418.182,784632405.177,113727,17059,49200,179986
2009-07-02,NYSE (DN),18891969,3072208,14293325,36257502,456954404.866,80310386.9471,245513129.854,782777921.667,67105,4147,42568,113820
2009-07-02,NASDAQ (DQ),1380625161,577439753,768285256,2726350170,26519689692.9,15375299241.4,11872336150.2,53767325084.5,3703531,900304,1759694,6363529
2009-07-02,ADF (D),28591400,3660000,9387500,41638900,702159127.1,133732295.5,190495524.26,1026386946.86,121331,7917,38509,167757
2009-07-02,ISE (I),79131777,22647956,47006976,148786709,1583764570.77,592909024.979,609444003.987,2786117599.74,345763,51908,148899,546570
2009-07-02,CHX (M),10402134,9344634,7230237,26977005,205046823.258,576879831.45,97562002.1018,879488656.809,8947,3664,4421,17032
2009-07-02,NYSE (N),733601663,100,37600,733639363,16169440357.4,2835.5,710289.0,16170153481.9,2324589,1,101,2324691
2009-07-02,NYSE Arca (P),564921970,391613888,238307409,1194843267,13395060595.3,14026512123.9,4981511338.07,32403084057.3,3162906,1039115,1176801,5378822
2009-07-02,NASDAQ (Q),657743507,355713803,615965207,1629422517,15737484499.4,14229777093.0,12692575567.0,42659837159.4,3615751,1066621,2446540,7128912
2009-07-02,CBOE (W),3980600,5938100,993600,10912300,68315058.0,294109789.86,28157476.95,390582324.81,3457,4067,3544,11068
2009-07-02,BATS (Z),427836441,256300389,225158009,909294839,9506858343.01,8378676378.75,4165009275.7,22050543997.5,2767937,907320,1280687,4955944
2009-07-06,AMEX (A),0,12390778,0,12390778,0.0,54079936.6,0.0,54079936.6,0,25810,0,25810
2009-07-06,BEX (B),87391964,27607205,37225312,152224481,1463950721.47,836556202.72,683983715.018,2984490639.2,451390,89066,162100,702556
2009-07-06,NSX (C),15375451,14181620,16020669,45577740,297849630.304,181478357.494,116320481.601,595648469.4,85758,18091,46005,149854
2009-07-06,NYSE (DN),16054646,3064561,13174777,32293984,363062458.148,92585599.2213,214620190.004,670268247.374,46563,4523,33606,84692
2009-07-06,NASDAQ (DQ),1493479767,609835281,743801557,2847116605,27311359281.2,15147331716.2,11584964279.4,54043655276.7,4036408,1010871,1773207,6820486
2009-07-06,ADF (D),31557990,3032900,11680900,46271790,694422227.88,92116015.38,228179050.75,1014717294.01,127662,7589,50028,185279
2009-07-06,ISE (I),89081633,24616583,41966667,155664883,1672459926.81,634351933.898,557384825.204,2864196685.91,365748,56274,133809,555831
2009-07-06,CHX (M),11627639,10806525,6739631,29173795,232532481.059,717957940.15,77263764.994,1027754186.2,9867,4007,4556,18430
2009-07-06,NYSE (N),1140653485,100,64500,1140718085,24228915086.8,398.5,1002999.5,24229918484.8,3477715,1,112,3477828
2009-07-06,NYSE Arca (P),635624762,386670350,257395269,1279690381,14425041710.7,12860144324.1,5346425268.09,32631611302.9,3543991,1136176,1279059,5959226
2009-07-06,NASDAQ (Q),702140322,346016177,638162056,1686318555,16083553435.6,13198433390.7,12862997495.3,42144984321.5,3881809,1107897,2623822,7613528
2009-07-06,CBOE (W),4376500,3796700,2356300,10529500,67310418.1,148968849.0,56786527.65,273065794.75,4060,4699,5602,14361
2009-07-06,BATS (Z),488175625,261855070,240911606,990942301,10432614951.8,8127382354.37,4260737799.41,22820735105.6,3142079,983696,1417267,5543042
2009-07-07,AMEX (A),0,10826081,0,10826081,0.0,48812325.51,0.0,48812325.51,0,23786,0,23786
2009-07-07,BEX (B),81240378,25868561,32436533,139545472,1369341753.94,842938407.12,692448810.98,2904728972.04,448349,96541,160325,705215
2009-07-07,NSX (C),16935003,15983155,15376401,48294559,338591780.943,228169997.088,131129767.709,697891545.74,96143,20689,48073,164905
2009-07-07,NYSE (DN),17348669,2528952,13722379,33600000,406064948.086,86887857.1166,241427206.189,734380011.391,50189,4132,34410,88731
2009-07-07,NASDAQ (DQ),1502335893,595171028,782304204,2879811125,27409494402.1,15544292661.5,12827063919.6,55780850983.2,4151948,1046893,1879681,7078522
2009-07-07,ADF (D),32631680,3928800,12809200,49369680,740941947.67,128625978.17,253438203.45,1123006129.29,132267,8573,52907,193747
2009-07-07,ISE (I),86342119,21255721,41533410,149131250,1552633679.21,591762019.419,612356370.415,2756752069.04,346675,53780,135658,536113
2009-07-07,CHX (M),12338145,9969491,6872334,29179970,291336892.838,673084442.64,118260086.182,1082681421.66,8146,3961,4814,16921
2009-07-07,NYSE (N),1107765476,0,50200,1107815676,23458646243.7,0.0,954364.5,23459600608.2,3440745,0,79,3440824
2009-07-07,NYSE Arca (P),643176828,390197413,272904595,1306278836,14494245791.7,13431941899.4,5766381198.57,33692568889.7,3589507,1190377,1321690,6101574
2009-07-07,NASDAQ (Q),712495217,349637701,662428488,1724561406,15822593031.1,14099773691.3,13548269066.3,43470635788.7,3938242,1167453,2703501,7809196
2009-07-07,CBOE (W),6003700,5752800,2530000,14286500,158706031.65,266137358.84,70988786.27,495832176.76,5025,5228,6371,16624
2009-07-07,BATS (Z),458109811,284850508,245210005,988170324,9691708725.17,9049253181.23,4462757943.75,23203719850.2,2957297,1076222,1372884,5406403
2009-07-08,AMEX (A),0,14361854,0,14361854,0.0,55921210.5,0.0,55921210.5,0,28244,0,28244
2009-07-08,BEX (B),103698581,44908167,43587132,192193880,1740208260.98,1288004277.4,938434084.114,3966646622.49,582578,136245,213069,931892
2009-07-08,NSX (C),22832902,22657964,19047102,64537968,452024286.01,308196353.742,171788627.711,932009267.463,130296,29170,62950,222416
2009-07-08,NYSE (DN),21102687,4827789,15051360,40981836,469926743.043,170091251.395,273010590.861,913028585.299,52414,6911,37262,96587
2009-07-08,NASDAQ (DQ),1889115245,923002365,916666092,3728783702,33119890966.7,21821379183.6,15371354628.6,70312624779.0,4731449,1464516,2089753,8285718
2009-07-08,ADF (D),42595020,5914010,19260000,67769030,895962652.48,214487679.89,368280830.65,1478731163.02,166722,14271,70702,251695
2009-07-08,ISE (I),106309331,36801662,45353416,188464409,1750362070.22,872714107.137,693704035.505,3316780212.86,408192,79862,144671,632725
2009-07-08,CHX (M),15425752,14345712,8444665,38216129,380094240.801,1034995420.71,179341365.267,1594431026.78,13413,6316,4170,23899
2009-07-08,NYSE (N),1438098265,0,49900,1438148165,29100795954.7,0.0,889353.5,29101685308.2,4196110,0,111,4196221
2009-07-08,NYSE Arca (P),870396188,539165691,334627175,1744189054,18773652132.0,18561807402.6,7476272369.14,44811731903.7,4740396,1634256,1662880,8037532
2009-07-08,NASDAQ (Q),943306074,519816433,819904376,2283026883,20514552704.3,19283016512.3,17430937098.7,57228506315.4,5091058,1658990,3313712,10063760
2009-07-08,CBOE (W),3267200,5954700,2540800,11762700,102093201.46,263832013.07,68408991.8,434334206.33,6231,7874,8159,22264
2009-07-08,BATS (Z),609489878,395418397,301524426,1306432701,12320278086.9,11944728044.7,5602688517.46,29867694649.1,3879928,1436020,1674359,6990307
2009-07-09,AMEX (A),0,10075435,0,10075435,0.0,40880774.71,0.0,40880774.71,0,22703,0,22703
2009-07-09,BEX (B),92346711,24814902,32639439,149801052,1666544558.02,939094459.5,700151916.312,3305790933.83,520434,104837,176067,801338
2009-07-09,NSX (C),15569396,8045628,12470866,36085890,342978379.523,208933155.217,142613859.058,694525393.798,100941,19451,47084,167476
2009-07-09,NYSE (DN),17037018,3291960,11984058,32313036,361959312.919,123044343.928,210548168.061,695551824.908,46544,5349,30545,82438
2009-07-09,NASDAQ (DQ),1364185656,440153434,695786661,2500125751,23834958160.3,14223752085.3,11606437716.0,49665147961.6,3666954,943361,1675428,6285743
2009-07-09,ADF (D),27260220,2692200,13456100,43408520,601281985.16,117509807.1,271999456.56,990791248.82,106901,7320,53186,167407
2009-07-09,ISE (I),81188392,19066189,38103455,138358036,1419225464.57,615051894.252,532964057.233,2567241416.06,334984,60107,126668,521759
2009-07-09,CHX (M),14006912,13307071,5374258,32688241,251710903.077,901044100.51,87832041.352,1240587044.94,8177,4976,3789,16942
2009-07-09,NYSE (N),1006111235,200,67200,1006178635,21160142478.6,754.0,1105730.5,21161248963.1,3372785,2,132,3372919
2009-07-09,NYSE Arca (P),591573588,334672181,252682126,1178927895,13029379795.6,12893573160.2,5265431331.09,31188384286.9,3368105,1222650,1317353,5908108
2009-07-09,NASDAQ (Q),703954693,344498476,614525501,1662978670,15579845728.2,14450422996.3,12531939191.5,42562207916.0,4005794,1317763,2759445,8083002
2009-07-09,CBOE (W),5244500,4594000,2018900,11857400,91465600.46,182568049.55,51477064.2,325510714.21,2921,3071,1841,7833
2009-07-09,BATS (Z),433399342,245080609,230888536,909368487,9089086998.55,8639580859.42,4099988007.54,21828655865.5,2889568,1065897,1368762,5324227
2009-07-10,AMEX (A),0,7694229,0,7694229,0.0,34571209.23,0.0,34571209.23,0,19178,0,19178
2009-07-10,BEX (B),82498137,23158779,31033340,136690256,1441536276.42,872641167.77,642435973.02,2956613417.21,457632,97830,162422,717884
2009-07-10,NSX (C),13737859,8233525,13870743,35842127,297615687.984,235820547.773,125364155.101,658800390.858,85552,19803,41096,146451
2009-07-10,NYSE (DN),14039505,2938145,10455129,27432779,310350278.457,109310752.787,184114662.13,603775693.373,37002,4927,25939,67868
2009-07-10,NASDAQ (DQ),1246475632,408239996,591567119,2246282747,22108221373.9,14282118554.9,9986937420.6,46377277349.4,3335615,858153,1469049,5662817
2009-07-10,ADF (D),30787760,2667400,12823430,46278590,631760982.37,107660507.5,251422684.0,990844173.87,120966,6799,50161,177926
2009-07-10,ISE (I),72738515,17182470,29992602,119913587,1302803227.51,611282598.97,445722654.732,2359808481.21,297164,54651,102793,454608
2009-07-10,CHX (M),11743629,12130277,5372060,29245966,183361788.334,935955234.394,109448490.18,1228765512.91,5157,4239,2935,12331
2009-07-10,NYSE (N),922161362,0,49000,922210362,19851223369.3,0.0,675673.0,19851899042.3,3090948,0,119,3091067
2009-07-10,NYSE Arca (P),541561477,303013127,225586878,1070161482,12382617451.5,12001900149.1,4705388952.97,29089906553.6,3088957,1100052,1168041,5357050
2009-07-10,NASDAQ (Q),607563311,292771895,559042851,1459378057,13939319838.6,13166215778.8,11521661923.2,38627197540.6,3499952,1181151,2425011,7106114
2009-07-10,CBOE (W),2353000,7551900,1467900,11372800,59957537.1,292410396.0,33136386.0,385504319.1,4307,6763,5056,16126
2009-07-10,BATS (Z),369205807,211401833,209153858,789761498,7651872151.29,7852226897.26,3791019345.24,19295118393.8,2448642,960890,1224551,4634083
2009-07-13,AMEX (A),0,9915636,0,9915636,0.0,41622744.81,0.0,41622744.81,0,20571,0,20571
2009-07-13,BEX (B),105146784,29405664,37103540,171655988,1768830131.85,1026759270.54,791319917.66,3586909320.05,566937,111720,193726,872383
2009-07-13,NSX (C),18737814,12075671,13024407,43837892,445867222.928,331493251.397,150134546.816,927495021.142,115772,26743,47901,190416
2009-07-13,NYSE (DN),15899307,2765268,11068942,29733517,349075740.923,103220776.159,217078608.573,669375125.654,44703,5006,29580,79289
2009-07-13,NASDAQ (DQ),1567052577,547644772,687199740,2801897089,26803344009.7,17800884836.5,11944052706.4,56548281552.6,3803561,1061003,1687235,6551799
2009-07-13,ADF (D),34175200,4210000,13834700,52219900,761814146.64,147452034.5,295775870.44,1205042051.58,129333,11189,57777,198299
2009-07-13,ISE (I),88827686,21775940,33539364,144142990,1504667384.23,747281493.44,539559274.244,2791508151.91,324205,66292,115919,506416
2009-07-13,CHX (M),15599820,12169125,4376490,32145435,282696846.546,949998756.76,65852980.385,1298548583.69,7674,4861,4464,16999
2009-07-13,NYSE (N),1189460458,0,0,1189460458,25751234048.6,0.0,0.0,25751234048.6,3493085,0,0,3493085
2009-07-13,NYSE Arca (P),617293885,361219823,242388724,1220902432,13687211004.8,13992935593.4,5377192632.53,33057339230.7,3365343,1195380,1274455,5835178
2009-07-13,NASDAQ (Q),739329528,371315045,672765513,1783410086,16365855396.8,15709552478.8,14506074240.2,46581482115.8,3947318,1316781,2773643,8037742
2009-07-13,CBOE (W),4535800,4222400,1150200,9908400,69982945.0,230085662.0,30244625.5,330313232.5,4933,6347,4639,15919
2009-07-13,BATS (Z),454459867,270376343,242242609,967078819,9235497576.06,9572431739.17,4721546237.57,23529475552.8,2838510,1155939,1394073,5388522
2009-07-14,AMEX (A),0,10256060,0,10256060,0.0,47308712.08,0.0,47308712.08,0,21322,0,21322
2009-07-14,BEX (B),99217538,25584396,35210693,160012627,1816308635.38,955520069.11,753419403.29,3525248107.78,552375,110861,192023,855259
2009-07-14,NSX (C),16312286,7550622,17400808,41263716,352510956.89,198499483.337,134349861.241,685360301.469,99317,17063,44710,161090
2009-07-14,NYSE (DN),13549255,2256256,10822151,26627662,299297899.749,78897120.5278,180349313.487,558544333.764,39466,4102,26469,70037
2009-07-14,NASDAQ (DQ),1412159172,432204355,685511457,2529874984,24527499481.5,14533026285.8,10959094894.9,50019620662.2,3660449,853385,1627645,6141479
2009-07-14,ADF (D),29492070,2925700,13506200,45923970,656465090.8,116863389.73,252308362.31,1025636842.84,111101,8268,51202,170571
2009-07-14,ISE (I),82359122,16867349,37885255,137111726,1377366001.81,558974154.156,475549608.187,2411889764.15,302936,51750,112414,467100
2009-07-14,CHX (M),21981597,12075332,6637556,40694485,323697118.291,849264709.07,120713713.904,1293675541.27,6647,3876,3686,14209
2009-07-14,NYSE (N),978936124,1000,113000,979050124,21249041687.9,10193.5,1324415.0,21250376296.4,3258439,5,271,3258715
2009-07-14,NYSE Arca (P),581291705,315185179,253721027,1150197911,13468690036.7,12018044751.2,5220578265.45,30707313053.4,3236750,1121749,1263175,5621674
2009-07-14,NASDAQ (Q),673764091,310429365,631492903,1615686359,15269422992.9,13161092476.5,12968837675.9,41399353145.3,3720676,1174915,2590406,7485997
2009-07-14,CBOE (W),3512600,5068700,1698100,10279400,80663954.04,325797767.0,47955641.5,454417362.54,6905,5870,3984,16759
2009-07-14,BATS (Z),403068889,225288851,223694256,852051996,8269029816.23,7678516230.53,4110927531.48,20058473578.2,2589726,989297,1265910,4844933
2009-07-15,AMEX (A),0,14956110,0,14956110,0.0,61763091.33,0.0,61763091.33,0,23903,0,23903
2009-07-15,BEX (B),137766770,33903290,46786975,218457035,2494650568.45,1290189221.73,1061729737.97,4846569528.15,687408,119064,238475,1044947
2009-07-15,NSX (C),27615856,11283325,25063895,63963076,595986965.622,280998049.857,299117719.018,1176102734.5,170682,23204,102983,296869
2009-07-15,NYSE (DN),19760494,4010638,16176976,39948108,455810918.581,144497614.852,282652844.187,882961377.619,54844,6815,38644,100303
2009-07-15,NASDAQ (DQ),1915138634,615390200,976584330,3507113164,34554899498.1,20061283016.4,16835936526.2,71452119040.7,4528522,1156401,2114804,7799727
2009-07-15,ADF (D),39608130,4505700,18510400,62624230,856183248.84,179506138.56,363555977.06,1399245364.46,144521,11197,70154,225872
2009-07-15,ISE (I),119667252,28883266,55788802,204339320,2104752352.71,873553783.46,860431748.074,3838737884.25,444697,76121,175807,696625
2009-07-15,CHX (M),22600287,14913205,8016296,45529788,411260864.874,876587295.96,179673731.73,1467521892.56,10986,4675,5188,20849
2009-07-15,NYSE (N),1374281716,0,58100,1374339816,30593893170.3,0.0,876486.5,30594769656.8,3741333,0,127,3741460
2009-07-15,NYSE Arca (P),661802235,399262958,302393026,1363458219,15006355398.6,16101627941.9,6547722492.0,37655705832.5,3275999,1080503,1352311,5708813
2009-07-15,NASDAQ (Q),776381080,396771247,847905308,2021057635,18105471993.9,17243454763.3,18044422919.2,53393349676.5,4023368,1239810,3127247,8390425
2009-07-15,CBOE (W),8665200,3249500,4642500,16557200,127088385.83,191793002.1,152215162.65,471096550.58,8343,4968,5922,19233
2009-07-15,BATS (Z),478955844,293054616,303094429,1075104889,10015202826.7,10250709727.9,5882363526.21,26148276080.7,2772739,1058666,1534038,5365443
2009-07-16,AMEX (A),0,10156866,0,10156866,0.0,36074671.91,0.0,36074671.91,0,19454,0,19454
2009-07-16,BEX (B),119586599,25229129,37347201,182162929,2297999732.53,967157113.44,887131774.62,4152288620.59,631390,103558,204297,939245
2009-07-16,NSX (C),50639309,8847410,16904552,76391271,508724144.137,234594630.579,195292009.503,938610784.219,138981,18586,64359,221926
2009-07-16,NYSE (DN),16646176,3067404,13152982,32866562,388356804.926,122027961.985,249145677.822,759530444.733,47317,4669,29839,81825
2009-07-16,NASDAQ (DQ),1729613550,483430786,777127515,2990171851,28983887919.5,16851344110.8,13842551112.2,59677783142.4,3939499,994331,1855732,6789562
2009-07-16,ADF (D),34914070,3904920,13451010,52270000,836029625.02,172477162.17,281718334.02,1290225121.21,129087,8496,50475,188058
2009-07-16,ISE (I),112041279,18994466,37493555,168529300,1615109530.67,628903226.458,600446286.519,2844459043.65,359724,58029,130690,548443
2009-07-16,CHX (M),29045192,14789547,6614379,50449118,368169800.828,991156813.63,141028065.6,1500354680.06,9147,5340,4700,19187
2009-07-16,NYSE (N),1175782004,0,37100,1175819104,24786697410.8,0.0,542934.5,24787240345.3,3469832,0,104,3469936
2009-07-16,NYSE Arca (P),643416255,292939722,255824957,1192180934,13715268429.9,12764622588.9,6168445666.27,32648336685.0,3027098,882663,1219558,5129319
2009-07-16,NASDAQ (Q),773401186,326216235,703027247,1802644668,17027068341.1,15474783243.4,15909253531.7,48411105116.2,3905462,1108872,2842808,7857142
2009-07-16,CBOE (W),8910500,5224100,2158700,16293300,129668904.39,270571544.5,75276737.5,475517186.39,12087,4674,7909,24670
2009-07-16,BATS (Z),444650283,233106482,255243601,933000366,9000889514.13,8868977773.71,5015970361.88,22885837649.7,2643968,913013,1394089,4951070
2009-07-17,AMEX (A),0,9907055,0,9907055,0.0,43508496.23,0.0,43508496.23,0,17656,0,17656
2009-07-17,BEX (B),104458320,24075622,33450867,161984809,1948980800.49,923120598.74,806230612.833,3678332012.06,547100,94640,177241,818981
2009-07-17,NSX (C),46946370,8363410,14719294,70029074,496195662.996,232819845.673,191631956.197,920647464.867,123014,19781,48314,191109
2009-07-17,NYSE (DN),17804911,2424418,11706981,31936310,357068889.151,84140605.7489,238810846.971,680020341.871,41928,4063,26393,72384
2009-07-17,NASDAQ (DQ),1660091708,429704662,685100031,2774896401,26570811926.7,13743593064.7,12486972495.9,52801377487.3,3744732,871152,1698650,6314534
2009-07-17,ADF (D),30822250,2817500,11477500,45117250,679227169.97,117376075.19,247813069.48,1044416314.64,108771,6868,43588,159227
2009-07-17,ISE (I),113037526,17808019,36963640,167809185,1543196849.34,585343106.22,638334012.241,2766873967.8,319889,55347,126787,502023
2009-07-17,CHX (M),35318698,9233243,7347051,51898992,355598915.443,554456658.11,100577715.835,1010633289.39,10669,3249,4348,18266
2009-07-17,NYSE (N),1290375718,100,57200,1290433018,28459729565.9,1228.5,617791.5,28460348585.9,3189077,1,92,3189170
2009-07-17,NYSE Arca (P),663823259,276115884,232210187,1172149330,13484840992.2,10594346461.3,5919106483.96,29998293937.4,3065752,892316,1147974,5106042
2009-07-17,NASDAQ (Q),744694214,276056734,664271109,1685022057,15542264774.5,12163532831.0,15293838810.3,42999636415.8,3526204,959171,2420322,6905697
2009-07-17,CBOE (W),7308800,4155900,2101700,13566400,113384043.09,224689332.54,72475173.6,410548549.23,12156,7131,7712,26999
2009-07-17,BATS (Z),434289950,191192421,214974796,840457167,8501096279.05,7057834309.62,4288205271.15,19847135859.8,2462514,809931,1206416,4478861
2009-07-20,AMEX (A),0,11743193,0,11743193,0.0,50647535.54,0.0,50647535.54,0,20710,0,20710
2009-07-20,BEX (B),134741035,26482980,44162461,205386476,2271801029.65,1015817221.41,873944004.69,4161562255.75,643908,113311,204664,961883
2009-07-20,NSX (C),17353894,10567012,16172514,44093420,382373800.324,294642149.211,143509546.587,820525496.122,93807,23189,42844,159840
2009-07-20,NYSE (DN),18329220,3323119,12664866,34317205,465740586.169,123871324.411,261438876.587,851050787.167,51268,5494,33570,90332
2009-07-20,NASDAQ (DQ),1755692805,498327588,778779190,3032799583,29344969179.8,16131943146.7,13929247151.4,59406159477.9,4047045,978718,1944890,6970653
2009-07-20,ADF (D),30333270,2184000,12079100,44596370,656985420.11,67619813.3,287503414.39,1012108647.8,108972,5614,48723,163309
2009-07-20,ISE (I),106119528,19419296,48578729,174117553,1807179861.94,645510744.04,717390813.61,3170081419.59,368354,61329,150911,580594
2009-07-20,CHX (M),18897494,14614532,5313411,38825437,387438567.466,836286196.775,110238789.695,1333963553.94,6896,4331,4172,15399
2009-07-20,NYSE (N),1126863356,300,28900,1126892556,24111565241.3,2923.5,326962.0,24111895126.8,3272267,1,105,3272373
2009-07-20,NYSE Arca (P),665692624,312148289,261844321,1239685234,14197861927.0,13717937890.1,6159962125.93,34075761943.1,3297174,1025818,1359765,5682757
2009-07-20,NASDAQ (Q),732261709,304249325,655952597,1692463631,16256931354.2,13803816123.7,14729994848.7,44790742326.7,3782889,1096115,2773769,7652773
2009-07-20,CBOE (W),9908500,5634900,2840300,18383700,180638334.01,258916273.0,81042787.6,520597394.61,10263,7369,6891,24523
2009-07-20,BATS (Z),467833628,219009800,241615758,928459186,9381649947.12,8088185163.81,4735923786.98,22205758897.9,2801880,968790,1415358,5186028
2009-07-21,AMEX (A),0,13238047,0,13238047,0.0,58119290.98,0.0,58119290.98,0,24092,0,24092
2009-07-21,BEX (B),135583560,30261838,45748058,211593456,2361791514.19,1204771716.19,929172948.545,4495736178.92,718589,133831,234388,1086808
2009-07-21,NSX (C),24071953,12424933,14401263,50898149,403372090.916,317522134.467,140144968.615,861039193.998,102545,25640,44304,172489
2009-07-21,NYSE (DN),20099882,3305176,14596207,38001265,495353958.729,116525549.038,284687150.684,896566658.451,52428,5546,33186,91160
2009-07-21,NASDAQ (DQ),1795686606,543249113,880609709,3219545428,31551303319.4,18698657917.2,15957178070.5,66207139307.0,4316419,1096232,2117574,7530225
2009-07-21,ADF (D),32948330,3295600,15070400,51314330,754751251.47,147616143.89,338025740.9,1240393136.26,122086,7116,53440,182642
2009-07-21,ISE (I),115219189,22374031,51056976,188650196,1911980458.84,706931619.581,836396560.168,3455308638.59,408649,66836,169238,644723
2009-07-21,CHX (M),22017752,16355650,9040295,47413697,383400260.989,1190010634.46,180271786.332,1753682681.78,9227,4211,5521,18959
2009-07-21,NYSE (N),1207239084,0,46000,1207285084,25666336480.6,0.0,556235.0,25666892715.6,3601528,0,112,3601640
2009-07-21,NYSE Arca (P),694622773,357064983,297970468,1349658224,15551904110.5,14849861739.2,7204535190.81,37606301040.5,3588460,1165942,1508247,6262649
2009-07-21,NASDAQ (Q),778259303,335519690,699116966,1812895959,17689560622.1,15885736572.9,15978138076.0,49553435271.0,4082314,1212516,2924851,8219681
2009-07-21,CBOE (W),15767200,6546000,2715000,25028200,183962102.48,357033532.52,80504801.47,621500436.47,14207,9325,7701,31233
2009-07-21,BATS (Z),476434963,236433890,255273332,968142185,9686633297.71,8602727245.36,5012810702.3,23302171245.4,2897910,1008878,1469860,5376648
2009-07-22,AMEX (A),0,14775522,0,14775522,0.0,59893282.52,0.0,59893282.52,0,23722,0,23722
2009-07-22,BEX (B),120910976,29066269,42854277,192831522,2351733598.97,1195137316.64,991327829.44,4538198745.05,685213,132475,227797,1045485
2009-07-22,NSX (C),18949198,13763923,12241998,44955119,357402526.499,333080229.579,142353198.683,832835954.761,92573,25116,44724,162413
2009-07-22,NYSE (DN),21745789,4235450,14331505,40312744,524099929.394,139718095.286,296705027.023,960523051.703,55723,5996,33205,94924
2009-07-22,NASDAQ (DQ),1591110005,491715127,951587701,3034412833,30014168191.7,16062059674.9,17094091187.8,63170319054.4,4015546,1000816,2139847,7156209
2009-07-22,ADF (D),32458350,2891400,14252700,49602450,768834390.73,130862335.0,303107250.45,1202803976.18,126110,5576,57652,189338
2009-07-22,ISE (I),101814076,21798503,49805385,173417964,1824047826.12,646059250.903,882366949.559,3352474026.58,377968,63393,169462,610823
2009-07-22,CHX (M),19911630,9861726,6808973,36582329,477535095.279,746184127.36,137388668.63,1361107891.27,9045,3447,5443,17935
2009-07-22,NYSE (N),1079660326,0,48800,1079709126,23933841332.7,0.0,781720.0,23934623052.7,3423936,0,120,3424056
2009-07-22,NYSE Arca (P),659873359,306076239,299672430,1265622028,15121150845.4,12643586007.7,7527101222.6,35291838075.6,3518268,1078661,1535076,6132005
2009-07-22,NASDAQ (Q),735007109,337799864,718835431,1791642404,17113618156.2,16182769183.6,16901011198.2,50197398538.0,3969312,1190875,3068375,8228562
2009-07-22,CBOE (W),5094200,7470200,10650800,23215200,102511592.06,531632350.8,280991484.0,915135426.86,8419,6286,6301,21006
2009-07-22,BATS (Z),452777864,228841096,262894375,944513335,9639596187.22,8489685818.03,5294737495.6,23424019500.8,2861406,981116,1519464,5361986
2009-07-23,AMEX (A),0,12928518,0,12928518,0.0,57626243.7,0.0,57626243.7,0,25037,0,25037
2009-07-23,BEX (B),151822434,33491466,57855006,243168906,2919855405.69,1295293133.36,1244554988.61,5459703527.67,815829,133708,276147,1225684
2009-07-23,NSX (C),26527356,15587947,16731170,58846473,485306780.393,398705631.833,176943512.815,1060955925.04,116412,31180,52571,200163
2009-07-23,NYSE (DN),24665101,3835813,18418030,46918944,611440514.923,141177010.268,381168839.793,1133786364.98,69758,6206,45555,121519
2009-07-23,NASDAQ (DQ),2057872606,661569895,1304505055,4023947556,39939627670.3,22479023573.3,22757096250.3,85175747493.8,5082259,1260014,2679296,9021569
2009-07-23,ADF (D),43604010,3982800,21536700,69123510,1096602296.99,157708366.23,487622321.45,1741932984.67,165758,9757,78574,254089
2009-07-23,ISE (I),137150048,27920568,68023782,233094398,2526017137.78,891687355.479,1083570568.31,4501275061.57,511719,73031,207966,792716
2009-07-23,CHX (M),25186532,13294292,12954206,51435030,535258849.126,815150635.99,373294641.334,1723704126.45,7576,4277,5547,17400
2009-07-23,NYSE (N),1396574299,900,74200,1396649399,32409496095.5,990.0,1068552.0,32410565637.5,4198407,1,205,4198613
2009-07-23,NYSE Arca (P),790907176,417780277,414615340,1623302793,19415039909.8,17331964751.1,9460887930.81,46207892591.7,4210403,1282787,1892183,7385373
2009-07-23,NASDAQ (Q),866434199,404249391,921650754,2192334344,21063236039.0,19958968604.3,20393979857.1,61416184500.4,4569398,1277852,3564564,9411814
2009-07-23,CBOE (W),16520700,4703200,5006300,26230200,172107277.66,246160057.0,139477381.74,557744716.4,9093,7277,7640,24010
2009-07-23,BATS (Z),536221136,302531448,361111304,1199863888,12000268310.2,11487115466.2,7100704355.56,30588088132.0,3329635,1148315,1906538,6384488
2009-07-24,AMEX (A),0,10642289,0,10642289,0.0,44670929.95,0.0,44670929.95,0,21321,0,21321
2009-07-24,BEX (B),124083781,24952929,47267455,196304165,2372393603.3,1083157845.96,1012963116.68,4468514565.94,677055,113387,224579,1015021
2009-07-24,NSX (C),24551560,9917094,15002665,49471319,348424546.754,245637177.095,139125540.216,733187264.065,88958,19329,43703,151990
2009-07-24,NYSE (DN),19373081,2781898,12425579,34580558,482182734.425,109054335.884,281960225.801,873197296.109,49209,4269,29258,82736
2009-07-24,NASDAQ (DQ),1535131619,409797344,876631374,2821560337,28496077602.5,14367397289.4,16705381902.8,59568856794.7,3714365,849922,1966034,6530321
2009-07-24,ADF (D),30779750,2222203,13909800,46911753,726594890.32,96688917.71,374564619.26,1197848427.29,116120,5021,49969,171110
2009-07-24,ISE (I),101898050,17616593,53675545,173190188,1834978684.67,552183939.087,926062620.133,3313225243.89,360780,49615,165673,576068
2009-07-24,CHX (M),24850382,7869815,8584911,41305108,416226863.562,562597924.8,154497179.197,1133321967.56,10263,2962,5447,18672
2009-07-24,NYSE (N),1024071861,0,29300,1024101161,22439743873.1,0.0,736112.5,22440479985.6,3128836,0,82,3128918
2009-07-24,NYSE Arca (P),543016265,242378322,293916213,1079310800,13204045187.0,9888055226.67,7124269983.97,30216370397.7,3095293,862319,1437777,5395389
2009-07-24,NASDAQ (Q),631656696,246054628,676804279,1554515603,15307528144.1,12006688917.7,15662595491.0,42976812552.8,3473489,907030,2797142,7177661
2009-07-24,CBOE (W),6794600,5598900,1631700,14025200,105403072.6,322454618.0,45768178.5,473625869.1,5217,3230,5257,13704
2009-07-24,BATS (Z),397244781,181742595,261180370,840167746,8989346247.66,7327010847.64,5231820504.82,21548177600.1,2581221,787018,1436152,4804391
2009-07-27,AMEX (A),0,12528554,0,12528554,0.0,48205243.69,0.0,48205243.69,0,22673,0,22673
2009-07-27,BEX (B),119379637,27094503,32568116,179042256,2193853175.03,1081836413.27,666833948.342,3942523536.64,615971,113130,156527,885628
2009-07-27,NSX (C),20378020,11730088,13594472,45702580,378082209.522,267415810.259,156297360.088,801795379.869,97689,21918,47266,166873
2009-07-27,NYSE (DN),18159157,2893250,13467312,34519719,425319151.19,105134445.069,268190660.251,798644256.51,50531,4343,32100,86974
2009-07-27,NASDAQ (DQ),1667418884,415610175,851785701,2934814760,26963136877.7,13471981204.9,13834411964.7,54269530047.4,3686463,831495,1932173,6450131
2009-07-27,ADF (D),32734960,2473900,13425460,48634320,735078413.05,100891072.37,263723099.26,1099692584.68,119194,5800,46832,171826
2009-07-27,ISE (I),118109830,18896399,58500215,195506444,1820651058.75,565430854.305,806921394.67,3193003307.73,365675,56385,172032,594092
2009-07-27,CHX (M),17892885,10701948,9481795,38076628,347478737.666,667371680.983,150243940.7,1165094359.35,8396,3360,5934,17690
2009-07-27,NYSE (N),1043441363,200,43800,1043485363,22092549525.6,3171.5,546322.5,22093099019.6,3064008,2,97,3064107
2009-07-27,NYSE Arca (P),621405708,270058844,285504808,1176969360,12846356613.4,11162453409.8,6274437952.31,30283247975.5,3099792,904738,1429313,5433843
2009-07-27,NASDAQ (Q),720157556,275106436,655638282,1650902274,15736264830.3,13245388704.7,14045178400.4,43026831935.4,3590610,959280,2706372,7256262
2009-07-27,CBOE (W),3536900,3124100,1480800,8141800,76796416.0,114183767.0,45648745.0,236628928.0,4279,4674,4200,13153
2009-07-27,BATS (Z),403377126,165843831,232821928,802042885,8246583410.77,6250502231.79,4298680331.88,18795765974.4,2377251,713952,1276712,4367915
2009-07-28,AMEX (A),0,13320051,0,13320051,0.0,53074293.74,0.0,53074293.74,0,23906,0,23906
2009-07-28,BEX (B),133318167,26692341,39477491,199487999,2264988672.68,1095506712.43,890511980.13,4251007365.24,651560,120182,211202,982944
2009-07-28,NSX (C),28528857,11158691,15920148,55607696,580902709.979,268669098.732,243784666.471,1093356475.18,137814,23205,57958,218977
2009-07-28,NYSE (DN),17703582,2717405,12828628,33249615,404139788.595,117786779.543,261143813.237,783070381.375,45887,4044,31696,81627
2009-07-28,NASDAQ (DQ),2071300601,467847405,887155170,3426303176,31709605153.5,15775201373.3,15226935596.3,62711742123.1,4174293,942428,2136742,7253463
2009-07-28,ISE (I),140095168,18875556,53953001,212923725,2012787142.51,634961895.096,806657125.111,3454406162.72,405130,57954,173056,636140
2009-07-28,CHX (M),20367916,9980683,9732727,40081326,419641012.658,756266567.105,119190612.143,1295098191.91,9407,3838,5758,19003
2009-07-28,NYSE (N),1242595220,1600,46800,1242643620,25104040090.2,9306.0,695643.5,25104745039.7,3509941,5,174,3510120
2009-07-28,NYSE Arca (P),725018120,298589667,313142779,1336750566,15065896674.3,12965311357.8,6925699590.31,34956907622.4,3521891,1018520,1557078,6097489
2009-07-28,NASDAQ (Q),827186330,303389552,660469432,1791045314,17424977908.1,15691336732.9,14501156261.0,47617470902.0,3846813,1059223,2767554,7673590
2009-07-28,CBOE (W),4329200,4720200,1594400,10643800,102094185.16,319556112.82,41252250.0,462902547.98,5931,5469,5320,16720
2009-07-28,BATS (Z),474565194,185980753,244932079,905478026,9359965805.7,7323249184.08,4853536805.37,21536751795.2,2620666,783016,1357801,4761483
2009-07-29,AMEX (A),0,17772070,0,17772070,0.0,65737757.39,0.0,65737757.39,0,26284,0,26284
2009-07-29,BEX (B),126914298,26398657,33569554,186882509,2251867823.44,995203739.74,721279271.683,3968350834.86,630653,106656,179986,917295
2009-07-29,NSX (C),16901547,12925646,12393914,42221107,324170506.77,275171911.391,122173277.389,721515695.55,87267,23086,44185,154538
2009-07-29,NYSE (DN),18870571,3173207,13740484,35784262,426605894.718,129820703.592,271495327.023,827921925.334,49964,4224,31609,85797
2009-07-29,NASDAQ (DQ),2074408473,516279684,841281015,3431969172,31915041810.4,16560141704.5,14563978936.0,63039162450.8,4235500,948435,2003695,7187630
2009-07-29,ISE (I),118706467,22515064,48857166,190078697,1944943805.77,669805997.565,777361133.653,3392110936.99,392873,62470,161809,617152
2009-07-29,CHX (M),13333305,14251259,7086973,34671537,319191502.731,908373071.845,165712363.179,1393276937.75,7689,5115,5647,18451
2009-07-29,NYSE (N),1252722960,0,18700,1252741660,24632852646.6,0.0,367703.0,24633220349.6,3349161,0,80,3349241
2009-07-29,NYSE Arca (P),722689613,317275873,298708328,1338673814,14996530626.1,12869397431.5,6680712432.41,34546640490.0,3481189,974552,1469747,5925488
2009-07-29,NASDAQ (Q),770324527,320525912,628889505,1719739944,16857068074.0,15609107142.9,13578625112.2,46044800329.1,3718189,1052603,2629993,7400785
2009-07-29,CBOE (W),5537600,4147600,1636200,11321400,95117206.48,265971999.12,52818617.0,413907822.6,6262,4447,4868,15577
2009-07-29,BATS (Z),470855603,194074879,228790759,893721241,9376669921.73,7261050891.88,4597923372.38,21235644186.0,2631089,762552,1297912,4691553
2009-07-30,AMEX (A),0,23448976,0,23448976,0.0,91087489.33,0.0,91087489.33,0,30969,0,30969
2009-07-30,BEX (B),148603068,30057308,41606636,220267012,2518021373.91,1178954360.31,920369243.992,4617344978.21,698623,120797,222968,1042388
2009-07-30,NSX (C),25248735,14194700,13474457,52917892,419887959.612,290502595.021,196142115.832,906532670.464,106810,26252,50133,183195
2009-07-30,NYSE (DN),19895552,3449995,16258910,39604457,481360837.476,135723706.632,321132595.001,938217139.11,52720,5067,36394,94181
2009-07-30,NASDAQ (DQ),2283886252,616109712,1009332644,3909328608,37393534453.3,19195135310.9,17163371922.1,73752041686.4,4683492,1099502,2345329,8128323
2009-07-30,ISE (I),150089124,27116431,59039993,236245548,2449772072.42,772911498.773,904032441.025,4126716012.22,452263,71547,192488,716298
2009-07-30,CHX (M),22544192,11542982,9108935,43196109,463891126.512,838589641.421,194655899.415,1497136667.35,10888,4438,7233,22559
2009-07-30,NYSE (N),1357955832,100,29200,1357985132,29026091442.8,394.0,374609.0,29026466445.8,3872797,1,71,3872869
2009-07-30,NYSE Arca (P),810070433,413230373,367053558,1590354364,17575656399.9,16832562914.6,8255791917.24,42664011231.7,3936348,1170664,1777575,6884587
2009-07-30,NASDAQ (Q),941789840,387483976,776708457,2105982273,20352725913.3,18407663522.5,17047843983.6,55808233419.3,4385891,1219355,3168732,8773978
2009-07-30,CBOE (W),20840100,5024600,2623000,28487700,174007523.36,354448056.5,86631628.0,615087207.86,7936,6201,6293,20430
2009-07-30,BATS (Z),542651742,232746764,277959587,1053358093,10826111010.1,8815941860.24,5330512387.1,24972565257.4,3031773,892271,1548103,5472147
2009-07-31,AMEX (A),0,22648633,0,22648633,0.0,80034627.73,0.0,80034627.73,0,29372,0,29372
2009-07-31,BEX (B),151684667,27329275,35104638,214118580,2245279637.71,1130703101.77,738576100.545,4114558840.03,629703,119213,185729,934645
2009-07-31,NSX (C),25347897,13944986,18647711,57940594,577525205.014,284578782.359,283519258.858,1145623246.23,133057,24277,58746,216080
2009-07-31,NYSE (DN),15316300,2913538,12933872,31163710,395563934.014,123433139.4,259440141.546,778437214.96,39808,4228,30983,75019
2009-07-31,NASDAQ (DQ),2052701048,533688984,925110035,3511500067,32081786698.7,17596770136.2,14438306746.7,64116863581.6,4210577,937987,2003688,7152252
2009-07-31,ISE (I),116788958,24119541,54070947,194979446,1935294730.96,745323129.63,712279733.345,3392897593.93,360559,61010,160741,582310
2009-07-31,CHX (M),17476779,17637674,7493789,42608242,467989006.89,1213402859.79,122781900.122,1804173766.81,8563,4459,5035,18057
2009-07-31,NYSE (N),1515344023,0,19000,1515363023,30742998944.6,0.0,321925.0,30743320869.6,3459268,0,55,3459323
2009-07-31,NYSE Arca (P),682525492,351801337,285886349,1320213178,14806192185.0,14642386629.8,6260886603.03,35709465417.8,3379037,1041090,1423446,5843573
2009-07-31,NASDAQ (Q),768712190,339139448,731745318,1839596956,17264232787.0,16560349581.7,14914861731.8,48739444100.5,3788872,1121965,2641405,7552242
2009-07-31,CBOE (W),5708700,4755800,1779900,12244400,79015051.25,292540114.84,51755245.75,423310411.84,6469,6097,6511,19077
2009-07-31,BATS (Z),473803923,202527623,224733300,901064846,9501947025.38,7482233146.81,4286391781.02,21270571953.2,2619479,802034,1287515,4709028
2009-08-03,AMEX (A),0,17480429,0,17480429,0.0,68425707.63,0.0,68425707.63,0,28433,0,28433
2009-08-03,BEX (B),162401025,29932258,39222447,231555730,2646541810.83,1109774431.44,844616382.543,4600932624.82,708688,117640,205787,1032115
2009-08-03,NSX (C),28362187,14017733,18881836,61261756,548202173.996,333519269.076,289809579.549,1171531022.62,137228,25536,66074,228838
2009-08-03,NYSE (DN),22060483,3219237,14645952,39925672,534197104.67,115569215.245,265442792.572,915209112.487,59479,4706,37178,101363
2009-08-03,NASDAQ (DQ),2099531476,502390164,858661565,3460583205,35629316243.5,15889090563.1,14149203416.9,65667610223.5,4828855,995007,2163130,7986992
2009-08-03,ADF (D),18625310,1923700,7309920,27858930,422739768.16,63406818.0,127207028.86,613353615.02,67984,4417,30431,102832
2009-08-03,ISE (I),123538202,24011455,51957942,199507599,2131924447.44,755481786.321,744244948.994,3631651182.75,422529,63169,173198,658896
2009-08-03,CHX (M),24411210,12441487,7148114,44000811,376667965.354,936595942.56,99495640.1658,1412759548.08,11206,4426,5916,21548
2009-08-03,NYSE (N),1214171019,0,32100,1214203119,27707613335.2,0.0,459954.5,27708073289.7,3620179,0,93,3620272
2009-08-03,NYSE Arca (P),762933090,354998728,290676953,1408608771,16973147131.3,14205068472.7,6416929933.43,37595145537.4,3720526,1061708,1483057,6265291
2009-08-03,NASDAQ (Q),798742485,333920068,665703698,1798366251,18422263212.5,15959465283.0,14435140781.3,48816869276.9,3936027,1109213,2796165,7841405
2009-08-03,CBOE (W),6226800,3593800,3274700,13095300,136338123.21,248686244.6,103642697.74,488667065.55,6337,4931,6400,17668
2009-08-03,BATS (Z),555224322,205321174,240850310,1001395806,11110701316.5,7563827304.07,4714212492.91,23388741113.5,3023267,813905,1410819,5247991
2009-08-04,AMEX (A),0,16550986,0,16550986,0.0,58459700.69,0.0,58459700.69,0,27279,0,27279
2009-08-04,BEX (B),169736749,28319027,39374150,237429926,2667121035.86,1150890921.2,845367377.72,4663379334.78,727290,121142,211170,1059602
2009-08-04,NSX (C),24681156,13159924,28590268,66431348,483207523.996,345394181.23,281507763.933,1110109469.16,123996,27073,62058,213127
2009-08-04,NYSE (DN),17257321,2809167,12538148,32604636,410837118.615,116692541.837,226920030.447,754449690.899,45947,4795,28274,79016
2009-08-04,NASDAQ (DQ),2088308960,526301492,931976070,3546586522,35767188271.1,16711185996.2,15466179569.0,67944553836.3,4693422,993948,2172379,7859749
2009-08-04,ADF (D),47724100,2895400,16158100,66777600,894393735.96,125565361.5,294687535.25,1314646632.71,150831,7287,65736,223854
2009-08-04,ISE (I),115952960,24315255,55946296,196214511,2136085747.37,778355369.401,800069199.799,3714510316.57,428463,68046,177778,674287
2009-08-04,CHX (M),17671936,11603417,12827837,42103190,432875612.068,906770078.0,221408198.665,1561053888.73,10732,4549,6282,21563
2009-08-04,NYSE (N),1249554627,0,40800,1249595427,27994291171.3,0.0,709605.5,27995000776.8,3737455,0,154,3737609
2009-08-04,NYSE Arca (P),811468716,322770856,294391579,1428631151,17312967738.1,13520165257.1,6324978860.86,37158111856.1,3847609,1096769,1491620,6435998
2009-08-04,NASDAQ (Q),814684960,308683464,656673033,1780041457,18427283526.7,14914842240.1,14013681883.2,47355807650.0,4084644,1099673,2766359,7950676
2009-08-04,CBOE (W),4410300,3815200,1507000,9732500,153523869.0,268306818.8,46354335.96,468185023.76,7605,5462,6591,19658
2009-08-04,BATS (Z),554217304,206391804,247421490,1008030598,11043439853.6,7913692052.67,4815726826.73,23772858733.0,3093793,884436,1432437,5410666
2009-08-05,AMEX (A),0,19700859,0,19700859,0.0,72362204.54,0.0,72362204.54,0,26158,0,26158
2009-08-05,BEX (B),213077393,30827443,40738862,284643698,2936547153.43,1164813148.25,898655247.141,5000015548.82,755501,121812,220477,1097790
2009-08-05,NSX (C),40073229,17213898,26481225,83768352,580579696.508,421426651.147,344579930.655,1346586278.31,131462,29753,63920,225135
2009-08-05,NYSE (DN),22612419,3964112,12985503,39562034,472723434.517,148255709.775,245434100.181,866413244.472,52550,4651,31293,88494
2009-08-05,NASDAQ (DQ),3289762959,578951158,955382366,4824096483,41639743547.6,17571751603.2,15236463594.8,74447958745.5,5073185,1029739,2241193,8344117
2009-08-05,ADF (D),63535370,6981320,16948280,87464970,1106231345.54,181795485.29,369828395.89,1657855226.72,179974,11712,69899,261585
2009-08-05,ISE (I),172716170,28293827,67226248,268236245,2445724531.99,836386801.422,899466959.078,4181578292.49,487459,72125,200586,760170
2009-08-05,CHX (M),39013719,14567362,11254635,64835716,460088331.354,1146924577.85,142547117.35,1749560026.55,12679,4042,6153,22874
2009-08-05,NYSE (N),1881225974,0,50700,1881276674,30302924247.4,0.0,888044.5,30303812291.9,3656101,0,127,3656228
2009-08-05,NYSE Arca (P),1035899157,357369504,323789075,1717057736,17685019149.2,14328072152.1,6785897216.05,38798988517.4,3855873,1099512,1552800,6508185
2009-08-05,NASDAQ (Q),953386221,345075438,718017877,2016479536,18668153939.5,15843408029.1,15189914543.6,49701476512.3,4100226,1118513,2860058,8078797
2009-08-05,CBOE (W),8106500,4138700,2248200,14493400,127999120.85,282755816.8,77114718.0,487869655.65,7087,5322,7310,19719
2009-08-05,BATS (Z),656985371,229180386,245231750,1131397507,11678250113.0,8302609817.13,4910825917.01,24891685847.2,3223217,889682,1433764,5546663
2009-08-06,AMEX (A),0,16703122,0,16703122,0.0,60342559.85,0.0,60342559.85,0,27612,0,27612
2009-08-06,BEX (B),199443722,35672979,38704590,273821291,2765089841.51,1254353369.4,845833600.464,4865276811.37,715334,124781,206111,1046226
2009-08-06,NSX (C),38970782,14706119,22162207,75839108,538675094.684,336579350.926,279455403.275,1154709848.88,130467,25495,57647,213609
2009-08-06,NYSE (DN),19630103,3424444,14270452,37324999,447343319.1,136034216.096,263464253.834,846841789.031,49003,5208,34301,88512
2009-08-06,NASDAQ (DQ),2522057564,644472601,944989385,4111519550,37268500490.5,20126693313.8,14706948332.9,72102142137.2,4773529,988786,2126225,7888540
2009-08-06,ADF (D),49259450,4528200,18095700,71883350,986739385.54,153576732.0,366157981.53,1506474099.07,166487,10149,72793,249429
2009-08-06,ISE (I),158206707,31764797,58890688,248862192,2362017866.89,849628830.565,769631596.389,3981278293.84,470535,74180,181650,726365
2009-08-06,CHX (M),26207801,14745881,10507863,51461545,435921011.73,1102761218.13,175683032.624,1714365262.49,12463,4145,5880,22488
2009-08-06,NYSE (N),1382385993,100,31100,1382417193,28178010389.0,478.0,465248.5,28178476115.5,3760175,1,87,3760263
2009-08-06,NYSE Arca (P),973732279,401801030,334264216,1709797525,18050502635.1,15561661627.7,6899365124.12,40511529386.9,4031071,1184392,1623444,6838907
2009-08-06,NASDAQ (Q),987448907,372036740,744433950,2103919597,20087348204.4,16336747208.0,15470217193.4,51894312605.9,4322578,1172319,2991084,8485981
2009-08-06,CBOE (W),2651500,7336300,3059800,13047600,63545417.9,407932576.2,54502117.3,525980111.4,5744,5080,6890,17714
2009-08-06,BATS (Z),642744333,250159239,266782995,1159686567,11819231371.4,8464036891.74,5229077686.35,25512345949.5,3316214,916201,1541009,5773424
2009-08-07,AMEX (A),0,16488359,0,16488359,0.0,76124433.43,0.0,76124433.43,0,24581,0,24581
2009-08-07,BEX (B),196752539,36638682,38579012,271970233,2583674383.91,1364551563.01,839949045.959,4788174992.88,672596,132080,208617,1013293
2009-08-07,NSX (C),28527633,13392559,14721922,56642114,382747622.215,343317145.93,184279649.582,910344417.727,104240,25394,49271,178905
2009-08-07,NYSE (DN),16733528,3455117,13789442,33978087,419334698.873,140818957.314,232975390.843,793129047.029,43622,4489,28725,76836
2009-08-07,NASDAQ (DQ),2708237241,637154298,1099049534,4444441073,37711722043.6,20224904767.0,14806662475.5,72743289286.1,4772258,1029506,2103936,7905700
2009-08-07,ADF (D),58925300,6044700,16392110,81362110,1018044864.52,232318443.0,288390201.62,1538753509.14,160084,13266,66479,239829
2009-08-07,ISE (I),169547020,30946683,62301510,262795213,2561779595.73,895668287.08,830347185.716,4287795068.53,483048,69802,185780,738630
2009-08-07,CHX (M),25916490,16254044,7789890,49960424,561695397.448,1182927220.86,91852876.6451,1836475494.95,17325,5542,6383,29250
2009-08-07,NYSE (N),1467908223,200,32200,1467940623,29838019872.4,2918.0,339198.0,29838361988.4,3763015,1,63,3763079
2009-08-07,NYSE Arca (P),996491130,406338512,309696946,1712526588,18456196670.5,16864956248.1,6548591375.43,41869744294.0,4007671,1183082,1576993,6767746
2009-08-07,NASDAQ (Q),929446044,385771656,694568987,2009786687,18211248409.1,17942469922.0,14542902322.9,50696620654.0,3931589,1211152,2824788,7967529
2009-08-07,CBOE (W),7224600,4001200,4077500,15303300,232978199.2,302076911.0,115330904.2,650386014.4,5435,4367,7286,17088
2009-08-07,BATS (Z),649439980,257429448,261172619,1168042047,11444602898.0,9339173736.15,4965321418.63,25749098052.7,3183721,927455,1519225,5630401
2009-08-10,AMEX (A),0,20650835,0,20650835,0.0,62417556.75,0.0,62417556.75,0,25619,0,25619
2009-08-10,BEX (B),147067167,25688729,31374580,204130476,2047663620.22,938478794.65,675647660.839,3661790075.71,533573,98593,163786,795952
2009-08-10,NSX (C),31504462,12332663,10816319,54653444,322643945.417,250106232.14,134660781.691,707410959.248,88693,22213,39982,150888
2009-08-10,NYSE (DN),14936778,2614012,10602274,28153064,320638963.194,90923627.8138,197579258.269,609141849.278,39125,3892,26718,69735
2009-08-10,NASDAQ (DQ),2212859502,477831465,750666412,3441357379,29330629225.8,14478917377.5,11880179441.2,55689726044.5,3934013,788643,1794544,6517200
2009-08-10,ADF (D),54277570,3738200,15068200,73083970,868628798.03,113717411.04,292601256.13,1274947465.2,168063,7971,67188,243222
2009-08-10,ISE (I),132707976,23567021,51409393,207684390,1831929161.16,623723616.233,655243115.457,3110895892.85,379039,57834,150980,587853
2009-08-10,CHX (M),22831367,10035538,9123980,41990885,374056978.891,706061179.6,126089534.895,1206207693.39,13899,3870,5081,22850
2009-08-10,NYSE (N),1086253986,200,32500,1086286686,22600087988.9,2885.5,546843.0,22600637717.4,3076491,2,92,3076585
2009-08-10,NYSE Arca (P),771867152,301503565,237845199,1311215916,13567117712.9,12007453821.6,5246889696.49,30821461231.0,3121835,915711,1249988,5287534
2009-08-10,NASDAQ (Q),686543366,271741266,555415756,1513700388,13649975082.2,12116336137.2,11538012612.8,37304323832.2,3144181,899324,2369320,6412825
2009-08-10,CBOE (W),2723500,3470900,1548400,7742800,65216375.5,210579469.38,41224558.63,317020403.51,4907,3482,5902,14291
2009-08-10,BATS (Z),464143412,179024776,212989876,856158064,8561155782.37,6612249478.26,4068792967.13,19242198227.8,2469512,721104,1233070,4423686
2009-08-11,AMEX (A),0,19025925,0,19025925,0.0,72682806.14,0.0,72682806.14,0,29190,0,29190
2009-08-11,BEX (B),166196704,32721774,32439054,231357532,2235166460.73,1175567199.24,704248355.575,4114982015.55,591066,121233,179821,892120
2009-08-11,NSX (C),27023270,12831324,11057274,50911868,360996800.891,311032569.081,142262636.611,814292006.583,91163,23616,44481,159260
2009-08-11,NYSE (DN),16689511,2880644,11669606,31239761,327133772.962,97734978.475,210456230.775,635324982.213,41379,4728,29111,75218
2009-08-11,NASDAQ (DQ),2371065906,504000909,757583564,3632650379,30576895266.0,15045540833.6,11717563407.2,57339999506.8,4038603,888418,1792627,6719648
2009-08-11,ADF (D),39534780,4760500,13111400,57406680,657260868.9,166937008.78,269447373.35,1093645251.03,119452,12151,58290,189893
2009-08-11,ISE (I),131382803,24504943,59911123,215798869,1974263498.53,684924876.259,872466338.313,3531654713.11,407205,64409,204430,676044
2009-08-11,CHX (M),15238960,8460550,9912178,33611688,308974341.245,617353646.11,150094991.053,1076422978.41,12861,3200,5678,21739
2009-08-11,NYSE (N),1198168792,0,19000,1198187792,24038682376.3,0.0,359742.0,24039042118.3,3147373,0,61,3147434
2009-08-11,NYSE Arca (P),792022032,332913176,254152809,1379088017,13930041735.6,13190526156.9,5450712360.36,32571280252.9,3175397,1037786,1289028,5502211
2009-08-11,NASDAQ (Q),724210644,311087585,597002274,1632300503,14029019089.0,14111266092.6,12258328228.8,40398613410.3,3217925,1044392,2531693,6794010
2009-08-11,CBOE (W),2896800,5566700,2381400,10844900,62691709.4,255985520.7,68580178.5,387257408.6,5283,3749,6243,15275
2009-08-11,BATS (Z),538449915,214801576,220884962,974136453,9148696965.19,7826665431.68,4188625352.07,21163987748.9,2601580,830061,1288238,4719879
2009-08-12,AMEX (A),0,19145047,0,19145047,0.0,81368570.93,0.0,81368570.93,0,27529,0,27529
2009-08-12,BEX (B),167279237,28860202,34730596,230870035,2243491966.27,1126179063.82,766921060.65,4136592090.74,564404,109538,186369,860311
2009-08-12,NSX (C),27805588,13850463,14255829,55911880,507533418.869,321543765.049,182062623.992,1011139807.91,119132,26122,56188,201442
2009-08-12,NYSE (DN),19750160,6367925,14626379,40744464,487117547.21,278265656.157,275395042.161,1040778245.53,46616,8454,31608,86678
2009-08-12,NASDAQ (DQ),2077561174,524461072,822454665,3424476911,31075921120.7,17410154516.9,13775536419.3,62261612056.9,3963662,937683,1911887,6813232
2009-08-12,ADF (D),37950240,3480500,12837200,54267940,607182429.28,115915621.5,243674871.94,966772922.72,110280,7264,56025,173569
2009-08-12,ISE (I),129752030,26568608,62553632,218874270,2247723060.38,786261082.964,1035070459.09,4069054602.44,446457,74756,230918,752131
2009-08-12,CHX (M),12536085,11276396,6970595,30783076,282920503.519,879508021.32,155443256.618,1317871781.46,7485,4055,5443,16983
2009-08-12,NYSE (N),1226996970,0,30700,1227027670,25979006724.5,0.0,565903.5,25979572628.0,3500594,0,94,3500688
2009-08-12,NYSE Arca (P),720615956,348379402,268510058,1337505416,14140024282.0,15235995422.7,5927196874.86,35303216579.6,3126805,1091156,1340464,5558425
2009-08-12,NASDAQ (Q),755635748,363496086,688106674,1807238508,15909176182.8,18260503101.9,15025618579.8,49195297864.5,3593589,1256619,2881287,7731495
2009-08-12,CBOE (W),3681400,4509700,4335600,12526700,77686625.0,310226785.6,156075603.0,543989013.6,6982,5121,7424,19527
2009-08-12,BATS (Z),527087207,225358737,263335109,1015781053,10006022591.3,8826078115.29,5139802817.55,23971903524.1,2796459,910953,1487248,5194660
2009-08-13,AMEX (A),0,17423970,0,17423970,0.0,54082357.92,0.0,54082357.92,0,20880,0,20880
2009-08-13,BEX (B),177213072,32267611,30681717,240162400,2548306286.15,1194161281.88,653037396.678,4395504964.71,633973,124152,162306,920431
2009-08-13,NSX (C),28765275,18340062,14146908,61252245,398415356.196,321693949.378,140887859.68,860997165.254,97483,27931,43407,168821
2009-08-13,NYSE (DN),20639199,3357715,12701183,36698097,449077054.321,133532549.753,241211253.734,823820857.808,46670,5210,29260,81140
2009-08-13,NASDAQ (DQ),2058015955,520040415,847963865,3426020235,32576895157.3,15548564079.8,13617915944.7,61743375181.8,4252615,924496,1894991,7072102
2009-08-13,ADF (D),45651140,5133900,16718490,67503530,905031434.63,209379943.88,344510778.17,1458922156.68,164842,13842,69443,248127
2009-08-13,ISE (I),116712395,31807908,69711635,218231938,2089388578.81,760330188.627,1001166797.88,3850885565.32,412120,76152,228036,716308
2009-08-13,CHX (M),16425286,13474707,8349917,38249910,319142020.591,804093576.88,115908386.362,1239143983.83,10327,3616,5294,19237
2009-08-13,NYSE (N),777397285,300,28200,777425785,17122638332.4,1462.5,563528.0,17123203322.9,1944654,1,85,1944740
2009-08-13,NYSE Arca (P),801033189,338474966,261699192,1401207347,17511836136.3,13790180374.1,5694063182.37,36996079692.8,3744513,1043728,1291918,6080159
2009-08-13,NASDAQ (Q),832176605,342931848,623458914,1798567367,18231157067.1,16209928885.3,13304886724.0,47745972676.4,4028878,1203361,2548897,7781136
2009-08-13,CBOE (W),4275500,3277000,1442500,8995000,98626169.01,204984012.4,38203960.0,341814141.41,5565,4306,5172,15043
2009-08-13,BATS (Z),550230025,212037495,230556513,992824033,10824658357.9,8171500145.24,4357951354.88,23354109858.0,3026451,854924,1305647,5187022
2009-08-14,AMEX (A),0,18984140,0,18984140,0.0,72284481.9,0.0,72284481.9,0,29932,0,29932
2009-08-14,BEX (B),153733826,31050096,35522036,220305958,2144894331.04,1196364507.66,708270076.719,4049528915.42,562241,121968,172480,856689
2009-08-14,NSX (C),21561284,13984964,18096915,53643163,382246995.415,280627317.88,139232822.635,802107135.929,94313,25855,40871,161039
2009-08-14,NYSE (DN),13137020,2756183,10031671,25924874,314015005.9,106776661.019,183931642.327,604723309.246,35926,3870,25234,65030
2009-08-14,NASDAQ (DQ),1925395864,517512755,756719004,3199627623,28716803641.5,16865235877.1,11849848505.4,57431888024.1,3799853,887779,1732743,6420375
2009-08-14,ADF (D),36445150,4214800,13408800,54068750,691078798.35,151082012.28,278727000.96,1120887811.59,129634,11261,60038,200933
2009-08-14,ISE (I),107828196,25243230,58229469,191300895,1790477313.58,681795059.005,836923630.894,3309196003.48,363639,67004,192385,623028
2009-08-14,CHX (M),11967936,11998930,8921033,32887899,236946933.831,921676226.672,160521650.85,1319144811.35,11017,4386,5322,20725
2009-08-14,NYSE (N),1094673171,400,33400,1094706971,23449273834.4,2448.0,735334.5,23450011616.9,3055600,3,107,3055710
2009-08-14,NYSE Arca (P),642762143,310722153,244557953,1198042249,12767981544.0,13349464464.5,5220858706.08,31338304714.6,2918393,996533,1227104,5142030
2009-08-14,NASDAQ (Q),714683506,333100871,606809270,1654593647,14535894154.1,16665920295.1,12890691563.1,44092506012.3,3211993,1130534,2463738,6806265
2009-08-14,CBOE (W),2495700,3522100,1136400,7154200,60746355.8,286334964.75,38276776.0,385358096.55,5263,3404,2305,10972
2009-08-14,BATS (Z),456695558,198399604,215477199,870572361,8592827795.94,7723942908.19,4110027078.69,20426797782.8,2467387,791065,1236567,4495019
2009-08-17,AMEX (A),0,19240287,0,19240287,0.0,66584894.05,0.0,66584894.05,0,28589,0,28589
2009-08-17,BEX (B),147053393,33832268,35195056,216080717,2146832726.51,1218543653.82,703595370.936,4068971751.27,592298,127700,165646,885644
2009-08-17,NSX (C),24741817,13361501,16535645,54638963,477158251.333,306445686.4,148943799.239,932547736.971,123185,27273,51182,201640
2009-08-17,NYSE (DN),13562233,3782118,11611208,28955559,332911200.669,139926629.323,209693896.983,682531726.975,38179,4919,27732,70830
2009-08-17,NASDAQ (DQ),1772437874,520526355,729867142,3022831371,28692899857.6,16370834734.2,11767130292.2,56830864884.0,3746763,976664,1702038,6425465
2009-08-17,ADF (D),35821460,6268430,13654500,55744390,671687590.6,202410497.0,252433384.74,1126531472.34,120825,13681,56103,190609
2009-08-17,ISE (I),97546358,26524894,56953469,181024721,1617341930.45,794851299.971,864530601.247,3276723831.67,334449,73927,186752,595128
2009-08-17,CHX (M),13356669,19303232,6585463,39245364,325815829.053,1503135613.56,81730139.142,1910681581.75,9404,4613,4493,18510
2009-08-17,NYSE (N),1220492735,1400,21700,1220515835,27073379811.6,7673.0,507327.5,27073894812.1,3279271,2,61,3279334
2009-08-17,NYSE Arca (P),646180913,434395898,246677882,1327254693,13535956384.1,19128934393.4,5655830287.33,38320721064.8,3049633,1204749,1210643,5465025
2009-08-17,NASDAQ (Q),751932639,382473373,637536545,1771942557,15875900770.8,18016042295.1,13972030852.8,47863973918.6,3467932,1271292,2423545,7162769
2009-08-17,CBOE (W),2512000,2653000,1504600,6669600,65191021.4,134939876.75,40577402.0,240708300.15,4495,3688,5189,13372
2009-08-17,BATS (Z),472875410,226449362,224064213,923388985,9361816502.34,8555527882.4,4298558174.58,22215902559.3,2654499,891671,1250658,4796828
2009-08-18,AMEX (A),0,27039220,0,27039220,0.0,83547407.61,0.0,83547407.61,0,30501,0,30501
2009-08-18,BEX (B),131023413,25659607,36443135,193126155,1923852185.86,981555201.08,642550357.484,3547957744.42,506962,104723,153882,765567
2009-08-18,NSX (C),27171440,10967075,15350713,53489228,475562109.661,234063165.945,145136171.91,854761447.515,114962,21272,51528,187762
2009-08-18,NYSE (DN),12776092,2675018,10767850,26218960,296435975.225,106548981.751,210961897.008,613946853.984,36062,3919,25757,65738
2009-08-18,NASDAQ (DQ),1551940115,461482540,684305840,2697728495,26040392438.3,13571162397.9,11073388920.9,50684943757.1,3466174,827251,1604762,5898187
2009-08-18,ADF (D),32165450,4328800,12528330,49022580,654989442.43,137896374.5,238202762.76,1031088579.69,117825,9808,53485,181118
2009-08-18,ISE (I),87682653,22327667,43678921,153689241,1529066732.18,600854532.878,666448690.39,2796369955.45,316352,60015,150455,526822
2009-08-18,CHX (M),18210010,11673797,6659121,36542928,480453365.577,889996284.28,156097874.685,1526547524.54,9767,3701,3922,17390
2009-08-18,NYSE (N),991094846,0,36100,991130946,22646952982.3,0.0,576297.0,22647529279.3,2830891,0,85,2830976
2009-08-18,NYSE Arca (P),524953260,286839470,235647544,1047440274,11326360634.9,12082666960.5,5074898396.27,28483925991.6,2611449,895239,1125369,4632057
2009-08-18,NASDAQ (Q),622075584,293846020,542983273,1458904877,13900525336.6,14046844652.4,11781442832.8,39728812821.9,3070218,1005129,2229020,6304367
2009-08-18,CBOE (W),2839400,5188800,1136600,9164800,69556113.6,238880946.8,33988467.48,342425527.88,4924,3120,4427,12471
2009-08-18,BATS (Z),402899031,188358358,198614559,789871948,8147524913.0,7259342477.79,3681390873.24,19088258264.0,2344404,735558,1135079,4215041
2009-08-19,AMEX (A),0,21626857,0,21626857,0.0,74176707.74,0.0,74176707.74,0,26921,0,26921
2009-08-19,BEX (B),146558188,27002198,34672714,208233100,2097888001.08,1036443787.59,683535581.097,3817867369.77,534593,115279,160551,810423
2009-08-19,NSX (C),23150829,11931527,22450243,57532599,403259460.138,289826417.681,116394692.299,809480570.118,98737,23092,46306,168135
2009-08-19,NYSE (DN),12280595,3517499,10168200,25966294,322187552.024,120979257.122,187760497.57,630927306.715,33486,4754,23360,61600
2009-08-19,NASDAQ (DQ),1509334358,509846851,782993229,2802174438,26115964734.1,15301010066.5,11393593163.9,52810567964.5,3417049,927686,1673944,6018679
2009-08-19,ADF (D),40716910,5385100,17177500,63279510,830952406.05,266454861.5,339501475.65,1436908743.2,150455,14217,74361,239033
2009-08-19,ISE (I),88248906,24070019,51855536,164174461,1624373427.75,626755517.632,682055867.679,2933184813.06,318148,61992,160373,540513
2009-08-19,CHX (M),12539707,10877195,8324972,31741874,316792396.732,664532699.747,112858974.851,1094184071.33,11972,3881,6307,22160
2009-08-19,NYSE (N),988347365,200,34300,988381865,23726054000.6,1042.0,638516.0,23726693558.6,3036503,2,72,3036577
2009-08-19,NYSE Arca (P),572116421,311321575,256850131,1140288127,12461956214.4,13202322819.0,5245951456.24,30910230489.6,2787656,1010098,1205983,5003737
2009-08-19,NASDAQ (Q),638563994,343121937,595787895,1577473826,14902078785.2,16977926503.8,12239932050.3,44119937339.3,3240937,1171153,2414982,6827072
2009-08-19,CBOE (W),5412100,4288900,2040700,11741700,123999317.5,289705108.6,60351199.46,474055625.56,5273,4017,4115,13405
2009-08-19,BATS (Z),394162170,199622567,217121466,810906203,8491891207.43,7768838800.56,3987567855.96,20248297863.9,2358919,802976,1204708,4366603
2009-08-20,AMEX (A),0,23275619,0,23275619,0.0,78648566.77,0.0,78648566.77,0,27292,0,27292
2009-08-20,BEX (B),176514381,23954829,32855894,233325104,2059969880.24,873966652.1,616649731.358,3550586263.7,496223,90995,139851,727069
2009-08-20,NSX (C),23886054,11722001,29749615,65357670,455455553.448,244047843.955,142069458.248,841572855.65,108026,21281,51464,180771
2009-08-20,NYSE (DN),11853449,2856212,10581427,25291088,305337807.688,105522848.681,206357765.259,617218421.629,33683,3854,25275,62812
2009-08-20,NASDAQ (DQ),1943550421,459754089,803713054,3207017564,28143963099.4,13489598240.7,12126597671.0,53760159011.1,3496487,797533,1648211,5942231
2009-08-20,ADF (D),36154650,4491400,14982400,55628450,660225993.89,160226633.05,311161702.86,1131614329.8,108728,9596,57290,175614
2009-08-20,ISE (I),109207771,24267782,55769211,189244764,1739965713.31,586541623.73,731046250.359,3057553587.4,323221,55428,152681,531330
2009-08-20,CHX (M),16661894,10020535,13767461,40449890,363919611.223,645788944.055,199518703.77,1209227259.05,10851,2713,5594,19158
2009-08-20,NYSE (N),1046415092,100,32000,1046447192,23012051793.3,4516.0,590996.5,23012647305.8,2845183,1,66,2845250
2009-08-20,NYSE Arca (P),592347862,290955657,243446544,1126750063,11777414369.0,11995162746.4,4946985534.42,28719562649.8,2562393,841918,1106916,4511227
2009-08-20,NASDAQ (Q),712449397,309579507,585542785,1607571689,14957675998.6,15162610238.6,12561159400.0,42681445637.2,3183087,995953,2302618,6481658
2009-08-20,CBOE (W),3673700,3047700,3509500,10230900,79959147.2,167812428.0,117537530.49,365309105.69,6048,3065,3855,12968
2009-08-20,BATS (Z),436419724,176064330,210428371,822912425,8091373075.75,6726079107.63,3936686712.55,18754138895.9,2210680,694996,1147309,4052985
2009-08-21,AMEX (A),0,23286634,0,23286634,0.0,95733181.78,0.0,95733181.78,0,29034,0,29034
2009-08-21,BEX (B),193557001,29677915,35023666,258258582,2217039364.69,1078527266.49,702915571.848,3998482203.03,519574,100618,157674,777866
2009-08-21,NSX (C),28989007,11192403,34265973,74447383,540072727.074,277428595.934,246837612.513,1064338935.52,117785,23151,66119,207055
2009-08-21,NYSE (DN),13954556,3894332,11418046,29266934,372759930.798,161492648.268,227163313.374,761415892.44,42283,4916,29254,76453
2009-08-21,NASDAQ (DQ),2274457010,550757001,827625140,3652839151,31748771198.8,17729102815.5,12630193308.2,62108067322.5,3837006,901831,1743349,6482186
2009-08-21,ADF (D),42260520,5132200,19402100,66794820,761890590.25,181725766.5,342000377.71,1285616734.46,129579,11772,67628,208979
2009-08-21,ISE (I),133919417,23569142,59524171,217012730,2010689208.53,664152321.415,785960038.317,3460801568.27,353316,60501,165042,578859
2009-08-21,CHX (M),16545467,7920670,13496186,37962323,375977055.972,497722660.855,228536219.968,1102235936.79,9376,3042,7055,19473
2009-08-21,NYSE (N),1475983380,0,53900,1476037280,34809499680.5,0.0,1276967.0,34810776647.5,3163283,0,81,3163364
2009-08-21,NYSE Arca (P),679485509,341980698,278911067,1300377274,13971243309.1,14814612664.7,6090212382.7,34876068356.5,2854617,965537,1249202,5069356
2009-08-21,NASDAQ (Q),801845731,346686637,773288525,1921820893,16829843121.3,18116190339.1,16490711298.1,51436744758.5,3304546,1092728,2368839,6766113
2009-08-21,CBOE (W),5420800,5848500,5837100,17106400,147120304.9,423734127.99,221397978.6,792252411.49,6176,3251,4908,14335
2009-08-21,BATS (Z),480570626,215826503,231107370,927504499,9108434147.7,8704187528.82,4444815084.53,22257436761.1,2320698,769354,1224795,4314847
2009-08-24,AMEX (A),0,20606456,0,20606456,0.0,80616403.74,0.0,80616403.74,0,27115,0,27115
2009-08-24,BEX (B),185018181,28681892,32706499,246406572,2005853209.02,1083182055.17,629118315.729,3718153579.92,527275,114465,142066,783806
2009-08-24,NSX (C),29649881,12691154,25266365,67607400,537083438.971,307918326.587,167391465.755,1012393231.31,120806,26528,62153,209487
2009-08-24,NYSE (DN),15284313,3439097,11798421,30521831,363723415.862,122258007.521,206539863.938,692521287.32,38829,4945,27204,70978
2009-08-24,NASDAQ (DQ),2660206002,538395804,823310441,4021912247,32204650057.5,17168506908.4,12468468366.8,61841625332.7,4033450,970490,1739913,6743853
2009-08-24,ADF (D),49424830,3651000,14720700,67796530,748616241.82,134431192.0,273388481.29,1156435915.11,123987,9344,58232,191563
2009-08-24,ISE (I),139024017,24086987,55402079,218513083,1922630431.7,652960058.24,778513248.146,3354103738.09,351168,66316,169705,587189
2009-08-24,CHX (M),18739621,8973629,10290311,38003561,412306097.732,613381935.981,131114902.16,1156802935.87,10014,3608,7177,20799
2009-08-24,NYSE (N),1230805835,200,41600,1230847635,25308565284.2,1225.0,580448.5,25309146957.7,3163323,1,110,3163434
2009-08-24,NYSE Arca (P),727558783,308979549,252569457,1289107789,13638220011.5,12835962424.0,5362994903.72,31837177339.2,2910687,963184,1179371,5053242
2009-08-24,NASDAQ (Q),909887449,323307280,609153163,1842347892,16669718163.1,16420310813.3,13094625410.7,46184654387.1,3344212,1114477,2408821,6867510
2009-08-24,CBOE (W),6271600,4675000,3514800,14461400,154784464.06,290848118.6,95742285.32,541374867.98,8282,5859,5841,19982
2009-08-24,BATS (Z),530690437,209128948,221541306,961360691,9179176833.44,8004202463.36,4292509691.03,21475888987.8,2390643,823940,1200817,4415400
2009-08-25,AMEX (A),0,17214329,0,17214329,0.0,64570060.21,0.0,64570060.21,0,26629,0,26629
2009-08-25,BEX (B),195414072,32530509,34747339,262691920,2264213416.28,1258865654.86,647701699.634,4170780770.78,589009,140839,163181,893029
2009-08-25,NSX (C),27602659,11124041,23108178,61834878,548625163.404,307917786.245,186736572.541,1043279522.19,122109,25902,55701,203712
2009-08-25,NYSE (DN),14674236,3202675,11795385,29672296,364456628.493,133024253.958,227863979.127,725344861.579,38121,4183,27003,69307
2009-08-25,NASDAQ (DQ),2357062212,502158227,773957324,3633177763,33106295854.3,17258136910.4,12649684914.9,63014117679.6,3983567,938987,1752518,6675072
2009-08-25,ISE (I),137980550,23516618,52221025,213718193,2045915732.49,706592965.822,768943931.361,3521452629.68,358453,67581,166144,592178
2009-08-25,CHX (M),15616767,11628878,9078127,36323772,386367916.004,796255745.35,101676265.072,1284299926.43,13808,3698,6510,24016
2009-08-25,NYSE (N),1141805581,0,13500,1141819081,24811016147.6,0.0,217035.5,24811233183.1,3169568,0,43,3169611
2009-08-25,NYSE Arca (P),736169479,314731481,250409942,1301310902,14412936445.5,13849302733.1,5461541162.29,33723780341.0,3112028,1029592,1220662,5362282
2009-08-25,NASDAQ (Q),822995505,349596873,591206060,1763798438,17053568545.7,18626783632.1,12888811005.5,48569163183.4,3511743,1211615,2438155,7161513
2009-08-25,CBOE (W),5412100,6023100,1620700,13055900,119802781.5,326342130.0,53029932.16,499174843.66,6595,7759,5104,19458
2009-08-25,BATS (Z),520336147,208305054,212339333,940980534,9160242037.42,8289522788.73,4275572293.83,21725337120.0,2405227,875410,1200980,4481617
2009-08-26,AMEX (A),0,18778808,0,18778808,0.0,62155207.34,0.0,62155207.34,0,26260,0,26260
2009-08-26,BEX (B),191280109,31646812,42097096,265024017,2390614062.44,1225993860.85,695822815.44,4312430738.73,629473,140586,182497,952556
2009-08-26,NSX (C),30309405,12407334,35387901,78104640,593872070.225,284063008.75,176653489.458,1054588568.43,132767,25057,65026,222850
2009-08-26,NYSE (DN),14130031,2505496,11298210,27933737,340111206.385,98696863.729,198701059.02,637509129.134,36241,3733,24499,64473
2009-08-26,NASDAQ (DQ),2026993186,476740267,876787599,3380521052,29594250105.6,15462727557.2,12927439229.6,57984416892.4,3876617,846414,1780892,6503923
2009-08-26,ISE (I),114787587,24552952,59310642,198651181,1837985610.1,614439419.903,779916342.058,3232341372.06,339293,61774,171587,572654
2009-08-26,CHX (M),12789503,8962481,13801435,35553419,334237987.353,678355968.87,178045224.71,1190639180.93,9966,3748,6820,20534
2009-08-26,NYSE (N),1052116225,0,19800,1052136025,23655112705.1,0.0,282895.5,23655395600.6,3168830,0,68,3168898
2009-08-26,NYSE Arca (P),623094639,285930901,250759203,1159784743,12242719943.5,12179273784.9,4912758127.9,29334751856.3,2758736,891721,1174247,4824704
2009-08-26,NASDAQ (Q),711585536,326332299,592199562,1630117397,15499325198.9,16695101333.3,11804931242.0,43999357774.3,3369139,1101779,2413699,6884617
2009-08-26,CBOE (W),4954800,4497700,1519600,10972100,123908915.62,271056024.82,41769212.99,436734153.43,5423,4851,4447,14721
2009-08-26,BATS (Z),453274245,185835026,214470113,853579384,8322232741.06,7163009140.8,4041771242.2,19527013124.1,2229988,761037,1192289,4183314
2009-08-27,AMEX (A),0,18625432,0,18625432,0.0,55190353.14,0.0,55190353.14,0,30829,0,30829
2009-08-27,BEX (B),222067838,33880529,46563994,302512361,2815034360.69,1236340475.64,828112858.213,4879487694.55,719490,151213,210891,1081594
2009-08-27,NSX (C),26942582,12847963,30097280,69887825,440589340.675,307010170.604,146685253.397,894284764.676,104096,25236,56373,185705
2009-08-27,NYSE (DN),15007001,3149614,12149038,30305653,362713159.636,137229111.166,211048919.449,710991190.252,35391,3940,24351,63682
2009-08-27,NASDAQ (DQ),2388378115,493000732,867611965,3748990812,33048196858.9,16060176221.8,12677603858.1,61785976938.7,4061961,871822,1760523,6694306
2009-08-27,ISE (I),165806518,22667832,62779941,251254291,2501030786.72,631657400.981,790774891.726,3923463079.43,403267,60540,168712,632519
2009-08-27,CHX (M),17032143,11731619,9516419,38280181,385121084.371,841752276.752,128729616.369,1355602977.49,13325,4055,6243,23623
2009-08-27,NYSE (N),1161492895,100,15300,1161508295,25338173637.1,1023.0,248785.5,25338423445.6,3151940,1,50,3151991
2009-08-27,NYSE Arca (P),727340998,296558751,275801132,1299700881,13980490924.3,12656988315.3,5446626482.42,32084105722.0,3021822,939111,1194558,5155491
2009-08-27,NASDAQ (Q),792350061,324427746,631731058,1748508865,16643376967.0,16875531647.6,12336733050.5,45855641665.1,3490045,1077259,2421667,6988971
2009-08-27,CBOE (W),4589300,5311700,2004500,11905500,115848693.3,245184466.48,59880690.0,420913849.78,6887,4020,4147,15054
2009-08-27,BATS (Z),458623204,192674770,227839647,879137621,8408482256.17,7632731635.16,4304953619.7,20346167511.0,2239936,748352,1201121,4189409
2009-08-28,AMEX (A),0,24231713,0,24231713,0.0,64663891.13,0.0,64663891.13,0,27598,0,27598
2009-08-28,BEX (B),233180804,36589589,53935767,323706160,2870210216.54,1341352114.9,823477642.47,5035039973.91,770829,171796,220873,1163498
2009-08-28,NSX (C),26138013,14812763,20216840,61167616,451824810.3,306679245.083,148716861.131,907220916.514,111864,28301,54943,195108
2009-08-28,NYSE (DN),12344323,2427632,11684401,26456356,321681182.459,97259181.5424,195301343.87,614241707.871,31334,3283,24090,58707
2009-08-28,NASDAQ (DQ),2331657425,451822646,977549429,3761029500,30341761805.5,13464259664.6,13360087141.2,57166108611.3,3930683,817721,1812447,6560851
2009-08-28,ISE (I),120730199,21044200,56415298,198189697,1873943682.48,540413497.332,759139183.066,3173496362.88,310016,55123,154636,519775
2009-08-28,CHX (M),13419003,9214481,6927855,29561339,373603599.304,590374001.9,91761075.472,1055738676.68,12895,3276,5623,21794
2009-08-28,NYSE (N),1186360560,100,18600,1186379260,25838683993.0,803.5,444270.0,25839129066.5,3202589,1,60,3202650
2009-08-28,NYSE Arca (P),691986841,254550617,292726094,1239263552,13015571055.6,10690333116.4,5610658006.06,29316562178.1,2818655,821754,1215127,4855536
2009-08-28,NASDAQ (Q),867883077,297924288,703767356,1869574721,17168526361.8,14772025210.3,13298567520.3,45239119092.4,3439343,1010400,2458775,6908518
2009-08-28,CBOE (W),5593300,4318400,1268200,11179900,78796962.9,259107335.0,42966492.2,380870790.1,5748,4833,4379,14960
2009-08-28,BATS (Z),480380332,178377397,255207966,913965695,8360719389.02,6664626234.4,4345053738.64,19370399362.1,2208350,719399,1231606,4159355
2009-08-31,AMEX (A),0,31707394,0,31707394,0.0,120096612.04,0.0,120096612.04,0,36594,0,36594
2009-08-31,BEX (B),222725167,35658138,53075231,311458536,3277132637.71,1281150445.95,793314942.6,5351598026.26,912394,165540,234892,1312826
2009-08-31,NSX (C),27278452,16562522,20499669,64340643,651670303.244,302563622.801,179396318.96,1133630245.0,149493,28072,63518,241083
2009-08-31,NYSE (DN),11946717,2949419,12459840,27355976,322982054.906,104465589.294,181138290.447,608585934.648,33496,3752,27759,65007
2009-08-31,NASDAQ (DQ),1963656111,465524948,1000614891,3429795950,30155993201.7,13536200402.4,12387302521.5,56079496125.6,3798325,854524,1786740,6439589
2009-08-31,ISE (I),94845799,20795010,58458904,174099713,1652216327.91,530012172.095,652524058.86,2834752558.87,295857,56837,152192,504886
2009-08-31,CHX (M),20301391,10346041,7232793,37880225,433398402.722,756255969.68,77122860.9617,1266777233.36,10366,3590,5197,19153
2009-08-31,NYSE (N),1377860273,600,17200,1377878073,31809614091.0,4786.0,233320.5,31809852197.5,3282506,4,62,3282572
2009-08-31,NYSE Arca (P),591623656,292685849,255837743,1140147248,12535696905.5,12836045876.9,4637893201.62,30009635984.0,2805272,838247,1101970,4745489
2009-08-31,NASDAQ (Q),744400327,305022183,713757596,1763180106,15933129931.0,14804828080.4,13373083083.4,44111041094.9,3347038,1012729,2354913,6714680
2009-08-31,CBOE (W),3394800,4284400,1707100,9386300,84803074.25,274941637.0,40448313.12,400193024.37,6085,5010,5675,16770
2009-08-31,BATS (Z),444839609,178867942,230951239,854658790,8295114106.85,6956745875.47,4077277042.18,19329137024.5,2212655,721979,1191727,4126361
2009-09-01,AMEX (A),0,26517678,0,26517678,0.0,120328270.18,0.0,120328270.18,0,41534,0,41534
2009-09-01,BEX (B),259110781,52186425,64676871,375974077,3967876479.51,1813584530.02,1182313884.51,6963774894.04,1214831,220109,356655,1791595
2009-09-01,NSX (C),34709734,20304953,26069248,81083935,789331440.0,428977352.234,262338548.68,1480647340.91,183952,36775,82301,303028
2009-09-01,NYSE (DN),16270248,5685616,17565090,39520954,422861808.453,224909380.06,287470481.143,935241669.656,42260,5694,36558,84512
2009-09-01,NASDAQ (DQ),2533575174,752585207,1096771721,4382932102,37188744213.2,24760061056.5,16261459406.1,78210264675.8,4694683,1257189,2198459,8150331
2009-09-01,ADF (D),47222850,9379600,19834600,76437050,796132803.2,323440193.06,352359243.89,1471932240.15,147056,24377,79125,250558
2009-09-01,ISE (I),155478317,37927313,72732571,266138201,2358246410.88,1075152444.63,1046993162.83,4480392018.35,427733,88393,221718,737844
2009-09-01,CHX (M),12378316,17154642,10946980,40479938,298816202.98,1387408978.84,159561684.414,1845786866.24,10793,5063,8038,23894
2009-09-01,NYSE (N),1634860202,0,19400,1634879602,36284352939.4,0.0,249619.5,36284602558.9,4662998,0,62,4663060
2009-09-01,NYSE Arca (P),835786843,472844797,365044389,1673676029,17461977630.1,19042685384.2,7321615864.2,43826278878.5,3881232,1367837,1663153,6912222
2009-09-01,NASDAQ (Q),1046609261,537635427,847218635,2431463323,21535028806.1,27680227295.5,16985085451.2,66200341552.9,4516455,1650257,3300722,9467434
2009-09-01,CBOE (W),3556300,9083000,2568900,15208200,84603525.52,522870211.5,78130718.15,685604455.17,8648,6824,9099,24571
2009-09-01,BATS (Z),586529458,316453090,294207265,1197189813,11177878417.2,12049171782.1,5715285441.35,28942335640.6,3028186,1173259,1628161,5829606
2009-09-02,AMEX (A),0,30922265,0,30922265,0.0,133147578.24,0.0,133147578.24,0,37721,0,37721
2009-09-02,BEX (B),223098244,36726659,46006232,305831135,3287460396.37,1293335361.9,846590971.61,5427386729.88,1027224,172778,275546,1475548
2009-09-02,NSX (C),31757862,15225291,23166011,70149164,705104226.22,290737018.283,204790451.547,1200631696.05,156813,27847,68196,252856
2009-09-02,NYSE (DN),14505127,3658546,12326332,30490005,369002476.501,152106166.05,226460621.318,747569263.869,36063,4172,26813,67048
2009-09-02,NASDAQ (DQ),2184127215,532764573,767012790,3483904578,31225963327.6,15138732104.5,11696283665.7,58060979097.7,3848793,920516,1627340,6396649
2009-09-02,ADF (D),38202110,4520100,14190300,56912510,648828624.85,146907069.92,229910174.19,1025645868.96,121789,12455,58960,193204
2009-09-02,ISE (I),114145142,29243020,46378912,189767074,1812911922.82,712217014.3,691785578.418,3216914515.54,336335,67323,152522,556180
2009-09-02,CHX (M),14356357,14168036,8486744,37011137,331235072.333,876205925.9,114575243.83,1322016242.06,11198,4853,6590,22641
2009-09-02,NYSE (N),1377294957,100,27700,1377322757,29786102934.7,356.5,368884.0,29786472175.2,3821625,1,83,3821709
2009-09-02,NYSE Arca (P),708806949,331314773,256536555,1296658277,14165866765.5,13027682640.8,5298860982.49,32492410388.7,3197631,1022296,1245401,5465328
2009-09-02,NASDAQ (Q),904009474,360466944,618116431,1882592849,17149290780.4,16998116630.0,12483381015.5,46630788425.9,3622689,1223045,2458896,7304630
2009-09-02,CBOE (W),3563700,6202700,2194000,11960400,78575884.0,473287296.2,60300607.0,612163787.2,11917,8240,9252,29409
2009-09-02,BATS (Z),481426168,208698618,210127368,900252154,8853652422.88,7828158317.47,4113243621.28,20795054361.6,2463049,841384,1217470,4521903
2009-09-03,AMEX (A),0,25788165,0,25788165,0.0,117359451.34,0.0,117359451.34,0,41235,0,41235
2009-09-03,BEX (B),176307737,30547939,42930888,249786564,2831224829.39,1058868404.9,832512815.357,4722606049.65,867222,139989,242939,1250150
2009-09-03,NSX (C),20944611,15085711,17440865,53471187,534688742.368,275821827.063,155677413.099,966187982.531,124539,26029,54986,205554
2009-09-03,NYSE (DN),13266569,3264977,12114953,28646499,328668789.797,130957387.662,216926732.208,676552909.667,35904,4205,25222,65331
2009-09-03,NASDAQ (DQ),1675853331,498381679,702334795,2876569805,27168860232.2,14697571681.6,11551998438.7,53418430352.6,3395305,821459,1545588,5762352
2009-09-03,ADF (D),33281460,3955900,13900800,51138160,647349824.89,115709073.48,248079030.8,1011137929.17,130271,10995,51443,192709
2009-09-03,ISE (I),90823204,25441991,45352064,161617259,1587153841.57,620375259.286,680993119.292,2888522220.15,296895,61434,140249,498578
2009-09-03,CHX (M),14870519,11824580,6831413,33526512,377267843.289,711506209.5,131820983.398,1220595036.19,10139,3343,4021,17503
2009-09-03,NYSE (N),1161683290,0,13500,1161696790,27169609592.9,0.0,286569.0,27169896161.9,3265028,0,44,3265072
2009-09-03,NYSE Arca (P),584617296,282672906,260589821,1127880023,12965306223.7,10468145825.4,5398855114.92,28832307164.1,2857471,870209,1150019,4877699
2009-09-03,NASDAQ (Q),677677874,298039802,571477270,1547194946,14808402371.4,13834584632.8,11898780344.0,40541767348.3,3076968,1014313,2153517,6244798
2009-09-03,CBOE (W),2806100,4267200,1670700,8744000,59207162.95,189933722.0,50850523.81,299991408.76,8264,6249,6983,21496
2009-09-03,BATS (Z),402381318,171874531,197784015,772039864,8099769692.03,6262498559.94,3953018623.8,18315286875.8,2164220,672676,1062926,3899822
2009-09-04,AMEX (A),0,24198561,0,24198561,0.0,81201955.62,0.0,81201955.62,0,33272,0,33272
2009-09-04,BEX (B),151649866,31245026,39193323,222088215,2466747547.52,1059454591.8,802092540.41,4328294679.73,756814,138778,237815,1133407
2009-09-04,NSX (C),16334439,14095135,19370862,49800436,416913160.115,247929405.867,127658145.424,792500711.406,94843,23577,46259,164679
2009-09-04,NYSE (DN),11129658,2202057,10688938,24020653,276957095.077,96783496.5564,203075605.051,576816196.684,28600,2869,24525,55994
2009-09-04,NASDAQ (DQ),1452364171,431722785,682968483,2567055439,22739576851.7,12847438584.8,10669653303.7,46256668740.2,2812838,745788,1434867,4993493
2009-09-04,ADF (D),29972270,3525200,12881800,46379270,605064259.05,111987071.46,266937079.79,983988410.3,112248,9978,53760,175986
2009-09-04,ISE (I),78371508,22261135,43907819,144540462,1398006577.22,561174987.332,713550472.658,2672732037.21,251085,50153,135744,436982
2009-09-04,CHX (M),8128502,9055251,6881686,24065439,203587226.756,632622174.182,151052196.457,987261597.395,5558,3432,4410,13400
2009-09-04,NYSE (N),1019788250,0,15900,1019804150,23197715305.9,0.0,380681.5,23198095987.4,2897312,0,54,2897366
2009-09-04,NYSE Arca (P),506208546,262447255,219324103,987979904,10812183308.5,10563989518.2,4725049934.49,26101222761.2,2399276,843402,1072728,4315406
2009-09-04,NASDAQ (Q),614188893,286768844,526664384,1427622121,12914185232.5,13485623314.6,11046099554.2,37445908101.4,2702455,965910,2092513,5760878
2009-09-04,CBOE (W),3104100,3309900,1928500,8342500,81547513.0,160000701.0,58758210.0,300306424.0,8800,5611,7408,21819
2009-09-04,BATS (Z),362175543,170357993,179135385,711668921,6761884824.91,6429809414.64,3551916051.36,16743610290.9,1805074,654146,1001893,3461113
2009-09-08,AMEX (A),0,24810320,0,24810320,0.0,94932576.82,0.0,94932576.82,0,37723,0,37723
2009-09-08,BEX (B),191418510,30697967,44940883,267057360,3235078156.82,1102229820.33,897351902.74,5234659879.89,907388,135672,252443,1295503
2009-09-08,NSX (C),27126005,14676053,20329509,62131567,735662449.908,254529403.883,201158189.688,1191350043.48,158183,26164,66483,250830
2009-09-08,NYSE (DN),16037982,2877021,13263184,32178187,440575880.993,118122499.204,236383081.697,795081461.893,47479,3591,29586,80656
2009-09-08,NASDAQ (DQ),1925101695,487244976,827443316,3239789987,32577530426.3,14056028106.6,13260946537.0,59894505070.0,3697690,790049,1771088,6258827
2009-09-08,ADF (D),50279740,4537100,14885800,69702640,773776652.58,136477731.82,274272969.97,1184527354.37,127851,13190,63504,204545
2009-09-08,ISE (I),103776174,23417681,56515311,183709166,1817067046.41,580747502.648,784373405.522,3182187954.58,320615,53195,164755,538565
2009-09-08,CHX (M),13771559,8743377,6154503,28669439,362926716.757,572367735.108,133056022.21,1068350474.08,8877,2979,5647,17503
2009-09-08,NYSE (N),1317725075,0,22300,1317747375,31449821928.2,0.0,418691.5,31450240619.7,3398728,0,70,3398798
2009-09-08,NYSE Arca (P),642613171,287757146,250650124,1181020441,14179641085.6,11752031524.7,5387977274.36,31319649884.6,2903812,882321,1210922,4997055
2009-09-08,NASDAQ (Q),760918682,289660798,605935590,1656515070,16862064848.7,13798762870.9,12686497839.4,43347325558.9,3358466,965572,2428203,6752241
2009-09-08,CBOE (W),3230600,3589000,1656300,8475900,85400415.0,239414536.0,53545242.0,378360193.0,9764,5369,8413,23546
2009-09-08,BATS (Z),463208221,166701833,198474388,828384442,8866031722.8,6582748865.47,3870216816.43,19318997404.7,2171012,653460,1095169,3919641
2009-09-09,AMEX (A),0,24682822,0,24682822,0.0,70089978.16,0.0,70089978.16,0,30753,0,30753
2009-09-09,BEX (B),208445664,39803000,54181984,302430648,3941466431.82,1444890560.62,1089170859.49,6475527851.93,1074598,185792,296549,1556939
2009-09-09,NSX (C),18062473,15135644,29845661,63043778,466101800.305,295521645.809,195828380.522,957451826.636,102711,26717,68636,198064
2009-09-09,NYSE (DN),17559785,2782038,14733232,35075055,500635050.326,124394123.83,283061911.619,908091085.775,36995,3268,29656,69919
2009-09-09,NASDAQ (DQ),1883974819,482322144,1009980698,3376277661,33576800113.5,14188531234.0,16580175809.8,64345507157.4,3831962,856873,2089267,6778102
2009-09-09,ADF (D),52970770,5181500,17075900,75228170,801757645.68,161603131.45,344770722.62,1308131499.75,133925,15862,67580,217367
2009-09-09,ISE (I),106217169,24415751,75703192,206336112,1951197670.51,620524209.463,1066040682.36,3637762562.33,343513,55718,207953,607184
2009-09-09,CHX (M),16859252,10966467,11295636,39121355,473527241.69,717489064.13,148920170.062,1339936475.88,11890,3797,6604,22291
2009-09-09,NYSE (N),1242545618,0,30200,1242575818,29886246888.2,0.0,550121.5,29886797009.7,3602354,0,89,3602443
2009-09-09,NYSE Arca (P),598938327,298707019,325992492,1223637838,14078878785.3,12465005035.8,7083484990.38,33627368811.5,2926925,999211,1474832,5400968
2009-09-09,NASDAQ (Q),779937187,320142167,743336238,1843415592,17845195096.4,15931609059.1,16144015817.5,49920819973.0,3557593,1077164,3005737,7640494
2009-09-09,CBOE (W),3490000,7655000,2260200,13405200,95704351.0,331551463.24,72942979.0,500198793.24,10208,6430,9682,26320
2009-09-09,BATS (Z),433240247,196609099,232502508,862351854,8920537557.89,7729556830.2,4793519982.51,21443614370.6,2237174,786594,1265709,4289477
2009-09-10,AMEX (A),0,24483776,0,24483776,0.0,78287812.88,0.0,78287812.88,0,33550,0,33550
2009-09-10,BEX (B),205819833,38109638,53864907,297794378,3799432896.42,1420537163.47,1105621029.54,6325591089.43,1072030,173001,317606,1562637
2009-09-10,NSX (C),21932873,15924681,29680403,67537957,600094737.141,277125277.93,201663491.202,1078883506.27,133368,28286,76724,238378
2009-09-10,NYSE (DN),15315284,3178600,12909279,31403163,427416396.962,144644019.875,235854719.785,807915136.622,38671,3833,27466,69970
2009-09-10,NASDAQ (DQ),2006877714,490791967,1022487587,3520157268,34562207242.0,15038783794.8,15952660900.4,65553651937.2,3807714,813541,1954674,6575929
2009-09-10,ADF (D),61700420,3553020,21871400,87124840,924701820.3,128369507.54,372691872.45,1425763200.29,146304,10688,76949,233941
2009-09-10,ISE (I),102802820,25152381,69561670,197516871,1967453429.06,636421818.934,912111224.733,3515986472.73,334623,57181,187555,579359
2009-09-10,CHX (M),17042357,13065319,8361367,38469043,424573730.52,856585643.28,130926099.612,1412085473.41,9301,4103,4633,18037
2009-09-10,NYSE (N),1494519536,200,17200,1494536936,33148856197.3,561.0,271098.5,33149127856.8,3601660,1,64,3601725
2009-09-10,NYSE Arca (P),606553013,290172659,308994446,1205720118,14043022103.9,11684947416.5,6229397789.33,31957367309.7,2856914,901117,1358987,5117018
2009-09-10,NASDAQ (Q),737650099,313765980,733355826,1784771905,17067613970.7,16002099896.7,14816226099.2,47885939966.6,3426514,1024444,2767063,7218021
2009-09-10,CBOE (W),5248700,4892700,1873800,12015200,132883428.2,199470296.13,61496773.0,393850497.33,10554,5355,8111,24020
2009-09-10,BATS (Z),444134402,183603145,234230386,861967933,8746744335.82,7136994899.02,4614272309.66,20498011544.5,2184634,698442,1236852,4119928
2009-09-11,AMEX (A),0,33527625,0,33527625,0.0,121151631.5,0.0,121151631.5,0,50722,0,50722
2009-09-11,BEX (B),192159015,33854599,50627481,276641095,3612291455.47,1266189178.19,997557327.239,5876037960.9,1067385,161874,303732,1532991
2009-09-11,NSX (C),19579965,18756536,29719600,68056101,469319398.469,291080167.498,177157521.233,937557087.201,106611,30480,74391,211482
2009-09-11,NYSE (DN),16133875,3508363,12969072,32611310,454612669.445,161133285.6,225740497.869,841486452.913,38276,3934,25178,67388
2009-09-11,NASDAQ (DQ),1706265652,480645077,980893385,3167804114,32428111486.5,13912755810.8,14800358528.9,61141225826.3,3741772,832282,1889787,6463841
2009-09-11,ADF (D),38283130,3565000,24108700,65956830,756542710.29,135959045.49,388090959.67,1280592715.45,123008,11618,76434,211060
2009-09-11,ISE (I),98036902,23832245,66263727,188132874,1986261448.97,595314045.466,775533638.603,3357109133.04,347467,55483,179296,582246
2009-09-11,CHX (M),15378557,19294614,11205656,45878827,459842072.377,1399624598.19,151924402.065,2011391072.63,8013,4016,6955,18984
2009-09-11,NYSE (N),1294363985,0,15800,1294379785,32184750074.2,0.0,358451.5,32185108525.7,3746275,0,74,3746349
2009-09-11,NYSE Arca (P),600071086,276377796,279902885,1156351767,14834868548.9,11746090981.4,5630099428.06,32211058958.3,3142626,943945,1314826,5401397
2009-09-11,NASDAQ (Q),708380042,304562925,660220078,1673163045,17354861859.0,15320233269.2,13225900597.0,45900995725.2,3524071,1036941,2672012,7233024
2009-09-11,CBOE (W),4205000,4449900,2305300,10960200,131733339.0,223851670.0,70970107.8,426555116.8,9636,6053,7020,22709
2009-09-11,BATS (Z),415385602,180037188,224453801,819876591,9119330527.31,6989051836.72,4367093598.31,20475475962.3,2323908,739456,1218391,4281755
2009-09-14,AMEX (A),0,30406970,0,30406970,0.0,108548243.32,0.0,108548243.32,0,34937,0,34937
2009-09-14,BEX (B),198997897,33225591,59007332,291230820,3446410627.9,1258144287.06,1013563727.38,5718118642.34,1046715,161980,303690,1512385
2009-09-14,NSX (C),16130619,15438659,20141164,51710442,391542682.815,242361983.915,140225177.458,774129844.188,88527,26295,50241,165063
2009-09-14,NYSE (DN),14495820,2784883,12350717,29631420,387371811.287,121380311.008,226652949.353,735405071.648,32243,2965,24708,59916
2009-09-14,NASDAQ (DQ),1774134883,438513392,911170447,3123818722,30129464483.5,13488457674.5,13267552038.6,56885474196.6,3627505,733149,1785469,6146123
2009-09-14,ADF (D),32138260,3245300,17576100,52959660,662071033.93,106301546.37,332610669.13,1100983249.43,119683,10647,68504,198834
2009-09-14,ISE (I),106177479,22277634,55994334,184449447,1859633958.38,545336342.352,750970764.966,3155941065.7,320138,50656,160253,531047
2009-09-14,CHX (M),11382153,13248491,8593223,33223867,321971503.744,902893369.42,127296164.952,1352161038.12,8733,3470,5438,17641
2009-09-14,NYSE (N),1211930501,100,13700,1211944301,28466668361.5,1874.0,251180.0,28466921415.5,3388048,1,59,3388108
2009-09-14,NYSE Arca (P),577354351,252742764,261305452,1091402567,12172689946.9,10059029985.7,5064664541.95,27296384474.6,2601685,830720,1162613,4595018
2009-09-14,NASDAQ (Q),725195728,297447872,643173539,1665817139,15684904214.6,14889122958.7,12836127777.1,43410154950.4,3269677,972679,2463707,6706063
2009-09-14,CBOE (W),3698200,5099400,1823500,10621100,87159011.0,238165787.0,47382799.0,372707597.0,7917,6400,7102,21419
2009-09-14,BATS (Z),393868878,174157975,206754383,774781236,7809189436.66,6734820532.65,3836434485.71,18380444455.0,2024844,710043,1097000,3831887
2009-09-15,AMEX (A),0,36300867,0,36300867,0.0,123306590.77,0.0,123306590.77,0,46097,0,46097
2009-09-15,BEX (B),265210306,46145716,69594261,380950283,4585621606.86,1703907216.82,1325340912.23,7614869735.91,1389927,216352,404219,2010498
2009-09-15,NSX (C),25324679,21772739,27025341,74122759,694704501.952,332037845.414,201618646.251,1228360993.62,149383,31110,77921,258414
2009-09-15,NYSE (DN),19783478,3408012,12451105,35642595,532867403.804,152232049.64,244314606.299,929414059.743,49101,3980,26478,79559
2009-09-15,NASDAQ (DQ),2247358417,569076356,977342721,3793777494,38079375798.6,16935473481.8,15537360593.5,70552209873.9,4360790,906165,1979414,7246369
2009-09-15,ADF (D),70309820,4229400,20037100,94576320,988706088.38,152248041.81,354992655.47,1495946785.66,153834,12097,74486,240417
2009-09-15,ISE (I),127493573,31642922,64156908,223293403,2315468374.08,728639406.739,904454656.92,3948562437.74,394244,63508,185336,643088
2009-09-15,CHX (M),19524769,15768513,13051964,48345246,637215849.35,1237418808.68,375320650.441,2249955308.47,10603,5127,5993,21723
2009-09-15,NYSE (N),1496977116,0,18100,1496995216,34777813310.4,0.0,473865.5,34778287175.9,3956066,0,52,3956118
2009-09-15,NYSE Arca (P),736671242,332524158,287581406,1356776806,15878254028.0,13674273098.7,6217610120.23,35770137247.0,3232064,1050470,1305091,5587625
2009-09-15,NASDAQ (Q),883625116,382483290,695596382,1961704788,18943032536.8,19078172325.6,14805296217.1,52826501079.5,3773670,1219123,2675260,7668053
2009-09-15,CBOE (W),3877400,3236000,2193100,9306500,89690986.9,165069714.8,62970121.49,317730823.19,11562,6193,8406,26161
2009-09-15,BATS (Z),538639782,227150711,235995256,1001785749,10523299218.3,8954139033.12,4593860608.73,24071298860.1,2697738,900962,1274839,4873539
2009-09-16,AMEX (A),0,39017086,0,39017086,0.0,121872985.78,0.0,121872985.78,0,43043,0,43043
2009-09-16,BEX (B),286673940,47770852,70980287,405425079,5283317859.77,1754606098.0,1514586461.05,8552510418.82,1560789,221001,445927,2227717
2009-09-16,NSX (C),27229964,20805762,31019676,79055402,739688810.454,332028269.972,248898029.018,1320615109.44,148810,33926,79484,262220
2009-09-16,NYSE (DN),22855204,4050695,15871750,42777649,599807204.654,170261993.491,316557611.764,1086626809.91,57410,4785,33141,95336
2009-09-16,NASDAQ (DQ),2557239564,670961301,1196700741,4424901606,44406968874.9,18747408684.6,20252068758.9,83406446318.4,4892153,1070108,2299341,8261602
2009-09-16,ADF (D),112218000,6694400,21767500,140679900,1268917073.76,219484824.57,425545463.47,1913947361.8,179082,17229,85725,282036
2009-09-16,ISE (I),150822228,32440363,75475817,258738408,2794201263.52,770705436.486,1111116759.63,4676023459.63,446098,68107,202272,716477
2009-09-16,CHX (M),21320886,15331715,11939335,48591936,573968590.75,1022218097.42,158020527.362,1754207215.54,12049,4974,7293,24316
2009-09-16,NYSE (N),1581652595,0,0,1581652595,37547837844.4,0.0,0.0,37547837844.4,4371340,0,0,4371340
2009-09-16,NYSE Arca (P),807050238,384688052,342721569,1534459859,17832999249.2,15671589482.7,7751670182.48,41256258914.5,3596759,1098641,1496746,6192146
2009-09-16,NASDAQ (Q),972207827,411429586,792057498,2175694911,21415050639.0,19611129493.2,17157176011.3,58183356143.5,4247117,1239780,3007612,8494509
2009-09-16,CBOE (W),7453200,4949700,4439100,16842000,162523621.12,369059432.85,154583419.16,686166473.13,12047,6427,8613,27087
2009-09-16,BATS (Z),597481950,250417413,248587965,1096487328,11416811326.1,10447683576.8,5183054840.98,27047549743.9,2845448,927211,1398300,5170959
2009-09-17,AMEX (A),0,28550480,0,28550480,0.0,111566525.77,0.0,111566525.77,0,42755,0,42755
2009-09-17,BEX (B),253647090,45313287,66953637,365914014,4216821845.34,1714689539.61,1413526578.6,7345037963.55,1314936,211210,419060,1945206
2009-09-17,NSX (C),31776439,17739752,33731686,83247877,860099069.849,394328387.805,258778548.057,1513206005.71,179045,34746,88524,302315
2009-09-17,NYSE (DN),25978486,3846821,16568144,46393451,626436995.367,195988096.285,332091489.141,1154516580.79,55700,4371,34493,94564
2009-09-17,NASDAQ (DQ),2424905348,619814228,1070027957,4114747533,41716453489.3,20335625817.1,18988764053.6,81040843359.9,4655517,1006454,2245121,7907092
2009-09-17,ADF (D),137400250,5877300,20300000,163577550,1346787996.59,244452655.5,357348812.34,1948589464.43,180301,17930,82091,280322
2009-09-17,ISE (I),141201725,29443553,72513815,243159093,2500091508.54,801600795.437,1108574388.09,4410266692.07,429828,65634,203930,699392
2009-09-17,CHX (M),22380610,17772429,13180295,53333334,578530032.84,1370984247.09,781706733.81,2731221013.74,11049,4796,7181,23026
2009-09-17,NYSE (N),1519513102,0,0,1519513102,35878997199.1,0.0,0.0,35878997199.1,4370981,0,0,4370981
2009-09-17,NYSE Arca (P),812019856,384341697,335463090,1531824643,17792318158.7,17108766546.6,7778844551.65,42679929256.9,3679545,1125056,1514788,6319389
2009-09-17,NASDAQ (Q),964583504,403231632,755859599,2123674735,20794962002.2,19226027985.5,16884327451.2,56905317438.8,4286426,1367672,3006131,8660229
2009-09-17,CBOE (W),6850700,3862900,2725200,13438800,146679469.0,243383662.8,79924163.92,469987295.72,12802,7938,9814,30554
2009-09-17,BATS (Z),560935829,266486929,260398070,1087820828,11053734827.9,10498161859.2,5564508301.27,27116404988.4,2799555,1011971,1417518,5229044
2009-09-18,AMEX (A),0,40551338,0,40551338,0.0,179518330.22,0.0,179518330.22,0,44969,0,44969
2009-09-18,BEX (B),205916930,36456912,71800779,314174621,3686804263.61,1360709379.91,1256169792.02,6303683435.54,1095097,164488,386589,1646174
2009-09-18,NSX (C),32310806,11868676,27037056,71216538,766927023.738,237529493.562,231966974.263,1236423491.56,151063,23558,82254,256875
2009-09-18,NYSE (DN),20840651,3268058,16938709,41047418,526723882.499,154363294.521,295821025.904,976908202.925,48372,3815,33629,85816
2009-09-18,NASDAQ (DQ),2105019029,542889620,1233928749,3881837398,38845837086.4,14514764449.4,18097502746.2,71458104282.0,3640032,752745,1951629,6344406
2009-09-18,ADF (D),121330740,4838200,20556070,146725010,1108453055.76,188192784.52,340907174.3,1637553014.58,139301,12635,73047,224983
2009-09-18,ISE (I),110293239,21093958,64885477,196272674,1995835023.65,615338127.128,865306179.485,3476479330.26,346671,51255,181764,579690
2009-09-18,CHX (M),15219616,19343996,9779355,44342967,459307936.879,1476714490.98,176828099.03,2112850526.88,8291,5216,5182,18689
2009-09-18,NYSE (N),2275400479,0,0,2275400479,55920078752.8,0.0,0.0,55920078752.8,3810065,0,0,3810065
2009-09-18,NYSE Arca (P),596564252,282826061,358953611,1238343924,13209396400.8,12268561360.2,6362359526.73,31840317287.7,2652993,853154,1355757,4861904
2009-09-18,NASDAQ (Q),710225766,293297331,1134684016,2138207113,15994489943.0,14412411389.8,22975055482.0,53381956814.8,3203853,1002133,2707886,6913872
2009-09-18,CBOE (W),5518500,4436700,2707200,12662400,156061659.78,271071218.04,76265192.58,503398070.4,9668,5642,9393,24703
2009-09-18,BATS (Z),405724555,203521080,259525844,868771479,8483406227.65,7777242036.67,4836994394.42,21097642658.7,2151546,757311,1293922,4202779
2009-09-21,AMEX (A),0,26057803,0,26057803,0.0,99451275.66,0.0,99451275.66,0,41731,0,41731
2009-09-21,BEX (B),208726353,35324422,68319840,312370615,4113749724.8,1322682495.58,1186961428.82,6623393649.2,1200454,165535,375299,1741288
2009-09-21,NSX (C),23226934,12966940,25452840,61646714,534919234.681,245918130.082,165561415.229,946398779.992,123217,22952,69948,216117
2009-09-21,NYSE (DN),12472447,2000802,11498904,25972153,332495116.79,98832038.83,201763425.494,633090581.114,35152,2159,26312,63623
2009-09-21,NASDAQ (DQ),1663923445,497599684,1015472733,3176995862,31716559480.7,16299403562.9,14207068260.3,62223031303.8,3587770,761988,1906507,6256265
2009-09-21,ADF (D),33992960,3736600,20055100,57784660,693377296.17,97565497.7,290853608.89,1081796402.76,121267,9860,65707,196834
2009-09-21,ISE (I),118844293,25440692,69274329,213559314,2230672044.21,618739486.995,925864170.799,3775275702.0,364525,56287,198579,619391
2009-09-21,CHX (M),12095516,13441301,11417219,36954036,355149093.505,744042847.821,133174202.582,1232366143.91,11433,5344,5641,22418
2009-09-21,NYSE (N),1198463749,0,0,1198463749,29731313315.3,0.0,0.0,29731313315.3,3570516,0,0,3570516
2009-09-21,NYSE Arca (P),372659319,223478075,227663533,823800927,8935886678.71,9193757361.76,3902907164.3,22032551204.8,1654302,543363,839247,3036912
2009-09-21,NASDAQ (Q),769320464,320859339,723687027,1813866830,18714084632.8,14823665527.9,14480748853.5,48018499014.1,3673513,1083710,2772875,7530098
2009-09-21,CBOE (W),3628300,2607400,2372200,8607900,91973169.16,165582481.7,69100905.0,326656555.86,9307,6479,8734,24520
2009-09-21,BATS (Z),419970166,196269166,254011550,870250882,9139419615.7,7328091759.39,4636693326.13,21104204701.2,2280728,733782,1288345,4302855
2009-09-22,AMEX (A),0,24210241,0,24210241,0.0,88651179.83,0.0,88651179.83,0,38627,0,38627
2009-09-22,BEX (B),213488702,30891965,62265845,306646512,3959002855.24,1193390263.93,1145941957.32,6298335076.49,1152397,142676,341066,1636139
2009-09-22,NSX (C),23182760,12219506,26055617,61457883,473916427.876,260732481.453,151176268.952,885825178.281,108010,21005,58989,188004
2009-09-22,NYSE (DN),14329615,3490280,13166065,30985960,355137061.172,184338249.78,239198771.049,778674082.001,31784,3151,25073,60008
2009-09-22,NASDAQ (DQ),2063209338,455044587,1048577578,3566831503,36600245754.8,13890749508.7,15362896913.4,65853892176.9,4029971,747657,1919816,6697444
2009-09-22,ADF (D),11956000,1738200,6092780,19786980,212163675.25,119270351.5,101650058.07,433084084.82,43483,3943,24304,71730
2009-09-22,ISE (I),127632870,20584550,75624074,223841494,2248885274.53,565693710.668,955554845.549,3770133830.75,366523,48241,187652,602416
2009-09-22,CHX (M),15303118,9989156,12644854,37937128,544589890.577,647146968.53,377750768.679,1569487627.79,8434,3535,6205,18174
2009-09-22,NYSE (N),1266680710,0,0,1266680710,30904205104.2,0.0,0.0,30904205104.2,3507966,0,0,3507966
2009-09-22,NYSE Arca (P),597825791,272322843,300267286,1170415920,13539068177.0,11992474119.6,5632433550.67,31163975847.3,2706998,808657,1229980,4745635
2009-09-22,NASDAQ (Q),759955573,273511985,740343341,1773810899,17450557718.3,13132653220.3,13967347239.7,44550558178.2,3461875,943224,2610836,7015935
2009-09-22,CBOE (W),5389400,3647500,2907000,11943900,142229860.7,231246621.66,101566962.42,475043444.78,9925,5857,7560,23342
2009-09-22,BATS (Z),414699905,170683776,230211446,815595127,8534799708.21,6521753863.12,4257947382.93,19314500954.3,2125486,631246,1196745,3953477
2009-09-23,AMEX (A),0,26248565,0,26248565,0.0,94080669.6,0.0,94080669.6,0,43346,0,43346
2009-09-23,BEX (B),237555112,44365612,72981002,354901726,4288291447.03,1713932996.84,1440081276.58,7442305720.45,1255534,192101,391593,1839228
2009-09-23,NSX (C),20811609,17841473,27630642,66283724,463447047.818,370373487.71,172815110.21,1006635645.74,106694,29182,63172,199048
2009-09-23,NYSE (DN),20588959,4981082,16947677,42517718,527008929.901,262014179.557,332635556.753,1121658666.21,44979,4764,31877,81620
2009-09-23,NASDAQ (DQ),2041919627,551568349,1122262648,3715750624,38649672563.9,17545799967.5,18693944055.2,74889416586.5,4309912,891260,2144658,7345830
2009-09-23,ISE (I),114797009,30587155,73290009,218674173,2203615188.91,855773207.658,1079532050.8,4138920447.37,359489,64267,196721,620477
2009-09-23,CHX (M),13385406,20077799,10541879,44005084,376830000.413,1378970531.39,144110671.05,1899911202.85,8642,4626,6966,20234
2009-09-23,NYSE (N),1320215787,0,0,1320215787,32110553020.1,0.0,0.0,32110553020.1,3968094,0,0,3968094
2009-09-23,NYSE Arca (P),694239269,386626822,336147183,1417013274,15764334420.7,17208051893.3,7464770413.44,40437156727.4,3159337,1119484,1472720,5751541
2009-09-23,NASDAQ (Q),836967233,406774833,797542556,2041284622,19525610783.6,21240963270.4,17138494272.6,57905068326.5,3891096,1301258,3017519,8209873
2009-09-23,CBOE (W),4273700,4985100,2535600,11794400,140503331.0,282024043.95,74529979.0,497057353.95,13341,7659,10964,31964
2009-09-23,BATS (Z),454704743,233347570,266520966,954573279,9726296976.41,9316734377.02,5495990935.44,24539022288.9,2430858,866377,1390400,4687635
2009-09-24,AMEX (A),0,23406347,0,23406347,0.0,87576700.06,0.0,87576700.06,0,38013,0,38013
2009-09-24,BEX (B),223393106,45658358,67044425,336095889,3891094862.93,1609245608.12,1242331290.36,6742671761.41,1259505,186768,390935,1837208
2009-09-24,NSX (C),18694058,16940289,32483778,68118125,450721077.768,391723552.365,178121056.719,1020565686.85,107914,29180,70266,207360
2009-09-24,NYSE (DN),21855099,5353173,16077891,43286163,505384022.369,255610211.621,310791833.934,1071786067.92,42895,4617,30804,78316
2009-09-24,NASDAQ (DQ),1974752799,649057712,1084523431,3708333942,36565916829.8,20236069231.3,17033771720.6,73835757781.7,4399329,1059963,2172998,7632290
2009-09-24,ISE (I),115098368,32049131,70047382,217194881,2188928760.63,905266276.471,1020446312.31,4114641349.41,384720,69876,201982,656578
2009-09-24,CHX (M),12421579,17742029,9653417,39817025,310296196.403,1150872490.05,104301196.627,1565469883.08,12446,5915,6473,24834
2009-09-24,NYSE (N),1367883817,0,1400,1367885217,32542961182.0,0.0,50435.0,32543011617.0,4016031,0,1,4016032
2009-09-24,NYSE Arca (P),696672349,426346264,344308020,1467326633,15667871430.3,18475475220.0,7551788931.03,41695135581.4,3307074,1221871,1530489,6059434
2009-09-24,NASDAQ (Q),852804979,457724769,781710569,2092240317,19251263954.8,21949840484.2,16442824950.9,57643929389.9,3987859,1494911,3039254,8522024
2009-09-24,CBOE (W),3587500,5690800,2952800,12231100,92872876.2,306812170.3,84815039.46,484500085.96,13310,7134,10048,30492
2009-09-24,BATS (Z),464870775,269612310,243936662,978419747,9423028048.13,10110007127.1,4846969135.23,24380004310.5,2509823,950983,1360883,4821689
2009-09-25,AMEX (A),0,15874821,0,15874821,0.0,66305523.65,0.0,66305523.65,0,33155,0,33155
2009-09-25,BEX (B),204670480,34645776,66564148,305880404,3417091755.09,1238831308.07,1160243976.1,5816167039.26,1119920,150412,377657,1647989
2009-09-25,NSX (C),19623348,11382496,25828392,56834236,485226336.241,258281999.148,181570628.419,925078963.808,121388,22468,79417,223273
2009-09-25,NYSE (DN),15636470,3457842,13526619,32620931,428677721.85,172578417.696,273943260.109,875199399.655,35016,3246,28659,66921
2009-09-25,NASDAQ (DQ),1568128904,497704388,968440158,3034273450,31378521678.5,16350579677.6,16277500670.5,64006602026.6,3701639,822688,1955504,6479831
2009-09-25,ISE (I),89175962,24107145,59444158,172727265,1850996778.82,737711752.702,968326321.103,3557034852.63,324079,57898,184498,566475
2009-09-25,CHX (M),11089362,11633703,4970040,27693105,317007190.773,1027390610.38,122662934.253,1467060735.41,7104,3700,3130,13934
2009-09-25,NYSE (N),1203061541,0,0,1203061541,29923903057.6,0.0,0.0,29923903057.6,3666158,0,0,3666158
2009-09-25,NYSE Arca (P),532524670,336880900,307335581,1176741151,12982543578.0,15401856672.4,7165696215.83,35550096466.2,2773159,967282,1377623,5118064
2009-09-25,NASDAQ (Q),701555736,361274496,713740265,1776570497,16947867955.8,16938145377.0,16019109304.0,49905122636.9,3554672,1170740,2764957,7490369
2009-09-25,CBOE (W),5523900,6105900,2024500,13654300,141036485.1,420193739.6,88972072.45,650202297.15,10478,7363,7462,25303
2009-09-25,BATS (Z),373615404,218120762,229628995,821365161,8373635052.17,8426936720.32,4700422494.75,21500994267.2,2222143,770447,1258184,4250774
2009-09-28,AMEX (A),0,16056533,0,16056533,0.0,63149085.9,0.0,63149085.9,0,33270,0,33270
2009-09-28,BEX (B),160387448,25031886,53739966,239159300,2794824535.87,915771697.08,1077702608.76,4788298841.71,878573,106161,300481,1285215
2009-09-28,NSX (C),19424734,10170840,30249678,59845252,491379934.03,213324044.65,137838759.326,842542738.006,108249,19085,56823,184157
2009-09-28,NYSE (DN),12361077,2653986,10884387,25899450,335807175.438,123862210.418,230115714.277,689785100.134,32287,2625,25690,60602
2009-09-28,NASDAQ (DQ),1333287762,387338229,756421134,2477047125,26620311890.8,12111335281.6,13314413388.9,52046060561.3,3083872,648207,1618786,5350865
2009-09-28,ADF (D),15603280,2230300,7941600,25775180,312877840.81,84161632.03,182367990.7,579407463.54,57963,5525,32003,95491
2009-09-28,ISE (I),75687160,17411501,49252317,142350978,1517768177.08,516984008.77,748417453.489,2783169639.34,261710,44742,151238,457690
2009-09-28,CHX (M),10218852,7265897,6749332,24234081,249867290.567,571337766.48,117773740.15,938978797.197,8098,3445,4564,16107
2009-09-28,NYSE (N),979445786,0,0,979445786,24111116259.5,0.0,0.0,24111116259.5,2986056,0,0,2986056
2009-09-28,NYSE Arca (P),460380929,254901410,239998705,955281044,11295279931.9,11118221329.1,5628325823.36,28041827084.4,2364555,755842,1166060,4286457
2009-09-28,NASDAQ (Q),547676207,236988086,568844771,1353509064,13402664931.8,11044998633.7,12563396323.9,37011059889.5,2773453,776620,2280955,5831028
2009-09-28,CBOE (W),1917700,712400,2306300,4936400,61688690.7,35127210.69,97172695.0,193988596.39,3233,2195,1602,7030
2009-09-28,BATS (Z),319021219,171790007,206825148,697636374,6898376760.86,6783704858.29,4240879348.6,17922960967.8,1821724,607872,1171326,3600922
2009-09-29,AMEX (A),0,18191894,0,18191894,0.0,76291468.88,0.0,76291468.88,0,32620,0,32620
2009-09-29,BEX (B),216505527,30121639,73075575,319702741,3678611538.71,1090438979.1,1384554828.46,6153605346.27,1176662,133736,420961,1731359
2009-09-29,NSX (C),20872973,11312869,21619389,53805231,456605253.447,252395727.143,149096552.288,858097532.879,108443,19539,58071,186053
2009-09-29,NYSE (DN),18223089,3047057,12587213,33857359,435653152.726,154085491.159,236424907.189,826163551.074,39616,3197,28199,71012
2009-09-29,NASDAQ (DQ),1846529220,417427273,861466237,3125422730,32793156088.4,12774228932.3,14503408389.3,60070793409.9,3678403,714526,1792286,6185215
2009-09-29,ISE (I),94981153,19944997,48494940,163421090,1701819422.71,618515530.199,732814371.304,3053149324.21,304436,46223,149234,499893
2009-09-29,CHX (M),10492487,14802528,12493690,37788705,329949495.984,952662513.185,187037501.792,1469649510.96,10012,4332,5393,19737
2009-09-29,NYSE (N),1182576006,0,400,1182576406,27493207714.9,0.0,12010.0,27493219724.9,3392341,0,3,3392344
2009-09-29,NYSE Arca (P),574480685,270428592,247628200,1092537477,12741363557.3,11289004048.1,5417185537.77,29447553143.1,2675573,809720,1156855,4642148
2009-09-29,NASDAQ (Q),753347661,299130084,618116478,1670594223,16765470206.0,13841298779.6,13092810724.7,43699579710.3,3479421,1010635,2429363,6919419
2009-09-29,CBOE (W),3872500,3406700,1487400,8766600,97786087.0,158021286.35,31038086.5,286845459.85,10268,5653,7188,23109
2009-09-29,BATS (Z),410248927,185709094,218545787,814503808,8589454416.84,6963425619.6,4440086616.09,19992966652.5,2233077,672210,1188875,4094162
2009-09-30,AMEX (A),0,23824652,0,23824652,0.0,103905905.69,0.0,103905905.69,0,42295,0,42295
2009-09-30,BEX (B),268983623,45768933,91011705,405764261,4500719392.79,1674562471.23,1770196702.56,7945478566.58,1437959,196282,520718,2154959
2009-09-30,NSX (C),28583723,14323724,22694213,65601660,637264969.07,353531618.338,190873570.073,1181670157.48,141099,26823,62441,230363
2009-09-30,NYSE (DN),21737448,5373942,15261826,42373216,498711971.09,284169915.721,287611459.11,1070493345.92,45293,4980,32122,82395
2009-09-30,NASDAQ (DQ),2190002723,613733961,1086150895,3889887579,36786422057.5,22167958474.5,18155002326.2,77109382858.2,4384446,997554,2071622,7453622
2009-09-30,ISE (I),108384253,27381581,53925812,189691646,1895177430.89,976993404.361,927317358.866,3799488194.12,340846,67127,177999,585972
2009-09-30,CHX (M),13734011,16719128,8384961,38838100,407296294.582,1365967470.6,152548296.589,1925812061.77,10411,5752,5034,21197
2009-09-30,NYSE (N),1774872168,0,0,1774872168,40278770631.9,0.0,0.0,40278770631.9,4358795,0,0,4358795
2009-09-30,NYSE Arca (P),749364315,427756569,328044143,1505165027,16315696760.9,19308156642.9,7490319084.96,43114172488.8,3445169,1201508,1456016,6102693
2009-09-30,NASDAQ (Q),934612123,465041088,871653649,2271306860,20472951603.9,23017239345.0,18915597634.0,62405788582.9,4247777,1458072,3057995,8763844
2009-09-30,CBOE (W),4463800,4465200,1799900,10728900,113468989.82,287581022.37,45934548.3,446984560.49,9974,6877,8548,25399
2009-09-30,BATS (Z),520883569,295101196,284456770,1100441535,10792572392.4,11919408270.3,5957447550.48,28669428213.1,2821677,1016089,1499231,5336997
2009-10-01,AMEX (A),0,23452391,0,23452391,0.0,89077038.18,0.0,89077038.18,0,39351,0,39351
2009-10-01,BEX (B),249972701,46978403,97799618,394750722,4385402147.18,1638719475.89,1748513355.85,7772634978.92,1427221,189916,546178,2163315
2009-10-01,NSX (C),26060217,15672751,27324675,69057643,628321445.722,375612788.168,199039731.473,1202973965.36,136188,29825,67954,233967
2009-10-01,NYSE (DN),20427594,4933776,15279293,40640663,509864824.445,238927705.41,286474609.901,1035267139.76,48798,4763,34169,87730
2009-10-01,NASDAQ (DQ),2016420357,685571779,1040031065,3742023201,37292534663.2,25837916275.0,17476167219.6,80606618157.8,4396502,1008691,2207547,7612740
2009-10-01,ADF (D),47696350,6300300,19102600,73099250,940067369.23,278820485.0,349941452.84,1568829307.07,175349,18790,74062,268201
2009-10-01,ISE (I),104244913,27974912,59143625,191363450,1904577666.68,1017346924.57,930564113.064,3852488704.32,359040,72672,196393,628105
2009-10-01,CHX (M),14557867,20123663,10170291,44851821,296327291.807,1511000063.85,152758273.08,1960085628.74,11613,6506,5872,23991
2009-10-01,NYSE (N),1602857102,0,0,1602857102,39177421625.6,0.0,0.0,39177421625.6,4583387,0,0,4583387
2009-10-01,NYSE Arca (P),690972513,416763881,337453019,1445189413,16538560588.0,18424101718.4,7593781032.12,42556443338.5,3517208,1150406,1555272,6222886
2009-10-01,NASDAQ (Q),880205751,463901300,860263824,2204370875,20649942491.2,22783686627.4,18973328275.1,62406957393.7,4298388,1432016,3246877,8977281
2009-10-01,CBOE (W),3712100,7564000,2520000,13796100,93002747.25,349243486.2,59775000.54,502021233.99,10453,7174,8912,26539
2009-10-01,BATS (Z),497330612,298714539,296901678,1092946829,11160576794.9,11771878430.7,6284763697.31,29217218922.9,2894114,1013865,1594299,5502278
2009-10-02,AMEX (A),0,21755288,0,21755288,0.0,84903020.63,0.0,84903020.63,0,39058,0,39058
2009-10-02,BEX (B),236549059,42001281,85546092,364096432,3898614745.74,1489705698.73,1515022282.72,6903342727.19,1288674,179054,481523,1949251
2009-10-02,NSX (C),18402653,6592914,19247575,44243142,466874076.393,150596184.548,163014446.863,780484707.803,111798,14544,56449,182791
2009-10-02,NYSE (DN),20421961,4805517,15256393,40483871,535347094.514,243012198.703,290653270.984,1069012564.2,42046,4666,31405,78117
2009-10-02,NASDAQ (DQ),1860421855,622731175,940061851,3423214881,33405877086.1,20344463838.8,15253349832.6,69003690757.4,4179851,959019,1979278,7118148
2009-10-02,ADF (D),46169760,4309200,20226400,70705360,899924789.16,179274977.58,349455945.21,1428655711.95,179858,12678,84322,276858
2009-10-02,ISE (I),94405975,26259783,53511857,174177615,1766811337.16,890274962.104,792230683.992,3449316983.26,332874,65854,168449,567177
2009-10-02,CHX (M),12516748,14769681,9633016,36919445,355531651.471,1134149290.43,118944820.325,1608625762.23,12402,4938,4531,21871
2009-10-02,NYSE (N),1403747728,0,0,1403747728,32970649299.5,0.0,0.0,32970649299.5,4197971,0,0,4197971
2009-10-02,NYSE Arca (P),685301669,390892337,312980031,1389174037,15566353770.8,17076893945.2,6911102591.97,39554350308.0,3432439,1144924,1410298,5987661
2009-10-02,NASDAQ (Q),907265228,437138548,771651017,2116054793,20165232517.1,20273540818.3,16194105905.5,56632879240.9,4271484,1422893,2930409,8624786
2009-10-02,CBOE (W),3163000,3464900,3765700,10393600,86391280.55,130127757.41,108391068.69,324910106.65,9035,5489,6733,21257
2009-10-02,BATS (Z),481501570,262092053,255924789,999518412,10130498752.0,10519921482.1,5335531632.54,25985951866.7,2721830,962411,1385172,5069413
2009-10-05,AMEX (A),0,19869461,0,19869461,0.0,80951751.39,0.0,80951751.39,0,34527,0,34527
2009-10-05,BEX (B),216004870,33236477,76953369,326194716,4014885508.86,1186791894.19,1409434338.08,6611111741.13,1268488,151044,451742,1871274
2009-10-05,NSX (C),21086212,13198751,22064575,56349538,528776084.713,276207734.619,155060738.484,960044557.815,120344,21968,58841,201153
2009-10-05,NYSE (DN),14969642,2900942,12959249,30829833,416015203.55,142842026.745,234107091.134,792964321.428,41805,3067,28198,73070
2009-10-05,NASDAQ (DQ),1455609318,446056222,837025128,2738690668,28707589636.9,14416735039.1,13563905770.2,56688230446.2,3600849,776665,1763832,6141346
2009-10-05,ADF (D),34797960,4093000,20610400,59501360,723812382.42,153507159.06,388789698.41,1266109239.89,149902,13488,83507,246897
2009-10-05,ISE (I),69229955,18869844,43166291,131266090,1332762863.67,555371850.654,677330822.028,2565465536.35,243486,47542,142883,433911
2009-10-05,CHX (M),10344215,11869696,9814612,32028523,264417342.069,944549992.52,235554913.159,1444522247.75,7502,4760,3953,16215
2009-10-05,NYSE (N),1118634010,0,0,1118634010,27775235685.7,0.0,0.0,27775235685.7,3436547,0,0,3436547
2009-10-05,NYSE Arca (P),511212886,298666638,271894305,1081773829,12427605172.2,12478577499.9,5744835239.2,30651017911.2,2802932,902935,1289263,4995130
2009-10-05,NASDAQ (Q),681819137,324643344,677981153,1684443634,16656763025.1,14797767732.9,14403303359.6,45857834117.7,3585227,1087458,2682145,7354830
2009-10-05,CBOE (W),4003200,3070700,1859500,8933400,78182688.8,181992741.52,53667515.36,313842945.68,11415,6568,7502,25485
2009-10-05,BATS (Z),401922581,200888694,240767907,843579182,8950295682.21,7823268841.57,4818038378.74,21591602902.5,2432939,766403,1386306,4585648
2009-10-06,AMEX (A),0,26533352,0,26533352,0.0,103362735.63,0.0,103362735.63,0,42728,0,42728
2009-10-06,BEX (B),232071148,41413582,81193153,354677883,4279462527.91,1472832358.23,1549714869.01,7302009755.15,1274164,168466,444171,1886801
2009-10-06,NSX (C),19780422,14126996,23355545,57262963,511920348.36,316307683.916,148001363.406,976229395.683,100039,23763,51891,175693
2009-10-06,NYSE (DN),19025032,4682648,13708054,37415734,543450499.93,248393907.038,274584459.131,1066428866.1,42340,4046,30367,76753
2009-10-06,NASDAQ (DQ),1750282662,576808119,940948119,3268038900,36526343271.3,17892291260.5,16235416715.3,70654051247.2,3980957,973531,1924041,6878529
2009-10-06,ADF (D),40703330,4626300,19922900,65252530,848739891.39,162545270.36,402826218.54,1414111380.29,154269,13279,74005,241553
2009-10-06,ISE (I),89859102,23742805,56145823,169747730,1829480798.73,769033586.437,871537407.693,3470051792.86,299987,60480,175250,535717
2009-10-06,CHX (M),18075587,15086851,11044582,44207020,850114072.703,1177459400.15,827181306.529,2854754779.39,10054,5761,5280,21095
2009-10-06,NYSE (N),1228873109,0,0,1228873109,31131210817.7,0.0,0.0,31131210817.7,3671566,0,0,3671566
2009-10-06,NYSE Arca (P),599206896,384471744,298974678,1282653318,14992759700.8,17024490990.8,7069840969.73,39087091661.3,3108467,1150688,1347499,5606654
2009-10-06,NASDAQ (Q),792832863,426710165,738279549,1957822577,19564104326.2,21430827107.1,16819593297.7,57814524731.0,3934899,1328395,2836199,8099493
2009-10-06,CBOE (W),3545700,3014200,1704000,8263900,95297235.4,156049120.65,49585650.86,300932006.91,11667,6793,8530,26990
2009-10-06,BATS (Z),427839357,255343222,250847571,934030150,9730223360.71,9986808722.35,5334710169.56,25051742252.6,2486240,906204,1352332,4744776
2009-10-07,AMEX (A),0,21252642,0,21252642,0.0,80366698.31,0.0,80366698.31,0,35422,0,35422
2009-10-07,BEX (B),188921400,31684759,65049794,285655953,3420496471.99,1129216869.99,1268472401.82,5818185743.8,1074926,142582,370194,1587702
2009-10-07,NSX (C),19183200,10719164,26839555,56741919,438795708.392,246968716.043,150402895.496,836167319.931,93908,20038,55645,169591
2009-10-07,NYSE (DN),14132583,3168257,12371964,29672804,407263412.748,154245834.718,247328077.062,808837324.529,35944,2952,25353,64249
2009-10-07,NASDAQ (DQ),1466343469,415312402,898777971,2780433842,29727550860.7,13065615136.8,14070214701.6,56863380699.1,3350648,728011,1672308,5750967
2009-10-07,ADF (D),32516190,4119400,19768700,56404290,687691756.76,163493848.84,358899344.83,1210084950.43,123992,13890,73147,211029
2009-10-07,ISE (I),82198507,17479203,50291222,149968932,1561073449.03,534055085.037,803438793.522,2898567327.59,249277,45265,150213,444755
2009-10-07,CHX (M),12676929,12012219,11183801,35872949,336823910.422,889318362.674,222246450.28,1448388723.38,6435,4784,4640,15859
2009-10-07,NYSE (N),1091299745,0,0,1091299745,27057556400.7,0.0,0.0,27057556400.7,3160654,0,0,3160654
2009-10-07,NYSE Arca (P),486563891,274450593,256156004,1017170488,12233471370.8,11857144813.3,6178252147.74,30268868331.9,2499117,859931,1168367,4527415
2009-10-07,NASDAQ (Q),659021659,328894751,684312223,1672228633,16283471009.3,17023501403.9,15202842126.7,48509814539.9,3286705,1075213,2515520,6877438
2009-10-07,CBOE (W),2685000,3290300,1901400,7876700,74669186.24,186956101.5,50197651.72,311822939.46,8930,4664,6698,20292
2009-10-07,BATS (Z),343587563,188158244,215729468,747475275,7835536251.15,7229529809.99,4476455466.49,19541521527.6,2019744,716859,1198915,3935518
2009-10-08,AMEX (A),0,22492079,0,22492079,0.0,98208379.76,0.0,98208379.76,0,40296,0,40296
2009-10-08,BEX (B),228093988,34277781,70255234,332627003,4243829174.11,1213511349.93,1444861230.95,6902201754.99,1337770,152006,432493,1922269
2009-10-08,NSX (C),24069771,13111217,27283910,64464898,633224489.304,322373284.526,263900056.109,1219497829.94,124695,24436,67351,216482
2009-10-08,NYSE (DN),16535627,4150278,13998452,34684357,480208613.048,202474411.685,288894876.997,971577901.73,40661,3697,31342,75700
2009-10-08,NASDAQ (DQ),1780237048,478706050,960282998,3219226096,37956241203.1,16174233996.7,17511640104.8,71642115304.5,4050613,832347,1959909,6842869
2009-10-08,ADF (D),41566610,6477900,22856300,70900810,958683567.96,274286834.7,438783342.36,1671753745.02,154598,20585,78221,253404
2009-10-08,ISE (I),90626884,19699966,53785719,164112569,1853282401.51,661762755.194,891877826.128,3406922982.83,300732,50055,166583,517370
2009-10-08,CHX (M),18770922,12400224,9839062,41010208,552438999.619,860464759.95,189603971.468,1602507731.04,10482,5234,5598,21314
2009-10-08,NYSE (N),1278301558,0,0,1278301558,33191070044.9,0.0,0.0,33191070044.9,3663090,0,0,3663090
2009-10-08,NYSE Arca (P),592832726,313475346,283763442,1190071514,15082444095.5,13889548246.6,6784249516.95,35756241859.0,3013707,970737,1299438,5283882
2009-10-08,NASDAQ (Q),770672504,380868546,749527416,1901068466,19881970995.4,19119444457.4,17579502885.4,56580918338.2,3925078,1171963,2860086,7957127
2009-10-08,CBOE (W),3407200,2985700,2229300,8622200,80887708.0,188059596.8,64335968.81,333283273.61,10120,5209,7239,22568
2009-10-08,BATS (Z),401953392,222694276,234242112,858889780,9433477507.86,9652193542.13,5029829989.27,24115501039.3,2366190,788655,1311058,4465903
2009-10-09,AMEX (A),0,20152094,0,20152094,0.0,81688909.89,0.0,81688909.89,0,34883,0,34883
2009-10-09,BEX (B),188620701,27783709,58431752,274836162,3657244747.36,1025625250.35,1235776987.89,5918646985.6,1095456,121969,367777,1585202
2009-10-09,NSX (C),16068538,11425188,22523583,50017309,462073913.263,232408967.913,153200029.356,847682910.532,88810,19303,52338,160451
2009-10-09,NYSE (DN),13498226,2896267,11460359,27854852,381910926.005,136948648.51,234392919.826,753252494.342,33172,3012,26433,62617
2009-10-09,NASDAQ (DQ),1304762292,381742844,784860273,2471365409,26933695217.8,12764041938.4,14147240413.0,53844977569.1,3068123,632260,1676338,5376721
2009-10-09,ADF (D),32786620,4039400,16192600,53018620,777590126.35,146560625.25,319402831.19,1243553582.79,133591,12489,62608,208688
2009-10-09,ISE (I),75744578,15465964,47814449,139024991,1400123695.68,509420293.322,800142572.221,2709686561.22,235945,42337,157889,436171
2009-10-09,CHX (M),25586020,8759112,5847344,40192476,412342954.474,543800111.87,107380052.534,1063523118.88,8031,3360,4108,15499
2009-10-09,NYSE (N),990193466,0,0,990193466,25491576027.4,0.0,0.0,25491576027.4,2860549,0,0,2860549
2009-10-09,NYSE Arca (P),408096885,232848904,233545721,874491510,10440113885.3,10353252045.1,5425446073.58,26218812004.0,2156929,706310,1091598,3954837
2009-10-09,NASDAQ (Q),552652552,265347446,587908962,1405908960,13822640618.7,13095225185.1,13393248751.7,40311114555.6,2806886,812023,2370195,5989104
2009-10-09,CBOE (W),3579200,3592000,1507400,8678600,86175028.19,193390976.3,42256832.5,321822836.99,8105,6685,6211,21001
2009-10-09,BATS (Z),299646633,164535624,196947470,661129727,6844167329.4,6922032494.52,4196312325.99,17962512149.9,1741456,578315,1124177,3443948
2009-10-12,AMEX (A),0,23259118,0,23259118,0.0,110323436.15,0.0,110323436.15,0,34636,0,34636
2009-10-12,BEX (B),173661992,22690974,54941866,251294832,3388988056.18,845116712.83,1140617205.1,5374721974.11,1015307,104868,344495,1464670
2009-10-12,NSX (C),13716040,8269080,19210223,41195343,373336746.503,176521264.772,122561970.415,672419981.69,74679,15399,48346,138424
2009-10-12,NYSE (DN),12963859,2279363,11602959,26846181,368514894.468,95654845.33,250356914.407,714526654.205,34328,2639,25282,62249
2009-10-12,NASDAQ (DQ),1321930966,342788448,724162394,2388881808,26251122130.7,10872525213.3,13253357531.1,50377004875.1,3003045,610707,1610537,5224289
2009-10-12,ADF (D),32444730,3855600,16000400,52300730,674719274.4,130763718.48,303564469.86,1109047462.74,113999,12126,58281,184406
2009-10-12,ISE (I),74392419,12323477,43293301,130009197,1409721024.32,378438690.092,760831352.575,2548991066.99,220780,34266,139980,395026
2009-10-12,CHX (M),10724640,7408250,5571635,23704525,300699744.917,508901648.26,115168037.066,924769430.243,5010,3086,3855,11951
2009-10-12,NYSE (N),946919690,0,0,946919690,23825152189.1,0.0,0.0,23825152189.1,2665152,0,0,2665152
2009-10-12,NYSE Arca (P),407014847,196691291,213633857,817339995,9882962613.66,8553949116.37,5148803222.18,23585714952.2,2022893,598449,1023055,3644397
2009-10-12,NASDAQ (Q),534788506,221307018,524977857,1281073381,12931666740.4,11114037770.1,12015012703.7,36060717214.2,2545823,655887,2200895,5402605
2009-10-12,CBOE (W),3819800,2717100,1542900,8079800,98702862.0,159269857.0,43826463.87,301799182.87,6269,3669,4730,14668
2009-10-12,BATS (Z),281726459,136314165,180822383,598863007,6473672323.97,5939640671.03,3776934393.09,16190247388.1,1607827,488509,1035314,3131650
2009-10-13,AMEX (A),0,22165204,0,22165204,0.0,95589842.55,0.0,95589842.55,0,38733,0,38733
2009-10-13,BEX (B),212789130,35262059,71475780,319526969,4033311151.23,1282821876.83,1510638561.21,6826771589.27,1228884,161012,443936,1833832
2009-10-13,NSX (C),26163765,10414642,16955445,53533852,349321364.063,231851485.806,135607372.474,716780222.344,78533,18936,47364,144833
2009-10-13,NYSE (DN),15129649,2905609,11693372,29728630,405399030.752,137655497.963,243753437.924,786807966.639,35113,2971,24325,62409
2009-10-13,NASDAQ (DQ),1526480008,402029779,787349767,2715859554,30218546487.4,12933653187.2,14233682258.8,57385881933.3,3286149,725022,1683294,5694465
2009-10-13,ADF (D),36590990,3801500,21607200,61999690,793477539.05,134554815.83,433004643.51,1361036998.39,136320,13455,80532,230307
2009-10-13,ISE (I),76234551,14040317,42204205,132479073,1409138847.89,445298442.996,718844872.785,2573282163.67,227815,39605,140046,407466
2009-10-13,CHX (M),14645095,12869235,9117454,36631784,717076517.213,996898449.111,883179604.99,2597154571.31,5441,3639,3696,12776
2009-10-13,NYSE (N),1143498982,0,1300,1143500282,29212264313.2,0.0,9542.0,29212273855.2,3191384,0,2,3191386
2009-10-13,NYSE Arca (P),514264854,277896030,262746271,1054907155,12647930235.4,12523341970.3,6183401802.33,31354674008.0,2652346,882141,1214968,4749455
2009-10-13,NASDAQ (Q),652526779,310604171,644885791,1608016741,15878262172.7,15481301371.9,14809726217.6,46169289762.1,3210544,980590,2564617,6755751
2009-10-13,CBOE (W),3199400,7697100,1226100,12122600,81658345.13,356670945.97,31489170.2,469818461.3,7157,7592,6298,21047
2009-10-13,BATS (Z),360696572,193542179,216769153,771007904,8114902794.4,8477779857.84,4458232977.81,21050915630.0,2094301,743706,1235855,4073862
2009-10-14,AMEX (A),0,25667287,0,25667287,0.0,103018523.25,0.0,103018523.25,0,40367,0,40367
2009-10-14,BEX (B),285727775,47183113,93616726,426527614,5674031791.99,1701692555.3,1975610450.29,9351334797.59,1600650,186871,557373,2344894
2009-10-14,NSX (C),28356241,12698606,26146924,67201771,726161294.801,290120973.65,266024498.69,1282306767.14,137462,24122,76389,237973
2009-10-14,NYSE (DN),18502496,3834619,12954300,35291415,517804242.49,193541381.803,284012312.306,995357936.598,44937,3751,26157,74845
2009-10-14,NASDAQ (DQ),1948951196,556302355,931007006,3436260557,39263107299.2,19124733531.3,17307600911.0,75695441741.5,4111788,891549,2090381,7093718
2009-10-14,ADF (D),42886920,5598700,23005300,71490920,987955278.87,181986155.73,470098288.0,1640039722.6,159844,14056,84618,258518
2009-10-14,ISE (I),97310480,19547029,55749922,172607431,2049123691.19,608454888.811,967120098.439,3624698678.44,316649,51980,182726,551355
2009-10-14,CHX (M),13719385,11986266,7657931,33363582,356263475.555,895625391.04,105560595.312,1357449461.91,9179,4806,5219,19204
2009-10-14,NYSE (N),1350973868,0,0,1350973868,35521371989.0,0.0,0.0,35521371989.0,3660244,0,0,3660244
2009-10-14,NYSE Arca (P),660126889,363192631,313249371,1336568891,16735928746.3,15764644189.8,7781007126.92,40281580063.0,3196423,1016489,1470005,5682917
2009-10-14,NASDAQ (Q),843380982,403907779,738241985,1985530746,21231173125.2,19959902029.9,17464367026.9,58655442182.1,4011573,1168494,3065719,8245786
2009-10-14,CBOE (W),5339600,7572900,1563100,14475600,152669958.7,596428140.8,48322273.7,797420373.2,7223,6771,7007,21001
2009-10-14,BATS (Z),330052372,201638817,187330482,719021671,7394810631.55,8150821930.04,4069767234.21,19615399795.8,1779054,686277,1050238,3515569
2009-10-15,AMEX (A),0,27371927,0,27371927,0.0,116893482.72,0.0,116893482.72,0,41126,0,41126
2009-10-15,BEX (B),254008803,36197508,73600953,363807264,4929345881.41,1324358291.54,1575438914.43,7829143087.38,1422050,159618,450221,2031889
2009-10-15,NSX (C),27470657,12193096,25702742,65366495,769973022.957,278627708.605,241558518.125,1290159249.69,141499,22123,64365,227987
2009-10-15,NYSE (DN),19344242,3113684,13207840,35665766,504394661.804,156563816.815,291882877.536,952841356.155,44444,3168,27968,75580
2009-10-15,NASDAQ (DQ),1874956817,442850365,862226695,3180033877,37139604147.3,15537770021.6,16510313081.8,69187687250.7,3849056,756679,1820241,6425976
2009-10-15,ADF (D),45356800,5179800,21149700,71686300,951464930.65,178061696.29,433776382.42,1563303009.36,152074,13092,80592,245758
2009-10-15,ISE (I),113280103,19046372,49526398,181852873,2123593265.48,559385307.269,851953082.157,3534931654.91,308099,49280,162999,520378
2009-10-15,CHX (M),13154068,11852300,7619531,32625899,355910929.997,783362442.92,145045580.581,1284318953.5,8238,4509,4247,16994
2009-10-15,NYSE (N),1357921085,0,300,1357921385,35210499868.8,0.0,7394.0,35210507262.8,3501213,0,3,3501216
2009-10-15,NYSE Arca (P),666081671,278904147,247834859,1192820677,15960799872.9,13102227807.2,6746162475.21,35809190155.3,2944301,866327,1202959,5013587
2009-10-15,NASDAQ (Q),872462024,328321497,690041628,1890825149,20527225951.4,16779668513.2,17307445687.3,54614340151.9,3795611,1016282,2665676,7477569
2009-10-15,CBOE (W),4199300,2765000,3723400,10687700,80517363.86,124835716.2,135738220.45,341091300.51,7572,3738,6393,17703
2009-10-15,BATS (Z),422552649,184139843,208174422,814866914,9470583967.9,7648558792.25,4654000949.91,21773143710.1,2269511,699394,1230134,4199039
2009-10-16,AMEX (A),0,25014283,0,25014283,0.0,107914875.56,0.0,107914875.56,0,39888,0,39888
2009-10-16,BEX (B),225698141,38380642,70462409,334541192,4355096094.02,1370762757.81,1526370986.68,7252229838.51,1303614,157667,423306,1884587
2009-10-16,NSX (C),21468684,12727746,24930921,59127351,570593295.233,289570171.001,184755866.108,1044919332.34,114620,21661,59308,195589
2009-10-16,NYSE (DN),16190799,3596701,13567914,33355414,502776334.805,172285175.144,305723853.633,980785363.582,37328,3704,28370,69402
2009-10-16,NASDAQ (DQ),1651094279,469269332,822450041,2942813652,34272966328.0,16096733160.9,16375714232.4,66745413721.3,3835343,795254,1892030,6522627
2009-10-16,ADF (D),29640560,4153100,16453700,50247360,654677546.55,161829184.74,394984814.52,1211491545.81,101578,10878,59987,172443
2009-10-16,ISE (I),79634969,17884332,47649294,145168595,1703745031.25,559586315.576,947120203.074,3210451549.9,271606,46671,161517,479794
2009-10-16,CHX (M),15237883,10853551,8861296,34952730,534018876.726,824285010.367,218969348.615,1577273235.71,8584,4867,4293,17744
2009-10-16,NYSE (N),1386529541,0,3600,1386533141,36865021425.5,0.0,83754.0,36865105179.5,3466933,0,1,3466934
2009-10-16,NYSE Arca (P),574919852,305683617,268834275,1149437744,14500964312.2,14154074850.4,7445350633.76,36100389796.4,2802121,913411,1275822,4991354
2009-10-16,NASDAQ (Q),746143806,375751313,743466884,1865362003,18789462291.3,19039567151.9,18404255843.6,56233285286.8,3617516,1127219,2802629,7547364
2009-10-16,CBOE (W),4694700,3731500,4668400,13094600,111678244.69,244279482.35,141906488.5,497864215.54,6903,3766,5961,16630
2009-10-16,BATS (Z),392988615,210458620,216704927,820152162,9331681867.94,8773225856.99,4982977180.45,23087884905.4,2273477,751710,1268290,4293477
2009-10-19,AMEX (A),0,24594600,0,24594600,0.0,92463452.11,0.0,92463452.11,0,39642,0,39642
2009-10-19,BEX (B),205567416,34261815,66691319,306520550,3922171367.46,1249198558.48,1319473959.74,6490843885.68,1192557,149894,402411,1744862
2009-10-19,NSX (C),19721847,14336198,20285300,54343345,512343831.091,280943645.923,179704790.01,972992267.024,97555,23140,55313,176008
2009-10-19,NYSE (DN),16401159,2782215,11279037,30462411,494702427.976,140557221.215,241932751.424,877192400.615,37679,3120,27363,68162
2009-10-19,NASDAQ (DQ),1727795902,449823972,777279338,2954899212,32657195078.1,14472085118.0,15297068670.4,62426348866.4,3662577,739820,1819685,6222082
2009-10-19,ADF (D),45243480,3536100,22025800,70805380,936488778.77,110941220.0,540347044.1,1587777042.87,168550,10352,80928,259830
2009-10-19,ISE (I),82509519,17127364,44102802,143739685,1632065054.72,507343583.808,898411074.783,3037819713.31,257404,41871,152640,451915
2009-10-19,CHX (M),12295293,11059469,8458330,31813092,456404352.818,687911796.37,194051856.294,1338368005.48,7953,4780,4568,17301
2009-10-19,NYSE (N),1081527307,0,0,1081527307,27991599685.4,0.0,0.0,27991599685.4,3183657,0,0,3183657
2009-10-19,NYSE Arca (P),512357128,284967769,238747444,1036072341,13028595187.1,13494860048.2,6832626634.38,33356081869.7,2560071,822489,1182886,4565446
2009-10-19,NASDAQ (Q),701440696,316142107,609424476,1627007279,17571345129.3,15733745854.7,15815985565.0,49121076549.1,3378412,980261,2574758,6933431
2009-10-19,CBOE (W),3077100,3860400,1220000,8157500,81077002.46,316949111.1,66046236.4,464072349.96,2782,1356,2477,6615
2009-10-19,BATS (Z),363567382,173440225,202067002,739074609,8596711074.44,7060794777.98,4630243018.97,20287748871.4,2122209,662534,1194169,3978912
2009-10-20,AMEX (A),0,24697095,0,24697095,0.0,96875095.11,0.0,96875095.11,0,36524,0,36524
2009-10-20,BEX (B),245157950,37545281,67386070,350089301,4243820371.88,1413188241.6,1421068628.63,7078077242.11,1283829,167317,425894,1877040
2009-10-20,NSX (C),26155659,12164446,22993397,61313502,653603866.976,268107806.894,226074178.224,1147785852.09,121740,23561,58108,203409
2009-10-20,NYSE (DN),20271174,3712910,11791708,35775792,562207254.823,211324087.783,269648079.21,1043179421.82,44907,3619,26232,74758
2009-10-20,NASDAQ (DQ),1946528194,458876735,820832136,3226237065,37085484932.2,15854176095.0,17209533848.4,70149194875.6,3858160,749192,1853321,6460673
2009-10-20,ADF (D),54461180,5351600,22507900,82320680,1061523108.62,188758789.86,499895228.31,1750177126.79,183846,20242,86990,291078
2009-10-20,ISE (I),95885143,17600507,45564867,159050517,1859910408.41,622185868.141,929877160.617,3411973437.17,300649,45586,158998,505233
2009-10-20,CHX (M),21116980,16831463,11944072,49892515,827098365.612,1254879620.66,987780599.892,3069758586.16,8830,4668,5534,19032
2009-10-20,NYSE (N),1236996603,0,0,1236996603,30485312967.4,0.0,0.0,30485312967.4,3593627,0,0,3593627
2009-10-20,NYSE Arca (P),627094752,317654145,258393018,1203141915,15512516662.3,14783547113.2,7228633286.84,37524697062.3,3078739,978827,1311217,5368783
2009-10-20,NASDAQ (Q),857016193,377631108,683099309,1917746610,20310762251.0,19742019195.2,17871960788.2,57924742234.4,3948049,1164437,2894534,8007020
2009-10-20,CBOE (W),5219600,3878000,1658200,10755800,112359825.38,263693619.52,63924877.38,439978322.28,5633,2909,6271,14813
2009-10-20,BATS (Z),442502241,197921332,214818515,855242088,10051136890.1,8186950227.2,4967710614.87,23205797732.1,2515879,760197,1274500,4550576
2009-10-21,AMEX (A),0,27007512,0,27007512,0.0,99395933.16,0.0,99395933.16,0,42870,0,42870
2009-10-21,BEX (B),237794859,45743942,75020212,358559013,4406474737.97,1741274953.02,1447731217.2,7595480908.19,1379266,207654,466389,2053309
2009-10-21,NSX (C),26606699,14098826,27241355,67946880,688594340.515,318753451.643,233211557.055,1240559349.21,131555,26242,73062,230859
2009-10-21,NYSE (DN),20347043,5157509,14373482,39878034,595506064.237,298251046.04,326426166.589,1220183276.87,42474,4383,29551,76408
2009-10-21,NASDAQ (DQ),1904499944,565555777,992121003,3462176724,39588554782.9,18971708074.1,20709771342.8,79270034199.9,4289756,899384,2178105,7367245
2009-10-21,ADF (D),42281240,4234520,18780400,65296160,909768808.7,159415328.0,438322422.6,1507506559.3,143779,13838,72048,229665
2009-10-21,ISE (I),108622569,24436427,64186083,197245079,2239061849.74,753921643.406,1282489060.66,4275472553.81,361873,59307,224676,645856
2009-10-21,CHX (M),19810209,20872381,9498597,50181187,590277919.853,1334808277.33,253609757.461,2178695954.64,9902,4940,5143,19985
2009-10-21,NYSE (N),1406180862,0,0,1406180862,36352695874.3,0.0,0.0,36352695874.3,4163721,0,0,4163721
2009-10-21,NYSE Arca (P),670492635,353858369,312203881,1336554885,17470327484.1,16179024841.5,8364318657.01,42013670982.6,3506154,1079311,1527662,6113127
2009-10-21,NASDAQ (Q),921459934,448072552,833532877,2203065363,23594770784.4,24222839109.0,21043320188.9,68860930082.2,4571239,1367202,3430709,9369150
2009-10-21,CBOE (W),2527200,3932200,2796400,9255800,68190766.57,240275711.99,98795904.48,407262383.04,7966,3608,6793,18367
2009-10-21,BATS (Z),470427488,246047629,258844082,975319199,11130283043.9,10324190648.4,5656084816.56,27110558508.9,2832688,932731,1527285,5292704
2009-10-22,AMEX (A),0,21485311,0,21485311,0.0,78885825.17,0.0,78885825.17,0,36867,0,36867
2009-10-22,BEX (B),222031618,40441354,66737794,329210766,4125034305.45,1539022430.69,1288124459.04,6952181195.18,1284927,177371,427412,1889710
2009-10-22,NSX (C),21709177,12410943,20646310,54766430,570022494.864,297684621.163,233566011.028,1101273127.05,121237,22500,72175,215912
2009-10-22,NYSE (DN),18681682,3958560,13727750,36367992,557376409.787,196591288.356,301037049.835,1055004747.98,38293,3959,29359,71611
2009-10-22,NASDAQ (DQ),1840499111,559500040,885207598,3285206749,39113490120.0,20047576978.7,18373110633.8,77534177732.5,4282097,880976,2115374,7278447
2009-10-22,ISE (I),85180273,18605334,48275472,152061079,1866592238.97,622726419.182,956445995.91,3445764654.06,308673,48011,171177,527861
2009-10-22,CHX (M),15122784,13627589,5316336,34066709,403682750.278,957444465.16,144071775.125,1505198990.56,11069,4915,4682,20666
2009-10-22,NYSE (N),1314853201,0,0,1314853201,34944943978.3,0.0,0.0,34944943978.3,3987319,0,0,3987319
2009-10-22,NYSE Arca (P),626532821,332203677,285138247,1243874745,16337832335.2,14943533826.1,7392454783.19,38673820944.5,3217941,970338,1407022,5595301
2009-10-22,NASDAQ (Q),853558224,424832493,750502929,2028893646,22180025785.2,22407679693.3,18647455440.9,63235160919.4,4339472,1287472,3201722,8828666
2009-10-22,CBOE (W),4218200,3260900,1475000,8954100,108105477.1,177979944.5,50324347.87,336409769.47,8404,4871,6433,19708
2009-10-22,BATS (Z),406233963,234312026,223883718,864429707,9756146224.23,9512229652.86,4971464348.36,24239840225.5,2415264,793140,1309388,4517792
2009-10-23,AMEX (A),0,19122656,0,19122656,0.0,80433721.59,0.0,80433721.59,0,34267,0,34267
2009-10-23,BEX (B),208352669,39185923,70168188,317706780,3780580042.13,1506687999.35,1415735569.73,6703003611.21,1213447,172952,439690,1826089
2009-10-23,NSX (C),19749991,10893808,23232296,53876095,526598957.63,302805217.086,247703125.663,1077107300.38,108170,21850,65885,195905
2009-10-23,NYSE (DN),16063589,4096857,14118459,34278905,441871357.044,226559968.135,347601799.522,1016033124.7,33073,3531,28703,65307
2009-10-23,NASDAQ (DQ),1574546505,496365180,928594506,2999506191,32656742970.4,18457782190.6,20975131400.3,72089656561.3,3935622,840001,2201749,6977372
2009-10-23,ISE (I),85001512,16988305,51377200,153367017,1715836656.08,594372854.305,1187101964.06,3497311474.45,286123,46893,180977,513993
2009-10-23,CHX (M),10836699,12928606,6700967,30466272,381188445.852,1106502503.66,198787518.73,1686478468.24,8064,5318,5298,18680
2009-10-23,NYSE (N),1277205192,0,0,1277205192,33239351165.2,0.0,0.0,33239351165.2,3993365,0,0,3993365
2009-10-23,NYSE Arca (P),575189991,328976757,319210555,1223377303,14831931804.1,15259996951.5,9021742370.7,39113671126.3,3021238,1031299,1522592,5575129
2009-10-23,NASDAQ (Q),775675949,436289016,811896528,2023861493,19740457567.6,23608654977.7,21731907959.8,65081020505.2,4025206,1425055,3313443,8763704
2009-10-23,CBOE (W),2638500,2759700,4118400,9516600,66229277.77,132853659.1,157801136.83,356884073.7,8430,5454,7253,21137
2009-10-23,BATS (Z),383498316,236206895,251297279,871002490,8965175068.73,10016987843.6,6109281903.72,25091444816.0,2300014,868696,1404069,4572779
2009-10-26,AMEX (A),0,21232362,0,21232362,0.0,84136696.96,0.0,84136696.96,0,38738,0,38738
2009-10-26,BEX (B),241744018,47394915,76025823,365164756,4113893263.07,1817776009.94,1487182075.37,7418851348.38,1305278,205441,476158,1986877
2009-10-26,NSX (C),19741862,15915332,22898923,58556117,479791659.031,415920518.16,178224717.895,1073936895.09,99612,28503,58067,186182
2009-10-26,NYSE (DN),17795113,4959503,14520645,37275261,498335871.592,258579273.178,319641302.601,1076556447.37,36236,4698,28682,69616
2009-10-26,NASDAQ (DQ),1869286908,572496160,883168793,3324951861,35975009487.3,19346013273.9,18200850542.1,73521873303.3,4188854,985475,2132059,7306388
2009-10-26,ISE (I),98678501,24439800,52497247,175615548,1843486239.03,757570396.287,1058723183.72,3659779819.04,315720,60332,178073,554125
2009-10-26,CHX (M),11299088,13481741,7163035,31943864,383351976.537,1207897223.51,185717342.109,1776966542.15,9674,7024,5531,22229
2009-10-26,NYSE (N),1388274476,0,0,1388274476,34801862167.4,0.0,0.0,34801862167.4,4343276,0,0,4343276
2009-10-26,NYSE Arca (P),685982451,386659022,301314781,1373956254,16425234334.8,17635158669.3,7674686279.13,41735079283.2,3395620,1165738,1531323,6092681
2009-10-26,NASDAQ (Q),956145063,473610782,749549607,2179305452,22780318077.0,24807815565.2,18845891476.4,66434025118.6,4667133,1569547,3337228,9573908
2009-10-26,CBOE (W),4696900,6601000,1751400,13049300,159048311.73,341652116.6,60071933.55,560772361.88,14312,8690,8480,31482
2009-10-26,BATS (Z),439924697,275205141,236945569,952075407,9677094236.92,11501632825.4,5219432254.19,26398159316.5,2510427,975275,1395143,4880845
2009-10-27,AMEX (A),0,18197149,0,18197149,0.0,73660557.48,0.0,73660557.48,0,35734,0,35734
2009-10-27,BEX (B),188892009,47005304,66378702,302276015,3246831852.44,1754545757.89,1250509156.22,6251886766.56,1018823,198122,383006,1599951
2009-10-27,NSX (C),26669985,13112562,22435451,62217998,594979827.171,371280380.0,215966606.591,1182226813.76,125302,28271,64277,217850
2009-10-27,NYSE (DN),20320927,5432641,14873621,40627189,551474505.245,280014054.67,314405532.289,1145894092.2,40636,4875,29288,74799
2009-10-27,NASDAQ (DQ),1763368321,588026916,917066511,3268461748,35999384013.1,22758218402.0,19104866817.6,77862469232.7,4274658,951834,2164148,7390640
2009-10-27,ISE (I),81118590,22216918,51088534,154424042,1651185815.03,798195279.603,1064045454.15,3513426548.79,310976,60461,186510,557947
2009-10-27,CHX (M),17631498,20170523,11737363,49539384,901572347.153,1760650480.47,1280778515.29,3943001342.91,10685,7911,7474,26070
2009-10-27,NYSE (N),1396457535,0,3000,1396460535,35897670325.5,0.0,11535.0,35897681860.5,4487152,0,1,4487153
2009-10-27,NYSE Arca (P),664120594,388659091,312686898,1365466583,16482223498.7,17461084545.8,8500755525.38,42444063569.9,3423094,1155885,1514248,6093227
2009-10-27,NASDAQ (Q),955075954,470561435,793659155,2219296544,23635728902.2,24102904351.0,20358664404.5,68097297657.7,4977562,1658518,3474809,10110889
2009-10-27,CBOE (W),6173300,2986700,1894900,11054900,117102917.73,180463346.7,62445428.23,360011692.66,9770,8336,7222,25328
2009-10-27,BATS (Z),417928477,263834524,235301389,917064390,9492342875.1,10784102836.6,5104190313.54,25380636025.2,2429988,932127,1327101,4689216
2009-10-28,AMEX (A),0,23286475,0,23286475,0.0,93732268.49,0.0,93732268.49,0,43698,0,43698
2009-10-28,BEX (B),247679297,57823970,78396246,383899513,3913754994.82,2039137714.82,1439696737.13,7392589446.76,1195322,221406,433329,1850057
2009-10-28,NSX (C),29817035,14458594,24853596,69129225,682878898.228,399606212.026,218542618.645,1301027728.9,140496,29162,63159,232817
2009-10-28,NYSE (DN),26740132,6145564,17193564,50079260,684365335.898,320887102.835,372014803.203,1377267241.94,48528,5407,36100,90035
2009-10-28,NASDAQ (DQ),2231160623,700376063,1078601971,4010138657,41502909174.4,23509643458.1,20811642951.9,85824195584.4,5041554,1192342,2464637,8698533
2009-10-28,ISE (I),107850666,27334470,54452934,189638070,1943704478.93,927684072.594,1030323888.19,3901712439.71,385346,75034,215365,675745
2009-10-28,CHX (M),18355337,18086678,10899887,47341902,478037131.12,1560919187.75,234573751.074,2273530069.94,17646,8625,7950,34221
2009-10-28,NYSE (N),1678598506,0,0,1678598506,39410473379.3,0.0,0.0,39410473379.3,5003388,0,0,5003388
2009-10-28,NYSE Arca (P),797354863,476502237,356991591,1630848691,18397593316.0,20781903842.5,8987887985.19,48167385143.7,3868397,1318750,1682389,6869536
2009-10-28,NASDAQ (Q),1142333105,551392706,912535873,2606261684,26312933933.1,26733642402.1,21731063075.9,74777639411.1,5504740,1857971,3772777,11135488
2009-10-28,CBOE (W),5646200,7106800,2792900,15545900,129760191.75,331150758.83,84750389.0,545661339.58,12209,8682,8475,29366
2009-10-28,BATS (Z),494877487,309869169,274278277,1079024933,10429618945.5,12698223726.7,5623615997.8,28751458670.0,2725067,1058200,1498471,5281738
2009-10-29,AMEX (A),0,19172641,0,19172641,0.0,73894788.31,0.0,73894788.31,0,35171,0,35171
2009-10-29,BEX (B),229740493,46728141,68492449,344961083,3885541816.71,1673723886.0,1301891727.39,6861157430.1,1195092,188472,414697,1798261
2009-10-29,NSX (C),26100203,13420208,22828030,62348441,580201193.225,368868056.776,225691156.311,1174760406.31,123439,24958,60000,208397
2009-10-29,NYSE (DN),20963163,3933412,14646022,39542597,544765392.478,206195936.838,307537458.203,1058498787.52,41602,4022,30605,76229
2009-10-29,NASDAQ (DQ),2008097123,577223834,880705915,3466026872,39084174704.0,20231815380.0,17550317452.2,76866307536.3,4441443,944323,2121984,7507750
2009-10-29,ISE (I),94086789,22484467,49940862,166512118,1760920053.91,735491039.393,910544058.651,3406955151.95,323352,58374,187218,568944
2009-10-29,CHX (M),13098672,11646555,6240274,30985501,362034268.42,974411292.488,217843997.424,1554289558.33,10561,5381,4351,20293
2009-10-29,NYSE (N),1454998412,0,0,1454998412,35647312711.9,0.0,0.0,35647312711.9,4255772,0,0,4255772
2009-10-29,NYSE Arca (P),742220583,370953942,306084684,1419259209,17401944706.4,16387015794.3,7599372903.2,41388333404.0,3558620,1093075,1542312,6194007
2009-10-29,NASDAQ (Q),879988185,424852759,759912351,2064753295,21156304001.0,20777526892.8,17983280864.4,59917111758.2,4578777,1472798,3205553,9257128
2009-10-29,CBOE (W),3472600,4221100,1891700,9585400,75063578.2,216602442.6,64324449.35,355990470.15,9201,6114,6532,21847
2009-10-29,BATS (Z),425908438,250602327,234003318,910514083,9339792412.16,10444996241.5,4875309988.3,24660098642.0,2430323,876696,1351695,4658714
2009-10-30,AMEX (A),0,18902476,0,18902476,0.0,83468368.42,0.0,83468368.42,0,35026,0,35026
2009-10-30,BEX (B),274778204,69911432,75045740,419735376,4720412309.54,2470042937.38,1448269468.2,8638724715.13,1546204,290874,469906,2306984
2009-10-30,NSX (C),46227445,19842674,22876710,88946829,851446094.744,605695790.587,293897653.428,1751039538.76,177764,40215,70182,288161
2009-10-30,NYSE (DN),21897219,6531924,15253037,43682180,549070210.656,348580328.864,310822027.556,1208472567.08,42694,6204,32028,80926
2009-10-30,NASDAQ (DQ),2181385091,753037138,983015559,3917437788,41541726381.9,27273894458.6,19402575337.8,88218196178.4,5073022,1228952,2304685,8606659
2009-10-30,ISE (I),119264181,29984683,58253601,207502465,2151747276.14,1087904124.46,1076167304.19,4315818704.79,398261,79568,222299,700128
2009-10-30,CHX (M),19862139,24209799,6827270,50899208,474421052.561,2061041375.38,168952761.758,2704415189.7,12298,9597,5245,27140
2009-10-30,NYSE (N),1654952525,0,0,1654952525,40201209380.6,0.0,0.0,40201209380.6,4655317,0,0,4655317
2009-10-30,NYSE Arca (P),884280481,555156146,335859229,1775295856,21002278330.8,24418021148.7,8495568392.09,53915867871.6,4679960,1606284,1726242,8012486
2009-10-30,NASDAQ (Q),1196205367,671603139,942530575,2810339081,29263766017.5,34312354595.5,21703647526.2,85279768139.3,6518706,2367993,3744782,12631481
2009-10-30,CBOE (W),4045400,5485900,2051900,11583200,102276128.57,337764271.3,67470763.8,507511163.67,11826,10623,6947,29396
2009-10-30,BATS (Z),565319381,387534336,266790456,1219644173,12393439880.5,16022659275.3,5670538534.6,34086637690.3,3272258,1367133,1576348,6215739
2009-11-02,AMEX (A),0,18645788,0,18645788,0.0,77031667.66,0.0,77031667.66,0,35256,0,35256
2009-11-02,BEX (B),219520075,64895342,62402516,346817933,3503104037.33,2406355659.33,1173971254.48,7083430951.14,1074599,279005,361064,1714668
2009-11-02,NSX (C),54157191,16232397,24469876,94859464,856613008.102,459099392.274,263861417.5,1579573817.88,171600,35196,67099,273895
2009-11-02,NYSE (DN),18330631,5938578,15147239,39416448,437732445.804,291227096.868,304841398.075,1033800940.75,36752,5158,30312,72222
2009-11-02,NASDAQ (DQ),2035603735,709889707,861653762,3607147204,34999166991.2,23719184159.6,16790604234.7,75508955385.6,4494119,1147451,2135185,7776755
2009-11-02,ADF (D),44588891,10863300,23556500,79008691,799038470.91,360598419.63,427734278.28,1587371168.82,152807,33993,86038,272838
2009-11-02,ISE (I),94905004,24432205,45306395,164643604,1514020005.92,856877064.722,827176324.539,3198073395.18,294654,64459,175264,534377
2009-11-02,CHX (M),18605064,21819587,10396845,50821496,458895411.912,1888149250.63,187843301.252,2534887963.8,11877,10526,4056,26459
2009-11-02,NYSE (N),1545630989,0,0,1545630989,34721918392.4,0.0,0.0,34721918392.4,4745512,0,0,4745512
2009-11-02,NYSE Arca (P),777456733,470383328,331815750,1579655811,16932462316.3,20257107512.7,8028449787.02,45218019616.0,3703554,1408971,1668543,6781068
2009-11-02,NASDAQ (Q),1095117818,587711922,797589591,2480419331,24320718042.3,27371646520.5,18769840849.2,70462205412.1,5326904,2051278,3538061,10916243
2009-11-02,CBOE (W),4399200,7537500,2418600,14355300,82782905.11,370056755.06,83679778.52,536519438.69,11312,9566,10169,31047
2009-11-02,BATS (Z),475651249,358097477,256500250,1090248976,9818321354.62,13998847257.9,5185824530.62,29002993143.1,2653390,1222601,1484813,5360804
2009-11-03,AMEX (A),0,19231636,0,19231636,0.0,80023035.84,0.0,80023035.84,0,37714,0,37714
2009-11-03,BEX (B),200781739,52562195,55531622,308875556,3496771922.43,1957027434.21,1009264883.55,6463064240.18,1021680,236117,335110,1592907
2009-11-03,NSX (C),22844129,13803453,21254099,57901681,556190919.806,378670453.001,195431926.525,1130293299.33,111850,28988,57454,198292
2009-11-03,NYSE (DN),19349320,5616368,12922089,37887777,534839104.61,300656544.486,264889313.705,1100384962.8,39229,5571,29965,74765
2009-11-03,NASDAQ (DQ),1815955472,596093027,794338118,3206386617,37420339071.7,20277252633.1,15267685606.1,72965277310.9,4253302,936862,1987066,7177230
2009-11-03,ADF (D),40353931,10699000,19952200,71005131,912741172.43,412062392.18,404045786.73,1728849351.34,153681,28476,79163,261320
2009-11-03,ISE (I),75680923,21112855,38775396,135569174,1621881639.88,675770112.932,685088689.017,2982740441.83,293896,57013,157694,508603
2009-11-03,CHX (M),20075025,23528075,9863109,53466209,983079852.613,2015318606.4,784324847.431,3782723306.44,10688,8541,4851,24080
2009-11-03,NYSE (N),1380839024,0,0,1380839024,35142622070.6,0.0,0.0,35142622070.6,4426161,0,0,4426161
2009-11-03,NYSE Arca (P),700141025,386008404,284225182,1370374611,17438534339.1,17077801179.6,6493245692.45,41009581211.1,3512917,1216310,1469332,6198559
2009-11-03,NASDAQ (Q),962645334,470718010,727875515,2161238859,23840225238.8,23390348955.1,16405011017.5,63635585211.3,4977039,1724453,3194980,9896472
2009-11-03,CBOE (W),3541100,3869500,1660700,9071300,102641676.36,208547448.86,54150364.09,365339489.31,9099,7632,8312,25043
2009-11-03,BATS (Z),446536564,279784514,224753770,951074848,10105290050.9,11270143532.2,4558164581.91,25933598165.0,2540588,1026284,1331075,4897947
2009-11-04,AMEX (A),0,19161847,0,19161847,0.0,84510133.96,0.0,84510133.96,0,36918,0,36918
2009-11-04,BEX (B),199672540,56114287,57312702,313099529,3447966180.56,2082408171.03,1103299925.11,6633674276.7,999443,228385,343416,1571244
2009-11-04,NSX (C),24819454,13069808,21751320,59640582,616818046.311,405447804.703,207589042.312,1229854893.33,124658,27743,57285,209686
2009-11-04,NYSE (DN),19655865,5955740,15168418,40780023,531636769.086,315488312.707,317667398.743,1164792480.53,41968,5785,32401,80154
2009-11-04,NASDAQ (DQ),1884637782,577819575,808518392,3270975749,36594716175.8,20362413713.0,15736077532.5,72693207421.4,4249543,943691,2059098,7252332
2009-11-04,ADF (D),45565412,9216900,21770400,76552712,970726036.39,328190567.28,420178453.07,1719095056.74,172829,25564,86418,284811
2009-11-04,ISE (I),88868608,23471084,45445136,157784828,1729834129.63,789702953.652,811473465.561,3331010548.84,309135,61911,171495,542541
2009-11-04,CHX (M),10000154,18143701,7248435,35392290,333844650.895,1539202503.49,125821721.736,1998868876.12,9475,6086,4344,19905
2009-11-04,NYSE (N),1350162304,0,0,1350162304,34056789664.8,0.0,0.0,34056789664.8,4394408,0,0,4394408
2009-11-04,NYSE Arca (P),715179194,414508120,306147748,1435835062,17640164356.9,18638287228.6,6991472047.08,43269923632.6,3666925,1251867,1588202,6506994
2009-11-04,NASDAQ (Q),984122917,503463429,733972276,2221558622,24754747584.2,25899060521.3,17127843620.3,67781651725.8,5040677,1760086,3338033,10138796
2009-11-04,CBOE (W),4165400,2596800,2645100,9407300,176295792.5,134365053.27,91133196.25,401794042.02,11910,7691,9049,28650
2009-11-04,BATS (Z),458553449,302418103,236842595,997814147,10323402934.0,12518635672.9,4857488338.24,27699526945.1,2653115,1073654,1428632,5155401
2009-11-05,AMEX (A),0,13477836,0,13477836,0.0,58135435.29,0.0,58135435.29,0,27596,0,27596
2009-11-05,BEX (B),169055427,42618883,48170181,259844491,3112353932.53,1538997681.17,940721719.182,5592073332.88,895003,168835,293651,1357489
2009-11-05,NSX (C),18175166,10549710,21952789,50677665,482434553.165,293840051.074,171208875.396,947483479.636,95276,21490,48694,165460
2009-11-05,NYSE (DN),19027419,3277411,13583315,35888145,480379001.664,170950021.871,285868160.178,937197183.713,41125,3247,31682,76054
2009-11-05,NASDAQ (DQ),1646165822,482585588,877228754,3005980164,33975922499.0,15890204452.3,18955232701.0,68821359652.4,3866631,764704,1977093,6608428
2009-11-05,ADF (D),41047960,7157800,21596920,69802680,908083337.62,220230956.32,457280790.93,1585595084.87,165839,18306,89598,273743
2009-11-05,ISE (I),76794801,18056293,45196286,140047380,1538974122.67,574438908.484,788609397.331,2902022428.49,273351,45315,161489,480155
2009-11-05,CHX (M),12775803,14484044,10214988,37474835,406356121.834,1222589987.33,171805698.837,1800751808.0,7143,4911,4219,16273
2009-11-05,NYSE (N),1303229011,0,0,1303229011,32944986810.6,0.0,0.0,32944986810.6,3804476,0,0,3804476
2009-11-05,NYSE Arca (P),598611955,310871101,288373500,1197856556,14904855527.3,13654928587.1,6825556124.39,35385340238.8,3067256,911528,1412978,5391762
2009-11-05,NASDAQ (Q),816877739,363887204,719381080,1900146023,20618200924.4,17949002284.7,17166062429.2,55733265638.2,4278793,1232463,2941960,8453216
2009-11-05,CBOE (W),2726400,3515900,1495700,7738000,72677630.04,195926237.32,43219094.45,311822961.81,7409,6425,6267,20101
2009-11-05,BATS (Z),384123495,223609784,224002267,831735546,8892921050.46,9226503532.4,4782267864.26,22901692447.1,2245958,764127,1271047,4281132
2009-11-06,AMEX (A),0,13043386,0,13043386,0.0,57303925.8,0.0,57303925.8,0,27088,0,27088
2009-11-06,BEX (B),152689414,36553345,47964229,237206988,2829347552.45,1346652642.59,858037160.426,5034037355.47,846899,153832,284200,1284931
2009-11-06,NSX (C),16988274,10544564,18043868,45576706,438913945.412,282107568.875,155766310.343,876787824.63,83451,20047,43938,147436
2009-11-06,NYSE (DN),18028125,3524034,11908632,33460791,400270070.387,196761020.242,255276464.717,852307555.345,37144,3248,28384,68776
2009-11-06,NASDAQ (DQ),1441428636,439988104,668307599,2549724339,29924631079.3,14381991048.0,13404335948.4,57710958075.7,3476514,741015,1641003,5858532
2009-11-06,ADF (D),33120320,5413700,14912100,53446120,652779595.67,176129793.99,298510197.65,1127419587.31,131997,16567,62480,211044
2009-11-06,ISE (I),63984829,16383558,36506696,116875083,1327512352.36,498268541.402,671427401.771,2497208295.53,234056,41415,132671,408142
2009-11-06,CHX (M),15614822,13793352,5298296,34706470,369722367.661,1137181483.29,159506414.677,1666410265.63,6517,4935,3662,15114
2009-11-06,NYSE (N),1084724922,0,1300,1084726222,27180984625.5,0.0,13865.0,27180998490.5,3383067,0,2,3383069
2009-11-06,NYSE Arca (P),512920512,285598403,236821229,1035340144,12275323966.7,12600330592.4,5647369562.11,30523024121.2,2630996,910770,1202974,4744740
2009-11-06,NASDAQ (Q),732191222,345393263,603519079,1681103564,18116713832.4,17851228086.8,14177117817.6,50145059736.8,3840227,1233704,2610357,7684288
2009-11-06,CBOE (W),2731900,4883400,2069600,9684900,79047445.66,316328201.85,56607864.8,451983512.31,6974,6025,5971,18970
2009-11-06,BATS (Z),342527000,201482401,199802671,743812072,7926987786.54,8521284103.22,4083328547.34,20531600437.1,2024017,754651,1126340,3905008
2009-11-09,AMEX (A),0,17329810,0,17329810,0.0,73293544.59,0.0,73293544.59,0,34266,0,34266
2009-11-09,BEX (B),163193862,37184220,50749388,251127470,3107806855.93,1288131619.18,989648261.285,5385586736.39,866719,144734,297626,1309079
2009-11-09,NSX (C),20051476,10630238,22350222,53031936,541501617.332,286070554.084,188647538.853,1016219710.27,101754,20926,49559,172239
2009-11-09,NYSE (DN),18188237,3224056,13165052,34577345,494543868.755,145853444.268,292336324.526,932733637.549,44181,3376,32424,79981
2009-11-09,NASDAQ (DQ),1578836147,514203508,801158458,2894198113,32916638417.1,17782282834.9,16214734121.6,66913655373.7,3760987,803617,1827092,6391696
2009-11-09,ADF (D),37524470,7817200,16774100,62115770,833813828.65,285712356.11,363168202.56,1482694387.32,144536,22999,66362,233897
2009-11-09,ISE (I),73234022,19624311,44773999,137632332,1520314824.78,563921182.37,834912642.018,2919148649.17,250848,47597,153435,451880
2009-11-09,CHX (M),18073041,12355572,8533923,38962536,1006813604.76,974965372.14,875598017.889,2857376994.79,6658,4400,4758,15816
2009-11-09,NYSE (N),1236198682,0,0,1236198682,32328948944.8,0.0,0.0,32328948944.8,3408930,0,0,3408930
2009-11-09,NYSE Arca (P),508517508,296116915,248113632,1052748055,13250106707.3,12710403296.2,6265281865.17,32225791868.7,2592504,849147,1241599,4683250
2009-11-09,NASDAQ (Q),721584450,327241123,638106075,1686931648,19139557775.4,16664217947.2,15739335734.7,51543111457.2,3692040,1095576,2595318,7382934
2009-11-09,CBOE (W),2854200,1687700,2356200,6898100,99352223.98,78675044.57,70431214.0,248458482.55,6564,4653,6069,17286
2009-11-09,BATS (Z),325223356,197449782,200650609,723323747,7776438171.61,8214281857.77,4397305587.4,20388025616.8,1852271,662198,1115916,3630385
2009-11-10,AMEX (A),0,14963516,0,14963516,0.0,75684291.8,0.0,75684291.8,0,29040,0,29040
2009-11-10,BEX (B),155312036,35367331,52574135,243253502,2790548746.55,1238429752.85,955894593.0,4984873092.4,834684,145108,305374,1285166
2009-11-10,NSX (C),23641385,9958552,19277296,52877233,512254025.273,261681724.532,187982820.33,961918570.135,94539,19516,47207,161262
2009-11-10,NYSE (DN),91092177,13741092,39913562,144746831,2131737199.02,654037609.923,850848681.964,3636623490.91,294094,21589,120834,436517
2009-11-10,NASDAQ (DQ),1516213500,438752649,744382700,2699348849,30521892150.9,15988108129.0,14879106150.7,61389106430.6,3418688,753320,1754247,5926255
2009-11-10,ADF (D),32756440,6699000,20081000,59536440,738445804.89,239338231.01,378513019.59,1356297055.49,138107,19949,84310,242366
2009-11-10,ISE (I),74445618,16474284,42599650,133519552,1422767460.65,518482766.863,788672019.899,2729922247.41,248120,42579,147290,437989
2009-11-10,CHX (M),11490855,13126411,5938373,30555639,396055201.311,1163451240.99,136814983.088,1696321425.38,8367,4417,3647,16431
2009-11-10,NYSE (N),1073044792,0,0,1073044792,27371510685.0,0.0,0.0,27371510685.0,3214747,0,0,3214747
2009-11-10,NYSE Arca (P),502041179,271784543,245231863,1019057585,12550838769.9,12188975651.4,6060849221.41,30800663642.7,2603519,891592,1214612,4709723
2009-11-10,NASDAQ (Q),732318229,332258293,644996388,1709572910,18890917092.0,17102923359.0,15627588483.6,51621428934.5,3859094,1205704,2748187,7812985
2009-11-10,CBOE (W),3228300,3122000,2214700,8565000,83673962.0,147280261.0,57976459.01,288930682.01,6784,6077,6031,18892
2009-11-10,BATS (Z),333898707,193737121,205922436,733558264,7900673535.04,8149473427.22,4357140505.8,20407287468.1,1981065,708630,1182730,3872425
2009-11-11,AMEX (A),0,13985414,0,13985414,0.0,65914246.23,0.0,65914246.23,0,29109,0,29109
2009-11-11,BEX (B),162649632,38951235,47880571,249481438,3045499105.41,1377003073.98,936915749.219,5359417928.61,889770,159502,296760,1346032
2009-11-11,NSX (C),22404765,9806463,17253034,49464262,519419582.511,270695085.668,151223071.563,941337739.742,94549,19540,42682,156771
2009-11-11,NYSE (DN),92376752,14379362,35400260,142156374,2180851975.38,557503231.298,768064351.16,3506419557.84,285247,17675,109728,412650
2009-11-11,NASDAQ (DQ),1463203054,478560609,688983851,2630747514,29044784475.9,16021518165.4,13696911755.3,58763214396.7,3384224,805185,1628430,5817839
2009-11-11,ADF (D),30406910,7944130,17092370,55443410,711423594.24,232641222.46,354122562.42,1298187379.12,124479,19074,70574,214127
2009-11-11,ISE (I),71110469,16040450,38333988,125484907,1429940735.94,559734749.81,726268201.901,2715943687.65,239649,42530,133102,415281
2009-11-11,CHX (M),11638437,13645820,5022175,30306432,362972209.639,1055358719.71,97505460.4514,1515836389.8,6604,4240,3541,14385
2009-11-11,NYSE (N),1046188180,0,0,1046188180,27030793691.0,0.0,0.0,27030793691.0,3220233,0,0,3220233
2009-11-11,NYSE Arca (P),494765936,289871173,246619335,1031256444,12528911175.0,13360794369.7,6202112799.85,32091818344.6,2600639,953180,1202130,4755949
2009-11-11,NASDAQ (Q),739503988,367307197,613491780,1720302965,19268922950.5,19045391399.4,15079240063.1,53393554413.1,3886312,1306764,2574907,7767983
2009-11-11,CBOE (W),2817000,2639500,1785300,7241800,82099624.13,135365604.62,64085262.22,281550490.97,7631,6550,5834,20015
2009-11-11,BATS (Z),326792218,212601071,190356600,729749889,7523390530.22,8777908772.55,4186057846.6,20487357149.4,1932157,775318,1128568,3836043
2009-11-12,AMEX (A),0,16873666,0,16873666,0.0,80261658.18,0.0,80261658.18,0,35138,0,35138
2009-11-12,BEX (B),155161638,37473962,50968512,243604112,2993709412.41,1386867726.29,914981621.685,5295558760.38,852687,158632,286750,1298069
2009-11-12,NSX (C),19008942,12017116,24399608,55425666,454568924.391,318587621.986,169503521.1,942660067.478,86116,22456,48582,157154
2009-11-12,NYSE (DN),97632843,16350821,40507392,154491056,2421418423.77,670005010.676,811951323.503,3903374757.95,299525,21997,116805,438327
2009-11-12,NASDAQ (DQ),1329092664,477908444,804949476,2611950584,28175973999.8,15936418001.4,14058532562.7,58170924563.9,3334391,791660,1694453,5820504
2009-11-12,ADF (D),28174670,8320700,18653500,55148870,657391151.75,254485321.92,379215224.89,1291091698.56,118465,24459,67561,210485
2009-11-12,ISE (I),60995857,17363035,47422655,125781547,1307791849.07,544038172.955,756310977.729,2608140999.76,222938,47858,140687,411483
2009-11-12,CHX (M),12326269,16669285,10136164,39131718,374932088.586,1018952702.83,271904947.189,1665789738.6,7448,4735,3888,16071
2009-11-12,NYSE (N),1050433179,0,0,1050433179,27999743717.8,0.0,0.0,27999743717.8,3282609,0,0,3282609
2009-11-12,NYSE Arca (P),502267483,319378185,302124002,1123769670,12920377484.2,13823318604.7,6218128586.1,32961824674.9,2684123,1011497,1282171,4977791
2009-11-12,NASDAQ (Q),728790308,390000278,715038906,1833829492,19202672126.1,19835857618.3,15332351249.5,54370880993.8,3906161,1414542,2661390,7982093
2009-11-12,CBOE (W),2398800,3523500,1545400,7467700,59189431.98,159623315.84,84282452.68,303095200.5,7199,7557,3431,18187
2009-11-12,BATS (Z),326823234,220765551,230505438,778094223,7911558161.75,8958752057.48,4442039369.38,21312349588.6,2007418,817113,1226631,4051162
2009-11-13,AMEX (A),0,12931083,0,12931083,0.0,57918068.24,0.0,57918068.24,0,28831,0,28831
2009-11-13,BEX (B),146405722,34848104,47541496,228795322,2733951199.91,1303534052.91,894813509.773,4932298762.59,807270,149082,278866,1235218
2009-11-13,NSX (C),15691645,10925818,23484713,50102176,376717717.995,289509206.251,124766080.512,790993004.757,70989,20839,38288,130116
2009-11-13,NYSE (DN),102920123,12873497,44183960,159977580,2506678398.4,623565669.276,931550264.684,4061794332.36,362995,17899,136313,517207
2009-11-13,NASDAQ (DQ),1195969161,431913885,689905743,2317788789,25867386410.7,15005420093.3,12868571632.1,53741378136.0,3088437,721145,1585009,5394591
2009-11-13,ADF (D),26095240,5380400,15750900,47226540,597968175.09,180152302.75,324441990.38,1102562468.22,107454,14425,62291,184170
2009-11-13,ISE (I),57228483,16773391,41217931,115219805,1221040649.59,497433127.578,711118113.356,2429591890.53,210819,41456,138429,390704
2009-11-13,CHX (M),10965426,11835610,5324763,28125799,352987474.989,917509934.48,114842467.881,1385339877.35,6565,4354,4206,15125
2009-11-13,NYSE (N),985095540,0,0,985095540,26355982265.9,0.0,0.0,26355982265.9,3142475,0,0,3142475
2009-11-13,NYSE Arca (P),439302159,292353655,243612118,975267932,11381997596.4,13237970524.7,5668301417.08,30288269538.2,2403221,872716,1157133,4433070
2009-11-13,NASDAQ (Q),646496044,331249310,592317351,1570062705,16941805533.5,17045393684.8,13836828515.6,47824027733.9,3465804,1183780,2379301,7028885
2009-11-13,CBOE (W),2656000,3920400,3552600,10129000,74972838.14,168138968.8,109714578.64,352826385.58,7154,6640,4054,17848
2009-11-13,BATS (Z),285386012,194211532,197940373,677537917,6805872664.26,7996909228.74,4187941703.26,18990723596.3,1724216,695377,1081944,3501537
2009-11-16,AMEX (A),0,19796239,0,19796239,0.0,73381248.01,0.0,73381248.01,0,35187,0,35187
2009-11-16,BEX (B),186752390,42774626,56090422,285617438,3534434199.12,1522612219.59,1032467085.56,6089513504.27,992953,159641,321809,1474403
2009-11-16,NSX (C),18663768,17266585,18597787,54528140,463343907.509,299200510.909,158394347.06,920938765.478,86318,26108,44696,157122
2009-11-16,NYSE (DN),96917821,19069599,43928978,159916398,2442389862.96,1120144484.58,927325701.093,4489860048.63,343213,28466,143205,514884
2009-11-16,NASDAQ (DQ),1514166017,590428973,786183612,2890778602,31732687079.3,20620406573.8,14914388432.0,67267482085.2,3484114,878119,1824551,6186784
2009-11-16,ADF (D),35358850,6793300,19394500,61546650,796789810.39,253741897.37,419454381.66,1469986089.42,140726,19523,71472,231721
2009-11-16,ISE (I),78754541,23434306,49595936,151784783,1657962806.52,683914007.03,854347712.305,3196224525.85,267092,52986,160197,480275
2009-11-16,CHX (M),11731779,17648056,7819500,37199335,395226327.682,1343186468.08,237392358.795,1975805154.55,7203,4174,2092,13469
2009-11-16,NYSE (N),1145583096,0,0,1145583096,30604323456.3,0.0,0.0,30604323456.3,3355144,0,0,3355144
2009-11-16,NYSE Arca (P),499074698,340248567,259821104,1099144369,12754988971.9,15128021762.3,6180158437.81,34063169172.0,2540498,975328,1216669,4732495
2009-11-16,NASDAQ (Q),767133642,401357957,671285230,1839776829,20253009772.4,21028973525.4,16236206925.2,57518190223.0,3868215,1274169,2660657,7803041
2009-11-16,CBOE (W),4422100,4760400,3171200,12353700,126074843.47,239646672.99,111675177.32,477396693.78,9906,7587,3736,21229
2009-11-16,BATS (Z),353312077,243609259,224467476,821388812,8351757832.81,10124965864.2,4699470806.26,23176194503.3,2034792,812396,1233983,4081171
2009-11-17,AMEX (A),0,17356448,0,17356448,0.0,96005127.34,0.0,96005127.34,0,27773,0,27773
2009-11-17,BEX (B),156426624,28712040,48924808,234063472,3270251047.38,1039102436.92,908410567.584,5217764051.88,911380,119991,276253,1307624
2009-11-17,NSX (C),18057860,9568713,22512448,50139021,489794471.025,217688003.269,182088705.906,889571180.2,90184,17780,43344,151308
2009-11-17,NYSE (DN),83374615,11208120,39264556,133847291,2064302206.55,429621612.24,808313601.136,3302237419.92,303571,17983,118431,439985
2009-11-17,NASDAQ (DQ),1302022900,408322072,705127943,2415472915,28396994695.9,13953921931.4,13023978051.8,55374894679.2,3065969,639338,1535621,5240928
2009-11-17,ADF (D),34009660,5475500,17393120,56878280,732987604.81,179943816.6,380975571.92,1293906993.33,129568,15387,70444,215399
2009-11-17,ISE (I),60924133,15757074,44090832,120772039,1288993093.75,428739316.895,656538064.838,2374270475.48,208986,39933,126248,375167
2009-11-17,CHX (M),16288726,8088509,13023352,37400587,855812874.782,676241300.68,728378320.206,2260432495.67,6140,3462,2269,11871
2009-11-17,NYSE (N),972208244,0,11400,972219644,26544515197.7,0.0,189912.0,26544705109.7,3019687,0,5,3019692
2009-11-17,NYSE Arca (P),428683017,271439609,242912493,943035119,11425654464.1,12635473984.9,5691403654.01,29752532103.0,2315446,821685,1108599,4245730
2009-11-17,NASDAQ (Q),629494690,300618476,596837482,1526950648,16876964305.1,15603358478.6,13635305504.4,46115628288.1,3289376,1033329,2365068,6687773
2009-11-17,CBOE (W),7437400,4144000,4705900,16287300,178660791.0,195164743.66,200305758.86,574131293.52,7235,5704,3480,16419
2009-11-17,BATS (Z),285933284,175564558,192898250,654396092,6815500437.32,7269210336.4,4043712702.64,18128423476.4,1668587,649405,1045593,3363585
2009-11-18,AMEX (A),0,13594553,0,13594553,0.0,64718876.1,0.0,64718876.1,0,29948,0,29948
2009-11-18,BEX (B),169708294,30102841,50116276,249927411,3460338252.92,1049186229.7,901699609.85,5411224092.47,947589,118506,281330,1347425
2009-11-18,NSX (C),20948470,10821110,23016441,54786021,481248300.247,243848417.855,174853358.707,899950076.809,89200,23190,40600,152990
2009-11-18,NYSE (DN),95278995,12161487,43447761,150888243,2411584208.29,539517164.135,909396133.462,3860497505.89,321274,19637,133159,474070
2009-11-18,NASDAQ (DQ),1481477973,443298726,768066455,2692843154,29597934466.0,15749674566.6,13381792593.1,58729401625.7,3221805,687224,1601229,5510258
2009-11-18,ADF (D),32687000,5230900,16218000,54135900,712353855.01,160947553.27,301283514.29,1174584922.57,131370,16081,67370,214821
2009-11-18,ISE (I),80654163,16973580,42665932,140293675,1534428573.02,496521097.094,690130587.824,2721080257.94,249144,42760,135655,427559
2009-11-18,CHX (M),17073554,11102403,7822728,35998685,506212825.948,915562442.392,198132775.151,1619908043.49,9911,3812,4086,17809
2009-11-18,NYSE (N),1063605349,0,0,1063605349,27567554922.4,0.0,0.0,27567554922.4,3071506,0,0,3071506
2009-11-18,NYSE Arca (P),477486766,262262587,244547857,984297210,11822425326.4,12381696107.8,5431332157.92,29635453592.2,2321909,795482,1076321,4193712
2009-11-18,NASDAQ (Q),686223662,298507586,613212187,1597943435,17391332656.2,15971356192.0,13853152635.3,47215841483.5,3346059,1015414,2304004,6665477
2009-11-18,CBOE (W),5993200,3130300,3721500,12845000,156573268.97,168458089.65,253374236.03,578405594.65,6985,5448,3123,15556
2009-11-18,BATS (Z),305008356,174463028,202085237,681556621,7013756977.4,7093030262.05,4050579390.46,18157366629.9,1697065,623916,1056199,3377180
2009-11-19,AMEX (A),0,12992082,0,12992082,0.0,64816927.5,0.0,64816927.5,0,29120,0,29120
2009-11-19,BEX (B),179826033,36046081,58143700,274015814,3653047214.07,1302348050.58,1039070268.97,5994465533.62,994711,147846,313460,1456017
2009-11-19,NSX (C),16057905,10174935,18934390,45167230,443650103.612,296760732.234,172324727.493,912735563.339,83392,20732,42183,146307
2009-11-19,NYSE (DN),95216677,17006146,50397390,162620213,2451284914.45,784043694.511,1059809918.5,4295138527.47,363355,26132,165619,555106
2009-11-19,NASDAQ (DQ),1417794999,517688122,863244781,2798727902,29780161917.8,19510205999.8,16466641066.9,65757008984.5,3579514,843796,1886421,6309731
2009-11-19,ISE (I),68674811,19122141,43743928,131540880,1447723871.43,677662687.3,774032432.685,2899418991.42,249170,50587,142895,442652
2009-11-19,CHX (M),13962254,14648795,6393637,35004686,445740480.452,1265341595.88,146928236.324,1858010312.66,10556,4998,3794,19348
2009-11-19,NYSE (N),1083884781,0,0,1083884781,28278266625.9,0.0,0.0,28278266625.9,3270453,0,0,3270453
2009-11-19,NYSE Arca (P),467701370,344395934,283003292,1095100596,11969683719.8,15885563557.4,6691167683.22,34546414960.5,2478793,1009458,1291409,4779660
2009-11-19,NASDAQ (Q),684852603,374631075,736808482,1796292160,17621102537.6,19537494373.0,17450262667.8,54608859578.4,3491346,1256730,2622313,7370389
2009-11-19,CBOE (W),4478100,4525100,2052100,11055300,129198441.75,237208344.5,81427026.33,447833812.58,7487,6334,3569,17390
2009-11-19,BATS (Z),334585711,235210667,236460974,806257352,7646285489.27,10177821315.2,4914719701.27,22738826505.8,1900079,850958,1220959,3971996
2009-11-20,AMEX (A),0,15133953,0,15133953,0.0,67307694.19,0.0,67307694.19,0,29220,0,29220
2009-11-20,BEX (B),174581380,29999840,50240118,254821338,3870627219.78,1032767052.49,899559097.221,5802953369.49,1030067,124477,285334,1439878
2009-11-20,NSX (C),17415670,7969796,18931159,44316625,536053765.991,198331138.865,152295397.398,886680302.254,91593,16112,37809,145514
2009-11-20,NYSE (DN),80483890,12664045,38406423,131554358,2077404315.0,541660978.31,786438681.317,3405503974.63,305791,23286,119989,449066
2009-11-20,NASDAQ (DQ),1160019822,396769708,712482121,2269271651,26067273641.9,13429957942.4,12056255435.8,51553487020.2,3084674,673032,1593861,5351567
2009-11-20,ISE (I),51302776,14220715,41346037,106869528,1161862564.28,472091548.938,629886732.197,2263840845.41,210514,38968,127834,377316
2009-11-20,CHX (M),17325912,10209558,8011862,35547332,490489490.042,841517536.51,174618136.296,1506625162.85,9967,3502,3035,16504
2009-11-20,NYSE (N),1142496209,0,0,1142496209,32187305287.9,0.0,0.0,32187305287.9,2853573,0,0,2853573
2009-11-20,NYSE Arca (P),389509581,240309457,238691060,868510098,10359014106.0,10899906301.4,5296933301.18,26555853708.6,2086259,745425,1074438,3906122
2009-11-20,NASDAQ (Q),564942713,260882108,668051350,1493876171,15276407366.8,13286062684.7,15242262221.5,43804732273.1,3006412,889199,2247572,6143183
2009-11-20,CBOE (W),4284600,4746900,2954300,11985800,138284655.81,271741623.41,89189573.12,499215852.34,7004,5414,3405,15823
2009-11-20,BATS (Z),288997698,175334750,203927911,668260359,6723260419.8,7407195766.49,4009322962.62,18139779148.9,1651542,656668,1072613,3380823
2009-11-23,AMEX (A),0,13551661,0,13551661,0.0,67280039.42,0.0,67280039.42,0,30023,0,30023
2009-11-23,BEX (B),174223611,30971683,48278377,253473671,3837750142.04,1108899943.0,922182475.93,5868832560.97,1013696,121242,281042,1415980
2009-11-23,NSX (C),16420339,10293811,13985978,40700128,414787206.627,251329013.299,151980407.921,818096627.846,80830,20802,36397,138029
2009-11-23,NYSE (DN),93550333,11979058,43490276,149019667,2331243007.24,478875766.734,894572874.47,3704691648.45,345622,25336,144024,514982
2009-11-23,NASDAQ (DQ),1316661168,419187496,691696757,2427545421,28607572700.6,14605019088.5,13335205970.3,56547797759.3,3266705,731029,1664930,5662664
2009-11-23,ISE (I),56846750,16860692,37402323,111109765,1289240099.64,571297798.018,665135912.364,2525673810.02,224046,43552,131298,398896
2009-11-23,CHX (M),16197626,15037865,10220170,41455661,756229625.117,1263619499.46,890554785.875,2910403910.45,10370,4293,4664,19327
2009-11-23,NYSE (N),980122920,0,0,980122920,26949131610.8,0.0,0.0,26949131610.8,2976668,0,0,2976668
2009-11-23,NYSE Arca (P),394828672,295388480,228994022,919211174,10555688009.7,13523328019.3,5365565251.75,29444581280.7,2080242,841125,1099381,4020748
2009-11-23,NASDAQ (Q),610288492,304384107,591434808,1506107407,16223144237.8,15248569232.5,13694295576.1,45166009046.4,3112522,1043142,2370331,6525995
2009-11-23,CBOE (W),6488400,3954100,2962600,13405100,194833999.81,242074077.8,72132021.73,509040099.34,6399,5797,2989,15185
2009-11-23,BATS (Z),314193256,212057726,203986815,730237797,7417170500.32,8964905934.34,4467473168.79,20849549603.4,1747100,731002,1143875,3621977
2009-11-24,AMEX (A),0,11047810,0,11047810,0.0,59022771.21,0.0,59022771.21,0,24117,0,24117
2009-11-24,BEX (B),176804394,30003678,47021303,253829375,3794598334.08,1082653708.99,792206825.045,5669458868.12,1035564,122254,268553,1426371
2009-11-24,NSX (C),17859996,7993260,20290600,46143856,420722668.467,237565955.484,135158000.215,793446624.166,87234,18605,43382,149221
2009-11-24,NYSE (DN),91610946,10673725,44084496,146369167,2381633780.94,488923840.11,870061509.345,3740619130.39,352654,19340,132767,504761
2009-11-24,NASDAQ (DQ),1263466881,432736570,708815975,2405019426,26468965710.3,15717145225.2,12051733858.2,54237844793.7,3098674,703690,1644428,5446792
2009-11-24,ISE (I),57622632,15031625,43116564,115770821,1247291084.52,519931362.062,603265345.465,2370487792.04,220701,41796,127911,390408
2009-11-24,CHX (M),8391055,8922427,7980488,25293970,249467055.684,728873099.6,156725864.794,1135066020.08,9384,3790,3929,17103
2009-11-24,NYSE (N),964046633,0,0,964046633,25709357252.8,0.0,0.0,25709357252.8,2945044,0,0,2945044
2009-11-24,NYSE Arca (P),399145170,252320393,222835944,874301507,10435302916.6,11247847986.6,4600834678.02,26283985581.3,2117550,784763,1039494,3941807
2009-11-24,NASDAQ (Q),598407447,299452195,575283711,1473143353,15669793496.2,15338398335.8,12222180945.6,43230372777.5,3118317,1054014,2265460,6437791
2009-11-24,CBOE (W),5587100,4016100,3077100,12680300,177868910.93,251912575.23,118875777.84,548657264.0,7710,6098,2682,16490
2009-11-24,BATS (Z),299272717,194903668,206156210,700332595,6819213061.74,8138005914.66,4026343203.33,18983562179.7,1680990,720308,1127756,3529054
2009-11-25,AMEX (A),0,13222266,0,13222266,0.0,60314738.8,0.0,60314738.8,0,26346,0,26346
2009-11-25,BEX (B),149701351,24534830,40127743,214363924,3395758801.54,877980449.85,701248089.29,4974987340.68,888131,96361,222063,1206555
2009-11-25,NSX (C),14492689,7680444,12152397,34325530,342467347.492,201708646.779,95297163.8528,639473158.124,67626,16340,30111,114077
2009-11-25,NYSE (DN),81785529,10044930,40118713,131949172,2086627195.94,372669487.823,855795271.295,3315091955.05,307847,17872,133466,459185
2009-11-25,NASDAQ (DQ),1056278002,350051726,559020290,1965350018,23187236429.1,11981231232.7,9756419205.79,44924886867.6,2738378,609621,1336395,4684394
2009-11-25,ISE (I),51495859,15480921,30394053,97370833,1178802778.2,434639912.887,497370898.891,2110813589.98,195122,37573,101345,334040
2009-11-25,CHX (M),11610721,12080845,8430662,32122228,359855203.705,1093380984.93,260503983.615,1713740172.25,8381,2842,2738,13961
2009-11-25,NYSE (N),795343665,0,400,795344065,21572824857.7,0.0,12898.0,21572837755.7,2483602,0,1,2483603
2009-11-25,NYSE Arca (P),302164793,221667567,167154171,690986531,8340304691.98,9769982267.72,3644485899.17,21754772858.9,1634322,644507,818938,3097767
2009-11-25,NASDAQ (Q),437967079,220025116,409743839,1067736034,12086482188.3,11253027879.4,9132830396.55,32472340464.3,2316066,737928,1693044,4747038
2009-11-25,CBOE (W),3712500,6312500,2293200,12318200,116018241.51,514905751.08,68814546.9,699738539.49,5573,4191,2252,12016
2009-11-25,BATS (Z),218174200,147777051,147804872,513756123,5318367749.12,6239249551.08,3004124405.94,14561741706.1,1242428,538787,817554,2598769
2009-11-27,AMEX (A),0,12858834,0,12858834,0.0,56992412.15,0.0,56992412.15,0,17292,0,17292
2009-11-27,BEX (B),96183856,27898485,23289933,147372274,1938268537.81,992102536.02,449356213.695,3379727287.52,544371,106819,132487,783677
2009-11-27,NSX (C),8596025,7746682,6317961,22660668,196030397.485,204137187.284,61634246.3087,461801831.078,34682,16158,13586,64426
2009-11-27,NYSE (DN),44841944,11694115,20153653,76689712,1137733840.6,551271522.997,445534548.011,2134539911.6,155346,19739,59915,235000
2009-11-27,NASDAQ (DQ),692621908,380121444,334556357,1407299709,13598799181.7,13406252757.0,6602135319.42,33607187258.1,1679458,627559,819517,3126534
2009-11-27,ISE (I),40297030,17074899,21917082,79289011,824164459.838,547560527.368,374785658.958,1746510646.16,138913,41929,71133,251975
2009-11-27,CHX (M),4758437,9377253,1958708,16094398,125187925.16,872767469.69,45819786.9865,1043775181.84,4064,4466,2040,10570
2009-11-27,NYSE (N),654922907,0,0,654922907,17310718469.3,0.0,0.0,17310718469.3,1898671,0,0,1898671
2009-11-27,NYSE Arca (P),273892835,285897838,116194566,675985239,6937866878.32,12046883143.9,2997280493.69,21982030515.9,1376135,780757,595948,2752840
2009-11-27,NASDAQ (Q),393223622,286185052,364184470,1043593144,10077716032.4,14055961174.0,8745019223.38,32878696429.8,1981061,930382,1374795,4286238
2009-11-27,CBOE (W),1887800,2665800,1328700,5882300,61165886.22,164109639.6,69549814.23,294825340.05,4028,4340,1935,10303
2009-11-27,BATS (Z),152158707,169854084,82166410,404179201,3422613246.79,7114065259.7,1957242850.02,12493921356.5,842154,601295,465046,1908495
2009-11-30,AMEX (A),0,25864804,0,25864804,0.0,125207698.86,0.0,125207698.86,0,33517,0,33517
2009-11-30,BEX (B),201768235,37894484,50218390,289881109,4150409202.97,1306206435.48,867089353.53,6323704991.98,1131394,147417,284824,1563635
2009-11-30,NSX (C),22364737,10374756,15413957,48153450,547552899.946,261088123.574,154221931.443,962862954.962,117193,20789,49251,187233
2009-11-30,NYSE (DN),85102614,21463989,42554847,149121450,2139417507.05,754515624.595,905555943.282,3799489074.92,331684,31429,148087,511200
2009-11-30,NASDAQ (DQ),1275312537,520879319,703713011,2499904867,27113739314.3,17304808909.1,12761901758.6,57180449982.0,3329530,843257,1762918,5935705
2009-11-30,ISE (I),60657841,21933435,38153347,120744623,1289000451.99,658560585.885,651842854.836,2599403892.71,231500,54314,130940,416754
2009-11-30,CHX (M),11021771,10743892,4026830,25792493,377708450.809,926267650.468,79273264.022,1383249365.3,10467,4679,3981,19127
2009-11-30,NYSE (N),1348457250,0,0,1348457250,35961022115.4,0.0,0.0,35961022115.4,3382541,0,0,3382541
2009-11-30,NYSE Arca (P),428518790,335678550,237552121,1001749461,11263829374.4,14448880146.3,5438865946.19,31151575466.9,2326406,961874,1187923,4476203
2009-11-30,NASDAQ (Q),636512308,366932167,730025854,1733470329,16732134052.2,17905958807.8,15605119604.6,50243212464.6,3421546,1256536,2501033,7179115
2009-11-30,CBOE (W),8330800,3080400,2650600,14061800,229510638.82,144467911.8,61978365.13,435956915.75,7529,5538,3384,16451
2009-11-30,BATS (Z),329470226,252224096,208784349,790478671,7518886256.69,10297501076.8,4347636476.33,22164023809.9,1851236,865191,1149055,3865482
2009-12-01,AMEX (A),0,21252535,0,21252535,0.0,110978224.28,0.0,110978224.28,0,32051,0,32051
2009-12-01,BEX (B),202929505,37095031,57473138,297497674,4530820816.49,1321029044.75,1051476428.95,6903326290.19,1163475,149761,322335,1635571
2009-12-01,NSX (C),21003389,10270363,16148984,47422736,504246781.855,210223367.139,150805909.091,865276058.084,99818,19415,42382,161615
2009-12-01,NYSE (DN),104000808,21093884,49731783,174826475,2711547699.55,724763641.047,1135808898.03,4572120238.64,386553,30902,163088,580543
2009-12-01,NASDAQ (DQ),1433561356,492216425,839770864,2765548645,31236091244.5,16391675327.2,15338989567.4,62966756139.1,3447373,819899,1903743,6171015
2009-12-01,ADF (D),35413000,7021300,19452000,61886300,814293032.8,221099039.61,369878839.64,1405270912.05,157475,21857,88464,267796
2009-12-01,ISE (I),70163858,22149250,46080965,138394073,1552103791.22,655135497.698,811535227.565,3018774516.49,268446,53233,157574,479253
2009-12-01,CHX (M),14178499,13174296,6781457,34134252,1009923452.2,1158450694.3,464101377.32,2632475523.82,9882,4040,4994,18916
2009-12-01,NYSE (N),1132037683,0,0,1132037683,30617817128.2,0.0,0.0,30617817128.2,3250610,0,0,3250610
2009-12-01,NYSE Arca (P),460677595,332230980,254115921,1047024496,12240368461.3,14537159151.3,5818018480.71,32595546093.3,2400057,910452,1201541,4512050
2009-12-01,NASDAQ (Q),657764121,341009247,686644077,1685417445,17294457100.5,16822551756.6,15512249615.0,49629258472.1,3369159,1095500,2645523,7110182
2009-12-01,CBOE (W),5032000,6524700,2221500,13778200,148810589.72,300851591.39,64219283.59,513881464.7,6846,5425,2606,14877
2009-12-01,BATS (Z),320964408,224936190,225005194,770905792,7598833745.89,9286910168.83,4781596805.97,21667340720.7,1808283,747874,1208463,3764620
2009-12-02,AMEX (A),0,18786140,0,18786140,0.0,80170134.91,0.0,80170134.91,0,31671,0,31671
2009-12-02,BEX (B),199410278,36230898,54602763,290243939,4236984557.37,1279397175.86,926078986.198,6442460719.43,1167263,152224,303150,1622637
2009-12-02,NSX (C),16623591,13775138,18955674,49354403,432950443.049,214167517.388,171810938.303,818928898.74,89819,23640,46155,159614
2009-12-02,NYSE (DN),79534774,14141331,43042836,136718941,2151655509.61,557511955.053,1027732028.37,3736899493.04,300049,21946,144981,466976
2009-12-02,NASDAQ (DQ),1262286474,467253924,797213694,2526754092,28062836233.7,14412045247.8,14476416332.7,56951297814.2,3267510,782495,1819228,5869233
2009-12-02,ADF (D),28658410,5714300,18512300,52885010,666344137.89,179818566.67,329610708.0,1175773412.56,118909,16971,82172,218052
2009-12-02,ISE (I),64458617,21033915,47263102,132755634,1448448486.0,543846976.887,806315242.82,2798610705.7,256547,50962,151834,459343
2009-12-02,CHX (M),14141942,9087517,5982188,29211647,501413382.672,692010705.914,120743070.05,1314167158.64,10366,3868,5146,19380
2009-12-02,NYSE (N),1032214806,0,0,1032214806,28329434419.7,0.0,0.0,28329434419.7,3193863,0,0,3193863
2009-12-02,NYSE Arca (P),444681848,297353043,252525386,994560277,12101332693.3,12887659488.1,5645669244.14,30634661425.6,2400605,861700,1173087,4435392
2009-12-02,NASDAQ (Q),657808273,318081661,622211106,1598101040,17508857557.8,15404045057.2,14286998126.6,47199900741.6,3487901,1078535,2539797,7106233
2009-12-02,CBOE (W),3218300,2973600,2703700,8895600,101023019.31,161940879.4,65845075.3,328808974.01,7745,5566,2926,16237
2009-12-02,BATS (Z),303128884,209366212,222197526,734692622,7341754029.89,8318466896.99,4524754622.07,20184975548.9,1790219,736767,1185925,3712911
2009-12-03,AMEX (A),0,17197546,0,17197546,0.0,75957685.14,0.0,75957685.14,0,31747,0,31747
2009-12-03,BEX (B),201945099,31149703,43322098,276416900,4402629460.89,1122097855.63,791570181.118,6316297497.64,1065074,107628,223620,1396322
2009-12-03,NSX (C),20681993,11541280,15435629,47658902,478045651.421,242470525.55,182174977.108,902691154.079,93172,21268,44227,158667
2009-12-03,NYSE (DN),98531600,15761707,42047629,156340936,2529721579.68,588814244.465,986673472.08,4105209296.22,313713,22667,136685,473065
2009-12-03,NASDAQ (DQ),1584978576,520306796,769519810,2874805182,32726244388.0,16612967059.4,14363649338.9,63702860786.4,3526761,812795,1796966,6136522
2009-12-03,ADF (D),38539470,6295200,21290550,66125220,837160241.6,190975907.45,426013434.82,1454149583.87,145732,16778,94052,256562
2009-12-03,ISE (I),83792431,20397798,41568289,145758518,1736380608.39,610016181.453,756539637.703,3102936427.55,273986,50005,144677,468668
2009-12-03,CHX (M),15675376,11911563,5376294,32963233,400563621.172,945231312.017,109304824.321,1455099757.51,14536,5297,5074,24907
2009-12-03,NYSE (N),1133017099,0,0,1133017099,29919515307.6,0.0,0.0,29919515307.6,3206443,0,0,3206443
2009-12-03,NYSE Arca (P),587210535,352113735,249500128,1188824398,14462959872.9,15129995927.5,6157439398.18,35750395198.6,2740501,1016563,1200005,4957069
2009-12-03,NASDAQ (Q),812021027,378987211,600465215,1791473453,20517785641.8,18928946115.8,14532330747.0,53979062504.6,3779517,1240205,2443152,7462874
2009-12-03,CBOE (W),5360900,1741900,2722800,9825600,159989078.19,102532755.0,83230135.74,345751968.93,8472,4392,2753,15617
2009-12-03,BATS (Z),396414698,264798456,234185348,895398502,9207764234.75,10433909186.0,5059006530.24,24700679951.0,2177327,910796,1260069,4348192
2009-12-04,AMEX (A),0,15313104,0,15313104,0.0,74272941.01,0.0,74272941.01,0,31891,0,31891
2009-12-04,BEX (B),226455417,44086602,55760204,326302223,4665332731.07,1673616317.16,978626091.242,7317575139.47,1194650,151670,295186,1641506
2009-12-04,NSX (C),23389730,14424128,16283486,54097344,631205417.64,339087470.497,170777662.817,1141070550.95,118146,28411,44957,191514
2009-12-04,NYSE (DN),130649433,20475568,44354921,195479922,3204956598.94,936322744.298,991302250.993,5132581594.23,415219,31808,145404,592431
2009-12-04,NASDAQ (DQ),1948306718,673386553,813492605,3435185876,40503552925.5,24826718051.6,16969295600.6,82299566577.8,4188349,1112077,2010941,7311367
2009-12-04,ADF (D),64091125,10732400,24671700,99495225,1109167007.85,371431555.73,482718389.78,1963316953.36,177403,25418,102280,305101
2009-12-04,ISE (I),86891306,26649579,41957503,155498388,1885352367.08,951783889.054,809857982.167,3646994238.3,310429,64944,141332,516705
2009-12-04,CHX (M),13288937,13872915,5784644,32946496,356840472.099,1147769590.74,139833284.28,1644443347.12,9280,8070,5186,22536
2009-12-04,NYSE (N),1574624753,0,500,1574625253,39905305111.8,0.0,14256.5,39905319368.3,4104383,0,2,4104385
2009-12-04,NYSE Arca (P),772291165,489997266,306496786,1568785217,18947656359.3,23608960044.6,7877844240.96,50434460644.8,3447031,1491995,1482213,6421239
2009-12-04,NASDAQ (Q),1019105085,549867258,747868005,2316840348,25763389240.9,29873354613.4,18275005339.2,73911749193.5,4789243,1837691,3115464,9742398
2009-12-04,CBOE (W),10726500,5390700,3146200,19263400,281021361.06,348950946.1,108216011.89,738188319.05,11821,7061,4794,23676
2009-12-04,BATS (Z),518600860,399999148,282483813,1201083821,11769546350.9,16395834406.7,6257528621.35,34422909379.0,2785015,1383187,1575033,5743235
2009-12-07,AMEX (A),0,14054861,0,14054861,0.0,63762463.95,0.0,63762463.95,0,24182,0,24182
2009-12-07,BEX (B),186670851,29416217,42685342,258772410,3942794149.55,1080007999.07,704857016.634,5727659165.25,994489,115690,224779,1334958
2009-12-07,NSX (C),22002956,10507844,21537112,54047912,568844668.84,193595411.015,166469858.385,928909938.24,107232,18653,46072,171957
2009-12-07,NYSE (DN),88189032,11852317,42155810,142197159,2270124578.47,565729160.661,1005684128.73,3841537867.86,333286,18963,131733,483982
2009-12-07,NASDAQ (DQ),1346790781,447982611,712502588,2507275980,27846630499.2,15055088364.4,13627319409.0,56529038272.6,3289643,749428,1689997,5729068
2009-12-07,ADF (D),33250040,6329800,20203900,59783740,732863705.69,219056326.22,418021158.91,1369941190.82,137641,18691,86144,242476
2009-12-07,ISE (I),68421986,16684238,35840838,120947062,1376061002.75,494461468.045,650603456.127,2521125926.92,238925,42378,114981,396284
2009-12-07,CHX (M),8499155,7450364,5573393,21522912,252797832.935,566386048.705,98213959.96,917397841.6,7532,4266,4161,15959
2009-12-07,NYSE (N),1059262782,0,0,1059262782,28231110351.8,0.0,0.0,28231110351.8,3009377,0,0,3009377
2009-12-07,NYSE Arca (P),476130172,282760870,239426382,998317424,11845077142.1,12115400545.7,5543879724.2,29504357412.0,2343858,860226,1109810,4313894
2009-12-07,NASDAQ (Q),648768364,313492693,556633655,1518894712,16733272864.5,15746936839.6,13448899992.5,45929109696.5,3246727,1065114,2297099,6608940
2009-12-07,CBOE (W),9833400,3093400,2795000,15721800,259585709.55,169785198.13,112902440.86,542273348.54,6834,4448,2662,13944
2009-12-07,BATS (Z),344100062,224001384,218602507,786703953,7651244454.22,8908777933.57,4632061481.02,21192083868.8,1840654,789908,1160208,3790770
2009-12-08,AMEX (A),0,18115827,0,18115827,0.0,96247882.68,0.0,96247882.68,0,28583,0,28583
2009-12-08,BEX (B),208082780,34115478,46345275,288543533,4204050575.95,1272134696.05,764218695.98,6240403967.98,1064333,138003,250738,1453074
2009-12-08,NSX (C),21715740,11180318,28813898,61709956,578926726.209,264117440.27,175836330.612,1018880497.09,112372,21336,53084,186792
2009-12-08,NYSE (DN),103591158,14115644,41745801,159452603,2632309194.71,565967739.763,901156917.157,4099433851.63,360395,21779,128708,510882
2009-12-08,NASDAQ (DQ),1602146724,492793203,744211035,2839150962,31018079994.7,17377411530.8,14509278540.9,62904770066.3,3620867,837854,1724253,6182974
2009-12-08,ADF (D),38823860,7511400,20030000,66365260,806606076.6,242574515.97,423473589.63,1472654182.2,153424,20832,89828,264084
2009-12-08,ISE (I),82023655,17557403,36737379,136318437,1589173053.77,551884309.284,610001628.421,2751058991.47,267166,46664,115838,429668
2009-12-08,CHX (M),13967081,8059370,8683988,30710439,446748951.039,671782784.97,751103127.546,1869634863.55,9650,5082,4254,18986
2009-12-08,NYSE (N),1178385490,0,0,1178385490,30705981196.7,0.0,0.0,30705981196.7,3363558,0,0,3363558
2009-12-08,NYSE Arca (P),540558860,328478795,250842729,1119880384,12702304776.5,14617977458.4,5775251761.48,33095533996.4,2511859,975595,1133275,4620729
2009-12-08,NASDAQ (Q),728283072,352032086,611135497,1691450655,18288621979.9,17873243304.8,14204418083.0,50366283367.6,3536600,1224898,2413924,7175422
2009-12-08,CBOE (W),8163200,2640500,2809900,13613600,241480433.52,169655306.44,79359332.57,490495072.53,6278,4525,2748,13551
2009-12-08,BATS (Z),389932829,240002798,219677342,849612969,8487728986.89,9669615033.7,4713261827.12,22870605847.7,1932659,869366,1143469,3945494
2009-12-09,AMEX (A),0,13063582,0,13063582,0.0,64607238.88,0.0,64607238.88,0,24710,0,24710
2009-12-09,BEX (B),186859119,27945877,45095029,259900025,4203958754.21,1118677409.45,724591200.71,6047227364.37,1055018,119499,230186,1404703
2009-12-09,NSX (C),21168817,10907016,26502397,58578230,577872614.723,230414905.055,219398209.989,1027685729.77,95275,20212,46769,162256
2009-12-09,NYSE (DN),100001254,11296288,37703039,149000581,2527615664.17,522900640.45,815207002.088,3865723306.71,330688,18875,123022,472585
2009-12-09,NASDAQ (DQ),1388349782,442940085,697185179,2528475046,29024492028.4,16124965032.9,13819644050.4,58969101111.6,3308153,754169,1661146,5723468
2009-12-09,ADF (D),34534160,5408400,22056300,61998860,803085920.71,186153913.4,421694415.94,1410934250.05,148626,15312,87957,251895
2009-12-09,ISE (I),65007886,16959324,37547853,119515063,1380857057.61,545324946.863,643782220.892,2569964225.37,247840,40979,117014,405833
2009-12-09,CHX (M),11971576,8853817,6099498,26924891,386015104.102,697524283.529,184080527.312,1267619914.94,9849,5077,4260,19186
2009-12-09,NYSE (N),1082754003,0,0,1082754003,29075424816.0,0.0,0.0,29075424816.0,3181707,0,0,3181707
2009-12-09,NYSE Arca (P),464732828,298359712,245228520,1008321060,11715954445.6,13713569574.3,5776056412.52,31205580432.4,2326718,897344,1087816,4311878
2009-12-09,NASDAQ (Q),626503604,305364700,578461715,1510330019,16436754673.5,15971634282.6,13807969750.5,46216358706.6,3087781,1117131,2212769,6417681
2009-12-09,CBOE (W),4754900,2962100,2413000,10130000,121739436.0,196562133.44,84105109.93,402406679.37,5155,3541,1763,10459
2009-12-09,BATS (Z),338935125,210068414,228372110,777375649,7751434878.48,8560229532.59,4958358332.6,21270022743.7,1772458,761548,1136306,3670312
2009-12-10,AMEX (A),0,10897178,0,10897178,0.0,54176417.75,0.0,54176417.75,0,20676,0,20676
2009-12-10,BEX (B),184206676,23319091,44155966,251681733,3969568042.34,878432738.38,715053828.9,5563054609.62,982732,94505,222064,1299301
2009-12-10,NSX (C),16778541,8060510,20886671,45725722,412656182.537,195307630.324,163366686.408,771330499.269,79595,15742,41572,136909
2009-12-10,NYSE (DN),81081636,11976322,37886857,130944815,2116423831.31,566442143.31,825685140.178,3508551114.8,312889,18736,132482,464107
2009-12-10,NASDAQ (DQ),1368380965,394802685,774040654,2537224304,30000502153.8,14317568811.8,14675761992.5,58993832958.1,3134321,641324,1716143,5491788
2009-12-10,ADF (D),33029800,4840000,18078600,55948400,722633911.84,151385600.97,367064581.61,1241084094.42,135599,13832,75271,224702
2009-12-10,ISE (I),65151446,14731436,40187756,120070638,1464798837.96,472082910.457,657654256.058,2594536004.48,254027,37799,131006,422832
2009-12-10,CHX (M),15889695,9385564,7797737,33072996,432855728.533,792677665.94,160726898.827,1386260293.3,9965,4893,4883,19741
2009-12-10,NYSE (N),1062554701,0,0,1062554701,29313692256.2,0.0,0.0,29313692256.2,3027101,0,0,3027101
2009-12-10,NYSE Arca (P),460688462,248382968,244573740,953645170,11080307875.1,11117265233.3,5387914711.71,27585487820.1,2102553,707977,1065226,3875756
2009-12-10,NASDAQ (Q),608579176,249580960,566700781,1424860917,16048466294.2,12519753713.0,13459350143.2,42027570150.4,2989943,883114,2220731,6093788
2009-12-10,CBOE (W),17378500,3836700,2581800,23797000,334753806.57,249562323.49,85179703.23,669495833.29,6306,3533,2239,12078
2009-12-10,BATS (Z),331609181,175935065,222273676,729817922,7296866221.34,7158517368.02,4745074027.24,19200457616.6,1630391,618633,1123172,3372196
2009-12-11,AMEX (A),0,11277199,0,11277199,0.0,44795077.08,0.0,44795077.08,0,19725,0,19725
2009-12-11,BEX (B),172816014,23704333,39964829,236485176,3930587241.21,888663695.65,655426087.51,5474677024.36,975810,90896,200867,1267573
2009-12-11,NSX (C),17326235,8203532,23029662,48559429,395998339.016,181522763.307,137781209.233,715302311.556,73951,15766,37016,126733
2009-12-11,NYSE (DN),78236208,12343998,32147791,122727997,2077150415.86,496407932.091,684265096.448,3257823444.4,295511,20734,110106,426351
2009-12-11,NASDAQ (DQ),1348037785,364133611,698089187,2410260583,28612343937.6,13444003828.9,12840718317.0,54897066083.6,3135573,629510,1571824,5336907
2009-12-11,ADF (D),38822510,5325300,16249200,60397010,816614422.39,167273228.17,310477976.5,1294365627.06,139848,13422,69055,222325
2009-12-11,ISE (I),67907362,15581063,39985716,123474141,1379377136.93,498306742.473,569617810.598,2447301690.0,246446,41630,116876,404952
2009-12-11,CHX (M),13249020,8610325,7294042,29153387,335562469.316,688478221.68,125217441.433,1149258132.43,7460,5908,4297,17665
2009-12-11,NYSE (N),1024409966,0,100,1024410066,27689946656.1,0.0,3877.5,27689950533.6,2897039,0,1,2897040
2009-12-11,NYSE Arca (P),388960872,241951350,213908418,844820640,9971790659.19,10902550185.7,4656348223.88,25530689068.8,1973877,710890,942520,3627287
2009-12-11,NASDAQ (Q),553398027,247494085,510589170,1311481282,14674960929.2,13037061043.3,11888805747.0,39600827719.4,2802524,858721,2049773,5711018
2009-12-11,CBOE (W),6221700,2099500,2788800,11110000,188766062.65,154682438.7,82523469.93,425971971.28,4508,2831,2107,9446
2009-12-11,BATS (Z),284336762,175674873,190092857,650104492,6643649257.58,7422203521.13,4074212969.87,18140065748.6,1518794,602235,1005855,3126884
2009-12-14,AMEX (A),0,14666088,0,14666088,0.0,60286948.06,0.0,60286948.06,0,25364,0,25364
2009-12-14,BEX (B),198995086,21063750,44262705,264321541,3968291338.73,750589643.807,731319517.848,5450200500.39,907371,75880,218662,1201913
2009-12-14,NSX (C),16161656,10447403,21124359,47733418,444076528.992,157537172.047,137654613.661,739268314.699,78753,16540,39939,135232
2009-12-14,NYSE (DN),113569818,11361936,34872723,159804477,2722522577.68,486414733.808,819050770.182,4027988081.67,335740,18898,112981,467619
2009-12-14,NASDAQ (DQ),1694612345,380346352,744084266,2819042963,34278650716.9,12828481964.6,13294538144.6,60401670826.1,3604714,597411,1677503,5879628
2009-12-14,ADF (D),45368190,4947200,18366900,68682290,916581097.92,157165422.96,396038485.85,1469785006.73,155839,12814,81764,250417
2009-12-14,ISE (I),88055806,17161357,40313779,145530942,1772779793.7,435212922.319,631824462.898,2839817178.91,286872,41913,126768,455553
2009-12-14,CHX (M),11734879,7164594,7016115,25915588,1396103605.92,429903346.66,117173457.808,1943180410.39,7817,3581,4696,16094
2009-12-14,NYSE (N),1076473984,0,0,1076473984,29366978176.6,0.0,0.0,29366978176.6,2939510,0,0,2939510
2009-12-14,NYSE Arca (P),525615466,232655754,216275206,974546426,12452800338.2,10242193114.6,4644862023.91,27339855476.7,2135631,649957,948570,3734158
2009-12-14,NASDAQ (Q),640236129,214767789,526274975,1381278893,16488115783.4,11045043494.9,11850968388.5,39384127666.8,2844219,719350,1992640,5556209
2009-12-14,CBOE (W),8932200,1863500,2825400,13621100,269375099.5,80831204.74,91188922.56,441395226.8,5173,3418,2428,11019
2009-12-14,BATS (Z),351601822,157825501,207998216,717425539,7650853620.95,6518647268.95,4341025120.87,18510526010.8,1612424,545163,1049006,3206593
2009-12-15,AMEX (A),0,18142068,0,18142068,0.0,73730878.44,0.0,73730878.44,0,29831,0,29831
2009-12-15,BEX (B),209220637,20628096,50702605,280551338,3790850223.13,677964924.758,819200587.68,5288015735.57,876740,69717,245552,1192009
2009-12-15,NSX (C),17222141,11083796,20951179,49257116,431257052.27,135577169.336,145225747.357,712059968.963,83135,14956,41766,139857
2009-12-15,NYSE (DN),143877545,14220795,48589335,206687675,3095127923.66,609432436.94,1028195131.66,4732755492.27,398427,24676,175354,598457
2009-12-15,NASDAQ (DQ),1886790488,403928896,765992201,3056711585,36241883120.0,13209862167.5,13771687085.1,63223432372.6,3740359,626431,1710420,6077210
2009-12-15,ADF (D),45769780,5653300,17285300,68708380,715961483.29,148489601.51,310136336.6,1174587421.4,122063,11501,71770,205334
2009-12-15,ISE (I),87511651,18441648,40663906,146617205,1745890224.18,484911056.306,610655227.521,2841456508.01,284397,41941,129637,455975
2009-12-15,CHX (M),18517565,13354014,8700782,40572361,626839476.513,866260189.03,688059565.936,2181159231.48,8957,4110,4829,17896
2009-12-15,NYSE (N),1179410580,0,0,1179410580,30026072435.3,0.0,0.0,30026072435.3,2903206,0,0,2903206
2009-12-15,NYSE Arca (P),591373884,244333661,236285416,1071992961,13567637067.5,10563910031.6,4992948857.66,29124495956.7,2256440,677527,1047807,3981774
2009-12-15,NASDAQ (Q),703248287,232824438,575230203,1511302928,17260755720.2,11873055318.6,12642450742.3,41776261781.0,2976460,708455,2170565,5855480
2009-12-15,CBOE (W),12269800,6458700,2981900,21710400,372227448.01,526378510.36,109686323.46,1008292281.83,5319,3336,2478,11133
2009-12-15,BATS (Z),391286271,165202649,217643397,774132317,8503820065.49,6809564777.69,4550505105.73,19863889948.9,1771773,551516,1106683,3429972
2009-12-16,AMEX (A),0,13820136,0,13820136,0.0,65816341.55,0.0,65816341.55,0,25749,0,25749
2009-12-16,BEX (B),210634086,22817070,46389838,279840994,3692511165.18,745102990.28,778461809.57,5216075965.03,851816,74005,230409,1156230
2009-12-16,NSX (C),15385495,9228810,24751940,49366245,370824515.11,179801560.349,129740062.238,680366137.697,79593,14794,36811,131198
2009-12-16,NYSE (DN),108102775,14770534,41908465,164781774,2534361057.92,593661559.492,1033566036.54,4161588653.96,330310,28395,147469,506174
2009-12-16,NASDAQ (DQ),1971436636,447366034,878545272,3297347942,39134955166.8,17184155090.5,16798626725.7,73117736983.0,3667986,651546,1832649,6152181
2009-12-16,ADF (D),45263570,4362500,18767500,68393570,808090065.56,132346566.61,375510964.86,1315947597.03,136178,11992,73614,221784
2009-12-16,ISE (I),83893210,16154228,47466735,147514173,1623730343.11,575534187.683,704152287.826,2903416818.62,281343,42862,140636,464841
2009-12-16,CHX (M),27942102,12501093,7184509,47627704,556675952.652,804806888.124,77810910.8044,1439293751.58,7767,3653,4343,15763
2009-12-16,NYSE (N),1166565135,0,0,1166565135,29143343663.9,0.0,0.0,29143343663.9,2966879,0,0,2966879
2009-12-16,NYSE Arca (P),634999143,251749141,256971871,1143720155,12439125264.0,12331227272.5,5806463901.03,30576816437.5,2199950,699113,1116112,4015175
2009-12-16,NASDAQ (Q),744061906,241588409,572977484,1558627799,16779824913.0,12540861026.1,13623291067.4,42943977006.5,2969033,763595,2203987,5936615
2009-12-16,CBOE (W),14668200,1902400,2966000,19536600,401892369.06,117881592.75,100643602.7,620417564.51,7519,3388,3023,13930
2009-12-16,BATS (Z),367869436,181406904,218597960,767874300,7774453652.1,7567823515.92,4780544345.61,20122821513.6,1670055,596527,1113184,3379766
2009-12-17,AMEX (A),0,17067608,0,17067608,0.0,65962729.71,0.0,65962729.71,0,27712,0,27712
2009-12-17,BEX (B),366167217,25148968,43473603,434789788,3943113417.66,808527063.82,720978131.123,5472618612.6,825416,86379,217651,1129446
2009-12-17,NSX (C),17516557,17711485,20922275,56150317,450753908.356,139109835.716,135613539.46,725477283.532,89916,16391,42443,148750
2009-12-17,NYSE (DN),201217319,14881941,45361998,261461258,3049276050.07,670966668.734,989407450.601,4709650169.4,392105,24696,147785,564586
2009-12-17,NASDAQ (DQ),2715422950,484043674,742936034,3942402658,38633396127.4,18056795767.6,13930097073.8,70620288968.7,3961112,756055,1698470,6415637
2009-12-17,ADF (D),104558900,6743500,17283900,128586300,960300076.88,188988725.89,308517457.77,1457806260.54,144771,15035,68021,227827
2009-12-17,ISE (I),93316121,23512410,39417807,156246338,1771111026.92,741051352.379,667146511.801,3179308891.1,310441,54204,133181,497826
2009-12-17,CHX (M),23083290,14862719,7033532,44979541,649728390.961,858757287.98,467958630.95,1976444309.89,10211,6243,3376,19830
2009-12-17,NYSE (N),1718439075,0,0,1718439075,30983154201.8,0.0,0.0,30983154201.8,2976288,0,0,2976288
2009-12-17,NYSE Arca (P),1146810536,322125299,233880656,1702816491,14481300671.1,14401879451.1,5591829507.38,34475009629.6,2341167,835809,1042250,4219226
2009-12-17,NASDAQ (Q),1002885192,285989977,584278260,1873153429,18863907332.6,14652495193.0,14171716794.7,47688119320.3,3291823,870636,2206109,6368568
2009-12-17,CBOE (W),12910200,6167300,7642600,26720100,402654667.84,558381086.7,489180941.14,1450216695.68,5161,4133,2417,11711
2009-12-17,BATS (Z),607251307,208462776,208038905,1023752988,9271556857.05,9186634047.63,4792719892.68,23250910797.4,1933934,698771,1095598,3728303
2009-12-18,AMEX (A),0,50714117,0,50714117,0.0,241251452.29,0.0,241251452.29,0,34914,0,34914
2009-12-18,BEX (B),266967276,23283759,48745112,338996147,4004252149.44,749637191.94,846842025.833,5600731367.21,947493,78546,249058,1275097
2009-12-18,NSX (C),27774182,14086238,20004629,61865049,646053407.886,134277558.782,246177593.387,1026508560.05,134197,19331,62070,215598
2009-12-18,NYSE (DN),153689715,21571464,57235164,232496343,2947195507.84,1008048542.73,1263945403.16,5219189453.73,357117,33760,169180,560057
2009-12-18,NASDAQ (DQ),2932965824,462714784,1168191602,4563872210,47648323218.1,16122005212.5,23569549099.8,87339877530.4,3735641,693819,1887717,6317177
2009-12-18,ADF (D),66128660,7825400,22852800,96806860,958897253.08,206742718.75,493249597.92,1658889569.75,165101,14449,96035,275585
2009-12-18,ISE (I),76622463,24636828,44693501,145952792,1632534186.05,678193001.209,790103467.608,3100830654.86,288395,52498,150854,491747
2009-12-18,CHX (M),10400393,12107402,8024004,30531799,359733399.88,669550038.615,267977041.336,1297260479.83,7048,5272,4020,16340
2009-12-18,NYSE (N),3160348305,0,0,3160348305,68358014717.9,0.0,0.0,68358014717.9,3385028,0,0,3385028
2009-12-18,NYSE Arca (P),653146396,299442683,281699963,1234289042,13195306445.0,13650845553.2,7044632741.95,33890784740.2,2318661,820898,1257708,4397267
2009-12-18,NASDAQ (Q),783783057,278339476,1300519216,2362641749,18207627299.2,14295776478.6,29560882576.4,62064286354.2,3299838,868523,2700246,6868607
2009-12-18,CBOE (W),3790300,6803200,2325400,12918900,86359911.27,600356641.33,96355260.81,783071813.41,5269,3648,2866,11783
2009-12-18,BATS (Z),481460688,206601155,253145251,941207094,8775243775.66,9032908044.95,6237818486.21,24045970306.8,1900923,704055,1320435,3925413
2009-12-21,AMEX (A),0,15094922,0,15094922,0.0,58295386.21,0.0,58295386.21,0,25621,0,25621
2009-12-21,BEX (B),169985466,20418741,42372813,232777020,3165976089.15,652843764.786,745929702.014,4564749555.95,734322,67564,215742,1017628
2009-12-21,NSX (C),16626618,10990651,25076884,52694153,449511824.306,132066073.13,183876187.479,765454084.915,88804,17161,73699,179664
2009-12-21,NYSE (DN),94263668,10624283,41649779,146537730,2273491130.72,501265113.513,967775378.298,3742531622.53,318050,18178,146618,482846
2009-12-21,NASDAQ (DQ),1509082376,403422557,747818488,2660323421,31426879205.6,14068867919.3,14677387070.3,60173134195.3,3258609,618122,1739055,5615786
2009-12-21,ADF (D),32324900,4694700,15492070,52511670,677796020.7,136770607.07,299459450.68,1114026078.45,116444,10561,62847,189852
2009-12-21,ISE (I),62879217,17305975,38324054,118509246,1435172871.85,480053022.688,646307556.844,2561533451.39,251225,41128,127719,420072
2009-12-21,CHX (M),12522926,14978897,19008806,46510629,832087567.703,1151645014.99,2255379056.24,4239111638.94,6568,4483,6138,17189
2009-12-21,NYSE (N),1013052822,0,0,1013052822,25187096531.3,0.0,0.0,25187096531.3,2659363,0,0,2659363
2009-12-21,NYSE Arca (P),429200227,236394778,211343476,876938481,10252214574.4,10667595741.3,5233897573.74,26153707889.4,1908140,662551,1009796,3580487
2009-12-21,NASDAQ (Q),579858794,212039777,514424458,1306323029,15092387847.6,10510185769.1,12392157381.0,37994730997.7,2733591,691321,2005735,5430647
2009-12-21,CBOE (W),3710900,5993800,3876800,13581500,123232914.9,444461992.84,153845662.98,721540570.72,4125,2812,2035,8972
2009-12-21,BATS (Z),312787895,155110680,193159559,661058134,6859372634.29,6414609811.99,4372978756.38,17646961202.7,1534791,524106,1044991,3103888
2009-12-22,AMEX (A),0,12390288,0,12390288,0.0,48591103.66,0.0,48591103.66,0,22789,0,22789
2009-12-22,BEX (B),152724864,19594348,38283906,210603118,2886076016.23,654749034.05,645166890.987,4185991941.27,706035,72815,199976,978826
2009-12-22,NSX (C),17928181,8307622,28008643,54244446,392233572.958,105101901.588,139760767.806,637096242.352,85579,19547,61801,166927
2009-12-22,NYSE (DN),84547013,10220070,33742600,128509683,2006435034.89,542240620.087,792295496.024,3340971151.0,284344,20674,128341,433359
2009-12-22,NASDAQ (DQ),1369778292,342699852,722628826,2435106970,28599527076.2,12474546611.0,12928609274.4,54002682961.6,3082107,585047,1647140,5314294
2009-12-22,ADF (D),32258190,3687700,14584700,50530590,617146666.13,120724905.0,302995789.31,1040867360.44,110684,12767,66539,189990
2009-12-22,ISE (I),62437049,15078694,40265370,117781113,1413044547.93,453668761.844,616723105.131,2483436414.9,247688,38564,127533,413785
2009-12-22,CHX (M),10245005,9486221,5825923,25557149,326848277.697,731388769.75,124715935.041,1182952982.49,8358,3730,4753,16841
2009-12-22,NYSE (N),956415701,0,0,956415701,24591982752.6,0.0,0.0,24591982752.6,2504828,0,0,2504828
2009-12-22,NYSE Arca (P),375821518,196279936,205535509,777636963,8965489716.86,9176876384.9,4676345686.05,22818711787.8,1688833,588219,956328,3233380
2009-12-22,NASDAQ (Q),504298472,194278003,487789372,1186365847,12872195028.8,10128142734.6,11050421271.0,34050759034.3,2443145,681488,1892159,5016792
2009-12-22,CBOE (W),4905800,4523400,1857200,11286400,103252687.9,263134019.36,82441375.01,448828082.27,5010,2835,1990,9835
2009-12-22,BATS (Z),289055158,134025852,176618547,599699557,6441168039.08,5834027090.9,3858929837.96,16134124967.9,1457957,494635,983178,2935770
2009-12-23,AMEX (A),0,11923492,0,11923492,0.0,53967664.61,0.0,53967664.61,0,23549,0,23549
2009-12-23,BEX (B),123992597,17856489,32552759,174401845,2388583278.37,622584545.95,554598306.271,3565766130.59,581685,63274,168991,813950
2009-12-23,NSX (C),16870605,7312008,30472740,54655353,340885049.417,103252878.885,122479218.788,566617147.09,76066,14925,90497,181488
2009-12-23,NYSE (DN),63791205,10172755,28708930,102672890,1644024291.05,439835497.969,663154181.168,2747013970.19,223882,18214,101232,343328
2009-12-23,NASDAQ (DQ),1243910699,333598289,682064909,2259573897,24987788439.9,13180659307.5,12991752911.8,51160200659.1,2913021,547971,1591026,5052018
2009-12-23,ISE (I),60760424,15678622,39327655,115766701,1256448674.95,416623226.385,564980973.141,2238052874.47,225530,37791,115638,378959
2009-12-23,CHX (M),7677539,8496094,6769733,22943366,315074619.358,552018141.868,138171339.086,1005264100.31,6092,3481,4079,13652
2009-12-23,NYSE (N),786742802,0,0,786742802,20388974650.3,0.0,0.0,20388974650.3,2287321,0,0,2287321
2009-12-23,NYSE Arca (P),291083582,193168869,190460509,674712960,7205707319.47,8805176947.56,4365779788.56,20376664055.6,1385124,511166,833864,2730154
2009-12-23,NASDAQ (Q),450447656,180656194,429889853,1060993703,11897673965.3,9242673614.45,10099904233.1,31240251812.9,2235876,589643,1717657,4543176
2009-12-23,CBOE (W),3662900,8924300,1486900,14074100,126031067.62,685007155.6,77532518.07,888570741.29,3856,2803,1700,8359
2009-12-23,BATS (Z),224866233,122739844,164886480,512492557,5140748700.9,5366279325.73,3587050869.29,14094078895.9,1178676,443172,887527,2509375
2009-12-24,AMEX (A),0,6133937,0,6133937,0.0,30648972.15,0.0,30648972.15,0,11437,0,11437
2009-12-24,BEX (B),46483438,7680117,12124977,66288532,905619732.65,270330015.91,238943524.045,1414893272.6,245276,26113,64908,336297
2009-12-24,NSX (C),5525124,4011610,14167327,23704061,124608985.896,48183432.3976,51795665.6345,224588083.928,25692,10375,52935,89002
2009-12-24,NYSE (DN),22439258,4568605,10085094,37092957,528031524.223,221847427.865,254134509.519,1004013461.61,73912,9513,34463,117888
2009-12-24,NASDAQ (DQ),496121597,158417509,269549221,924088327,9382811404.24,5626307627.94,6404810399.2,21413929431.4,1174757,259892,660401,2095050
2009-12-24,ISE (I),26394912,6904973,17270034,50569919,552655485.358,181077637.558,337136082.475,1070869205.39,98011,16934,51590,166535
2009-12-24,CHX (M),2498125,4212786,2220463,8931374,102790454.489,326055800.32,41484279.38,470330534.189,2184,1605,1748,5537
2009-12-24,NYSE (N),319464544,0,0,319464544,8517515131.4,0.0,0.0,8517515131.4,964283,0,0,964283
2009-12-24,NYSE Arca (P),102897739,85588574,70128952,258615265,2506718864.41,3411513553.16,2057509702.25,7975742119.82,515266,214119,330925,1060310
2009-12-24,NASDAQ (Q),164306383,76402478,179803333,420512194,4198902788.35,3650538702.11,5022126873.0,12871568363.5,816575,250596,714303,1781474
2009-12-24,CBOE (W),2421100,1762800,1342600,5526500,32185077.89,110654821.81,83705124.49,226545024.19,2071,1345,815,4231
2009-12-24,BATS (Z),80007374,50180940,56123386,186311700,1813480873.43,1972105810.08,1501831775.31,5287418458.82,426945,178512,318554,924011
2009-12-28,AMEX (A),0,12129815,0,12129815,0.0,48292806.99,0.0,48292806.99,0,20301,0,20301
2009-12-28,BEX (B),120353124,14021740,28449115,162823979,2258154128.5,524283323.71,537850507.75,3320287959.96,562400,49831,145870,758101
2009-12-28,NSX (C),12484396,15532627,28815928,56832951,247273834.746,162938131.654,113845012.423,524056978.823,60659,36510,83512,180681
2009-12-28,NYSE (DN),48973811,11798132,21936062,82708005,1176208879.29,628970626.759,519470559.303,2324650065.35,173692,21295,82953,277940
2009-12-28,NASDAQ (DQ),1189321671,340405076,557118764,2086845511,21692265934.4,12749649635.4,12101392436.0,46543308005.8,2434037,474831,1343463,4252331
2009-12-28,ISE (I),54875197,16050283,30236714,101162194,1064202133.39,358504760.326,522885447.792,1945592341.5,188656,34143,96168,318967
2009-12-28,CHX (M),5203727,5143767,5934113,16281607,179778529.039,223809623.466,154295481.2,557883633.705,4796,2285,3664,10745
2009-12-28,NYSE (N),705891528,0,0,705891528,17145760467.8,0.0,0.0,17145760467.8,1791612,0,0,1791612
2009-12-28,NYSE Arca (P),226121595,176045383,131712455,533879433,5076888447.18,7248100962.51,3590807653.22,15915797062.9,995422,386720,616185,1998327
2009-12-28,NASDAQ (Q),361603276,137737888,336023911,835365075,8658617454.09,6541372041.38,8523616365.69,23723605861.2,1621607,410193,1328199,3359999
2009-12-28,CBOE (W),1365600,1154000,1607600,4127200,30829967.14,60915609.77,148053525.3,239799102.21,3700,2032,1510,7242
2009-12-28,BATS (Z),169913902,86527898,110542578,366984378,3686645692.86,3784839839.66,2613058925.57,10084544458.1,834105,295486,608826,1738417
2009-12-29,AMEX (A),0,22265284,0,22265284,0.0,58212229.42,0.0,58212229.42,0,23009,0,23009
2009-12-29,BEX (B),121480068,16301725,27256803,165038596,2532459998.09,591997597.66,485815112.645,3610272708.4,616710,57449,147834,821993
2009-12-29,NSX (C),10790245,23067210,34168126,68025581,244828099.319,70848542.1769,98455468.2399,414132109.736,58354,22840,92031,173225
2009-12-29,NYSE (DN),53550543,10591267,21822370,85964180,1355928440.22,490783145.115,507611942.764,2354323528.1,203750,21198,83405,308353
2009-12-29,NASDAQ (DQ),979805369,331604822,500822728,1812232919,19664432542.0,9257101194.6,10005830257.0,38927363993.6,2362453,453009,1252452,4067914
2009-12-29,ISE (I),48460151,19893569,27931335,96285055,1036637639.6,329162893.548,470524355.252,1836324888.4,184237,36419,94607,315263
2009-12-29,CHX (M),4376749,10332252,7941945,22650946,152663085.419,519784150.645,277498064.167,949945300.231,4662,3817,3004,11483
2009-12-29,NYSE (N),638614331,0,0,638614331,17072675332.3,0.0,0.0,17072675332.3,1866311,0,0,1866311
2009-12-29,NYSE Arca (P),242793782,150924239,136660444,530378465,6051583512.76,6288701226.15,3313856393.92,15654141132.8,1171465,407886,636059,2215410
2009-12-29,NASDAQ (Q),333425186,140033715,323496124,796955025,8600810764.64,6806270845.75,7697521961.66,23104603572.0,1635461,442636,1302804,3380901
2009-12-29,CBOE (W),1686800,1667300,3989200,7343300,46354412.54,84620234.27,340015992.28,470990639.09,3518,1889,1465,6872
2009-12-29,BATS (Z),171557169,96881873,116476936,384915978,3945750314.66,4227318169.68,2635866265.86,10808934750.2,926995,342345,659631,1928971
2009-12-30,AMEX (A),0,20193033,0,20193033,0.0,82044043.18,0.0,82044043.18,0,25293,0,25293
2009-12-30,BEX (B),112336746,15138593,27879132,155354471,2294893664.12,515633645.58,519231101.945,3329758411.65,581555,51795,153850,787200
2009-12-30,NSX (C),12813409,16393508,17439687,46646604,344715904.02,77268665.3996,131433424.926,553417994.346,80766,23765,52663,157194
2009-12-30,NYSE (DN),53661737,10126228,24613559,88401524,1314483700.0,514871859.78,527898771.103,2357254330.88,206695,19151,104097,329943
2009-12-30,NASDAQ (DQ),876300891,315434563,571440874,1763176328,17551528656.0,9707148946.21,10977291372.0,38235968974.2,2275512,475526,1382923,4133961
2009-12-30,ISE (I),43879723,17380122,30675680,91935525,927458754.782,341381846.662,484695945.636,1753536547.08,173583,36800,99275,309658
2009-12-30,CHX (M),6872710,9000377,7197370,23070457,130442987.722,471510441.175,162322686.324,764276115.221,4226,3720,4024,11970
2009-12-30,NYSE (N),644811167,0,0,644811167,16813289537.7,0.0,0.0,16813289537.7,1802745,0,0,1802745
2009-12-30,NYSE Arca (P),212000115,157150688,146257001,515407804,5230806202.05,6466910784.37,3554979572.3,15252696558.7,1047107,422895,712939,2182941
2009-12-30,NASDAQ (Q),295093062,146256208,390634919,831984189,7725325907.31,7023130037.92,8767611105.58,23516067050.8,1510402,474348,1448828,3433578
2009-12-30,CBOE (W),1921800,2515600,1837100,6274500,51448353.19,162789300.07,120951052.73,335188705.99,3537,2205,1499,7241
2009-12-30,BATS (Z),157107105,92349630,119232574,368689309,3473923363.76,3769764388.92,2670548008.74,9914235761.43,860407,338806,685330,1884543
2009-12-31,AMEX (A),0,13458520,0,13458520,0.0,49902372.11,0.0,49902372.11,0,22257,0,22257
2009-12-31,BEX (B),102100244,13899106,30324448,146323798,2190434143.31,533943925.88,547842241.052,3272220310.24,520808,45885,154368,721061
2009-12-31,NSX (C),11803932,8396765,16071495,36272192,326809679.039,77693491.9566,120045330.936,524548501.931,73667,11559,41238,126464
2009-12-31,NYSE (DN),42814356,9081106,24272188,76167650,1061279891.81,425361784.385,577044411.749,2063686087.94,171913,17760,94695,284368
2009-12-31,NASDAQ (DQ),811790040,278842047,530613089,1621245176,16352864889.7,8899962143.46,9489040882.46,34741867915.6,2111391,446091,1250377,3807859
2009-12-31,ISE (I),46368876,14153263,29977806,90499945,1010095112.54,364372571.735,414375677.262,1788843361.54,171388,35072,90304,296764
2009-12-31,CHX (M),3545595,10176243,5423536,19145374,98973182.51,813197947.08,85972927.0238,998144056.614,3974,2147,4016,10137
2009-12-31,NYSE (N),680088843,0,0,680088843,18578202334.3,0.0,0.0,18578202334.3,1719012,0,0,1719012
2009-12-31,NYSE Arca (P),202974646,162808048,146446923,512229617,5004891312.17,7127480917.9,3142091111.34,15274463341.4,954911,388010,628921,1971842
2009-12-31,NASDAQ (Q),253431862,141681222,380177070,775290154,7016378913.38,7498276666.36,8608862422.59,23123518002.3,1380278,426018,1271009,3077305
2009-12-31,CBOE (W),1845000,3569000,2941100,8355100,38873057.62,214040594.2,146804168.63,399717820.45,3205,2430,1507,7142
2009-12-31,BATS (Z),131916230,89396047,110916264,332228541,3120555622.25,4049578600.0,2446201516.5,9616335738.75,736353,309360,610113,1655826
