Day,Market Participant,Tape A Shares,Tape B Shares,Tape C Shares,Total Shares,Tape A Notional,Tape B Notional,Tape C Notional,Total Notional,Tape A Trade Count,Tape B Trade Count,Tape C Trade Count,Total Trade Count
2014-12-31,NYSE MKT (A),0,17457232,4568370,22025602,0.000000,130281871.205100,127257526.174000,257539397.379100,0,30791,20259,51050
2014-12-31,NASDAQ BX (B),49364942,28431828,26935276,104732046,1548446797.020108,1712809831.529600,940633592.305298,4201890220.855006,392933,131143,210214,734290
2014-12-31,NYSE (DN),81068389,35872334,52807578,169748301,2719553247.672927,1778295103.653393,1981564848.007732,6479413199.334052,342141,104731,191873,638745
2014-12-31,NASDAQ (DQ),753509822,386451457,515361170,1655322449,22913687163.978861,21376901101.742916,16005202282.126461,60295790547.848238,2612841,751628,1496368,4860837
2014-12-31,ADF (D),18940448,14002001,14918475,47860924,468917907.227500,522579823.156500,390155703.897801,1381653434.281801,77901,39852,56566,174319
2014-12-31,EDGA (J),68951828,40754812,38937408,148644048,2168323574.133911,2225300253.423701,1280002270.623494,5673626098.181106,586676,192065,308441,1087182
2014-12-31,EDGX (K),142961996,82833645,116320145,342115786,4433801008.859691,3908681769.832997,3521832637.707412,11864315416.400100,750019,259320,550702,1560041
2014-12-31,CHX (M),5294331,11377743,2041044,18713118,269315182.100000,1496980148.866000,92846801.278400,1859142132.244400,496,1825,493,2814
2014-12-31,NYSE (N),670426322,0,0,670426322,24684340286.189471,0.000000,0.000000,24684340286.189471,1971382,0,0,1971382
2014-12-31,NYSE Arca (P),188001975,234207986,125200261,547410222,7149796782.725002,14936612415.432779,5009909630.651908,27096318828.809689,1392677,671727,873613,2938017
2014-12-31,NASDAQ (Q),340582322,133296340,454800210,928678872,13984326797.553390,9407793824.477165,16750446230.529146,40142566852.559701,2706839,545121,2144849,5396809
2014-12-31,NASDAQ PSX (X),15597968,11337344,9607192,36542504,517396593.354101,713263997.072100,332662758.554200,1563323348.980401,126464,47373,62475,236312
2014-12-31,BATS BYX (Y),94250068,47652914,52619047,194522029,2915737198.419001,2705639256.551701,1676126264.728398,7297502719.699100,785430,235221,407499,1428150
2014-12-31,BATS BZX (Z),180246082,109785618,105242497,395274197,6179356970.040477,7159012841.852309,3841185574.714715,17179555386.607501,1423283,469993,792043,2685319
2014-12-30,NYSE MKT (A),0,15160047,3874606,19034653,0.000000,76085730.032500,95439436.779000,171525166.811500,0,29177,16968,46145
2014-12-30,NASDAQ BX (B),48243722,23589998,23727424,95561144,1597132858.443397,1190250047.433493,903958757.547602,3691341663.424492,445320,107587,214461,767368
2014-12-30,NYSE (DN),84672613,33112464,51615715,169400792,2765380623.574969,1567746906.727799,1845267561.513421,6178395091.816189,343683,95091,187069,625843
2014-12-30,NASDAQ (DQ),746951148,373058228,438810919,1558820295,22541132557.998850,18009559802.921267,13301479898.559963,53852172259.480080,2658094,736724,1414962,4809780
2014-12-30,ADF (D),20818811,10466778,15572062,46857651,432966055.778000,337129505.419301,414733896.128001,1184829457.325302,76761,31134,52843,160738
2014-12-30,EDGA (J),63798010,33719508,32638498,130156016,2014864103.282101,1547242381.672594,1075105850.461198,4637212335.415893,555233,163235,271242,989710
2014-12-30,EDGX (K),138867218,66979235,102065827,307912280,3954777102.126497,2719354769.135095,3122490880.869781,9796622752.131373,711354,217971,483480,1412805
2014-12-30,CHX (M),6688983,5648275,4262171,16599429,247019083.800000,657353679.382100,171420020.042500,1075792783.224600,823,1247,530,2600
2014-12-30,NYSE (N),539086058,0,0,539086058,18242537769.894518,0.000000,0.000000,18242537769.894518,1782108,0,0,1782108
2014-12-30,NYSE Arca (P),190251557,212446612,114791968,517490137,6753217159.467486,12045042992.849697,4467300362.190149,23265560514.507332,1341521,585579,790581,2717681
2014-12-30,NASDAQ (Q),319232882,111703519,335634292,766570693,12313250618.136342,6842720386.445505,12151855997.298041,31307827001.879888,2479268,466834,1844191,4790293
2014-12-30,NASDAQ PSX (X),17740786,9141321,8500365,35382472,567549984.084901,517202668.389900,307681169.984601,1392433822.459402,140901,39391,63570,243862
2014-12-30,BATS BYX (Y),88369715,40825159,46988136,176183010,2649345668.219312,2039983716.985899,1469311605.452295,6158640990.657506,740347,193180,376734,1310261
2014-12-30,BATS BZX (Z),178341155,90939744,93259824,362540723,5846542154.921188,5145560783.599102,3280328816.601537,14272431755.121827,1401885,391764,713670,2507319
2014-12-29,NYSE MKT (A),0,14764566,3859465,18624031,0.000000,73492548.996400,96176767.455000,169669316.451400,0,29511,17186,46697
2014-12-29,NASDAQ BX (B),48760248,24998673,23079239,96838160,1654069670.518894,1319610539.217701,933596936.994504,3907277146.731099,428527,113819,202236,744582
2014-12-29,NYSE (DN),84985051,30879669,52289701,168154421,3036933552.091151,1581251574.417787,1964795090.082721,6582980216.591659,365478,95061,200750,661289
2014-12-29,NASDAQ (DQ),747690525,493740112,423617178,1665047815,23245979326.101342,27500101673.723447,14693066896.711127,65439147896.535916,2716867,707928,1404044,4828839
2014-12-29,ADF (D),18679532,10400990,12701961,41782483,474602641.961500,385924434.001200,380975156.581100,1241502232.543800,76995,29410,48226,154631
2014-12-29,EDGA (J),70354986,34487615,31989964,136832565,2345792611.436905,1678155367.793804,1091941405.682502,5115889384.913211,596979,161232,272075,1030286
2014-12-29,EDGX (K),129348761,72656034,102499615,304504410,4232688209.402331,3356783576.776201,3487410144.823608,11076881931.002140,714398,222010,492623,1429031
2014-12-29,CHX (M),6635596,6922395,2083111,15641102,297382454.105000,773206144.530000,111137844.087700,1181726442.722700,385,1237,279,1901
2014-12-29,NYSE (N),552118723,0,0,552118723,19968166725.465889,0.000000,0.000000,19968166725.465889,1817408,0,0,1817408
2014-12-29,NYSE Arca (P),185544178,197434477,100688549,483667204,6889000896.713648,11191286363.511721,4112711299.918304,22192998560.143673,1359001,539868,746853,2645722
2014-12-29,NASDAQ (Q),320606075,114686748,331309674,766602497,12962291241.919081,7433557003.499098,12961083746.634974,33356931992.053153,2583540,457893,1910418,4951851
2014-12-29,NASDAQ PSX (X),18005738,9711714,8960321,36677773,604396049.343900,567187890.827100,303642372.064399,1475226312.235399,142415,41898,63486,247799
2014-12-29,BATS BYX (Y),91139558,43851429,43957170,178948157,2871751858.922614,2225715025.345198,1442341149.375909,6539808033.643721,767188,193912,355540,1316640
2014-12-29,BATS BZX (Z),182700567,98906360,92875708,374482635,6344556629.189621,6077917708.070092,3379288443.255040,15801762780.514753,1498777,412677,765940,2677394
2014-12-26,NYSE MKT (A),0,12256792,3006880,15263672,0.000000,52228715.637600,102370303.705000,154599019.342600,0,23633,12052,35685
2014-12-26,NASDAQ BX (B),31645883,15141330,17186094,63973307,1130774010.188799,817270049.262800,789474714.991700,2737518774.443299,279404,78693,144862,502959
2014-12-26,NYSE (DN),57303185,20517177,36711295,114531657,1934199858.653711,934712585.526194,1539453702.052511,4408366146.232416,225150,71133,130704,426987
2014-12-26,NASDAQ (DQ),496151725,253810990,297724101,1047686816,15043665703.653652,12958479166.271855,9866814946.045426,37868959815.970933,1841429,518362,1021230,3381021
2014-12-26,ADF (D),13596824,9422448,9947093,32966365,337843049.844300,263940212.052000,328225284.269300,930008546.165600,54667,23402,38605,116674
2014-12-26,EDGA (J),46214029,21534587,22998000,90746616,1552716731.566501,1040216513.718401,813073697.068100,3406006942.353002,403043,107905,192441,703389
2014-12-26,EDGX (K),93506845,53859542,79169705,226536092,3000517393.309407,2212631378.339003,2980950846.717687,8194099618.366097,492491,159162,366749,1018402
2014-12-26,CHX (M),4955491,8643702,1353404,14952597,288647301.210600,649984565.965000,89733344.840000,1028365212.015600,283,814,227,1324
2014-12-26,NYSE (N),446628321,0,0,446628321,16684561928.083151,0.000000,0.000000,16684561928.083151,1427221,0,0,1427221
2014-12-26,NYSE Arca (P),133280463,152439560,79272203,364992226,5166951221.091892,9303742527.053731,3543360661.733400,18014054409.879023,1031371,423017,586321,2040709
2014-12-26,NASDAQ (Q),214211723,71741828,278625217,564578768,8730935781.529362,4561485322.030705,11609967238.583251,24902388342.143318,1739408,312568,1426272,3478248
2014-12-26,NASDAQ PSX (X),11275343,7046789,6223636,24545768,382115261.610000,377379902.313700,249495891.960000,1008991055.883700,90384,30986,44562,165932
2014-12-26,BATS BYX (Y),61171522,25663344,31753774,118588640,1984462798.586102,1333025406.997000,1110510668.917001,4427998874.500103,531025,135936,252855,919816
2014-12-26,BATS BZX (Z),125643793,61369394,67570105,254583292,4410324388.185306,3800013197.142909,2621840816.562154,10832178401.890369,1015575,277811,529291,1822677
2014-12-24,NYSE MKT (A),0,8055735,2639165,10694900,0.000000,45688357.743800,69145369.792200,114833727.536000,0,17325,12289,29614
2014-12-24,NASDAQ BX (B),23648770,12677862,12981400,49308032,871693474.214996,709514993.087200,553407618.579101,2134616085.881297,207938,66366,109084,383388
2014-12-24,NYSE (DN),43488048,16094251,27308440,86890739,1617190669.117609,747995153.130901,1102294488.991305,3467480311.239815,176167,52746,102018,330931
2014-12-24,NASDAQ (DQ),429200611,192308013,249225030,870733654,13983344986.919898,8678304553.656124,8699665273.616166,31361314814.192188,1491036,404159,810393,2705588
2014-12-24,ADF (D),12133771,5282128,8718058,26133957,306296898.359100,165222471.476400,257760168.386202,729279538.221702,47885,15818,32370,96073
2014-12-24,EDGA (J),37267710,18333695,18997282,74598687,1197139315.193400,942451300.677200,635604591.254302,2775195207.124902,318996,93835,157935,570766
2014-12-24,EDGX (K),77005016,39187549,60033924,176226489,2575099116.965192,1900816981.542505,2108318104.987801,6584234203.495498,424505,126464,287182,838151
2014-12-24,CHX (M),4047282,5599450,1405247,11051979,145117908.450000,505896362.140000,110778262.150000,761792532.740000,573,1002,691,2266
2014-12-24,NYSE (N),349388332,0,0,349388332,13139526276.192085,0.000000,0.000000,13139526276.192085,1164185,0,0,1164185
2014-12-24,NYSE Arca (P),109814883,130911635,65131935,305858453,4227019492.239314,7569124213.502627,2801588500.518718,14597732206.260659,822753,337622,476591,1636966
2014-12-24,NASDAQ (Q),177482832,60582406,204797170,442862408,7224335012.012919,4029382146.991419,8355518194.795605,19609235353.799943,1450802,268946,1157067,2876815
2014-12-24,NASDAQ PSX (X),8623211,4749177,5396848,18769236,286179300.729400,262028969.389300,186944202.600000,735152472.718700,68495,21055,33876,123426
2014-12-24,BATS BYX (Y),41744296,19711842,22761692,84217830,1375601943.066101,1069216159.487700,706617879.388194,3151435981.941995,360431,100503,181458,642392
2014-12-24,BATS BZX (Z),103169432,49890931,50955715,204016078,3577630434.701886,3042555923.275602,1846504166.853084,8466690524.830572,848706,227166,409192,1485064
2014-12-23,NYSE MKT (A),0,15642626,6943972,22586598,0.000000,146264522.470100,211046556.560600,357311079.030700,0,33716,26964,60680
2014-12-23,NASDAQ BX (B),53807760,30910904,27989137,112707801,1951302018.121900,1791195989.501801,1312143814.373103,5054641821.996804,443417,129174,229184,801775
2014-12-23,NYSE (DN),115732208,32046112,71052907,218831227,4382766638.499579,1533767813.017000,3186125269.235894,9102659720.752473,466695,97778,258013,822486
2014-12-23,NASDAQ (DQ),926405671,425151867,541752395,1893309933,30621785875.756700,25638042490.291151,20807881779.575795,77067710145.623646,3265789,787604,1775736,5829129
2014-12-23,ADF (D),23607046,11514069,15834562,50955677,631301770.968501,398673162.268700,523527605.668699,1553502538.905900,99084,32943,66042,198069
2014-12-23,EDGA (J),81589044,40823702,45564164,167976910,2765430838.868206,2124486341.688403,1896664841.040899,6786582021.597508,691550,188956,372594,1253100
2014-12-23,EDGX (K),161853953,73732081,124929285,360515319,5553549058.508414,3764368244.955084,4712485154.017273,14030402457.480771,901790,247096,635561,1784447
2014-12-23,CHX (M),6493210,11532307,3315608,21341125,407371483.361500,1150096070.192000,198374674.456700,1755842228.010200,524,1753,512,2789
2014-12-23,NYSE (N),692799502,0,0,692799502,26272488628.277779,0.000000,0.000000,26272488628.277779,2205685,0,0,2205685
2014-12-23,NYSE Arca (P),240650593,232863636,146898364,620412593,9275247197.849531,14856900073.988785,6613436418.964762,30745583690.803078,1717433,638791,1033095,3389319
2014-12-23,NASDAQ (Q),391789487,120209478,426187513,938186478,16440835076.762948,8158287509.702412,18213977871.511388,42813100457.976748,3094075,492638,2404136,5990849
2014-12-23,NASDAQ PSX (X),18581227,9817221,9839403,38237851,628975185.265000,601686030.999800,406216294.017001,1636877510.281801,137380,41520,67227,246127
2014-12-23,BATS BYX (Y),104633317,46566663,54721741,205921721,3315228140.949705,2542367903.163998,2030971592.137809,7888567636.251512,853503,219095,427668,1500266
2014-12-23,BATS BZX (Z),229376262,111884323,121422432,462683017,8309805658.655526,7337532403.300592,4866147233.313860,20513485295.269978,1828419,465279,943499,3237197
2014-12-22,NYSE MKT (A),0,19325643,6427469,25753112,0.000000,133316138.890701,199333784.865000,332649923.755701,0,42534,27662,70196
2014-12-22,NASDAQ BX (B),62897331,32378754,30761557,126037642,2119737615.675708,1693087117.669798,1323469658.254701,5136294391.600207,509157,144103,250753,904013
2014-12-22,NYSE (DN),120660523,38248231,69921858,228830612,4439150183.836376,1645985370.336397,3015323754.076162,9100459308.248935,479325,113784,268377,861486
2014-12-22,NASDAQ (DQ),977339374,489461274,589621041,2056421689,32073595132.304680,26225660540.564278,22505960188.189473,80805215861.058431,3414926,841649,1848616,6105191
2014-12-22,ADF (D),24882817,13100966,14803058,52786841,622796964.124199,393085735.250700,507205567.243699,1523088266.618598,105290,36345,65761,207396
2014-12-22,EDGA (J),91000003,43287201,46337332,180624536,2936970043.722310,2093399015.952102,1797908961.142099,6828278020.816511,771398,213012,384165,1368575
2014-12-22,EDGX (K),169364315,86426891,122354216,378145422,5468839292.307475,4068616154.198697,4652810241.730189,14190265688.236361,968601,277805,637939,1884345
2014-12-22,CHX (M),9853042,9424841,5893584,25171467,324742245.854000,1118534237.900000,457380805.751500,1900657289.505500,1558,1648,374,3580
2014-12-22,NYSE (N),790520332,0,0,790520332,29543553265.978302,0.000000,0.000000,29543553265.978302,2491228,0,0,2491228
2014-12-22,NYSE Arca (P),275167491,319372435,165379606,759919532,9979578370.409228,19638499515.039373,7512250460.624184,37130328346.072785,1954139,806702,1150153,3910994
2014-12-22,NASDAQ (Q),455884888,151478477,474106646,1081470011,18490876178.778751,9751914919.216233,21073726498.246219,49316517596.241203,3657373,618527,2679101,6955001
2014-12-22,NASDAQ PSX (X),22702024,13221811,11607626,47531461,771349195.583200,785265133.297700,508227674.956600,2064842003.837500,168688,54614,82908,306210
2014-12-22,BATS BYX (Y),117069807,54346299,56757106,228173212,3604964807.790005,2516977434.953992,2060265497.308611,8182207740.052608,954478,246059,453695,1654232
2014-12-22,BATS BZX (Z),262577061,140360682,134230495,537168238,8744641023.027562,8768538346.727599,5297840171.489657,22811019541.244818,2070244,579607,1045368,3695219
2014-12-19,NYSE MKT (A),0,169280786,6315360,175596146,0.000000,427469760.526000,151873909.162600,579343669.688600,0,50761,28005,78766
2014-12-19,NASDAQ BX (B),90343176,38553958,43879131,172776265,2963788218.995298,2315496993.783703,1732457427.056508,7011742639.835509,655620,161794,324880,1142294
2014-12-19,NYSE (DN),155458839,43146497,85302384,283907720,5634175568.663267,2005889840.369400,3165709254.655211,10805774663.687878,619753,124602,317572,1061927
2014-12-19,NASDAQ (DQ),1770020882,687209371,1099197641,3556427894,51607710955.311921,36143584540.764714,37691142078.315177,125442437574.391812,4026743,863755,2056739,6947237
2014-12-19,ADF (D),30937072,16543175,19077813,66558060,827760890.967500,594667810.307100,589958216.218000,2012386917.492600,146532,48859,82789,278180
2014-12-19,EDGA (J),129758069,57639405,64257864,251655338,4063828553.753109,2905849573.226695,2180895826.151377,9150573953.131181,1036059,264133,502080,1802272
2014-12-19,EDGX (K),216018425,109053683,152180302,477252410,7456031408.564803,5759931786.540384,5576601464.664898,18792564659.770085,1270488,351709,808748,2430945
2014-12-19,CHX (M),8698669,12412220,5484450,26595339,367422973.482000,1275454660.099999,372618693.938800,2015496327.520799,549,3305,1068,4922
2014-12-19,NYSE (N),2468948960,0,0,2468948960,89862528278.025505,0.000000,0.000000,89862528278.025505,3233105,0,0,3233105
2014-12-19,NYSE Arca (P),395694220,377295250,215816147,988805617,14768736710.901016,25216606279.962674,9317414674.542239,49302757665.405929,2651272,978788,1461357,5091417
2014-12-19,NASDAQ (Q),659356960,208525795,1345730903,2213613658,26692131310.798065,15739347676.451162,54588624685.830215,97020103673.079442,4934327,802065,3453113,9189505
2014-12-19,NASDAQ PSX (X),34091188,16001616,16948024,67040828,1203132178.041102,1017942010.077699,633875490.310001,2854949678.428802,245109,65648,114967,425724
2014-12-19,BATS BYX (Y),169080478,65058798,82644806,316784082,5201060393.653698,3445294822.374801,2770338194.060210,11416693410.088709,1289463,287466,626928,2203857
2014-12-19,BATS BZX (Z),365615711,175254509,190168081,731038301,12475775472.797643,11811425195.270738,7225282473.365622,31512483141.434003,2722564,692926,1353145,4768635
2014-12-18,NYSE MKT (A),0,18519051,7382805,25901856,0.000000,125111640.030200,160489677.033900,285601317.064100,0,42871,31111,73982
2014-12-18,NASDAQ BX (B),94536849,45095677,46458627,186091153,3185739647.607699,2913617001.167605,1922587698.742912,8021944347.518216,725953,188483,352846,1267282
2014-12-18,NYSE (DN),167718061,51223160,96090413,315031634,6095843809.833270,2809096119.140598,3824839157.785362,12729779086.759230,661878,155079,341144,1158101
2014-12-18,NASDAQ (DQ),1338911538,582560137,681446548,2602918223,43056122438.319845,35572890784.462948,24145878574.103077,102774891796.885870,4290343,1018529,2093665,7402537
2014-12-18,ADF (D),33938723,18291290,19462465,71692478,933483695.204898,632735918.842600,643098170.679301,2209317784.726799,156776,49235,87320,293331
2014-12-18,EDGA (J),140189256,61361727,65730167,267281150,4709198072.614203,3599683444.207795,2394470414.753720,10703351931.575718,1178854,300156,537794,2016804
2014-12-18,EDGX (K),236220195,120385637,152794581,509400413,7824272430.539118,6822324419.403574,5712205948.554846,20358802798.497538,1369959,385677,831645,2587281
2014-12-18,CHX (M),13665269,18545703,7684231,39895203,631345071.059200,2285423473.142900,532809947.630000,3449578491.832100,1457,7588,1793,10838
2014-12-18,NYSE (N),976144522,0,0,976144522,36549124706.646929,0.000000,0.000000,36549124706.646929,3097088,0,0,3097088
2014-12-18,NYSE Arca (P),416770797,408341486,218695733,1043808016,15235535546.790155,28810730656.249651,9254126695.549693,53300392898.589499,2824017,1131358,1494316,5449691
2014-12-18,NASDAQ (Q),699057335,236368537,598934366,1534360238,28510052518.390396,17867082861.452116,25418605314.605776,71795740694.448288,5411530,912511,3405996,9730037
2014-12-18,NASDAQ PSX (X),36192264,19717721,17983882,73893867,1216283014.943400,1496678144.318399,701867688.163000,3414828847.424799,258505,74698,117568,450771
2014-12-18,BATS BYX (Y),179710686,77023246,83832408,340566340,5794095234.063515,4900160152.959296,3064924990.992107,13759180378.014918,1474950,349329,665977,2490256
2014-12-18,BATS BZX (Z),382187907,191115857,183597658,756901422,13461369098.176465,12876234049.165268,6998171827.687375,33335774975.029108,2987225,783507,1406493,5177225
2014-12-17,NYSE MKT (A),0,17563539,6618329,24181868,0.000000,96943882.811400,155647273.481000,252591156.292400,0,42459,30371,72830
2014-12-17,NASDAQ BX (B),91476969,50799487,44334242,186610698,3061291705.923988,2832573502.505602,1820842877.303897,7714708085.733487,725996,221839,339859,1287694
2014-12-17,NYSE (DN),172308592,55282315,85976757,313567664,6044639997.043770,2858340725.002226,3424376364.865995,12327357086.911991,650215,164662,297773,1112650
2014-12-17,NASDAQ (DQ),1309489184,675983780,673468568,2658941532,40324248512.183333,35651989240.572336,22814773972.290768,98791011725.046437,4363255,1076572,2030726,7470553
2014-12-17,ADF (D),35506854,21976330,21744324,79227508,947416582.313399,789416962.993100,674984855.141800,2411818400.448299,168657,58689,89258,316604
2014-12-17,EDGA (J),147957653,72835258,65761007,286553918,4610195418.300927,3569766254.324308,2201860176.219007,10381821848.844242,1215617,362640,521434,2099691
2014-12-17,EDGX (K),249187111,137159365,165265258,551611734,8129151648.697903,6887803042.871229,5734632769.604597,20751587461.173729,1508518,461550,870245,2840313
2014-12-17,CHX (M),16915668,26593340,5825882,49334890,661499219.032500,2765899071.681999,352662096.160000,3780060386.874499,1241,13765,2658,17664
2014-12-17,NYSE (N),1050071398,0,0,1050071398,37191516854.776883,0.000000,0.000000,37191516854.776883,3622450,0,0,3622450
2014-12-17,NYSE Arca (P),448799184,502772838,263345333,1214917355,15864315180.693000,33080002632.334752,10189637644.673437,59133955457.701189,3085516,1463973,1579879,6129368
2014-12-17,NASDAQ (Q),755918313,305906015,634094366,1695918694,29136904917.659993,20011100203.799545,25335799763.689031,74483804885.148569,5827151,1224092,3668169,10719412
2014-12-17,NASDAQ PSX (X),38900848,26024052,22990284,87915184,1308245785.334600,1508643553.287300,811355009.405299,3628244348.027199,276399,93608,125843,495850
2014-12-17,BATS BYX (Y),182439218,88572177,88629996,359641391,5849011416.066102,4929882637.677116,2970335385.424893,13749229439.168111,1472615,405928,648703,2527246
2014-12-17,BATS BZX (Z),453702644,275595984,206349480,935648108,15156060100.586834,17444904571.461107,7638889394.192181,40239854066.240122,3420017,1124193,1494228,6038438
2014-12-16,NYSE MKT (A),0,16401744,8391652,24793396,0.000000,107743852.401300,197259833.428000,305003685.829300,0,42618,35384,78002
2014-12-16,NASDAQ BX (B),95295294,51280612,43340479,189916385,3080838810.782207,2753119008.544907,1881500363.523703,7715458182.850817,716870,219562,342186,1278618
2014-12-16,NYSE (DN),174646441,57417988,88179864,320244293,6017339156.487554,2938614947.974712,3468374078.664509,12424328183.126775,693149,167250,321519,1181918
2014-12-16,NASDAQ (DQ),1385711251,663982648,650309300,2700003199,40767773756.468783,36960684829.586418,22824572567.968532,100553031154.023733,4404278,1119586,2032834,7556698
2014-12-16,ADF (D),34713548,21761084,21711794,78186426,924658189.888900,789281629.176400,704347648.985102,2418287468.050402,170486,60479,90706,321671
2014-12-16,EDGA (J),149976752,74675750,64085410,288737912,4438181037.587690,3783146728.294604,2308566057.214293,10529893823.096587,1162472,350394,520141,2033007
2014-12-16,EDGX (K),232598916,134052566,163001399,529652881,7398083541.333414,6834320619.300788,5951247731.411069,20183651892.045271,1383210,457779,863749,2704738
2014-12-16,CHX (M),11721808,25510402,6348248,43580458,444898801.277400,1845248771.650400,398750435.644000,2688898008.571800,1012,9691,2835,13538
2014-12-16,NYSE (N),1022679437,0,0,1022679437,35660364827.885827,0.000000,0.000000,35660364827.885827,3321919,0,0,3321919
2014-12-16,NYSE Arca (P),444471897,482713248,233010145,1160195290,15047729579.559745,32503063440.944124,9926589724.294010,57477382744.797879,2891128,1476221,1536154,5903503
2014-12-16,NASDAQ (Q),753598090,286910967,643083034,1683592091,29967224612.805158,19548227874.693929,26790463072.749183,76305915560.248270,5920839,1203789,3736884,10861512
2014-12-16,NASDAQ PSX (X),40683450,25085997,22274173,88043620,1280329161.093601,1490445866.719800,826985591.074001,3597760618.887402,259385,95899,125184,480468
2014-12-16,BATS BYX (Y),185808890,90661533,86940445,363410868,5711899562.005775,4921067329.684400,3150075513.845104,13783042405.535279,1447620,416585,661883,2526088
2014-12-16,BATS BZX (Z),434063050,252312577,206072267,892447894,14604625824.322494,16583999672.618420,7734563099.148927,38923188596.089841,3308971,1075661,1508440,5893072
2014-12-15,NYSE MKT (A),0,19790612,7703632,27494244,0.000000,165088232.578801,200568253.470000,365656486.048801,0,41719,31997,73716
2014-12-15,NASDAQ BX (B),87026964,46086796,40137803,173251563,2797001994.331294,2495241039.806697,1606823643.963504,6899066678.101495,673504,205069,311844,1190417
2014-12-15,NYSE (DN),154256418,55994325,91457897,301708640,5516610661.252530,2898557181.916928,3324130705.255725,11739298548.425183,612414,158895,311070,1082379
2014-12-15,NASDAQ (DQ),1163600755,561301658,633095046,2357997459,35622920282.607085,26459780402.150437,21267543604.433599,83350244289.191121,4013584,1054708,1992535,7060827
2014-12-15,ADF (D),33400580,20247775,22998533,76646888,877153480.835401,846928006.723901,675458829.375902,2399540316.935204,161763,63676,96134,321573
2014-12-15,EDGA (J),126046255,65891802,62029626,253967683,4010649680.942207,3413654369.736514,2094661073.592497,9518965124.271218,1062436,324736,502898,1890070
2014-12-15,EDGX (K),218795827,125000113,163845894,507641834,7031830486.539288,6577346506.696483,5578635660.370224,19187812653.605995,1302963,437509,844628,2585100
2014-12-15,CHX (M),10250786,13832274,5878800,29961860,383680030.168000,1115524275.260000,298077385.901000,1797281691.329000,952,7196,2007,10155
2014-12-15,NYSE (N),979863957,0,0,979863957,35016222949.160244,0.000000,0.000000,35016222949.160244,3262572,0,0,3262572
2014-12-15,NYSE Arca (P),370587579,458087485,212538489,1041213553,13010480250.494501,28432315238.304159,8781102652.569868,50223898141.368528,2590578,1349950,1451142,5391670
2014-12-15,NASDAQ (Q),655937249,261438391,618389692,1535765332,26148701886.333470,17674871170.169498,24949930379.027045,68773503435.530013,5241064,1081714,3690847,10013625
2014-12-15,NASDAQ PSX (X),30950303,22724640,19642165,73317108,1003352716.597001,1378357719.741899,672910167.358400,3054620603.697300,219233,92140,118839,430212
2014-12-15,BATS BYX (Y),169544976,82402262,82445702,334392940,5257032431.949030,4627066569.861291,2853074821.280749,12737173823.091070,1380360,380931,630447,2391738
2014-12-15,BATS BZX (Z),372132680,221438235,188817548,782388463,12459518926.354305,13926210134.241858,6852666342.540695,33238395403.136858,2878027,940707,1425818,5244552
2014-12-12,NYSE MKT (A),0,14048758,5260764,19309522,0.000000,98506771.375800,132623444.050000,231130215.425800,0,36640,20768,57408
2014-12-12,NASDAQ BX (B),78646690,38765366,36335855,153747911,2783035642.671706,2294753885.908595,1484200872.172297,6561990400.752598,634665,177629,288731,1101025
2014-12-12,NYSE (DN),152162920,41665545,78730188,272558653,5507183266.585627,2177421876.546295,2850563366.659011,10535168509.790933,581167,117676,263338,962181
2014-12-12,NASDAQ (DQ),1152973853,471898969,581701398,2206574220,36867683384.276012,27305986336.830132,19548376822.797295,83722046543.903439,3870350,901675,1779371,6551396
2014-12-12,ADF (D),32702132,17084100,17674231,67460463,857004664.078000,682830150.976900,541992546.776200,2081827361.831100,151705,54165,74885,280755
2014-12-12,EDGA (J),114829256,60512495,49761255,225103006,3664146531.078115,3169259702.951494,1683143271.341200,8516549505.370809,954968,278186,400363,1633517
2014-12-12,EDGX (K),209537328,110575559,140421882,460534769,6999917606.543118,6251125833.248812,5240771224.119637,18491814663.911567,1230314,378525,745493,2354332
2014-12-12,CHX (M),10627362,12085311,5862724,28575397,367509051.031000,1294665374.210000,470584938.135000,2132759363.376000,789,8522,1700,11011
2014-12-12,NYSE (N),963738083,0,0,963738083,35453719432.746277,0.000000,0.000000,35453719432.746277,2974186,0,0,2974186
2014-12-12,NYSE Arca (P),348089869,358699113,186314937,893103919,12804956238.994039,26164704546.713591,7678538622.931216,46648199408.638846,2421044,1124012,1267651,4812707
2014-12-12,NASDAQ (Q),593800183,206885873,538875032,1339561088,24205262799.911131,14634272372.963201,22126531591.187992,60966066764.062324,4602712,886402,3040864,8529978
2014-12-12,NASDAQ PSX (X),31095920,16998739,16355105,64449764,993654267.789100,1229066753.493901,599063438.867201,2821784460.150202,207921,70800,98498,377219
2014-12-12,BATS BYX (Y),155057059,71316114,72382261,298755434,5104023219.811008,4083932723.490507,2522865756.370387,11710821699.671902,1254322,321953,562473,2138748
2014-12-12,BATS BZX (Z),340183967,189224214,160988123,690396304,11756673801.405382,12108509732.328302,5880802484.420383,29745986018.154067,2608477,794962,1192227,4595666
2014-12-11,NYSE MKT (A),0,12937108,6244950,19182058,0.000000,79106601.875900,156577573.921000,235684175.796900,0,31768,23889,55657
2014-12-11,NASDAQ BX (B),78909037,35203563,35023034,149135634,2834927914.446899,2023608829.254999,1540642521.936095,6399179265.637993,638358,157991,284396,1080745
2014-12-11,NYSE (DN),153486278,41463838,82843087,277793203,5430988520.229920,2133981036.977994,3176241089.925309,10741210647.133223,580537,113748,280988,975273
2014-12-11,NASDAQ (DQ),1179188057,448198152,605684248,2233070457,36929268719.256411,23810645986.937065,21145731322.542609,81885646028.736085,3810886,810458,1815330,6436674
2014-12-11,ADF (D),30723601,15427963,19364476,65516040,875887549.153599,568012371.855100,623168972.954799,2067068893.963498,151527,45293,80574,277394
2014-12-11,EDGA (J),114896692,48842279,52876374,216615345,3904459908.039614,2618216678.394596,1821630658.020820,8344307244.455030,964435,236089,421094,1621618
2014-12-11,EDGX (K),205202437,96068723,145677364,446948524,6944328348.814112,5280324827.973399,5306475226.468140,17531128403.255651,1222593,323003,743417,2289013
2014-12-11,CHX (M),11655238,10052625,7023906,28731769,463961683.663000,955204373.357600,336091891.085700,1755257948.106300,853,5309,1490,7652
2014-12-11,NYSE (N),824430847,0,0,824430847,29251719546.886115,0.000000,0.000000,29251719546.886115,2692569,0,0,2692569
2014-12-11,NYSE Arca (P),333708059,305589017,180886617,820183693,11725767326.272984,20821129898.136846,7320338053.048114,39867235277.457944,2188876,897296,1201675,4287847
2014-12-11,NASDAQ (Q),549409179,179229551,499483600,1228122330,22144495696.362510,12061633981.517011,19758819485.798696,53964949163.678217,4252587,750385,2894173,7897145
2014-12-11,NASDAQ PSX (X),26962382,16435130,14133905,57531417,872279363.965101,1237867335.926301,525291682.874701,2635438382.766103,176411,63856,84236,324503
2014-12-11,BATS BYX (Y),148211696,65681453,69349574,283242723,4702756216.940880,3655607992.010299,2403590061.308409,10761954270.259588,1178377,293001,535742,2007120
2014-12-11,BATS BZX (Z),308076975,158521911,156673226,623272112,10583879099.935578,10120384593.788490,5746340020.927681,26450603714.651749,2398312,643621,1160550,4202483
2014-12-10,NYSE MKT (A),0,15868245,6199862,22068107,0.000000,102660979.976800,126904887.484200,229565867.461000,0,35903,23941,59844
2014-12-10,NASDAQ BX (B),71950836,34873844,38063671,144888351,2630333622.453184,1965012891.563905,1519846177.773897,6115192691.790986,589667,148949,302637,1041253
2014-12-10,NYSE (DN),150505315,43205710,75559437,269270462,5609540455.267328,2254842721.878999,3055684560.400402,10920067737.546729,597164,116516,272307,985987
2014-12-10,NASDAQ (DQ),1162404848,465456659,560788481,2188649988,39234362534.752180,24136641806.836133,19914703105.095747,83285707446.684060,3967786,848391,1812035,6628212
2014-12-10,ADF (D),29171898,14718198,15630763,59520859,871843302.852600,613346627.638401,549755763.283401,2034945693.774402,158710,46015,74597,279322
2014-12-10,EDGA (J),118118550,54886923,52666378,225671851,4047514111.380600,2841934793.600609,1838808138.336490,8728257043.317699,997536,241551,430058,1669145
2014-12-10,EDGX (K),208538566,99931192,138341552,446811310,7154966363.125010,5640615823.859780,5005960454.547093,17801542641.531883,1279652,325990,742911,2348553
2014-12-10,CHX (M),18266744,6696776,5837413,30800933,689006649.064200,782414303.571000,258019910.490000,1729440863.125200,1726,5786,1481,8993
2014-12-10,NYSE (N),915147192,0,0,915147192,34066916385.212899,0.000000,0.000000,34066916385.212899,2854437,0,0,2854437
2014-12-10,NYSE Arca (P),344980981,333446619,187123508,865551108,12999877967.735446,21450018190.380078,7889690496.965398,42339586655.080922,2420614,979069,1270992,4670675
2014-12-10,NASDAQ (Q),577681019,194029657,524567793,1296278469,23720604943.838047,12704665168.711365,21534409784.687212,57959679897.236624,4500623,777245,3014337,8292205
2014-12-10,NASDAQ PSX (X),29420494,18050228,14757739,62228461,977135862.070000,1191237384.961000,574448799.754800,2742822046.785800,194761,68566,94867,358194
2014-12-10,BATS BYX (Y),155255870,67847539,76223445,299326854,5116614732.767327,3779984743.238293,2579279973.852887,11475879449.858507,1247925,300731,576791,2125447
2014-12-10,BATS BZX (Z),334085546,171084383,158886993,664056922,11994855599.164984,10671004787.056359,5920305129.710904,28586165515.932247,2610250,672757,1213240,4496247
2014-12-09,NYSE MKT (A),0,15950897,6209567,22160464,0.000000,97226296.952200,163573047.348200,260799344.300400,0,35268,24679,59947
2014-12-09,NASDAQ BX (B),69989152,33762984,35758516,139510652,2440801244.136910,1841854743.666898,1492283973.158608,5774939960.962416,575193,149754,290936,1015883
2014-12-09,NYSE (DN),151804977,43184477,83937411,278926865,5540986527.127137,2104724244.013298,3463996761.472978,11109707532.613413,617229,113333,315328,1045890
2014-12-09,NASDAQ (DQ),1187461900,438184581,650482166,2276128647,38994356665.108292,21531740510.702554,23832379015.657175,84358476191.468021,3968568,845100,1936103,6749771
2014-12-09,ADF (D),29091296,15497066,17297097,61885459,825377137.121799,598067895.312800,611272144.284700,2034717176.719299,138865,43581,78328,260774
2014-12-09,EDGA (J),110691864,48696680,51983830,211372374,3657340775.863902,2472398226.517199,1874451572.185996,8004190574.567097,935970,227711,427619,1591300
2014-12-09,EDGX (K),204769059,104790429,145557489,455116977,7026510721.337137,5203361703.641711,5542411808.644098,17772284233.622946,1250093,330124,770685,2350902
2014-12-09,CHX (M),8839354,12996328,8240722,30076404,387795812.549000,1199089509.266200,399379170.815000,1986264492.630200,931,5469,1103,7503
2014-12-09,NYSE (N),834277593,0,0,834277593,30393584796.697850,0.000000,0.000000,30393584796.697850,2661346,0,0,2661346
2014-12-09,NYSE Arca (P),329785623,310592298,183580221,823958142,12367733859.298122,19119808085.109399,8151491261.683215,39639033206.090736,2306815,895250,1281730,4483795
2014-12-09,NASDAQ (Q),553745043,180089221,520737417,1254571681,22703073658.588953,10980748233.237270,21436919909.490226,55120741801.316449,4328233,714066,3016470,8058769
2014-12-09,NASDAQ PSX (X),27207869,17025591,15187056,59420516,944270614.472399,1149521256.747501,586054503.628099,2679846374.847999,192948,68201,95085,356234
2014-12-09,BATS BYX (Y),149672786,63169408,76678822,289521016,4815758456.977599,3369732256.205404,2696384112.118316,10881874825.301319,1199356,284089,594375,2077820
2014-12-09,BATS BZX (Z),319468296,158645333,159020584,637134213,11151090482.771323,9367911819.121093,5962653569.156536,26481655871.048952,2489324,627146,1199765,4316235
2014-12-08,NYSE MKT (A),0,15558178,6074132,21632310,0.000000,171280368.045100,174291881.439100,345572249.484200,0,33458,25149,58607
2014-12-08,NASDAQ BX (B),70772869,33348570,37864389,141985828,2502964006.294904,1686166393.631203,1590835878.533508,5779966278.459615,581204,144326,300571,1026101
2014-12-08,NYSE (DN),139448050,35826059,79201818,254475927,5286727288.856072,1552230054.822201,3297160317.056820,10136117660.735093,486751,89674,253769,830194
2014-12-08,NASDAQ (DQ),1114963014,422886727,647203485,2185053226,36955541075.590922,19268118400.255698,22794555941.247013,79018215417.093633,3864002,775559,1936403,6575964
2014-12-08,ADF (D),34359418,15417607,24004722,73781747,971939167.874699,531168257.012800,719075670.347700,2222183095.235199,154915,45437,94793,295145
2014-12-08,EDGA (J),110620694,46343523,55327125,212291342,3767793709.060594,2145499644.530502,2005195182.141195,7918488535.732291,947517,220743,441834,1610094
2014-12-08,EDGX (K),209558659,91607299,158776566,459942524,7280846960.805112,4709979751.310686,5731206818.955094,17722033531.070892,1233539,300295,785472,2319306
2014-12-08,CHX (M),10961616,9308861,5651502,25921979,446835179.285000,739781245.259200,272450420.895000,1459066845.439200,1062,3819,1253,6134
2014-12-08,NYSE (N),813717800,0,0,813717800,30234478141.789794,0.000000,0.000000,30234478141.789794,2615049,0,0,2615049
2014-12-08,NYSE Arca (P),299169756,288983432,180695525,768848713,11590956380.422126,17939420628.382451,7822188712.136011,37352565720.940588,2176255,769853,1229417,4175525
2014-12-08,NASDAQ (Q),531697663,147778807,531021761,1210498231,22660782659.364930,8805657281.885226,22217619637.576326,53684059578.826482,4199633,595389,3015085,7810107
2014-12-08,NASDAQ PSX (X),26616534,15699961,15069521,57386016,882571753.949998,978840176.871200,584231801.214099,2445643732.035297,182860,60953,92702,336515
2014-12-08,BATS BYX (Y),148339132,56444129,75143470,279926731,4757959424.369954,2735351848.040898,2619162074.081818,10112473346.492670,1210100,255414,582363,2047877
2014-12-08,BATS BZX (Z),294381820,129336290,154981854,578699964,10661856321.125869,7888858585.802834,5796472116.226037,24347187023.154740,2371303,530867,1211009,4113179
2014-12-05,NYSE MKT (A),0,13274218,5910061,19184279,0.000000,79475445.752400,162963926.721500,242439372.473900,0,28512,23135,51647
2014-12-05,NASDAQ BX (B),60856128,23522648,32363968,116742744,2188664496.818601,1284911303.989299,1326222408.514397,4799798209.322297,498510,106662,243637,848809
2014-12-05,NYSE (DN),137480995,28392939,84490210,250364144,5072943529.088824,1350306112.663301,3250286791.611594,9673536433.363719,519806,83575,281169,884550
2014-12-05,NASDAQ (DQ),1080017080,337390378,584745635,2002153093,36828962165.353803,16865440534.351153,19352892824.002462,73047295523.707418,3536351,651958,1771296,5959605
2014-12-05,ADF (D),30117553,14230859,21399028,65747440,864930100.287898,477324859.574600,617498151.666100,1959753111.528598,134356,39400,82618,256374
2014-12-05,EDGA (J),89225822,33362591,46049693,168638106,2982884792.499800,1638007917.257697,1563224874.779703,6184117584.537200,740627,162175,351791,1254593
2014-12-05,EDGX (K),170248087,73017914,144425928,387691929,5912261126.014994,4203102496.477082,4915751611.057697,15031115233.549773,985247,221995,659770,1867012
2014-12-05,CHX (M),11039736,7579155,4335668,22954559,447352112.071500,736304885.660000,214883899.550000,1398540897.281500,1681,3571,655,5907
2014-12-05,NYSE (N),754954107,0,0,754954107,28136732226.137801,0.000000,0.000000,28136732226.137801,2219419,0,0,2219419
2014-12-05,NYSE Arca (P),254265055,227285094,156104285,637654434,10078365411.177514,13879937963.950086,6340545579.230411,30298848954.358011,1822255,621383,1017887,3461525
2014-12-05,NASDAQ (Q),437854714,127920570,472030276,1037805560,18445251890.564652,8099986559.130430,18504272349.625601,45049510799.320683,3358533,485363,2455655,6299551
2014-12-05,NASDAQ PSX (X),21035329,10969169,12432408,44436906,738932609.948001,720479994.206500,456420834.160499,1915833438.315000,145469,41556,75156,262181
2014-12-05,BATS BYX (Y),126994163,41881528,68718658,237594349,4212548132.365914,2187943500.023106,2234722465.009694,8635214097.398714,1035880,195586,505832,1737298
2014-12-05,BATS BZX (Z),249116417,108938289,137847165,495901871,9002326436.467259,6523208090.563516,4936018426.567612,20461552953.598387,1957807,437266,975459,3370532
2014-12-04,NYSE MKT (A),0,12924732,5593640,18518372,0.000000,144909418.585100,170178449.572500,315087868.157600,0,26173,22888,49061
2014-12-04,NASDAQ BX (B),57558488,23548487,31516826,112623801,2052486680.304495,1330242543.608102,1287841455.170504,4670570679.083101,468437,108475,231804,808716
2014-12-04,NYSE (DN),126135397,27652560,75626118,229414075,4924756201.472535,1332802455.565925,2896914432.420012,9154473089.458472,510926,91389,274897,877212
2014-12-04,NASDAQ (DQ),1039997248,327086232,569376097,1936459577,36387498096.126470,15739499374.489535,19373893177.699014,71500890648.315019,3500538,649305,1694949,5844792
2014-12-04,ADF (D),29451147,12921367,17385104,59757618,815536364.189799,465100475.117800,521057835.089802,1801694674.397401,125769,36978,73499,236246
2014-12-04,EDGA (J),91858808,31921095,46043060,169822963,3122948314.688590,1681134256.760099,1644094040.897800,6448176612.346489,777433,161697,366039,1305169
2014-12-04,EDGX (K),172119006,68576511,131633118,372328635,5766769692.580516,3987072340.228802,4905088154.691717,14658930187.501035,983156,216392,651290,1850838
2014-12-04,CHX (M),5167132,6460601,9527461,21155194,249336064.925800,600131277.849000,321062543.507000,1170529886.281800,599,3089,1099,4787
2014-12-04,NYSE (N),798776946,0,0,798776946,30226791154.492681,0.000000,0.000000,30226791154.492681,2277094,0,0,2277094
2014-12-04,NYSE Arca (P),256446124,222853111,152316499,631615734,10272082141.338797,14063895952.640026,6418806391.659031,30754784485.637854,1854578,621439,1038059,3514076
2014-12-04,NASDAQ (Q),442930987,121089874,474434038,1038454899,18998447397.581054,8015874191.793934,19163051545.218706,46177373134.593694,3490838,479774,2454568,6425180
2014-12-04,NASDAQ PSX (X),20305303,12334109,12803695,45443107,699448957.945000,868140293.037001,490638668.532501,2058227919.514502,143953,47667,78010,269630
2014-12-04,BATS BYX (Y),126587695,42930394,66302369,235820458,4212220592.464908,2281252854.934300,2282129868.291196,8775603315.690404,1059201,211149,506445,1776795
2014-12-04,BATS BZX (Z),246940157,109199176,134451104,490590437,8945817261.396464,6933349711.026111,4839736461.155945,20718903433.578520,1970205,478171,1029864,3478240
2014-12-03,NYSE MKT (A),0,14184369,6844810,21029179,0.000000,142617636.740300,168163058.446000,310780695.186300,0,31162,21676,52838
2014-12-03,NASDAQ BX (B),67437576,22647726,33806445,123891747,2475293339.096503,1181981692.204599,1354316476.447805,5011591507.748907,558172,107652,272013,937837
2014-12-03,NYSE (DN),138915494,29819953,75839189,244574636,5404025683.765398,1356599968.855195,3121617699.570603,9882243352.191196,541264,93962,266831,902057
2014-12-03,NASDAQ (DQ),1127547280,339831017,585187366,2052565663,38874658206.147336,17251247737.154726,20822893417.596278,76948799360.898340,3754647,656487,1774665,6185799
2014-12-03,ADF (D),31232766,13792365,17494798,62519929,952220353.838300,442810489.062000,553504749.894200,1948535592.794500,150169,36585,80359,267113
2014-12-03,EDGA (J),105253142,32446606,49220680,186920428,3744488283.634496,1607108306.345898,1841586410.182106,7193183000.162500,921899,162450,411017,1495366
2014-12-03,EDGX (K),181080623,65627456,124474703,371182782,6395237474.004212,3671118222.454111,4766798878.733049,14833154575.191372,1104941,221356,668946,1995243
2014-12-03,CHX (M),14910105,9993462,6856073,31759640,486154714.933200,715721469.821500,340058961.251000,1541935146.005700,1079,2598,828,4505
2014-12-03,NYSE (N),775976395,0,0,775976395,29954617889.024716,0.000000,0.000000,29954617889.024716,2431047,0,0,2431047
2014-12-03,NYSE Arca (P),278953571,212208255,159004061,650165887,10901531144.019376,12036282763.804112,6483593486.513014,29421407394.336502,2026755,622384,1094080,3743219
2014-12-03,NASDAQ (Q),490980387,113066053,472814549,1076860989,20936056272.092180,6924339133.292436,19813470540.018270,47673865945.402886,4016556,457717,2673576,7147849
2014-12-03,NASDAQ PSX (X),23395283,11098728,12566192,47060203,861233001.943302,722693265.730000,475947007.941999,2059873275.615301,169057,48444,78537,296038
2014-12-03,BATS BYX (Y),140694515,41888294,68165717,250748526,4832079674.210766,2112810672.935401,2339681259.777933,9284571606.924100,1166877,202153,535749,1904779
2014-12-03,BATS BZX (Z),263802987,103884449,132294617,499982053,9672510020.356130,6484059696.225699,4905828474.145388,21062398190.727217,2125417,469587,1021073,3616077
2014-12-02,NYSE MKT (A),0,15397467,8592249,23989716,0.000000,105159462.155000,259327806.734800,364487268.889800,0,34370,31344,65714
2014-12-02,NASDAQ BX (B),67896709,27251049,36735474,131883232,2484059334.106195,1318515352.327802,1456499471.428999,5259074157.862996,567816,119422,281192,968430
2014-12-02,NYSE (DN),141701621,34486479,79542006,255730106,5811244952.724218,1561453927.921404,3282674803.295400,10655373683.941022,568639,100954,279639,949232
2014-12-02,NASDAQ (DQ),1094288261,389837462,620157136,2104282859,38347542624.275329,16659420658.535222,20708320589.454713,75715283872.265264,3878362,744840,1871763,6494965
2014-12-02,ADF (D),34069568,16373415,19765304,70208287,1040606109.229398,490286741.637400,605120396.275799,2136013247.142597,170778,43462,91676,305916
2014-12-02,EDGA (J),104917642,40580319,53744136,199242097,3719119589.040401,1840573794.501102,1868399457.161709,7428092840.703212,923426,197654,429364,1550444
2014-12-02,EDGX (K),184384861,79643814,131926218,395954893,6457304316.975591,3894649179.463698,5059005682.085595,15410959178.524884,1142432,249093,703075,2094600
2014-12-02,CHX (M),20889426,7164829,9164631,37218886,994205865.146000,513370336.226800,706288884.315000,2213865085.687800,811,2846,811,4468
2014-12-02,NYSE (N),813108611,0,0,813108611,29890488448.958172,0.000000,0.000000,29890488448.958172,2438091,0,0,2438091
2014-12-02,NYSE Arca (P),290075202,251998406,173564899,715638507,11185539925.708081,13557990105.369149,7161722388.571986,31905252419.649216,2072097,704097,1124661,3900855
2014-12-02,NASDAQ (Q),509332056,126098743,485888494,1121319293,21837196789.827913,7421591341.232453,19396529771.569441,48655317902.629807,4189288,508757,2688555,7386600
2014-12-02,NASDAQ PSX (X),22129637,10281788,14042318,46453743,769246324.087599,614731372.610000,532080900.204799,1916058596.902398,162783,37822,87800,288405
2014-12-02,BATS BYX (Y),141652508,45958524,72749538,260360570,4766967827.128698,2287057913.007393,2383327970.066991,9437353710.203082,1192179,220178,559242,1971599
2014-12-02,BATS BZX (Z),267922438,117317014,136243593,521483045,9739803230.154689,6999075598.799998,5172226684.918534,21911105513.873221,2164181,478653,1034425,3677259
2014-12-01,NYSE MKT (A),0,23079133,6818346,29897479,0.000000,141441903.878500,228500038.146800,369941942.025300,0,40499,25988,66487
2014-12-01,NASDAQ BX (B),78747985,35345854,37395739,151489578,2755571220.245988,1817877412.135103,1646895772.882497,6220344405.263588,647515,156413,318136,1122064
2014-12-01,NYSE (DN),170234750,46893720,84473635,301602105,6542361559.350076,2167819524.647095,3575502046.645217,12285683130.642388,662664,142593,304384,1109641
2014-12-01,NASDAQ (DQ),1249369240,532972688,622034324,2404376252,42704298289.394003,23853310217.028021,22080428338.891610,88638036845.313634,4419416,948875,2032175,7400466
2014-12-01,ADF (D),38648171,19458913,21458054,79565138,1190052485.335998,696760762.943301,770634686.722902,2657447935.002201,204295,59015,107961,371271
2014-12-01,EDGA (J),120893323,55397621,58487026,234777970,4227687628.073106,2609723120.134098,2154142606.229891,8991553354.437095,1069320,253056,489415,1811791
2014-12-01,EDGX (K),209952079,103112301,137358818,450423198,7541286071.884106,5288249851.055770,5402592570.467987,18232128493.407863,1317076,343321,764577,2424974
2014-12-01,CHX (M),13152477,12720784,5726317,31599578,656754616.956000,1083409530.463800,311300037.260000,2051464184.679800,1588,3870,1435,6893
2014-12-01,NYSE (N),877332550,0,0,877332550,32115993264.899088,0.000000,0.000000,32115993264.899088,2773185,0,0,2773185
2014-12-01,NYSE Arca (P),328592674,359213702,173530431,861336807,12857452887.988323,19565687774.240035,7788270504.754973,40211411166.983331,2375298,879744,1247113,4502155
2014-12-01,NASDAQ (Q),593595693,167869730,509830288,1271295711,25144966819.045198,10497931696.247646,21592392773.421007,57235291288.713851,4910220,657917,3165605,8733742
2014-12-01,NASDAQ PSX (X),25199697,15609783,14713398,55522878,889932020.227000,952466733.884400,575592249.803699,2417991003.915099,179436,56379,93109,328924
2014-12-01,BATS BYX (Y),160507890,60819686,74542403,295869979,5257703461.073428,3110782287.274192,2633160290.267416,11001646038.615036,1327850,284407,617596,2229853
2014-12-01,BATS BZX (Z),301970243,152107163,151165039,605242445,11146267078.410290,9264752433.098911,6158403276.093343,26569422787.602544,2434713,598365,1213175,4246253
2014-11-28,NYSE MKT (A),0,11711306,2349753,14061059,0.000000,126140602.135000,102492073.725000,228632675.860000,0,20563,9687,30250
2014-11-28,NASDAQ BX (B),38672385,21558947,15837337,76068669,1303647427.708303,1102371232.480399,628765093.731399,3034783753.920101,305958,94933,125485,526376
2014-11-28,NYSE (DN),79705584,22907393,34632158,137245135,3204416987.925291,1044772024.495700,1311805737.026400,5560994749.447391,347668,74934,129547,552149
2014-11-28,NASDAQ (DQ),743430392,291107614,314859667,1349397673,25627776550.330708,13110098303.847563,11318001229.038386,50055876083.216657,2439578,534544,1045102,4019224
2014-11-28,ADF (D),24587519,11158618,11902577,47648714,726746730.164200,368388734.324400,365649065.816599,1460784530.305199,114005,32709,56468,203182
2014-11-28,EDGA (J),58877220,30676968,25049140,114603328,2036490368.318296,1384731546.344900,831120033.182802,4252341947.845998,497864,137866,208503,844233
2014-11-28,EDGX (K),133039122,63017804,75781695,271838621,4693656475.357809,2843846996.255291,2680916765.875986,10218420237.489086,733872,192282,382439,1308593
2014-11-28,CHX (M),2212817,4227990,1488927,7929734,123685026.240000,392328100.390000,86331458.860000,602344585.490000,667,2045,472,3184
2014-11-28,NYSE (N),648650214,0,0,648650214,24724545473.456926,0.000000,0.000000,24724545473.456926,1672355,0,0,1672355
2014-11-28,NYSE Arca (P),194050989,253513352,89772330,537336671,7705052005.198379,12713868946.304321,3839973337.784298,24258894289.286998,1332464,529547,614707,2476718
2014-11-28,NASDAQ (Q),324197111,104999214,316904754,746101079,13893821563.266390,5954156536.538688,13358767981.661917,33206746081.466995,2579596,393747,1645958,4619301
2014-11-28,NASDAQ PSX (X),13334862,7359055,7041292,27735209,498750665.940000,415292394.028000,275278155.885000,1189321215.853000,96745,26079,45240,168064
2014-11-28,BATS BYX (Y),76882342,33398617,32131433,142412392,2610770424.461286,1559465745.757101,1144680380.398609,5314916550.616996,619777,147536,266857,1034170
2014-11-28,BATS BZX (Z),167023430,91283849,71459014,329766293,6369990281.287683,5082309409.259505,2797532030.942920,14249831721.490108,1322602,348507,555697,2226806
2014-11-26,NYSE MKT (A),0,10025626,5461971,15487597,0.000000,66954452.353400,151689347.581000,218643799.934400,0,21958,19835,41793
2014-11-26,NASDAQ BX (B),49448691,19996192,27190973,96635856,1798116685.605995,981606622.534501,1098982379.938197,3878705688.078693,419674,91071,222465,733210
2014-11-26,NYSE (DN),100691854,23370989,59547621,183610464,3931267075.636805,1050793322.224199,2374791686.313641,7356852084.174645,407308,74654,222650,704612
2014-11-26,NASDAQ (DQ),820466486,270223283,457231642,1547921411,29897159153.980644,13436504138.820908,16610697780.523131,59944361073.324683,2967004,540465,1561988,5069457
2014-11-26,ADF (D),24873764,11140552,15752418,51766734,816450166.783499,341694602.110000,580301602.090799,1738446370.984298,127351,33193,74077,234621
2014-11-26,EDGA (J),70006068,28281638,39536680,137824386,2563587363.263590,1376980800.341800,1502529285.767912,5443097449.373302,633990,139889,320084,1093963
2014-11-26,EDGX (K),135662818,51841378,98820112,286324308,4894415212.928697,2406935947.615500,3806323096.501688,11107674257.045885,788308,167563,505463,1461334
2014-11-26,CHX (M),9556211,7522458,5560356,22639025,405809899.836600,547279515.670000,302971382.523000,1256060798.029600,464,1649,439,2552
2014-11-26,NYSE (N),700102031,0,0,700102031,28621433333.293790,0.000000,0.000000,28621433333.293790,1847338,0,0,1847338
2014-11-26,NYSE Arca (P),201499931,182644337,123986016,508130284,8236083616.068923,10777900189.528231,5038144125.208412,24052127930.805566,1439073,475717,831540,2746330
2014-11-26,NASDAQ (Q),343559238,86825358,368522867,798907463,15462827558.842686,5169371039.794916,15834198407.427849,36466397006.065451,2861032,334751,2091583,5287366
2014-11-26,NASDAQ PSX (X),15989045,7436485,9620018,33045548,627830151.141500,431315734.641600,402848347.512299,1461994233.295399,124252,29022,60363,213637
2014-11-26,BATS BYX (Y),101178642,31554143,52055781,184788566,3617183677.720504,1571515309.170900,1835238290.431399,7023937277.322803,846374,153996,422557,1422927
2014-11-26,BATS BZX (Z),172921414,77719342,101578092,352218848,6441883354.000561,4475048223.948093,3915862008.439300,14832793586.387954,1393299,309253,769913,2472465
2014-11-25,NYSE MKT (A),0,16001787,5909900,21911687,0.000000,118535855.381300,217846592.826000,336382448.207300,0,28566,24186,52752
2014-11-25,NASDAQ BX (B),63793644,28480394,33212042,125486080,2413694441.304906,1422234483.601600,1376875532.313406,5212804457.219912,531430,123576,263344,918350
2014-11-25,NYSE (DN),112799817,27350882,65920906,206071605,4740754140.569097,1321022446.207801,2828200920.621791,8889977507.398689,456322,78521,240319,775162
2014-11-25,NASDAQ (DQ),1024001520,332433425,589108017,1945542962,38669251790.180088,17260642440.822475,23168760022.837379,79098654253.839942,3483816,651382,1743409,5878607
2014-11-25,ADF (D),32110224,15148592,18443660,65702476,1034921637.861998,566506294.639000,630295372.226301,2231723304.727299,166017,42913,87585,296515
2014-11-25,EDGA (J),93204737,35331916,45625661,174162314,3410195855.051383,1733231299.227200,1710725543.085595,6854152697.364178,831998,175247,382951,1390196
2014-11-25,EDGX (K),153249526,65629482,107873250,326752258,5837947369.276503,3243745248.223200,4411267308.486190,13492959925.985893,933641,209421,587489,1730551
2014-11-25,CHX (M),10760175,4410576,7230121,22400872,546287613.083600,533543888.450200,431767063.348500,1511598564.882300,876,2549,1254,4679
2014-11-25,NYSE (N),846469886,0,0,846469886,34897666569.123146,0.000000,0.000000,34897666569.123146,2170495,0,0,2170495
2014-11-25,NYSE Arca (P),251874874,219799791,142430651,614105316,10439094672.815055,12638666370.324596,6243019624.566537,29320780667.706188,1790809,565231,998560,3354600
2014-11-25,NASDAQ (Q),438684165,120930613,511375818,1070990596,19747898399.484516,7262212973.905806,21914911672.877993,48925023046.268315,3627335,440828,2509141,6577304
2014-11-25,NASDAQ PSX (X),22496055,10438367,12858099,45792521,834005060.554900,691374780.661300,514270197.841001,2039650039.057201,162257,38487,81255,281999
2014-11-25,BATS BYX (Y),127226588,41173999,64086453,232487040,4576966215.202196,2234719873.151402,2335529031.308508,9147215119.662106,1074845,197289,509721,1781855
2014-11-25,BATS BZX (Z),217394623,102481104,117682013,437557740,8306333261.378258,6427684035.471485,4893973384.418571,19627990681.268314,1749457,394487,919735,3063679
2014-11-24,NYSE MKT (A),0,12597682,4272938,16870620,0.000000,175070981.099200,116922870.730600,291993851.829800,0,26126,19208,45334
2014-11-24,NASDAQ BX (B),60553837,23418121,31904671,115876629,2211105686.646798,1207716783.168401,1298390002.692997,4717212472.508196,507995,104398,263464,875857
2014-11-24,NYSE (DN),116059468,26875953,67707071,210642492,4961873358.628571,1216701770.786500,2950171743.632430,9128746873.047501,463355,77980,250370,791705
2014-11-24,NASDAQ (DQ),952559907,328418689,525623680,1806602276,35936198481.109660,15835424926.853764,19242561209.951258,71014184617.914682,3441499,634009,1769517,5845025
2014-11-24,ADF (D),28057445,11905557,18412714,58375716,938430137.259601,404098964.390700,641172579.196300,1983701680.846601,144792,34661,92098,271551
2014-11-24,EDGA (J),83597376,31089758,43300930,157988064,3091641560.370492,1533284317.590900,1606054658.732718,6230980536.694110,754115,151957,370192,1276264
2014-11-24,EDGX (K),156943255,58852236,115320861,331116352,5921235838.741281,2733356262.920201,4274797584.041308,12929389685.702790,921826,189326,606022,1717174
2014-11-24,CHX (M),11246853,9120854,4203777,24571484,623670235.834500,880514406.000000,233072927.012500,1737257568.847000,548,1991,522,3061
2014-11-24,NYSE (N),709530893,0,0,709530893,28659397085.034043,0.000000,0.000000,28659397085.034043,2130833,0,0,2130833
2014-11-24,NYSE Arca (P),240193354,203446249,141842092,585481695,9792973065.533154,12400741156.509949,6018284312.228122,28211998534.271225,1689649,526062,978815,3194526
2014-11-24,NASDAQ (Q),425073983,98349450,433378381,956801814,18987799628.947524,5819664925.867419,18174788747.302441,42982253302.117384,3465439,380439,2418027,6263905
2014-11-24,NASDAQ PSX (X),20961532,9471663,12283142,42716337,768418251.045000,558831126.771400,498678108.513699,1825927486.330099,148677,36214,79016,263907
2014-11-24,BATS BYX (Y),113729758,37096224,59080301,209906283,3990065721.246899,2004771166.137700,2099558241.508099,8094395128.892698,949148,169745,466733,1585626
2014-11-24,BATS BZX (Z),218669860,86181906,117383594,422235360,8229335815.138518,5116057398.245395,4461149067.804874,17806542281.188787,1737752,347983,923687,3009422
2014-11-21,NYSE MKT (A),0,15147944,5080755,20228699,0.000000,119778858.102300,130798872.845000,250577730.947300,0,33028,23959,56987
2014-11-21,NASDAQ BX (B),67083507,32479676,33800636,133363819,2367714934.241297,1685778108.076502,1402277625.259592,5455770667.577391,519746,140752,258436,918934
2014-11-21,NYSE (DN),138588196,36920067,70203345,245711608,5452852109.449535,1805403882.486098,2877277500.911503,10135533492.847136,523752,100258,250955,874965
2014-11-21,NASDAQ (DQ),1107534584,426727208,569713044,2103974836,41056268905.411255,25919846483.395175,20854125640.068728,87830241028.875158,3776225,786325,1835613,6398163
2014-11-21,ADF (D),31701082,18105064,19449030,69255176,1021012314.622801,696695099.877300,644245033.783099,2361952448.283200,162861,53101,95907,311869
2014-11-21,EDGA (J),93601428,43862253,47129743,184593424,3178196223.849703,2222551048.372801,1679005426.292910,7079752698.515414,788319,208039,379039,1375397
2014-11-21,EDGX (K),193405415,85579649,132925478,411910542,7124925533.302189,4420768047.562999,5081206047.733140,16626899628.598328,1118494,267437,678098,2064029
2014-11-21,CHX (M),14719906,12795872,9321233,36837011,677893964.493400,1434160499.700000,965672747.213000,3077727211.406400,1640,3089,778,5507
2014-11-21,NYSE (N),1037307838,0,0,1037307838,44353938598.117122,0.000000,0.000000,44353938598.117122,2464673,0,0,2464673
2014-11-21,NYSE Arca (P),309906898,325178306,172525739,807610943,12501926781.347783,20637314270.192747,7459645402.513060,40598886454.053590,2079110,728030,1138954,3946094
2014-11-21,NASDAQ (Q),515032780,158131274,580463613,1253627667,22003971735.930964,10312241544.306408,25498785584.125931,57814998864.363303,4008026,552804,2775950,7336780
2014-11-21,NASDAQ PSX (X),22563299,13280800,13606719,49450818,796439128.423500,897479064.911800,520713925.575801,2214632118.911101,156223,47836,84884,288943
2014-11-21,BATS BYX (Y),130990083,49869942,62700277,243560302,4577875951.438607,2622747670.287399,2204559351.059505,9405182972.785511,1071386,228202,488705,1788293
2014-11-21,BATS BZX (Z),260681797,131883152,139060351,531625300,9306793372.068764,8552514796.752987,5516864843.412821,23376173012.234572,1972111,499006,1015830,3486947
2014-11-20,NYSE MKT (A),0,12793945,4568187,17362132,0.000000,96436788.351200,125850592.483000,222287380.834200,0,29361,21553,50914
2014-11-20,NASDAQ BX (B),55403461,22445189,30547739,108396389,1976877246.249893,1152136765.032601,1248858486.345794,4377872497.628288,449792,100599,243843,794234
2014-11-20,NYSE (DN),120471473,29333075,68953622,218758170,5090146129.913206,1241131185.525703,2947271242.098709,9278548557.537618,457766,77435,248090,783291
2014-11-20,NASDAQ (DQ),957804633,311475542,562403876,1831684051,36515143847.884162,13081149896.865914,20189972661.195940,69786266405.946016,3410332,613060,1778490,5801882
2014-11-20,ADF (D),27134223,15774390,19140761,62049374,912490435.071401,436991436.374100,611039863.405800,1960521734.851301,143514,38252,89802,271568
2014-11-20,EDGA (J),82533893,31480398,44284479,158298770,2931441083.373510,1557845179.151496,1607534706.428806,6096820968.953812,725055,151731,369412,1246198
2014-11-20,EDGX (K),162169113,66142128,124985865,353297106,6081405007.514203,2941497307.740797,4393139882.284972,13416042197.539972,971943,196293,631834,1800070
2014-11-20,CHX (M),13958856,15103282,10968616,40030754,614123468.242200,1588478976.052000,742385556.874300,2944988001.168500,966,2207,561,3734
2014-11-20,NYSE (N),661780805,0,0,661780805,25855149002.191357,0.000000,0.000000,25855149002.191357,2199178,0,0,2199178
2014-11-20,NYSE Arca (P),255554566,209061733,161335575,625951874,10323596999.908874,11161387458.191670,6593007772.190276,28077992230.290820,1797495,538025,1082774,3418294
2014-11-20,NASDAQ (Q),437400565,107255570,438831296,983487431,19563404371.793582,6398243738.010832,17745835438.385094,43707483548.189508,3563001,412339,2551832,6527172
2014-11-20,NASDAQ PSX (X),20190982,10130263,13465229,43786474,713541647.206301,645069074.195400,520956054.842700,1879566776.244401,142546,35109,80851,258506
2014-11-20,BATS BYX (Y),112128805,36398000,59862373,208389178,3969476445.924390,1939373314.965796,2084405236.513724,7993254997.403910,941980,169244,464474,1575698
2014-11-20,BATS BZX (Z),222082015,93732627,130040655,445855297,8019360638.150721,5767392176.968105,4697963599.979332,18484716415.098158,1771757,375408,983191,3130356
2014-11-19,NYSE MKT (A),0,15559193,5336619,20895812,0.000000,143021877.480100,141605631.769000,284627509.249100,0,34480,22964,57444
2014-11-19,NASDAQ BX (B),61400531,30518052,32958959,124877542,2204724237.124402,1435661887.156499,1318101642.528086,4958487766.808987,518270,134251,272477,924998
2014-11-19,NYSE (DN),128451414,34009895,72781978,235243287,5336965629.314123,1400546770.275599,3096091081.616973,9833603481.206695,490109,90157,267317,847583
2014-11-19,NASDAQ (DQ),996640154,389696581,511731479,1898068214,36783228318.235877,16079182572.850216,18617641693.026688,71480052584.112781,3476541,719382,1771863,5967786
2014-11-19,ADF (D),30661349,18154664,18439781,67255794,1007763781.693101,555931597.888400,629060925.750299,2192756305.331800,153282,48223,91154,292659
2014-11-19,EDGA (J),90540101,39292868,44290487,174123456,3173367547.047888,1748771558.475902,1690962599.416495,6613101704.940285,791439,190003,376116,1357558
2014-11-19,EDGX (K),180960929,80595505,123470331,385026765,6588438341.161602,3225041598.938204,4670906509.606638,14484386449.706444,1097706,245149,665374,2008229
2014-11-19,CHX (M),9284069,9814399,6479330,25577798,463769830.658800,746790341.220000,544594517.065600,1755154688.944400,395,3092,534,4021
2014-11-19,NYSE (N),737562546,0,0,737562546,26963989851.401778,0.000000,0.000000,26963989851.401778,2381485,0,0,2381485
2014-11-19,NYSE Arca (P),288395971,283404109,163583168,735383248,11153407026.786369,15294177371.698246,6799219943.664842,33246804342.149457,2002781,735706,1132910,3871397
2014-11-19,NASDAQ (Q),492037585,148903939,451714147,1092655671,20691048420.654759,8245611956.687231,18322433292.075779,47259093669.417769,3985295,581453,2791694,7358442
2014-11-19,NASDAQ PSX (X),21961257,11677490,12739495,46378242,768238143.208600,680293685.658000,482526552.569999,1931058381.436599,161282,46452,83826,291560
2014-11-19,BATS BYX (Y),125357494,47306635,62977016,235641145,4304339903.989291,2342849076.454198,2186123034.220893,8833312014.664382,1029233,215160,493201,1737594
2014-11-19,BATS BZX (Z),256519122,124348367,139352854,520220343,8686109325.384920,6976197874.414200,5169642101.514518,20831949301.313638,1966599,492449,1054379,3513427
2014-11-18,NYSE MKT (A),0,14130546,4675615,18806161,0.000000,96877354.544900,128390915.806000,225268270.350900,0,33427,20904,54331
2014-11-18,NASDAQ BX (B),62435393,27974854,31122022,121532269,2303036128.938699,1409504231.459200,1282003898.519504,4994544258.917403,494545,119413,239847,853805
2014-11-18,NYSE (DN),133325453,30175569,69485771,232986793,5770321844.310787,1239355788.938705,2872875926.816712,9882553560.066204,512408,82798,251195,846401
2014-11-18,NASDAQ (DQ),1044719560,386690711,553656109,1985066380,38458477796.181514,19363256337.286378,19575993561.294742,77397727694.762634,3627444,667589,1733645,6028678
2014-11-18,ADF (D),29582699,15005273,19358321,63946293,959392483.926501,483477726.418600,605785020.385699,2048655230.730800,145625,39709,86759,272093
2014-11-18,EDGA (J),87681771,40175547,43061098,170918416,3209846112.543813,1754657184.117500,1661327446.599393,6625830743.260706,769833,158947,359323,1288103
2014-11-18,EDGX (K),178607108,66351565,128366065,373324738,6678568112.499421,2933642986.536591,4367432632.355311,13979643731.391323,1057790,198590,630365,1886745
2014-11-18,CHX (M),9857184,7266882,3490604,20614670,519497065.473400,634330183.150000,250513277.165000,1404340525.788400,423,2072,468,2963
2014-11-18,NYSE (N),730771459,0,0,730771459,27916680700.423617,0.000000,0.000000,27916680700.423617,2249926,0,0,2249926
2014-11-18,NYSE Arca (P),280552229,238296618,153866523,672715370,11174400566.349600,12687278223.110324,6382243423.612405,30243922213.072329,1901792,586456,1050446,3538694
2014-11-18,NASDAQ (Q),472865503,113425908,443656526,1029947937,20740566541.479068,6722267061.559918,17894807747.034864,45357641350.073850,3843018,421834,2593227,6858079
2014-11-18,NASDAQ PSX (X),21720634,11184967,12382283,45287884,785099771.598400,715031189.448600,499217473.979999,1999348435.026999,160894,42211,83058,286163
2014-11-18,BATS BYX (Y),136099469,43571059,65178631,244849159,4579720594.454102,2181324276.959101,2285300811.433085,9046345682.846288,1097599,189231,519708,1806538
2014-11-18,BATS BZX (Z),239369700,104851514,130641193,474862407,8617511665.792133,6393642317.303621,4781953715.850328,19793107698.946082,1852184,400939,975690,3228813
2014-11-17,NYSE MKT (A),0,16085473,5161147,21246620,0.000000,149548191.230200,125149957.969100,274698149.199300,0,29590,24192,53782
2014-11-17,NASDAQ BX (B),54877916,23962019,31218020,110057955,2129686951.533300,1123153759.226494,1226192639.736295,4479033350.496089,461933,113594,244315,819842
2014-11-17,NYSE (DN),123453018,30425762,73526906,227405686,5978080668.256845,1289853887.059998,3059313238.678696,10327247793.995539,494512,151993,265581,912086
2014-11-17,NASDAQ (DQ),914560034,331090243,564920454,1810570731,35673203960.536212,16483050810.927751,19202283632.037594,71358538403.501557,3340520,707009,1702913,5750442
2014-11-17,ADF (D),27656564,11595931,21055803,60308298,916884876.286501,388573003.212900,696651353.570898,2002109233.070299,140155,32571,93005,265731
2014-11-17,EDGA (J),80229099,30604258,45855281,156688638,2986525358.013097,1424664408.219902,1583563388.813188,5994753155.046187,728026,153255,369680,1250961
2014-11-17,EDGX (K),160281874,57771673,140129286,358182833,6359424934.293911,2420629496.243299,4692027868.822467,13472082299.359677,992202,187026,663739,1842967
2014-11-17,CHX (M),7186287,5320771,4388718,16895776,532076024.192000,400190067.080000,223161400.655000,1155427491.927000,957,2235,726,3918
2014-11-17,NYSE (N),693834875,0,0,693834875,26887108759.941233,0.000000,0.000000,26887108759.941233,2290288,0,0,2290288
2014-11-17,NYSE Arca (P),263015307,196647414,158153601,617816322,11578476582.143592,11300115113.165378,6415065991.604207,29293657686.913177,1875852,580188,1069103,3525143
2014-11-17,NASDAQ (Q),463323048,106743160,453873305,1023939513,20813926449.925320,6157814617.868604,18085123864.777080,45056864932.571004,3838089,433628,2647441,6919158
2014-11-17,NASDAQ PSX (X),20259835,9366618,10751225,40377678,727725787.607500,592313400.556200,408909305.577301,1728948493.741001,149428,38184,73509,261121
2014-11-17,BATS BYX (Y),121340429,38800387,65006061,225146877,4363707579.346659,1906737582.228502,2210223062.040192,8480668223.615353,1037509,182365,514144,1734018
2014-11-17,BATS BZX (Z),223788905,93958758,126790691,444538354,8244317381.860752,5764079831.175285,4686930827.147031,18695328040.183068,1788111,387265,953246,3128622
2014-11-14,NYSE MKT (A),0,16735843,4597020,21332863,0.000000,122063216.718800,128840269.763000,250903486.481800,0,31214,19232,50446
2014-11-14,NASDAQ BX (B),58062981,29815470,31146550,119025001,2013231346.749801,1293019785.741600,1303341405.357899,4609592537.849300,465206,127565,246739,839510
2014-11-14,NYSE (DN),130975815,31868648,76556241,239400704,5280649862.654532,1309790766.665298,3117882768.230020,9708323397.549850,499977,88816,278062,866855
2014-11-14,NASDAQ (DQ),946980303,348724782,577988205,1873693290,33105122865.826752,16092946934.456609,19909300484.449761,69107370284.733122,3286379,630304,1800355,5717038
2014-11-14,ADF (D),28851621,16304040,20459990,65615651,914225977.126000,552786932.223701,645360053.463698,2112372962.813399,145490,42616,87175,275281
2014-11-14,EDGA (J),76296641,36060221,42836189,155193051,2521264032.291192,1586899759.388501,1483432553.389701,5591596345.069394,655208,168670,334798,1158676
2014-11-14,EDGX (K),170065056,73725698,138005949,381796703,6066504758.906397,3048305513.778896,4762702490.348634,13877512763.033927,1012347,231201,653456,1897004
2014-11-14,CHX (M),6245654,7937092,3666307,17849053,314071528.069600,550717916.145000,275215112.481600,1140004556.696200,798,2513,568,3879
2014-11-14,NYSE (N),704851874,0,0,704851874,26058543000.637326,0.000000,0.000000,26058543000.637326,2136163,0,0,2136163
2014-11-14,NYSE Arca (P),274354024,249539498,166446593,690340115,10669658491.460417,13741704919.351076,6863512572.190144,31274875983.001637,1906647,636236,1105608,3648491
2014-11-14,NASDAQ (Q),445186003,124449885,465905258,1035541146,18576877331.699051,6688358901.666106,18455715026.565898,43720951259.931055,3632685,499234,2595348,6727267
2014-11-14,NASDAQ PSX (X),20920335,9998822,12069040,42988197,733773723.651001,562185770.167500,494607540.397300,1790567034.215801,150010,40306,81412,271728
2014-11-14,BATS BYX (Y),132267671,43843768,67172613,243284052,4450037670.854201,2095905292.213598,2382193694.177393,8928136657.245192,1075888,201531,516878,1794297
2014-11-14,BATS BZX (Z),232500357,119715631,136289437,488505425,8071818403.112467,7118593019.798491,4999909190.162293,20190320613.073251,1815471,471875,982438,3269784
2014-11-13,NYSE MKT (A),0,10924565,5558326,16482891,0.000000,98642365.141000,182263776.244000,280906141.385000,0,22959,23449,46408
2014-11-13,NASDAQ BX (B),61307871,28636967,32904206,122849044,2226636550.005397,1483337012.239002,1376568328.364909,5086541890.609308,507337,131308,261101,899746
2014-11-13,NYSE (DN),135422321,31962780,79467060,246852161,5929696978.586194,1545655985.845296,3335487742.453601,10810840706.885091,527621,91460,286075,905156
2014-11-13,NASDAQ (DQ),1011874123,319967569,614583749,1946425441,37685652238.185728,14200541398.308337,21285852441.133600,73172046077.627665,3630854,657938,1901210,6190002
2014-11-13,ADF (D),32453277,15645304,22702308,70800889,1130181108.811499,623891745.684800,703787315.368201,2457860169.864500,159240,49119,100936,309295
2014-11-13,EDGA (J),87434440,33798564,48155184,169388188,3257148146.565598,1810715100.462698,1759311690.879698,6827174937.907994,784816,171626,395719,1352161
2014-11-13,EDGX (K),204434808,72214845,153730103,430379756,7669027532.695103,3444516368.967504,5190709290.762693,16304253192.425300,1189548,237714,730845,2158107
2014-11-13,CHX (M),13542943,8386258,4941001,26870202,838600478.559400,545010656.090000,401712117.290000,1785323251.939400,528,3211,476,4215
2014-11-13,NYSE (N),708114597,0,0,708114597,26882688299.405928,0.000000,0.000000,26882688299.405928,2337592,0,0,2337592
2014-11-13,NYSE Arca (P),293368537,241207484,180219680,714795701,12167995130.357562,14371219114.595102,7293096513.789880,33832310758.742544,2060610,665051,1192181,3917842
2014-11-13,NASDAQ (Q),512460227,130518147,485648682,1128627056,22600723373.697598,7994956518.178555,18964237879.828286,49559917771.704439,4217871,544370,2809050,7571291
2014-11-13,NASDAQ PSX (X),22440828,11805424,13605951,47852203,842642042.256901,787775130.189801,529083416.472299,2159500588.919001,169557,48744,89657,307958
2014-11-13,BATS BYX (Y),143450788,46638891,69751461,259841140,5061550090.223727,2455606322.191295,2474489997.116421,9991646409.531443,1193288,212136,555449,1960873
2014-11-13,BATS BZX (Z),244689842,119260479,147655934,511606255,9025565059.678419,7487519112.176280,5425043453.472706,21938127625.327405,1927270,482293,1058136,3467699
2014-11-12,NYSE MKT (A),0,12271007,5965435,18236442,0.000000,94655642.977900,181175311.019000,275830953.996900,0,25972,23737,49709
2014-11-12,NASDAQ BX (B),56967465,24478218,32887835,114333518,2061340166.624503,1172309242.457099,1243293209.506901,4476942618.588503,478120,106498,259977,844595
2014-11-12,NYSE (DN),123873065,25046169,77381770,226301004,5246939184.219446,1141658582.050306,2823285797.751711,9211883564.021463,475638,71664,269951,817253
2014-11-12,NASDAQ (DQ),968023448,295064523,589955150,1853043121,34472199003.463144,17357744115.337753,19260067790.815665,71090010909.616562,3307169,560268,1737341,5604778
2014-11-12,ADF (D),31836235,12042059,21154814,65033108,1071653073.055500,440341889.859400,648313955.670799,2160308918.585699,157758,36581,93869,288208
2014-11-12,EDGA (J),81469155,28346145,47002179,156817479,2930057241.639008,1432983167.358604,1604238868.646185,5967279277.643797,724228,142850,377215,1244293
2014-11-12,EDGX (K),175911772,58130580,139553536,373595888,6637844000.136651,2623301142.201198,4427285943.958654,13688431086.296503,1046298,194630,664839,1905767
2014-11-12,CHX (M),12796563,7273217,5450676,25520456,442505963.639200,668386550.800000,259939120.508100,1370831634.947300,431,2900,674,4005
2014-11-12,NYSE (N),718436947,0,0,718436947,27249453315.775466,0.000000,0.000000,27249453315.775466,2213246,0,0,2213246
2014-11-12,NYSE Arca (P),270287079,200378714,169808606,640474399,10855121115.265781,12313173264.888799,6453254124.136952,29621548504.291532,1912201,552432,1105928,3570561
2014-11-12,NASDAQ (Q),464673791,110046896,468761555,1043482242,19968905575.203396,6562385098.888409,17904310993.762504,44435601667.854309,3830119,441911,2612071,6884101
2014-11-12,NASDAQ PSX (X),20992974,9338526,12198705,42530205,745597068.719400,584986771.400000,472036033.237800,1802619873.357200,158644,39270,82195,280109
2014-11-12,BATS BYX (Y),121691523,32576583,70425001,224693107,4224283916.629233,1676921382.136599,2259973254.390609,8161178553.156441,1026268,159973,524387,1710628
2014-11-12,BATS BZX (Z),226008434,102170551,134855925,463034910,7952542036.966136,6176179053.470805,4596772034.931822,18725493125.368763,1773735,397657,970294,3141686
2014-11-11,NYSE MKT (A),0,11625747,5715960,17341707,0.000000,86680255.570100,137145627.863000,223825883.433100,0,26425,21782,48207
2014-11-11,NASDAQ BX (B),52589974,22042334,30499432,105131740,1922470917.241496,975595579.678102,1183269062.095598,4081335559.015196,431948,104740,236976,773664
2014-11-11,NYSE (DN),115671633,26335929,78366842,220374404,5052890228.958709,1091759298.744302,2977211279.509318,9121860807.212329,456985,75801,273131,805917
2014-11-11,NASDAQ (DQ),877219524,294035055,568782938,1740037517,31599601488.537656,13147911379.542336,18565178537.333038,63312691405.413030,3163981,572717,1692658,5429356
2014-11-11,ADF (D),28508830,11828965,20191830,60529625,1008777032.130100,395460892.085600,623103270.117402,2027341194.333102,144120,32399,89553,266072
2014-11-11,EDGA (J),75101098,28480337,43943438,147524873,2711336812.873298,1228691466.767499,1460828412.121990,5400856691.762787,674892,140320,340898,1156110
2014-11-11,EDGX (K),163105434,56022177,127873116,347000727,6372664869.216925,2300633463.783997,4309172631.917578,12982470964.918500,994739,182630,619889,1797258
2014-11-11,CHX (M),12211809,8649925,4684023,25545757,551951358.498600,977380147.550000,237441948.604000,1766773454.652600,507,1976,412,2895
2014-11-11,NYSE (N),614488289,0,0,614488289,22780772294.437832,0.000000,0.000000,22780772294.437832,2096259,0,0,2096259
2014-11-11,NYSE Arca (P),253928316,204003190,152647681,610579187,10315177714.246575,10316117146.603628,6143804276.363611,26775099137.213814,1776689,516562,1014380,3307631
2014-11-11,NASDAQ (Q),427873340,101050662,430694897,959618899,18806599220.504121,5467534696.269304,16860541023.857904,41134674940.631329,3536774,403040,2478844,6418658
2014-11-11,NASDAQ PSX (X),18857416,8786724,11820242,39464382,672216767.724000,485014359.645000,431377753.430399,1588608880.799399,139614,32582,77945,250141
2014-11-11,BATS BYX (Y),117161648,34055351,65300309,216517308,4049406114.167623,1644181443.351506,2119028289.811317,7812615847.330446,967543,165647,483233,1616423
2014-11-11,BATS BZX (Z),202069835,92159856,124942927,419172618,7151325687.122545,5228277926.099301,4382737487.934696,16762341101.156542,1614857,359523,888525,2862905
2014-11-10,NYSE MKT (A),0,13162990,6958262,20121252,0.000000,82722811.896600,200766322.968100,283489134.864700,0,27431,26545,53976
2014-11-10,NASDAQ BX (B),56048895,26123096,32825886,114997877,2022089419.984002,1205655125.494397,1247134181.167201,4474878726.645600,462495,127107,253878,843480
2014-11-10,NYSE (DN),128965463,30589173,82261060,241815696,5518042437.390462,1228806667.757804,3074341427.231347,9821190532.379613,512966,85232,296818,895016
2014-11-10,NASDAQ (DQ),966198949,311845179,591172927,1869217055,35922764328.518903,13052494153.621563,19771728823.191746,68746987305.332212,3494423,641756,1853391,5989570
2014-11-10,ADF (D),30316101,13573315,21547768,65437184,1104432546.943697,466480619.600000,634171368.312700,2205084534.856397,148036,38836,95924,282796
2014-11-10,EDGA (J),84676578,33766564,52758327,171201469,3035870926.487095,1564490352.289598,1793493551.492512,6393854830.269205,768348,168443,408991,1345782
2014-11-10,EDGX (K),185234401,67159945,147966315,400360661,7261422494.926873,2741268974.072400,4614583518.194236,14617274987.193509,1102034,213137,705160,2020331
2014-11-10,CHX (M),13863911,4554786,4404254,22822951,507633217.702000,361176860.510000,242388293.789000,1111198372.001000,410,2026,510,2946
2014-11-10,NYSE (N),716773466,0,0,716773466,27169370690.890650,0.000000,0.000000,27169370690.890650,2349777,0,0,2349777
2014-11-10,NYSE Arca (P),267468314,248679302,171019562,687167178,11331857418.268797,13183657637.850831,6497268894.522949,31012783950.642577,1950491,610007,1141976,3702474
2014-11-10,NASDAQ (Q),463645339,114489765,493928909,1072064013,20495028691.072721,6408040839.516713,18741901144.038592,45644970674.628026,3922821,463473,2812993,7199287
2014-11-10,NASDAQ PSX (X),19735016,9734725,12723562,42193303,705118595.578999,618903155.294200,475567460.879699,1799589211.752898,152705,41401,85019,279125
2014-11-10,BATS BYX (Y),126060057,40413408,70403873,236877338,4293339845.129114,2034898919.457705,2358503997.647800,8686742762.234619,1029595,193320,535994,1758909
2014-11-10,BATS BZX (Z),227165392,100012179,144393521,471571092,8210700943.162082,6196367406.994203,5185935080.023002,19593003430.179287,1795796,403443,1029735,3228974
2014-11-07,NYSE MKT (A),0,14558064,5894629,20452693,0.000000,84448572.500000,150668408.579500,235116981.079500,0,31106,23847,54953
2014-11-07,NASDAQ BX (B),60581759,30956324,35958987,127497070,2134303260.041395,1471191625.811699,1312119681.636098,4917614567.489192,495121,137646,269892,902659
2014-11-07,NYSE (DN),132864815,33670180,87906854,254441849,5295565197.901629,1342441902.068606,3046414996.914101,9684422096.884336,520786,89365,303004,913155
2014-11-07,NASDAQ (DQ),1237578386,369098734,703201166,2309878286,43723580178.944156,15838512409.141116,22875952259.960441,82438044848.045713,3504410,655872,1875115,6035397
2014-11-07,ADF (D),30213593,14769873,21337008,66320474,972876639.387401,464218223.741700,638564793.437700,2075659656.566801,145393,41321,96406,283120
2014-11-07,EDGA (J),87396513,40168689,49104670,176669872,2901029621.064199,1910831188.294701,1549370984.349102,6361231793.708002,749098,187802,389262,1326162
2014-11-07,EDGX (K),193479263,75499837,140742177,409721277,7072782411.464607,3162559158.882892,4766802906.790221,15002144477.137720,1144166,239672,717038,2100876
2014-11-07,CHX (M),12116204,7871114,5241584,25228902,923106708.561500,588556374.780000,302775540.653200,1814438623.994700,472,2618,716,3806
2014-11-07,NYSE (N),773595681,0,0,773595681,29468792538.347736,0.000000,0.000000,29468792538.347736,2411492,0,0,2411492
2014-11-07,NYSE Arca (P),291713946,283579435,179974946,755268327,11752775489.137681,15387102061.978913,6974844733.800314,34114722284.916908,2055860,656922,1192485,3905267
2014-11-07,NASDAQ (Q),490458196,143421246,508179894,1142059336,21170919986.330852,8407165407.446122,19858917695.542145,49437003089.319119,3977049,534850,2905987,7417886
2014-11-07,NASDAQ PSX (X),20825987,10191745,13991044,45008776,782508426.334801,587642670.124200,494109847.296400,1864260943.755401,168395,44129,94300,306824
2014-11-07,BATS BYX (Y),130821039,45142595,76565334,252528968,4486780159.033692,2272449425.276196,2365809963.164112,9125039547.474000,1070119,195890,555173,1821182
2014-11-07,BATS BZX (Z),243141468,125031495,152528611,520701574,8451739753.279220,7357327547.873743,5097168765.286450,20906236066.439413,1883511,466404,1051804,3401719
2014-11-06,NYSE MKT (A),0,14754433,7366770,22121203,0.000000,62228364.326400,201597729.258300,263826093.584700,0,32342,31630,63972
2014-11-06,NASDAQ BX (B),63823711,31900031,36775705,132499447,2208570666.876091,1476716692.457000,1446364137.057208,5131651496.390299,505022,131452,273074,909548
2014-11-06,NYSE (DN),141206198,31923697,91364421,264494316,5628957157.436634,1404079979.031895,3406813143.845030,10439850280.313559,538742,99283,312565,950590
2014-11-06,NASDAQ (DQ),1131471479,391860968,655473082,2178805529,39654822467.584095,20228366814.802946,22507482562.791739,82390671845.178780,3741079,694830,2074266,6510175
2014-11-06,ADF (D),31732522,15281934,22459697,69474153,945653043.892600,532590033.864499,692390463.274999,2170633541.032098,148879,44878,99055,292812
2014-11-06,EDGA (J),98746341,41135544,54373181,194255066,3438438172.280593,1920034087.630103,1949495303.223002,7307967563.133698,840947,194699,437937,1473583
2014-11-06,EDGX (K),197242251,74766084,153878909,425887244,6914876117.990199,3397897202.572893,5418763436.753711,15731536757.316803,1149955,241009,785190,2176154
2014-11-06,CHX (M),10104368,8262564,8417222,26784154,406983513.993500,599792300.810000,575292247.960900,1582068062.764400,874,3182,886,4942
2014-11-06,NYSE (N),751914047,0,0,751914047,27707997920.441345,0.000000,0.000000,27707997920.441345,2539997,0,0,2539997
2014-11-06,NYSE Arca (P),312627244,282635967,200007872,795271083,12430224001.582019,16574206979.613412,8338616784.383099,37343047765.578530,2205958,688179,1344007,4238144
2014-11-06,NASDAQ (Q),516312346,143289572,515505681,1175107599,22138683573.054057,8577289934.666940,20815151045.316439,51531124553.037436,4206874,545252,3112380,7864506
2014-11-06,NASDAQ PSX (X),22865006,10815701,14055904,47736611,794865019.079501,648227268.668700,535613416.526300,1978705704.274501,174110,46116,91703,311929
2014-11-06,BATS BYX (Y),141389159,46710076,78234418,266333653,4672597661.747588,2391495414.662101,2586587759.596006,9650680836.005695,1143738,215714,600640,1960092
2014-11-06,BATS BZX (Z),256734290,124966893,154751550,536452733,8907669509.658231,7953734649.810765,5462490173.552536,22323894333.021532,1997389,474180,1113517,3585086
2014-11-05,NYSE MKT (A),0,13794110,6750716,20544826,0.000000,71086462.861300,167238777.858000,238325240.719300,0,28984,26998,55982
2014-11-05,NASDAQ BX (B),65775132,32395871,38018742,136189745,2403905288.392494,1618573856.069398,1525190087.051698,5547669231.513590,592308,139795,315966,1048069
2014-11-05,NYSE (DN),148019800,32439726,93708502,274168028,6110074372.811610,1543141390.482902,3499781124.612855,11152996887.907367,557614,91859,317974,967447
2014-11-05,NASDAQ (DQ),1157286382,340528727,656379015,2154194124,40552362741.602291,15598166940.508744,22572316684.121290,78722846366.232325,3961842,698928,2066406,6727176
2014-11-05,ADF (D),31668405,14902053,21556832,68127290,1007405710.030398,636593511.192600,691931423.822400,2335930645.045398,163147,45136,103771,312054
2014-11-05,EDGA (J),93191288,37189291,54440092,184820671,3200665493.381790,1896159485.772101,1984719521.531711,7081544500.685602,824671,181932,455449,1462052
2014-11-05,EDGX (K),204768540,73825289,154053338,432647167,7700591595.053617,3309267650.597690,5674833256.479865,16684692502.131172,1238658,233528,790559,2262745
2014-11-05,CHX (M),11648183,9126198,6026235,26800616,464253075.963700,831931679.912600,461007267.224300,1757192023.100600,832,4345,865,6042
2014-11-05,NYSE (N),796746389,0,0,796746389,30485869261.447799,0.000000,0.000000,30485869261.447799,2635557,0,0,2635557
2014-11-05,NYSE Arca (P),321798088,266176030,198797323,786771441,13510037557.777044,15832766185.881188,8190832472.738060,37533636216.396292,2315877,702683,1352085,4370645
2014-11-05,NASDAQ (Q),526695310,139407488,523304190,1189406988,23534407390.267978,8668402348.153689,21167164162.151798,53369973900.573465,4353502,547257,3196969,8097728
2014-11-05,NASDAQ PSX (X),23303556,12029592,13628612,48961760,870996978.261199,752534028.618100,505113889.119999,2128644895.999298,180898,49207,91514,321619
2014-11-05,BATS BYX (Y),145574694,45490857,79707042,270772593,4955601104.417876,2464986241.927407,2600898826.948289,10021486173.293572,1201393,206820,597877,2006090
2014-11-05,BATS BZX (Z),269904976,126729600,159055012,555689588,9541165804.247590,8240489106.580405,5629641294.882650,23411296205.710645,2060711,487880,1118357,3666948
2014-11-04,NYSE MKT (A),0,13349164,7186720,20535884,0.000000,108453648.672400,215393352.028000,323847000.700400,0,29102,32899,62001
2014-11-04,NASDAQ BX (B),71278961,30310525,38900517,140490003,2590833695.633809,1508437677.950897,1503484871.797596,5602756245.382302,588120,135891,299294,1023305
2014-11-04,NYSE (DN),154064162,31931428,82944978,268940568,6147245618.583821,1511565028.488600,3126819111.150638,10785629758.223059,578214,99737,301236,979187
2014-11-04,NASDAQ (DQ),1197211902,352590495,614328623,2164131020,42672988634.958175,17774553517.704202,20764989862.778433,81212532015.440810,4029949,685812,1944879,6660640
2014-11-04,ADF (D),32898833,13811231,21844705,68554769,1091744811.146299,559338581.980000,682185855.623302,2333269248.749601,164987,41963,96940,303890
2014-11-04,EDGA (J),101859375,37838402,58458745,198156522,3684889626.803802,1972312351.216300,2093751536.913398,7750953514.933500,873687,182498,455548,1511733
2014-11-04,EDGX (K),215009179,70048466,152362756,437420401,8159643286.567031,3235855978.514879,5282192910.687516,16677692175.769426,1302715,229757,769803,2302275
2014-11-04,CHX (M),13062787,11754806,8417452,33235045,488343828.286400,772005089.660000,553722640.386400,1814071558.332800,758,3291,874,4923
2014-11-04,NYSE (N),832785524,0,0,832785524,31546942702.611693,0.000000,0.000000,31546942702.611693,2686047,0,0,2686047
2014-11-04,NYSE Arca (P),340984783,262119806,185537122,788641711,13958076062.257882,15185836924.269365,7627168035.334881,36771081021.862128,2374139,669997,1264908,4309044
2014-11-04,NASDAQ (Q),557980210,135208718,515225611,1208414539,24402856454.629008,8238997319.710420,20510464345.155202,53152318119.494630,4500533,527516,3016867,8044916
2014-11-04,NASDAQ PSX (X),21533911,10825932,13432994,45792837,805209291.415000,646375122.277200,514195895.355000,1965780309.047200,170201,45213,92072,307486
2014-11-04,BATS BYX (Y),146157306,44553889,80384521,271095716,5154076074.902418,2380612927.734399,2619870454.449582,10154559457.086399,1204477,213342,609556,2027375
2014-11-04,BATS BZX (Z),272109564,126878317,162090249,561078130,9636196807.122197,8503767513.753928,5499741802.863757,23639706123.739882,2075026,494592,1134525,3704143
2014-11-03,NYSE MKT (A),0,12837447,6327829,19165276,0.000000,86132379.369300,209215799.311000,295348178.680300,0,30598,31521,62119
2014-11-03,NASDAQ BX (B),69500355,37412519,38736337,145649211,2479754972.103704,1827488100.811099,1468149720.857893,5775392793.772696,566478,152547,295797,1014822
2014-11-03,NYSE (DN),133917710,38295062,86760141,258972913,5475678869.012561,1817708195.785903,3341036494.194940,10634423558.993404,552381,109234,312518,974133
2014-11-03,NASDAQ (DQ),1012406331,549346231,684302392,2246054954,37531375889.915187,28139638402.463873,22900111766.784023,88571126059.163083,3871684,793076,2042766,6707526
2014-11-03,ADF (D),39506858,19829387,24177419,83513664,1340472838.436199,808042246.598801,742490543.417701,2891005628.452701,178522,56904,101895,337321
2014-11-03,EDGA (J),91409281,47760696,56899367,196069344,3186031895.296898,2406301288.106797,1984059774.809504,7576392958.213199,815493,211054,455203,1481750
2014-11-03,EDGX (K),168305353,72742296,138010028,379057677,6344528998.078925,3607547374.689302,4592510066.342947,14544586439.111174,1070755,240198,693488,2004441
2014-11-03,CHX (M),9110797,10190187,7877031,27178015,334241308.725000,732952916.676000,550967029.709000,1618161255.110000,1245,2274,860,4379
2014-11-03,NYSE (N),799950912,0,0,799950912,30285966627.102561,0.000000,0.000000,30285966627.102561,2635829,0,0,2635829
2014-11-03,NYSE Arca (P),288970468,298201988,191657861,778830317,12368148412.523255,17574372440.971394,7617503249.282463,37560024102.777112,2163750,742015,1262367,4168132
2014-11-03,NASDAQ (Q),524506526,147770465,549763004,1222039995,24094040464.357735,9391509019.278756,21283549128.533010,54769098612.169501,4610888,562887,3146672,8320447
2014-11-03,NASDAQ PSX (X),20928802,12229470,12708809,45867081,858175879.037401,741853697.191600,467908251.255000,2067937827.484001,178903,43492,88201,310596
2014-11-03,BATS BYX (Y),147843891,58083863,87216241,293143995,5148137561.104813,2840466431.734998,2764400139.826717,10753004132.666528,1260466,241757,666629,2168852
2014-11-03,BATS BZX (Z),248740750,139378096,150578404,538697250,9424298531.262764,9252025460.277597,5278320902.345715,23954644893.886076,2025773,535005,1093077,3653855
2014-10-31,NYSE MKT (A),0,15575421,7412290,22987711,0.000000,106147200.282800,236707080.390900,342854280.673700,0,30246,31474,61720
2014-10-31,NASDAQ BX (B),86554738,47397833,45994679,179947250,3103292335.866794,2222226608.158203,1796082039.971590,7121600983.996587,692616,172126,356231,1220973
2014-10-31,NYSE (DN),155301255,43435650,102426032,301162937,6070874922.754393,2161863495.420495,3767210588.885474,11999949007.060362,584162,120559,358037,1062758
2014-10-31,NASDAQ (DQ),1233864526,491129482,782125729,2507119737,44304891213.516839,25692570233.003106,26755737701.347829,96753199147.867774,4001592,836840,2306909,7145341
2014-10-31,ADF (D),38347395,20136973,36807993,95292361,1264342889.094000,817177763.385600,1184318482.741701,3265839135.221301,179020,57108,133397,369525
2014-10-31,EDGA (J),103973925,55748962,62434477,222157364,3425969828.524198,2718611713.843097,2065952649.594092,8210534191.961387,848341,245945,479007,1573293
2014-10-31,EDGX (K),217353361,96353056,169723214,483429631,8079528058.355805,4653523937.710082,5878472229.135743,18611524225.201630,1274341,306049,846029,2426419
2014-10-31,CHX (M),16048671,15920813,9132332,41101816,588508186.535600,1122004241.400000,443645121.270000,2154157549.205600,1752,5464,1185,8401
2014-10-31,NYSE (N),1044485777,0,0,1044485777,39547752635.620448,0.000000,0.000000,39547752635.620448,2740287,0,0,2740287
2014-10-31,NYSE Arca (P),340982122,371681031,226481446,939144599,13929698905.913529,21926090815.490783,9419884302.197600,45275674023.601912,2368256,859484,1487948,4715688
2014-10-31,NASDAQ (Q),583519561,182891190,693206015,1459616766,25592861551.207189,12113919207.735855,27606988947.787972,65313769706.731016,4715931,664097,3675475,9055503
2014-10-31,NASDAQ PSX (X),23710526,15702393,17096888,56509807,894560349.729001,970732736.559999,672818067.121000,2538111153.410000,191009,62313,111827,365149
2014-10-31,BATS BYX (Y),156824050,62188956,90465943,309478949,5359528808.055824,3112830634.209497,3143047871.059998,11615407313.325319,1232563,249712,675161,2157436
2014-10-31,BATS BZX (Z),291598130,166562436,182894264,641054830,10408509871.572741,10709872778.857400,6582526600.387003,27700909250.817144,2159049,601686,1258325,4019060
2014-10-30,NYSE MKT (A),0,12916655,8332033,21248688,0.000000,66380699.207500,306193229.486200,372573928.693700,0,26269,33002,59271
2014-10-30,NASDAQ BX (B),76730462,36842102,41884610,155457174,2574064695.702711,1829561791.586199,1562599526.079820,5966226013.368730,605090,153081,321163,1079334
2014-10-30,NYSE (DN),130751962,30709030,84976687,246437679,4976368246.866605,1524241786.341900,3348102891.448002,9848712924.656507,501505,89478,304030,895013
2014-10-30,NASDAQ (DQ),1060834186,376463830,633565176,2070863192,36458904530.395724,19516416799.787594,21786613850.599512,77761935180.782830,3683096,714472,2024684,6422252
2014-10-30,ADF (D),39999885,15422032,32661007,88082924,1237239051.097499,689410016.542201,1090213126.897500,3016862194.537200,175444,48333,123533,347310
2014-10-30,EDGA (J),95928434,38400005,59320343,193648782,3169719087.979701,2047955819.685600,2029738559.321691,7247413466.986992,786097,179861,457577,1423535
2014-10-30,EDGX (K),199109495,81901108,154330135,435340738,7166464059.325702,3827103208.918800,5355438866.325538,16349006134.570040,1151232,263337,771910,2186479
2014-10-30,CHX (M),9524436,9489292,7179979,26193707,381784841.040000,957317436.110000,203483745.825000,1542586022.975000,1032,5139,1194,7365
2014-10-30,NYSE (N),773750797,0,0,773750797,28215952558.620239,0.000000,0.000000,28215952558.620239,2619753,0,0,2619753
2014-10-30,NYSE Arca (P),311859126,291050824,205755490,808665440,12316910983.412592,18059032636.283809,8026682381.301756,38402626000.998157,2169420,751380,1350515,4271315
2014-10-30,NASDAQ (Q),522764690,158424433,546099182,1227288305,22321331049.578036,10346531792.230730,21610910427.858217,54278773269.666983,4214525,612872,3225983,8053380
2014-10-30,NASDAQ PSX (X),21133674,14771081,15318474,51223229,758730124.215001,1011962434.594401,560804784.359100,2331497343.168502,164243,57043,98557,319843
2014-10-30,BATS BYX (Y),141550949,49813749,79943936,271308634,4678785383.173337,2663824359.407801,2599781466.376313,9942391208.957451,1105097,226766,601706,1933569
2014-10-30,BATS BZX (Z),278898491,145482113,169098881,593479485,9845701003.461755,9513061928.935104,5880385282.667517,25239148215.064376,2112952,549986,1201192,3864130
2014-10-29,NYSE MKT (A),0,11628560,8665921,20294481,0.000000,75866517.687200,251735584.464000,327602102.151200,0,28031,37302,65333
2014-10-29,NASDAQ BX (B),74629956,36108512,46215939,156954407,2614271806.546412,1993863285.263790,1642812428.414402,6250947520.224604,629540,156639,337258,1123437
2014-10-29,NYSE (DN),128728455,35636838,96106876,260472169,5025009523.123615,1957561753.856500,3619175971.596893,10601747248.577008,505016,113933,336979,955928
2014-10-29,NASDAQ (DQ),1084171928,395455633,679233569,2158861130,39091125848.303953,21594338973.400296,23529935204.469521,84215400026.173770,3703034,792557,2096946,6592537
2014-10-29,ADF (D),32568409,15768187,25782264,74118860,1083264805.313401,703744802.366000,800414388.499503,2587423996.178904,169676,47709,107181,324566
2014-10-29,EDGA (J),111501076,44622851,61838745,217962672,3904182906.327695,2500791881.802996,2251818289.506602,8656793077.637293,917530,225529,490356,1633415
2014-10-29,EDGX (K),217111565,90739234,170791889,478642688,7807439004.032216,4451392035.263599,5939941489.193255,18198772528.489070,1259160,312292,825391,2396843
2014-10-29,CHX (M),12659911,11617339,9089927,33367177,540689581.767100,1265511398.770000,768121660.262000,2574322640.799100,852,7637,1009,9498
2014-10-29,NYSE (N),822948567,0,0,822948567,30705203928.406880,0.000000,0.000000,30705203928.406880,3062899,0,0,3062899
2014-10-29,NYSE Arca (P),324373542,313390605,229159526,866923673,12949016606.022452,20367444076.111878,8926693079.832859,42243153761.967189,2326851,908797,1419979,4655627
2014-10-29,NASDAQ (Q),530465776,188641287,578881146,1297988209,22584423783.185528,13467317804.719270,23450873745.531050,59502615333.435848,4227619,786018,3454560,8468197
2014-10-29,NASDAQ PSX (X),22979663,14330614,19065071,56375348,867579357.444301,994148670.776901,651552191.589800,2513280219.811002,185715,57451,110704,353870
2014-10-29,BATS BYX (Y),141753168,48850621,81109923,271713712,4915090906.367906,2903810713.064799,2815057563.513511,10633959182.946216,1188553,235382,619155,2043090
2014-10-29,BATS BZX (Z),272273522,167195346,180302936,619771804,9514419764.877631,11577189653.157204,5950824776.734878,27042434194.769713,2103334,653095,1233084,3989513
2014-10-28,NYSE MKT (A),0,11770239,6763892,18534131,0.000000,126197599.398800,212056854.203000,338254453.601800,0,27448,28769,56217
2014-10-28,NASDAQ BX (B),67564618,30792750,36173680,134531048,2384632451.090903,1747390266.854903,1481456203.929293,5613478921.875099,530879,137819,281367,950065
2014-10-28,NYSE (DN),128536284,29853188,83087317,241476789,5028077980.612739,1625070519.778903,3418336948.171362,10071485448.563004,531652,98569,312787,943008
2014-10-28,NASDAQ (DQ),1115207091,381564149,652888899,2149660139,39874130618.854692,21271497241.529799,23958006682.141646,85103634542.526137,3882438,696645,2065942,6645025
2014-10-28,ADF (D),32310101,11822035,20748901,64881037,1040199850.890898,520791263.705400,726506436.954601,2287497551.550899,149771,35320,94870,279961
2014-10-28,EDGA (J),91618717,34277699,51077623,176974039,3153924907.995199,1920103268.890798,1880872175.295803,6954900352.181800,772883,166009,414627,1353519
2014-10-28,EDGX (K),210510273,73680585,149688836,433879694,7693676259.170188,3708911397.944308,5863945468.079393,17266533125.193889,1137292,234807,724320,2096419
2014-10-28,CHX (M),15401981,13435881,5111440,33949302,585950870.705200,1074135864.366000,340039684.055000,2000126419.126200,1367,3855,809,6031
2014-10-28,NYSE (N),797802854,0,0,797802854,30035754494.455642,0.000000,0.000000,30035754494.455642,2701474,0,0,2701474
2014-10-28,NYSE Arca (P),308952915,260839257,189291291,759083463,12353655822.526304,17318162636.956290,8255676001.837740,37927494461.320334,2089500,688775,1252570,4030845
2014-10-28,NASDAQ (Q),478915375,136516916,541863717,1157296008,20545510359.801533,9577487215.672013,22405836165.970967,52528833741.444513,3689566,522123,3092173,7303862
2014-10-28,NASDAQ PSX (X),21861297,10987122,12866502,45714921,789701792.073000,819070941.127700,492448370.547700,2101221103.748400,173395,41219,84215,298829
2014-10-28,BATS BYX (Y),135023589,40804134,71931232,247758955,4703338617.641908,2583693546.306001,2567087577.801505,9854119741.749414,1090194,190756,568521,1849471
2014-10-28,BATS BZX (Z),250704403,122536469,149405259,522646131,9054938829.173207,8051209263.113216,5260007947.398398,22366156039.684821,1914933,464696,1077994,3457623
2014-10-27,NYSE MKT (A),0,10578988,5542074,16121062,0.000000,80080717.031800,142716904.396900,222797621.428700,0,26551,23094,49645
2014-10-27,NASDAQ BX (B),75074797,28658004,34322696,138055497,2383778836.333799,1461785738.678598,1321988585.502500,5167553160.514897,580069,138968,277752,996789
2014-10-27,NYSE (DN),120434172,29990328,63614192,214038692,4493014736.195112,1552227182.096802,2554735484.286305,8599977402.578219,494562,91418,254232,840212
2014-10-27,NASDAQ (DQ),1034345884,316757581,504722078,1855825543,34207340013.832662,15666749944.884178,17284655166.725088,67158745125.441928,3470563,660234,1665301,5796098
2014-10-27,ADF (D),29390072,12427288,19711548,61528908,948220992.737799,564452513.574900,684732562.352599,2197406068.665298,147204,41487,88568,277259
2014-10-27,EDGA (J),88959568,33146463,44290260,166396291,2861216262.888799,1803756272.767697,1592269342.639601,6257241878.296097,723204,161213,369196,1253613
2014-10-27,EDGX (K),193435343,64350019,120840633,378625995,7005834633.836663,3151678093.141800,4464683602.315409,14622196329.293872,1098313,233205,606691,1938209
2014-10-27,CHX (M),5588214,5459250,4407050,15454514,238427156.210000,415990208.700000,261623805.701200,916041170.611200,750,3493,787,5030
2014-10-27,NYSE (N),760970339,0,0,760970339,27399584070.333990,0.000000,0.000000,27399584070.333990,2575633,0,0,2575633
2014-10-27,NYSE Arca (P),350616194,230008243,146666042,727290479,12228684496.891273,14731259674.743275,6163904030.133736,33123848201.768284,2149026,677275,1031518,3857819
2014-10-27,NASDAQ (Q),467847827,126733033,443450080,1038030940,19010142002.089623,8222353583.275545,17917392652.206783,45149888237.571951,3630547,541706,2666522,6838775
2014-10-27,NASDAQ PSX (X),24295608,9568739,11716872,45581219,765892464.369001,665250873.815001,482935155.935701,1914078494.119703,170270,44273,80162,294705
2014-10-27,BATS BYX (Y),138950676,41463434,62953153,243367263,4534875815.775798,2345638299.500401,2239770842.969812,9120284958.246011,1104096,196503,514170,1814769
2014-10-27,BATS BZX (Z),250187171,114104479,125503534,489795184,8419408930.306167,7179005073.962325,4411720463.051177,20010134467.319669,1830514,470234,909845,3210593
2014-10-24,NYSE MKT (A),0,11396192,6222213,17618405,0.000000,105866994.956900,201237138.032000,307104132.988900,0,24514,27158,51672
2014-10-24,NASDAQ BX (B),66222390,25809436,33981283,126013109,2380184480.635280,1427012215.654400,1563789406.724214,5370986103.013894,552254,138520,288856,979630
2014-10-24,NYSE (DN),103001268,26681783,75380511,205063562,3883573035.249985,1424670336.784294,3423291557.308399,8731534929.342678,438992,85139,269370,793501
2014-10-24,NASDAQ (DQ),880153620,289074320,566054685,1735282625,30808530833.673793,15532897141.700379,21414379580.735750,67755807556.109922,3204801,625168,1789614,5619583
2014-10-24,ADF (D),28745360,12432674,21314574,62492608,884502815.207800,560492521.168000,731180124.350702,2176175460.726502,135962,40363,94977,271302
2014-10-24,EDGA (J),73690245,33513942,46823576,154027763,2434293562.624505,1935143650.512298,1709516754.227406,6078953967.364209,619120,165131,361445,1145696
2014-10-24,EDGX (K),168651488,78814645,132873543,380339676,6242824486.982672,3819238738.247405,5251150079.301455,15313213304.531532,959534,249549,639168,1848251
2014-10-24,CHX (M),7090524,9838426,9223839,26152789,279897439.796000,890713380.778200,451848104.791000,1622458925.365200,580,3876,882,5338
2014-10-24,NYSE (N),717676047,0,0,717676047,26758241487.265301,0.000000,0.000000,26758241487.265301,2387238,0,0,2387238
2014-10-24,NYSE Arca (P),259629087,243341453,170913517,673884057,10275975247.435062,16664363556.257434,7626409578.877784,34566748382.570280,1829216,751584,1107206,3688006
2014-10-24,NASDAQ (Q),416803054,139661275,477310732,1033775061,17629787769.382785,10402503275.253501,21133812088.907365,49166103133.543651,3368876,579934,2813692,6762502
2014-10-24,NASDAQ PSX (X),18642088,11908038,11754987,42305113,650130616.962000,875697946.295000,458763959.404099,1984592522.661099,145706,49764,75662,271132
2014-10-24,BATS BYX (Y),115245761,39621069,64622458,219489288,3891308816.172790,2336368245.447596,2446738855.339605,8674415916.959991,937393,187342,483953,1608688
2014-10-24,BATS BZX (Z),223232324,122641555,139223508,485097387,7813147403.949948,8258619136.858797,5287644522.746601,21359411063.555346,1706097,507505,983546,3197148
2014-10-23,NYSE MKT (A),0,13529723,6344861,19874584,0.000000,96425142.637900,158281931.585000,254707074.222900,0,33180,28513,61693
2014-10-23,NASDAQ BX (B),74053282,34491464,37390573,145935319,2807040280.413580,1951487029.169589,1630437320.650191,6388964630.233360,644051,170739,321454,1136244
2014-10-23,NYSE (DN),126767548,35444549,78488722,240700819,5069430560.415597,1898520393.148796,3353582043.906970,10321532997.471363,514806,113467,289350,917623
2014-10-23,NASDAQ (DQ),1064537955,461735090,615304036,2141577081,37486326116.610197,24208741852.687093,22311171696.951479,84006239666.248769,3705792,765527,1970692,6442011
2014-10-23,ADF (D),34316675,16050990,22794133,73161798,1112925294.445799,754696494.647899,829474295.962702,2697096085.056400,169770,49232,100229,319231
2014-10-23,EDGA (J),110596532,44553039,57844726,212994297,3831360239.110195,2440864043.222105,2277438199.486103,8549662481.818403,908952,205917,485168,1600037
2014-10-23,EDGX (K),217882823,95386025,146718459,459987307,8120457868.558592,4465343294.268297,5804773861.318760,18390575024.145649,1258814,303662,730160,2292636
2014-10-23,CHX (M),8948403,12614221,7276513,28839137,281376287.426800,1122722784.230000,382567285.945000,1786666357.601800,843,5253,1073,7169
2014-10-23,NYSE (N),818799776,0,0,818799776,30678375482.810843,0.000000,0.000000,30678375482.810843,2928518,0,0,2928518
2014-10-23,NYSE Arca (P),339456215,307032336,201315032,847803583,13492636009.329498,20212308282.195103,9115043945.947431,42819988237.472032,2366653,886421,1334085,4587159
2014-10-23,NASDAQ (Q),554829209,181885474,547131598,1283846281,23498174196.293228,13463399813.439333,23354425476.789747,60315999486.522308,4425146,725700,3331449,8482295
2014-10-23,NASDAQ PSX (X),22326236,15796068,12720893,50843197,783661689.674400,1102204371.969001,540615161.313100,2426481222.956501,174778,67266,85303,327347
2014-10-23,BATS BYX (Y),137192456,51682809,68662907,257538172,4696641925.607496,2975316127.464306,2588108449.450789,10260066502.522591,1150163,249490,568275,1967928
2014-10-23,BATS BZX (Z),282309887,160767419,153591023,596668329,9773517602.760130,11122650934.799687,5803587211.669131,26699755749.228948,2097482,623586,1108856,3829924
2014-10-22,NYSE MKT (A),0,11331482,5583812,16915294,0.000000,104037513.632500,151900229.789000,255937743.421500,0,26505,24961,51466
2014-10-22,NASDAQ BX (B),68736702,35428785,36701722,140867209,2546482020.959501,1957154199.968701,1542598969.694494,6046235190.622696,562035,169105,301403,1032543
2014-10-22,NYSE (DN),126797933,34732264,80422595,241952792,4924222551.311926,1866760346.525899,3444854581.401153,10235837479.238978,521398,109348,307471,938217
2014-10-22,NASDAQ (DQ),1059818538,379486964,619698601,2059004103,37404639194.893607,21586869933.949296,22558640047.750311,81550149176.593214,3826662,785325,2029098,6641085
2014-10-22,ADF (D),45375811,17104084,25633051,88112946,1692948974.336396,776950952.296499,955387985.629799,3425287912.262694,241639,56874,119379,417892
2014-10-22,EDGA (J),102304400,46308240,56385539,204998179,3757397091.564891,2682100505.613695,2229353153.570000,8668850750.748586,883731,227273,481759,1592763
2014-10-22,EDGX (K),214833880,94609794,152414390,461858064,8168140684.476103,4693792145.624102,5624373750.295398,18486306580.395603,1280999,308166,763708,2352873
2014-10-22,CHX (M),18459133,10084179,4527388,33070700,752604030.541000,1004632146.010000,258183982.229000,2015420158.780000,1624,4904,700,7228
2014-10-22,NYSE (N),802067347,0,0,802067347,30525663474.071886,0.000000,0.000000,30525663474.071886,2963021,0,0,2963021
2014-10-22,NYSE Arca (P),326517373,297489126,202000906,826007405,13520395621.538270,19226384406.468136,8806587103.788817,41553367131.795223,2366835,873351,1384402,4624588
2014-10-22,NASDAQ (Q),547055686,180707893,538445027,1266208606,24115929020.134004,13063124471.091604,22968299751.125370,60147353242.350978,4488910,760916,3341896,8591722
2014-10-22,NASDAQ PSX (X),22434517,16251092,13835742,52521351,824117463.690600,1177821204.889998,530968448.769900,2532907117.350498,181748,69649,89669,341066
2014-10-22,BATS BYX (Y),137957549,52094759,71611068,261663376,4848458407.564193,3296053416.636897,2711275229.406639,10855787053.607729,1161123,253505,595426,2010054
2014-10-22,BATS BZX (Z),289968660,166413580,162361066,618743306,10423475883.034980,11491880178.321748,6114471486.101128,28029827547.457856,2176611,661389,1178104,4016104
2014-10-21,NYSE MKT (A),0,11431408,70360,11501768,0.000000,108739498.864200,493993.405000,109233492.269200,0,26347,105,26452
2014-10-21,NASDAQ BX (B),81020722,35575972,40042557,156639251,3092670067.640797,2054041725.625897,1779342665.921296,6926054459.187990,653747,156744,315388,1125879
2014-10-21,NYSE (DN),152842869,38912175,89129144,280884188,6096269181.173396,2134087653.996194,3846768492.801535,12077125327.971125,606984,116822,325067,1048873
2014-10-21,NASDAQ (DQ),1236735714,394915182,657922794,2289573690,44295606258.465640,21496778133.829399,24331410227.363443,90123794619.658482,4144351,805357,2035514,6985222
2014-10-21,ADF (D),35585421,17162630,24935392,77683443,1169497365.949201,708878733.149700,851315963.724200,2729692062.823101,181926,49837,104124,335887
2014-10-21,EDGA (J),102315507,43519932,54162393,199997832,3745096778.371592,2568501509.663501,2219267598.559316,8532865886.594409,858681,198104,446429,1503214
2014-10-21,EDGX (K),215520234,90726070,146225910,452472214,8375538985.084777,4802331905.473495,5692361713.231583,18870232603.789855,1267264,288990,710676,2266930
2014-10-21,CHX (M),14652529,9820274,8683047,33155850,495192381.011800,937080760.427500,550548744.998300,1982821886.437600,1616,4253,940,6809
2014-10-21,NYSE (N),814788191,0,0,814788191,30943785308.042646,0.000000,0.000000,30943785308.042646,2691800,0,0,2691800
2014-10-21,NYSE Arca (P),341651119,281237027,199009574,821897720,14242905828.604861,19470627564.114225,9048653540.423028,42762186933.142114,2472312,836002,1327630,4635944
2014-10-21,NASDAQ (Q),536274959,166783934,526926014,1229984907,23359875057.952368,12742547874.441853,22417858410.507893,58520281342.902114,4224595,649900,3121831,7996326
2014-10-21,NASDAQ PSX (X),23054894,14251963,14132051,51438908,904691814.124598,1052744034.095000,578234849.880700,2535670698.100298,188679,55872,92011,336562
2014-10-21,BATS BYX (Y),149321796,56097467,75430432,280849695,5028195530.400678,3419909748.012404,2742669440.914213,11190774719.327295,1198015,253216,603684,2054915
2014-10-21,BATS BZX (Z),284085162,155113749,163294795,602493706,10604434542.295244,11219556679.125533,6359265203.489726,28183256424.910503,2153504,607530,1144075,3905109
2014-10-20,NYSE MKT (A),0,14312923,6173198,20486121,0.000000,106381338.527600,152949641.215400,259330979.743000,0,29144,24801,53945
2014-10-20,NASDAQ BX (B),70110337,30672145,33438434,134220916,2591615306.080202,1628489824.112410,1471200194.361523,5691305324.554135,588954,157491,289253,1035698
2014-10-20,NYSE (DN),111254237,32582271,67766043,211602551,4455407978.081472,1670567887.173005,2922777374.326946,9048753239.581423,486003,107211,268517,861731
2014-10-20,NASDAQ (DQ),923677413,483212145,525533910,1932423468,32145988319.599641,24774153389.238240,19095234761.625436,76015376470.463317,3523893,735060,1736307,5995260
2014-10-20,ADF (D),31192281,18283164,20821137,70296582,1020475595.402100,791352417.294200,724208366.007401,2536036378.703701,165788,54143,97151,317082
2014-10-20,EDGA (J),89542092,42390077,46471234,178403403,3257613309.145498,2322595508.585501,1784491688.448200,7364700506.179199,793632,206879,394369,1394880
2014-10-20,EDGX (K),179488148,89209001,123669687,392366836,6620225073.882476,4275323354.086824,4782484369.971508,15678032797.940808,1110914,290824,627154,2028892
2014-10-20,CHX (M),14739597,7845376,9217395,31802368,631954547.921600,752335133.140000,467649997.296200,1851939678.357800,833,4000,1026,5859
2014-10-20,NYSE (N),742365723,0,0,742365723,27989898655.993659,0.000000,0.000000,27989898655.993659,2583433,0,0,2583433
2014-10-20,NYSE Arca (P),306367660,280813533,177435720,764616913,13126024399.760562,18575723767.164129,7876630521.693849,39578378688.618540,2494820,837158,1225429,4557407
2014-10-20,NASDAQ (Q),469724976,160123191,487316616,1117164783,20262711421.437527,10857501364.007406,19841109289.901750,50961322075.346683,4011785,686229,3005724,7703738
2014-10-20,NASDAQ PSX (X),19459360,10710267,11709009,41878636,737262864.854300,721782013.013100,451083273.020299,1910128150.887699,165266,44598,78542,288406
2014-10-20,BATS BYX (Y),123987456,49837498,61992435,235817389,4148496275.519461,2666437834.494203,2189045978.831390,9003980088.845054,1024790,239200,511647,1775637
2014-10-20,BATS BZX (Z),251953027,143312734,147774001,543039762,9359105362.059130,9062461278.628116,5393846133.657989,23815412774.345235,2063571,588640,1104776,3756987
2014-10-17,NYSE MKT (A),0,16422282,6609266,23031548,0.000000,124156076.904100,141028745.876700,265184822.780800,0,33987,23386,57373
2014-10-17,NASDAQ BX (B),87278650,47535928,44570193,179384771,3365404388.861697,2718141043.544817,2106286003.314588,8189831435.721102,735974,226283,368555,1330812
2014-10-17,NYSE (DN),159494677,44273940,86043131,289811748,6255931612.994737,2478347354.550287,3833613956.322262,12567892923.867286,629794,141086,325633,1096513
2014-10-17,NASDAQ (DQ),1186292674,496859151,664929880,2348081705,41335074835.067718,26722147475.850178,26701916352.660830,94759138663.578726,4196650,928768,2072313,7197731
2014-10-17,ADF (D),38290525,21814560,25712312,85817397,1232263707.956096,960047280.561001,956442201.320398,3148753189.837495,206114,68830,128249,403193
2014-10-17,EDGA (J),108252798,58139313,58460721,224852832,3613588619.445903,3321019477.848833,2161694927.618816,9096303024.913552,913336,276374,476115,1665825
2014-10-17,EDGX (K),236760798,119692031,145413126,501865955,8400675997.225279,5750701718.450305,6064872599.221045,20216250314.896629,1440937,398311,809572,2648820
2014-10-17,CHX (M),11132322,21064624,7441723,39638669,340335909.843700,2268761492.676600,363672373.030000,2972769775.550300,565,6736,1022,8323
2014-10-17,NYSE (N),1069250293,0,0,1069250293,41329270810.435905,0.000000,0.000000,41329270810.435905,3286716,0,0,3286716
2014-10-17,NYSE Arca (P),438910876,390882607,228331034,1058124517,18750937519.313497,25706419213.061340,10883952900.627660,55341309633.002497,3523933,1187717,1554450,6266100
2014-10-17,NASDAQ (Q),644171200,245879163,712515710,1602566073,26840370491.437805,17934494488.763225,30559278859.876041,75334143840.077071,5314113,1012679,3919120,10245912
2014-10-17,NASDAQ PSX (X),25643853,17844884,15024048,58512785,990445070.808600,1172517083.934999,656218713.951901,2819180868.695500,214900,70510,108100,393510
2014-10-17,BATS BYX (Y),151709422,68869925,79640720,300220067,5179520546.390578,4071851640.830392,3095804532.923223,12347176720.144193,1256890,337857,629335,2224082
2014-10-17,BATS BZX (Z),335247690,217648181,187660081,740555952,12308787118.938042,15039721610.720970,7295673744.120416,34644182473.779428,2653290,876933,1356391,4886614
2014-10-16,NYSE MKT (A),0,16687568,6881097,23568665,0.000000,121727084.944100,165007870.651000,286734955.595100,0,37905,30840,68745
2014-10-16,NASDAQ BX (B),99795734,59139897,59531231,218466862,3946909577.337625,3685533945.477988,2581342270.330710,10213785793.146323,875192,271699,472468,1619359
2014-10-16,NYSE (DN),169568918,54081692,98748336,322398946,6646066362.957057,3109482683.445794,4020861041.607984,13776410088.010835,694883,161823,372736,1229442
2014-10-16,NASDAQ (DQ),1295122637,571701760,727079864,2593904261,45926736838.242345,34905156001.017683,26400890266.380755,107232783105.640783,4764032,1065173,2399713,8228918
2014-10-16,ADF (D),45230858,33658391,31686587,110575836,1449951705.715198,1406396206.317400,1082900151.681699,3939248063.714297,239522,114405,141805,495732
2014-10-16,EDGA (J),126568274,75736545,75455564,277760383,4421549859.215078,4407726199.484209,2650367994.802771,11479644053.502058,1106594,354401,583918,2044913
2014-10-16,EDGX (K),253552855,139485095,166604569,559642519,8855160645.293610,7320778605.800625,6172283641.204882,22348222892.299117,1573486,502057,901788,2977331
2014-10-16,CHX (M),18635188,17534416,5066244,41235848,596891577.956100,1837454584.561400,350311623.896300,2784657786.413800,1049,12098,1875,15022
2014-10-16,NYSE (N),1066124907,0,0,1066124907,38976917619.728920,0.000000,0.000000,38976917619.728920,4190623,0,0,4190623
2014-10-16,NYSE Arca (P),530788659,527354459,292656473,1350799591,21859953707.712422,36203388618.493433,13312432337.751179,71375774663.957034,4320175,1844409,1955507,8120091
2014-10-16,NASDAQ (Q),839480840,358497541,761034558,1959012939,34658726281.512561,25359379150.427089,30280384757.629122,90298490189.568772,7489706,1649139,5049127,14187972
2014-10-16,NASDAQ PSX (X),29685479,25366944,21453598,76506021,1129773932.871903,1638166817.294999,851254077.862000,3619194828.028902,234314,92314,128822,455450
2014-10-16,BATS BYX (Y),166110660,80053289,97588496,343752445,5712628891.710215,4767568540.167394,3453325719.618380,13933523151.495989,1432380,383921,769594,2585895
2014-10-16,BATS BZX (Z),433955661,316056439,250136400,1000148500,15612544128.810253,21201011133.404306,9219259671.890008,46032814934.104567,3479013,1348813,1774088,6601914
2014-10-15,NYSE MKT (A),0,21048860,7011861,28060721,0.000000,170356899.995200,151298359.305000,321655259.300200,0,47323,28590,75913
2014-10-15,NASDAQ BX (B),125896564,73430174,65537902,264864640,4880938152.323807,4603119218.723856,2897198207.849876,12381255578.897539,1038143,347494,522270,1907907
2014-10-15,NYSE (DN),219250593,67885066,122255530,409391189,8502169915.447580,3959065692.827206,5071982921.831397,17533218530.106183,850244,209125,425209,1484578
2014-10-15,NASDAQ (DQ),1599362069,708614564,862165103,3170141736,56634593019.770170,43101997751.782553,31016925888.500170,130753516660.052893,5591114,1432160,2694676,9717950
2014-10-15,ADF (D),58946015,32654583,39113431,130714029,2001280525.102999,1606807753.732199,1336212317.681201,4944300596.516399,350414,113429,191818,655661
2014-10-15,EDGA (J),158202394,87577664,88770088,334550146,5643743612.550387,5154812825.273590,3298182799.720413,14096739237.544390,1398007,421980,704289,2524276
2014-10-15,EDGX (K),351552699,194544981,217800127,763897807,12171900970.569312,10756163199.278971,8212635641.253207,31140699811.101490,2135523,705119,1145721,3986363
2014-10-15,CHX (M),9953731,26812414,12013700,48779845,378428702.152100,3520823603.850001,624876817.772400,4524129123.774501,1249,20062,2629,23940
2014-10-15,NYSE (N),1218089732,0,0,1218089732,44107181174.489916,0.000000,0.000000,44107181174.489916,4607958,0,0,4607958
2014-10-15,NYSE Arca (P),642970809,605736518,352473720,1601181047,26572820867.409638,44261452395.042598,15939828706.171628,86774101968.623864,5079636,2119364,2302689,9501689
2014-10-15,NASDAQ (Q),978719269,421195810,877897568,2277812647,40223708451.651825,31535174463.247985,35380506215.241550,107139389130.141360,8513045,1949074,5670533,16132652
2014-10-15,NASDAQ PSX (X),36912396,34713732,25976400,97602528,1474106940.660802,2242166282.603199,1097396176.259598,4813669399.523599,287474,117276,160878,565628
2014-10-15,BATS BYX (Y),200903040,100692311,109491811,411087162,6762499681.004883,5836462210.543818,3916735691.384145,16515697582.932846,1648051,466597,826375,2941023
2014-10-15,BATS BZX (Z),512240220,371111048,281510942,1164862210,18255341565.691843,25373344998.083249,10472121257.925827,54100807821.700919,4030976,1513579,2013217,7557772
2014-10-14,NYSE MKT (A),0,19432224,7403774,26835998,0.000000,144335902.181900,168333861.005000,312669763.186900,0,46808,32256,79064
2014-10-14,NASDAQ BX (B),98830682,56036374,53334029,208201085,3503086490.952501,3034978189.230994,2114789955.261918,8652854635.445413,833012,269353,420114,1522479
2014-10-14,NYSE (DN),181190410,55434032,107013375,343637817,6717559072.846367,2971028249.198612,3994269714.315282,13682857036.360261,751348,166383,380887,1298618
2014-10-14,NASDAQ (DQ),1261066446,502903116,709391479,2473361041,43127522618.152194,27654553274.613710,22564300390.159758,93346376282.925662,4631971,1064697,2229488,7926156
2014-10-14,ADF (D),44133459,25889061,31953993,101976513,1446474074.977898,1270952268.486000,1021773782.851299,3739200126.315197,263662,88818,152373,504853
2014-10-14,EDGA (J),129552258,68284655,72864976,270701889,4364025199.748309,3771625701.507802,2504242322.493507,10639893223.749618,1127836,320130,581579,2029545
2014-10-14,EDGX (K),272668438,132653124,184145187,589466749,9247788648.928709,6794186674.677091,6131922684.936804,22173898008.542604,1681593,471258,935817,3088668
2014-10-14,CHX (M),15955131,15214174,11917206,43086511,688225389.556200,1379878344.573400,582939036.971200,2651042771.100800,1027,8461,1264,10752
2014-10-14,NYSE (N),972362621,0,0,972362621,34348304400.934589,0.000000,0.000000,34348304400.934589,3587921,0,0,3587921
2014-10-14,NYSE Arca (P),474089903,409634840,276486640,1160211383,19403615278.804859,27840012086.093671,11173625692.400347,58417253057.298877,3918102,1403642,1821536,7143280
2014-10-14,NASDAQ (Q),773021374,269865173,702032796,1744919343,31556155677.991048,18374082969.532033,26357197177.563303,76287435825.086384,6623327,1144738,4517687,12285752
2014-10-14,NASDAQ PSX (X),27914762,21850955,19731571,69497288,1061491253.323398,1462575580.852099,697939782.089899,3222006616.265396,231517,85887,119885,437289
2014-10-14,BATS BYX (Y),171582909,78981650,96056888,346621447,5611916630.159211,4348209461.186995,3162610534.396576,13122736625.742782,1420542,368036,741141,2529719
2014-10-14,BATS BZX (Z),390984149,251375532,226386463,868746144,13869005558.158572,17712776452.085395,8130312021.065544,39712094031.309511,3153590,1014828,1616821,5785239
2014-10-13,NYSE MKT (A),0,19151628,5741848,24893476,0.000000,116382380.232100,120332973.214000,236715353.446100,0,42437,25394,67831
2014-10-13,NASDAQ BX (B),90478496,51508678,55137636,197124810,3181756299.160383,3056603332.194418,2112873471.140092,8351233102.494893,723018,258676,400481,1382175
2014-10-13,NYSE (DN),157741168,52224339,102173653,312139160,5934518778.975381,2919603817.509513,3868558593.211319,12722681189.696213,646501,160737,367490,1174728
2014-10-13,NASDAQ (DQ),1116794211,498413307,737691951,2352899469,38514465473.888057,27713019186.174098,23370297842.929825,89597782502.991980,4209681,1018140,2235831,7463652
2014-10-13,ADF (D),40731791,26384951,32254099,99370841,1285565714.518099,1346332286.855798,993924727.922202,3625822729.296099,230528,85380,137844,453752
2014-10-13,EDGA (J),109046955,61739564,63663852,234450371,3658939272.348397,3612221482.030999,2288663041.156104,9559823795.535500,914497,293408,493781,1701686
2014-10-13,EDGX (K),244774493,136290588,180793045,561858126,8354065418.850525,6367161130.210800,6316359657.436681,21037586206.498006,1481192,463306,905813,2850311
2014-10-13,CHX (M),11180724,11126587,7031611,29338922,437220246.242200,1286834588.291900,369039981.903400,2093094816.437500,852,7131,1427,9410
2014-10-13,NYSE (N),905399856,0,0,905399856,32183868116.442548,0.000000,0.000000,32183868116.442548,3230986,0,0,3230986
2014-10-13,NYSE Arca (P),441279039,426345967,265849765,1133474771,17784683411.512656,28745603071.023879,11156256326.356252,57686542808.892787,3476217,1366001,1710047,6552265
2014-10-13,NASDAQ (Q),687986959,253877360,686251093,1628115412,27677373102.544754,18008759577.430986,26560353135.344362,72246485815.320102,5611453,1093299,4246118,10950870
2014-10-13,NASDAQ PSX (X),24940198,18985506,18761579,62687283,928948928.677199,1309239494.460700,732695728.212298,2970884151.350197,197205,78734,115779,391718
2014-10-13,BATS BYX (Y),162163451,74563085,91477142,328203678,5427718004.640587,4290327537.562609,3248310677.541579,12966356219.744775,1310437,354347,690753,2355537
2014-10-13,BATS BZX (Z),360181975,227253597,222956181,810391753,12699201988.406340,15759027079.483660,8068036297.398497,36526265365.288497,2784572,945582,1544412,5274566
2014-10-10,NYSE MKT (A),0,16027240,5944779,21972019,0.000000,127095681.100700,139379915.036000,266475596.136700,0,34885,23735,58620
2014-10-10,NASDAQ BX (B),91909715,53837303,61078384,206825402,3343819959.749904,3110834170.711724,2367169033.387033,8821823163.848661,730404,255252,436012,1421668
2014-10-10,NYSE (DN),156539863,51226026,123850869,331616758,5950094264.145162,2634030132.550907,4648135687.766077,13232260084.462146,626544,151973,409893,1188410
2014-10-10,NASDAQ (DQ),1237211092,505201661,820899493,2563312246,42186729194.370284,26594865948.675794,26535694493.243229,95317289636.289307,4305032,998176,2507654,7810862
2014-10-10,ADF (D),42448608,24626519,32710486,99785613,1351744537.243101,1213241033.091900,1130766688.534499,3695752258.869500,232883,82877,153375,469135
2014-10-10,EDGA (J),121132567,67411933,78888504,267433004,4026459955.603889,3976764500.778803,2729672197.033413,10732896653.416105,999361,305276,606739,1911376
2014-10-10,EDGX (K),251484139,134801224,197866420,584151783,8630422396.777399,7158911552.174410,6999835029.754405,22789168978.706214,1460488,459280,971857,2891625
2014-10-10,CHX (M),8700948,10349919,7182319,26233186,332640374.028000,1258877635.850100,407986892.147500,1999504902.025600,806,6934,1712,9452
2014-10-10,NYSE (N),948739428,0,0,948739428,34717622280.720017,0.000000,0.000000,34717622280.720017,3206333,0,0,3206333
2014-10-10,NYSE Arca (P),448841473,420996510,300460283,1170298266,18494918474.913885,28358381181.384931,12651812611.667334,59505112267.966150,3543830,1289367,1887139,6720336
2014-10-10,NASDAQ (Q),704978169,276512761,769323072,1750814002,28947991709.084793,20242844742.260359,30215932785.034061,79406769236.379213,5685410,1110397,4525271,11321078
2014-10-10,NASDAQ PSX (X),24771675,24046259,21049399,69867333,895573353.315599,1531320134.968599,763028890.466808,3189922378.751006,185297,81754,121085,388136
2014-10-10,BATS BYX (Y),163162817,77668206,100458721,341289744,5637208063.646390,4635249096.474905,3558579337.338402,13831036497.459697,1330050,361036,754149,2445235
2014-10-10,BATS BZX (Z),359109278,229083356,247509116,835701750,12787090495.993072,15413003800.223275,9352415904.776938,37552510200.993285,2768562,928481,1688073,5385116
2014-10-09,NYSE MKT (A),0,12990726,6084214,19074940,0.000000,104268128.972700,125037438.366300,229305567.339000,0,32484,25448,57932
2014-10-09,NASDAQ BX (B),90649565,51144309,49832402,191626276,3142599313.815812,2841561492.053703,1985665257.404898,7969826063.274413,705691,223550,371124,1300365
2014-10-09,NYSE (DN),154722108,44592811,91448874,290763793,5751131716.148859,2424380389.266809,3579941048.654153,11755453154.069821,582002,137434,314335,1033771
2014-10-09,NASDAQ (DQ),1213482883,464883207,697305903,2375671993,40613998207.946117,25260154663.275627,21560261378.050239,87434414249.271983,4008708,915111,1984720,6908539
2014-10-09,ADF (D),42728497,24318415,30025646,97072558,1375677433.819399,1302130743.538700,985292427.646197,3663100605.004296,224882,88678,128683,442243
2014-10-09,EDGA (J),118303134,61143615,64803054,244249803,4024262862.620299,3592550162.930701,2298020386.546213,9914833412.097213,988654,284009,509590,1782253
2014-10-09,EDGX (K),249061096,119611593,174858235,543530924,8452523530.363676,6333578258.170196,5890038410.530873,20676140199.064745,1424363,405485,823681,2653529
2014-10-09,CHX (M),11366748,11303189,6095713,28765650,435909464.947700,1388572775.566400,519111369.472000,2343593609.986100,1146,7054,2067,10267
2014-10-09,NYSE (N),895816338,0,0,895816338,31760621520.726501,0.000000,0.000000,31760621520.726501,2997457,0,0,2997457
2014-10-09,NYSE Arca (P),425223398,431847437,254003957,1111074792,17151990241.735240,29904389433.097576,10407047251.370293,57463426926.203109,3249092,1247907,1562993,6059992
2014-10-09,NASDAQ (Q),641911181,235048785,601355257,1478315223,26324277182.535002,16991631863.500889,23450746814.166237,66766655860.202128,5141979,975396,3641730,9759105
2014-10-09,NASDAQ PSX (X),23407612,22502384,16847057,62757053,810753494.609401,1289703788.032700,639921694.511601,2740378977.153702,172415,87252,101975,361642
2014-10-09,BATS BYX (Y),153289845,72549244,82718361,308557450,5138117007.257295,4093640851.199298,2911011122.889037,12142768981.345630,1217634,328664,627835,2174133
2014-10-09,BATS BZX (Z),327343663,207935643,192190776,727470082,11458785454.850236,13640591135.944828,7172806266.016409,32272182856.811473,2532748,818850,1338427,4690025
2014-10-08,NYSE MKT (A),0,13609599,5719751,19329350,0.000000,104060042.749300,109342925.980000,213402968.729300,0,33460,20950,54410
2014-10-08,NASDAQ BX (B),94550939,49421685,54009929,197982553,3244734209.110701,2686451822.741098,1876377917.078613,7807563948.930412,739150,223988,383323,1346461
2014-10-08,NYSE (DN),158977853,45600755,101408186,305986794,5622041524.309784,2390470736.965708,3674089569.138818,11686601830.414310,589159,133028,346963,1069150
2014-10-08,NASDAQ (DQ),1278952401,447901629,811220761,2538074791,40834705649.599341,22966964921.777712,22297484150.689134,86099154722.066187,4102623,902232,2168505,7173360
2014-10-08,ADF (D),42585879,18625263,29451941,90663083,1377019183.979101,944697969.347900,884456080.674699,3206173234.001700,227137,61592,126701,415430
2014-10-08,EDGA (J),123335788,60690292,69166567,253192647,3974095836.750522,3381782747.693706,2228761030.917200,9584639615.361428,1008681,277055,510020,1795756
2014-10-08,EDGX (K),229465070,111040723,182794584,523300377,7335482000.759024,6061261897.625572,5420731978.021189,18817475876.405785,1225010,374275,765847,2365132
2014-10-08,CHX (M),14341770,12611914,3966805,30920489,614305825.675600,1240878640.476200,208383114.735000,2063567580.886800,825,6334,1711,8870
2014-10-08,NYSE (N),920276835,0,0,920276835,32824084785.283817,0.000000,0.000000,32824084785.283817,2916381,0,0,2916381
2014-10-08,NYSE Arca (P),431685529,403743367,257561020,1092989916,16644659758.325511,26386192409.955907,9828158972.792942,52859011141.074360,3120276,1078666,1528395,5727337
2014-10-08,NASDAQ (Q),637917361,225459857,636436680,1499813898,25279740678.460520,15693213679.026127,23289177187.936982,64262131545.423629,4834366,882812,3530560,9247738
2014-10-08,NASDAQ PSX (X),24197018,19803785,17198109,61198912,810579361.914001,1234194695.672400,629666954.094800,2674441011.681201,180508,74849,99995,355352
2014-10-08,BATS BYX (Y),154132326,67504638,87552565,309189529,4890669344.591532,3839804868.818803,2777176235.066042,11507650448.476377,1194839,307046,616486,2118371
2014-10-08,BATS BZX (Z),334515661,200297671,197774855,732588187,11143926049.039148,13248270563.026558,6930779384.910944,31322975996.976650,2448779,760117,1311440,4520336
2014-10-07,NYSE MKT (A),0,12039316,4913666,16952982,0.000000,73888770.021300,110724150.404000,184612920.425300,0,25356,19549,44905
2014-10-07,NASDAQ BX (B),79127659,35545270,47349353,162022282,2757328584.111313,1998180075.748598,1558255267.894498,6313763927.754409,610917,165061,332780,1108758
2014-10-07,NYSE (DN),125135810,34473443,81915913,241525166,4997293562.518083,1747175566.508798,2997834500.858409,9742303629.885290,505593,103579,308368,917540
2014-10-07,NASDAQ (DQ),1098242936,358539721,683377736,2140160393,36640591705.895645,20325331830.306294,18753674343.021148,75719597879.223087,3476212,713479,1856363,6046054
2014-10-07,ADF (D),32993271,14493621,27819155,75306047,1102442383.894002,728490489.080400,861951402.219401,2692884275.193803,175306,47680,107801,330787
2014-10-07,EDGA (J),100003453,43621990,63809409,207434852,3623199555.889410,2468000127.558800,1860995785.468806,7952195468.917016,841791,202336,433798,1477925
2014-10-07,EDGX (K),202207837,83189100,177754940,463151877,6947977860.110906,4321894632.560306,4930673259.201809,16200545751.873021,1120680,276603,716065,2113348
2014-10-07,CHX (M),14392355,14007154,5505158,33904667,507189120.075900,1394590928.885000,249646335.878100,2151426384.839000,977,4290,1158,6425
2014-10-07,NYSE (N),790804734,0,0,790804734,28091941926.053585,0.000000,0.000000,28091941926.053585,2395984,0,0,2395984
2014-10-07,NYSE Arca (P),335361350,277675806,219204825,832241981,13668616074.925931,18324648126.746718,7968868815.797655,39962133017.470304,2483457,802309,1252281,4538047
2014-10-07,NASDAQ (Q),496921335,154811767,542292695,1194025797,21074714358.051420,11172242989.843391,19070859085.544603,51317816433.439414,3844925,621182,2893811,7359918
2014-10-07,NASDAQ PSX (X),16846691,13894126,12610436,43351253,619215448.851000,884977025.860000,473198824.797099,1977391299.508099,131931,50998,79280,262209
2014-10-07,BATS BYX (Y),140197337,52959426,84509295,277666058,4835128230.248590,2987525610.937798,2600983451.173417,10423637292.359805,1117074,245997,592200,1955271
2014-10-07,BATS BZX (Z),256208202,134257347,162667056,553132605,8999843349.116016,8684910510.254915,5235358910.888303,22920112770.259234,1914314,534682,1076976,3525972
2014-10-06,NYSE MKT (A),0,13300377,5528795,18829172,0.000000,124198824.315000,106130853.090600,230329677.405600,0,24846,20344,45190
2014-10-06,NASDAQ BX (B),71402329,33601755,38513177,143517261,2426799736.956694,1716070013.904799,1333086349.878688,5475956100.740181,540101,147169,284784,972054
2014-10-06,NYSE (DN),121549571,34691945,77034259,233275775,4547324897.636967,1687949855.172208,3009230600.142124,9244505352.951299,481593,102077,287807,871477
2014-10-06,NASDAQ (DQ),987967530,332397219,580596799,1900961548,31527574862.400386,16189073159.386464,17196781759.414608,64913429781.201458,3262064,695481,1753535,5711080
2014-10-06,ADF (D),27867688,15624833,23728131,67220652,902960459.369401,710141993.979000,718711106.777201,2331813560.125602,148040,42631,97933,288604
2014-10-06,EDGA (J),88785886,44550641,49855667,183192194,2988218027.909308,2311202208.070396,1664777376.385104,6964197612.364808,735463,188811,382632,1306906
2014-10-06,EDGX (K),180545732,82503584,144604660,407653976,6107375449.423184,4132970055.777292,4554199699.737194,14794545204.937670,1012251,269413,655437,1937101
2014-10-06,CHX (M),10173218,9610106,3400591,23183915,404549228.258000,801193816.744600,212629150.332400,1418372195.335000,882,3429,1067,5378
2014-10-06,NYSE (N),695730053,0,0,695730053,24158584086.758327,0.000000,0.000000,24158584086.758327,2188380,0,0,2188380
2014-10-06,NYSE Arca (P),330236893,281797487,195165624,807200004,12625310809.546296,16980006417.185362,7200683389.132703,36806000615.864361,2349052,745135,1195634,4289821
2014-10-06,NASDAQ (Q),465492755,142319712,488165583,1095978050,18960167738.183834,9774279047.549235,17177580740.341374,45912027526.074443,3731134,565751,2789059,7085944
2014-10-06,NASDAQ PSX (X),16224635,11036358,11347257,38608250,571965005.733900,708253563.390000,390763989.217500,1670982558.341400,129888,41432,78352,249672
2014-10-06,BATS BYX (Y),121818017,48499850,68062416,238380283,3888990182.252945,2567503368.275002,2232242333.954584,8688735884.482531,946943,209659,510309,1666911
2014-10-06,BATS BZX (Z),240942789,131137876,145253118,517333783,8161771296.885719,8153207567.019396,4967134053.058099,21282112916.963214,1781618,503367,1006305,3291290
2014-10-03,NYSE MKT (A),0,10468489,4693355,15161844,0.000000,64797284.565700,106882259.385000,171679543.950700,0,23731,18942,42673
2014-10-03,NASDAQ BX (B),75012875,35688458,38041831,148743164,2703415736.062602,1897905447.587101,1532919477.394607,6134240661.044310,593848,147548,295259,1036655
2014-10-03,NYSE (DN),125893130,33983280,74836293,234712703,4840529441.295213,1714365670.239097,2901908715.234999,9456803826.769309,486743,106057,282253,875053
2014-10-03,NASDAQ (DQ),1094588904,365092170,582618184,2042299258,37453576701.810751,18866701217.002585,19588080344.869734,75908358263.683070,3503858,731067,1785410,6020335
2014-10-03,ADF (D),29578551,14049293,21771130,65398974,1015083665.194400,717879019.737000,741990503.864201,2474953188.795601,155035,42407,94762,292204
2014-10-03,EDGA (J),87628240,43067580,44173184,174869004,2985921465.876091,2352116048.535401,1632119646.475504,6970157160.886996,710067,183842,360849,1254758
2014-10-03,EDGX (K),192557593,83443170,125837288,401838051,6874089453.576794,4342698121.494997,4708156261.330944,15924943836.402735,1045950,275678,640562,1962190
2014-10-03,CHX (M),7911593,12765778,3554810,24232181,227668054.502200,1129303771.470000,229623852.812200,1586595678.784400,794,4622,1171,6587
2014-10-03,NYSE (N),812429928,0,0,812429928,30412606411.835727,0.000000,0.000000,30412606411.835727,2158893,0,0,2158893
2014-10-03,NYSE Arca (P),311192274,282691475,173615535,767499284,12993338241.977535,17946870682.716679,7569828526.394757,38510037451.088971,2281939,735219,1129145,4146303
2014-10-03,NASDAQ (Q),468000753,150138845,496896609,1115036207,19716461051.622359,10505097162.032331,20338520314.817716,50560078528.472406,3553053,566892,2706750,6826695
2014-10-03,NASDAQ PSX (X),17209552,12702005,12177015,42088572,662546293.208900,828746127.544000,492222398.968900,1983514819.721800,137411,44014,76822,258247
2014-10-03,BATS BYX (Y),123981963,46911745,63110093,234003801,4244802714.799500,2550365352.888699,2253590819.972200,9048758887.660399,984187,200154,495021,1679362
2014-10-03,BATS BZX (Z),231603222,129489567,137861912,498954701,8213920418.848812,8327877971.813797,5269037842.018781,21810836232.681390,1698971,481442,948655,3129068
2014-10-02,NYSE MKT (A),0,14336515,5784805,20121320,0.000000,101706349.646300,131810927.485100,233517277.131400,0,31428,24541,55969
2014-10-02,NASDAQ BX (B),82813802,42858385,44517184,170189371,2952718763.426306,2332781311.552501,1722956369.788208,7008456444.767015,663292,183113,339445,1185850
2014-10-02,NYSE (DN),148548364,42156124,94141082,284845570,5596579802.360941,2334496516.772097,3633897923.874951,11564974243.007989,596281,126526,331516,1054323
2014-10-02,NASDAQ (DQ),1234065066,469088566,693094523,2396248155,41793968151.984616,23801839799.174427,22815456018.492342,88411263969.651385,4108789,877867,2113435,7100091
2014-10-02,ADF (D),37665373,17518935,28103749,83288057,1305800774.434301,886001079.076499,984440777.889199,3176242631.399999,214153,54169,131527,399849
2014-10-02,EDGA (J),105463175,54070243,58600596,218134014,3717718501.888039,3053164393.786204,2112270726.996397,8883153622.670640,878329,237287,458907,1574523
2014-10-02,EDGX (K),225332607,100738393,153175469,479246469,7923048757.087193,5394027065.411503,5608392176.319524,18925467998.818220,1286808,340416,770901,2398125
2014-10-02,CHX (M),18189094,17451848,21443516,57084458,571448943.829000,1463439181.872200,491123728.723100,2526011854.424300,2106,5624,1952,9682
2014-10-02,NYSE (N),799869866,0,0,799869866,28191455957.075868,0.000000,0.000000,28191455957.075868,2627246,0,0,2627246
2014-10-02,NYSE Arca (P),379085208,345540808,229700635,954326651,15338331360.696642,22305827890.615215,9219056309.631734,46863215560.943591,2879552,951232,1454442,5285226
2014-10-02,NASDAQ (Q),566196905,195444766,562186738,1323828409,23168041277.313351,14231924719.849318,21478220435.943968,58878186433.106637,4393454,744309,3397778,8535541
2014-10-02,NASDAQ PSX (X),19879245,17944182,14875413,52698840,718719902.403801,1164569290.979999,534389738.943801,2417678932.327601,154238,63282,87680,305200
2014-10-02,BATS BYX (Y),141326196,59812692,78748676,279887564,4733840118.605903,3374321819.313504,2709026510.963014,10817188448.882421,1122843,266485,584621,1973949
2014-10-02,BATS BZX (Z),289389982,180502807,183590147,653482936,10263077873.336413,12152122509.632274,6658504262.228023,29073704645.196710,2162491,673292,1242166,4077949
2014-10-01,NYSE MKT (A),0,15788193,6844642,22632835,0.000000,97534585.910400,149323164.702000,246857750.612400,0,34024,27304,61328
2014-10-01,NASDAQ BX (B),97591977,45480004,54670776,197742757,3453430757.700184,2694710949.526203,2060440013.754292,8208581720.980679,778198,190787,421980,1390965
2014-10-01,NYSE (DN),153792243,45170955,101376368,300339566,5960808388.695207,2512446238.017213,3851331422.855349,12324586049.567769,638417,136405,377354,1152176
2014-10-01,NASDAQ (DQ),1266912221,529125248,729875803,2525913272,44024744246.973387,32062313592.403465,24082180328.222854,100169238167.599706,4231922,947683,2229769,7409374
2014-10-01,ADF (D),39715615,20496686,29515936,89728237,1376596374.127401,1056527089.507101,1033707416.076999,3466830879.711501,218404,65471,141897,425772
2014-10-01,EDGA (J),106550147,55597363,66134732,228282242,3819968629.565806,3308470295.754999,2349175291.083486,9477614216.404291,902757,245693,516360,1664810
2014-10-01,EDGX (K),230132152,106714340,164953295,501799787,8258595684.823683,6024001712.806312,5921462199.764375,20204059597.394370,1343577,365742,851803,2561122
2014-10-01,CHX (M),18087556,12146030,6157047,36390633,551362137.885200,1212900768.520000,276813528.810100,2041076435.215300,1352,5123,1609,8084
2014-10-01,NYSE (N),865093273,0,0,865093273,31352066356.798661,0.000000,0.000000,31352066356.798661,2690196,0,0,2690196
2014-10-01,NYSE Arca (P),388298050,368203567,237908484,994410101,15893011409.802142,25356090201.583788,9391769869.162679,50640871480.548609,3053353,989034,1547861,5590248
2014-10-01,NASDAQ (Q),584898854,202094394,618581537,1405574785,24614136200.540994,15636789508.882525,23805155581.605803,64056081291.029322,4707449,750450,3616662,9074561
2014-10-01,NASDAQ PSX (X),20879026,17216182,16268933,54364141,777765151.110601,1180301003.821600,613373682.583100,2571439837.515301,165713,59948,97882,323543
2014-10-01,BATS BYX (Y),154789893,60270316,90037830,305098039,5213518945.581043,3717028738.532903,3019178900.499007,11949726584.612953,1225069,275224,676421,2176714
2014-10-01,BATS BZX (Z),289133481,176362708,192901555,658397744,10332975068.138750,12445191664.586397,6921162855.530370,29699329588.255517,2212684,663607,1320471,4196762
2014-09-30,NYSE MKT (A),0,14508251,6974470,21482721,0.000000,107781364.375700,157330146.029000,265111510.404700,0,26494,26394,52888
2014-09-30,NASDAQ BX (B),86102319,36831064,48278576,171211959,3095526551.406103,1969180999.223808,1930671842.723809,6995379393.353720,704248,148536,373227,1226011
2014-09-30,NYSE (DN),134087397,34454579,89973165,258515141,4891695093.469803,1851915037.498605,3607124898.182517,10350735029.150925,560482,106130,349136,1015748
2014-09-30,NASDAQ (DQ),1234159073,388071156,741637758,2363867987,42057617253.643172,22537502747.748326,24876790513.533130,89471910514.924628,3783391,697455,1951605,6432451
2014-09-30,ADF (D),35630689,13918622,25909701,75459012,1187339905.613903,671275514.275500,932895838.523299,2791511258.412702,188080,41588,124030,353698
2014-09-30,EDGA (J),96455890,44826307,56747563,198029760,3223207181.761222,2468052431.559401,1987621051.025821,7678880664.346444,796105,190921,432922,1419948
2014-09-30,EDGX (K),201063258,84667566,144084577,429815401,6982998885.105795,4497208402.016004,5134730363.600593,16614937650.722392,1113794,268986,696494,2079274
2014-09-30,CHX (M),15104063,11435605,10085193,36624861,539429569.921000,903394418.318400,749548346.092900,2192372334.332300,955,3892,1924,6771
2014-09-30,NYSE (N),943769380,0,0,943769380,33492817760.959087,0.000000,0.000000,33492817760.959087,2458215,0,0,2458215
2014-09-30,NYSE Arca (P),323222425,289376535,211192457,823791417,12847895908.112593,18575763786.069175,8592292228.527657,40015951922.709425,2443391,757358,1275535,4476284
2014-09-30,NASDAQ (Q),484998550,153590146,619339223,1257927919,20204506338.768297,11128072532.517208,23270719045.531326,54603297916.816831,3741535,565437,3093043,7400015
2014-09-30,NASDAQ PSX (X),17168224,12613871,15250415,45032510,648412002.990500,821659759.214199,560818665.832100,2030890428.036799,135010,46454,83544,265008
2014-09-30,BATS BYX (Y),140218966,50602425,78005041,268826432,4644263152.923336,2679338049.956995,2676266736.281524,9999867939.161855,1101178,213232,579000,1893410
2014-09-30,BATS BZX (Z),243345038,136187224,158354077,537886339,8617605074.124695,8705860278.937395,5787596547.291178,23111061900.353268,1850242,491461,1087996,3429699
2014-09-29,NYSE MKT (A),0,9908682,6923323,16832005,0.000000,59240845.255800,143337016.974000,202577862.229800,0,19774,24490,44264
2014-09-29,NASDAQ BX (B),73945588,31668454,40641845,146255887,2658471805.944892,1685202296.481531,1582987853.664803,5926661956.091226,578346,128561,296875,1003782
2014-09-29,NYSE (DN),83331935,16997730,50558883,150888548,3161674562.434813,967187926.627902,1928314292.399617,6057176781.462332,361278,59756,201699,622733
2014-09-29,NASDAQ (DQ),962697604,406759834,592747292,1962204730,32731886053.071009,21191223665.462615,19380634651.100485,73303744369.634109,3288532,653529,1730425,5672486
2014-09-29,ADF (D),28242842,11204209,22239525,61686576,968536631.558298,562963715.620900,778669090.953302,2310169438.132500,161025,33413,103216,297654
2014-09-29,EDGA (J),82102696,39198890,48419823,169721409,2872158730.469703,2017043675.706000,1707518650.331902,6596721056.507605,682705,164332,372170,1219207
2014-09-29,EDGX (K),167075004,70367461,130577927,368020392,5730317116.879001,3820995828.920071,4601044782.633272,14152357728.432344,936931,228935,612451,1778317
2014-09-29,CHX (M),11319227,10716477,4039517,26075221,488479656.760000,1050850713.174200,271248250.531800,1810578620.466000,869,3102,1519,5490
2014-09-29,NYSE (N),653512600,0,0,653512600,22925071056.608412,0.000000,0.000000,22925071056.608412,2020474,0,0,2020474
2014-09-29,NYSE Arca (P),280158259,240335040,175475552,695968851,11569965524.573547,15019909221.506316,7046665033.030139,33636539779.110002,2162287,651644,1072293,3886224
2014-09-29,NASDAQ (Q),410868106,128035016,457935506,996838628,17108118641.272945,8671772482.795687,17106605934.760170,42886497058.828802,3136563,481755,2570736,6189054
2014-09-29,NASDAQ PSX (X),14236609,10361303,11495008,36092920,549439414.570600,692563602.045000,428396788.955000,1670399805.570600,112490,39525,67622,219637
2014-09-29,BATS BYX (Y),120813060,43386767,69435646,233635473,4072431972.692482,2289992004.879701,2319899242.645180,8682323220.217363,947160,183781,502358,1633299
2014-09-29,BATS BZX (Z),210404351,111262562,137522577,459189490,7541950109.861191,7040763783.311302,4939971508.213167,19522685401.385660,1599165,413901,935119,2948185
2014-09-26,NYSE MKT (A),0,8122860,8169036,16291896,0.000000,62499208.353600,179314797.077000,241814005.430600,0,19567,25552,45119
2014-09-26,NASDAQ BX (B),65061061,27484931,38437473,130983465,2398439467.264679,1569371567.219703,1603628733.018395,5571439767.502777,538647,117493,286043,942183
2014-09-26,NYSE (DN),106185009,25860506,68953571,200999086,3871469764.648696,1407187897.783696,2924215126.930297,8202872789.362689,432289,79726,255188,767203
2014-09-26,NASDAQ (DQ),889215054,269336860,532233331,1690785245,29545814572.508112,14837643012.464141,19079784240.373440,63463241825.345693,3053474,556202,1623583,5233259
2014-09-26,ADF (D),27326270,9972119,21230706,58529095,913929832.680800,492397015.359000,705969278.339201,2112296126.379001,153672,31977,92310,277959
2014-09-26,EDGA (J),72819261,34099133,41337242,148255636,2443741875.230303,1988942923.408093,1477008139.718600,5909692938.356996,605045,149660,329316,1084021
2014-09-26,EDGX (K),161914568,60866851,120765744,343547163,5445040802.789909,3406867617.918705,4581967681.376102,13433876102.084716,873550,202773,572153,1648476
2014-09-26,CHX (M),13511517,6421506,5724439,25657462,469238674.315600,634755871.837600,235827825.401600,1339822371.554800,782,2539,1427,4748
2014-09-26,NYSE (N),630637618,0,0,630637618,22922038634.515090,0.000000,0.000000,22922038634.515090,1960748,0,0,1960748
2014-09-26,NYSE Arca (P),262673251,217432727,157991487,638097465,10526736469.828735,14226080302.100008,6939912167.027158,31692728938.955901,1989332,546376,992011,3527719
2014-09-26,NASDAQ (Q),387219359,113468726,432964357,933652442,16183493617.594815,8625152616.489491,18113019250.184232,42921665484.268538,2973496,428912,2440773,5843181
2014-09-26,NASDAQ PSX (X),13237201,9675469,10939421,33852091,487929526.811500,701218217.745000,422972352.219200,1612120096.775700,106465,37531,63020,207016
2014-09-26,BATS BYX (Y),108229949,38310482,67397131,213937562,3618784387.716803,2185963356.283697,2361490615.436232,8166238359.436732,861690,172027,486729,1520446
2014-09-26,BATS BZX (Z),193840570,95659252,132863475,422363297,6927541884.825512,6596069699.923999,5288937273.984908,18812548858.734419,1511469,370666,907319,2789454
2014-09-25,NYSE MKT (A),0,11079359,7829545,18908904,0.000000,94481255.651900,167429748.261000,261911003.912900,0,26516,27009,53525
2014-09-25,NASDAQ BX (B),74799714,35684681,44983822,155468217,2723529245.760188,2011744856.418402,1807338783.226098,6542612885.404688,611571,154387,341325,1107283
2014-09-25,NYSE (DN),115693186,34717883,80479395,230890464,4419680110.607507,1920915947.347400,3620393910.933120,9960989968.888027,474372,104477,303604,882453
2014-09-25,NASDAQ (DQ),967166125,369885740,619547619,1956599484,33729705665.798525,21306001913.840963,22683440663.466707,77719148243.106195,3429429,712655,1902694,6044778
2014-09-25,ADF (D),30915492,15312148,25248103,71475743,1029990668.915001,744648464.144300,928261852.975000,2702900986.034301,172868,46028,116536,335432
2014-09-25,EDGA (J),84366011,41003593,53743914,179113518,2987576135.816297,2316201238.141803,2061351119.200200,7365128493.158300,710660,181560,424214,1316434
2014-09-25,EDGX (K),185690371,82716679,145226630,413633680,6324912829.183594,4564379595.658401,5593108536.325087,16482400961.167082,1035956,281451,710393,2027800
2014-09-25,CHX (M),17180141,15317317,3831332,36328790,353804425.403000,1456347575.191100,198875307.087200,2009027307.681300,553,4121,1761,6435
2014-09-25,NYSE (N),736655686,0,0,736655686,27652017633.443646,0.000000,0.000000,27652017633.443646,2277327,0,0,2277327
2014-09-25,NYSE Arca (P),292293821,270697028,189487170,752478019,12009304058.934286,18524688635.162233,8396150761.850056,38930143455.946575,2275116,742786,1195898,4213800
2014-09-25,NASDAQ (Q),448163009,159095740,521167815,1128426564,19082572671.461240,11700242355.326391,21721565877.326000,52504380904.113631,3588288,612352,3070545,7271185
2014-09-25,NASDAQ PSX (X),14132153,14534238,14915169,43581560,531718682.840000,978449794.011500,574672915.485000,2084841392.336500,114482,52314,82284,249080
2014-09-25,BATS BYX (Y),119440876,48959601,76971927,245372404,4081339992.889588,2857729041.039206,2688506199.823108,9627575233.751902,973042,220642,561431,1755115
2014-09-25,BATS BZX (Z),222412886,134980367,159486925,516880178,7939270328.047211,9254216917.452717,6466587548.302808,23660074793.802736,1742985,519232,1111498,3373715
2014-09-24,NYSE MKT (A),0,10444849,6477755,16922604,0.000000,71572411.221300,174660698.435000,246233109.656300,0,22072,24510,46582
2014-09-24,NASDAQ BX (B),76202075,28625039,38597786,143424900,2822249901.093400,1506898869.523000,1515971006.469991,5845119777.086391,633859,126210,307134,1067203
2014-09-24,NYSE (DN),128306491,28362724,75283864,231953079,4883065011.627988,1519808900.774098,3175704130.452523,9578578042.854609,510526,83097,279670,873293
2014-09-24,NASDAQ (DQ),1064541592,331437801,610437433,2006416826,37697242540.563853,18566122004.754288,20904584415.019760,77167948960.337901,3511913,578192,1799876,5889981
2014-09-24,ADF (D),30018368,10820696,23188103,64027167,1106116915.255500,520958061.881699,796746498.276900,2423821475.414099,173723,34652,105300,313675
2014-09-24,EDGA (J),85638862,34663484,45725149,166027495,3199932127.427299,1945551458.437996,1739108417.790099,6884592003.655394,739988,153500,377648,1271136
2014-09-24,EDGX (K),170573459,60512028,133204466,364289953,6149712292.772661,3312195180.454710,4700927259.591204,14162834732.818575,970888,198253,619682,1788823
2014-09-24,CHX (M),27452738,12915065,6514273,46882076,680662059.641600,1012123571.370000,266163833.496000,1958949464.507600,759,3362,1580,5701
2014-09-24,NYSE (N),745636971,0,0,745636971,27981989253.275915,0.000000,0.000000,27981989253.275915,2096684,0,0,2096684
2014-09-24,NYSE Arca (P),282571621,215839698,165078501,663489820,11737314084.242939,14285807062.202665,6827173604.302621,32850294750.748225,2133349,571177,1055512,3760038
2014-09-24,NASDAQ (Q),433070231,114710910,459598884,1007380025,19070896547.754358,8435073149.607430,18601958189.605749,46107927886.967537,3379525,442991,2671215,6493731
2014-09-24,NASDAQ PSX (X),14389300,8776071,10475608,33640979,564488190.785000,608069843.255000,420724643.778999,1593282677.818999,117154,32126,67152,216432
2014-09-24,BATS BYX (Y),120146164,38848282,63839769,222834215,4232467692.726089,2209589261.935198,2266314384.648003,8708371339.309290,964460,170520,489630,1624610
2014-09-24,BATS BZX (Z),214818180,101685537,128795021,445298738,7934820145.576115,6902815359.707208,4992359493.035463,19829994998.318786,1656181,393875,931935,2981991
2014-09-23,NYSE MKT (A),0,12998348,6063400,19061748,0.000000,85628486.804800,121084380.844000,206712867.648800,0,24172,23030,47202
2014-09-23,NASDAQ BX (B),74830765,29266204,40696011,144792980,2743361913.829512,1642847646.784403,1548980711.040304,5935190271.654219,607991,127583,312418,1047992
2014-09-23,NYSE (DN),122968003,28636289,78842348,230446640,5039142851.920130,1430914114.069807,3292355976.632531,9762412942.622468,486443,90378,294004,870825
2014-09-23,NASDAQ (DQ),1032637346,347471990,624782390,2004891726,37670137092.224189,18710108105.143224,21175353027.973820,77555598225.341233,3357962,592529,1793752,5744243
2014-09-23,ADF (D),28963322,11010104,23506619,63480045,1020788530.204699,496153556.070600,737732113.359196,2254674199.634495,169911,33549,102082,305542
2014-09-23,EDGA (J),83695456,35756524,48200956,167652936,3052291689.278399,2083270043.686403,1747177517.598219,6882739250.563021,711856,153965,385387,1251208
2014-09-23,EDGX (K),177550937,68153922,142012461,387717320,6468654698.461522,3681651790.162009,4851808730.144499,15002115218.768030,1013066,220719,661301,1895086
2014-09-23,CHX (M),16464881,14945028,7703293,39113202,427680596.123800,1390337671.487500,419389849.436800,2237408117.048100,945,3463,1288,5696
2014-09-23,NYSE (N),718743671,0,0,718743671,27052758190.042866,0.000000,0.000000,27052758190.042866,2125451,0,0,2125451
2014-09-23,NYSE Arca (P),281736657,236419829,176340928,694497414,12070586155.648407,15647882268.341128,7272215363.751630,34990683787.741165,2176056,617673,1122291,3916020
2014-09-23,NASDAQ (Q),430946092,120311298,484721146,1035978536,18710223131.074061,8681323154.204719,18786855701.715757,46178401986.994537,3351095,459238,2729354,6539687
2014-09-23,NASDAQ PSX (X),14127174,9855922,11625874,35608970,512255843.457000,719615138.235000,481416810.444799,1713287792.136799,110242,37844,72701,220787
2014-09-23,BATS BYX (Y),115153532,42362991,66059508,223576031,4034674016.051780,2407464095.503307,2350848446.993697,8792986558.548784,937460,178712,500540,1616712
2014-09-23,BATS BZX (Z),208784694,102325399,139190174,450300267,7812025224.337875,6982688587.168983,5124428017.022161,19919141828.529019,1677591,381901,989058,3048550
2014-09-22,NYSE MKT (A),0,15218761,7232142,22450903,0.000000,123908179.667400,141163917.023000,265072096.690400,0,29975,23304,53279
2014-09-22,NASDAQ BX (B),79232205,33164565,43468714,155865484,2945453300.738394,1851659555.970003,1674691859.897797,6471804716.606194,642214,137218,330244,1109676
2014-09-22,NYSE (DN),122806393,30879596,82286232,235972221,4771718771.754503,1564180873.913286,3395585515.583536,9731485161.251325,500363,99906,293558,893827
2014-09-22,NASDAQ (DQ),1041412009,371243934,617910363,2030566306,36701003512.753285,21996717335.579580,21400931923.365257,80098652771.698122,3579325,702909,1930087,6212321
2014-09-22,ADF (D),31963879,10875106,24681583,67520568,1145987983.574599,470365700.562400,802577318.364396,2418931002.501395,172684,34944,110438,318066
2014-09-22,EDGA (J),87430257,39209153,51076431,177715841,3219392465.742904,2235679391.511699,1995800126.747700,7450871984.002303,741615,164292,404179,1310086
2014-09-22,EDGX (K),184327174,71200341,144920025,400447540,6736243960.760982,3693388515.724992,5030749169.204189,15460381645.690163,1034121,232004,691557,1957682
2014-09-22,CHX (M),14491534,10870175,5702601,31064310,636885748.761200,973064589.740000,329308647.873000,1939258986.374200,659,3467,1459,5585
2014-09-22,NYSE (N),696898451,0,0,696898451,26150800045.324413,0.000000,0.000000,26150800045.324413,2116057,0,0,2116057
2014-09-22,NYSE Arca (P),293009474,247704426,184854042,725567942,12557698026.405346,15985983443.537432,8008534110.381743,36552215580.324521,2169976,611953,1167149,3949078
2014-09-22,NASDAQ (Q),441967944,130979702,496727233,1069674879,18678009249.976494,9237917530.352805,20551873492.136818,48467800272.466117,3305408,490794,2929708,6725910
2014-09-22,NASDAQ PSX (X),14788020,9290610,11457015,35535645,582283289.937600,592239167.585000,459637107.679800,1634159565.202400,117925,34097,71894,223916
2014-09-22,BATS BYX (Y),127921540,46885725,69542178,244349443,4511366768.247125,2685917647.054205,2501699810.494007,9698984225.795337,1025994,195429,518669,1740092
2014-09-22,BATS BZX (Z),214122757,110222088,144162185,468507030,7872266257.193472,7498802144.317201,5506578918.955768,20877647320.466441,1676792,420029,1033694,3130515
2014-09-19,NYSE MKT (A),0,50317448,9037244,59354692,0.000000,244079162.471401,199287274.026999,443366436.498400,0,35065,30463,65528
2014-09-19,NASDAQ BX (B),91398247,34528618,53652475,179579340,3589218324.217599,1852431450.169804,2070309682.791606,7511959457.179009,723990,142179,391110,1257279
2014-09-19,NYSE (DN),122694983,30182174,92744438,245621595,4902464051.839299,1464775413.282503,3700963425.380889,10068202890.502691,547565,91376,343337,982278
2014-09-19,NASDAQ (DQ),1332545864,400267164,1047010052,2779823080,51473061917.686612,19813899274.575759,39393228428.695530,110680189620.957901,3860378,642904,2146012,6649294
2014-09-19,ADF (D),32071503,11535514,26137189,69744206,1195484077.150099,499505206.730200,825307993.158899,2520297277.039198,168695,34421,108925,312041
2014-09-19,EDGA (J),98531540,40662882,62688409,201882831,3802619426.200517,2147792133.415001,2295414984.579994,8245826544.195512,805781,171760,468899,1446440
2014-09-19,EDGX (K),197549217,77195854,162070213,436815284,7569610727.095976,3838429651.924506,5817314308.034890,17225354687.055372,1081596,232072,740580,2054248
2014-09-19,CHX (M),11982755,20566672,5519228,38068655,402255055.551200,1679947433.950000,394582145.537000,2476784635.038200,887,4073,1560,6520
2014-09-19,NYSE (N),1849579263,0,0,1849579263,84507022036.503930,0.000000,0.000000,84507022036.503930,2403202,0,0,2403202
2014-09-19,NYSE Arca (P),330005015,256012370,217750026,803767411,15022378850.974373,17341126573.886771,9725797588.931682,42089303013.792826,2420533,613642,1277403,4311578
2014-09-19,NASDAQ (Q),479737656,132455638,1234173998,1846367292,21538275192.423190,9602633193.155602,50599052475.599609,81739960861.178401,3544082,489916,3372386,7406384
2014-09-19,NASDAQ PSX (X),16063939,9442428,13183358,38689725,632520044.823000,591504651.039300,507133178.705800,1731157874.568100,122754,32521,82659,237934
2014-09-19,BATS BYX (Y),147267027,43387108,83221532,273875667,5343916003.640099,2368434965.458699,2973876389.408717,10686227358.507515,1131824,188658,589628,1910110
2014-09-19,BATS BZX (Z),243294347,117873941,173972640,535140928,9233759794.761648,7807838538.590290,6744380549.657074,23785978883.009012,1832721,429628,1186152,3448501
2014-09-18,NYSE MKT (A),0,11970556,8759852,20730408,0.000000,61974501.813400,229929631.537000,291904133.350400,0,26633,26291,52924
2014-09-18,NASDAQ BX (B),72886486,26628443,38991081,138506010,2552295975.543797,1474917167.085400,1448441854.245608,5475654996.874805,568740,113456,302884,985080
2014-09-18,NYSE (DN),121317209,25276149,73800039,220393397,4570178238.699429,1253854520.712016,2882489566.664524,8706522326.075969,470261,83011,278902,832174
2014-09-18,NASDAQ (DQ),1058087325,291851338,639337804,1989276467,35017506819.665586,15028839433.811918,20072188520.860424,70118534774.337928,3414655,579495,1851336,5845486
2014-09-18,ADF (D),30305010,10016452,23352186,63673648,930362913.559500,371028976.124500,708061910.244401,2009453799.928401,153410,29911,99602,282923
2014-09-18,EDGA (J),78389383,32402728,43632127,154424238,2663322745.340507,1733194323.699899,1522379718.158105,5918896787.198511,649115,136380,339633,1125128
2014-09-18,EDGX (K),176534804,63165599,141288830,380989233,5804815286.394295,2845730425.445794,4478585714.843398,13129131426.683487,902371,188075,619195,1709641
2014-09-18,CHX (M),15220709,21148207,7030811,43399727,484158006.233600,1248719944.457800,433433983.183700,2166311933.875100,543,3017,1174,4734
2014-09-18,NYSE (N),676101546,0,0,676101546,25739426914.438482,0.000000,0.000000,25739426914.438482,1867659,0,0,1867659
2014-09-18,NYSE Arca (P),274670519,201488054,155142328,631300901,10975171496.994804,13916460507.097314,6261597311.138132,31153229315.230250,2009905,478220,973064,3461189
2014-09-18,NASDAQ (Q),399018756,99083449,454336055,952438260,16643719984.594629,6941297680.738104,17332961192.337778,40917978857.670511,2951007,372987,2501301,5825295
2014-09-18,NASDAQ PSX (X),13716508,7970722,10333652,32020882,507595699.012400,511388345.584800,368642906.414401,1387626951.011601,106320,30012,64909,201241
2014-09-18,BATS BYX (Y),120224349,39239349,61471687,220935385,4023562664.152512,1993934974.198197,2118749999.278597,8136247637.629306,944520,149962,470900,1565382
2014-09-18,BATS BZX (Z),201451596,84669468,119808105,405929169,7193752899.833351,5526916226.279285,4381097278.324599,17101766404.437235,1560452,322050,867511,2750013
2014-09-17,NYSE MKT (A),0,9562452,8899786,18462238,0.000000,78187927.702000,208796817.194000,286984744.896000,0,22959,28721,51680
2014-09-17,NASDAQ BX (B),69321386,36257266,40996363,146575015,2554257507.009104,2192983206.054698,1584937627.374306,6332178340.438108,579476,151009,326462,1056947
2014-09-17,NYSE (DN),104317142,31137239,73111305,208565686,4301569153.402071,1741982368.591000,3227747164.979114,9271298686.972185,431251,94854,279780,805885
2014-09-17,NASDAQ (DQ),973825971,365152713,602436580,1941415264,35075485028.454300,22740190763.025307,20111439448.520574,77927115240.000181,3093052,617304,1736584,5446940
2014-09-17,ADF (D),29736185,11336023,23057370,64129578,982675457.316400,520799030.464800,768032749.088901,2271507236.870101,147520,36054,105622,289196
2014-09-17,EDGA (J),78311332,40174434,45286502,163772268,2836591619.923598,2413517190.589099,1747461078.224999,6997569888.737696,675866,173071,368333,1217270
2014-09-17,EDGX (K),182739328,82786659,143872906,409398893,6608752881.460698,4496114302.590092,4881472716.365919,15986339900.416709,1027650,257162,666707,1951519
2014-09-17,CHX (M),10115875,16292148,5542599,31950622,380271545.602000,1486741231.999700,259758532.647000,2126771310.248700,1169,5946,1678,8793
2014-09-17,NYSE (N),668328435,0,0,668328435,25665548096.488368,0.000000,0.000000,25665548096.488368,2100102,0,0,2100102
2014-09-17,NYSE Arca (P),299974603,241742383,177573678,719290664,12596462399.611974,16834397134.460775,7403340016.898525,36834199550.971274,2298273,657877,1131455,4087605
2014-09-17,NASDAQ (Q),445819361,147369163,465941709,1059130233,19025743018.975533,11579564650.178907,19332664910.626325,49937972579.780765,3527258,556557,2813521,6897336
2014-09-17,NASDAQ PSX (X),13971452,11343465,11167014,36481931,495036266.279000,818649656.230000,462925854.963500,1776611777.472500,101163,40310,68176,209649
2014-09-17,BATS BYX (Y),111102267,44295356,63228882,218626505,3836594195.019722,2640184628.248201,2271385806.831912,8748164630.099835,919693,200142,480782,1600617
2014-09-17,BATS BZX (Z),222327492,125260471,137528148,485116111,8128084277.266144,8936580267.568973,5300846415.026140,22365510959.861257,1758002,450099,989775,3197876
2014-09-16,NYSE MKT (A),0,11781088,6858343,18639431,0.000000,80272511.425700,166237431.025000,246509942.450700,0,27723,23308,51031
2014-09-16,NASDAQ BX (B),79409012,34896401,44800946,159106359,2852125837.497093,2070014730.330101,1783117493.794195,6705258061.621389,656790,150274,354877,1161941
2014-09-16,NYSE (DN),108115115,31781020,82347371,222243506,4250837307.058037,1668505022.438900,3564483766.639882,9483826096.136819,453499,100655,300936,855090
2014-09-16,NASDAQ (DQ),962650965,383799894,635649526,1982100385,32884996349.089121,25921427945.279453,21281338175.932352,80087762470.300926,3289675,674408,1869852,5833935
2014-09-16,ADF (D),26555918,11667499,23423496,61646913,941008811.808401,504619449.983700,746759432.221100,2192387694.013201,149747,37799,101397,288943
2014-09-16,EDGA (J),82546241,40252812,47156442,169955495,2930866834.743196,2330912101.057402,1885955050.180593,7147733985.981191,700036,179125,380872,1260033
2014-09-16,EDGX (K),174362462,78245307,150324771,402932540,6314913136.863276,3862200172.250701,5157359917.396543,15334473226.510520,1012796,247664,686862,1947322
2014-09-16,CHX (M),12391517,14992047,4209487,31593051,628176655.783200,1522602591.784500,237245942.062600,2388025189.630300,871,5163,1377,7411
2014-09-16,NYSE (N),648617060,0,0,648617060,23775563756.526260,0.000000,0.000000,23775563756.526260,2090208,0,0,2090208
2014-09-16,NYSE Arca (P),292286055,237669570,180864342,710819967,11959588117.175229,15889205348.297575,7739494279.067725,35588287744.540529,2269264,631425,1124246,4024935
2014-09-16,NASDAQ (Q),435446208,129959415,488921800,1054327423,18021628609.867905,9211868746.976075,19848769581.883092,47082266938.727072,3394643,502175,2912538,6809356
2014-09-16,NASDAQ PSX (X),13631931,10897036,10596548,35125515,453041486.305800,811059956.500000,389301633.004199,1653403075.809999,96748,40498,65090,202336
2014-09-16,BATS BYX (Y),117991484,44119529,67148604,229259617,4063058529.124816,2628968023.134299,2353226579.398893,9045253131.658008,966965,197675,503171,1667811
2014-09-16,BATS BZX (Z),207113052,116745444,139095384,462953880,7355938709.450863,7807077935.943855,5465923013.256266,20628939658.650984,1659358,439939,1009598,3108895
2014-09-15,NYSE MKT (A),0,10158521,8423700,18582221,0.000000,81111234.197100,200066744.776000,281177978.973100,0,22582,26075,48657
2014-09-15,NASDAQ BX (B),68741597,27074428,43778406,139594431,2554987147.107911,1587996141.134399,1727330717.802710,5870314006.045020,591664,120860,345364,1057888
2014-09-15,NYSE (DN),100338697,24558640,85478670,210376007,3937112370.272930,1312621401.487399,3685767686.733455,8935501458.493784,412597,80529,313856,806982
2014-09-15,NASDAQ (DQ),859840321,272129760,668795240,1800765321,30356676576.669857,15264558550.983543,22815986944.739376,68437222072.392776,3125395,569546,2033608,5728549
2014-09-15,ADF (D),24868983,8299373,26922562,60090918,873912098.976800,367439574.911600,946243461.586097,2187595135.474497,135664,28749,121176,285589
2014-09-15,EDGA (J),70879316,30340583,48542517,149762416,2563153400.664111,1608951509.400105,1803457317.801315,5975562227.865531,620464,137752,378474,1136690
2014-09-15,EDGX (K),156260564,57774917,168385282,382420763,5516920852.984892,2840055359.385601,5890193232.551967,14247169444.922460,890273,194890,748287,1833450
2014-09-15,CHX (M),6964904,8073729,4570302,19608935,265835580.923200,909287563.165000,236131515.231900,1411254659.320100,766,5223,1193,7182
2014-09-15,NYSE (N),590996275,0,0,590996275,22344732976.954768,0.000000,0.000000,22344732976.954768,1868734,0,0,1868734
2014-09-15,NYSE Arca (P),243176693,185964937,185006146,614147776,10422348809.103805,11731013868.606604,7793195120.469035,29946557798.179444,1860936,514794,1143131,3518861
2014-09-15,NASDAQ (Q),357292735,99297495,484087492,940677722,15278341400.275057,6944144090.907410,19599981119.845541,41822466611.028008,2809725,401803,2791155,6002683
2014-09-15,NASDAQ PSX (X),12771520,8341248,12005737,33118505,456941373.560000,603808215.777100,419776036.089900,1480525625.427000,98598,32380,71092,202070
2014-09-15,BATS BYX (Y),105093034,34444418,66768971,206306423,3717645990.580295,1892888425.141399,2434198532.924872,8044732948.646566,863548,163943,501860,1529351
2014-09-15,BATS BZX (Z),179510743,88338000,139812110,407660853,6625188694.407337,5647172168.092702,5420540630.182548,17692901492.682587,1450348,346338,1014410,2811096
2014-09-12,NYSE MKT (A),0,9040339,6768948,15809287,0.000000,78957060.651100,190875970.892000,269833031.543100,0,22357,27429,49786
2014-09-12,NASDAQ BX (B),77193258,32268356,41164282,150625896,2741961158.521492,1891870640.266401,1623154746.569391,6256986545.357284,648132,139901,331178,1119211
2014-09-12,NYSE (DN),117365454,29104294,77231459,223701207,4477223978.549063,1584725426.153296,3371662434.977460,9433611839.679819,487926,94592,282064,864582
2014-09-12,NASDAQ (DQ),946228240,334604310,597470683,1878303233,32218192711.439302,19968387663.484685,21297688247.450457,73484268622.374444,3194533,620953,1788823,5604309
2014-09-12,ADF (D),32516014,10379748,23477968,66373730,1070001624.409800,509972679.550698,811677428.631298,2391651732.591796,177295,36731,118719,332745
2014-09-12,EDGA (J),82212705,40479284,44087008,166778997,2718858512.111901,2112619518.154602,1594104828.157595,6425582858.424098,698093,165542,355943,1219578
2014-09-12,EDGX (K),190145066,68756566,144189017,403090649,6353272100.439579,3784818936.773102,5406205004.016069,15544296041.228750,1025037,237207,698824,1961068
2014-09-12,CHX (M),9547171,10760854,4979002,25287027,368484555.361000,1124388788.580000,261639506.892000,1754512850.833000,938,6803,1003,8744
2014-09-12,NYSE (N),694417906,0,0,694417906,25694415991.799215,0.000000,0.000000,25694415991.799215,2090319,0,0,2090319
2014-09-12,NYSE Arca (P),285918522,241299450,167026149,694244121,11489942608.818749,16881072866.029372,7233448037.247544,35604463512.095665,2137456,621675,1092947,3852078
2014-09-12,NASDAQ (Q),416058559,123472342,467325031,1006855932,17106428353.188730,8911792990.839993,19166076461.413063,45184297805.441786,3270895,472632,2802943,6546470
2014-09-12,NASDAQ PSX (X),15983682,9728942,10260762,35973386,535891309.927900,725474711.758000,399524195.837699,1660890217.523599,117954,35584,64683,218221
2014-09-12,BATS BYX (Y),125833090,41585191,68131088,235549369,4255057911.077321,2326550844.755602,2379469551.868690,8961078307.701613,1028933,187717,514289,1730939
2014-09-12,BATS BZX (Z),215818828,116983454,135218474,468020756,7573429868.466007,7495856887.329410,5531649590.838864,20600936346.634281,1712291,434103,1003604,3149998
2014-09-11,NYSE MKT (A),0,9727346,9070102,18797448,0.000000,90521081.127500,223738329.954200,314259411.081700,0,24580,27572,52152
2014-09-11,NASDAQ BX (B),61895085,27318351,33376217,122589653,2139621327.009604,1492260399.342598,1341382998.214291,4973264724.566493,484842,116041,265714,866597
2014-09-11,NYSE (DN),104903671,23814734,73353013,202071418,4149773548.757511,1206842851.663496,3080514101.390989,8437130501.811996,439862,75547,279033,794442
2014-09-11,NASDAQ (DQ),929887710,261519350,589143462,1780550522,32169500282.385209,12520161363.562564,19576537519.755336,64266199165.703109,3122643,553457,1807582,5483682
2014-09-11,ADF (D),28883048,11275248,24086784,64245080,956297238.864702,515900649.472800,800407336.786002,2272605225.123504,156424,32431,116557,305412
2014-09-11,EDGA (J),74466296,30951490,40968890,146386676,2535463599.581017,1559227691.677001,1475975765.941102,5570667057.199120,620594,134834,342097,1097525
2014-09-11,EDGX (K),164254057,59998342,140764578,365016977,5814852637.779703,2922644570.318203,4936030230.036778,13673527438.134684,922020,196836,689190,1808046
2014-09-11,CHX (M),9802417,6578749,5693237,22074403,395090137.534000,546679709.839000,324794536.344200,1266564383.717200,626,3585,899,5110
2014-09-11,NYSE (N),604975893,0,0,604975893,22107917818.544189,0.000000,0.000000,22107917818.544189,1874216,0,0,1874216
2014-09-11,NYSE Arca (P),264513147,193296423,170610614,628420184,10712914707.440809,11759235015.971814,6886029564.441680,29358179287.854303,2040371,499435,1091239,3631045
2014-09-11,NASDAQ (Q),373878913,100153893,425688167,899720973,15841047453.866495,6851132465.729284,16887617332.872564,39579797252.468343,2891410,386261,2613693,5891364
2014-09-11,NASDAQ PSX (X),14967891,8463708,9168337,32599936,517461637.312800,545087509.473400,382586599.641800,1445135746.428000,111836,28885,63792,204513
2014-09-11,BATS BYX (Y),115528934,38003374,62989228,216521536,3996806883.107908,2023415448.602902,2228547599.663514,8248769931.374324,952921,163786,490603,1607310
2014-09-11,BATS BZX (Z),193538241,87232609,121985450,402756300,6816198782.377728,5621354129.553097,4711032680.600518,17148585592.531343,1511790,329050,922897,2763737
2014-09-10,NYSE MKT (A),0,9360644,8748014,18108658,0.000000,78032909.083500,212263784.057000,290296693.140500,0,21228,27490,48718
2014-09-10,NASDAQ BX (B),59726093,25414493,35044318,120184904,2109081796.002201,1416332810.976900,1333574225.837902,4858988832.817003,478310,109564,272180,860054
2014-09-10,NYSE (DN),112840813,26135583,78513291,217489687,4695767126.687296,1336090933.974593,3200156429.614587,9232014490.276476,463501,87384,292452,843337
2014-09-10,NASDAQ (DQ),927336835,282176626,642397145,1851910606,33520287228.659394,13616791347.590235,21402748563.428673,68539827139.678302,3113138,579161,1840374,5532673
2014-09-10,ADF (D),29029724,9365450,25918924,64314098,990927621.774799,457299956.736200,793295452.223401,2241523030.734400,159503,29706,111867,301076
2014-09-10,EDGA (J),70253431,31237643,42220784,143711858,2563763339.367208,1639920429.724597,1519977652.927801,5723661422.019606,596074,134204,339297,1069575
2014-09-10,EDGX (K),170029585,54035778,151783806,375849169,6305223312.919701,2745205638.014099,5051465917.974711,14101894868.908511,960388,180424,684337,1825149
2014-09-10,CHX (M),10942940,8156612,3775074,22874626,497756555.356400,537486814.640000,196595067.108700,1231838437.105100,1549,2693,751,4993
2014-09-10,NYSE (N),608873159,0,0,608873159,23345262865.331992,0.000000,0.000000,23345262865.331992,1880099,0,0,1880099
2014-09-10,NYSE Arca (P),254612372,183416867,172925347,610954586,10800882309.320798,11565614461.607215,7103633793.627188,29470130564.555201,1902905,472705,1055579,3431189
2014-09-10,NASDAQ (Q),355544434,98943014,444313778,898801226,15586646305.960952,6858829267.518588,17599502674.821050,40044978248.300590,2806774,391232,2506422,5704428
2014-09-10,NASDAQ PSX (X),12376733,7400680,8804542,28581955,426285041.591199,488463045.555000,329100960.872900,1243849048.019099,91265,27022,54887,173174
2014-09-10,BATS BYX (Y),112423761,34484961,65074437,211983159,4047436810.050412,1893207526.599400,2273556562.215824,8214200898.865636,944205,161654,497132,1602991
2014-09-10,BATS BZX (Z),191868063,89258712,130899265,412026040,7027971075.426375,5849743661.509190,5075919190.755332,17953633927.690897,1530347,333164,952993,2816504
2014-09-09,NYSE MKT (A),0,10928907,10538629,21467536,0.000000,93355381.307000,289692145.339000,383047526.646000,0,24138,32822,56960
2014-09-09,NASDAQ BX (B),60358489,27614978,38103767,126077234,2073281269.237504,1485784171.504701,1552323362.181997,5111388802.924202,488353,111723,293789,893865
2014-09-09,NYSE (DN),103051637,26640821,88891380,218583838,4107069489.733425,1463933844.940006,4266963371.438931,9837966706.112362,411194,83689,318703,813586
2014-09-09,NASDAQ (DQ),874919302,304122123,668986462,1848027887,31538324706.539288,16028480513.948877,25391608520.998444,72958413741.486609,3129980,613102,2097810,5840892
2014-09-09,ADF (D),29281019,12827122,29919556,72027697,1058838757.986499,573877067.018200,1050907179.584500,2683623004.589199,164154,35738,133229,333121
2014-09-09,EDGA (J),73818475,34709536,47867965,156395976,2579039397.638297,1803912480.002704,1865591945.178294,6248543822.819295,629080,146363,377652,1153095
2014-09-09,EDGX (K),192430998,67771542,170833699,431036239,7233140572.803177,3445412573.587199,6471521614.585567,17150074760.975943,1090815,212134,780610,2083559
2014-09-09,CHX (M),6996993,4858388,10369061,22224442,319473244.990500,499989371.110000,474524173.720400,1293986789.820900,1837,2816,909,5562
2014-09-09,NYSE (N),602718683,0,0,602718683,22912892743.822189,0.000000,0.000000,22912892743.822189,1946027,0,0,1946027
2014-09-09,NYSE Arca (P),257782754,204587416,189721773,652091943,10674153717.079109,13122488012.646595,8725932454.907164,32522574184.632868,2069024,538115,1190054,3797193
2014-09-09,NASDAQ (Q),359155518,108127303,474928524,942211345,15597122540.549901,7629768387.193987,20947672849.549777,44174563777.293665,2898213,410905,2957404,6266522
2014-09-09,NASDAQ PSX (X),12742699,9273793,10000522,32017014,447072627.761000,582706055.265600,411579664.439700,1441358347.466300,91530,31174,62807,185511
2014-09-09,BATS BYX (Y),110914086,38698301,73583179,223195566,3996578866.941607,2072042387.501201,2706879748.194403,8775501002.637211,953470,166436,541324,1661230
2014-09-09,BATS BZX (Z),199099618,98369758,145370574,442839950,7253126284.357789,6533762969.103483,6081290671.284277,19868179924.745549,1614224,366798,1083512,3064534
2014-09-08,NYSE MKT (A),0,11250550,7183337,18433887,0.000000,84506482.374400,198994015.020000,283500497.394400,0,23257,27251,50508
2014-09-08,NASDAQ BX (B),64489757,25969745,35951204,126410706,2352759760.457197,1401374778.845699,1402700903.094102,5156835442.396998,549858,117586,298898,966342
2014-09-08,NYSE (DN),101649906,22937967,70258225,194846098,3879846088.391296,1162873148.042298,2769329658.700658,7812048895.134252,396543,75368,265788,737699
2014-09-08,NASDAQ (DQ),861718498,237419610,577366861,1676504969,29704450348.194894,12011089826.621736,19400373080.851032,61115913255.667662,3150850,561629,1818970,5531449
2014-09-08,ADF (D),28999371,10956839,23572549,63528759,997828616.943001,512161923.482100,742752942.099701,2252743482.524802,159147,31069,103830,294046
2014-09-08,EDGA (J),70250228,29935359,40994849,141180436,2529629506.318211,1569027598.297798,1475443882.375298,5574100986.991307,620989,137451,340031,1098471
2014-09-08,EDGX (K),163860130,56545189,141618414,362023733,5880801993.052684,2664669584.336112,4768698294.422625,13314169871.811421,917043,185380,639335,1741758
2014-09-08,CHX (M),14748793,4351956,3130674,22231423,471958041.023600,472786344.887500,184640697.614900,1129385083.526000,437,1913,730,3080
2014-09-08,NYSE (N),601972412,0,0,601972412,22018224242.974794,0.000000,0.000000,22018224242.974794,1774199,0,0,1774199
2014-09-08,NYSE Arca (P),244052702,180965932,154101884,579120518,10290851891.591893,11455171861.671943,6349904426.120131,28095928179.383967,1959806,470499,1011011,3441316
2014-09-08,NASDAQ (Q),343027613,88742954,427823244,859593811,14731482676.974140,6087434290.531194,17325739940.185804,38144656907.691138,2722773,366735,2486592,5576100
2014-09-08,NASDAQ PSX (X),11989506,7105715,8873992,27969213,449683759.967700,455224818.495000,337011712.331100,1241920290.793800,95879,25990,57873,179742
2014-09-08,BATS BYX (Y),103907984,34492243,62770404,201170631,3602518312.874584,1845019750.991900,2149797630.083004,7597335693.949488,875144,167146,482911,1525201
2014-09-08,BATS BZX (Z),178949970,80106174,119049421,378105565,6641801242.826725,5175594803.383902,4482819667.381736,16300215713.592363,1460367,319332,900277,2679976
2014-09-05,NYSE MKT (A),0,8633064,6395885,15028949,0.000000,87647380.100400,159595180.798000,247242560.898400,0,20232,22520,42752
2014-09-05,NASDAQ BX (B),64530187,24521970,37349030,126401187,2393030146.371289,1443143965.607001,1522688852.390212,5358862964.368502,544138,111110,316023,971271
2014-09-05,NYSE (DN),106020196,21656923,70607992,198285111,4139651638.776719,1170367850.888601,3195084347.382144,8505103837.047464,413120,69348,281883,764351
2014-09-05,NASDAQ (DQ),893711282,245473250,559124673,1698309205,31176651857.154511,15352563850.702952,20871174895.532409,67400390603.389872,3061701,517423,1821814,5400938
2014-09-05,ADF (D),27448547,10363848,21671994,59484389,943469354.533699,645516280.982000,751008777.419696,2339994412.935395,149783,29767,101495,281045
2014-09-05,EDGA (J),68705006,28410762,40490090,137605858,2410442387.152490,1574790332.417595,1530166833.215292,5515399552.785377,575545,125174,334664,1035383
2014-09-05,EDGX (K),161662271,54743616,133678683,350084570,5792585140.073990,3051566293.103905,4997320119.557559,13841471552.735454,903936,176282,635661,1715879
2014-09-05,CHX (M),6587937,11738438,5035926,23362301,300929505.387000,837620116.676000,297471931.893500,1436021553.956500,1355,3075,879,5309
2014-09-05,NYSE (N),609749215,0,0,609749215,23870221971.149322,0.000000,0.000000,23870221971.149322,1740175,0,0,1740175
2014-09-05,NYSE Arca (P),246363973,178923825,158880241,584168039,10294024437.601364,12408220185.056269,7503950635.361313,30206195258.018946,1884454,462005,1038462,3384921
2014-09-05,NASDAQ (Q),343215289,95354325,422616980,861186594,15123998426.044972,7435506401.490201,18865612590.723420,41425117418.258593,2711910,360815,2539610,5612335
2014-09-05,NASDAQ PSX (X),11556063,8245841,8485614,28287518,419447379.104100,623329747.060100,337505275.625201,1380282401.789401,87357,28670,54425,170452
2014-09-05,BATS BYX (Y),103419024,32555537,58960706,194935267,3589129064.783808,1872108369.051999,2196572685.443118,7657810119.278925,845392,148964,446812,1441168
2014-09-05,BATS BZX (Z),175761254,81225882,120675618,377662754,6658390163.599234,5700497392.581584,5052987743.453795,17411875299.634613,1448801,307017,931920,2687738
2014-09-04,NYSE MKT (A),0,11010103,7304983,18315086,0.000000,185183655.165100,161953652.606999,347137307.772099,0,24076,22956,47032
2014-09-04,NASDAQ BX (B),67757351,26138853,36490611,130386815,2493284543.115788,1511746810.028301,1440802575.308601,5445833928.452690,568452,117534,293390,979376
2014-09-04,NYSE (DN),113791104,24522047,77149401,215462552,4514760647.266310,1285078750.184596,3288263763.464481,9088103160.915387,473983,81567,294830,850380
2014-09-04,NASDAQ (DQ),998614856,287260630,619400116,1905275602,36601230951.309399,15457460034.470085,21683760106.760377,73742451092.539861,3458487,595415,1922623,5976525
2014-09-04,ADF (D),31673307,11850057,23874963,67398327,1121231822.134499,633744041.910600,815364483.364199,2570340347.409298,172746,34521,111974,319241
2014-09-04,EDGA (J),75287949,30642913,42374670,148305532,2723886511.106681,1831043108.812496,1566718672.605906,6121648292.525083,640181,135976,341310,1117467
2014-09-04,EDGX (K),185526280,63975119,137997022,387498421,6800745951.067108,3422625581.244199,5248601415.953960,15471972948.265267,1013283,212684,667272,1893239
2014-09-04,CHX (M),7747921,6917536,2800069,17465526,365922338.895000,566728663.640000,233994766.034100,1166645768.569100,925,2619,700,4244
2014-09-04,NYSE (N),627280723,0,0,627280723,23953109017.143031,0.000000,0.000000,23953109017.143031,1885435,0,0,1885435
2014-09-04,NYSE Arca (P),267132534,193102314,160116960,620351808,11460831005.990076,12676424590.324030,7251308531.640912,31388564127.955018,2107830,505103,1029489,3642422
2014-09-04,NASDAQ (Q),375263202,101186529,427953024,904402755,16215606223.109688,7535493136.298999,18043063159.321806,41794162518.730493,2916045,395265,2528872,5840182
2014-09-04,NASDAQ PSX (X),14072609,8166521,9289264,31528394,510535949.882000,580842671.631500,353364328.384801,1444742949.898301,97116,29550,58845,185511
2014-09-04,BATS BYX (Y),111056502,36110538,63964981,211132021,3999376207.995214,2106116697.302499,2212543067.789602,8318035973.087315,915514,165728,466255,1547497
2014-09-04,BATS BZX (Z),197677181,93255885,121821446,412754512,7418025146.920376,6362822608.346609,4876996752.043353,18657844507.310338,1582504,347566,914366,2844436
2014-09-03,NYSE MKT (A),0,10426113,7303071,17729184,0.000000,80293797.256100,162953261.861000,243247059.117100,0,21986,24902,46888
2014-09-03,NASDAQ BX (B),68509669,22594192,42118663,133222524,2598773196.545108,1230951724.511301,1639824656.208391,5469549577.264800,608711,101693,350236,1060640
2014-09-03,NYSE (DN),99187466,21799820,80651687,201638973,4025477606.270704,1170426206.016094,3404969692.839134,8600873505.125932,434556,72711,306615,813882
2014-09-03,NASDAQ (DQ),890422752,249947735,676108759,1816479246,30860871717.914622,12409226656.650824,23723708569.673784,66993806944.239230,3263463,554191,2091091,5908745
2014-09-03,ADF (D),26259383,8476533,25076316,59812232,912292127.740299,345087579.487900,821459191.497898,2078838898.726097,149406,26626,116733,292765
2014-09-03,EDGA (J),73794308,28175011,48547034,150516353,2587821605.084694,1489458809.488003,1723546983.038893,5800827397.611590,626227,120690,390194,1137111
2014-09-03,EDGX (K),166980559,56190744,155808332,378979635,6020031666.734924,2667369408.353601,5716293038.850027,14403694113.938552,938208,174425,722615,1835248
2014-09-03,CHX (M),10085291,6075192,4989324,21149807,333623271.004600,574202953.720000,306286812.125900,1214113036.850500,1080,2390,646,4116
2014-09-03,NYSE (N),617678031,0,0,617678031,22975550255.625647,0.000000,0.000000,22975550255.625647,1767451,0,0,1767451
2014-09-03,NYSE Arca (P),232594567,163179697,177732048,573506312,9899587059.054160,10328397103.750915,7622733848.181968,27850718010.987043,1943317,435069,1109908,3488294
2014-09-03,NASDAQ (Q),337384043,83613221,473081969,894079233,14580381387.863290,5819599797.060792,18850986145.860431,39250967330.784513,2685633,324016,2729168,5738817
2014-09-03,NASDAQ PSX (X),11481795,6826201,9138643,27446639,439995270.383000,484484387.148000,337678899.003200,1262158556.534200,95430,24623,60833,180886
2014-09-03,BATS BYX (Y),104023328,31645086,67624061,203292475,3762448130.188378,1726589439.374501,2385819193.216716,7874856762.779595,889695,148594,510896,1549185
2014-09-03,BATS BZX (Z),172174705,76213078,131873490,380261273,6314652373.431302,4939323239.469392,5324614706.855364,16578590319.756058,1408082,289930,986602,2684614
2014-09-02,NYSE MKT (A),0,12008124,8915612,20923736,0.000000,90565892.991700,240750018.396299,331315911.387999,0,23863,29308,53171
2014-09-02,NASDAQ BX (B),70615107,28026428,40838573,139480108,2703884030.424000,1445092167.901901,1519136867.643796,5668113065.969697,619357,114465,326834,1060656
2014-09-02,NYSE (DN),102766281,28159408,83933113,214858802,4187825469.556625,1424043976.178807,3207775386.654916,8819644832.390348,437609,92452,295411,825472
2014-09-02,NASDAQ (DQ),876959370,433799102,658021225,1968779697,31540238061.947495,25746918676.466369,21942827323.143856,79229984061.557720,3467209,639006,2096134,6202349
2014-09-02,ADF (D),27699781,9833829,24842092,62375702,953944722.941400,463139595.915800,774536315.141301,2191620633.998501,142028,32211,109438,283677
2014-09-02,EDGA (J),69611948,34893222,45136384,149641554,2582070349.921398,1801933185.537501,1558166647.216999,5942170182.675898,621989,137422,359845,1119256
2014-09-02,EDGX (K),164625857,71166761,151237308,387029926,6193305090.742389,3392657484.559305,5442207965.608840,15028170540.910534,957198,217687,702962,1877847
2014-09-02,CHX (M),9190581,6266271,6577653,22034505,357419265.330000,472067862.130000,509679838.074000,1339166965.534000,945,1941,617,3503
2014-09-02,NYSE (N),593286122,0,0,593286122,23055179213.525777,0.000000,0.000000,23055179213.525777,1895365,0,0,1895365
2014-09-02,NYSE Arca (P),252765802,208952334,172413855,634131991,11324004796.196412,13060043756.874950,7013145131.822110,31397193684.893472,2263854,522721,1105026,3891601
2014-09-02,NASDAQ (Q),352751487,101484896,461152995,915389378,15836911718.626269,7028495591.302067,18266471114.062599,41131878423.990935,2959743,382041,2843546,6185330
2014-09-02,NASDAQ PSX (X),10824293,8073280,8792228,27689801,455935954.212600,488547234.303000,316927535.910000,1261410724.425600,92704,27868,55102,175674
2014-09-02,BATS BYX (Y),107392579,38811107,68784256,214987942,3914904987.381806,2045891924.250305,2266216466.805012,8227013378.437123,926348,162436,521447,1610231
2014-09-02,BATS BZX (Z),182468472,92892566,130018815,405379853,6967624514.489920,6182309487.805509,4775107495.607296,17925041497.902725,1548262,340623,972881,2861766
2014-08-29,NYSE MKT (A),0,10557860,6416028,16973888,0.000000,73853714.630500,183739728.433000,257593443.063500,0,20819,21549,42368
2014-08-29,NASDAQ BX (B),51848911,20308742,28531563,100689216,1896705676.597092,1097027064.075898,1160404637.625999,4154137378.298989,446326,87840,234855,769021
2014-08-29,NYSE (DN),73187876,20435965,53631712,147255553,2812209847.681514,1046128934.647699,2117631786.309614,5975970568.638827,328706,67620,211144,607470
2014-08-29,NASDAQ (DQ),674520906,236788726,486177385,1397487017,23604403773.230304,12290851698.405444,16874268963.435449,52769524435.071197,2621937,466473,1535573,4623983
2014-08-29,ADF (D),22262463,7849370,18368692,48480525,765664736.457299,356346158.097900,581210582.082899,1703221476.638098,111756,23469,80600,215825
2014-08-29,EDGA (J),55763530,24716161,31081383,111561074,1925438902.918897,1395304881.081902,1138850421.328401,4459594205.329200,473483,106507,257744,837734
2014-08-29,EDGX (K),128230740,47840297,104476126,280547163,4603701155.229692,2477571997.283984,3652411781.750719,10733684934.264395,695124,148887,473134,1317145
2014-08-29,CHX (M),4061824,2513686,2677310,9252820,190337123.977000,272111486.215000,147319378.510000,609767988.702000,673,1419,605,2697
2014-08-29,NYSE (N),616710745,0,0,616710745,24986325306.452424,0.000000,0.000000,24986325306.452424,1479623,0,0,1479623
2014-08-29,NYSE Arca (P),166905801,144783730,108684879,420374410,7296037670.862155,9784194602.831843,4550802955.209665,21631035228.903663,1470772,380743,720186,2571701
2014-08-29,NASDAQ (Q),245177131,73798548,368549945,687525624,10906331176.535611,5300997583.744612,15399206643.621857,31606535403.902080,1986264,281750,1942908,4210922
2014-08-29,NASDAQ PSX (X),7058961,5818357,5824061,18701379,264157183.025900,391213936.649500,217298997.639400,872670117.314800,57502,20594,39632,117728
2014-08-29,BATS BYX (Y),79172919,29421881,48681484,157276284,2768816913.596003,1608177836.598398,1725878130.921191,6102872881.115592,670258,129423,375752,1175433
2014-08-29,BATS BZX (Z),134741403,67015443,90673840,292430686,5112671367.070831,4606348127.048094,3495325486.145818,13214344980.264743,1116092,255538,687473,2059103
2014-08-28,NYSE MKT (A),0,8839365,6707422,15546787,0.000000,103649161.472100,126400991.606000,230050153.078100,0,20443,18792,39235
2014-08-28,NASDAQ BX (B),55133863,18605851,29275005,103014719,1987592399.235497,1085714071.231801,1093409822.005810,4166716292.473108,478549,90960,256790,826299
2014-08-28,NYSE (DN),77222598,17345418,49555725,144123741,3051879846.024337,900884898.849997,1892584103.056694,5845348847.931028,301458,62013,181936,545407
2014-08-28,NASDAQ (DQ),726201859,213352340,453454648,1393008847,24845761730.230980,11255147193.528807,15180328626.120409,51281237549.880196,2736300,478894,1494906,4710100
2014-08-28,ADF (D),24799366,7310237,17579863,49689466,780913536.860900,296641165.696000,561877226.035099,1639431928.591999,119986,21380,79954,221320
2014-08-28,EDGA (J),59128908,22135816,30365413,111630137,2057290694.597496,1250568817.510399,1105549166.734499,4413408678.842394,500861,101524,262938,865323
2014-08-28,EDGX (K),139461581,45941889,105493192,290896662,4947592245.518607,2126056488.576502,3632693346.297302,10706342080.392411,752235,145228,502259,1399722
2014-08-28,CHX (M),5881061,2080414,18595969,26557444,245883561.882000,235064588.575000,1784276627.188800,2265224777.645800,850,1517,492,2859
2014-08-28,NYSE (N),490899859,0,0,490899859,18997940855.346836,0.000000,0.000000,18997940855.346836,1522731,0,0,1522731
2014-08-28,NYSE Arca (P),195700411,144192790,119967832,459861033,8237513223.157698,9299570270.695104,4931744220.897591,22468827714.750393,1582027,386766,794254,2763047
2014-08-28,NASDAQ (Q),275326620,71763658,334698772,681789050,11685530722.489236,5088920654.942004,13737130344.749081,30511581722.180321,2165661,279115,2014967,4459743
2014-08-28,NASDAQ PSX (X),7937466,5322418,6245040,19504924,267216304.301700,375768913.685000,226411729.812000,869396947.798700,58198,20211,40866,119275
2014-08-28,BATS BYX (Y),84807749,26732347,48526557,160066653,2927498888.729296,1443470864.235701,1646995681.353606,6017965434.318603,702731,129687,375069,1207487
2014-08-28,BATS BZX (Z),142118491,63520108,91319500,296958099,5061322593.306318,4087416586.512795,3418811265.267820,12567550445.086933,1161604,240329,726702,2128635
2014-08-27,NYSE MKT (A),0,8799934,6545447,15345381,0.000000,63456268.795700,154984500.419000,218440769.214700,0,21350,21369,42719
2014-08-27,NASDAQ BX (B),53631117,16690490,31087827,101409434,2030511876.053199,924820022.584800,1215802994.057602,4171134892.695601,459304,78950,250296,788550
2014-08-27,NYSE (DN),84020113,16939387,61755985,162715485,3351173106.251796,866084930.161801,2550849253.042492,6768107289.456089,371571,54185,226022,651778
2014-08-27,NASDAQ (DQ),785761152,259224028,501676119,1546661299,27756280059.057220,12585699429.469312,17169648718.220891,57511628206.747423,2847018,437715,1607163,4891896
2014-08-27,ADF (D),24468557,7156130,18541816,50166503,838503555.236102,277252300.040300,580703694.812999,1696459550.089401,128994,22972,85443,237409
2014-08-27,EDGA (J),58653469,21306448,34152899,114112816,2144240040.075092,1152389078.359199,1292198181.126904,4588827299.561195,510310,93990,285337,889637
2014-08-27,EDGX (K),143614250,41651664,114999106,300265020,5213140538.165900,1822139009.407101,3871682133.200290,10906961680.773291,772075,126099,525301,1423475
2014-08-27,CHX (M),6753798,5490289,4331269,16575356,342196967.566800,503226948.261600,264073270.289000,1109497186.117400,1257,1693,506,3456
2014-08-27,NYSE (N),497312747,0,0,497312747,19366420913.523325,0.000000,0.000000,19366420913.523325,1494741,0,0,1494741
2014-08-27,NYSE Arca (P),185903423,117096764,119603925,422604112,8071237580.912967,7533057099.906680,4798308196.978269,20402602877.797916,1506020,329422,777472,2612914
2014-08-27,NASDAQ (Q),272385527,63241630,350716802,686343959,12134810609.919165,4473651169.414199,14066137799.053483,30674599578.386847,2164585,241031,2064740,4470356
2014-08-27,NASDAQ PSX (X),7722393,4506018,6275277,18503688,288847446.145600,300720793.485000,242348546.820000,831916786.450600,64074,17898,44437,126409
2014-08-27,BATS BYX (Y),85922423,24416900,51281622,161620945,3055398733.726391,1263354090.185500,1764894819.764191,6083647643.676082,725305,115783,394211,1235299
2014-08-27,BATS BZX (Z),139649136,55937049,95575973,291162158,5093907721.280487,3592765088.510498,3448730689.085418,12135403498.876403,1122841,212562,712862,2048265
2014-08-26,NYSE MKT (A),0,10034078,8168898,18202976,0.000000,70121852.354600,222384799.575000,292506651.929600,0,22671,21443,44114
2014-08-26,NASDAQ BX (B),53759735,19920783,29694344,103374862,2034437214.918993,1113226753.856898,1156833556.853500,4304497525.629391,464888,85902,243934,794724
2014-08-26,NYSE (DN),86890872,18037993,57387264,162316129,3493177243.265708,944021642.196001,2371782876.491206,6808981761.952915,381578,60617,223712,665907
2014-08-26,NASDAQ (DQ),837731901,238921124,568712528,1645365553,29747247773.354914,12417922936.399509,17769582956.776936,59934753666.531359,2993859,490613,1658400,5142872
2014-08-26,ADF (D),20196408,6582356,16696461,43475225,726694627.361600,278068713.206300,501833681.368201,1506597021.936101,108414,19859,74347,202620
2014-08-26,EDGA (J),58447733,22441534,33184575,114073842,2168183836.964497,1221920569.135900,1177439207.437991,4567543613.538388,515302,99385,274917,889604
2014-08-26,EDGX (K),149016691,46849297,120894204,316760192,5603663328.440990,2160969729.340299,4059526058.215294,11824159115.996583,820987,146562,537165,1504714
2014-08-26,CHX (M),10196788,7142209,3197132,20536129,524305870.997700,546897216.695000,204803290.033100,1276006377.725800,513,1603,917,3033
2014-08-26,NYSE (N),512168699,0,0,512168699,19356293269.123985,0.000000,0.000000,19356293269.123985,1558053,0,0,1558053
2014-08-26,NYSE Arca (P),201348468,140521020,126642346,468511834,8815224564.572579,8599217188.824828,5188727529.417452,22603169282.814859,1597108,389460,817735,2804303
2014-08-26,NASDAQ (Q),288176089,71933567,357681104,717790760,12840001536.140063,4970629627.967708,13790360857.037926,31600992021.145697,2282896,280622,2125815,4689333
2014-08-26,NASDAQ PSX (X),7625689,5679536,6157738,19462963,287522649.732000,363364731.722400,210096670.222200,860984051.676600,61935,20262,42108,124305
2014-08-26,BATS BYX (Y),84074374,27054258,49099632,160228264,3019132763.004212,1403649019.669802,1654535992.508506,6077317775.182520,713834,119280,377703,1210817
2014-08-26,BATS BZX (Z),143514774,62414986,94117643,300047403,5328376708.546275,4025165518.442301,3464769758.558931,12818311985.547507,1162392,238148,700882,2101422
2014-08-25,NYSE MKT (A),0,9927752,9026155,18953907,0.000000,94785623.446700,161778090.373000,256563713.819700,0,21057,21613,42670
2014-08-25,NASDAQ BX (B),49442138,19794448,28351832,97588418,1864136732.898597,1084836481.598299,1142862777.114910,4091835991.611806,427518,85711,240899,754128
2014-08-25,NYSE (DN),83187448,18848434,60598914,162634796,3314660349.200509,997665222.766802,2450774200.539502,6763099772.506813,345008,61607,238358,644973
2014-08-25,NASDAQ (DQ),722805714,266607443,505266231,1494679388,25952150918.417883,14586570034.904181,16929604547.181209,57468325500.503273,2737629,501580,1582083,4821292
2014-08-25,ADF (D),23614168,7868648,18598656,50081472,837054716.899099,336139354.401500,580320969.472400,1753515040.772999,120456,22524,84947,227927
2014-08-25,EDGA (J),54616873,23192735,32753272,110562880,2038387967.805890,1278614444.686799,1288971222.612194,4605973635.104883,489215,96954,278354,864523
2014-08-25,EDGX (K),138364982,47353884,110094374,295813240,5133158639.068685,2334704700.858899,3738043131.722554,11205906471.650138,758923,143319,514726,1416968
2014-08-25,CHX (M),6498538,8128707,3421511,18048756,297651628.827300,747962357.185000,199102233.335300,1244716219.347600,420,1878,544,2842
2014-08-25,NYSE (N),493744446,0,0,493744446,19102549753.670930,0.000000,0.000000,19102549753.670930,1523073,0,0,1523073
2014-08-25,NYSE Arca (P),179830618,147050524,119072383,445953525,7788065748.419536,9172946492.878382,5150048990.286316,22111061231.584234,1430387,364171,778567,2573125
2014-08-25,NASDAQ (Q),266517569,69888244,350468542,686874355,11928850957.971168,4910341316.473521,14681747899.729950,31520940174.174639,2186826,266045,2066166,4519037
2014-08-25,NASDAQ PSX (X),6719924,6137324,6267044,19124292,257196506.211300,396552235.755200,241566633.465000,895315375.431500,57860,20829,43778,122467
2014-08-25,BATS BYX (Y),80325456,28850559,51355404,160531419,2920970719.247816,1526212195.496202,1811389065.864985,6258571980.609003,675176,125095,367690,1167961
2014-08-25,BATS BZX (Z),128968036,62238464,91379215,282585715,4788010600.190388,4052017439.316694,3506948159.921907,12346976199.428989,1068268,225451,694318,1988037
2014-08-22,NYSE MKT (A),0,9020172,7434801,16454973,0.000000,64106442.086100,211517790.519000,275624232.605100,0,18710,25349,44059
2014-08-22,NASDAQ BX (B),52749785,22397018,29650160,104796963,1992442442.439096,1327361028.712099,1144016156.807397,4463819627.958592,438037,103135,240083,781255
2014-08-22,NYSE (DN),84425571,21191088,57159242,162775901,3383803032.884401,1161190275.169394,2205903314.976722,6750896623.030517,353400,73179,214971,641550
2014-08-22,NASDAQ (DQ),686641249,220415633,438143005,1345199887,24239947546.038685,12579107903.772631,14575031325.416638,51394086775.227954,2674945,484856,1446892,4606693
2014-08-22,ADF (D),21770132,7918371,16125379,45813882,823152893.443998,367974982.953700,541841633.790399,1732969510.188097,121036,24404,80617,226057
2014-08-22,EDGA (J),58263320,27727259,32201210,118191789,2051494192.138698,1500208999.905200,1153993911.352903,4705697103.396801,502600,118101,264837,885538
2014-08-22,EDGX (K),144409074,52357007,108696482,305462563,5473388442.602816,2670326443.006300,3850740862.747516,11994455748.356632,838037,167489,533957,1539483
2014-08-22,CHX (M),7786798,5295668,2950928,16033394,331499473.417100,394745264.649500,167101484.494900,893346222.561500,738,1867,525,3130
2014-08-22,NYSE (N),521167064,0,0,521167064,20459758047.340459,0.000000,0.000000,20459758047.340459,1575190,0,0,1575190
2014-08-22,NYSE Arca (P),193216125,156784532,118557459,468558116,8435772193.020228,10587860237.424711,5052844060.377901,24076476490.822840,1635093,468687,796810,2900590
2014-08-22,NASDAQ (Q),291749676,86289889,345522692,723562257,13188450473.783376,6623398451.445804,13972135164.252846,33783984089.482026,2427489,357078,2075992,4860559
2014-08-22,NASDAQ PSX (X),8034234,6825070,7151831,22011135,296992333.371000,493570273.930000,250793322.030000,1041355929.331000,66640,25841,46919,139400
2014-08-22,BATS BYX (Y),90823871,31569945,53225875,175619691,3159327944.383705,1765468177.979500,1756006816.880409,6680802939.243614,743592,145918,404360,1293870
2014-08-22,BATS BZX (Z),143656177,77396088,97096944,318149209,5453944730.780305,5416268124.732690,3764247604.345487,14634460459.858482,1191168,288458,718029,2197655
2014-08-21,NYSE MKT (A),0,10127332,7211761,17339093,0.000000,88731005.950600,169903341.784000,258634347.734600,0,21927,23913,45840
2014-08-21,NASDAQ BX (B),60762142,22757114,30945617,114464873,2193559560.766613,1191011570.743999,1143850749.361996,4528421880.872608,498004,100909,250826,849739
2014-08-21,NYSE (DN),100969975,22631941,62108430,185710346,3998517023.984420,1122798606.329201,2281563200.121145,7402878830.434766,411104,69704,233813,714621
2014-08-21,NASDAQ (DQ),842779054,249169442,493656409,1585604905,29446617997.747771,13100956592.406899,15630554345.326140,58178128935.480810,2902634,526254,1568673,4997561
2014-08-21,ADF (D),24564324,7627919,17005790,49198033,839090728.618100,323287185.296000,517289265.446800,1679667179.360900,128756,23116,83482,235354
2014-08-21,EDGA (J),68120052,27028048,35879740,131027840,2394101089.718600,1381727368.598500,1312744622.500101,5088573080.817201,565754,120118,298275,984147
2014-08-21,EDGX (K),160489052,53311097,119087185,332887334,5678594678.717090,2427151369.971101,3865552525.150696,11971298573.838887,850826,166975,547307,1565108
2014-08-21,CHX (M),20161259,15454486,5363408,40979153,713063018.611700,1387739357.857100,256216472.059400,2357018848.528200,709,2184,565,3458
2014-08-21,NYSE (N),565952812,0,0,565952812,21024111478.392526,0.000000,0.000000,21024111478.392526,1625814,0,0,1625814
2014-08-21,NYSE Arca (P),211835264,155834692,127213257,494883213,8907684180.315099,9887187712.435116,5009026246.862576,23803898139.612791,1600858,417342,847871,2866071
2014-08-21,NASDAQ (Q),320335320,85552666,362914893,768802879,13667555727.548668,6006632339.482334,13729271468.925692,33403459535.956694,2458319,329052,2118544,4905915
2014-08-21,NASDAQ PSX (X),9304558,7306688,6828330,23439576,339965944.903000,481735845.115000,238181080.324600,1059882870.342600,74630,27042,44771,146443
2014-08-21,BATS BYX (Y),95797089,32596134,55255539,183648762,3303424540.303503,1642121456.304500,1780208740.398005,6725754737.006008,758485,141507,403610,1303602
2014-08-21,BATS BZX (Z),159317491,70489533,100440131,330247155,5728233706.396060,4420523025.457296,3629494517.318988,13778251249.172344,1245236,263716,742028,2250980
2014-08-20,NYSE MKT (A),0,11592278,8892047,20484325,0.000000,84581544.613500,235354132.150000,319935676.763500,0,21958,26560,48518
2014-08-20,NASDAQ BX (B),54866547,25452654,31707693,112026894,2031532894.169205,1377479193.355498,1099398202.223005,4508410289.747708,475080,105322,259599,840001
2014-08-20,NYSE (DN),95261361,18867083,65001230,179129674,3765164369.387398,967025589.044097,2507492647.567715,7239682605.999210,407862,62743,228039,698644
2014-08-20,NASDAQ (DQ),814079241,266752438,536065588,1616897267,28849589338.403220,12774427511.637941,17024531634.986576,58648548485.027737,3011223,505174,1602817,5119214
2014-08-20,ADF (D),25946482,8038055,17541867,51526404,1029899957.542401,381868664.780700,499252204.038300,1911020826.361401,159414,25052,85668,270134
2014-08-20,EDGA (J),66307915,30477491,38905656,135691062,2393665248.341507,1679594435.755799,1275493165.963892,5348752850.061198,574756,129531,309098,1013385
2014-08-20,EDGX (K),156234086,53604889,127751976,337590951,5521097446.604679,2571139898.618496,4177602513.713677,12269839858.936852,874321,162349,573027,1609697
2014-08-20,CHX (M),13261782,7706668,4834604,25803054,503434725.359300,612347165.610000,175057338.559600,1290839229.528900,685,2059,595,3339
2014-08-20,NYSE (N),542265309,0,0,542265309,20895701677.491460,0.000000,0.000000,20895701677.491460,1752023,0,0,1752023
2014-08-20,NYSE Arca (P),226797298,156900224,134445603,518143125,9464283913.575386,10735007285.379293,5261048803.266286,25460340002.220965,1694718,428775,892828,3016321
2014-08-20,NASDAQ (Q),331750637,90716060,373590774,796057471,14311392171.083027,6827574241.978942,14466797548.848039,35605763961.910008,2614408,338670,2193469,5146547
2014-08-20,NASDAQ PSX (X),9510418,7109451,6880215,23500084,375321773.727400,503497630.235000,242054726.280300,1120874130.242700,78033,25617,47671,151321
2014-08-20,BATS BYX (Y),90483142,33477762,54495319,178456223,3243655593.142487,1780873590.152002,1740973101.250692,6765502284.545181,775490,141672,407260,1324422
2014-08-20,BATS BZX (Z),154340011,75883761,104090923,334314695,5719370582.872212,5092316062.423101,3752869069.157598,14564555714.452911,1247303,272876,764047,2284226
2014-08-19,NYSE MKT (A),0,10316364,9283158,19599522,0.000000,67904820.204400,220418586.091600,288323406.296000,0,20376,26296,46672
2014-08-19,NASDAQ BX (B),57680149,20708714,32794557,111183420,2115430193.349300,1100356349.254800,1245124411.174900,4460910953.779000,488204,87322,265508,841034
2014-08-19,NYSE (DN),105017004,19445361,68601065,193063430,4191304574.124401,941249572.413703,2654081622.638593,7786635769.176697,429679,68668,250133,748480
2014-08-19,NASDAQ (DQ),900667747,230556258,557254449,1688478454,30786323799.284608,11641091704.896476,18332094560.214847,60759510064.395931,3073666,502895,1702634,5279195
2014-08-19,ADF (D),24566407,6939780,18350381,49856568,842168846.151098,271735278.906400,555691862.805199,1669595987.862697,134031,20304,87508,241843
2014-08-19,EDGA (J),68662591,24690740,38531170,131884501,2503092392.179201,1239193769.307798,1353009163.366312,5095295324.853311,594687,107081,308028,1009796
2014-08-19,EDGX (K),161280853,48836842,131589497,341707192,5582125719.402292,2213003870.958302,4387761967.599707,12182891557.960301,856946,144905,562008,1563859
2014-08-19,CHX (M),11270385,17255453,5824351,34350189,474317111.583900,1433859201.604000,308343992.259600,2216520305.447500,1061,2210,570,3841
2014-08-19,NYSE (N),555676002,0,0,555676002,21536776128.497918,0.000000,0.000000,21536776128.497918,1630969,0,0,1630969
2014-08-19,NYSE Arca (P),209046584,140020987,138166230,487233801,8892319115.469366,8859148760.129990,5579935003.680319,23331402879.279675,1592126,382039,872910,2847075
2014-08-19,NASDAQ (Q),309711495,70600766,389491843,769804104,13355784167.476814,5167143604.257523,15423177094.139396,33946104865.873733,2416062,279429,2132014,4827505
2014-08-19,NASDAQ PSX (X),8555123,5809683,7144260,21509066,328634344.305000,422971852.515800,261942471.268100,1013548668.088900,70460,22423,47934,140817
2014-08-19,BATS BYX (Y),94257679,29207545,58447863,181913087,3292688634.813398,1478145340.236301,1868182947.364508,6639016922.414207,773526,129109,428175,1330810
2014-08-19,BATS BZX (Z),150784691,61989797,103193584,315968072,5495095962.428797,4161307349.621596,3841951453.985617,13498354766.036010,1203887,241487,743659,2189033
2014-08-18,NYSE MKT (A),0,9274196,9685255,18959451,0.000000,76504972.477700,227374166.485899,303879138.963599,0,20898,27023,47921
2014-08-18,NASDAQ BX (B),58278120,22386805,34079276,114744201,2133957140.529001,1248832828.895900,1275561561.431285,4658351530.856186,492340,92814,269529,854683
2014-08-18,NYSE (DN),101365145,22208631,70883976,194457752,4049267089.686744,1160902705.520705,2528052223.593224,7738222018.800673,452039,78003,249864,779906
2014-08-18,NASDAQ (DQ),835365632,329570690,536807919,1701744241,31236836546.560016,19277683145.287288,17249200569.283858,67763720261.131162,3240058,542147,1807542,5589747
2014-08-18,ADF (D),23182961,8108155,17617944,48909060,812989711.675800,348903264.058600,498008283.839499,1659901259.573899,129489,22859,84389,236737
2014-08-18,EDGA (J),68102172,28358686,39203316,135664174,2493143550.778603,1589343637.379101,1347431418.020096,5429918606.177800,603630,118473,322322,1044425
2014-08-18,EDGX (K),151697495,54840829,133200649,339738973,5653580742.561321,2711267648.129592,4464884994.409713,12829733385.100626,860368,161820,582175,1604363
2014-08-18,CHX (M),12924783,11541213,10712607,35178603,634870500.933000,899153372.974000,776598360.622800,2310622234.529800,475,2932,668,4075
2014-08-18,NYSE (N),604960119,0,0,604960119,23996899207.712013,0.000000,0.000000,23996899207.712013,1694096,0,0,1694096
2014-08-18,NYSE Arca (P),219201779,181721640,137152043,538075462,10095711584.317441,12972858194.333679,5413340924.901118,28481910703.552238,1930500,449972,897248,3277720
2014-08-18,NASDAQ (Q),308853778,82040488,415151897,806046163,13797931344.135833,6064687075.206090,16376066871.528928,36238685290.870851,2468669,314530,2334271,5117470
2014-08-18,NASDAQ PSX (X),8385305,5975239,7422115,21782659,295764279.050200,443353115.604000,246956368.604400,986073763.258600,69090,23822,46286,139198
2014-08-18,BATS BYX (Y),92601535,29860633,57990527,180452695,3269177340.851100,1617363069.895201,1898065885.120306,6784606295.866607,782370,130929,435982,1349281
2014-08-18,BATS BZX (Z),153662460,71314270,103058635,328035365,5679363589.391640,4882506579.504804,3779851316.046701,14341721484.943145,1235054,266340,758740,2260134
2014-08-15,NYSE MKT (A),0,11605440,7940461,19545901,0.000000,71881708.658900,156002075.730000,227883784.388900,0,21007,27158,48165
2014-08-15,NASDAQ BX (B),68178852,35645033,40815347,144639232,2500700268.703886,2178966189.921902,1652092022.019194,6331758480.644982,562832,160356,321648,1044836
2014-08-15,NYSE (DN),99199049,29648935,72532382,201380366,3847147435.080529,1751417539.436099,2799716623.390311,8398281597.906939,450966,93903,265424,810293
2014-08-15,NASDAQ (DQ),881394931,362474431,554633033,1798502395,30834983064.159266,21056697907.457044,19157686371.506849,71049367343.123159,3101851,662746,1742373,5506970
2014-08-15,ADF (D),26642308,11053316,20186494,57882118,989404299.539700,492798002.983000,618109284.416500,2100311586.939200,160243,38031,98341,296615
2014-08-15,EDGA (J),75262328,45245712,44984987,165493027,2608109499.687188,2565602861.637694,1610852839.206506,6784565200.531388,622373,193329,354780,1170482
2014-08-15,EDGX (K),179115237,84636984,141126264,404878485,6377262869.175199,4769540188.029208,5203247666.390712,16350050723.595119,1001237,280031,666706,1947974
2014-08-15,CHX (M),10257415,11112886,3647519,25017820,470791147.571800,1349159949.010000,202953723.351700,2022904819.933500,935,4652,934,6521
2014-08-15,NYSE (N),757856102,0,0,757856102,30252384680.626374,0.000000,0.000000,30252384680.626374,2079113,0,0,2079113
2014-08-15,NYSE Arca (P),253278420,253176661,173690171,680145252,10799275923.153521,17651667687.761590,7803646422.530172,36254590033.445283,1992830,737531,1119057,3849418
2014-08-15,NASDAQ (Q),376834677,164126068,537929559,1078890304,16423137136.101813,12820278041.431507,22615298969.404057,51858714146.937377,3021866,653057,2746196,6421119
2014-08-15,NASDAQ PSX (X),10739437,12455218,9562611,32757266,384682674.140000,786913605.976000,363582382.905600,1535178663.021600,84839,42359,60113,187311
2014-08-15,BATS BYX (Y),94235138,48875670,65649248,208760056,3347645593.825604,2787019984.556996,2306159923.796304,8440825502.178904,770839,218838,456837,1446514
2014-08-15,BATS BZX (Z),191148687,143128470,129303309,463580466,6956226236.861719,9783189338.751128,5190143664.802617,21929559240.415464,1519873,528357,947447,2995677
2014-08-14,NYSE MKT (A),0,8641949,8541643,17183592,0.000000,53218181.027600,151423786.173000,204641967.200600,0,19762,25672,45434
2014-08-14,NASDAQ BX (B),58896029,21385940,37116514,117398483,2081052740.468701,1127957730.856102,1226013281.995599,4435023753.320402,485326,89909,276243,851478
2014-08-14,NYSE (DN),100872039,20879473,68700641,190452153,4073078433.990440,1040960253.373900,2403622210.825724,7517660898.190064,427579,63834,233953,725366
2014-08-14,NASDAQ (DQ),892980116,225260344,561141017,1679381477,30691093373.528797,11281216034.960745,16995291121.665616,58967600530.155158,3100278,491755,1686250,5278283
2014-08-14,ADF (D),22839867,6886464,18620915,48347246,835821233.441700,271942327.690400,501842340.610697,1609605901.742797,135311,22253,86449,244013
2014-08-14,EDGA (J),66122740,23882706,38533486,128538932,2350195652.388197,1319066303.255401,1278978555.165796,4948240510.809394,566748,109611,304554,980913
2014-08-14,EDGX (K),155883334,47488625,137553719,340925678,5647040898.764995,2207104632.416602,4320381290.240230,12174526821.421827,867208,147949,601111,1616268
2014-08-14,CHX (M),12354958,12836923,6269886,31461767,882398149.609600,954607053.170000,604618750.275900,2441623953.055500,982,2284,795,4061
2014-08-14,NYSE (N),516669615,0,0,516669615,19386493163.691963,0.000000,0.000000,19386493163.691963,1634508,0,0,1634508
2014-08-14,NYSE Arca (P),224910464,138573527,149301291,512785282,9613319485.952572,8868198424.820888,5646452400.894613,24127970311.668073,1768576,398712,933566,3100854
2014-08-14,NASDAQ (Q),301555437,76040983,353128249,730724669,13012559091.278206,5442244733.355096,13362163133.729380,31816966958.362682,2336780,299568,2074322,4710670
2014-08-14,NASDAQ PSX (X),9927355,5996240,7413950,23337545,370949908.455000,382340708.979000,239646975.754700,992937593.188700,80971,22286,48878,152135
2014-08-14,BATS BYX (Y),90613854,29497752,59905208,180016814,3106623177.302004,1517328821.284699,1808152089.820003,6432104088.406706,729076,125647,412064,1266787
2014-08-14,BATS BZX (Z),158003329,65203858,105302632,328509819,5837552236.458691,4281425384.019896,3732870227.180478,13851847847.659065,1265310,259372,763538,2288220
2014-08-13,NYSE MKT (A),0,7059031,7091189,14150220,0.000000,52660229.591900,143307676.998000,195967906.589900,0,18747,25091,43838
2014-08-13,NASDAQ BX (B),61612012,23510500,37582512,122705024,2174729650.712499,1333024570.357198,1423259241.672400,4931013462.742097,508267,108121,282349,898737
2014-08-13,NYSE (DN),97801731,21753492,73726252,193281475,3840360816.183312,1125937107.616500,2700261665.088820,7666559588.888632,434674,69570,257487,761731
2014-08-13,NASDAQ (DQ),876062422,230574277,567630883,1674267582,30350110185.563330,12065096462.114372,17546229294.421658,59961435942.099360,3139247,531412,1753525,5424184
2014-08-13,ADF (D),24698979,7419103,18256172,50374254,895783269.555898,319108694.394200,565061140.326602,1779953104.276700,143230,23296,88357,254883
2014-08-13,EDGA (J),71744575,29401158,43085796,144231529,2458327112.541698,1598853688.133602,1533412120.116099,5590592920.791399,611553,131158,339564,1082275
2014-08-13,EDGX (K),157349119,55196499,134432991,346978609,5617205965.670811,2765216687.021998,4744904588.873369,13127327241.566178,899108,177043,598341,1674492
2014-08-13,CHX (M),7698217,8727217,8977369,25402803,379309104.800000,853826202.785600,669212459.039400,1902347766.625000,1290,2449,896,4635
2014-08-13,NYSE (N),558947133,0,0,558947133,20365676673.075218,0.000000,0.000000,20365676673.075218,1746271,0,0,1746271
2014-08-13,NYSE Arca (P),244529787,163720175,151840343,560090305,9624623698.451734,10508623266.527433,6256338384.421593,26389585349.400760,1868181,481516,974979,3324676
2014-08-13,NASDAQ (Q),341555670,94487548,392522473,828565691,14299146890.307785,6179826520.190909,15409079800.325622,35888053210.824316,2615851,370039,2325364,5311254
2014-08-13,NASDAQ PSX (X),11018817,6670994,7582372,25272183,365466880.720000,434560182.235000,298507950.605000,1098535013.560000,79979,25116,52046,157141
2014-08-13,BATS BYX (Y),95745654,34434340,62431122,192611116,3236827530.164810,1808085302.770497,2053820562.316408,7098733395.251715,762065,147490,438313,1347868
2014-08-13,BATS BZX (Z),170399946,80149759,108555760,359105465,5844187304.942686,5145984708.798006,3979079350.146811,14969251363.887503,1322616,314683,778851,2416150
2014-08-12,NYSE MKT (A),0,8702067,7817556,16519623,0.000000,54581200.441500,153621108.235000,208202308.676500,0,20375,29783,50158
2014-08-12,NASDAQ BX (B),60720250,22648898,35275409,118644557,2189876861.517296,1281791667.949899,1281722681.020996,4753391210.488191,525837,102963,281610,910410
2014-08-12,NYSE (DN),92022875,21425834,70226731,183675440,3485936384.724440,1132780511.039101,2476912625.039313,7095629520.802854,409206,64521,238277,712004
2014-08-12,NASDAQ (DQ),826216484,223375490,528268652,1577860626,28444330391.553006,12304961110.024656,16058688324.114977,56807979825.692639,2941775,491782,1619829,5053386
2014-08-12,ADF (D),23739991,7758921,19036283,50535195,873914268.561800,348647366.777000,569433735.321802,1791995370.660602,149173,26495,97281,272949
2014-08-12,EDGA (J),67987752,30677255,42067414,140732421,2377345233.533304,1599410708.993397,1367557959.653595,5344313902.180296,592182,134368,338875,1065425
2014-08-12,EDGX (K),166804102,55265069,139944438,362013609,5982434276.753458,2853753480.320599,4554428775.827803,13390616532.901860,994148,187386,641886,1823420
2014-08-12,CHX (M),13426212,7768003,7139634,28333849,622731455.682600,555113283.343700,474128268.245299,1651973007.271599,1099,2787,846,4732
2014-08-12,NYSE (N),543416502,0,0,543416502,20272658338.676387,0.000000,0.000000,20272658338.676387,1802163,0,0,1802163
2014-08-12,NYSE Arca (P),231660664,163261202,150723616,545645482,9880957491.381510,10800402191.489684,5931900212.846516,26613259895.717710,1906484,485540,1003703,3395727
2014-08-12,NASDAQ (Q),319650728,95506757,382838124,797995609,13708713496.117492,6798346336.855895,14153813450.004808,34660873282.978195,2578165,387476,2284105,5249746
2014-08-12,NASDAQ PSX (X),9234495,6940256,7130153,23304904,336251187.116100,473622000.935000,255858404.213300,1065731592.264400,78852,28675,52596,160123
2014-08-12,BATS BYX (Y),90289112,33092605,58757455,182139172,3153973444.609395,1762292131.588103,1885133381.432806,6801398957.630304,753748,149417,425196,1328361
2014-08-12,BATS BZX (Z),164340845,82365253,113118149,359824247,6013754537.584308,5540958319.220200,3967763494.151146,15522476350.955654,1385047,334266,869523,2588836
2014-08-11,NYSE MKT (A),0,9102592,8153868,17256460,0.000000,65086109.196800,175619058.967000,240705168.163800,0,22505,30993,53498
2014-08-11,NASDAQ BX (B),71039780,25780541,40087720,136908041,2610931833.887703,1396134282.419201,1456296987.991303,5463363104.298207,600567,110327,310449,1021343
2014-08-11,NYSE (DN),97416897,23148123,67861771,188426791,3958060644.776598,1389453719.523204,2591768475.271413,7939282839.571215,434888,76460,241987,753335
2014-08-11,NASDAQ (DQ),860839787,270812549,517762350,1649414686,30994709851.942317,14283057617.799868,16746207190.260429,62023974660.002614,3393556,553267,1804453,5751276
2014-08-11,ADF (D),23627020,7542844,17788149,48958013,890537232.675001,328888588.293500,558717619.723600,1778143440.692101,138258,23485,92570,254313
2014-08-11,EDGA (J),71144220,31000247,38827682,140972149,2602542052.023407,1743464160.138303,1369550840.771799,5715557052.933509,615446,135896,319971,1071313
2014-08-11,EDGX (K),175454525,57226556,131988290,364669371,6569053810.352720,3031038161.384401,4642104833.096394,14242196804.833515,1019435,186659,647516,1853610
2014-08-11,CHX (M),8700634,8850474,2566216,20117324,446973781.460800,615534796.557800,180209446.666100,1242718024.684700,1182,2926,548,4656
2014-08-11,NYSE (N),596448639,0,0,596448639,22863473406.594951,0.000000,0.000000,22863473406.594951,1905225,0,0,1905225
2014-08-11,NYSE Arca (P),251842285,183848599,151530023,587220907,11285298504.606001,11848711330.011636,6165585687.186406,29299595521.804043,2171989,524662,1004662,3701313
2014-08-11,NASDAQ (Q),343132483,88834142,384192630,816159255,15065549931.099105,6394248449.779702,15247733133.648985,36707531514.527792,2725695,373608,2362034,5461337
2014-08-11,NASDAQ PSX (X),10009583,7044308,8040614,25094505,374457246.152000,474801958.135000,282801732.255000,1132060936.542000,83517,27058,58828,169403
2014-08-11,BATS BYX (Y),100753254,34576005,61591526,196920785,3537639784.128005,1834127920.146702,1993909773.160776,7365677477.435483,835725,148864,457345,1441934
2014-08-11,BATS BZX (Z),175033199,83425997,109659492,368118688,6688197002.710985,5789952556.472987,3935382973.960119,16413532533.144091,1450890,333013,832426,2616329
2014-08-08,NYSE MKT (A),0,8892512,8933791,17826303,0.000000,62048711.901500,165443542.205400,227492254.106900,0,20906,35838,56744
2014-08-08,NASDAQ BX (B),70552128,27303237,44725588,142580953,2581139420.993304,1566406271.323297,1589502294.836600,5737047987.153201,569652,121412,318531,1009595
2014-08-08,NYSE (DN),106326818,25862454,82256292,214445564,4187308044.111365,1471428422.728399,2701031082.150960,8359767548.990724,449024,83917,278180,811121
2014-08-08,NASDAQ (DQ),878515789,293686295,563856974,1736059058,29499490579.871908,16653508012.187706,17496144173.253723,63649142765.313337,3214868,576569,1825350,5616787
2014-08-08,ADF (D),24452584,8686150,18923913,52062647,920230063.843100,438865479.922400,570866915.626200,1929962459.391700,148027,25751,94257,268035
2014-08-08,EDGA (J),73737942,36587406,45994523,156319871,2623658834.700402,1930954052.052803,1500088526.487599,6054701413.240804,606852,149903,342817,1099572
2014-08-08,EDGX (K),170838949,66669404,141259823,378768176,6228306317.627809,3663167506.280904,4995230052.407800,14886703876.316513,1000926,224986,680126,1906038
2014-08-08,CHX (M),12314519,8298550,5499204,26112273,507829202.601500,809505285.304000,334633554.138800,1651968042.044300,769,3439,835,5043
2014-08-08,NYSE (N),628512591,0,0,628512591,23759174690.620270,0.000000,0.000000,23759174690.620270,1947367,0,0,1947367
2014-08-08,NYSE Arca (P),244708114,209020500,171691286,625419900,10372242860.865306,14376961335.533784,6778050368.305317,31527254564.704407,1943676,601305,1054766,3599747
2014-08-08,NASDAQ (Q),384549767,124934749,462031133,971515649,16486215771.214089,9386424251.525684,17805784380.023880,43678424402.763653,3024823,487530,2646206,6158559
2014-08-08,NASDAQ PSX (X),11574991,8911924,9620929,30107844,429499757.019999,585424382.038800,334993984.830000,1349918123.888799,91873,32480,61410,185763
2014-08-08,BATS BYX (Y),99614277,37792563,69334448,206741288,3498696985.954985,2115893730.210701,2159932293.774088,7774523009.939774,799189,170795,473998,1443982
2014-08-08,BATS BZX (Z),194572971,111619528,135873809,442066308,7194500587.733219,7416581184.268589,4914482429.531795,19525564201.533603,1533972,426142,922423,2882537
2014-08-07,NYSE MKT (A),0,9155035,8136746,17291781,0.000000,78746322.730000,208818580.818600,287564903.548600,0,20943,31030,51973
2014-08-07,NASDAQ BX (B),81891496,34008399,49555163,165455058,3087715324.860592,1949075318.130998,1840085102.735091,6876875745.726681,665286,152547,382105,1199938
2014-08-07,NYSE (DN),112229309,28844121,77419819,218493249,4367071809.626172,1665676979.731194,3055589874.452594,9088338663.809960,471601,85017,286129,842747
2014-08-07,NASDAQ (DQ),980609702,323057602,596939760,1900607064,33063311896.260916,19886577074.051741,19846471074.209742,72796360044.522399,3425047,603164,1876080,5904291
2014-08-07,ADF (D),29110823,9441800,20094313,58646936,1050017876.470802,472152105.070700,667902107.890601,2190072089.432103,169278,28797,110842,308917
2014-08-07,EDGA (J),80125820,39859987,48538947,168524754,2825005666.547587,2148064848.819701,1689252841.188500,6662323356.555788,656765,165620,377343,1199728
2014-08-07,EDGX (K),207511242,73559126,150199328,431269696,7296289015.400889,4101922915.918798,5553828396.961892,16952040328.281579,1187838,243533,764286,2195657
2014-08-07,CHX (M),7371533,6978683,6720478,21070694,367737024.680000,600924272.864000,474992381.120900,1443653678.664900,1052,3432,774,5258
2014-08-07,NYSE (N),670186513,0,0,670186513,24600935136.239789,0.000000,0.000000,24600935136.239789,2131460,0,0,2131460
2014-08-07,NYSE Arca (P),289524817,239042729,192203614,720771160,12114678386.387656,15839402118.748098,7733252042.249446,35687332547.385200,2269344,675216,1231912,4176472
2014-08-07,NASDAQ (Q),436706994,140996137,485250552,1062953683,18349150356.553708,10180262230.672490,18561580498.629821,47090993085.856019,3378682,543705,2900699,6823086
2014-08-07,NASDAQ PSX (X),12277860,9771686,10186867,32236413,443019987.255900,678941474.695000,384458794.786600,1506420256.737500,96186,37262,71086,204534
2014-08-07,BATS BYX (Y),112407167,48509601,74518404,235435172,3916255022.743106,2612836857.318704,2366806274.021390,8895898154.083200,896478,207712,514140,1618330
2014-08-07,BATS BZX (Z),216969496,137338347,148468788,502776631,7919294115.608870,9224696701.858203,5335289206.711842,22479280024.178915,1717374,494223,1072129,3283726
2014-08-06,NYSE MKT (A),0,9316153,6695189,16011342,0.000000,62081116.435900,137085486.954000,199166603.389900,0,21825,27500,49325
2014-08-06,NASDAQ BX (B),83696215,34876417,44019165,162591797,3120968062.440991,1830261034.236020,1601790011.087401,6553019107.764412,668343,167259,333759,1169361
2014-08-06,NYSE (DN),131502368,31477996,78123777,241104141,5257787997.063752,1749643027.798000,2873821346.283518,9881252371.145270,515623,97582,280058,893263
2014-08-06,NASDAQ (DQ),1116015024,352854260,610217600,2079086884,38712561435.382410,16660654051.510553,20007063950.881527,75380279437.774490,3633601,648208,1907539,6189348
2014-08-06,ADF (D),32894308,11309379,19149041,63352728,1246979590.684200,517925559.784200,599940313.180799,2364845463.649199,198861,42760,104618,346239
2014-08-06,EDGA (J),90229954,44579132,46554983,181364069,3330664927.875892,2281357401.432094,1615534786.666895,7227557115.974881,729826,224888,356452,1311166
2014-08-06,EDGX (K),215818965,71537725,138550162,425906852,8012040202.258487,3760853026.586899,5251333462.529608,17024226691.374994,1226279,242684,732619,2201582
2014-08-06,CHX (M),10083179,8420677,7397269,25901125,361786782.476600,721617662.375000,334977901.045700,1418382345.897300,1040,3653,863,5556
2014-08-06,NYSE (N),690912972,0,0,690912972,25927354649.788509,0.000000,0.000000,25927354649.788509,2158160,0,0,2158160
2014-08-06,NYSE Arca (P),338703003,254571318,183703529,776977850,14050881339.624994,15358520749.983041,7444347099.549070,36853749189.157105,2328123,657207,1159211,4144541
2014-08-06,NASDAQ (Q),471227879,142455080,468261436,1081944395,20388474330.432460,9758806729.187611,17923962376.866307,48071243436.486378,3563866,514535,2802111,6880512
2014-08-06,NASDAQ PSX (X),15855922,11015503,9705699,36577124,526004069.043001,726423501.380000,367939311.040000,1620366881.463001,110668,40834,65449,216951
2014-08-06,BATS BYX (Y),114343729,49086956,69900693,233331378,3999965353.048216,2525041869.363206,2170689324.958720,8695696547.370142,900136,200028,492563,1592727
2014-08-06,BATS BZX (Z),229722431,131732085,139568627,501023143,8729336356.662832,8123878256.177079,5096622999.983877,21949837612.823788,1770343,472950,978771,3222064
2014-08-05,NYSE MKT (A),0,10765859,7040687,17806546,0.000000,72094401.797800,134371619.530000,206466021.327800,0,25353,26788,52141
2014-08-05,NASDAQ BX (B),89034716,37219456,49806644,176060816,3495036279.416714,2140673793.161605,1864754359.900900,7500464432.479219,734063,199838,367612,1301513
2014-08-05,NYSE (DN),121687861,27658842,75238462,224585165,4943775797.053605,1606769112.628895,2838232859.151091,9388777768.833591,490808,87597,265630,844035
2014-08-05,NASDAQ (DQ),1029671423,346046838,623208874,1998927135,36731178310.546827,20433397034.146981,20428934315.499605,77593509660.193413,3579157,693914,1868391,6141462
2014-08-05,ADF (D),28636945,10876545,18089044,57602534,1073580066.325100,549199532.079099,621686630.232601,2244466228.636800,180627,35178,104308,320113
2014-08-05,EDGA (J),89478950,45363456,48869120,183711526,3351965190.377286,2439140614.165491,1686467966.991499,7477573771.534276,741663,249366,379562,1370591
2014-08-05,EDGX (K),219290793,79385004,159982341,458658138,8066421497.291461,4393265578.284505,5381134660.519285,17840821736.095251,1272183,281376,774770,2328329
2014-08-05,CHX (M),11691910,11608585,10190205,33490700,429474513.497700,1616697301.487000,616890825.387000,2663062640.371700,1294,5138,1228,7660
2014-08-05,NYSE (N),702905894,0,0,702905894,26575259294.576905,0.000000,0.000000,26575259294.576905,2401148,0,0,2401148
2014-08-05,NYSE Arca (P),318787685,261092717,196993429,776873831,13714030068.184824,18833387975.079667,7879045004.586961,40426463047.851452,2397295,726421,1214466,4338182
2014-08-05,NASDAQ (Q),487206560,167069946,497586949,1151863455,21338650747.444068,12455426839.125947,19009612391.385305,52803689977.955320,3800442,621436,2960566,7382444
2014-08-05,NASDAQ PSX (X),13436953,11518251,11718087,36673291,497403708.560000,812621951.500000,430926886.165000,1740952546.225000,107173,43316,74171,224660
2014-08-05,BATS BYX (Y),118565809,50551792,72694475,241812076,4170833323.427705,2761097595.495097,2368770554.778532,9300701473.701334,935570,213658,510730,1659958
2014-08-05,BATS BZX (Z),233619623,139957001,147875587,521452211,8622242334.155684,9599949210.890456,5421667436.239444,23643858981.285584,1824234,546777,1038375,3409386
2014-08-04,NYSE MKT (A),0,9864688,8257175,18121863,0.000000,66080375.205100,217417048.849000,283497424.054100,0,23844,26823,50667
2014-08-04,NASDAQ BX (B),81311336,28707282,44030328,154048946,3219666388.765796,1570734188.276608,1711902440.032001,6502303017.074405,694540,152670,356535,1203745
2014-08-04,NYSE (DN),105373738,26791289,64708809,196873836,4381152208.432332,1466483718.185493,2467690501.984117,8315326428.601942,448371,84258,256750,789379
2014-08-04,NASDAQ (DQ),918571728,324017548,545049424,1787638700,33464081809.344459,17561967190.277852,18455792354.452701,69481841354.075012,3546247,615341,1837566,5999154
2014-08-04,ADF (D),23841619,8265968,15461720,47569307,897922358.346101,377963975.504200,533331359.004001,1809217692.854302,148759,24898,89587,263244
2014-08-04,EDGA (J),78923145,34140586,43027459,156091190,2889406975.622017,1852006632.294901,1512773142.506097,6254186750.423015,648640,171739,339221,1159600
2014-08-04,EDGX (K),185865979,66967527,136426031,389259537,7179016917.411954,3700371186.875696,5081271077.320682,15960659181.608332,1139371,222336,700366,2062073
2014-08-04,CHX (M),9443389,5898455,4095570,19437414,448861762.741000,563437547.182300,134152662.334800,1146451972.258100,1197,2874,717,4788
2014-08-04,NYSE (N),675544945,0,0,675544945,25969209811.017111,0.000000,0.000000,25969209811.017111,2115620,0,0,2115620
2014-08-04,NYSE Arca (P),267956731,194045689,157886771,619889191,11861748304.548817,13094184727.901604,6439315890.768684,31395248923.219105,2143230,549069,1048890,3741189
2014-08-04,NASDAQ (Q),408897104,118253159,464063645,991213908,18129355472.709309,8556453867.018093,18066674324.928081,44752483664.655483,3269612,447159,2629127,6345898
2014-08-04,NASDAQ PSX (X),10794638,7840432,7662273,26297343,438011783.585000,618963744.170000,305497166.764600,1362472694.519600,93106,31631,59290,184027
2014-08-04,BATS BYX (Y),110751862,37391341,64729225,212872428,3819789295.150824,2016854592.504296,2072145154.698115,7908789042.353235,887395,165454,476429,1529278
2014-08-04,BATS BZX (Z),200294949,103790458,126111043,430196450,7622203843.497323,7074976448.344791,4604151506.395753,19301331798.237867,1650302,403036,954923,3008261
2014-08-01,NYSE MKT (A),0,10869001,9716241,20585242,0.000000,78895299.071300,223182515.419000,302077814.490300,0,24098,29471,53569
2014-08-01,NASDAQ BX (B),100784460,42215561,51455594,194455615,4001355158.616585,2660553562.679901,2169728135.583796,8831636856.880282,831648,228010,411909,1471567
2014-08-01,NYSE (DN),133530051,37213181,80379643,251122875,5504738955.222654,2149520932.500816,3222917668.894379,10877177556.617849,549831,112831,310990,973652
2014-08-01,NASDAQ (DQ),1166616387,502175098,670731940,2339523425,43047285161.856186,33317817059.095063,23101088784.077362,99466191005.028611,4085671,812313,2089636,6987620
2014-08-01,ADF (D),32185830,13409865,22483187,68078882,1249752502.410101,745587145.618100,763247118.335499,2758586766.363700,197216,49289,118918,365423
2014-08-01,EDGA (J),94056600,52934975,52898156,199889731,3549330910.964906,3308995320.073492,2107242071.965299,8965568303.003697,782029,224209,420703,1426941
2014-08-01,EDGX (K),242538841,97603643,169305960,509448444,9205293453.383235,5973197617.822884,6345836419.548507,21524327490.754626,1463406,330681,870585,2664672
2014-08-01,CHX (M),7996301,7066137,6036299,21098737,378617882.652800,803648289.370000,335299500.762200,1517565672.785000,1942,6188,1192,9322
2014-08-01,NYSE (N),791733948,0,0,791733948,29974280150.006735,0.000000,0.000000,29974280150.006735,2559958,0,0,2559958
2014-08-01,NYSE Arca (P),345040183,312617768,201778298,859436249,15104427381.952314,22930498974.010354,8733961428.776118,46768887784.738786,2730692,852492,1312029,4895213
2014-08-01,NASDAQ (Q),524238695,190096301,540526256,1254861252,23128177662.431530,15872423182.948112,21627960184.521023,60628561029.900665,4170719,719426,3290122,8180267
2014-08-01,NASDAQ PSX (X),17044571,17392525,12380668,46817764,674918226.756001,1270246861.055000,541784026.965000,2486949114.776001,134991,62401,83891,281283
2014-08-01,BATS BYX (Y),135165752,55607760,79086811,269860323,4816010146.716217,3342850032.599798,2737108174.626305,10895968353.942320,1097367,246264,574308,1917939
2014-08-01,BATS BZX (Z),259131027,171130484,157297695,587559206,10121598040.308613,13155749573.431805,6074694500.558178,29352042114.298596,2057576,649387,1128402,3835365
2014-07-31,NYSE MKT (A),0,14037381,8248421,22285802,0.000000,96437992.055500,205145144.173999,301583136.229499,0,26632,32582,59214
2014-07-31,NASDAQ BX (B),110040396,46924806,56276856,213242058,4263472635.818480,2836297492.714798,2232835862.065983,9332605990.599261,895600,239101,436320,1571021
2014-07-31,NYSE (DN),167783341,35840015,91680946,295304302,6188820036.312132,2142148317.479400,3664974774.942627,11995943128.734159,633622,116393,339151,1089166
2014-07-31,NASDAQ (DQ),1278949352,452239858,747455985,2478645195,45890388100.351929,26579918483.739435,24948292901.367253,97418599485.458617,4496289,836119,2263985,7596393
2014-07-31,ADF (D),32639290,11874516,19588393,64102199,1215189498.890798,754706192.530300,687217459.515500,2657113150.936598,202269,36296,113515,352080
2014-07-31,EDGA (J),97863264,53863503,54873041,206599808,3570925969.831284,3122770962.526142,1970326802.361993,8664023734.719419,783830,259235,420498,1463563
2014-07-31,EDGX (K),274278002,101389674,188829212,564496888,10193804960.428041,5838059927.867913,7016015145.698607,23047880033.994561,1550044,324665,935435,2810144
2014-07-31,CHX (M),12324505,14937552,6799915,34061972,606556890.254800,1981763590.268800,376143082.488400,2964463563.012000,1672,5946,1693,9311
2014-07-31,NYSE (N),926766010,0,0,926766010,34832589237.317898,0.000000,0.000000,34832589237.317898,2650429,0,0,2650429
2014-07-31,NYSE Arca (P),376906455,315330857,219436333,911673645,15930204844.106157,22000891876.577299,9073438658.404507,47004535379.087963,2787032,812174,1383668,4982874
2014-07-31,NASDAQ (Q),549722907,187318821,615232442,1352274170,23625816105.636410,14810915533.521777,24057187166.741018,62493918805.899205,4196632,656734,3389917,8243283
2014-07-31,NASDAQ PSX (X),17849143,17052119,12940716,47841978,662989740.620000,1250389723.720000,561618001.459402,2474997465.799402,130214,59250,81397,270861
2014-07-31,BATS BYX (Y),144344563,59123779,84913403,288381745,5171573480.005708,3284294103.106897,2778286821.633303,11234154404.745908,1135404,256594,593307,1985305
2014-07-31,BATS BZX (Z),292164290,163175745,169378403,624718438,10623369292.179136,11665771854.034652,6310399917.754328,28599541063.968116,2172111,599538,1189070,3960719
2014-07-30,NYSE MKT (A),0,11375873,9383492,20759365,0.000000,64560725.022500,242086323.056900,306647048.079400,0,23811,30965,54776
2014-07-30,NASDAQ BX (B),85031733,29849620,46589104,161470457,3328080044.364792,1764251399.886403,1807305421.925906,6899636866.177101,710517,130069,368877,1209463
2014-07-30,NYSE (DN),128924705,26462875,79992933,235380513,5179770158.413594,1525586789.335905,2993720602.166326,9699077549.915825,505675,83204,286504,875383
2014-07-30,NASDAQ (DQ),1070592754,280243934,627416739,1978253427,38786120776.174133,14764926733.140780,21249230830.280712,74800278339.595625,3677972,566982,1893012,6137966
2014-07-30,ADF (D),31536890,9119663,19411080,60067633,1134772833.311699,408128091.667400,673762140.014397,2216663064.993496,172045,27214,103953,303212
2014-07-30,EDGA (J),87373431,35417657,50704684,173495772,3437438802.327508,2021710914.088998,1827366636.088798,7286516352.505304,739059,175417,392717,1307193
2014-07-30,EDGX (K),237706981,71171350,153237406,462115737,9041232140.139713,3821695598.398609,5668922752.273511,18531850490.811833,1327815,226427,788637,2342879
2014-07-30,CHX (M),10490574,8618603,6732452,25841629,433684525.699200,892927557.205000,358217094.369900,1684829177.274100,988,4492,844,6324
2014-07-30,NYSE (N),680440020,0,0,680440020,25969043868.272325,0.000000,0.000000,25969043868.272325,2227387,0,0,2227387
2014-07-30,NYSE Arca (P),315179968,213319374,177310402,705809744,13617114134.591526,14226844505.362077,7318542851.046058,35162501490.999661,2288806,620682,1155840,4065328
2014-07-30,NASDAQ (Q),466288980,126834591,478553565,1071677136,20727233135.084447,9572502267.314363,19166241945.448637,49465977347.847447,3623454,471281,2856322,6951057
2014-07-30,NASDAQ PSX (X),14201519,12780184,10538499,37520202,551021785.160000,859101363.770000,460061054.785001,1870184203.715001,108568,41236,68705,218509
2014-07-30,BATS BYX (Y),110626776,39598162,70254055,220478993,3858375624.245521,2169259309.461496,2250747437.569576,8278382371.276593,879197,175489,489209,1543895
2014-07-30,BATS BZX (Z),224374260,115541015,145348541,485263816,8735374360.879469,8384932515.173304,5322282194.350515,22442589070.403288,1764976,445893,1030106,3240975
2014-07-29,NYSE MKT (A),0,9538884,11543646,21082530,0.000000,62160350.623000,249880381.745000,312040732.368000,0,21538,33573,55111
2014-07-29,NASDAQ BX (B),79724933,24212267,48162819,152100019,3228391935.526603,1359180714.954601,1731327033.778690,6318899684.259894,664863,105443,357204,1127510
2014-07-29,NYSE (DN),123320402,23517917,88657982,235496301,5046029275.573697,1274516258.239701,3132756648.050094,9453302181.863492,472295,71330,295560,839185
2014-07-29,NASDAQ (DQ),1011097428,221598397,757412218,1990108043,37936821293.504484,11274934321.083843,21594372427.352028,70806128041.940355,3474030,495577,1986730,5956337
2014-07-29,ADF (D),25279076,7348376,23357732,55985184,948225730.313300,319886812.082800,664245745.583200,1932358287.979300,142299,21723,106878,270900
2014-07-29,EDGA (J),73701398,29777210,49484136,152962744,2781502663.616098,1595694236.570202,1617407676.541197,5994604576.727497,601974,120746,358533,1081253
2014-07-29,EDGX (K),211138723,56643512,165055681,432837916,8069318507.461094,3091903755.179901,5530265119.755416,16691487382.396411,1185317,180121,766634,2132072
2014-07-29,CHX (M),11891312,7581687,4921348,24394347,402583688.059700,739563303.524100,283042323.941900,1425189315.525700,1299,3030,833,5162
2014-07-29,NYSE (N),627736977,0,0,627736977,24395746832.976098,0.000000,0.000000,24395746832.976098,1952642,0,0,1952642
2014-07-29,NYSE Arca (P),280004732,165352953,198441146,643798831,12163007915.215906,11039218239.566585,6993534843.341384,30195760998.123875,2029435,454330,1145725,3629490
2014-07-29,NASDAQ (Q),423323698,95942959,508027834,1027294491,19044763762.701874,7349058928.259527,18254945549.421393,44648768240.382794,3207568,353374,2706504,6267446
2014-07-29,NASDAQ PSX (X),13446387,8782605,12021155,34250147,531725524.391000,598977292.700000,402633206.205001,1533336023.296001,102503,31560,69448,203511
2014-07-29,BATS BYX (Y),104276162,33059638,72001599,209337399,3674419758.970617,1795495094.161298,2091116169.198499,7561031022.330414,826651,149341,485539,1461531
2014-07-29,BATS BZX (Z),206067432,83960249,156775987,446803668,8142643259.833087,5887752866.265018,5125212308.260061,19155608434.358166,1610440,324455,1010013,2944908
2014-07-28,NYSE MKT (A),0,9803275,8550021,18353296,0.000000,60009060.028300,203126792.766000,263135852.794300,0,21570,26351,47921
2014-07-28,NASDAQ BX (B),72420486,24158339,43648184,140227009,2920430640.611806,1321468825.250599,1716530574.300202,5958430040.162607,628389,125155,349719,1103263
2014-07-28,NYSE (DN),111482845,24646913,82995693,219125451,4417130481.181922,1308468702.166601,3280712616.869230,9006311800.217753,438202,81440,294783,814425
2014-07-28,NASDAQ (DQ),896108686,326792836,612549043,1835450565,32856473708.514381,16856898762.342725,21150519700.572508,70863892171.429614,3215789,538685,1931454,5685928
2014-07-28,ADF (D),22224143,8655234,20016907,50896284,822315520.856999,357503517.635500,640115753.215501,1819934791.708000,126668,22156,95593,244417
2014-07-28,EDGA (J),65991540,29891673,44762763,140645976,2354340186.237295,1580843360.291795,1561214301.453994,5496397847.983084,543443,128504,344070,1016017
2014-07-28,EDGX (K),173581533,58463562,148110281,380155376,6536917609.351093,3007059886.429997,5476579923.070569,15020557418.851659,993085,177310,708789,1879184
2014-07-28,CHX (M),7531717,7923512,5811948,21267177,270819438.544300,643479930.257300,350262112.513200,1264561481.314800,842,2616,624,4082
2014-07-28,NYSE (N),588984264,0,0,588984264,22757128204.560510,0.000000,0.000000,22757128204.560510,1837230,0,0,1837230
2014-07-28,NYSE Arca (P),232361936,169161485,166159014,567682435,10430257980.270012,10990016989.660217,6961265836.841556,28381540806.771785,1815975,460924,1056014,3332913
2014-07-28,NASDAQ (Q),349230937,91558074,448770928,889559939,15916797281.174558,6572153658.750326,18006233770.234394,40495184710.159278,2764792,332979,2591778,5689549
2014-07-28,NASDAQ PSX (X),10898897,10071504,9399750,30370151,442616294.315000,621995196.000000,380567347.995000,1445178838.310000,91511,30944,64551,187006
2014-07-28,BATS BYX (Y),97866429,34245271,71372816,203484516,3453771151.648424,1695690082.735001,2178308018.887011,7327769253.270436,785511,140967,462765,1389243
2014-07-28,BATS BZX (Z),175881511,84713739,131191348,391786598,6860424526.303341,5602748577.538305,4710773024.400973,17173946128.242619,1396019,317628,909828,2623475
2014-07-25,NYSE MKT (A),0,9460664,7005525,16466189,0.000000,65181032.889700,161351581.260000,226532614.149700,0,22515,24423,46938
2014-07-25,NASDAQ BX (B),68848538,23389126,43551719,135789383,2666080582.859611,1305398886.517000,1831362456.656195,5802841926.032806,583235,105183,347297,1035715
2014-07-25,NYSE (DN),93697788,20911476,72380493,186989757,3835933646.825726,1229699253.687198,3326876203.901448,8392509104.414372,395728,66751,275414,737893
2014-07-25,NASDAQ (DQ),816490430,246527219,578363873,1641381522,29903743839.123742,12697926705.130377,21245875322.912611,63847545867.166730,3015278,495984,1850993,5362255
2014-07-25,ADF (D),22145584,6964019,17256941,46366544,804925625.598301,297068647.290500,617971689.586001,1719965962.474802,119906,19768,88312,227986
2014-07-25,EDGA (J),63853452,27973462,44574566,136401480,2214225971.841405,1546968588.093471,1675041819.323404,5436236379.258280,517693,127452,343218,988363
2014-07-25,EDGX (K),168839800,52703881,134302220,355845901,6260973455.875787,2783005665.647605,5480923722.174182,14524902843.697574,960141,168695,698061,1826897
2014-07-25,CHX (M),8050792,6373982,6423970,20848744,315985006.549400,675673602.130000,298186900.556600,1289845509.236000,947,2555,937,4439
2014-07-25,NYSE (N),569751422,0,0,569751422,21963826247.162623,0.000000,0.000000,21963826247.162623,1799243,0,0,1799243
2014-07-25,NYSE Arca (P),224161658,155250411,164082980,543495049,9826984614.778615,10763050829.799128,7687178746.037434,28277214190.615177,1707338,426899,1079991,3214228
2014-07-25,NASDAQ (Q),338313242,88547100,447988331,874848673,15193644532.041450,6968609489.171790,19429093746.483033,41591347767.696273,2651924,331993,2595744,5579661
2014-07-25,NASDAQ PSX (X),10424516,8822815,9687355,28934686,426141010.289001,590327195.985000,407648816.985000,1424117023.259001,82381,30319,65350,178050
2014-07-25,BATS BYX (Y),92949479,31955763,63221585,188126827,3184748218.432798,1662484874.560901,2118100842.210209,6965333935.203908,740910,129645,451978,1322533
2014-07-25,BATS BZX (Z),169782291,78940423,127522446,376245160,6596107211.958075,5637199080.892568,4990978097.244778,17224284390.095421,1367126,298199,930055,2595380
2014-07-24,NYSE MKT (A),0,10245844,9615858,19861702,0.000000,61358245.242500,259599769.252001,320958014.494501,0,22237,28268,50505
2014-07-24,NASDAQ BX (B),80760732,21648010,47455429,149864171,3250441374.851794,1094524557.824388,1987905217.816688,6332871150.492870,672519,135686,373546,1181751
2014-07-24,NYSE (DN),120888237,20552007,82696109,224136353,5277599634.492249,1067780316.101198,3589937465.926320,9935317416.519767,464609,67393,293466,825468
2014-07-24,NASDAQ (DQ),1109424313,247409989,702264577,2059098879,42262657992.748213,11491714579.873804,26474093548.684782,80228466121.306799,3351829,492517,1967490,5811836
2014-07-24,ADF (D),26268321,7443501,19573785,53285607,973987266.187200,277883315.406600,683024261.843898,1934894843.437698,142383,20144,96527,259054
2014-07-24,EDGA (J),75701123,24838582,47959694,148499399,2828682605.723404,1305566694.949301,1994201515.237497,6128450815.910202,611689,108183,370454,1090326
2014-07-24,EDGX (K),199560857,55808127,158320692,413689676,7501277918.159303,2622654424.018701,6562969941.763760,16686902283.941764,1128255,170584,780787,2079626
2014-07-24,CHX (M),13655664,6803645,8426973,28886282,544522539.387900,465390851.246000,497379882.071400,1507293272.705300,1506,2687,876,5069
2014-07-24,NYSE (N),631661420,0,0,631661420,23949526088.879067,0.000000,0.000000,23949526088.879067,1948279,0,0,1948279
2014-07-24,NYSE Arca (P),267421667,159302708,182747741,609472116,11782472612.087678,9939275547.444287,8842256368.766599,30564004528.298564,1954226,418405,1170587,3543218
2014-07-24,NASDAQ (Q),398992952,82379880,477905508,959278340,17507821053.989109,5812406988.616199,21375784659.491402,44696012702.096710,3037654,311995,2768492,6118141
2014-07-24,NASDAQ PSX (X),13668308,7747094,10129738,31545140,558589457.379400,502675844.325000,450588984.983000,1511854286.687400,101830,23661,69560,195051
2014-07-24,BATS BYX (Y),108316647,31459090,71125317,210901054,3830985004.847799,1495775274.425998,2357001273.666614,7683761552.940411,848271,127271,480262,1455804
2014-07-24,BATS BZX (Z),196536439,76471964,132034651,405043054,7580076438.702761,5050744132.062406,5093411088.968234,17724231659.733401,1520749,293291,940452,2754492
2014-07-23,NYSE MKT (A),0,9972514,12539264,22511778,0.000000,73833638.567900,373320241.672998,447153880.240898,0,24115,36390,60505
2014-07-23,NASDAQ BX (B),75018239,18735436,45931664,139685339,3040160358.865200,963559516.956799,1895708349.092601,5899428224.914600,636669,84956,367117,1088742
2014-07-23,NYSE (DN),113454703,17764028,88019223,219237954,4724849585.546600,988202416.083901,3650669861.291367,9363721862.921868,445216,62755,297504,805475
2014-07-23,NASDAQ (DQ),934961245,225861790,671326250,1832149285,34823922540.508771,11927196066.050860,24067085325.383950,70818203931.943581,3146221,467797,1957120,5571138
2014-07-23,ADF (D),22682674,6449323,18503051,47635048,874842924.281001,284248887.851500,636257600.200900,1795349412.333401,125678,19110,88994,233782
2014-07-23,EDGA (J),68698085,21744766,46190501,136633352,2596667154.705200,1173408705.291522,1819924285.848098,5590000145.844820,563456,134965,357867,1056288
2014-07-23,EDGX (K),183870609,51807440,162354686,398032735,7100759601.484086,2527695388.701095,6200716139.673087,15829171129.858268,1041615,160134,749473,1951222
2014-07-23,CHX (M),9361971,7750636,5294103,22406710,395415852.787500,661159170.407600,379907052.543999,1436482075.739099,866,2424,917,4207
2014-07-23,NYSE (N),580723780,0,0,580723780,22514221343.902390,0.000000,0.000000,22514221343.902390,1785452,0,0,1785452
2014-07-23,NYSE Arca (P),234911360,139855743,185845055,560612158,10598573096.848935,9589082528.076278,8420213117.478924,28607868742.404137,1716367,397361,1158467,3272195
2014-07-23,NASDAQ (Q),356963233,68851533,468056825,893871591,16236510580.297187,4939270343.435713,19863412621.530659,41039193545.263559,2730307,281640,2597934,5609881
2014-07-23,NASDAQ PSX (X),11418773,7304012,10056443,28779228,468800423.890000,502242544.251000,440228957.165400,1411271925.306400,89766,25985,67860,183611
2014-07-23,BATS BYX (Y),103416093,26633285,67414798,197464176,3577361981.363117,1400829453.284297,2186905785.081897,7165097219.729311,816984,124917,468072,1409973
2014-07-23,BATS BZX (Z),179778618,65848713,132664192,378291523,6892142221.662302,4449756555.365884,5012053271.212511,16353952048.240697,1383096,269014,948518,2600628
2014-07-22,NYSE MKT (A),0,10029674,9381146,19410820,0.000000,80436753.200100,384113503.963100,464550257.163200,0,20984,34820,55804
2014-07-22,NASDAQ BX (B),74230875,21431614,41439726,137102215,3120825584.237000,1182789746.870801,1706670000.530209,6010285331.638010,617482,89878,324146,1031506
2014-07-22,NYSE (DN),105487881,19158382,70991930,195638193,4301920654.078285,1067420731.358899,2795070178.518917,8164411563.956101,418798,62949,238989,720736
2014-07-22,NASDAQ (DQ),963585253,247650015,611290107,1822525375,36393204684.501314,13207674286.630434,20103108113.511368,69703987084.643116,3233110,502979,1745133,5481222
2014-07-22,ADF (D),25483576,6880197,17357828,49721601,941787519.121600,323421140.331700,558306045.107900,1823514704.561200,133306,19503,79966,232775
2014-07-22,EDGA (J),69661461,25931840,43246564,138839865,2670930444.603698,1439180784.755490,1577522734.228598,5687633963.587786,567674,146307,322659,1036640
2014-07-22,EDGX (K),180265501,53999402,146021868,380286771,7183533044.789095,2766366686.555901,5336275455.384338,15286175186.729334,1024880,168056,658016,1850952
2014-07-22,CHX (M),9120623,8951221,7008697,25080541,437313597.243000,720114751.065200,514491538.930000,1671919887.238200,1118,2107,687,3912
2014-07-22,NYSE (N),582069889,0,0,582069889,23369774645.112747,0.000000,0.000000,23369774645.112747,1807862,0,0,1807862
2014-07-22,NYSE Arca (P),235068053,152013138,163622195,550703386,10849817111.549903,9981936094.308325,7113904942.867470,27945658148.725698,1736054,419741,1011772,3167567
2014-07-22,NASDAQ (Q),354068669,79156376,424319823,857544868,16286935978.189203,5765487601.811100,17225980644.043809,39278404224.044112,2718876,297176,2324923,5340975
2014-07-22,NASDAQ PSX (X),11368951,7802437,8412453,27583841,493836401.160000,535541970.895000,360025953.599999,1389404325.654999,89317,26257,54995,170569
2014-07-22,BATS BYX (Y),100051840,31171519,61082949,192306308,3611014584.277490,1617080744.576696,1973875986.780496,7201971315.634682,801477,137063,433329,1371869
2014-07-22,BATS BZX (Z),180596965,75356658,121948052,377901675,7185582321.016196,5060948137.674790,4514949071.548397,16761479530.239383,1401322,292964,841317,2535603
2014-07-21,NYSE MKT (A),0,8591466,8308307,16899773,0.000000,58931849.079300,261680447.101000,320612296.180300,0,19813,31649,51462
2014-07-21,NASDAQ BX (B),72478237,21631562,39802610,133912409,2853935893.100101,1145918307.610484,1629834901.709493,5629689102.420078,601535,136797,319757,1058089
2014-07-21,NYSE (DN),96406207,20859750,68223404,185489361,3790380906.039702,1150841519.870499,2747614059.646721,7688836485.556922,401027,69400,245912,716339
2014-07-21,NASDAQ (DQ),833802107,304212940,520739967,1658755014,29345666212.963011,15319996735.301480,17391152082.057391,62056815030.321882,2982158,516759,1646510,5145427
2014-07-21,ADF (D),22192291,8938771,16171973,47303035,757124302.641599,384295862.255200,560242482.845599,1701662647.742398,117662,21842,78559,218063
2014-07-21,EDGA (J),66025736,27566799,39543802,133136337,2287645235.356303,1498831936.765789,1380578716.285299,5167055888.407391,520633,159639,299732,980004
2014-07-21,EDGX (K),157621160,55807620,127086203,340514983,5904947808.160915,2953485363.506898,4696688622.538196,13555121794.206009,908314,171558,617115,1696987
2014-07-21,CHX (M),8543753,10272598,8491640,27307991,355550782.903700,727006107.280000,487482990.240600,1570039880.424300,605,3243,703,4551
2014-07-21,NYSE (N),541416451,0,0,541416451,20738253434.526355,0.000000,0.000000,20738253434.526355,1698919,0,0,1698919
2014-07-21,NYSE Arca (P),219781168,161723531,147500997,529005696,9488614191.440900,10548756105.809685,6411218697.773707,26448588995.024292,1624474,440754,951258,3016486
2014-07-21,NASDAQ (Q),317991732,85077134,398943923,802012789,13874430718.286911,6076360211.433104,16395344845.721714,36346135775.441729,2451002,325533,2266957,5043492
2014-07-21,NASDAQ PSX (X),9942258,8256786,7443660,25642704,378755458.640000,577986964.620000,285960247.915999,1242702671.175999,78846,30140,49604,158590
2014-07-21,BATS BYX (Y),95977559,30134220,61979266,188091045,3273251546.678913,1598013600.328200,1897909693.622803,6769174840.629916,753642,141979,431482,1327103
2014-07-21,BATS BZX (Z),173287609,80686064,115766576,369740249,6589076159.655102,5415651713.175295,4284232516.077153,16288960388.907550,1348060,308704,815674,2472438
2014-07-18,NYSE MKT (A),0,9057602,9456068,18513670,0.000000,69276622.338300,223222379.480000,292499001.818300,0,19773,27815,47588
2014-07-18,NASDAQ BX (B),76907234,25842261,47454366,150203861,2932475928.151998,1481146795.160196,1972441102.576007,6386063825.888201,617234,137420,378378,1133032
2014-07-18,NYSE (DN),106974932,25094450,66688170,198757552,4156101555.188485,1397650123.651199,2747734859.369813,8301486538.209497,424005,76589,248772,749366
2014-07-18,NASDAQ (DQ),950589292,281747157,601833233,1834169682,31486150596.170758,18720700275.350965,20462160647.552937,70669011519.074660,3146593,545026,1768012,5459631
2014-07-18,ADF (D),25152213,8072883,17114194,50339290,848223643.502300,430061247.937000,588730422.377900,1867015313.817200,128248,23268,85833,237349
2014-07-18,EDGA (J),73461208,30607112,43926516,147994836,2472064499.708808,1787605098.517599,1667316426.431506,5926986024.657913,549643,130998,336261,1016902
2014-07-18,EDGX (K),179591936,58942968,123140981,361675885,6168924958.070193,3368680002.291499,4874711700.775529,14412316661.137221,968878,188387,642602,1799867
2014-07-18,CHX (M),8005157,11974812,7860305,27840274,284921027.142700,1110391036.451800,434394415.783600,1829706479.378100,605,3374,830,4809
2014-07-18,NYSE (N),757560300,0,0,757560300,29820742598.420822,0.000000,0.000000,29820742598.420822,1883526,0,0,1883526
2014-07-18,NYSE Arca (P),261734264,196265758,172124388,630124410,10203225409.730996,13819898242.111490,7689912405.213722,31713036057.056208,1741312,522727,1076301,3340340
2014-07-18,NASDAQ (Q),367698291,101774482,529225660,998698433,15286579049.177023,8061265302.930493,22659745608.916185,46007589961.023701,2692918,384441,2647673,5725032
2014-07-18,NASDAQ PSX (X),12358974,10335678,8944465,31639117,407290897.720000,768421922.615000,352639022.459900,1528351842.794900,83862,34372,57761,175995
2014-07-18,BATS BYX (Y),105471027,33619526,63413686,202504239,3537536200.965791,1792214808.601998,2195002881.625384,7524753891.193173,815748,154046,459795,1429589
2014-07-18,BATS BZX (Z),191922573,98316845,134365414,424604832,7019804150.250768,7008293901.307796,5172379213.687978,19200477265.246542,1430754,377994,945094,2753842
2014-07-17,NYSE MKT (A),0,11267439,8568184,19835623,0.000000,72756520.105300,188189619.758000,260946139.863300,0,23858,28353,52211
2014-07-17,NASDAQ BX (B),94172043,40775139,55616171,190563353,3717973423.453816,2256480871.278502,2309947946.124992,8284402240.857310,779198,216229,442645,1438072
2014-07-17,NYSE (DN),120990856,33955824,92308763,247255443,5044496049.050962,1983546908.108401,3715887696.532617,10743930653.691980,479923,107323,300316,887562
2014-07-17,NASDAQ (DQ),1024632123,354907109,677742530,2057281762,36464843964.346712,18600703549.671644,23714484900.326863,78780032414.345219,3468395,712024,2034961,6215380
2014-07-17,ADF (D),29675188,11260795,20031232,60967215,1071229313.204602,510115512.186900,659955579.291901,2241300404.683403,159166,30127,97991,287284
2014-07-17,EDGA (J),83090900,45866810,52229791,181187501,2845215519.498707,2507330382.351509,1847571463.124499,7200117364.974715,631576,226810,388311,1246697
2014-07-17,EDGX (K),216753949,88636764,155435517,460826230,7952006593.291823,4780007953.203194,5936013713.486422,18668028259.981439,1208512,285323,784261,2278096
2014-07-17,CHX (M),10536059,11063882,8424482,30024423,433094509.001000,1025327949.539800,502366375.870400,1960788834.411200,1155,4558,885,6598
2014-07-17,NYSE (N),705186629,0,0,705186629,26611799761.840302,0.000000,0.000000,26611799761.840302,2238234,0,0,2238234
2014-07-17,NYSE Arca (P),304964032,286164677,205188188,796316897,12759312010.620230,19547414083.592576,8864082177.668155,41170808271.880961,2198682,724504,1254160,4177346
2014-07-17,NASDAQ (Q),438157604,153143608,537609519,1128910731,19299838324.451914,11823802231.221302,21863195698.825447,52986836254.498663,3394712,573061,3165938,7133711
2014-07-17,NASDAQ PSX (X),13567573,17602103,11151883,42321559,503887324.544800,1192308713.040001,446039552.925000,2142235590.509801,102679,56810,70927,230416
2014-07-17,BATS BYX (Y),117102736,52204376,74691729,243998841,4113195137.311972,2838409532.638393,2500654369.949026,9452259039.899391,898104,216947,525650,1640701
2014-07-17,BATS BZX (Z),227478322,145932464,159907560,533318346,8809094653.811355,10306996192.289688,6199741216.013165,25315832062.114208,1740244,550323,1103419,3393986
2014-07-16,NYSE MKT (A),0,11382552,9830450,21213002,0.000000,78812048.132500,237148808.884000,315960857.016500,0,21688,33474,55162
2014-07-16,NASDAQ BX (B),89188173,23973411,51646502,164808086,3429895709.064984,1356488621.043399,2094526819.195288,6880911149.303671,715889,102335,397851,1216075
2014-07-16,NYSE (DN),128390730,25188504,93384524,246963758,5207411550.694100,1402734787.963094,3525859258.694074,10136005597.351268,520757,79632,307362,907751
2014-07-16,NASDAQ (DQ),1120022301,325702132,722696888,2168421321,40456174595.216646,22257679580.501040,23946385606.385186,86660239782.102872,3593455,530366,2091839,6215660
2014-07-16,ADF (D),29595590,8960043,21853362,60408995,1045916516.341301,428468779.358300,621171675.496498,2095556971.196099,158122,28928,97089,284139
2014-07-16,EDGA (J),84400489,28869612,52047437,165317538,2928587974.355097,1618038480.593596,1767265553.799412,6313892008.748105,655802,168949,387876,1212627
2014-07-16,EDGX (K),197006858,55389949,153787160,406183967,7134653895.269614,2940279277.792790,5221942037.050265,15296875210.112669,1081420,179051,730922,1991393
2014-07-16,CHX (M),15541172,7480324,7673496,30694992,676851694.112500,776999134.105800,413760312.399200,1867611140.617500,1293,3379,673,5345
2014-07-16,NYSE (N),674959989,0,0,674959989,25936004138.163830,0.000000,0.000000,25936004138.163830,2097076,0,0,2097076
2014-07-16,NYSE Arca (P),304885872,164050047,202625238,671561157,12545738596.231165,11688658102.369275,7792684865.013784,32027081563.614224,2078496,450603,1141121,3670220
2014-07-16,NASDAQ (Q),423126323,94261936,514393805,1031782064,18374433194.196685,7492106237.284827,19735261331.434685,45601800762.916197,3211986,348587,2860870,6421443
2014-07-16,NASDAQ PSX (X),14161691,9297298,11086833,34545822,579533686.874001,639923877.605000,403135307.410000,1622592871.889001,113425,31718,71923,217066
2014-07-16,BATS BYX (Y),108615892,32373420,69488588,210477900,3814957838.340793,1765367743.643799,2171441913.854209,7751767495.838801,833041,146312,476612,1455965
2014-07-16,BATS BZX (Z),216590434,90370910,150796144,457757488,8374436873.365488,6901264129.696567,5435129086.205742,20710830089.267797,1671736,355722,1030208,3057666
2014-07-15,NYSE MKT (A),0,10583738,7833949,18417687,0.000000,67904418.558900,189701628.329000,257606046.887900,0,24812,32174,56986
2014-07-15,NASDAQ BX (B),87792358,29308392,45237053,162337803,3358296294.706893,1522167059.156314,1899947199.956617,6780410553.819824,750868,165412,391820,1308100
2014-07-15,NYSE (DN),126940349,23584550,65095437,215620336,4888477150.392338,1319447808.224399,2618842642.561207,8826767601.177944,475022,79243,239648,793913
2014-07-15,NASDAQ (DQ),1018398559,303118383,604113306,1925630248,37115976645.442301,16262270899.894666,19572295378.020296,72950542923.357263,3434995,578619,1800221,5813835
2014-07-15,ADF (D),31499408,10095860,19443373,61038641,1077040436.908899,439343518.457600,611795486.111100,2128179441.477599,165336,27048,91954,284338
2014-07-15,EDGA (J),81270123,34657521,43166746,159094390,2702576835.480712,1817222634.717102,1419123231.713198,5938922701.911012,619931,190628,342488,1153047
2014-07-15,EDGX (K),197220455,72983391,146936756,417140602,7106900688.710974,3861529830.608306,5108618633.868790,16077049153.188070,1099909,237019,691264,2028192
2014-07-15,CHX (M),8336005,6189798,4043028,18568831,475254414.996500,535749957.416600,252613246.133700,1263617618.546800,1542,4164,763,6469
2014-07-15,NYSE (N),731013520,0,0,731013520,28708814119.080093,0.000000,0.000000,28708814119.080093,2090116,0,0,2090116
2014-07-15,NYSE Arca (P),290532633,202363279,174851390,667747302,12202319446.270977,14059139150.069906,7111565249.246594,33373023845.587477,2099223,565292,1077092,3741607
2014-07-15,NASDAQ (Q),417759276,124254755,468671955,1010685986,17946399507.601919,9925119087.626377,18891866647.684470,46763385242.912766,3169530,467692,2729671,6366893
2014-07-15,NASDAQ PSX (X),14154446,12698758,8639379,35492583,540548122.158700,901426351.535000,361530950.170000,1803505423.863700,109720,43082,62327,215129
2014-07-15,BATS BYX (Y),106598536,37793043,60727543,205119122,3618118443.132697,2053694370.820297,1883726592.592589,7555539406.545583,825530,167849,430845,1424224
2014-07-15,BATS BZX (Z),219029823,118430793,126319784,463780400,8397717359.397505,8352785929.154000,4825979119.488006,21576482408.039511,1683033,436353,943877,3063263
2014-07-14,NYSE MKT (A),0,11200998,5861598,17062596,0.000000,68958581.867300,152198848.035000,221157429.902300,0,22072,26811,48883
2014-07-14,NASDAQ BX (B),76622117,22523500,41276959,140422576,2946711461.062788,1125463283.458502,1689193585.783399,5761368330.304689,649795,123878,345179,1118852
2014-07-14,NYSE (DN),106474129,21611861,61993340,190079330,4209271248.863187,1104574711.126202,2630125173.802209,7943971133.791598,436393,73132,224074,733599
2014-07-14,NASDAQ (DQ),877251978,239293500,562170720,1678716198,30524204425.209921,11941794196.448138,17705459982.307206,60171458603.965265,3193596,527771,1704941,5426308
2014-07-14,ADF (D),25489534,7089873,17508775,50088182,851959571.051701,272519897.008000,496501077.303199,1620980545.362900,137354,18776,77415,233545
2014-07-14,EDGA (J),66580216,25971193,39142517,131693926,2299376095.110000,1316590060.919194,1279811545.924301,4895777701.953495,533614,151108,291522,976244
2014-07-14,EDGX (K),160783031,54125833,146579439,361488303,5803424409.202814,2515192724.046495,4278801705.639806,12597418838.889115,900906,167925,561251,1630082
2014-07-14,CHX (M),12511343,4728801,5732773,22972917,604703522.196200,355158993.390000,391651318.021100,1351513833.607300,1107,2323,714,4144
2014-07-14,NYSE (N),592213457,0,0,592213457,23060306167.465064,0.000000,0.000000,23060306167.465064,1782918,0,0,1782918
2014-07-14,NYSE Arca (P),224532823,157025853,139311973,520870649,9242953280.959035,9547657065.228382,5636119028.315803,24426729374.503220,1643966,390790,862543,2897299
2014-07-14,NASDAQ (Q),329625640,78978053,393314910,801918603,14390549661.985883,5703766886.347418,15444901203.504465,35539217751.837766,2508463,296848,2194952,5000263
2014-07-14,NASDAQ PSX (X),11872187,7711875,6910899,26494961,497391193.466900,509077284.890000,289546152.515000,1296014630.871900,97831,29912,54296,182039
2014-07-14,BATS BYX (Y),92417832,29468452,57607427,179493711,3149758520.448810,1477478827.515800,1722596587.529604,6349833935.494214,733235,130827,390362,1254424
2014-07-14,BATS BZX (Z),170263760,74504466,108837650,353605876,6608625931.977175,4786498577.649098,3755962089.824894,15151086599.451167,1339515,288560,727896,2355971
2014-07-11,NYSE MKT (A),0,10971460,6156757,17128217,0.000000,55365486.891500,158749989.651000,214115476.542500,0,21384,27642,49026
2014-07-11,NASDAQ BX (B),72968022,22099399,36891603,131959024,2627325594.942898,1150523279.725504,1507438840.722787,5285287715.391189,604786,133854,301856,1040496
2014-07-11,NYSE (DN),98054556,19828017,56783089,174665662,3622923674.694114,1086502649.283699,2243929063.257418,6953355387.235231,388957,67113,206689,662759
2014-07-11,NASDAQ (DQ),814430734,219005445,511918334,1545354513,26426786213.996865,11133565187.220711,14854743625.813476,52415095027.031052,2852670,484012,1479421,4816103
2014-07-11,ADF (D),21296538,6861589,18237320,46395447,686683922.258500,270609647.643500,475348564.226900,1432642134.128900,113929,17576,68163,199668
2014-07-11,EDGA (J),66561506,25402669,37811591,129775766,2216206515.531398,1355648884.245492,1322700658.765398,4894556058.542288,528081,135986,283063,947130
2014-07-11,EDGX (K),167333849,54061458,154989700,376385007,5654122952.944489,2715377632.583800,4193618012.191491,12563118597.719780,923398,167698,557980,1649076
2014-07-11,CHX (M),10861169,5822366,5536436,22219971,445529106.109000,699540902.396300,404474829.776100,1549544838.281400,975,2247,552,3774
2014-07-11,NYSE (N),582568207,0,0,582568207,20626004234.433421,0.000000,0.000000,20626004234.433421,1802183,0,0,1802183
2014-07-11,NYSE Arca (P),238432067,147360331,139014306,524806704,9253529829.549864,9619334973.825079,5780598804.794399,24653463608.169342,1720370,403863,877909,3002142
2014-07-11,NASDAQ (Q),339787072,78924168,384607623,803318863,13728719194.879695,5685934470.382206,14980055164.506365,34394708829.768266,2598062,324606,2208308,5130976
2014-07-11,NASDAQ PSX (X),11731979,7503320,7247988,26483287,475337635.403999,497111204.170000,308145243.065000,1280594082.638999,96916,26317,51954,175187
2014-07-11,BATS BYX (Y),84624825,26992271,49826233,161443329,2771126921.402817,1371221524.223899,1562418571.816809,5704767017.443525,669930,122563,346661,1139154
2014-07-11,BATS BZX (Z),176757608,79748542,103838974,360345124,6391950222.249011,5340113462.208794,3820970568.456578,15553034252.914383,1366241,313393,728169,2407803
2014-07-10,NYSE MKT (A),0,14740932,7051897,21792829,0.000000,71950199.477300,168188786.733001,240138986.210301,0,26980,31035,58015
2014-07-10,NASDAQ BX (B),81744702,34223984,44656856,160625542,3075115600.458917,1774187170.738899,1751652954.468710,6600955725.666526,695171,192881,385153,1273205
2014-07-10,NYSE (DN),110982709,28804080,69133961,208920750,4256369426.583278,1531698633.625295,2633300982.163292,8421369042.371865,468218,93810,254744,816772
2014-07-10,NASDAQ (DQ),950285555,369917504,564714873,1884917932,32468527410.786678,17807891863.150233,18345391277.786312,68621810551.723223,3341029,663358,1800172,5804559
2014-07-10,ADF (D),25377856,10655455,17832220,53865531,843054887.274400,457026636.992500,500694105.263701,1800775629.530601,134943,27844,82929,245716
2014-07-10,EDGA (J),74072492,37936261,41991011,153999764,2419627758.513390,1965658693.729690,1386473430.326694,5771759882.569774,590207,187342,335299,1112848
2014-07-10,EDGX (K),193191284,79811396,139139223,412141903,6525947451.931418,3697253953.242205,4609774352.017588,14832975757.191211,1067842,245536,653959,1967337
2014-07-10,CHX (M),79456559,6905532,6621786,92983877,4353741120.507000,749334898.872600,428139109.532200,5531215128.911800,1197,3854,933,5984
2014-07-10,NYSE (N),654265375,0,0,654265375,24003574315.236743,0.000000,0.000000,24003574315.236743,2101709,0,0,2101709
2014-07-10,NYSE Arca (P),288623300,217283710,165867774,671774784,11529488307.439023,14060395906.500888,6814716749.603044,32404600963.542955,2157906,557929,1061035,3776870
2014-07-10,NASDAQ (Q),381252449,117169570,435088938,933510957,15639070090.407217,8888593822.807913,16450153461.678145,40977817374.893275,2929845,447607,2668013,6045465
2014-07-10,NASDAQ PSX (X),13823216,11537764,9244782,34605762,553675745.745000,770003078.355000,387543979.798601,1711222803.898601,113066,38061,64392,215519
2014-07-10,BATS BYX (Y),98963328,39817534,59595298,198376160,3267117710.595674,2071510050.606398,1789400390.964000,7128028152.166072,794315,173357,415841,1383513
2014-07-10,BATS BZX (Z),213951136,111728412,124541149,450220697,7847780027.957843,7472178225.512797,4518388886.832870,19838347140.303510,1658680,416998,911332,2987010
2014-07-09,NYSE MKT (A),0,11580837,6878066,18458903,0.000000,75289090.883700,170981498.135100,246270589.018800,0,26684,30755,57439
2014-07-09,NASDAQ BX (B),77766789,26844286,42320402,146931477,2914454082.851823,1421039594.710780,1646355218.217908,5981848895.780511,648223,168221,351496,1167940
2014-07-09,NYSE (DN),102057771,24058180,67839963,193955914,4031728323.838732,1328180753.317500,2567673085.011714,7927582162.167946,429771,81173,240456,751400
2014-07-09,NASDAQ (DQ),888845033,250184141,602286712,1741315886,31737296907.858255,11659474894.193304,17720925995.196293,61117697797.247852,3101670,573864,1698848,5374382
2014-07-09,ADF (D),24588034,9901453,17632117,52121604,855509145.427498,417158513.013000,482256748.400401,1754924406.840899,134643,30980,77823,243446
2014-07-09,EDGA (J),71231086,28097454,42704791,142033331,2424639247.612109,1506832589.161982,1359956381.105690,5291428217.879781,567204,171684,315835,1054723
2014-07-09,EDGX (K),173927939,60393307,151701243,386022489,5942483265.107422,3062578555.400593,4330399938.406309,13335461758.914324,972651,200650,612688,1785989
2014-07-09,CHX (M),53504909,5308899,4991586,63805394,2995338795.233100,596407257.910000,339784484.182200,3931530537.325300,1412,3428,820,5660
2014-07-09,NYSE (N),569640320,0,0,569640320,21696621170.279047,0.000000,0.000000,21696621170.279047,1818347,0,0,1818347
2014-07-09,NYSE Arca (P),252570050,163842511,170239291,586651852,10438110439.014428,11174488542.229373,6339669068.746648,27952268049.990449,1929511,464441,1017296,3411248
2014-07-09,NASDAQ (Q),352979226,92517906,436364517,881861649,14965610936.121093,6819736671.067682,16667274120.830298,38452621728.019073,2731053,353969,2453901,5538923
2014-07-09,NASDAQ PSX (X),12866762,9047813,8570156,30484731,540203741.332000,602406087.675000,336959449.669200,1479569278.676200,105123,31944,60228,197295
2014-07-09,BATS BYX (Y),90505242,32443682,67908075,190856999,3035015368.172600,1823275477.502998,1755576995.335706,6613867841.011304,715670,159133,417900,1292703
2014-07-09,BATS BZX (Z),189970651,92048710,121954227,403973588,7020960919.745751,6235988945.006495,4406148921.670476,17663098786.422722,1452877,347691,835759,2636327
2014-07-08,NYSE MKT (A),0,14021587,7930873,21952460,0.000000,89230814.980600,169380549.193000,258611364.173600,0,30098,29600,59698
2014-07-08,NASDAQ BX (B),91075450,29307477,56328206,176711133,3455996106.998110,1621225289.727913,2228443945.321306,7305665342.047329,782041,168386,462415,1412842
2014-07-08,NYSE (DN),118158204,28077372,91836151,238071727,4572318761.374054,1746296057.647298,3685951218.543571,10004566037.564923,484569,93251,315993,893813
2014-07-08,NASDAQ (DQ),1060332045,310841220,767214341,2138387606,36709847097.537554,17487929971.752866,25057455156.234452,79255232225.524872,3631108,663039,2280960,6575107
2014-07-08,ADF (D),28010031,9479554,22422438,59912023,886180581.738201,407917677.440100,611572546.147298,1905670805.325599,142646,27014,99399,269059
2014-07-08,EDGA (J),77913709,31238076,53238295,162390080,2583722789.517510,1813222102.951602,1708816010.413887,6105760902.882999,614538,189226,390835,1194599
2014-07-08,EDGX (K),200810992,72884088,184331804,458026884,6900921333.372829,3606124467.177704,5967277608.858100,16474323409.408633,1131964,232348,835819,2200131
2014-07-08,CHX (M),38604225,11745598,7027289,57377112,1904158483.996800,1315010359.140001,451777773.528300,3670946616.665101,1070,4552,1044,6666
2014-07-08,NYSE (N),682966474,0,0,682966474,25290183772.236465,0.000000,0.000000,25290183772.236465,2086831,0,0,2086831
2014-07-08,NYSE Arca (P),282859367,192785252,216212425,691857044,11411158930.350655,13375938628.624893,8573368466.351074,33360466025.326622,2126790,552554,1303637,3982981
2014-07-08,NASDAQ (Q),398985959,108942776,569442228,1077370963,16683867871.168903,8250267282.868727,21832428491.633415,46766563645.671045,3139680,432025,3230560,6802265
2014-07-08,NASDAQ PSX (X),15101761,12231431,10896524,38229716,596225507.435000,763321834.121200,444254487.112500,1803801828.668700,123694,33570,78141,235405
2014-07-08,BATS BYX (Y),101796421,37639922,83640029,223076372,3376744710.131398,2087559243.990700,2334267094.521597,7798571048.643695,798311,163830,527280,1489421
2014-07-08,BATS BZX (Z),208605355,106010868,154520732,469136955,7618660964.761205,7395417105.449718,5661629064.209074,20675707134.419997,1630755,402505,1083862,3117122
2014-07-07,NYSE MKT (A),0,12700496,5979062,18679558,0.000000,90708380.660100,132157706.578000,222866087.238100,0,25988,25682,51670
2014-07-07,NASDAQ BX (B),75207146,24960288,41220464,141387898,2843736454.646492,1272716946.265984,1589124338.868705,5705577739.781181,682140,143148,363959,1189247
2014-07-07,NYSE (DN),96960431,22585212,64987710,184533353,3649555049.347418,1164970426.729703,2434158057.989463,7248683534.066584,442490,89033,261020,792543
2014-07-07,NASDAQ (DQ),836451111,255435432,578481299,1670367842,29185790564.862518,11759006350.665344,17105922991.481431,58050719907.009293,3387456,568604,1927133,5883193
2014-07-07,ADF (D),23202989,8902849,19876688,51982526,732709714.712400,398978969.917100,483169174.765601,1614857859.395101,120295,21722,81436,223453
2014-07-07,EDGA (J),63224797,26006928,40836250,130067975,2116313326.385901,1334475737.106393,1198534073.769194,4649323137.261488,534987,154469,306546,996002
2014-07-07,EDGX (K),161784558,59464870,160595680,381845108,5637269599.319106,2739747199.722399,4490584727.758472,12867601526.799977,944304,184702,643483,1772489
2014-07-07,CHX (M),29080521,4259703,6024232,39364456,1368659403.585400,400634502.320000,311368225.998200,2080662131.903600,1157,3016,870,5043
2014-07-07,NYSE (N),601582221,0,0,601582221,22685935918.775332,0.000000,0.000000,22685935918.775332,1901115,0,0,1901115
2014-07-07,NYSE Arca (P),216266969,156965182,152810971,526043122,9024001416.868419,10801232463.359425,5762740687.465677,25587974567.693521,1886020,408166,980535,3274721
2014-07-07,NASDAQ (Q),314141475,79701661,444930265,838773401,13503122265.195600,5886334182.405391,16445553631.634355,35835010079.235346,2578831,305534,2546971,5431336
2014-07-07,NASDAQ PSX (X),14341432,8403683,8293788,31038903,619679728.081800,522863594.415000,324557535.308601,1467100857.805401,122087,28940,62463,213490
2014-07-07,BATS BYX (Y),87677685,29497499,60967523,178142707,3055393050.754699,1545140543.446803,1690666035.160677,6291199629.362179,737978,131740,416379,1286097
2014-07-07,BATS BZX (Z),162294581,80432144,108853633,351580358,6204074406.728188,5269887379.642488,4010469194.309336,15484430980.680012,1356662,300796,819495,2476953
2014-07-03,NYSE MKT (A),0,8211370,2417751,10629121,0.000000,55644393.799400,60014872.604000,115659266.403400,0,15620,10931,26551
2014-07-03,NASDAQ BX (B),42989948,15340895,21538998,79869841,1593733769.015102,822357823.184603,900763824.073701,3316855416.273406,349500,69331,178830,597661
2014-07-03,NYSE (DN),63908477,15884439,37105195,116898111,2307924476.253122,788190641.328198,1505025930.933187,4601141048.514507,271191,52875,140122,464188
2014-07-03,NASDAQ (DQ),585419551,173529680,329353712,1088302943,19263633174.992887,8523798767.071443,10987572023.638364,38775003965.702694,2010963,368351,1073498,3452812
2014-07-03,ADF (D),15609668,5336962,9603129,30549759,471265678.664900,228662257.299500,301157065.887100,1001085001.851500,66790,14127,43715,124632
2014-07-03,EDGA (J),40537576,19364837,21090031,80992444,1265791473.597595,1048595665.904817,747506692.868599,3061893832.371011,308444,86452,162303,557199
2014-07-03,EDGX (K),124916515,39318374,87639427,251874316,3925649866.909809,2015979394.284802,2901579483.929310,8843208745.123921,602879,116934,368447,1088260
2014-07-03,CHX (M),58922860,4070466,2175677,65169003,2179772884.509800,554901037.809000,153731444.480000,2888405366.798800,804,2124,423,3351
2014-07-03,NYSE (N),536974892,0,0,536974892,21435355570.899875,0.000000,0.000000,21435355570.899875,1239779,0,0,1239779
2014-07-03,NYSE Arca (P),157761180,115279470,89751066,362791716,6252249514.278294,7838057699.881887,3816298548.072379,17906605762.232560,1172319,300061,576221,2048601
2014-07-03,NASDAQ (Q),203074842,59303555,308141113,570519510,8264736667.414581,4345588177.099902,12599827239.846704,25210152084.361187,1558195,214138,1504663,3276996
2014-07-03,NASDAQ PSX (X),6989106,5732562,4030562,16752230,286317571.647600,376165388.420000,177267122.836500,839750082.904100,53861,19029,27674,100564
2014-07-03,BATS BYX (Y),52614596,19083045,27508033,99205674,1748807452.714904,1000095317.930799,923005419.667606,3671908190.313309,404121,82097,198352,684570
2014-07-03,BATS BZX (Z),108445202,56554266,62621712,227621180,3965720385.302811,3690136734.693998,2513087464.914720,10168944584.911529,848406,206223,455105,1509734
2014-07-02,NYSE MKT (A),0,12591893,5026177,17618070,0.000000,86929018.958500,119224222.975100,206153241.933600,0,27448,24441,51889
2014-07-02,NASDAQ BX (B),72592860,23760472,37688080,134041412,2688590669.835700,1199548936.020500,1460227735.252802,5348367341.109002,610429,101234,322000,1033663
2014-07-02,NYSE (DN),104505344,22276523,67412338,194194205,3958824703.819704,1052377931.468500,2521237459.463770,7532440094.751974,459507,81734,255635,796876
2014-07-02,NASDAQ (DQ),934533904,252817243,568629867,1755981014,33320799456.054618,11351175588.790841,17792443028.669960,62464418073.515419,3417396,562284,1820952,5800632
2014-07-02,ADF (D),25584269,7848596,18236779,51669644,839898125.505900,347466095.943000,517216379.612500,1704580601.061400,129015,24345,79699,233059
2014-07-02,EDGA (J),65483463,27445739,38305052,131234254,2230701276.899002,1370958748.755478,1205512171.846398,4807172197.500878,536558,148079,293930,978567
2014-07-02,EDGX (K),184527573,59122256,136661212,380311041,6516344005.507113,2703664170.403106,4493737763.672223,13713745939.582442,1024585,182793,627410,1834788
2014-07-02,CHX (M),24734531,6298968,4564514,35598013,1181786237.977400,660936969.781400,225266523.266800,2067989731.025600,1152,1731,508,3391
2014-07-02,NYSE (N),596689660,0,0,596689660,22666602490.597662,0.000000,0.000000,22666602490.597662,1853084,0,0,1853084
2014-07-02,NYSE Arca (P),243508644,163734287,148018125,555261056,10040889807.402833,10060214165.212448,5757272653.994980,25858376626.610261,1820344,418021,965992,3204357
2014-07-02,NASDAQ (Q),325012292,79742134,406350715,811105141,13970968553.333554,5259159898.006314,15408406833.464630,34638535284.804498,2606243,301953,2381098,5289294
2014-07-02,NASDAQ PSX (X),12304940,6630175,7947854,26882969,463591020.910200,411793832.703400,293320954.771400,1168705808.385000,94761,21478,54827,171066
2014-07-02,BATS BYX (Y),87195669,29133382,53679683,170008734,2920883814.413196,1489690173.994399,1611724268.676301,6022298257.083896,706381,131349,380541,1218271
2014-07-02,BATS BZX (Z),175159612,80541036,108803250,364503898,6590555308.346277,5145731788.402305,3945082988.927240,15681370085.675822,1386965,301240,776455,2464660
2014-07-01,NYSE MKT (A),0,13011201,6170407,19181608,0.000000,99344285.207000,137599648.704100,236943933.911100,0,27035,24285,51320
2014-07-01,NASDAQ BX (B),85031952,26030068,49205046,160267066,3312940770.630398,1558828727.017069,1919931982.937595,6791701480.585062,735299,144069,426879,1306247
2014-07-01,NYSE (DN),115756387,27407257,81032163,224195807,4517797502.908628,1520541087.772002,3009353529.890407,9047692120.571037,507243,83914,310386,901543
2014-07-01,NASDAQ (DQ),1014485001,394126849,678415245,2087027095,39460353858.135904,25336404388.667557,21625384274.985233,86422142521.788694,3726502,675461,2165901,6567864
2014-07-01,ADF (D),25414156,9018864,21207248,55640268,924060108.095899,433266248.790400,680638180.317398,2037964537.203697,137824,27911,96055,261790
2014-07-01,EDGA (J),74869380,30451053,46256652,151577085,2692433774.434900,1861055511.942870,1620727214.878524,6174216501.256294,631975,173004,369661,1174640
2014-07-01,EDGX (K),190822682,65703913,156746166,413272761,7263514088.286202,3710173221.755104,5613795447.755201,16587482757.796507,1135773,218151,763249,2117173
2014-07-01,CHX (M),29485585,6861970,5681089,42028644,1374896382.270000,694000377.284000,258221115.465600,2327117875.019600,1004,3540,702,5246
2014-07-01,NYSE (N),686375267,0,0,686375267,27081181897.632282,0.000000,0.000000,27081181897.632282,2115955,0,0,2115955
2014-07-01,NYSE Arca (P),275608553,201294853,177058938,653962344,12021349890.272503,14373759336.574467,7101920611.606606,33497029838.453576,2232947,550844,1167786,3951577
2014-07-01,NASDAQ (Q),379781263,102052750,516856444,998690457,16761993351.447904,8110635648.016489,19267286753.630917,44139915753.095310,3163744,386630,3018934,6569308
2014-07-01,NASDAQ PSX (X),11047408,8215610,7338724,26601742,430893262.473000,643377243.142500,282839610.451593,1357110116.067093,92424,26985,54091,173500
2014-07-01,BATS BYX (Y),105642959,34311746,69029227,208983932,3702819520.506393,2101061966.879101,2048977153.257299,7852858640.642793,863596,155057,482274,1500927
2014-07-01,BATS BZX (Z),195789527,99140366,130342158,425272051,7713142352.463344,7587931767.382698,4793611985.121409,20094686104.967451,1605253,375963,967334,2948550
2014-06-30,NYSE MKT (A),0,20254921,6445312,26700233,0.000000,167609695.643600,148254623.917000,315864319.560600,0,32417,26522,58939
2014-06-30,NASDAQ BX (B),74171465,25911312,43325013,143407790,2897783150.202617,1410742461.451501,1627369568.637508,5935895180.291626,651108,132669,386625,1170402
2014-06-30,NYSE (DN),99050292,23473957,71791845,194316094,3836969675.038492,1214252153.409692,2491259965.475802,7542481793.923986,452353,82873,282204,817430
2014-06-30,NASDAQ (DQ),939863737,334332570,628279528,1902475835,36045585800.129598,17163878376.868446,18840577014.014035,72050041191.012079,3429610,581785,2051191,6062586
2014-06-30,ADF (D),22450166,9365033,19866962,51682161,797257752.199102,386528944.439800,530917004.272297,1714703700.911199,125567,24813,87810,238190
2014-06-30,EDGA (J),66333075,26337697,43285796,135956568,2374445791.326512,1516336858.078406,1335868382.927100,5226651032.332018,575105,153832,340597,1069534
2014-06-30,EDGX (K),160936891,61863555,165653212,388453658,6086475476.854284,3146177323.015391,5064816064.489025,14297468864.358700,984718,201605,734804,1921127
2014-06-30,CHX (M),23558546,7396034,5011314,35965894,1039538576.657800,672215887.065000,220887883.514400,1932642347.237200,1010,2587,698,4295
2014-06-30,NYSE (N),791831319,0,0,791831319,33554520762.758652,0.000000,0.000000,33554520762.758652,2095265,0,0,2095265
2014-06-30,NYSE Arca (P),243434664,180624046,170287656,594346366,10542498349.443014,12010411187.917094,5916790609.536025,28469700146.896133,1974674,486607,1077300,3538581
2014-06-30,NASDAQ (Q),343446768,86687473,515402447,945536688,15165741621.740713,5887843716.583216,18666700526.148537,39720285864.472466,2849600,340625,2745932,5936157
2014-06-30,NASDAQ PSX (X),8493296,5843901,5570073,19907270,334961252.730800,368635199.706800,215426317.505000,919022769.942600,69560,18473,41929,129962
2014-06-30,BATS BYX (Y),93657065,31287175,58101565,183045805,3262536664.008193,1725809760.647802,1688016577.997885,6676363002.653880,792942,144798,442427,1380167
2014-06-30,BATS BZX (Z),178141654,87311724,118961270,384414648,6893133440.258063,6011695817.131998,4101570932.752948,17006400190.143009,1509448,334129,929040,2772617
2014-06-27,NYSE MKT (A),0,94028317,5883913,99912230,0.000000,573610743.201100,120893577.205000,694504320.406100,0,40380,25259,65639
2014-06-27,NASDAQ BX (B),80209590,20316458,51486055,152012103,2910432281.689201,1177582289.771000,1746804577.264797,5834819148.724998,653994,129302,407287,1190583
2014-06-27,NYSE (DN),100325310,22987287,73110054,196422651,3759107366.059219,1108444603.156601,2373441906.853421,7240993876.069241,456003,83324,311678,851005
2014-06-27,NASDAQ (DQ),1498637728,262660114,1950961564,3712259406,54157015640.414808,11406377025.781950,48380628911.921948,113944021578.118706,3277927,489065,1980587,5747579
2014-06-27,ADF (D),25616722,8950879,22745712,57313313,906604598.137399,348664900.037400,568597708.627000,1823867206.801799,135872,22332,93628,251832
2014-06-27,EDGA (J),71209184,22089030,48861432,142159646,2373193216.597705,1210719757.863096,1309994840.231991,4893907814.692792,581477,142473,363393,1087343
2014-06-27,EDGX (K),163209314,60517763,168893714,392620791,5660477759.296615,2847753125.646792,4960855788.480414,13469086673.423821,879691,180748,679765,1740204
2014-06-27,CHX (M),18808847,5706881,2909969,27425697,711556587.167200,517903610.040000,181398610.048400,1410858807.255600,1123,2107,758,3988
2014-06-27,NYSE (N),1490460416,0,0,1490460416,52528839491.272498,0.000000,0.000000,52528839491.272498,2129748,0,0,2129748
2014-06-27,NYSE Arca (P),244201211,135699644,171106187,551007042,9944313533.828208,9664262882.692724,5990745555.082618,25599321971.603550,1923482,403387,1006435,3333304
2014-06-27,NASDAQ (Q),331956483,86075367,1269760057,1687791907,13865770027.372348,6019314165.569555,32909747939.394518,52794832132.336421,2571603,331184,2753062,5655849
2014-06-27,NASDAQ PSX (X),9831430,5851000,7315425,22997855,387433310.133800,376092570.830000,278428579.638900,1041954460.602700,74232,17365,48565,140162
2014-06-27,BATS BYX (Y),102970196,31041920,70353349,204365465,3346458708.929292,1726876280.078001,1872588306.768678,6945923295.775971,805336,146232,496374,1447942
2014-06-27,BATS BZX (Z),184807325,76066304,127753905,388627534,6662657903.558224,5019947458.907896,4134272043.511041,15816877405.977161,1424193,283987,889586,2597766
2014-06-26,NYSE MKT (A),0,11408719,6110819,17519538,0.000000,70089920.888200,144218606.239400,214308527.127600,0,24883,25011,49894
2014-06-26,NASDAQ BX (B),70113949,24341384,39812593,134267926,2632745617.024203,1296181715.439356,1597456889.627409,5526384222.090968,587272,147381,349914,1084567
2014-06-26,NYSE (DN),95875378,23186843,64478414,183540635,3604346620.824488,1262085416.452306,2440932511.995177,7307364549.271971,415011,72647,253740,741398
2014-06-26,NASDAQ (DQ),867397580,278286004,518373514,1664057098,30404341130.337398,13024716592.946306,16630074422.235676,60059132145.519380,3141329,494521,1803681,5439531
2014-06-26,ADF (D),26032565,9666687,16523851,52223103,958173069.675498,382252777.076000,486299789.910301,1826725636.661799,145126,27173,76460,248759
2014-06-26,EDGA (J),68740551,26567824,40149501,135457876,2388021270.442509,1390879782.440270,1288528110.735588,5067429163.618367,573334,161666,324582,1059582
2014-06-26,EDGX (K),174006298,61567805,141451939,377026042,6341601154.503854,3003925984.959170,5029491683.934692,14375018823.397716,986341,188514,657184,1832039
2014-06-26,CHX (M),23335840,6664661,3565163,33565664,944458092.418800,491908446.885000,282962755.676900,1719329294.980700,1223,2695,471,4389
2014-06-26,NYSE (N),591694743,0,0,591694743,22717497304.556749,0.000000,0.000000,22717497304.556749,1911585,0,0,1911585
2014-06-26,NYSE Arca (P),241924583,145511939,150266321,537702843,9959549459.764373,9996606486.967888,5914966135.322081,25871122082.054342,1852950,462348,965685,3280983
2014-06-26,NASDAQ (Q),338935329,94077245,394085187,827097761,14620450993.213227,6727697866.970188,14970959576.055384,36319108436.238799,2717303,339800,2435501,5492604
2014-06-26,NASDAQ PSX (X),9404886,6695856,5836975,21937717,374253392.745000,444347786.175000,258354114.585000,1076955293.505000,70711,20005,41144,131860
2014-06-26,BATS BYX (Y),93267071,34085487,56059918,183412476,3120503941.582409,1816957487.206998,1673841412.994496,6611302841.783903,757790,156768,412273,1326831
2014-06-26,BATS BZX (Z),196348393,90691207,119838082,406877682,7391400484.337779,5857789161.028901,4353068978.637023,17602258624.003703,1547503,341211,877552,2766266
2014-06-25,NYSE MKT (A),0,14158621,6449154,20607775,0.000000,79649231.749700,131434989.031000,211084220.780700,0,31881,24656,56537
2014-06-25,NASDAQ BX (B),75783244,23851673,41500144,141135061,3023439383.269896,1309447407.180986,1591939743.443994,5924826533.894876,669168,142617,368474,1180259
2014-06-25,NYSE (DN),105953602,24971178,66274950,197199730,4160356486.674795,1313872284.147405,2610426332.966128,8084655103.788328,454390,78268,256624,789282
2014-06-25,NASDAQ (DQ),993184522,268615791,603488762,1865289075,36819620898.392765,13491414563.131416,19393734615.561518,69704770077.085699,3574053,550660,1911597,6036310
2014-06-25,ADF (D),25706464,10472561,16538283,52717308,985390908.407502,413457689.907100,532628137.359700,1931476735.674302,155022,29833,83854,268709
2014-06-25,EDGA (J),77079045,28614799,43994777,149688621,2723961114.761301,1627721134.954474,1395944352.588712,5747626602.304487,643077,176559,346367,1166003
2014-06-25,EDGX (K),180239630,64576155,129709225,374525010,6769365340.559722,3184355554.249408,4673172970.344497,14626893865.153627,1048148,204221,657957,1910326
2014-06-25,CHX (M),28814975,11694553,6607852,47117380,1469393481.601000,823825110.486000,384887110.492100,2678105702.579100,1903,3051,551,5505
2014-06-25,NYSE (N),653374594,0,0,653374594,25009819875.589169,0.000000,0.000000,25009819875.589169,2020383,0,0,2020383
2014-06-25,NYSE Arca (P),273352239,176544090,161385165,611281494,11800687668.394224,12248911159.791946,6344730707.885496,30394329536.071666,2125471,514659,1053471,3693601
2014-06-25,NASDAQ (Q),389113080,98252046,448332931,935698057,17097382157.890343,7131755593.040136,17091240059.287449,41320377810.217928,3084764,358399,2691852,6135015
2014-06-25,NASDAQ PSX (X),10783285,6899354,6528274,24210913,399798801.092800,436630745.011800,258945016.626700,1095374562.731300,80565,20780,46876,148221
2014-06-25,BATS BYX (Y),93341027,33897020,57763066,185001113,3297032204.037504,1971097697.853203,1773499306.149911,7041629208.040618,772004,154454,422343,1348801
2014-06-25,BATS BZX (Z),211171101,100074474,136666213,447911788,8112639284.215978,6837331127.074611,4919593907.886811,19869564319.177400,1637874,366674,963199,2967747
2014-06-24,NYSE MKT (A),0,17048552,7382894,24431446,0.000000,94340533.037900,160658198.847000,254998731.884900,0,34187,29213,63400
2014-06-24,NASDAQ BX (B),76665111,29759153,47144694,153568958,2933611855.535299,1565233184.847192,1905607070.978415,6404452111.360906,639376,167904,392387,1199667
2014-06-24,NYSE (DN),100016975,29840562,77789675,207647212,3779885420.826289,1645832032.609804,3129559382.956589,8555276836.392682,422514,90380,278925,791819
2014-06-24,NASDAQ (DQ),981720405,308450504,690518301,1980689210,34881547569.230623,14825690933.510543,22476967434.608210,72184205937.349376,3582840,640569,2153563,6376972
2014-06-24,ADF (D),28180534,10763372,22200086,61143992,984506108.894500,417855588.766700,656024476.957199,2058386174.618399,154480,28333,106961,289774
2014-06-24,EDGA (J),74710762,30570813,50181524,155463099,2554076692.639197,1722653761.032692,1586829471.824209,5863559925.496098,616415,175588,374181,1166184
2014-06-24,EDGX (K),199107072,76559959,165472935,441139966,7027252294.953670,3457669140.143091,5687684332.721776,16172605767.818537,1102457,228718,755018,2086193
2014-06-24,CHX (M),15300904,14773883,4767592,34842379,543930454.325500,910882117.925000,246333106.929400,1701145679.179900,898,2213,506,3617
2014-06-24,NYSE (N),647846867,0,0,647846867,24906117362.684432,0.000000,0.000000,24906117362.684432,1998781,0,0,1998781
2014-06-24,NYSE Arca (P),257582559,202882504,186058020,646523083,10612211332.928330,14201711737.020539,7456949412.305134,32270872482.254003,1935617,584602,1169810,3690029
2014-06-24,NASDAQ (Q),386065538,118475378,507670215,1012211131,16871423482.780932,8991520595.767891,19676191627.844017,45539135706.392840,3103078,434531,2938332,6475941
2014-06-24,NASDAQ PSX (X),9072433,8129675,6821775,24023883,361762792.233000,540323777.780000,299687814.220400,1201774384.233400,68337,25195,45839,139371
2014-06-24,BATS BYX (Y),100795961,37909257,62934506,201639724,3438207791.493005,2173010466.875401,2000385195.225294,7611603453.593700,834296,175024,469805,1479125
2014-06-24,BATS BZX (Z),212178411,106035889,146617935,464832235,7772310055.182103,7138999686.270604,5385916135.808265,20297225877.260972,1622359,394942,1018189,3035490
2014-06-23,NYSE MKT (A),0,14126874,5969379,20096253,0.000000,74282525.944400,128595133.517300,202877659.461700,0,28877,25313,54190
2014-06-23,NASDAQ BX (B),67156375,19992649,39536644,126685668,2570497590.904404,1017348026.637583,1471016321.134402,5058861938.676389,588510,127132,333615,1049257
2014-06-23,NYSE (DN),98423558,21396281,70872808,190692647,3816183662.568793,1012300326.949701,2477387493.216784,7305871482.735278,442729,72357,261328,776414
2014-06-23,NASDAQ (DQ),896019622,244498256,608700406,1749218284,31777655090.201828,12896924838.266576,18477311651.460550,63151891579.928954,3418653,537609,1971427,5927689
2014-06-23,ADF (D),23612731,7778091,18032049,49422871,798583909.420502,291442167.384000,501121693.842501,1591147770.647003,126680,21173,85981,233834
2014-06-23,EDGA (J),69151435,22687873,42473012,134312320,2434634333.180294,1110330504.745996,1238816762.389497,4783781600.315787,582303,139125,319422,1040850
2014-06-23,EDGX (K),158930990,52400104,135525939,346857033,5636174463.432581,2365667234.358398,4357433787.100707,12359275484.891686,897309,165804,617698,1680811
2014-06-23,CHX (M),9417853,10277727,5500645,25196225,439853941.046500,549697848.400000,295598059.015000,1285149848.461500,550,2376,479,3405
2014-06-23,NYSE (N),572457356,0,0,572457356,22891222012.375592,0.000000,0.000000,22891222012.375592,1815412,0,0,1815412
2014-06-23,NYSE Arca (P),220753976,143234895,159423737,523412608,9331524451.616465,9150723673.727979,6071514767.811502,24553762893.155946,1748584,412385,969946,3130915
2014-06-23,NASDAQ (Q),331295699,79128454,442724620,853148773,14383564090.193481,5869033501.773004,16569444969.387934,36822042561.354419,2689044,294161,2510466,5493671
2014-06-23,NASDAQ PSX (X),8493159,5146849,6335875,19975883,343129805.410000,326154631.680000,269134107.045000,938418544.135000,66217,16919,42075,125211
2014-06-23,BATS BYX (Y),89928404,27716938,57715238,175360580,3069090066.164984,1422341374.155700,1663465997.668808,6154897437.989492,744169,134433,429005,1307607
2014-06-23,BATS BZX (Z),174483769,67248145,122802646,364534560,6627312813.999923,4272714990.594400,4396464045.735174,15296491850.329497,1425293,272182,875411,2572886
2014-06-20,NYSE MKT (A),0,76992819,7184375,84177194,0.000000,392388015.026299,156171150.201000,548559165.227299,0,36098,27746,63844
2014-06-20,NASDAQ BX (B),79273649,24324872,47835817,151434338,2968450948.075792,1309680845.767495,1826595641.615306,6104727435.458593,661789,138410,389052,1189251
2014-06-20,NYSE (DN),111587205,25067737,76346469,213001411,4557283711.106267,1220210065.908297,2658226301.174391,8435720078.188955,505149,79132,286270,870551
2014-06-20,NASDAQ (DQ),1189839580,329018330,885782231,2404640141,43470906360.436926,16194871034.985247,27997136246.518106,87662913641.940279,3607186,581422,2013409,6202017
2014-06-20,ADF (D),26349757,8732920,19050187,54132864,907016556.895199,351756730.828500,487773699.484600,1746546987.208299,140113,21498,85679,247290
2014-06-20,EDGA (J),81522424,27666070,50048346,159236840,2822725933.085106,1401018479.293113,1547893428.365300,5771637840.743519,649271,142976,361407,1153654
2014-06-20,EDGX (K),178115878,59945080,140235519,378296477,6359992415.107628,2857806655.297692,4613072054.357204,13830871124.762524,974982,184277,632613,1791872
2014-06-20,CHX (M),29672593,19844669,6649749,56167011,995685726.121200,1641869532.754100,227585653.609500,2865140912.484800,673,2649,618,3940
2014-06-20,NYSE (N),1722351776,0,0,1722351776,72528596442.395838,0.000000,0.000000,72528596442.395838,2168235,0,0,2168235
2014-06-20,NYSE Arca (P),254163223,177324873,168926443,600414539,10670782301.957823,12593198340.932106,6691722960.343706,29955703603.233635,1872575,459713,1017550,3349838
2014-06-20,NASDAQ (Q),368481166,88944001,1108735786,1566160953,15832993521.551154,6555719106.030473,41546907788.320118,63935620415.901745,2858967,333302,2836961,6029230
2014-06-20,NASDAQ PSX (X),9485887,5871538,7017941,22375366,382501091.266600,409850981.795800,293868577.397900,1086220650.460300,72354,17180,46128,135662
2014-06-20,BATS BYX (Y),113456649,31978237,70288315,215723201,3869491059.839621,1738549542.068901,2046830171.878802,7654870773.787324,882281,142975,468906,1494162
2014-06-20,BATS BZX (Z),199708006,86326239,135578695,421612940,7398775340.924729,5937254710.140328,4755577891.963619,18091607943.028676,1531042,332040,921242,2784324
2014-06-19,NYSE MKT (A),0,17039096,7319669,24358765,0.000000,79033388.668300,134194071.194000,213227459.862300,0,32983,28385,61368
2014-06-19,NASDAQ BX (B),72605092,32091425,41143085,145839602,2658327589.941298,1500483720.481809,1547291787.081101,5706103097.504208,595914,167680,324970,1088564
2014-06-19,NYSE (DN),102424607,29014998,66832853,198272458,4008769068.132889,1324017921.094197,2496511060.429007,7829298049.656093,438801,93102,245826,777729
2014-06-19,NASDAQ (DQ),936058487,329495801,656975763,1922530051,33103729317.689146,15724031606.708335,20137639983.097105,68965400907.494586,3349710,678968,1861779,5890457
2014-06-19,ADF (D),25692667,10428097,22063216,58183980,954029190.356401,391274321.241500,572541156.087500,1917844667.685401,141011,28095,90213,259319
2014-06-19,EDGA (J),80922973,38110704,47737481,166771158,2887813588.284600,1793167940.508778,1469299042.404795,6150280571.198173,664648,193315,345817,1203780
2014-06-19,EDGX (K),171123724,79832412,150355217,401311353,6053555260.209915,3506463113.613723,4680186932.071626,14240205305.895264,955023,238708,633622,1827353
2014-06-19,CHX (M),14039910,12362826,6372040,32774776,566919919.344600,1120601412.060000,318652745.435400,2006174076.840000,1025,2994,453,4472
2014-06-19,NYSE (N),648953657,0,0,648953657,25955153515.646865,0.000000,0.000000,25955153515.646865,1935171,0,0,1935171
2014-06-19,NYSE Arca (P),239944821,211636650,177711275,629292746,10028794842.315104,12925054458.663975,6557838079.015346,29511687379.994425,1828394,550792,1024757,3403943
2014-06-19,NASDAQ (Q),355273924,110471259,476350009,942095192,15314865751.655013,7382171859.757487,17902080430.409373,40599118041.821873,2904432,423202,2562088,5889722
2014-06-19,NASDAQ PSX (X),9949510,8450982,7039291,25439783,410346821.643600,475566795.524600,300534221.199601,1186447838.367801,75015,25859,43283,144157
2014-06-19,BATS BYX (Y),106799725,40940937,62574214,210314876,3703766869.872301,1971284978.288496,1825436880.797515,7500488728.958312,861853,175604,434948,1472405
2014-06-19,BATS BZX (Z),191864101,104361146,125262766,421488013,7034589689.993466,6551224109.574196,4404546208.219167,17990360007.786829,1515249,392085,880088,2787422
2014-06-18,NYSE MKT (A),0,10508019,8026548,18534567,0.000000,61071768.386000,149448723.411000,210520491.797000,0,25575,30933,56508
2014-06-18,NASDAQ BX (B),81151136,30412881,45299164,156863181,3082302350.286322,1583240445.411393,1761793455.254902,6427336250.952617,653058,180924,363945,1197927
2014-06-18,NYSE (DN),112198448,26011012,76072679,214282139,4541812156.954200,1526248673.944405,2832588717.459627,8900649548.358232,459921,89530,272232,821683
2014-06-18,NASDAQ (DQ),973492278,324655629,661946194,1960094101,34289787582.424793,17723732759.684205,20002858629.533530,72016378971.642528,3495400,659714,1965853,6120967
2014-06-18,ADF (D),29325510,10931844,23848943,64106297,1092968590.877400,413685831.082600,638810330.065800,2145464752.025800,155759,28082,99528,283369
2014-06-18,EDGA (J),80346292,38158410,49210053,167714755,2829324184.877007,2031130120.029690,1546204615.915002,6406658920.821699,641749,204786,355083,1201618
2014-06-18,EDGX (K),185252974,69757711,149854367,404865052,6720876654.553586,3645331808.615128,5067966682.976309,15434175146.145023,1036741,225652,688220,1950613
2014-06-18,CHX (M),14979760,11924074,3929537,30833371,449308134.397500,1071749574.525499,207492647.109800,1728550356.032799,682,4934,992,6608
2014-06-18,NYSE (N),628077828,0,0,628077828,24257016594.778307,0.000000,0.000000,24257016594.778307,2026120,0,0,2026120
2014-06-18,NYSE Arca (P),263279938,218241813,176295521,657817272,11131344609.256144,14483961945.953738,6742571121.156048,32357877676.365930,1941779,588774,1093555,3624108
2014-06-18,NASDAQ (Q),393984122,119628908,461308291,974921321,17521445693.060292,8464085751.897196,17715281956.988258,43700813401.945746,3262820,440182,2746755,6449757
2014-06-18,NASDAQ PSX (X),10426398,9602641,7847311,27876350,418456227.606000,609760171.612200,306938982.660000,1335155381.878200,79195,26678,47095,152968
2014-06-18,BATS BYX (Y),103315159,41846129,64065685,209226973,3550139789.442900,2252874475.405597,1912890485.337497,7715904750.185994,846844,176849,453730,1477423
2014-06-18,BATS BZX (Z),211255908,118304122,135466792,465026822,8070087248.862440,7807140551.656999,4828466241.030316,20705694041.549755,1643703,420600,942789,3007092
2014-06-17,NYSE MKT (A),0,11484996,7559467,19044463,0.000000,75949609.063400,148953456.403200,224903065.466600,0,27890,31351,59241
2014-06-17,NASDAQ BX (B),76730858,22654171,43962199,143347228,2947222758.512897,1299815936.199194,1684163308.577511,5931202003.289602,652577,139807,371391,1163775
2014-06-17,NYSE (DN),102573188,23052758,75116699,200742645,3933533952.889199,1264296202.422604,2695746204.521235,7893576359.833038,452343,74485,277449,804277
2014-06-17,NASDAQ (DQ),967981397,346197044,639075450,1953253891,33233280420.570157,23698132274.420686,19675280496.796972,76606693191.787815,3432259,551387,2022105,6005751
2014-06-17,ADF (D),26156549,7592695,22087272,55836516,941473049.387502,306769577.196100,595395935.687101,1843638562.270703,139757,20471,95619,255847
2014-06-17,EDGA (J),73382674,28159704,44954168,146496546,2548574874.822216,1667000891.576012,1389983695.966697,5605559462.364925,586426,170241,341460,1098127
2014-06-17,EDGX (K),179384788,56271716,149597968,385254472,6357636177.920589,3032171111.750592,5060933660.881107,14450740950.552288,1002629,189871,691809,1884309
2014-06-17,CHX (M),11230742,15852081,6357279,33440102,510064356.649000,1381987629.489000,360268643.919000,2252320630.057000,1624,3974,766,6364
2014-06-17,NYSE (N),600075011,0,0,600075011,22970875076.194759,0.000000,0.000000,22970875076.194759,1969479,0,0,1969479
2014-06-17,NYSE Arca (P),249664070,169993305,169612824,589270199,10305142905.304105,12142519501.916910,6650253752.370286,29097916159.591301,1876122,492731,1104966,3473819
2014-06-17,NASDAQ (Q),384702699,94653804,465057588,944414091,16587803960.757428,6870085723.643184,17383703886.238356,40841593570.638968,3136452,368791,2793052,6298295
2014-06-17,NASDAQ PSX (X),8825354,6704548,6428144,21958046,334562755.977000,461781860.023500,245805002.785500,1042149618.786000,71489,21927,43992,137408
2014-06-17,BATS BYX (Y),101587533,30759067,63087794,195434394,3494458646.023703,1788565836.565500,1889636772.198102,7172661254.787305,816120,142283,444876,1403279
2014-06-17,BATS BZX (Z),193147874,86928196,125039405,405115475,7152230144.338961,6850340792.545519,4435800677.306720,18438371614.191200,1534798,349544,936572,2820914
2014-06-16,NYSE MKT (A),0,10915276,5725431,16640707,0.000000,65832946.678100,126373219.290700,192206165.968800,0,26390,27512,53902
2014-06-16,NASDAQ BX (B),80155189,22733251,42326195,145214635,3003929024.790991,1208381560.120307,1632243896.084207,5844554480.995505,666967,148963,355174,1171104
2014-06-16,NYSE (DN),96058099,24522089,64215754,184795942,3730265544.541211,1316129105.206999,2355419482.425333,7401814132.173543,403848,83107,246063,733018
2014-06-16,NASDAQ (DQ),954896514,314071481,606171673,1875139668,33538212241.066097,18662850779.314569,18975513489.394926,71176576509.775592,3556173,585707,1995702,6137582
2014-06-16,ADF (D),24783547,8194369,19354089,52332005,911077470.262500,353709795.860700,556624281.131101,1821411547.254301,139954,21288,90925,252167
2014-06-16,EDGA (J),75270227,25917404,44538107,145725738,2647351809.848707,1374973577.525807,1278020529.023198,5300345916.397712,609270,160328,325499,1095097
2014-06-16,EDGX (K),173127217,51430797,133722910,358280924,6428478946.736512,2503453191.220105,4488233068.117897,13420165206.074514,988338,176980,652820,1818138
2014-06-16,CHX (M),16382926,13154428,3793527,33330881,634471233.462400,997413912.120700,185829778.771300,1817714924.354400,754,2849,879,4482
2014-06-16,NYSE (N),603807900,0,0,603807900,23840445407.829661,0.000000,0.000000,23840445407.829661,1914084,0,0,1914084
2014-06-16,NYSE Arca (P),252975198,170286623,155651162,578912983,10876877907.505158,11162056216.007285,6075305695.775896,28114239819.288339,1920850,450200,1049511,3420561
2014-06-16,NASDAQ (Q),373763475,83330047,424872227,881965749,16234350273.985331,5709734532.703583,16211705927.595274,38155790734.284188,3006920,332122,2581081,5920123
2014-06-16,NASDAQ PSX (X),10618524,6289306,6325555,23233385,408347888.390000,396395387.702500,243563369.485800,1048306645.578300,88136,18873,48586,155595
2014-06-16,BATS BYX (Y),102902198,28386820,59036638,190325656,3415216588.467208,1525891062.097899,1669431548.969387,6610539199.534494,828189,133870,433533,1395592
2014-06-16,BATS BZX (Z),185631401,76591014,116326200,378548615,6949495898.206428,4951696264.770089,4136695413.580595,16037887576.557112,1504979,313032,880840,2698851
2014-06-13,NYSE MKT (A),0,12629894,5829993,18459887,0.000000,60822612.262200,137090055.079000,197912667.341200,0,26039,26170,52209
2014-06-13,NASDAQ BX (B),64900083,22880645,42905076,130685804,2426378713.826806,1207897594.825571,1554875788.038990,5189152096.691367,541257,150950,336305,1028512
2014-06-13,NYSE (DN),89455499,22616592,63868097,175940188,3356841407.700886,1151224750.609801,2302505781.236312,6810571939.546999,374423,69431,242603,686457
2014-06-13,NASDAQ (DQ),808878917,263589592,612516408,1684984917,27898854978.735598,13809302443.293875,19808718521.834765,61516875943.864238,2958505,517426,1856788,5332719
2014-06-13,ADF (D),22812709,8347333,18206007,49366049,828089975.585001,300707032.234400,568228604.422700,1697025612.242101,125709,20189,88771,234669
2014-06-13,EDGA (J),65855908,26302993,43445456,135604357,2299199987.809201,1323432898.058901,1499022177.258998,5121655063.127100,531275,113372,333095,977742
2014-06-13,EDGX (K),151992143,52985713,136960498,341938354,5477998503.564004,2488722028.257589,4592509676.567003,12559230208.388596,876777,164854,657690,1699321
2014-06-13,CHX (M),11690836,7599741,4110145,23400722,385948266.687500,850884966.968200,179562304.326500,1416395537.982200,670,2900,899,4469
2014-06-13,NYSE (N),574427959,0,0,574427959,22255209216.664320,0.000000,0.000000,22255209216.664320,1705718,0,0,1705718
2014-06-13,NYSE Arca (P),212622881,157805184,171835519,542263584,8657663983.295520,10561786461.856159,6791863520.481625,26011313965.633304,1592089,433266,1035982,3061337
2014-06-13,NASDAQ (Q),331758204,88181321,466837595,886777120,13617222584.738683,6056332994.047083,17316196885.943827,36989752464.729593,2648991,339048,2537826,5525865
2014-06-13,NASDAQ PSX (X),8046650,6475429,6110705,20632784,286190374.075000,428856182.000000,237440331.580000,952486887.655000,59791,20610,40567,120968
2014-06-13,BATS BYX (Y),86702348,28664740,55686428,171053516,2905637809.950806,1543987865.186303,1753759959.936703,6203385635.073812,702621,135917,423197,1261735
2014-06-13,BATS BZX (Z),174267962,78142833,128998506,381409301,6293605501.315313,5228978075.558509,4675083782.100392,16197667358.974214,1360041,318342,894300,2572683
2014-06-12,NYSE MKT (A),0,14449791,7057257,21507048,0.000000,86108621.263900,143959845.950200,230068467.214100,0,30185,27958,58143
2014-06-12,NASDAQ BX (B),77141644,28881070,44796589,150819303,2972659146.738892,1591290904.017880,1714023246.106000,6277973296.862772,638110,156386,359165,1153661
2014-06-12,NYSE (DN),106240221,29807592,74675093,210722906,4242318132.213899,1577282691.333399,2753078923.297399,8572679746.844697,440384,89216,262271,791871
2014-06-12,NASDAQ (DQ),984100824,323598113,667428794,1975127731,34340176449.721967,17038711326.461250,20306465558.164613,71685353334.347830,3432494,629851,1990146,6052491
2014-06-12,ADF (D),28354563,11413357,22774828,62542748,1025627311.986300,387761431.231900,647130591.323900,2060519334.542100,158573,28373,103146,290092
2014-06-12,EDGA (J),73362102,31799346,45442891,150604339,2564838798.773606,1765423388.156401,1411991004.484296,5742253191.414303,583323,138020,339295,1060638
2014-06-12,EDGX (K),189755610,70282190,165132293,425170093,7023396965.975872,3270179456.285699,5342838394.155139,15636414816.416710,1080732,212214,743734,2036680
2014-06-12,CHX (M),10732344,8767391,8291235,27790970,494930743.856100,955343941.643600,447949879.763000,1898224565.262700,1359,3155,1203,5717
2014-06-12,NYSE (N),623421180,0,0,623421180,24397648353.304674,0.000000,0.000000,24397648353.304674,1932004,0,0,1932004
2014-06-12,NYSE Arca (P),261777621,198437341,179505275,639720237,11082964127.296106,13371982260.798178,6745737424.801307,31200683812.895591,1899787,526177,1073587,3499551
2014-06-12,NASDAQ (Q),383461224,114799034,489743086,988003344,16412802126.899410,8161335050.024435,17873516918.895216,42447654095.819061,3035567,433652,2706043,6175262
2014-06-12,NASDAQ PSX (X),10339283,8053618,6706460,25099361,389412790.152000,527141747.040500,250713321.508200,1167267858.700700,78000,23554,46715,148269
2014-06-12,BATS BYX (Y),101627060,36750141,62050547,200427748,3512165084.442314,2035217115.056498,1909338003.541209,7456720203.040021,822994,163780,447034,1433808
2014-06-12,BATS BZX (Z),203219088,102181049,137723802,443123939,7688682168.788927,6675973207.943004,4853385158.115259,19218040534.847190,1640187,396228,989306,3025721
2014-06-11,NYSE MKT (A),0,12358323,8645259,21003582,0.000000,76303410.132500,214171517.528000,290474927.660500,0,25840,30165,56005
2014-06-11,NASDAQ BX (B),65675708,22433090,38198218,126307016,2434313440.323195,1151242857.150488,1415054561.858707,5000610859.332390,524373,137922,299047,961342
2014-06-11,NYSE (DN),94764093,21616232,71183625,187563950,3669330556.490119,1116144916.241113,2517619220.059286,7303094692.790518,381250,78423,247487,707160
2014-06-11,NASDAQ (DQ),910337556,253262157,657371794,1820971507,31061667214.912557,13418268646.900930,18760249385.514523,63240185247.328010,3124277,556645,1886892,5567814
2014-06-11,ADF (D),24711152,8715235,21338241,54764628,877490257.452799,288243070.087800,551900478.384701,1717633805.925300,129218,21884,90209,241311
2014-06-11,EDGA (J),65231548,26098031,41132330,132461909,2229887036.904001,1280625296.202497,1240075378.818204,4750587711.924702,506021,113279,294331,913631
2014-06-11,EDGX (K),166632158,53893978,148566332,369092468,5726116063.683883,2400521092.428911,4690854581.210534,12817491737.323328,887284,165656,642825,1695765
2014-06-11,CHX (M),19325807,10039445,5090116,34455368,895367057.486600,738603331.324400,273481563.249000,1907451952.060000,1617,1572,684,3873
2014-06-11,NYSE (N),531555829,0,0,531555829,20141342428.801121,0.000000,0.000000,20141342428.801121,1702356,0,0,1702356
2014-06-11,NYSE Arca (P),216655700,143583585,167335328,527574613,8880024460.455801,9034239602.711251,6119331462.257213,24033595525.424265,1567409,413229,985519,2966157
2014-06-11,NASDAQ (Q),334853014,81994570,427886021,844733605,14156549665.745235,5515072739.806973,15528627601.176346,35200250006.728554,2623095,316427,2399699,5339221
2014-06-11,NASDAQ PSX (X),7693671,5495916,6253964,19443551,286033478.022900,340563191.164000,232846403.394800,859443072.581700,59638,15880,40581,116099
2014-06-11,BATS BYX (Y),93497575,28687411,56878888,179063874,3153565165.429407,1501978236.688500,1653412812.860921,6308956214.978828,749451,134755,412696,1296902
2014-06-11,BATS BZX (Z),180118903,73761361,131589614,385469878,6550603428.363548,4733355640.363098,4498988974.033973,15782948042.760619,1393252,297924,898619,2589795
2014-06-10,NYSE MKT (A),0,11386419,6357962,17744381,0.000000,79294950.001800,147895413.759700,227190363.761500,0,26142,27294,53436
2014-06-10,NASDAQ BX (B),60433289,19716141,39545020,119694450,2135576872.315995,981182915.961682,1466441534.637411,4583201322.915088,499389,130266,311880,941535
2014-06-10,NYSE (DN),97487031,21188018,71830859,190505908,3673549774.117694,1060027572.074002,2714538059.145801,7448115405.337497,409475,71792,263696,744963
2014-06-10,NASDAQ (DQ),931185253,272904509,670075148,1874164910,31007363475.686275,15035033361.105361,20436565981.625297,66478962818.416933,3298198,532339,2007134,5837671
2014-06-10,ADF (D),25371631,7278419,21301551,53951601,865507727.744601,247578507.128300,600829492.408199,1713915727.281100,134014,18212,98122,250348
2014-06-10,EDGA (J),62875545,23036134,40927466,126839145,2110845733.284907,1132004173.089104,1342100694.798894,4584950601.172905,504923,101108,303358,909389
2014-06-10,EDGX (K),161317686,46340787,141726837,349385310,5520798005.273812,2044135332.149299,4847549685.124577,12412483022.547688,873649,141624,644973,1660246
2014-06-10,CHX (M),11420183,10389842,9327857,31137882,478463125.211800,811771692.644000,383861762.435900,1674096580.291700,1042,2008,473,3523
2014-06-10,NYSE (N),557124399,0,0,557124399,21385209903.926512,0.000000,0.000000,21385209903.926512,1729708,0,0,1729708
2014-06-10,NYSE Arca (P),207657796,134177367,157821971,499657134,8445981938.910278,8184281774.549022,6012298107.167264,22642561820.626564,1623716,387543,954648,2965907
2014-06-10,NASDAQ (Q),315119523,75190878,436576075,826886476,12970352082.436859,5109001063.932294,16789456298.158460,34868809444.527613,2471416,282852,2476773,5231041
2014-06-10,NASDAQ PSX (X),7799418,4907696,5739591,18446705,278368635.858000,306529577.375000,209360093.000000,794258306.233000,60844,14142,39717,114703
2014-06-10,BATS BYX (Y),88264374,26400241,57977361,172641976,2872643380.805295,1377034766.521799,1705566199.037926,5955244346.365020,716118,118828,403003,1237949
2014-06-10,BATS BZX (Z),177866526,71177670,130340717,379384913,6418992786.478704,4522153589.070203,4718102494.789365,15659248870.338272,1384581,281010,926512,2592103
2014-06-09,NYSE MKT (A),0,10296638,7583589,17880227,0.000000,68342863.585800,177513495.712000,245856359.297800,0,24423,31474,55897
2014-06-09,NASDAQ BX (B),65173865,22238463,40137286,127549614,2294477199.986688,1179974852.391906,1436655463.399005,4911107515.777599,529223,141565,306331,977119
2014-06-09,NYSE (DN),98813990,25832328,77978054,202624372,3821236837.854672,1385446056.843802,2691439303.191115,7898122197.889589,423249,87348,308594,819191
2014-06-09,NASDAQ (DQ),932476898,287886218,630488255,1850851371,32264803879.595874,14914144046.662003,19613941875.881664,66792889802.139541,3374904,589220,2086397,6050521
2014-06-09,ADF (D),24680721,8249058,21196532,54126311,904593851.617500,333801673.073400,607636049.143800,1846031573.834700,134339,20781,100213,255333
2014-06-09,EDGA (J),68528083,26915922,42741870,138185875,2319572109.309292,1432872956.550400,1322224154.259101,5074669220.118793,537690,118732,311937,968359
2014-06-09,EDGX (K),162181445,48451982,150341063,360974490,5795481174.821389,2558723498.995198,4995907328.025820,13350112001.842407,906517,152564,679482,1738563
2014-06-09,CHX (M),12054407,10734423,4473295,27262125,448461011.958500,759182822.940600,283375933.782800,1491019768.681900,819,2204,707,3730
2014-06-09,NYSE (N),607958885,0,0,607958885,22234099382.393268,0.000000,0.000000,22234099382.393268,1813668,0,0,1813668
2014-06-09,NYSE Arca (P),225194786,151166225,159313943,535674954,9466057718.495210,9847046007.354720,6019380813.650724,25332484539.500654,1705261,438404,1002604,3146269
2014-06-09,NASDAQ (Q),334712635,83140070,452758696,870611401,14044145651.163496,6232368241.716400,16864221748.555951,37140735641.435847,2711722,316794,2585395,5613911
2014-06-09,NASDAQ PSX (X),8318018,6386310,6357564,21061892,311843814.140000,426658708.650000,235283724.826300,973786247.616300,65110,17076,43426,125612
2014-06-09,BATS BYX (Y),95557078,31267647,61195433,188020158,3121400374.033393,1717935058.568502,1809465280.617792,6648800713.219687,777687,140733,435702,1354122
2014-06-09,BATS BZX (Z),178998199,81494485,132886289,393378973,6596087152.277197,5521820407.004698,4773496655.444144,16891404214.726039,1446735,327839,951601,2726175
2014-06-06,NYSE MKT (A),0,9696464,6978986,16675450,0.000000,86400795.687800,160388164.578900,246788960.266700,0,21435,29570,51005
2014-06-06,NASDAQ BX (B),63860811,23285582,37545370,124691763,2219128838.068987,1273440199.768924,1479141258.317601,4971710296.155512,520715,146439,292622,959776
2014-06-06,NYSE (DN),104219553,24037429,61184023,189441005,3886262615.325426,1233101175.188402,2561464164.408370,7680827954.922198,442777,78195,253297,774269
2014-06-06,NASDAQ (DQ),957113314,304323959,571906890,1833344163,31308738390.637213,17562512299.459651,18519009504.005111,67390260194.101975,3366755,587780,1848676,5803211
2014-06-06,ADF (D),26230116,8727811,18889627,53847554,920603971.575902,368833567.350600,578549785.717099,1867987324.643601,137288,20763,88040,246091
2014-06-06,EDGA (J),71895850,28926278,42350836,143172964,2388950600.867595,1506979709.428302,1456921958.664391,5352852268.960288,546948,121713,312349,981010
2014-06-06,EDGX (K),172808827,51074643,125223772,349107242,5715984734.608393,2851894391.138004,4716823920.239484,13284703045.985881,892929,162347,581495,1636771
2014-06-06,CHX (M),8728602,8045184,5725928,22499714,362727133.752500,720833835.523000,303060167.682600,1386621136.958100,1162,1810,647,3619
2014-06-06,NYSE (N),640320042,0,0,640320042,24609559185.989958,0.000000,0.000000,24609559185.989958,1797666,0,0,1797666
2014-06-06,NYSE Arca (P),219768347,165193425,141109580,526071352,8522002338.036285,11089940618.051703,6277793233.880898,25889736189.968886,1611604,456014,909868,2977486
2014-06-06,NASDAQ (Q),327337621,90850039,429713443,847901103,13396169991.801182,6486147291.250991,17902083971.047090,37784401254.099263,2571943,337870,2369519,5279332
2014-06-06,NASDAQ PSX (X),9947391,6606684,6278018,22832093,331095870.279102,397358805.055000,230622193.897300,959076869.231402,68587,17763,39974,126324
2014-06-06,BATS BYX (Y),98068522,30515391,56515667,185099580,3195118651.212602,1638710778.738602,1801240814.044019,6635070243.995223,786015,138287,419475,1343777
2014-06-06,BATS BZX (Z),173605216,84043832,115127937,372776985,6142059576.967490,5653095439.892903,4585837020.398475,16380992037.258868,1351479,329858,832488,2513825
2014-06-05,NYSE MKT (A),0,9874528,7923190,17797718,0.000000,78314358.620900,169030790.119600,247345148.740500,0,24755,31269,56024
2014-06-05,NASDAQ BX (B),68925807,29969395,42751947,141647149,2493143630.607899,1604067993.263913,1674963584.212099,5772175208.083911,570170,177999,331280,1079449
2014-06-05,NYSE (DN),106366210,28043315,79874719,214284244,4040076757.865319,1475913192.226398,2866087071.137910,8382077021.229627,447283,88504,283457,819244
2014-06-05,NASDAQ (DQ),1052331517,281796323,711568739,2045696579,34667392386.082502,14047568105.688259,20201954788.672599,68916915280.443360,3581024,612927,2038414,6232365
2014-06-05,ADF (D),29799850,10281985,24360443,64442278,1033979752.127500,368983451.670700,640187749.095899,2043150952.894099,154185,24037,101088,279310
2014-06-05,EDGA (J),74840067,35149960,45621426,155611453,2580319480.498290,1720697760.952999,1427953425.839503,5728970667.290792,596452,137375,322649,1056476
2014-06-05,EDGX (K),194023624,66197944,156307239,416528807,6543721153.788555,3424845464.089601,5143684892.511217,15112251510.389373,1011312,202590,671754,1885656
2014-06-05,CHX (M),18037897,11206247,4430936,33675080,728412511.255600,1171727556.355800,587584129.266000,2487724196.877400,809,2991,829,4629
2014-06-05,NYSE (N),628832299,0,0,628832299,23436337758.073044,0.000000,0.000000,23436337758.073044,2030702,0,0,2030702
2014-06-05,NYSE Arca (P),253745134,194816323,167505455,616066912,9749256805.006505,14185391548.387333,6827113661.524836,30761762014.918674,1827970,522778,1052004,3402752
2014-06-05,NASDAQ (Q),378289467,114050533,477816349,970156349,15557275704.426011,8449386518.411914,18573924281.280710,42580586504.118635,2997867,412373,2745678,6155918
2014-06-05,NASDAQ PSX (X),10848953,8408128,7426219,26683300,370207615.999000,536724497.405000,280547981.164900,1187480094.568900,75331,23423,43860,142614
2014-06-05,BATS BYX (Y),101207717,37858775,62703701,201770193,3355039862.406012,2055190291.476695,1944182587.476117,7354412741.358824,830927,158537,441863,1431327
2014-06-05,BATS BZX (Z),196903488,101492250,140336925,438732663,6932973497.476787,6721819474.638801,5264876369.352001,18919669341.467589,1520687,392691,971487,2884865
2014-06-04,NYSE MKT (A),0,10606045,6170630,16776675,0.000000,71845294.974200,129601253.930000,201446548.904200,0,26208,27604,53812
2014-06-04,NASDAQ BX (B),65270227,20377632,40262738,125910597,2490324884.200606,1109914470.123720,1560020362.704506,5160259717.028832,537400,126711,305799,969910
2014-06-04,NYSE (DN),96950982,20928157,64007926,181887065,3791872777.098293,1091962749.097194,2398045139.676031,7281880665.871518,431068,74265,256201,761534
2014-06-04,NASDAQ (DQ),942136813,225106761,584962715,1752206289,33248253705.737497,11230187557.502618,18384753155.890302,62863194419.130417,3403490,510406,1881887,5795783
2014-06-04,ADF (D),25111304,6606360,18862019,50579683,895284816.908902,232217921.243900,544895626.354300,1672398364.507102,138676,18129,92430,249235
2014-06-04,EDGA (J),69532132,23324360,40667997,133524489,2442131299.318495,1225584833.568202,1277555469.133797,4945271602.020494,553219,99986,306006,959211
2014-06-04,EDGX (K),165797000,44529254,124711544,335037798,5798192120.438385,2253691400.735493,4565639132.112583,12617522653.286461,922933,138110,594652,1655695
2014-06-04,CHX (M),11964793,9768974,3802224,25535991,468461881.586400,742249691.087500,462217492.295500,1672929064.969400,1364,1554,649,3567
2014-06-04,NYSE (N),591884397,0,0,591884397,22487957385.227051,0.000000,0.000000,22487957385.227051,1866614,0,0,1866614
2014-06-04,NYSE Arca (P),219785164,131726807,143327335,494839306,9063064077.528011,8399170272.827264,5744007807.362572,23206242157.717847,1630790,368092,930871,2929753
2014-06-04,NASDAQ (Q),330343929,70601652,408831722,809777303,14061355431.740410,5020509852.712421,15646985488.832916,34728850773.285747,2638622,278406,2427205,5344233
2014-06-04,NASDAQ PSX (X),9001376,5050394,5552638,19604408,352944199.895000,302057013.480000,210098720.730400,865099934.105400,70730,16222,39865,126817
2014-06-04,BATS BYX (Y),91894901,25302878,50621687,167819466,3094853098.848221,1348380921.057099,1628253862.415290,6071487882.320610,744292,116661,395407,1256360
2014-06-04,BATS BZX (Z),174644794,68025436,120231043,362901273,6341460851.022662,4374617870.780609,4356924445.302485,15073003167.105756,1351950,264546,860799,2477295
2014-06-03,NYSE MKT (A),0,12762363,6327542,19089905,0.000000,97511826.703300,136988070.197000,234499896.900300,0,29821,27092,56913
2014-06-03,NASDAQ BX (B),66540207,19113679,41049900,126703786,2409076690.282798,1036685569.672471,1473017349.737787,4918779609.693056,547966,131889,313253,993108
2014-06-03,NYSE (DN),93555324,21508647,65448510,180512481,3406101915.339400,1080155511.205904,2504463023.535296,6990720450.080600,414085,75939,250511,740535
2014-06-03,NASDAQ (DQ),951645231,237543865,647166005,1836355101,33232028658.817443,12559448639.700222,19274191719.248004,65065669017.765669,3458856,535394,1902673,5896923
2014-06-03,ADF (D),24137471,6900174,18675440,49713085,797300296.979601,282861333.501200,496058993.006598,1576220623.487399,132761,18252,85639,236652
2014-06-03,EDGA (J),70077611,25741561,42128456,137947628,2406457804.415303,1343040129.458498,1279401650.680307,5028899584.554108,556785,108539,305943,971267
2014-06-03,EDGX (K),163743839,47095100,124223147,335062086,5654579536.182410,2347677415.438894,4327100230.110016,12329357181.731320,914807,147099,601377,1663283
2014-06-03,CHX (M),13477858,11159158,3859995,28497011,627448380.909800,900311933.944600,257403192.678200,1785163507.532600,1049,1734,627,3410
2014-06-03,NYSE (N),657417773,0,0,657417773,24030963639.631745,0.000000,0.000000,24030963639.631745,1880120,0,0,1880120
2014-06-03,NYSE Arca (P),217523571,129416628,148328797,495268996,8660177511.841476,8255609728.606889,5793352039.857546,22709139280.305911,1645109,393331,949495,2987935
2014-06-03,NASDAQ (Q),338733200,75526815,450852403,865112418,14186328675.156328,5350985586.165908,16660429986.376532,36197744247.698768,2736278,296719,2538696,5571693
2014-06-03,NASDAQ PSX (X),9072231,5011057,6476701,20559989,329634948.430800,298881251.324000,251147015.838800,879663215.593600,71281,14555,44536,130372
2014-06-03,BATS BYX (Y),89147409,24584165,51244514,164976088,2849634633.240386,1360874993.572801,1522078043.189486,5732587670.002673,732518,119277,399177,1250972
2014-06-03,BATS BZX (Z),177614834,73390370,119233423,370238627,6397988669.936656,4869914815.944591,4264136257.029705,15532039742.910952,1366916,276495,819494,2462905
2014-06-02,NYSE MKT (A),0,10362899,5956903,16319802,0.000000,79878440.695300,129125561.340000,209004002.035300,0,25286,28842,54128
2014-06-02,NASDAQ BX (B),62111703,21948889,41734491,125795083,2289611495.310298,1215223604.537914,1567107145.390513,5071942245.238725,551970,136727,326061,1014758
2014-06-02,NYSE (DN),92076691,23747608,62514701,178339000,3589318801.525309,1255889678.355002,2563394687.013878,7408603166.894189,390767,84304,256151,731222
2014-06-02,NASDAQ (DQ),794589791,281719883,583648507,1659958181,27723426694.897127,14934933555.840499,18168873634.311600,60827233885.049226,3242043,577381,1935046,5754470
2014-06-02,ADF (D),22044620,7482767,17681644,47209031,788447464.484199,278389629.426900,477597456.360200,1544434550.271299,126105,20587,83228,229920
2014-06-02,EDGA (J),60966047,26123307,40271347,127360701,2111921530.445299,1370779599.494100,1269934285.030703,4752635414.970102,510818,111138,300505,922461
2014-06-02,EDGX (K),161670570,50117762,135583530,347371862,5916801757.796038,2570602163.274902,4623274569.923194,13110678490.994134,960068,165087,651527,1776682
2014-06-02,CHX (M),8607717,7358943,3761966,19728626,393984232.199400,909300660.793600,222586762.934000,1525871655.927000,905,2341,833,4079
2014-06-02,NYSE (N),548981684,0,0,548981684,20975640861.724324,0.000000,0.000000,20975640861.724324,1818153,0,0,1818153
2014-06-02,NYSE Arca (P),198997350,160649115,145388577,505035042,8134561284.554597,10027405528.220477,6064635780.562912,24226602593.337986,1676617,450066,955181,3081864
2014-06-02,NASDAQ (Q),314957388,88496170,426349997,829803555,13382483118.867438,6623050715.239916,16479747769.863568,36485281603.970922,2639209,340248,2562280,5541737
2014-06-02,NASDAQ PSX (X),7992238,5645232,6123429,19760899,295952517.905000,376643606.058800,228931584.938000,901527708.901800,65156,17621,42006,124783
2014-06-02,BATS BYX (Y),82559608,27623548,51105955,161289111,2732860297.652806,1509325635.563901,1585572042.927804,5827757976.144511,697696,127879,386185,1211760
2014-06-02,BATS BZX (Z),156625859,80053177,114413911,351092947,5804902051.476121,5290740789.161705,4127338029.589175,15222980870.227001,1271211,296346,798378,2365935
2014-05-30,NYSE MKT (A),0,13262801,7230490,20493291,0.000000,136858622.946500,146770759.759000,283629382.705500,0,25417,29916,55333
2014-05-30,NASDAQ BX (B),71733879,24762367,40420934,136917180,2640247692.192283,1377630297.282985,1761729675.480006,5779607664.955274,592844,151629,329121,1073594
2014-05-30,NSX (C),5536034,1631883,5581112,12749029,196666429.590000,20360994.865000,84419237.560100,301446662.015100,45910,5501,22860,74271
2014-05-30,NYSE (DN),97962950,23454842,66615417,188033209,3779849484.759196,1237821537.379799,2948385729.242984,7966056751.381979,433375,79276,249601,762252
2014-05-30,NASDAQ (DQ),981038082,293775609,685603552,1960417243,34387207327.451264,15306729271.666689,23291821488.169292,72985758087.287245,3425110,572626,1893423,5891159
2014-05-30,ADF (D),23493966,7831414,16298488,47623868,843292847.953000,347215945.292900,522998803.751500,1713507596.997400,142318,21623,85429,249370
2014-05-30,EDGA (J),72952661,29858918,41630208,144441787,2524716500.232695,1582236285.557806,1486800333.338608,5593753119.129109,582054,123420,311263,1016737
2014-05-30,EDGX (K),181732355,53714926,154695513,390142794,6185241016.227921,2639865246.878697,6074565768.182573,14899672031.289191,1011228,169917,700358,1881503
2014-05-30,CHX (M),9063372,8765820,2957554,20786746,347835136.065200,576667862.230000,571894431.113400,1496397429.408600,1231,1613,712,3556
2014-05-30,NYSE (N),915512471,0,0,915512471,35435786079.687621,0.000000,0.000000,35435786079.687621,1988851,0,0,1988851
2014-05-30,NYSE Arca (P),230537771,195924595,150207628,576669994,9456611961.122035,12195082898.067589,7158635960.746841,28810330819.936465,1786704,485334,936920,3208958
2014-05-30,NASDAQ (Q),354957984,100256645,540185040,995399669,14942844096.879769,7190504672.754276,21801138745.318003,43934487514.952048,2831865,359346,2455889,5647100
2014-05-30,NASDAQ PSX (X),8858386,6388356,6272092,21518834,335460515.800000,439095225.590400,250161725.509700,1024717466.900100,68898,20000,40714,129612
2014-05-30,BATS BYX (Y),98589500,31019267,50767356,180376123,3313894463.757297,1708518371.701700,1824147065.497400,6846559900.956397,791146,139098,387552,1317796
2014-05-30,BATS BZX (Z),211415783,101369372,137227603,450012758,7512078627.603839,6669576675.495000,5434504639.340173,19616159942.439012,1559518,322520,909782,2791820
2014-05-29,NYSE MKT (A),0,12024792,7220565,19245357,0.000000,100240764.263600,154171212.024000,254411976.287600,0,27549,31814,59363
2014-05-29,NASDAQ BX (B),61408801,19026332,37938853,118373986,2303046812.356997,1126594156.120705,1669916691.515504,5099557659.993206,525339,124718,292758,942815
2014-05-29,NSX (C),4114995,2269168,5090610,11474773,158772012.563800,29125321.396300,67527474.982100,255424808.942200,34330,6308,18277,58915
2014-05-29,NYSE (DN),95270004,22349006,66283357,183902367,3591139749.400095,1091877848.821200,2634827885.132101,7317845483.353396,412215,74977,249957,737149
2014-05-29,NASDAQ (DQ),899178773,240838848,661170301,1801187922,31215872499.888822,12036164313.102837,19009190061.375781,62261226874.367440,3300461,532541,1804943,5637945
2014-05-29,ADF (D),23089040,7381798,17146329,47617167,841896632.297499,272836192.992900,486639095.248300,1601371920.538699,141056,20114,81627,242797
2014-05-29,EDGA (J),64316597,23178665,40310915,127806177,2254989936.696193,1306914080.693101,1316595757.587698,4878499774.976992,522356,104393,291417,918166
2014-05-29,EDGX (K),171052579,48619411,162340932,382012922,6255212499.442068,2185109020.838898,5870717205.484596,14311038725.765562,968103,150597,679431,1798131
2014-05-29,CHX (M),13696433,6499369,4702840,24898642,594211293.236300,485509492.120000,788372659.263600,1868093444.619900,917,1564,528,3009
2014-05-29,NYSE (N),544076785,0,0,544076785,20394634991.894606,0.000000,0.000000,20394634991.894606,1776691,0,0,1776691
2014-05-29,NYSE Arca (P),217671840,128936175,147854783,494462798,8979616557.815178,8476620710.039157,5910548974.595649,23366786242.449984,1721357,397082,873095,2991534
2014-05-29,NASDAQ (Q),332802543,81856368,382614036,797272947,13889175899.243123,6018026855.169395,15146788346.171684,35053991100.584202,2624591,322990,2299143,5246724
2014-05-29,NASDAQ PSX (X),8635356,5872280,6238071,20745707,339991006.295000,368181415.928000,238945713.538800,947118135.761800,70689,18009,39816,128514
2014-05-29,BATS BYX (Y),88380222,25476099,50301600,164157921,2926343009.660403,1424203893.244799,1733111951.142494,6083658854.047696,727974,122302,375905,1226181
2014-05-29,BATS BZX (Z),185696236,78372852,126891097,390960185,6671972826.590273,5138453480.351910,4476145944.677197,16286572251.619380,1390764,287299,817736,2495799
2014-05-28,NYSE MKT (A),0,12095987,7576301,19672288,0.000000,70727222.200800,175843651.206000,246570873.406800,0,26086,34076,60162
2014-05-28,NASDAQ BX (B),74046413,23415044,42425827,139887284,2738378583.076203,1192201429.534105,1709920117.720603,5640500130.330911,620577,134164,346346,1101087
2014-05-28,NSX (C),5723778,1246460,9358245,16328483,192778636.826100,33528510.821700,97166243.208900,323473390.856700,46869,5229,26180,78278
2014-05-28,NYSE (DN),105158958,24150487,68222812,197532257,4063288085.294518,1168566925.184503,2549340956.548902,7781195967.027923,459816,78908,264840,803564
2014-05-28,NASDAQ (DQ),971674017,285484917,654420878,1911579812,33844558562.009317,13202337419.709503,19077339275.742739,66124235257.461559,3586511,589661,2003781,6179953
2014-05-28,ADF (D),21950768,8122611,17566387,47639766,837226102.951198,366357717.463400,514915217.673598,1718499038.088196,134973,22523,88370,245866
2014-05-28,EDGA (J),69840844,27938799,41754262,139533905,2382511197.620696,1434467413.990504,1377791084.257008,5194769695.868208,558323,125139,311950,995412
2014-05-28,EDGX (K),185972609,54788385,174819072,415580066,6792175511.860822,2429106412.219200,5897368239.767679,15118650163.847701,1054018,160936,740482,1955436
2014-05-28,CHX (M),10988741,9299862,4512332,24800935,429282108.972600,727466585.065000,209114015.749600,1365862709.787200,877,2475,1326,4678
2014-05-28,NYSE (N),635961420,0,0,635961420,23557761768.305101,0.000000,0.000000,23557761768.305101,1977696,0,0,1977696
2014-05-28,NYSE Arca (P),239056999,169455783,152690237,561203019,10015530503.614443,10293595389.077072,6410902723.878901,26720028616.570416,1884800,452104,989470,3326374
2014-05-28,NASDAQ (Q),362284724,94182531,427821219,884288474,15658189521.779835,6821752438.791597,17055025153.125047,39534967113.696479,2967747,357780,2595338,5920865
2014-05-28,NASDAQ PSX (X),9584607,6124787,6476535,22185929,334717910.685000,406382126.423000,268944352.107200,1010044389.215200,72314,18498,42989,133801
2014-05-28,BATS BYX (Y),95711850,28876189,53440633,178028672,3187086140.107387,1546090918.759004,1764835372.745687,6498012431.612078,773978,133490,408553,1316021
2014-05-28,BATS BZX (Z),189782401,83353819,126464010,399600230,7033093279.776703,5446787106.418805,4860546694.606044,17340427080.801552,1489927,311470,909169,2710566
2014-05-27,NYSE MKT (A),0,16703488,8012291,24715779,0.000000,93958018.986100,203833391.490300,297791410.476400,0,24359,35099,59458
2014-05-27,NASDAQ BX (B),79242805,23126244,47042879,149411928,2772808493.789977,1213977784.873075,1957390419.853920,5944176698.516972,650209,140713,377957,1168879
2014-05-27,NSX (C),8282278,1623735,7655278,17561291,208496904.361500,40895774.157700,113129332.252700,362522010.771900,51820,6627,30965,89412
2014-05-27,NYSE (DN),103478408,26805921,76148819,206433148,3803982940.397509,1312217579.228096,2832448738.082106,7948649257.707711,451771,88792,280276,820839
2014-05-27,NASDAQ (DQ),920852822,279356703,637856018,1838065543,31113582709.513408,13604102965.564891,20073535978.088739,64791221653.167038,3488233,606286,2027067,6121586
2014-05-27,ADF (D),23104905,8430090,18403545,49938540,847734840.966902,307981462.806000,568942160.141099,1724658463.914001,137959,22203,94327,254489
2014-05-27,EDGA (J),69617818,30573794,44033898,144225510,2278013490.868998,1514720391.793500,1438209484.812808,5230943367.475306,552006,131452,328597,1012055
2014-05-27,EDGX (K),172798222,60628091,173255423,406681736,5968768909.401122,2666200947.766696,6381326783.781214,15016296640.949032,911673,174358,729115,1815146
2014-05-27,CHX (M),12699157,9020585,6219910,27939652,525743918.080900,1064750210.710000,374491658.044203,1964985786.835103,757,2042,1445,4244
2014-05-27,NYSE (N),658758316,0,0,658758316,24338533166.703658,0.000000,0.000000,24338533166.703658,1833363,0,0,1833363
2014-05-27,NYSE Arca (P),230415089,186251637,157724141,574390867,9347684730.758787,11462772595.529938,6890338137.833751,27700795464.122476,1793825,470773,1003912,3268510
2014-05-27,NASDAQ (Q),354837908,93508470,451062845,899409223,14639823890.174497,6146847619.265059,19130950471.686459,39917621981.126015,2783417,359550,2600880,5743847
2014-05-27,NASDAQ PSX (X),7925149,7000840,6016124,20942113,276876232.550000,461436636.652000,233296724.760000,971609593.962000,55500,21465,35697,112662
2014-05-27,BATS BYX (Y),92037028,29514044,55077610,176628682,2969580280.889484,1593138438.948500,1863742715.801398,6426461435.639382,738645,135994,398697,1273336
2014-05-27,BATS BZX (Z),179253202,81010056,127404144,387667402,6302867923.285388,4934559506.107598,4790564631.520419,16027992060.913405,1359179,301199,874813,2535191
2014-05-23,NYSE MKT (A),0,8906689,6940857,15847546,0.000000,52885535.453900,168874572.259000,221760107.712900,0,19407,25743,45150
2014-05-23,NASDAQ BX (B),58431267,18826227,37440127,114697621,2036221956.988407,978929489.626789,1350624212.408595,4365775659.023791,496175,105832,290929,892936
2014-05-23,NSX (C),4339846,1314621,4606407,10260874,144206949.794600,38924229.375100,72098545.997000,255229725.166700,36774,5295,22285,64354
2014-05-23,NYSE (DN),84936221,19282505,67220095,171438821,3094358205.520001,959790008.015708,2295879072.980417,6350027286.516126,363363,68293,228800,660456
2014-05-23,NASDAQ (DQ),772018972,232713916,527946839,1532679727,25066523715.462156,11674207991.634872,15795929207.255329,52536660914.352357,2951054,464320,1752911,5168285
2014-05-23,ADF (D),18635129,5980482,14316283,38931894,652611743.803198,247548828.525500,469081978.167499,1369242550.496197,107341,16357,79925,203623
2014-05-23,EDGA (J),58631038,21726471,37148790,117506299,1949761620.469201,1155454739.125799,1233783411.094506,4338999770.689506,483182,95897,286877,865956
2014-05-23,EDGX (K),144473614,44337972,127579555,316391141,4883867743.227494,2229076127.246900,4476611307.001291,11589555177.475685,788843,130341,580362,1499546
2014-05-23,CHX (M),13049768,7339319,2933640,23322727,480641880.258900,615338783.910000,175437303.468000,1271417967.636900,783,1733,642,3158
2014-05-23,NYSE (N),554133900,0,0,554133900,20602819431.109867,0.000000,0.000000,20602819431.109867,1674246,0,0,1674246
2014-05-23,NYSE Arca (P),186639969,129765650,140676163,457081782,7508710393.524977,8683749250.890194,5723327140.530620,21915786784.945791,1511697,355464,893087,2760248
2014-05-23,NASDAQ (Q),297380920,67372078,404364534,769117532,12148550123.597902,4794108294.742616,15783902391.897118,32726560810.237636,2435931,268694,2325710,5030335
2014-05-23,NASDAQ PSX (X),8473886,5086119,6015988,19575993,304375043.715000,381883518.625000,236630708.985200,922889271.325200,64463,16429,36566,117458
2014-05-23,BATS BYX (Y),75411531,23969392,49349032,148729955,2400288188.881488,1290550844.861301,1567750847.252603,5258589880.995392,628011,111888,372900,1112799
2014-05-23,BATS BZX (Z),144692875,61038333,112666477,318397685,5142093816.685202,4080468556.928203,4014428875.749708,13236991249.363113,1150106,234472,756818,2141396
2014-05-22,NYSE MKT (A),0,9351701,7090121,16441822,0.000000,65117396.234000,173849666.425600,238967062.659600,0,21303,33369,54672
2014-05-22,NASDAQ BX (B),64376978,19869692,43837820,128084490,2323219271.841001,1056577069.200000,1617850008.256607,4997646349.297608,545909,85782,322356,954047
2014-05-22,NSX (C),5900231,1700245,6872052,14472528,198456732.475800,35574508.080400,99317123.892500,333348364.448700,47678,5102,26813,79593
2014-05-22,NYSE (DN),92055490,22172331,70492605,184720426,3404592402.889498,1055046169.812801,2420929442.813523,6880568015.515822,396368,65702,252379,714449
2014-05-22,NASDAQ (DQ),906492912,245442751,614326641,1766262304,30485887009.573790,11627055263.697696,18730661352.693518,60843603625.965004,3310713,497801,1983285,5791799
2014-05-22,ADF (D),21188700,7793529,16958967,45941196,771770304.500900,309297385.981701,546569943.054202,1627637633.536803,130948,19484,93939,244371
2014-05-22,EDGA (J),65118003,24969651,46768059,136855713,2158492465.751791,1295325010.590701,1401251594.268494,4855069070.610986,542141,111451,331924,985516
2014-05-22,EDGX (K),166206049,52400654,156619695,375226398,5804305275.657800,2517529691.041102,5330537455.333489,13652372422.032391,919130,152099,685319,1756548
2014-05-22,CHX (M),25244710,9820685,6500915,41566310,996558275.396000,771224695.110000,423795806.287800,2191578776.793800,1087,1942,759,3788
2014-05-22,NYSE (N),577487710,0,0,577487710,21493923061.434725,0.000000,0.000000,21493923061.434725,1848390,0,0,1848390
2014-05-22,NYSE Arca (P),216596683,144748800,180727082,542072565,8931932678.175270,9357255715.501512,6761912153.586414,25051100547.263196,1755194,395199,1047492,3197885
2014-05-22,NASDAQ (Q),350717049,80795048,490426791,921938888,14370244538.419237,5469815535.434206,17008440849.456316,36848500923.309759,2922395,311538,2672837,5906770
2014-05-22,NASDAQ PSX (X),9564707,6019782,9017701,24602190,347194693.414000,398896907.063800,321471468.450000,1067563068.927800,68099,17597,45165,130861
2014-05-22,BATS BYX (Y),83928982,26143069,53828880,163900931,2748099450.088993,1442644956.600601,1741221107.799194,5931965514.488788,693579,117388,385908,1196875
2014-05-22,BATS BZX (Z),174484999,70411861,136474703,381371563,6108044066.221625,4504405740.415101,4598084740.778588,15210534547.415314,1340170,274643,891327,2506140
2014-05-21,NYSE MKT (A),0,12220984,8795776,21016760,0.000000,114343353.408300,217814790.288000,332158143.696300,0,25363,35934,61297
2014-05-21,NASDAQ BX (B),66828129,23316819,42711250,132856198,2370530518.580808,1378949497.153917,1574330699.341590,5323810715.076315,545471,167632,313955,1027058
2014-05-21,NSX (C),5435630,2321418,6226120,13983168,184020837.554300,44736298.360300,100998360.253800,329755496.168400,45405,6762,29804,81971
2014-05-21,NYSE (DN),89507337,23737822,77432308,190677467,3264233374.828506,1303996668.635201,2697703793.458828,7265933836.922535,372089,71392,218730,662211
2014-05-21,NASDAQ (DQ),901804994,265363813,579419562,1746588369,29420578341.621766,13634472054.731735,18588868424.246764,61643918820.600265,3249907,553226,1807786,5610919
2014-05-21,ADF (D),22654066,9139455,16358827,48152348,841508251.930000,344116738.878000,555661146.163000,1741286136.971000,140955,22506,91810,255271
2014-05-21,EDGA (J),68343776,30558065,45108387,144010228,2235923359.476996,1795329288.441501,1452982773.930311,5484235421.848808,549808,136797,321207,1007812
2014-05-21,EDGX (K),170432052,61767250,141830436,374029738,5852960378.675213,3070564699.573496,5039393693.356570,13962918771.605279,935288,180743,632232,1748263
2014-05-21,CHX (M),12524704,9071637,5941781,27538122,465771203.267400,634325861.617700,282761064.670000,1382858129.555100,1109,3018,811,4938
2014-05-21,NYSE (N),586939821,0,0,586939821,21663456587.960065,0.000000,0.000000,21663456587.960065,1868227,0,0,1868227
2014-05-21,NYSE Arca (P),217303156,165064187,155566048,537933391,8942868319.742440,11717110754.222459,6209245450.783131,26869224524.748030,1756095,479012,975585,3210692
2014-05-21,NASDAQ (Q),360489487,98777075,437132716,896399278,14675301166.299814,7520632763.645265,16406603257.258747,38602537187.203826,2951756,403645,2576650,5932051
2014-05-21,NASDAQ PSX (X),11448201,6282412,8069952,25800565,405447890.930000,457101306.067501,321459372.941700,1184008569.939201,80219,20808,46676,147703
2014-05-21,BATS BYX (Y),86733373,30645727,51725364,169104464,2809550828.782227,1844974660.007103,1639578962.412991,6294104451.202321,710048,145590,377218,1232856
2014-05-21,BATS BZX (Z),182714407,89012350,130439796,402166553,6433523685.591017,6100727743.327096,4688671466.553104,17222922895.471217,1385102,351013,858418,2594533
2014-05-20,NYSE MKT (A),0,11577673,7790465,19368138,0.000000,66266369.863500,197694776.215700,263961146.079200,0,22531,32887,55418
2014-05-20,NASDAQ BX (B),74929925,24344955,44178927,143453807,2668275508.499900,1568167111.329307,1782328293.156796,6018770912.986003,617188,163450,361738,1142376
2014-05-20,NSX (C),5117975,2717646,6014573,13850194,178482491.924500,52176878.737900,106775160.306400,337434530.968800,43228,7345,27086,77659
2014-05-20,NYSE (DN),111065087,25222350,78636289,214923726,3780020625.012382,1519464995.286599,2834615006.725401,8134100627.024382,454757,80678,270507,805942
2014-05-20,NASDAQ (DQ),922488202,364336470,600861533,1887686205,30790631303.786110,24354313177.507654,18581948922.277275,73726893403.571039,3416510,591710,1867853,5876073
2014-05-20,ADF (D),25432544,8037969,17843414,51313927,951125585.247099,380891165.931700,576239688.774301,1908256439.953100,162802,23833,103962,290597
2014-05-20,EDGA (J),71969304,33868756,42559759,148397819,2333509438.927601,2045247351.294203,1447036737.016999,5825793527.238803,575512,149924,323866,1049302
2014-05-20,EDGX (K),190067588,68425052,150416169,408908809,6783788005.763988,3766285138.832487,5342657469.150216,15892730613.746691,1059069,208606,704321,1971996
2014-05-20,CHX (M),8456565,13032680,3890214,25379459,348588882.261000,1280333893.899200,236952353.408200,1865875129.568400,1484,3334,754,5572
2014-05-20,NYSE (N),649251835,0,0,649251835,23168446809.900913,0.000000,0.000000,23168446809.900913,2070630,0,0,2070630
2014-05-20,NYSE Arca (P),252299314,180807635,165862048,598968997,10055992912.408142,13310337283.375034,6514458478.395009,29880788674.178185,1950418,530305,1092748,3573471
2014-05-20,NASDAQ (Q),398242358,119933473,482304977,1000480808,16480902904.899660,9585040828.358656,18163690892.805425,44229634626.063741,3282919,480516,2850482,6613917
2014-05-20,NASDAQ PSX (X),12969819,7314082,7946790,28230691,413139499.882900,537926592.485000,326318070.207000,1277384162.574900,79211,24333,49893,153437
2014-05-20,BATS BYX (Y),98498321,34705646,56611051,189815018,3178939617.692695,2179732430.057002,1872239646.891009,7230911694.640706,800305,160573,431453,1392331
2014-05-20,BATS BZX (Z),198993588,103179940,136570960,438744488,7066801001.167596,7371491798.684603,4880943372.196615,19319236172.048814,1549267,413133,959732,2922132
2014-05-19,NYSE MKT (A),0,9533698,6484203,16017901,0.000000,58672272.592600,165310264.162000,223982536.754600,0,20795,29170,49965
2014-05-19,NASDAQ BX (B),64946372,19095191,39389982,123431545,2372507947.410595,1047261727.630592,1568404935.283197,4988174610.324384,528835,132475,308847,970157
2014-05-19,NSX (C),4781913,1841477,3263396,9886786,159404918.000800,31289499.292800,72717919.457600,263412336.751200,37708,5678,20965,64351
2014-05-19,NYSE (DN),90374843,22581008,67313268,180269119,3269976696.398774,1135782656.022401,2638542160.257286,7044301512.678461,395787,76379,254464,726630
2014-05-19,NASDAQ (DQ),832106882,240439345,556008240,1628554467,28862176922.910622,11051067982.276445,19148581469.488067,59061826374.675134,3139068,519378,1787195,5445641
2014-05-19,ADF (D),21689797,7202674,15399440,44291911,796086124.442399,267888932.069500,539783771.927800,1603758828.439699,132202,20128,84780,237110
2014-05-19,EDGA (J),66184629,26771364,41880734,134836727,2286997491.951090,1306892228.631398,1449521304.664001,5043411025.246489,545304,112346,314523,972173
2014-05-19,EDGX (K),155911629,51097943,128196204,335205776,5453664423.811005,2413509114.413503,4696395420.789320,12563568959.013828,856527,155387,596355,1608269
2014-05-19,CHX (M),9401097,16645541,5880047,31926685,400459165.273000,1372830662.820000,296336631.286100,2069626459.379100,2156,3008,1237,6401
2014-05-19,NYSE (N),584445418,0,0,584445418,22515344692.727265,0.000000,0.000000,22515344692.727265,1837818,0,0,1837818
2014-05-19,NYSE Arca (P),221796454,134129444,148096576,504022474,9396488702.823298,9080663211.981679,6262728254.156728,24739880168.961705,1780084,408032,975776,3163892
2014-05-19,NASDAQ (Q),349919573,79372302,417874611,847166486,14818915758.169669,5491800876.504007,16688611244.944134,36999327879.617810,2842861,324109,2503086,5670056
2014-05-19,NASDAQ PSX (X),10027455,4925371,7222752,22175578,383479590.060000,353258008.745000,274755124.909800,1011492723.714800,70759,16653,43266,130678
2014-05-19,BATS BYX (Y),87486420,27756121,50927176,166169717,2886757529.821595,1489155973.789100,1689956950.315087,6065870453.925782,710582,129097,383246,1222925
2014-05-19,BATS BZX (Z),167671357,68250363,117578590,353500310,6185906275.398430,4380350941.892687,4568650209.217490,15134907426.508607,1316849,277718,818047,2412614
2014-05-16,NYSE MKT (A),0,9980580,7326883,17307463,0.000000,61775206.195600,176378053.300700,238153259.496300,0,20725,31343,52068
2014-05-16,NASDAQ BX (B),76714295,23049629,43754750,143518674,2729128461.148612,1321937009.903704,1722494647.625603,5773560118.677919,604574,102876,326765,1034215
2014-05-16,NSX (C),8271787,1481868,3532301,13285956,230367829.466300,28628419.540400,104917965.081100,363914214.087800,54920,5257,28663,88840
2014-05-16,NYSE (DN),109058161,25638317,63404276,198100754,3737765052.870498,1421627091.007405,2292353026.108287,7451745169.986190,427465,80812,230381,738658
2014-05-16,NASDAQ (DQ),943466939,263051332,573500702,1780018973,31472707992.517796,14049955537.490164,17946296875.671412,63468960405.679372,3472942,540507,1797366,5810815
2014-05-16,ADF (D),27966555,7934797,18650407,54551759,931739656.313701,348657932.595400,661317206.120203,1941714795.029304,153185,22179,98594,273958
2014-05-16,EDGA (J),76088933,29692675,44176198,149957806,2478265012.156298,1675326077.631796,1473189122.459897,5626780212.247991,595179,125762,315370,1036311
2014-05-16,EDGX (K),182768559,57922095,122958918,363649572,6012680067.873522,3173389656.829896,4441198722.723196,13627268447.426614,969649,175598,596465,1741712
2014-05-16,CHX (M),17414748,13822515,5201204,36438467,647602479.855500,1343268570.156000,509839880.134000,2500710930.145500,857,2856,939,4652
2014-05-16,NYSE (N),775423658,0,0,775423658,30873754166.360697,0.000000,0.000000,30873754166.360697,2059425,0,0,2059425
2014-05-16,NYSE Arca (P),254356525,166562208,159642622,580561355,9914370544.730841,11644971216.261400,6931589191.262241,28490930952.254482,1979378,488883,1028878,3497139
2014-05-16,NASDAQ (Q),399443704,106738503,494606962,1000789169,16691884660.747077,8179033397.156191,19689071367.126910,44559989425.030178,3236472,414346,2690732,6341550
2014-05-16,NASDAQ PSX (X),11219088,6812060,8733541,26764689,385671729.572000,514397420.898200,341178361.905000,1241247512.375200,77973,21328,47131,146432
2014-05-16,BATS BYX (Y),105889170,32330727,60131410,198351307,3465389666.667699,1860481547.975399,2024752200.493688,7350623415.136786,834641,141745,429769,1406155
2014-05-16,BATS BZX (Z),201867308,91500283,137461208,430828799,7277618743.131916,6338581328.074291,5183838006.178694,18800038077.384901,1550868,344605,903023,2798496
2014-05-15,NYSE MKT (A),0,10376275,9505965,19882240,0.000000,70060895.391600,228855565.196200,298916460.587800,0,23742,36752,60494
2014-05-15,NASDAQ BX (B),90820845,33529566,56657889,181008300,3338942543.988087,2057732955.021603,2144671504.129397,7541347003.139087,745213,188521,445151,1378885
2014-05-15,NSX (C),8076203,1859019,3670084,13605306,244164351.116300,55808422.221100,102095919.666300,402068693.003700,56235,7031,28256,91522
2014-05-15,NYSE (DN),121144001,34818395,81225313,237187709,4581425265.248170,2250859109.771701,2792667201.840912,9624951576.860783,547557,102342,303077,952976
2014-05-15,NASDAQ (DQ),1070068606,366984113,679261140,2116313859,36114350140.372625,21495925891.887835,20577504304.869715,78187780337.130175,4057950,709725,2171100,6938775
2014-05-15,ADF (D),33659081,12713724,22503732,68876537,1158076410.292902,744410076.734200,731551152.450001,2634037639.477103,186252,34302,119872,340426
2014-05-15,EDGA (J),84236436,43854336,53714669,181805441,2795655751.757503,2709787211.711005,1733712942.399816,7239155905.868324,707205,181707,399911,1288823
2014-05-15,EDGX (K),230474537,78534299,158613887,467622723,7517963923.214890,4526573358.133704,5415722512.715721,17460259794.064315,1248231,249438,784818,2282487
2014-05-15,CHX (M),9800439,11579571,5725548,27105558,479397675.258000,1111931391.217600,434465764.917900,2025794831.393500,951,4474,1066,6491
2014-05-15,NYSE (N),750260092,0,0,750260092,27030048110.581365,0.000000,0.000000,27030048110.581365,2452283,0,0,2452283
2014-05-15,NYSE Arca (P),302141408,237754310,190263522,730159240,11611743006.121299,16989350513.265652,7630417406.437957,36231510925.824908,2487705,688512,1232619,4408836
2014-05-15,NASDAQ (Q),485031639,152872558,569431391,1207335588,20410534980.809913,12017479487.008238,20995120109.501491,53423134577.319642,4047301,617962,3472168,8137431
2014-05-15,NASDAQ PSX (X),13731644,10158863,9935967,33826474,447048006.573001,770797945.670000,370856175.807999,1588702128.051000,93405,30863,59825,184093
2014-05-15,BATS BYX (Y),112185721,44040503,67474843,223701067,3695263891.959205,2735614665.331800,2196383678.805609,8627262236.096614,900739,199107,496658,1596504
2014-05-15,BATS BZX (Z),250108778,132586797,177532542,560228117,9008895358.073790,9362606045.319838,6494686442.534677,24866187845.928305,1974608,513576,1211864,3700048
2014-05-14,NYSE MKT (A),0,9227487,8208659,17436146,0.000000,55525986.247400,191603097.804600,247129084.052000,0,21074,34744,55818
2014-05-14,NASDAQ BX (B),69268319,22706566,42709089,134683974,2538038728.798392,1280732690.046415,1686167313.647996,5504938732.492803,573688,157758,339573,1071019
2014-05-14,NSX (C),5105149,1632974,5754133,12492256,193155423.844600,49011490.817400,89005295.030800,331172209.692800,44543,7315,25540,77398
2014-05-14,NYSE (DN),98401662,25036666,69168153,192606481,3542531260.848295,1398984580.982298,2358332179.185280,7299848021.015873,411800,74146,262196,748142
2014-05-14,NASDAQ (DQ),868856759,277448035,593624363,1739929157,29333922424.816869,14639756225.284382,16974645627.278184,60948324277.379435,3336131,579600,1867250,5782981
2014-05-14,ADF (D),25232146,8543630,21445632,55221408,861066849.592500,340197450.539300,563675284.226299,1764939584.358099,144990,24768,94468,264226
2014-05-14,EDGA (J),65505447,29109443,42209524,136824414,2168239208.613804,1549623683.140102,1318576764.518898,5036439656.272804,541739,131578,323010,996327
2014-05-14,EDGX (K),159901145,55560644,151639735,367101524,5644035023.018607,2905827967.988001,4392365143.943280,12942228134.949888,902220,173646,644056,1719922
2014-05-14,CHX (M),14632839,12293818,5269995,32196652,470243864.354100,794239492.170000,334094000.797900,1598577357.322000,645,3381,611,4637
2014-05-14,NYSE (N),620139409,0,0,620139409,23004924687.377280,0.000000,0.000000,23004924687.377280,1990058,0,0,1990058
2014-05-14,NYSE Arca (P),225932100,166686672,162449352,555068124,9080679582.917732,11016510438.504979,6073924042.564052,26171114063.986763,1862613,482486,1069763,3414862
2014-05-14,NASDAQ (Q),373595756,100327486,462829152,936752394,15475365195.657455,7277824851.697075,16552799322.426281,39305989369.780811,3037221,403458,2852407,6293086
2014-05-14,NASDAQ PSX (X),10581904,6403102,8342768,25327774,352203736.295000,413256495.130000,300946797.840000,1066407029.265000,71834,20314,50005,142153
2014-05-14,BATS BYX (Y),93863492,30344645,58209846,182417983,3106580420.224793,1671801005.813501,1839048177.685700,6617429603.723994,748007,139697,431404,1319108
2014-05-14,BATS BZX (Z),191663034,81880031,134155059,407698124,6843383415.500787,5528128581.917691,4607510864.197701,16979022861.616179,1494740,321616,939514,2755870
2014-05-13,NYSE MKT (A),0,9341520,8683324,18024844,0.000000,57790502.930100,213180089.423600,270970592.353700,0,21359,36872,58231
2014-05-13,NASDAQ BX (B),68854174,20884781,41410594,131149549,2593843501.588795,1165791415.635281,1618967717.349707,5378602634.573783,569487,117135,327609,1014231
2014-05-13,NSX (C),10650294,1943370,8397063,20990727,400278234.640401,77503511.395700,195809302.924001,673591048.960102,124564,13208,67979,205751
2014-05-13,NYSE (DN),102198594,24941442,94899967,222040003,3849352604.012674,1232358137.237401,3055805637.643584,8137516378.893659,456356,75064,311805,843225
2014-05-13,NASDAQ (DQ),969145418,280675794,730959955,1980781167,32381961297.464752,13210433910.155492,20397689819.089470,65990085026.709714,3504090,541473,2010014,6055577
2014-05-13,ADF (D),27401981,8524279,26156753,62083013,973281704.234100,351164771.413800,708822018.412399,2033268494.060299,152171,21458,111018,284647
2014-05-13,EDGA (J),61592546,28879727,42879425,133351698,2064659173.013801,1567962366.408601,1317541611.858789,4950163151.281191,484225,116606,301242,902073
2014-05-13,EDGX (K),164713367,54242172,149126821,368082360,5869679571.785193,2701001411.328501,4553551005.247996,13124231988.361690,939063,160074,665663,1764800
2014-05-13,CHX (M),12737476,14385790,3954779,31078045,420671214.313000,1336058242.580000,266032131.165800,2022761588.058800,1028,3305,800,5133
2014-05-13,NYSE (N),604057914,0,0,604057914,22506063849.874672,0.000000,0.000000,22506063849.874672,1991484,0,0,1991484
2014-05-13,NYSE Arca (P),228448914,154022873,159087319,541559106,9384218175.970284,10347283049.592605,6382027633.770270,26113528859.333159,1873460,442815,1071139,3387414
2014-05-13,NASDAQ (Q),384263749,94887692,468443362,947594803,16342721592.757970,6364593018.876694,17108668150.549776,39815982762.184440,3121947,360227,2828209,6310383
2014-05-13,NASDAQ PSX (X),11504809,6709104,8525193,26739106,389260156.351000,409085293.405000,311624351.543700,1109969801.299700,74398,20128,51496,146022
2014-05-13,BATS BYX (Y),92747741,28484071,60046513,181278325,3136862682.326304,1646364947.194200,1913267694.358706,6696495323.879210,750337,128950,446345,1325632
2014-05-13,BATS BZX (Z),188512003,75264733,141683892,405460628,6855188883.639419,4907255938.307202,4904969245.317512,16667414067.264133,1502632,290131,963618,2756381
2014-05-12,NYSE MKT (A),0,10107195,7826416,17933611,0.000000,66165170.280800,202785321.862800,268950492.143600,0,22145,35096,57241
2014-05-12,NASDAQ BX (B),81903321,25278593,45622150,152804064,2989030153.209782,1546682832.110207,1843403855.312710,6379116840.632699,677514,119064,378525,1175103
2014-05-12,NSX (C),9843050,1886548,8541195,20270793,379558362.778301,74963033.857800,158093941.460199,612615338.096300,126667,12330,63016,202013
2014-05-12,NYSE (DN),105156895,27346956,82819249,215323100,3967943600.481711,1385319754.954406,2833450992.803000,8186714348.239117,479320,83776,297071,860167
2014-05-12,NASDAQ (DQ),942250721,307895967,633554771,1883701459,31951994813.002275,16568865386.872472,18717666267.135484,67238526467.010231,3750855,648381,2133757,6532993
2014-05-12,ADF (D),30556933,10165370,23974450,64696753,1018269125.275898,470740102.530300,762431742.377099,2251440970.183297,159026,29735,110956,299717
2014-05-12,EDGA (J),66864664,31830558,44537828,143233050,2171315968.699193,1692082623.242299,1380958751.775700,5244357343.717192,526856,134381,328073,989310
2014-05-12,EDGX (K),177721185,63244832,149152605,390118622,6205097937.871865,3342664899.791985,4828727258.385133,14376490096.048983,974621,189720,696274,1860615
2014-05-12,CHX (M),7884910,10625403,4801204,23311517,297806929.498800,1262174957.261600,486639424.000000,2046621310.760400,707,2701,977,4385
2014-05-12,NYSE (N),640779468,0,0,640779468,24312786098.350366,0.000000,0.000000,24312786098.350366,2084600,0,0,2084600
2014-05-12,NYSE Arca (P),240913860,176015889,162679896,579609645,10282625697.021957,12363423357.336157,6662817340.091272,29308866394.449386,2067456,490240,1132753,3690449
2014-05-12,NASDAQ (Q),395372320,105444880,508426986,1009244186,16514095992.844985,7458250512.698904,18973660442.492977,42946006948.036866,3248417,402775,3130384,6781576
2014-05-12,NASDAQ PSX (X),11364956,7314631,8652998,27332585,406891253.444800,471186622.264999,332743769.760000,1210821645.469799,83966,23489,56077,163532
2014-05-12,BATS BYX (Y),91320619,31776866,57484739,180582224,3046934737.200305,1856541569.231498,1965312916.078086,6868789222.509889,728326,139478,426142,1293946
2014-05-12,BATS BZX (Z),206251917,90978111,144467204,441697232,7496273449.612032,5956047312.773281,4969678809.536065,18421999571.921378,1652732,342583,1056897,3052212
2014-05-09,NYSE MKT (A),0,9365568,7694606,17060174,0.000000,57450988.693600,206033376.333300,263484365.026900,0,23162,36330,59492
2014-05-09,NASDAQ BX (B),81309824,22726187,47630877,151666888,2941755386.470005,1225585013.206012,1776927798.783199,5944268198.459216,660406,106969,383589,1150964
2014-05-09,NSX (C),8005451,2050340,8693912,18749703,319328028.454400,69147285.235900,134927122.687401,523402436.377701,102878,10227,57954,171059
2014-05-09,NYSE (DN),104231130,24726472,82352089,211309691,3781314376.511396,1420176707.791339,2826696981.375116,8028188065.677851,449608,76090,313104,838802
2014-05-09,NASDAQ (DQ),915917414,242008879,664389180,1822315473,30224306543.125214,11747260015.472737,18368246245.646878,60339812804.244829,3412543,518887,2092565,6023995
2014-05-09,ADF (D),30066243,8956917,26781953,65805113,1034463319.167501,447631468.552500,729340600.000701,2211435387.720702,164109,24864,112904,301877
2014-05-09,EDGA (J),66425011,29097762,45924785,141447558,2177332595.702601,1692077529.149902,1386687353.989196,5256097478.841699,515411,127541,331484,974436
2014-05-09,EDGX (K),170471293,53574153,155782299,379827745,5906884023.144830,2941772477.554713,4901816907.427881,13750473408.127424,990725,166979,729398,1887102
2014-05-09,CHX (M),13653502,7773369,5251317,26678188,684089041.932000,616031087.432000,967595541.150000,2267715670.514000,898,2769,731,4398
2014-05-09,NYSE (N),651348638,0,0,651348638,24146454038.994361,0.000000,0.000000,24146454038.994361,2096112,0,0,2096112
2014-05-09,NYSE Arca (P),247561070,151613209,183029689,582203968,10138753817.866042,10454868548.724635,7173375423.551513,27766997790.142190,2046717,473010,1205706,3725433
2014-05-09,NASDAQ (Q),429610254,102277248,525869317,1057756819,17881354490.164525,7569280398.559302,19223755054.597206,44674389943.321033,3503335,427397,3222954,7153686
2014-05-09,NASDAQ PSX (X),12928697,7191582,9638548,29758827,417388605.051000,488860786.605000,314178141.961100,1220427533.617100,85042,21477,61342,167861
2014-05-09,BATS BYX (Y),86091344,30393242,58677886,175162472,2859542573.391600,1771201629.110897,1867619153.371106,6498363355.873603,666872,129407,420244,1216523
2014-05-09,BATS BZX (Z),217322309,87763012,156835105,461920426,7686452557.282721,6032297652.612101,5524306357.786761,19243056567.681583,1676898,353555,1109001,3139454
2014-05-08,NYSE MKT (A),0,11409710,7900681,19310391,0.000000,67329835.550100,163068450.278600,230398285.828700,0,26138,35061,61199
2014-05-08,NASDAQ BX (B),86408625,27719829,57776506,171904960,3090887753.672239,1582276884.216298,2315900677.151382,6989065315.039919,700792,114124,434145,1249061
2014-05-08,NSX (C),10241571,2263273,13407285,25912129,402905575.798800,100661854.918800,178461365.056899,682028795.774499,139180,15243,77051,231474
2014-05-08,NYSE (DN),122167165,29673214,96823611,248663990,4422673168.471036,1680022902.101600,3463161897.727440,9565857968.300076,505771,86936,332562,925269
2014-05-08,NASDAQ (DQ),1054058738,283423469,828687792,2166169999,35042862776.908155,14034869919.225496,24110733301.643902,73188465997.777553,4081416,644858,2441302,7167576
2014-05-08,ADF (D),34958748,10879928,33130021,78968697,1198135559.049299,507897815.667000,944960244.737400,2650993619.453699,186098,26917,141497,354512
2014-05-08,EDGA (J),73486188,36020259,55225613,164732060,2355415924.001018,2013263953.208696,1759725806.649202,6128405683.858916,565344,149755,381965,1097064
2014-05-08,EDGX (K),204450558,70837856,194688363,469976777,6857106808.076315,3685514176.302596,5978003410.864672,16520624395.243583,1137287,214715,856988,2208990
2014-05-08,CHX (M),13479689,8495347,7187735,29162771,511138735.744000,606626440.780000,318822037.827200,1436587214.351200,733,3590,1143,5466
2014-05-08,NYSE (N),694876593,0,0,694876593,25363888004.265855,0.000000,0.000000,25363888004.265855,2377841,0,0,2377841
2014-05-08,NYSE Arca (P),282779663,183412048,219487131,685678842,11594404172.403114,13018470258.786260,8862005061.455301,33474879492.644675,2380200,593297,1381320,4354817
2014-05-08,NASDAQ (Q),472532340,128248084,622352832,1223133256,19254749096.507755,9469011007.741311,22609734659.732988,51333494763.982054,3882004,508453,3772602,8163059
2014-05-08,NASDAQ PSX (X),13901529,9692772,13416936,37011237,463729812.141000,682099282.915000,452667649.000001,1598496744.056001,95425,28428,73155,197008
2014-05-08,BATS BYX (Y),96683570,36375950,71825016,204884536,3165618222.272407,2160244365.230202,2421744663.436292,7747607250.938901,754214,150044,484112,1388370
2014-05-08,BATS BZX (Z),246084166,111231694,194717201,552033061,8666423774.169136,7488093651.010289,6833635179.794942,22988152604.974367,1886373,418385,1297364,3602122
2014-05-07,NYSE MKT (A),0,11204725,9014423,20219148,0.000000,73997996.609900,203295066.853800,277293063.463700,0,25045,40988,66033
2014-05-07,NASDAQ BX (B),97302180,29375495,60387760,187065435,3533488616.906284,1654725124.103601,2491277316.440186,7679491057.450071,781823,126068,484616,1392507
2014-05-07,NSX (C),10405086,2620117,8559631,21584834,425715385.372700,109351614.954100,233344975.333800,768411975.660600,148319,16585,83698,248602
2014-05-07,NYSE (DN),131671647,32479895,105334120,269485662,4947615192.589962,1653303724.431101,3993297221.835908,10594216138.856971,549803,98693,385234,1033730
2014-05-07,NASDAQ (DQ),1108226389,287134410,839673894,2235034693,36977710873.161307,15426972207.351742,28230337115.740344,80635020196.253393,4344780,660455,2720805,7726040
2014-05-07,ADF (D),37081477,11706230,30991958,79779665,1282352840.116498,532944690.488100,999190088.779499,2814487619.384097,198972,29677,155645,384294
2014-05-07,EDGA (J),79217678,37141288,56759100,173118066,2534871400.840494,1953938775.381099,1985821715.235199,6474631891.456792,608846,153067,417798,1179711
2014-05-07,EDGX (K),214202016,67768035,186422198,468392249,7301795932.412000,3759915715.191598,6626152597.788008,17687864245.391606,1214597,214824,939640,2369061
2014-05-07,CHX (M),14394147,8614642,5609882,28618671,534136694.044500,633420756.260000,498426749.512500,1665984199.817000,1079,3710,1091,5880
2014-05-07,NYSE (N),766149047,0,0,766149047,28457608677.926710,0.000000,0.000000,28457608677.926710,2510338,0,0,2510338
2014-05-07,NYSE Arca (P),292527768,200134512,233719331,726381611,12152114566.785654,14066236642.935863,9690716243.188882,35909067452.910399,2462716,609131,1513651,4585498
2014-05-07,NASDAQ (Q),499368323,129431726,672680825,1301480874,20211705514.352842,9418457186.575972,26294691403.269640,55924854104.198454,4095944,523345,4106342,8725631
2014-05-07,NASDAQ PSX (X),17506370,9962640,13134294,40603304,524456449.094999,652514333.085300,498244388.700400,1675215170.880699,104879,27929,80535,213343
2014-05-07,BATS BYX (Y),100938415,37328565,69866313,208133293,3317547270.758292,2123401205.943296,2483961982.516499,7924910459.218087,781826,157421,497401,1436648
2014-05-07,BATS BZX (Z),264653546,119862539,200774404,585290489,9416113105.512667,7968570108.996196,7460435861.386675,24845119075.895538,2024694,469206,1397051,3890951
2014-05-06,NYSE MKT (A),0,10656437,7749559,18405996,0.000000,69006017.376900,185409144.442300,254415161.819200,0,22519,37365,59884
2014-05-06,NASDAQ BX (B),87517350,23153749,44054012,154725111,3095392379.425010,1266927104.042001,1920526283.101601,6282845766.568612,679309,99918,359587,1138814
2014-05-06,NSX (C),9321020,1522023,6106301,16949344,352168008.014800,62805226.532200,158710230.072400,573683464.619400,134062,10776,60156,204994
2014-05-06,NYSE (DN),114158506,25902055,76980726,217041287,4328540614.884500,1337220242.685305,3141795406.319701,8807556263.889506,471027,78519,273848,823394
2014-05-06,NASDAQ (DQ),1056013773,259899149,632194213,1948107135,35984428423.405385,14563982670.344406,21090047475.958247,71638458569.708038,3930596,551831,2075593,6558020
2014-05-06,ADF (D),34866378,9798906,23322211,67987495,1168455997.241099,407973444.146800,789327598.765001,2365757040.152900,167125,25321,104973,297419
2014-05-06,EDGA (J),74894804,27201899,43404408,145501111,2422221571.758501,1457079167.208001,1586929215.702807,5466229954.669309,566127,118447,328959,1013533
2014-05-06,EDGX (K),200563746,57874385,143821179,402259310,6977514900.080827,3009365836.640307,5067991758.068156,15054872494.789290,1099210,172158,687364,1958732
2014-05-06,CHX (M),11843446,8853592,4817299,25514337,491901374.043800,681500214.025000,931482485.285800,2104884073.354600,1257,2823,657,4737
2014-05-06,NYSE (N),699660057,0,0,699660057,25897254747.365146,0.000000,0.000000,25897254747.365146,2198472,0,0,2198472
2014-05-06,NYSE Arca (P),273948289,149519116,168067897,591535302,10901248283.940782,10054823289.707210,7041067833.007590,27997139406.655582,2242909,470400,1127686,3840995
2014-05-06,NASDAQ (Q),425965667,96762821,500006584,1022735072,17261994597.227043,6783343683.742917,19310293984.757039,43355632265.726999,3388064,381965,3063080,6833109
2014-05-06,NASDAQ PSX (X),14483119,8488902,9738541,32710562,460023184.209000,525688019.665000,349778673.375000,1335489877.249000,92401,22315,58039,172755
2014-05-06,BATS BYX (Y),92232150,29093173,51920129,173245452,2985152183.499604,1629786475.059299,1886881289.722304,6501819948.281207,698268,124703,382132,1205103
2014-05-06,BATS BZX (Z),232407166,88919579,141406970,462733715,8296961039.905442,5790844424.338192,5145257114.774610,19233062579.018244,1778834,340205,1014421,3133460
2014-05-05,NYSE MKT (A),0,8011634,5966900,13978534,0.000000,51016309.214000,138916662.601500,189932971.815500,0,19052,30369,49421
2014-05-05,NASDAQ BX (B),72398897,19959216,40383976,132742089,2715967819.930003,1118071089.636601,1604567961.820603,5438606871.387207,601955,89071,334338,1025364
2014-05-05,NSX (C),8002206,1411617,5532688,14946511,293893982.480000,51276241.548500,122174897.267500,467345121.296000,97703,9339,45910,152952
2014-05-05,NYSE (DN),92448458,23790417,62941178,179180053,3655573579.917378,1254481557.429998,2414760239.805720,7324815377.153096,415243,77013,245468,737724
2014-05-05,NASDAQ (DQ),840431262,244183696,527259034,1611873992,28721642860.215026,12689046683.520824,16501464269.421646,57912153813.157496,3375267,535826,1808732,5719825
2014-05-05,ADF (D),27335322,6794533,19008501,53138356,1003586268.139100,322195801.428000,621544009.985301,1947326079.552401,147847,18614,96805,263266
2014-05-05,EDGA (J),62827330,25553473,38818854,127199657,2209641623.295001,1432854459.557303,1289970309.937893,4932466392.790197,514171,115755,295724,925650
2014-05-05,EDGX (K),158452802,49292039,119463650,327208491,5771522453.088411,2701615056.715099,4436528313.062109,12909665822.865619,930676,156923,599501,1687100
2014-05-05,CHX (M),12884499,6174400,3167058,22225957,547502299.650000,499852609.368000,291096986.909401,1338451895.927401,1106,2513,848,4467
2014-05-05,NYSE (N),608748912,0,0,608748912,23538919604.262612,0.000000,0.000000,23538919604.262612,2047525,0,0,2047525
2014-05-05,NYSE Arca (P),217814681,154156530,140282171,512253382,9259401370.870943,11146869033.196969,6203194093.498005,26609464497.565917,1818746,439036,980436,3238218
2014-05-05,NASDAQ (Q),357893184,83679277,422683102,864255563,15066080150.771280,6123434893.068310,16337188600.923081,37526703644.762671,2956236,340960,2611572,5908768
2014-05-05,NASDAQ PSX (X),12215926,5983696,8599434,26799056,443643453.540000,437603956.895000,332314903.187100,1213562313.622100,90288,18007,55818,164113
2014-05-05,BATS BYX (Y),74874845,25420429,46125053,146420327,2515642462.079016,1468727411.883702,1599382727.026400,5583752600.989118,599364,113587,343971,1056922
2014-05-05,BATS BZX (Z),188222525,73766894,122958724,384948143,6944598429.104084,4887787326.920998,4597636955.156115,16430022711.181197,1489285,295297,872216,2656798
2014-05-02,NYSE MKT (A),0,8947241,6337284,15284525,0.000000,56861815.348900,148399755.415300,205261570.764200,0,21006,30073,51079
2014-05-02,NASDAQ BX (B),87335462,28327539,50004141,165667142,3208436689.864600,1535915002.816799,2056380489.208108,6800732181.889507,714151,120914,410765,1245830
2014-05-02,NSX (C),8690662,1924347,6211861,16826870,332962353.202500,77402301.966500,145006708.604000,555371363.773000,123996,10893,56068,190957
2014-05-02,NYSE (DN),110284955,29042039,77998030,217325024,4405242221.159625,1597067566.595411,2797974373.807531,8800284161.562567,488248,86446,287858,862552
2014-05-02,NASDAQ (DQ),942702719,257585271,604752993,1805040983,33039544517.478723,13555460375.406554,18542333416.490368,65137338309.375645,3718788,590686,2018156,6327630
2014-05-02,ADF (D),25642781,8854240,20032162,54529183,953401354.363299,438583644.189700,653486598.913300,2045471597.466299,145006,22083,104029,271118
2014-05-02,EDGA (J),76270588,39580343,45248340,161099271,2436300379.320095,2077930003.393400,1481841281.691510,5996071664.405005,576615,158829,337401,1072845
2014-05-02,EDGX (K),187741551,71296511,146999716,406037778,6876455166.304542,3836668449.537300,5124850566.450468,15837974182.292310,1108826,226670,745122,2080618
2014-05-02,CHX (M),11074846,7424842,4253950,22753638,447154355.135000,727984345.120000,251414173.925400,1426552874.180400,539,4003,545,5087
2014-05-02,NYSE (N),700637228,0,0,700637228,25711961771.797763,0.000000,0.000000,25711961771.797763,2337601,0,0,2337601
2014-05-02,NYSE Arca (P),265147767,202219537,173627182,640994486,11078410746.698370,13515498663.713877,7284541021.376044,31878450431.788291,2289865,587284,1224403,4101552
2014-05-02,NASDAQ (Q),435023589,132300421,502817384,1070141394,17829956726.662657,9805506175.066301,18722168280.146959,46357631181.875917,3572311,503335,3088484,7164130
2014-05-02,NASDAQ PSX (X),12864109,10059223,8507221,31430553,448264157.460000,675218306.484600,300434741.565001,1423917205.509601,96706,27635,49409,173750
2014-05-02,BATS BYX (Y),83505114,34837054,52003201,170345369,2886175631.010207,1958480441.065498,1948163749.616101,6792819821.691806,664217,143162,382655,1190034
2014-05-02,BATS BZX (Z),220849119,113033650,148055520,481938289,8054927494.066819,7498804652.459982,5320435095.662904,20874167242.189705,1771345,428806,1062763,3262914
2014-05-01,NYSE MKT (A),0,12754023,7051072,19805095,0.000000,67448164.841200,151234113.926900,218682278.768100,0,24232,31429,55661
2014-05-01,NASDAQ BX (B),101417219,28712559,57227891,187357669,3741229541.034691,1757166477.147699,2257455014.689801,7755851032.872191,822175,120361,471997,1414533
2014-05-01,NSX (C),5616799,2386911,5403716,13407426,170215638.441800,40242311.367500,114472848.031600,324930797.840900,53733,9411,35446,98590
2014-05-01,NYSE (DN),128297222,30313965,91822277,250433464,4774419935.954089,1614116473.741702,3511778952.909370,9900315362.605161,557547,95357,353504,1006408
2014-05-01,NASDAQ (DQ),1051812829,341154495,700725419,2093692743,36338479710.458002,19630881926.303894,22415113993.755405,78384475630.517301,4118384,643287,2303845,7065516
2014-05-01,ADF (D),33376746,9022101,20279974,62678821,1181722986.276502,415688038.878100,691196110.015400,2288607135.170002,187247,23400,115146,325793
2014-05-01,EDGA (J),83361234,33583029,51110066,168054329,2735342867.698602,2084740680.893403,1637850234.078192,6457933782.670197,704405,153739,415689,1273833
2014-05-01,EDGX (K),201644801,70707901,168381159,440733861,7124995807.228579,3899809838.608809,5794234571.185323,16819040217.022711,1155546,223519,801049,2180114
2014-05-01,CHX (M),16227531,7232653,5894914,29355098,651480743.426000,671585518.597400,406725566.937400,1729791828.960800,742,4563,766,6071
2014-05-01,NYSE (N),698772483,0,0,698772483,25606600396.244151,0.000000,0.000000,25606600396.244151,2410835,0,0,2410835
2014-05-01,NYSE Arca (P),284958575,188615691,186220487,659794753,12024768790.214252,13462781923.607943,7710260403.506865,33197811117.329060,2546612,551878,1298000,4396490
2014-05-01,NASDAQ (Q),473776071,112499602,558904442,1145180115,19625288506.305353,8577033521.182419,20599231022.094134,48801553049.581906,3952046,445795,3634777,8032618
2014-05-01,NASDAQ PSX (X),13554492,8930185,10028716,32513393,455662495.915000,657184898.950000,370455738.880000,1483303133.745000,96871,27329,59655,183855
2014-05-01,BATS BYX (Y),91614489,33009281,57364122,181987892,3092706019.525405,2122695556.420199,2088234757.399179,7303636333.344783,739535,144076,442626,1326237
2014-05-01,BATS BZX (Z),232714604,99420763,159683254,491818621,8398577336.802806,7110121648.059803,5852640568.357914,21361339553.220523,1855560,388715,1147774,3392049
2014-04-30,NYSE MKT (A),0,14120621,7469735,21590356,0.000000,81892558.406000,157427538.480000,239320096.886000,0,24242,33541,57783
2014-04-30,NASDAQ BX (B),108658357,28800621,57006711,194465689,4075319361.528117,1532563020.252698,2478043300.192534,8085925681.973349,864427,127779,466703,1458909
2014-04-30,NSX (C),8784549,1706340,5482768,15973657,242324229.576500,56192175.896200,130620412.571200,429136818.043900,71288,8247,37783,117318
2014-04-30,NYSE (DN),120725033,29844510,81397882,231967425,4591275070.096192,1533693829.564499,3363574153.602307,9488543053.262998,523374,89011,303647,916032
2014-04-30,NASDAQ (DQ),1154326020,347893182,737128540,2239347742,40037098189.494524,14962421203.615875,24558944255.684179,79558463648.794578,4155824,619949,2167998,6943771
2014-04-30,ADF (D),31590612,9542370,19035696,60168678,1186481214.800399,416562149.288300,705196167.107500,2308239531.196199,180912,24826,107451,313189
2014-04-30,EDGA (J),91934534,35926241,50348177,178208952,3085109908.020200,1899868826.104491,1765531991.099587,6750510725.224278,762245,154491,414755,1331491
2014-04-30,EDGX (K),209516314,73962230,175347998,458826542,7316005367.496972,3605126694.046494,6394136180.009407,17315268241.552873,1195843,223832,826379,2246054
2014-04-30,CHX (M),17545506,5533564,6431201,29510271,696933316.629000,550962449.976300,389303839.887700,1637199606.493000,783,3684,641,5108
2014-04-30,NYSE (N),908988498,0,0,908988498,34764895830.198750,0.000000,0.000000,34764895830.198750,2473389,0,0,2473389
2014-04-30,NYSE Arca (P),314634662,202918143,186950673,704503478,12896187329.765851,13859835767.812734,8113077774.823729,34869100872.402314,2586101,559349,1263807,4409257
2014-04-30,NASDAQ (Q),468335211,129278506,604518056,1202131773,19253508251.055317,9931286736.613492,23505249136.271722,52690044123.940531,3761795,488933,3382608,7633336
2014-04-30,CBSX (W),267093,2337962,337322,2942377,14194379.520000,165259262.680000,16201714.230000,195655356.430000,1411,132,1501,3044
2014-04-30,NASDAQ PSX (X),15158209,8544611,10553028,34255848,517213191.345000,585486591.505000,377962719.398800,1480662502.248800,102686,25149,64311,192146
2014-04-30,BATS BYX (Y),95202033,31686458,53169434,180057925,3274312878.909193,1816087332.606499,2139455311.001805,7229855522.517497,735137,140995,407851,1283983
2014-04-30,BATS BZX (Z),235958578,110308830,162374531,508641939,8253961527.010529,7330544180.115566,5891713829.457517,21476219536.583612,1781024,403563,1092514,3277101
2014-04-29,NYSE MKT (A),0,9312265,6836977,16149242,0.000000,50822148.376200,161324824.147000,212146972.523200,0,21935,30646,52581
2014-04-29,NASDAQ BX (B),107467850,25990888,53265627,186724365,3817306561.888386,1365618267.527400,2255699142.659696,7438623972.075482,811321,114973,419383,1345677
2014-04-29,NSX (C),7659613,1001672,6230395,14891680,212777399.141100,31599464.148000,110356691.081900,354733554.371000,60333,5148,34770,100251
2014-04-29,NYSE (DN),131610337,25815026,81314394,238739757,4628207278.706328,1402525984.049304,3360252729.137833,9390985991.893465,522711,79372,290961,893044
2014-04-29,NASDAQ (DQ),1155992223,237302934,644419655,2037714812,37537216791.689198,11810557678.850935,21339599651.332960,70687374121.873093,4009447,567029,2118753,6695229
2014-04-29,ADF (D),31824358,6824020,18421281,57069659,1078339204.769199,299263535.425000,678060091.067300,2055662831.261499,158441,18803,97428,274672
2014-04-29,EDGA (J),87602130,33784073,49258579,170644782,2866998081.128497,1774896926.368999,1718266361.604606,6360161369.102102,691634,148178,387925,1227737
2014-04-29,EDGX (K),227567981,61415470,176202557,465186008,7478283159.403409,3058116489.935293,6354585675.553909,16890985324.892611,1200414,196660,807023,2204097
2014-04-29,CHX (M),19019602,6021376,4697725,29738703,614600334.915300,652178568.153400,241029509.954600,1507808413.023300,856,2492,617,3965
2014-04-29,NYSE (N),739204544,0,0,739204544,26408948994.492105,0.000000,0.000000,26408948994.492105,2366553,0,0,2366553
2014-04-29,NYSE Arca (P),331609319,169430686,180013441,681053446,12188886441.528724,10621801661.915341,8067420032.337792,30878108135.781857,2370163,507740,1216421,4094324
2014-04-29,NASDAQ (Q),467560785,117591619,480876171,1066028575,18753486134.892343,9091974341.320193,20014915789.772809,47860376265.985345,3534741,460622,3184430,7179793
2014-04-29,CBSX (W),314305,1086946,245841,1647092,15125125.280000,84721632.880000,16289276.580000,116136034.740000,1867,168,2004,4039
2014-04-29,NASDAQ PSX (X),14282938,7453319,10544187,32280444,501266851.133000,471982713.462000,390734891.274600,1363984455.869600,100995,22254,61474,184723
2014-04-29,BATS BYX (Y),86525952,28995785,50167889,165689626,2914699468.303406,1626593605.214200,1929468780.759692,6470761854.277298,667512,125131,371619,1164262
2014-04-29,BATS BZX (Z),242173148,96515533,154145195,492833876,8097762163.149781,6404058046.077087,5683560615.194581,20185380824.421449,1781866,379119,1111919,3272904
2014-04-28,NYSE MKT (A),0,10656268,8286562,18942830,0.000000,81645677.489900,182328073.331001,263973750.820901,0,24641,37551,62192
2014-04-28,NASDAQ BX (B),121977197,33536545,63492203,219005945,4311241105.144990,1948025172.981089,3061313054.823082,9320579332.949161,867724,250941,485042,1603707
2014-04-28,NSX (C),7672670,2171080,6230832,16074582,231359746.425000,61685173.580700,156768943.636900,449813863.642600,64353,9609,39885,113847
2014-04-28,NYSE (DN),162443227,35011871,107989030,305444128,5937474242.696704,1923319423.360410,5047087395.605733,12907881061.662847,615110,96706,377711,1089527
2014-04-28,NASDAQ (DQ),1236399165,323063995,760564176,2320027336,42640874885.151726,17793470602.463873,29581692708.121244,90016038195.736843,4435633,691026,2600604,7727263
2014-04-28,ADF (D),38247517,10116064,22624761,70988342,1387687629.850499,528205537.804800,892983707.287500,2808876874.942799,207845,28597,124921,361363
2014-04-28,EDGA (J),100691930,39787700,60742376,201222006,3369864820.934986,2351137346.604006,2304868463.586005,8025870631.124997,762862,182036,451946,1396844
2014-04-28,EDGX (K),256744489,82273310,214588667,553606466,8878995972.605017,4560441611.659605,8854669197.426857,22294106781.691479,1354169,269840,1018007,2642016
2014-04-28,CHX (M),6642873,7750080,6857953,21250906,227910578.908600,788956710.550000,606760667.147000,1623627956.605600,1336,4870,1053,7259
2014-04-28,NYSE (N),821271072,0,0,821271072,31413100465.947081,0.000000,0.000000,31413100465.947081,2669145,0,0,2669145
2014-04-28,NYSE Arca (P),334185875,226145567,217625941,777957383,13868474481.950035,16449378071.930034,11034783446.760684,41352636000.640753,2529292,698051,1473000,4700343
2014-04-28,NASDAQ (Q),548869340,156456689,605584983,1310911012,22999539469.604743,11968697594.518347,26928999220.745932,61897236284.869022,4344208,707863,3932211,8984282
2014-04-28,CBSX (W),379149,796295,329358,1504802,16356416.970000,50053998.030000,20991005.840000,87401420.840000,1818,139,1861,3818
2014-04-28,NASDAQ PSX (X),19740200,11181036,13353378,44274614,707273830.160001,735509050.820000,506476043.652499,1949258924.632500,133476,32583,79763,245822
2014-04-28,BATS BYX (Y),108184646,38839002,64477674,211501322,3650907610.492983,2281259206.206898,2773378725.293788,8705545541.993669,797328,173715,460225,1431268
2014-04-28,BATS BZX (Z),278819059,135990556,202477299,617286914,10036142038.795016,9621786556.015204,8335442706.424054,27993371301.234274,2083861,534542,1370734,3989137
2014-04-25,NYSE MKT (A),0,11352164,7175950,18528114,0.000000,118238055.333300,162094809.988200,280332865.321500,0,21892,31973,53865
2014-04-25,NASDAQ BX (B),91623115,28381204,55766921,175771240,3437404437.000013,1498487512.773746,2416623181.935200,7352515131.708959,725805,167336,432116,1325257
2014-04-25,NSX (C),6238452,1724007,3864875,11827334,187916506.760000,47590028.875300,117967418.136000,353473953.771300,52301,8248,32109,92658
2014-04-25,NYSE (DN),116759714,29979952,85398952,232138618,4408592080.731899,1603204296.918198,3779974251.396775,9791770629.046872,460783,91254,326575,878612
2014-04-25,NASDAQ (DQ),959830360,280842825,664939484,1905612669,33520216717.273514,14224978428.727811,24754065458.412105,72499260604.413430,3777007,644054,2360616,6781677
2014-04-25,ADF (D),31637051,9634538,23700744,64972333,1188929204.426298,437048057.170200,858452517.872298,2484429779.468796,168516,28532,115033,312081
2014-04-25,EDGA (J),81839739,37320875,57562713,176723327,2863675297.960519,2035882890.521708,2302485003.263507,7202043191.745734,657879,159196,441881,1258956
2014-04-25,EDGX (K),200886362,75877783,196731869,473496014,6992575923.495005,3948956819.659906,7890312694.868614,18831845438.023525,1108297,239924,937058,2285279
2014-04-25,CHX (M),8849793,8629182,4372258,21851233,320935691.339400,687979685.020000,309931717.125400,1318847093.484800,1267,3221,1315,5803
2014-04-25,NYSE (N),694869934,0,0,694869934,26198095796.103736,0.000000,0.000000,26198095796.103736,2243835,0,0,2243835
2014-04-25,NYSE Arca (P),263353408,201900692,201219060,666473160,10983763716.529957,13216129947.480884,9553509689.844830,33753403353.855671,2115756,560965,1305392,3982113
2014-04-25,NASDAQ (Q),441086203,132691587,553835672,1127613462,18568328943.491855,9643927702.796603,23452812052.274904,51665068698.563362,3557175,547592,3430313,7535080
2014-04-25,CBSX (W),250959,2159934,272273,2683166,15683754.740000,82227735.230000,18196046.960000,116107536.930000,1676,183,1755,3614
2014-04-25,NASDAQ PSX (X),13803367,9013078,11776891,34593336,481053753.680000,599041109.440000,426772095.450000,1506866958.570000,94357,26911,68079,189347
2014-04-25,BATS BYX (Y),81984742,32053273,55615334,169653349,2823825760.990004,1800157496.122398,2101796910.119991,6725780167.232393,643591,138541,405377,1187509
2014-04-25,BATS BZX (Z),220397704,112710110,168214002,501321816,7887265123.035009,7630075371.758302,6661868689.634511,22179209184.427822,1686673,436035,1157737,3280445
2014-04-24,NYSE MKT (A),0,10416057,9445314,19861371,0.000000,52857750.648100,197380034.821100,250237785.469200,0,23418,39516,62934
2014-04-24,NASDAQ BX (B),92556787,26327024,57523800,176407611,3644561843.485017,1386805112.856097,2690222409.906478,7721589366.247592,764342,128729,439243,1332314
2014-04-24,NSX (C),7078650,2121693,4912579,14112922,213365409.755000,47334435.359800,98499023.439500,359198868.554300,60658,9192,31769,101619
2014-04-24,NYSE (DN),106482158,25661562,89432538,221576258,4474567041.921488,1345180003.705905,4461292774.421093,10281039820.048486,480735,79046,327287,887068
2014-04-24,NASDAQ (DQ),991700580,258934841,700033836,1950669257,36014634688.434467,12749947399.105574,27519452455.884739,76284034543.424780,3861065,587860,2425787,6874712
2014-04-24,ADF (D),30980461,9015959,24027986,64024406,1177871317.988601,418106445.296299,1097251942.880405,2693229706.165305,170059,25367,124865,320291
2014-04-24,EDGA (J),81360216,33125371,55718319,170203906,2832945846.175006,1682848514.129097,2251703716.149310,6767498076.453413,687912,145230,442778,1275920
2014-04-24,EDGX (K),197404911,65423840,180591988,443420739,7168540943.379968,3460417611.711202,7877383124.838591,18506341679.929761,1135774,217747,891774,2245295
2014-04-24,CHX (M),13038262,5810010,4467871,23316143,678272159.738600,528641953.143600,270284699.338000,1477198812.220200,1036,2699,1257,4992
2014-04-24,NYSE (N),661014729,0,0,661014729,25539617303.067871,0.000000,0.000000,25539617303.067871,2328307,0,0,2328307
2014-04-24,NYSE Arca (P),266995282,178432167,218244848,663672297,11843005918.985019,11743366990.311493,11385006894.385429,34971379803.681941,2205398,532548,1332102,4070048
2014-04-24,NASDAQ (Q),426704316,123534293,550799563,1101038172,18263654285.276964,9359776109.905043,25082587218.246452,52706017613.428459,3530401,508602,3419256,7458259
2014-04-24,CBSX (W),218868,685945,548866,1453679,15991699.560000,39194608.606200,31237988.420000,86424296.586200,1247,150,1855,3252
2014-04-24,NASDAQ PSX (X),10673875,8379790,13359468,32413133,385036981.865000,560692791.280000,482442564.875000,1428172338.020000,71532,27267,76695,175494
2014-04-24,BATS BYX (Y),88393651,29524857,53650027,171568535,3231655417.205005,1662107736.138101,2245136461.606401,7138899614.949507,733881,132673,396168,1262722
2014-04-24,BATS BZX (Z),219129695,103148192,171222625,493500512,8068003938.254981,6928150612.191108,7145592115.011857,22141746665.457946,1711773,405675,1174778,3292226
2014-04-23,NYSE MKT (A),0,10092026,7355775,17447801,0.000000,58266923.235800,175963210.654000,234230133.889800,0,23279,34722,58001
2014-04-23,NASDAQ BX (B),92929620,26375645,53593582,172898847,3670287176.270093,1323404600.082801,2376461104.804856,7370152881.157750,801973,108266,441755,1351994
2014-04-23,NSX (C),6538089,1969036,5577430,14084555,227968009.335000,38802355.934500,121205584.693900,387975949.963400,60094,8512,34064,102670
2014-04-23,NYSE (DN),107714644,24802976,75615705,208133325,4344085863.019171,1292919550.638205,3434845536.129527,9071850949.786903,491833,79335,287784,858952
2014-04-23,NASDAQ (DQ),993152790,263691995,603013240,1859858025,35342444205.811613,12176799718.083288,22206908643.296497,69726152567.191398,3733962,591170,2106260,6431392
2014-04-23,ADF (D),29188917,7938176,21617357,58744450,1120994824.549701,336695661.899800,861514837.503000,2319205323.952501,156800,21469,117013,295282
2014-04-23,EDGA (J),79244301,33330460,45368185,157942946,2788643525.395000,1613557867.889699,1728932320.743791,6131133714.028490,655999,141142,363343,1160484
2014-04-23,EDGX (K),184036102,59185495,152544822,395766419,6792089821.744984,2933104409.820809,6676237890.131785,16401432121.697578,1047195,189405,748666,1985266
2014-04-23,CHX (M),11245707,6912832,4950290,23108829,541167325.010700,444314786.800000,286914180.791500,1272396292.602200,759,2008,1118,3885
2014-04-23,NYSE (N),661727160,0,0,661727160,25454751994.180775,0.000000,0.000000,25454751994.180775,2114250,0,0,2114250
2014-04-23,NYSE Arca (P),250529431,159725852,175855434,586110717,11107348693.629914,9999510692.562990,9162531557.962535,30269390944.155439,2098254,474409,1187409,3760072
2014-04-23,NASDAQ (Q),390167510,104231734,473228863,967628107,16829381322.420140,7632050439.646504,21071226453.978469,45532658216.045113,3166432,407680,2953455,6527567
2014-04-23,CBSX (W),240060,5229194,440431,5909685,15392898.480000,317673868.930000,32334116.050000,365400883.460000,1569,289,2077,3935
2014-04-23,NASDAQ PSX (X),10468714,7976302,8874335,27319351,355473716.070000,528079867.339200,331898466.206000,1215452049.615200,70090,25548,50694,146332
2014-04-23,BATS BYX (Y),76685533,28723388,44744178,150153099,2803042922.807005,1508708091.144700,1796909237.818006,6108660251.769711,619999,120336,343338,1083673
2014-04-23,BATS BZX (Z),193648894,87314986,126514253,407478133,7022084136.379983,5517529808.145601,4871851687.286071,17411465631.811655,1512946,331730,902110,2746786
2014-04-22,NYSE MKT (A),0,11460553,8562589,20023142,0.000000,61661522.952900,196284401.778000,257945924.730900,0,24481,39031,63512
2014-04-22,NASDAQ BX (B),86863806,22946369,49517732,159327907,3403588030.045011,1279005162.610299,2141001105.001594,6823594297.656904,698341,104307,403367,1206015
2014-04-22,NSX (C),6728386,2542808,4088662,13359856,213143021.305000,45171911.396800,101166283.744800,359481216.446600,58101,9335,29969,97405
2014-04-22,NYSE (DN),116636751,25390355,82171888,224198994,4782007793.313665,1303183521.774511,3286894941.513528,9372086256.601704,477570,86714,301161,865445
2014-04-22,NASDAQ (DQ),1006484864,271131880,657198246,1934814990,36791163272.508998,13771957363.894124,23120656440.841790,73683777077.244912,3765869,615006,2199203,6580078
2014-04-22,ADF (D),31670105,9553477,21597449,62821031,1215871727.060599,405578492.827000,826323413.203400,2447773633.090999,155444,24021,107353,286818
2014-04-22,EDGA (J),81455836,30193170,47333845,158982851,2858322780.182502,1653310687.054797,1691673079.784099,6203306547.021398,660670,143630,368652,1172952
2014-04-22,EDGX (K),204582942,61950906,157399352,423933200,7508198740.125503,3112910812.262407,5946831724.364312,16567941276.752222,1120777,193481,750606,2064864
2014-04-22,CHX (M),17661788,8664002,3578829,29904619,516777969.002300,733308593.193000,469049647.428500,1719136209.623800,791,2559,863,4213
2014-04-22,NYSE (N),679288884,0,0,679288884,26563056082.213605,0.000000,0.000000,26563056082.213605,2160470,0,0,2160470
2014-04-22,NYSE Arca (P),263175034,156285005,170285693,589745732,12314524554.244890,10544482421.042677,7682448919.739065,30541455895.026632,2105878,488984,1179305,3774167
2014-04-22,NASDAQ (Q),417043112,100678803,486313358,1004035273,18947074226.675958,8045973887.872755,20152304631.552073,47145352746.100786,3341191,419078,2934164,6694433
2014-04-22,CBSX (W),238952,3275921,2782513,6297386,18174501.080000,225354667.950000,165526025.120000,409055194.150000,1578,281,1613,3472
2014-04-22,NASDAQ PSX (X),12202366,7061159,10248368,29511893,471773617.512001,484787672.190000,414420550.669600,1370981840.371601,88252,23647,66890,178789
2014-04-22,BATS BYX (Y),79802405,26481361,45929206,152212972,2954487099.962013,1555780212.845998,1744583143.283197,6254850456.091208,632202,119924,348475,1100601
2014-04-22,BATS BZX (Z),212512736,85722313,134607578,432842627,7744708592.129933,5935549465.335817,4949483606.188849,18629741663.654599,1622481,347198,959151,2928830
2014-04-21,NYSE MKT (A),0,11884185,6776510,18660695,0.000000,103214035.264700,156537243.825000,259751279.089700,0,24576,31137,55713
2014-04-21,NASDAQ BX (B),75583400,20146371,42798415,138528186,2671279114.859990,1031126828.586698,1563088332.740308,5265494276.186996,600125,94989,345519,1040633
2014-04-21,NSX (C),4798853,1824465,3030293,9653611,134819743.960000,24776518.839900,68752742.071100,228349004.871000,40679,6170,21504,68353
2014-04-21,NYSE (DN),88536584,22245427,76006148,186788159,3488546589.471691,1183051566.776206,2682086762.307452,7353684918.555349,392010,72443,246026,710479
2014-04-21,NASDAQ (DQ),795078359,232778645,499758636,1527615640,26259896528.757195,10819800436.180914,16124837332.823744,53204534297.761853,3096958,538914,1812230,5448102
2014-04-21,ADF (D),27216193,7490752,20568855,55275800,992897317.431999,347317381.780200,725196237.501399,2065410936.713598,121916,20652,90198,232766
2014-04-21,EDGA (J),68675943,23400860,38726778,130803581,2235344341.770005,1202013848.122299,1284510420.106694,4721868609.998998,560151,112206,320334,992691
2014-04-21,EDGX (K),167239569,51290033,130724967,349254569,5823041078.043569,2461910362.343693,4742539774.915200,13027491215.302462,905808,163852,632537,1702197
2014-04-21,CHX (M),6597895,8946699,3735694,19280288,287556869.877300,655729265.780000,241424627.090800,1184710762.748100,502,1731,577,2810
2014-04-21,NYSE (N),603402930,0,0,603402930,23877294503.761801,0.000000,0.000000,23877294503.761801,1907500,0,0,1907500
2014-04-21,NYSE Arca (P),202439952,156326189,145160158,503926299,8737680328.920021,10985172560.894220,6069454517.722120,25792307407.536361,1599418,454399,983536,3037353
2014-04-21,NASDAQ (Q),340282869,82939780,415107056,838329705,14673361142.682871,5831777530.018398,16533066102.873663,37038204775.574932,2771520,340246,2574289,5686055
2014-04-21,CBSX (W),135688,6021159,660329,6817176,14803954.290000,430977962.060000,39389022.710000,485170939.060000,1163,348,1523,3034
2014-04-21,NASDAQ PSX (X),10903820,6824921,10107350,27836091,400507316.465000,399545088.525000,382712959.855001,1182765364.845001,76594,19956,63365,159915
2014-04-21,BATS BYX (Y),70142342,21496349,36827069,128465760,2351824464.519003,1230916046.215700,1301628971.146797,4884369481.881500,552748,101585,279849,934182
2014-04-21,BATS BZX (Z),181900000,73241677,119306004,374447681,6292645346.290000,4814157376.296200,4041895064.195848,15148697786.782048,1393662,303801,851839,2549302
2014-04-17,NYSE MKT (A),0,10589615,7891532,18481147,0.000000,59077478.810600,180089271.524000,239166750.334600,0,22487,35912,58399
2014-04-17,NASDAQ BX (B),93130548,29488492,50253973,172873013,3493081741.869989,1605659781.499599,2229020532.387401,7327762055.756989,716299,125153,389999,1231451
2014-04-17,NSX (C),6347508,2565330,4449925,13362763,209364873.365000,56409980.073300,87932136.832600,353706990.270900,56048,9104,28703,93855
2014-04-17,NYSE (DN),97404970,25426463,69978392,192809825,4036583900.124608,1284869264.743002,2973102294.710413,8294555459.578023,443477,77949,266817,788243
2014-04-17,NASDAQ (DQ),991217170,327380283,659802661,1978400114,34515841620.603390,16849563434.901628,23695653826.955036,75061058882.460054,3726266,668158,2107532,6501956
2014-04-17,ADF (D),31058141,11323051,23786320,66167512,1199553739.554995,513308699.758400,899653547.460998,2612515986.774393,150732,26522,105292,282546
2014-04-17,EDGA (J),82817662,36842899,48892850,168553411,2954911002.835200,1886580743.191899,1819785863.171196,6661277609.198295,665764,159725,378144,1203633
2014-04-17,EDGX (K),196786059,71660247,147781189,416227495,7373411461.500009,3622390054.328768,5803903124.822072,16799704640.650849,1083305,218631,733794,2035730
2014-04-17,CHX (M),12226421,14418160,4810992,31455573,392564590.182000,1719642516.209600,373548635.523300,2485755741.914900,875,2560,1867,5302
2014-04-17,NYSE (N),833563612,0,0,833563612,33697660824.261731,0.000000,0.000000,33697660824.261731,2232722,0,0,2232722
2014-04-17,NYSE Arca (P),260348716,204978348,179763654,645090718,11711094187.045069,13591228560.055474,8449360875.395432,33751683622.495975,2012005,557400,1146951,3716356
2014-04-17,NASDAQ (Q),428305027,127829886,556400650,1112535563,18788493835.180099,8963504415.981302,22947076121.841133,50699074373.002534,3405311,493555,3006986,6905852
2014-04-17,CBSX (W),320498,2847438,428474,3596410,22157670.170000,154590272.889200,17087213.590000,193835156.649200,2161,151,1931,4243
2014-04-17,NASDAQ PSX (X),12706596,10224463,11103365,34034424,482297652.455000,666096524.450000,438901843.172199,1587296020.077199,89667,29494,70739,189900
2014-04-17,BATS BYX (Y),84879431,33723590,44104147,162707168,3085518789.420992,1822401363.968102,1792493180.660620,6700413334.049714,666015,144938,336210,1147163
2014-04-17,BATS BZX (Z),219978400,114052975,152236954,486268329,8036682900.824977,7514708600.281097,5941850431.184117,21493241932.290191,1653793,429360,1043495,3126648
2014-04-16,NYSE MKT (A),0,10637236,7145662,17782898,0.000000,66012288.008300,161429969.194000,227442257.202300,0,23932,33471,57403
2014-04-16,NASDAQ BX (B),93048923,31624570,53710855,178384348,3430666948.295012,1718097420.129600,2318958238.202597,7467722606.627209,722901,134938,415120,1272959
2014-04-16,NSX (C),6750388,2359603,5073887,14183878,236756458.900000,56930434.589500,100412051.914000,394098945.403500,59350,9489,32005,100844
2014-04-16,NYSE (DN),115238109,28677513,73729542,217645164,4233504554.576602,1564696466.447800,2892151695.256794,8690352716.281196,458140,89426,279077,826643
2014-04-16,NASDAQ (DQ),970916805,340623693,620551716,1932092214,33495953032.241583,17775906817.170390,21625359565.901243,72897219415.313216,3725449,664542,2112114,6502105
2014-04-16,ADF (D),32585211,9554834,22873993,65014038,1222622662.335001,473881569.160600,849526516.987899,2546030748.483500,170243,26055,109558,305856
2014-04-16,EDGA (J),85260041,42102200,51211664,178573905,2977792922.557000,2074663329.318604,1830437409.710991,6882893661.586595,679144,171796,395260,1246200
2014-04-16,EDGX (K),212347879,69229340,155891104,437468323,7609839854.333411,3616236933.293405,6003094052.623402,17229170840.250218,1179947,225122,797565,2202634
2014-04-16,CHX (M),9909472,12248573,3370935,25528980,389977913.929600,1162862662.796600,223820491.205600,1776661067.931800,1019,2632,1349,5000
2014-04-16,NYSE (N),675156942,0,0,675156942,25805111122.463920,0.000000,0.000000,25805111122.463920,2256546,0,0,2256546
2014-04-16,NYSE Arca (P),219861057,200742919,132503359,553107335,9354151714.825033,13837626820.120515,6529453690.656833,29721232225.602381,1749608,590905,817828,3158341
2014-04-16,NASDAQ (Q),419336796,126168085,510789674,1056294555,18102119033.473913,9049920830.319915,21063739984.069937,48215779847.863765,3432990,513009,3252608,7198607
2014-04-16,CBSX (W),239727,8806702,697582,9744011,17190042.110000,538008153.323500,34602803.690000,589800999.123500,1546,315,2415,4276
2014-04-16,NASDAQ PSX (X),12639777,8991939,11752269,33383985,509508646.444999,616391666.367000,497165089.283800,1623065402.095799,90533,26165,78533,195231
2014-04-16,BATS BYX (Y),83747514,34909635,46697228,165354377,2997510445.609997,1950977835.113505,1829700459.683995,6778188740.407497,649028,156369,351395,1156792
2014-04-16,BATS BZX (Z),231971225,118400227,169494742,519866194,8632723922.516301,7967985631.579101,6312087963.785757,22912797517.881159,1803352,451026,1199974,3454352
2014-04-15,NYSE MKT (A),0,15954969,9309037,25264006,0.000000,79067125.769800,187888503.241000,266955629.010800,0,32063,36602,68665
2014-04-15,NASDAQ BX (B),110145540,49496516,66394436,226036492,3860048106.135016,2599604450.933900,2727231358.167901,9186883915.236817,844250,208951,496922,1550123
2014-04-15,NSX (C),8411295,3365373,4788293,16564961,257999962.435000,75803179.616400,125505037.289300,459308179.340700,75454,13033,38511,126998
2014-04-15,NYSE (DN),131689867,44888538,100755740,277334145,4708256853.099781,2385056391.247608,3827579513.708701,10920892758.056090,529728,129329,346741,1005798
2014-04-15,NASDAQ (DQ),1063441572,445051345,773609949,2282102866,35230827156.671256,22322994355.775826,24460467777.286183,82014289289.733265,4068304,894376,2466912,7429592
2014-04-15,ADF (D),37015445,18531059,30726005,86272509,1258222264.369897,845885267.961800,1054438228.059000,3158545760.390697,185844,41766,144994,372604
2014-04-15,EDGA (J),98153513,67832249,61262124,227247886,3198406735.731006,3125167196.807197,2158006746.055299,8481580678.593502,792478,264053,476579,1533110
2014-04-15,EDGX (K),237037419,114906444,202521601,554465464,8130224345.886429,5881819263.148217,6848669347.568399,20860712956.603045,1336460,367629,944128,2648217
2014-04-15,CHX (M),8579331,10145968,6519129,25244428,306823311.921000,866364286.614300,457826210.230000,1631013808.765300,1602,5611,1570,8783
2014-04-15,NYSE (N),789261849,0,0,789261849,29347015447.278866,0.000000,0.000000,29347015447.278866,2758883,0,0,2758883
2014-04-15,NYSE Arca (P),334272245,322804253,243653378,900729876,13906954205.495007,20586015087.216966,10617188851.519250,45110158144.231223,2777528,890636,1561434,5229598
2014-04-15,NASDAQ (Q),538227260,210384022,637214990,1385826272,21789938774.396877,14897897884.084924,24689031800.302686,61376868458.784487,4419713,869515,4153499,9442727
2014-04-15,CBSX (W),595419,2129722,381437,3106578,20934056.610000,126129860.910000,25078452.630000,172142370.150000,2430,285,2532,5247
2014-04-15,NASDAQ PSX (X),16153829,14140947,15705838,46000614,580621479.520000,994687561.796200,660510702.398699,2235819743.714899,112920,42263,99540,254723
2014-04-15,BATS BYX (Y),98426059,53438690,58972770,210837519,3332515386.436004,3019369117.153804,2249081784.702890,8600966288.292698,761796,229470,438626,1429892
2014-04-15,BATS BZX (Z),272536998,188672846,204901547,666111391,9379227374.240004,12127873617.605378,7464858338.684717,28971959330.530099,2057695,718768,1374321,4150784
2014-04-14,NYSE MKT (A),0,13804865,8170546,21975411,0.000000,88298638.268100,189961232.310000,278259870.578100,0,27460,38098,65558
2014-04-14,NASDAQ BX (B),87430343,30227775,52121480,169779598,3247508142.589943,1689521037.230998,2103159283.417602,7040188463.238543,725773,133211,409287,1268271
2014-04-14,NSX (C),6310692,2875323,3603274,12789289,205899145.475000,56562064.789100,93917125.580400,356378335.844500,55628,9859,30533,96020
2014-04-14,NYSE (DN),116947148,30550670,76325805,223823623,4426821638.205751,1690915054.808902,2749689121.767809,8867425814.782462,506830,91657,290288,888775
2014-04-14,NASDAQ (DQ),869709229,313241989,594885120,1777836338,29915029795.238513,17408663199.755051,18692289903.234743,66015982898.228307,3564071,658443,2057964,6280478
2014-04-14,ADF (D),32302587,11310623,25955202,69568412,1168242540.195000,477400622.449200,896774696.272299,2542417858.916499,180556,28802,127939,337297
2014-04-14,EDGA (J),82736008,42533325,50004641,175273974,2725433056.080001,2159611430.732500,1726650691.655597,6611695178.468098,688011,176509,421653,1286173
2014-04-14,EDGX (K),207339890,81258488,157428648,446027026,7441988651.610008,4318071694.441400,5434820528.971003,17194880875.022411,1199472,268710,787949,2256131
2014-04-14,CHX (M),6550311,10037567,4245015,20832893,201606478.995000,898552428.451800,202842851.576800,1303001759.023600,1292,3891,1504,6687
2014-04-14,NYSE (N),691506640,0,0,691506640,26505514920.308076,0.000000,0.000000,26505514920.308076,2341760,0,0,2341760
2014-04-14,NYSE Arca (P),265025935,206982655,179069661,651078251,10998958933.200081,14830076880.553961,7827204780.159114,33656240593.913156,2169965,615438,1220058,4005461
2014-04-14,NASDAQ (Q),424753500,134082179,520489995,1079325674,17828052624.467922,9970467409.660632,20045054159.540546,47843574193.669100,3531712,560861,3237981,7330554
2014-04-14,CBSX (W),262429,4996527,390080,5649036,15442283.370000,396096028.010000,26211079.320000,437749390.700000,1555,310,2100,3965
2014-04-14,NASDAQ PSX (X),13505197,8536418,11698405,33740020,526599670.395000,632412680.529000,477902789.959500,1636915140.883500,101582,26223,80897,208702
2014-04-14,BATS BYX (Y),85734827,38841662,48504535,173081024,2915223304.655012,2266651675.662201,1740141028.158106,6922016008.475319,667777,164043,362339,1194159
2014-04-14,BATS BZX (Z),221656993,123532786,160743119,505932898,7979415665.444983,8806287232.634720,5652179917.854891,22437882815.934594,1736308,481660,1110906,3328874
2014-04-11,NYSE MKT (A),0,13854107,7893998,21748105,0.000000,91210249.956300,173283551.341000,264493801.297300,0,26112,31858,57970
2014-04-11,NASDAQ BX (B),110751846,41850556,66473617,219076019,4018609707.669974,2284064576.810397,2838690969.602769,9141365254.083140,864301,179852,505111,1549264
2014-04-11,NSX (C),7199355,2397461,4264330,13861146,247583203.570000,73030691.295100,115754198.072200,436368092.937300,65323,10075,33048,108446
2014-04-11,NYSE (DN),142546376,37600535,92763970,272910881,5326786692.777916,2150238306.192714,3796236062.243450,11273261061.214080,548324,113500,337882,999706
2014-04-11,NASDAQ (DQ),1057027535,386891228,696185990,2140104753,36296622291.749336,21030369339.853866,24754813176.784847,82081804808.388049,4177298,791318,2424764,7393380
2014-04-11,ADF (D),38227040,13511923,28675679,80414642,1383241483.861699,647616872.004100,974637520.877195,3005495876.742994,213430,35319,140469,389218
2014-04-11,EDGA (J),96873306,48245298,60502355,205620959,3297934366.149994,2652819183.997396,2306903166.646705,8257656716.794095,780141,207407,471557,1459105
2014-04-11,EDGX (K),240142552,100093049,178393104,518628705,8588104796.629989,5694902569.980296,6782195649.644300,21065203016.254585,1393972,335868,916231,2646071
2014-04-11,CHX (M),13599706,11379445,4337517,29316668,628739391.294200,975580011.209900,373776933.708800,1978096336.212900,1592,5852,1557,9001
2014-04-11,NYSE (N),815145946,0,0,815145946,31120299798.782272,0.000000,0.000000,31120299798.782272,2593700,0,0,2593700
2014-04-11,NYSE Arca (P),330176037,281942360,222812382,834930779,13459251189.150034,19818402148.757401,10461602198.359491,43739255536.266926,2566202,796481,1428483,4791166
2014-04-11,NASDAQ (Q),532807398,182362187,638509499,1353679084,21609503532.883938,13827273983.328018,26296305920.528671,61733083436.740627,4196270,712842,3799949,8709061
2014-04-11,CBSX (W),421504,3954833,234085,4610422,13333474.410000,280496491.440000,15160601.670000,308990567.520000,1919,239,1927,4085
2014-04-11,NASDAQ PSX (X),15630600,12484721,13895145,42010466,567306899.895000,871510440.214000,556368942.214300,1995186282.323300,111237,35520,81372,228129
2014-04-11,BATS BYX (Y),100246901,44090483,57234593,201571977,3553390823.750002,2550433860.195602,2249112267.876504,8352936951.822108,778515,192892,420817,1392224
2014-04-11,BATS BZX (Z),267853855,165541524,197117324,630512703,9331997668.950077,11990318323.828798,7539852718.858730,28862168711.637605,1998992,616843,1309286,3925121
2014-04-10,NYSE MKT (A),0,12667522,8808190,21475712,0.000000,72669723.934100,180761324.073000,253431048.007100,0,27383,35980,63363
2014-04-10,NASDAQ BX (B),109787186,43638131,72385263,225810580,4105843419.095009,2403073008.316398,2859459555.685901,9368375983.097308,857313,187209,517858,1562380
2014-04-10,NSX (C),8603639,2837696,5008602,16449937,290692475.140000,67035263.312000,128950574.063100,486678312.515100,69968,11883,37176,119027
2014-04-10,NYSE (DN),118125558,38577093,105584634,262287285,4552101854.725233,2229281085.905491,4043934483.052363,10825317423.683087,491805,113885,337125,942815
2014-04-10,NASDAQ (DQ),1053084358,396321760,760131178,2209537296,37540786731.330061,23072390999.552159,26087856772.385677,86701034503.267897,4059713,806376,2516669,7382758
2014-04-10,ADF (D),37077547,16544544,30975541,84597632,1319887755.920898,763491650.178699,1149505177.948098,3232884584.047695,190153,38151,150179,378483
2014-04-10,EDGA (J),104868483,49346322,67695583,221910388,3676121274.084978,2532614898.476593,2506072273.713125,8714808446.274696,847112,208474,514597,1570183
2014-04-10,EDGX (K),262949079,112830907,197810045,573590031,9441340488.815009,5968063332.405751,7236119398.245963,22645523219.466723,1472890,364565,1002483,2839938
2014-04-10,CHX (M),10044622,12099462,5567091,27711175,358763108.994000,1079267151.819000,358170448.040800,1796200708.853800,1668,4601,1886,8155
2014-04-10,NYSE (N),802445776,0,0,802445776,30562796867.591752,0.000000,0.000000,30562796867.591752,2646008,0,0,2646008
2014-04-10,NYSE Arca (P),330208679,280722971,232596852,843528502,13610687519.474996,19696741237.794251,10531783052.932638,43839211810.201885,2602379,770593,1486425,4859397
2014-04-10,NASDAQ (Q),530131790,182447025,652725273,1365304088,22010908540.812962,13462248661.320833,26668512252.635153,62141669454.768948,4236870,709362,4038891,8985123
2014-04-10,CBSX (W),369513,2077216,307050,2753779,18840640.050000,140812640.470000,19279856.130000,178933136.650000,2179,253,2177,4609
2014-04-10,NASDAQ PSX (X),16453031,13005528,15052421,44510980,593643492.730000,864569334.393000,555272632.998802,2013485460.121802,119942,36923,87029,243894
2014-04-10,BATS BYX (Y),112465869,46571721,62778909,221816499,4055856134.275992,2719752183.567108,2417201483.787704,9192809801.630804,859134,204448,447124,1510706
2014-04-10,BATS BZX (Z),265287649,172624437,211822413,649734499,9523521894.360046,12397614020.671215,7740910456.614790,29662046371.646051,2012650,609369,1371405,3993424
2014-04-09,NYSE MKT (A),0,13785791,8103540,21889331,0.000000,77069490.240700,172556981.765000,249626472.005700,0,26597,35229,61826
2014-04-09,NASDAQ BX (B),88532649,32836253,53543377,174912279,3137821619.505000,1704061848.174901,2076272426.509011,6918155894.188912,712473,139881,394304,1246658
2014-04-09,NSX (C),6392922,3107363,4460735,13961020,217406250.630000,49544325.985700,106248648.082999,373199224.698699,55346,9798,31872,97016
2014-04-09,NYSE (DN),111452914,29567355,80404975,221425244,4166203100.488316,1537085712.769199,3322596405.467151,9025885218.724666,485041,89138,285382,859561
2014-04-09,NASDAQ (DQ),1020228404,335517873,667675065,2023421342,35586721457.263315,17066941893.318514,22522524979.517308,75176188330.099137,3844273,645528,2170624,6660425
2014-04-09,ADF (D),36672170,12327025,27325115,76324310,1310469293.390004,505336906.046100,1053395757.656401,2869201957.092505,193758,29434,126528,349720
2014-04-09,EDGA (J),89179655,38517988,53744872,181442515,2974104213.259990,1937443994.178699,2039089042.482385,6950637249.921074,729291,163118,411126,1303535
2014-04-09,EDGX (K),216370299,80664264,153709922,450744485,7935431638.914981,3938682399.248499,6011966219.960104,17886080258.123584,1265876,244520,807801,2318197
2014-04-09,CHX (M),9807462,6587710,4713566,21108738,403555750.569600,533894924.920000,303800715.055000,1241251390.544600,1584,3915,1318,6817
2014-04-09,NYSE (N),703002854,0,0,703002854,26901505538.061920,0.000000,0.000000,26901505538.061920,2288808,0,0,2288808
2014-04-09,NYSE Arca (P),285137145,215784131,185122856,686044132,11841308030.659932,13765197542.437443,8463952043.866223,34070457616.963598,2280352,607246,1239555,4127153
2014-04-09,NASDAQ (Q),441583329,130316915,501327437,1073227681,18150446661.443109,8536394954.883126,21074057970.802676,47760899587.128911,3487360,479055,3075167,7041582
2014-04-09,CBSX (W),405868,2871406,340015,3617289,17588369.290000,172284789.230000,27207964.430000,217081122.950000,2353,244,2126,4723
2014-04-09,NASDAQ PSX (X),14053402,8598673,9811265,32463340,532369442.275000,541837271.205000,374383039.325000,1448589752.805000,107683,25882,60759,194324
2014-04-09,BATS BYX (Y),89288664,36534590,49871771,175695025,3111419932.399009,2005956132.815601,1872632946.274704,6990009011.489314,710405,161372,355497,1227274
2014-04-09,BATS BZX (Z),226651670,121386469,162436112,510474251,7935230235.579977,7877551698.032698,6124304696.146319,21937086629.758994,1747765,423808,1098346,3269919
2014-04-08,NYSE MKT (A),0,11157128,7918617,19075745,0.000000,75208613.596900,173094783.736000,248303397.332900,0,25322,34539,59861
2014-04-08,NASDAQ BX (B),104138701,38249504,58223143,200611348,3815099553.710008,1968295452.385101,2378738545.032001,8162133551.127110,814890,162608,447855,1425353
2014-04-08,NSX (C),6966226,2671203,4767788,14405217,235975270.755000,70054189.193500,122719947.323400,428749407.271900,64607,11484,34988,111079
2014-04-08,NYSE (DN),126222253,34598071,98509814,259330138,5028279202.888532,1852022841.061307,3814991672.950136,10695293716.899975,516761,102977,319382,939120
2014-04-08,NASDAQ (DQ),1141727195,353498207,726438215,2221663617,39380476062.325378,17416632326.978695,24461681353.179914,81258789742.483987,4198832,707581,2392416,7298829
2014-04-08,ADF (D),39697726,13554405,29454177,82706308,1500782568.514397,680668669.848600,1099743165.821600,3281194404.184597,219444,32013,143380,394837
2014-04-08,EDGA (J),101488927,47251705,61232145,209972777,3421531998.240005,2244459136.469600,2052860418.372201,7718851553.081806,819061,202544,456728,1478333
2014-04-08,EDGX (K),238952769,89740306,174726010,503419085,8749290779.675002,4638754938.964986,6528593045.555057,19916638764.195045,1391021,297468,905625,2594114
2014-04-08,CHX (M),13691867,8447121,7669994,29808982,504873156.739400,699979988.320000,447963593.813000,1652816738.872400,1205,3686,1341,6232
2014-04-08,NYSE (N),749094926,0,0,749094926,28476276055.787225,0.000000,0.000000,28476276055.787225,2483110,0,0,2483110
2014-04-08,NYSE Arca (P),321937230,242069249,208230762,772237241,13292221955.795036,15665975940.523692,9550474234.277801,38508672130.596529,2560421,682661,1390715,4633797
2014-04-08,NASDAQ (Q),506107428,146670484,573494807,1226272719,21221071574.231736,10398771989.966807,23083817409.423855,54703660973.622398,3980428,578341,3539263,8098032
2014-04-08,CBSX (W),518830,1076563,461278,2056671,21459536.710000,61495827.960000,20124033.320000,103079397.990000,2485,270,2664,5419
2014-04-08,NASDAQ PSX (X),16490111,9317570,11910649,37718330,624630101.215000,628779629.010000,468961493.943900,1722371224.168900,124167,30010,72269,226446
2014-04-08,BATS BYX (Y),98854942,41523219,54734849,195113010,3541738340.077004,2254661063.481503,2020708153.033991,7817107556.592498,789660,180831,394770,1365261
2014-04-08,BATS BZX (Z),261412477,137536102,185692969,584641548,9225662674.257976,9339946283.352036,6764267896.077493,25329876853.687505,1984232,504657,1251830,3740719
2014-04-07,NYSE MKT (A),0,13764024,7727587,21491611,0.000000,83398284.432700,162314250.574000,245712535.006700,0,28734,33121,61855
2014-04-07,NASDAQ BX (B),108933735,40373885,70633390,219941010,4067605416.410010,2194161805.769300,2998656619.275798,9260423841.455108,874920,169633,533953,1578506
2014-04-07,NSX (C),6907304,2894999,4838076,14640379,227302002.930000,70681880.903100,131869891.776400,429853775.609500,63164,11078,39017,113259
2014-04-07,NYSE (DN),137684925,39619956,110720247,288025128,5302969501.761330,2172346873.054697,4485275417.484727,11960591792.300754,596043,116823,391407,1104273
2014-04-07,NASDAQ (DQ),1121053635,367181680,830608115,2318843430,39561818911.380324,18840551551.298431,30109614605.400650,88511985068.079405,4350645,786888,2740122,7877655
2014-04-07,ADF (D),40818405,16081684,33757498,90657587,1489241467.327399,780802272.677400,1267309026.727694,3537352766.732493,213136,40777,171970,425883
2014-04-07,EDGA (J),105617430,45995298,71552198,223164926,3598015340.994992,2432199761.276498,2538073217.617691,8568288319.889181,849364,196480,550425,1596269
2014-04-07,EDGX (K),240064673,99254557,200465093,539784323,8891877165.320038,5245012259.865204,7226870353.732441,21363759778.917683,1380755,315310,1019048,2715113
2014-04-07,CHX (M),13231695,6022021,5856141,25109857,490883641.362200,573901282.950000,277375131.529000,1342160055.841200,838,3645,1940,6423
2014-04-07,NYSE (N),835926223,0,0,835926223,32522582397.903898,0.000000,0.000000,32522582397.903898,2594705,0,0,2594705
2014-04-07,NYSE Arca (P),317072459,252897049,244012722,813982230,13606186742.750117,17502262341.481151,11142931559.683219,42251380643.914487,2600529,783023,1556822,4940374
2014-04-07,NASDAQ (Q),500674455,165048537,691928606,1357651598,21203348551.849761,12191389749.973309,29041932980.204045,62436671282.027115,4045866,670727,4116065,8832658
2014-04-07,CBSX (W),568670,2142228,671471,3382369,21721446.680000,104769298.190000,32595214.360000,159085959.230000,2295,357,2626,5278
2014-04-07,NASDAQ PSX (X),16678201,12414238,14474643,43567082,658124436.965000,822864243.905000,582948449.479998,2063937130.349998,130361,37052,84168,251581
2014-04-07,BATS BYX (Y),100470151,42657944,61097580,204225675,3598999885.711013,2552500295.496801,2369789951.231529,8521290132.439343,813499,194501,463853,1471853
2014-04-07,BATS BZX (Z),259786373,155214601,213668315,628669289,9399078579.940058,11107279148.610619,7886490412.307917,28392848140.858594,2008368,586509,1421031,4015908
2014-04-04,NYSE MKT (A),0,12486506,8299972,20786478,0.000000,77011903.641700,181136500.807000,258148404.448700,0,26217,36466,62683
2014-04-04,NASDAQ BX (B),101790593,44468215,69623490,215882298,3921418941.450004,2555954763.941304,3111595428.947595,9588969134.338903,810619,194986,518706,1524311
2014-04-04,NSX (C),6901453,2207848,5227098,14336399,229562314.165000,70353575.298100,140100694.679400,440016584.142500,61998,9898,40503,112399
2014-04-04,NYSE (DN),122197959,38744222,109264839,270207020,4854509936.155894,2220023426.480998,4691556019.839631,11766089382.476523,517719,112037,359933,989689
2014-04-04,NASDAQ (DQ),1046943969,397634848,851487345,2296066162,36113816348.803167,22941834228.582571,33520128277.492247,92575778854.877985,3899172,791168,2687749,7378089
2014-04-04,ADF (D),43979135,15263590,34935968,94178693,1533676747.342498,814759493.983800,1375403599.522899,3723839840.849197,210815,41101,171813,423729
2014-04-04,EDGA (J),103815501,53818521,74008335,231642357,3576792479.370005,2818155041.612396,2773400686.462117,9168348207.444518,829243,220351,566286,1615880
2014-04-04,EDGX (K),258746477,113416154,221710375,593873006,9266324595.034999,6350142574.153391,8581951805.365194,24198418974.553584,1430008,354269,1123061,2907338
2014-04-04,CHX (M),6955085,13013870,5427760,25396715,281293735.847000,1147909888.940000,327758136.516500,1756961761.303500,922,4552,2171,7645
2014-04-04,NYSE (N),781049344,0,0,781049344,30286331870.135008,0.000000,0.000000,30286331870.135008,2588475,0,0,2588475
2014-04-04,NYSE Arca (P),314259710,304379102,248417593,867056405,13087043285.785062,21261519981.743914,12161835281.634590,46510398549.163566,2482673,860499,1614674,4957846
2014-04-04,NASDAQ (Q),487476664,195354652,696674651,1379505967,20646598696.918929,15076142699.226087,30494384788.717318,66217126184.862334,4003281,753912,4313482,9070675
2014-04-04,CBSX (W),409724,715203,629427,1754354,19065352.780000,60380686.730000,40624710.240000,120070749.750000,2548,262,2921,5731
2014-04-04,NASDAQ PSX (X),17206550,14179952,15661447,47047949,666055460.995000,957609603.680000,630078408.880001,2253743473.555001,130181,39136,93881,263198
2014-04-04,BATS BYX (Y),94677646,48327939,63759768,206765353,3312073560.149009,2896223378.288505,2584862881.542720,8793159819.980234,749770,219286,453774,1422830
2014-04-04,BATS BZX (Z),249485163,181567500,219522623,650575286,8953401937.245017,13132800618.370231,8983970676.392063,31070173232.007311,1949159,645527,1502683,4097369
2014-04-03,NYSE MKT (A),0,10878233,8079344,18957577,0.000000,64982427.247300,170246940.785000,235229368.032300,0,25750,32504,58254
2014-04-03,NASDAQ BX (B),85310115,29497595,55379879,170187589,3264137878.595002,1546647943.290499,2205223854.025612,7016009675.911113,719810,128187,437103,1285100
2014-04-03,NSX (C),5737576,1616545,4628099,11982220,201552079.315000,37824364.440500,104953659.701700,344330103.457200,52070,7538,32657,92265
2014-04-03,NYSE (DN),107809609,27983099,85729821,221522529,4219521927.084085,1343996415.590901,3373604938.820420,8937123281.495406,468699,83366,304741,856806
2014-04-03,NASDAQ (DQ),955658586,273740634,714897148,1944296368,35613580986.575057,12813855847.604057,24041984351.653925,72469421185.833039,3648609,620587,2278794,6547990
2014-04-03,ADF (D),32403722,11711530,29766666,73881918,1186504035.957498,405113180.459500,994898338.585592,2586515555.002590,168510,27395,135060,330965
2014-04-03,EDGA (J),83747736,36936318,55510988,176195042,2813663433.279994,1799361139.275698,1766166062.699799,6379190635.255491,673399,155920,408756,1238075
2014-04-03,EDGX (K),186701769,72085362,173675069,432462200,7103434274.859976,3287259742.434405,5996089803.283907,16386783820.578288,1077899,218752,822398,2119049
2014-04-03,CHX (M),6481691,5610495,3980957,16073143,231429214.936700,442807887.720000,233473207.892800,907710310.549500,954,2932,949,4835
2014-04-03,NYSE (N),660836332,0,0,660836332,25972708470.392566,0.000000,0.000000,25972708470.392566,2089210,0,0,2089210
2014-04-03,NYSE Arca (P),255402024,196680928,194295377,646378329,10796654554.374901,12305372623.801244,8089874662.974627,31191901841.150772,2060330,526338,1245945,3832613
2014-04-03,NASDAQ (Q),383986521,114299943,525593985,1023880449,16350056575.840015,7817285268.298814,20941653401.505724,45108995245.644553,3032211,443483,3076358,6552052
2014-04-03,CBSX (W),782131,5049286,435452,6266869,22271109.170000,417381269.820000,28967579.640000,468619958.630000,1586,321,2094,4001
2014-04-03,NASDAQ PSX (X),12955577,8089538,10314649,31359764,530237444.720000,500176793.430000,377497830.010002,1407912068.160002,104340,24127,65742,194209
2014-04-03,BATS BYX (Y),78540931,31485700,47622285,157648916,2813420716.824997,1701484308.139901,1698063318.092713,6212968343.057611,636160,143872,354690,1134722
2014-04-03,BATS BZX (Z),201707393,108028863,162746930,472483186,7199849237.870022,7274836964.377500,5912801012.983957,20387487215.231479,1559643,379929,1113227,3052799
2014-04-02,NYSE MKT (A),0,13946197,8488469,22434666,0.000000,81491977.629700,186545423.491000,268037401.120700,0,29921,38201,68122
2014-04-02,NASDAQ BX (B),86212943,28981332,56694650,171888925,3296353793.740001,1547107645.825900,2031616545.889805,6875077985.455706,715577,133338,413224,1262139
2014-04-02,NSX (C),5518681,1953549,5501618,12973848,191704417.375000,34898438.043900,86434819.704399,313037675.123299,51088,8609,31433,91130
2014-04-02,NYSE (DN),108350501,30220982,93612541,232184024,4102557931.045028,1362002424.701900,3105988838.730620,8570549194.477548,469245,88203,305088,862536
2014-04-02,NASDAQ (DQ),1020499757,302055783,818445226,2141000766,35858250716.250098,14743285579.991113,22832966217.865473,73434502514.106684,3748041,645110,2232882,6626033
2014-04-02,ADF (D),33121758,11982726,30426334,75530818,1193897367.217199,439565084.112000,861660905.462002,2495123356.791201,167100,28409,119338,314847
2014-04-02,EDGA (J),83631979,34726493,53548972,171907444,2748987613.055006,1677887325.141200,1537633564.678498,5964508502.874704,667959,155291,379887,1203137
2014-04-02,EDGX (K),199829446,75975564,186171379,461976389,7404614672.215037,3463897184.113206,5750028434.545865,16618540290.874108,1137408,231408,804211,2173027
2014-04-02,CHX (M),11124623,11899161,5042395,28066179,436893686.863300,724944976.274000,195651298.980300,1357489962.117600,836,2520,972,4328
2014-04-02,NYSE (N),653104689,0,0,653104689,25131058708.187713,0.000000,0.000000,25131058708.187713,2050146,0,0,2050146
2014-04-02,NYSE Arca (P),260439903,193287282,196186657,649913842,10895946505.094920,11953750927.648832,7780261515.578630,30629958948.322382,2080766,547411,1204361,3832538
2014-04-02,NASDAQ (Q),383463873,111458182,516302251,1011224306,16119271217.969178,7756363579.136391,19054435127.024801,42930069924.130370,2997908,458467,2858779,6315154
2014-04-02,CBSX (W),351893,2066856,332148,2750897,18066606.070000,85483444.500000,23569565.420000,127119615.990000,1565,484,2097,4146
2014-04-02,NASDAQ PSX (X),13059404,8043547,11412606,32515557,527215498.080000,485148765.025000,356130933.935000,1368495197.040000,102342,24550,62418,189310
2014-04-02,BATS BYX (Y),78244916,29649645,46421435,154315996,2660697230.741001,1558290870.293201,1489972116.809911,5708960217.844113,640781,138472,334065,1113318
2014-04-02,BATS BZX (Z),203532100,98040442,160744854,462317396,7152526586.614924,6852836536.664592,5324691133.687600,19330054256.967116,1552573,378906,1048948,2980427
2014-04-01,NYSE MKT (A),0,13701879,9352052,23053931,0.000000,79545867.287900,203754787.880000,283300655.167900,0,27710,39279,66989
2014-04-01,NASDAQ BX (B),89091905,31477082,56118866,176687853,3358542195.649995,1757235086.205595,2146985789.039994,7262763070.895584,726626,132284,433169,1292079
2014-04-01,NSX (C),5974375,2308652,4597664,12880691,200610974.735000,43857114.868500,96385026.228300,340853115.831800,51630,9338,32782,93750
2014-04-01,NYSE (DN),121898107,35736416,92833247,250467770,4837858654.718934,1780557155.075600,3434274912.384925,10052690722.179459,548659,108294,326299,983252
2014-04-01,NASDAQ (DQ),1053446016,329453968,744054012,2126953996,38109299666.685242,17818522077.828724,23466705348.825373,79394527093.339339,3870687,715676,2237321,6823684
2014-04-01,ADF (D),32302738,13030713,28589491,73922942,1157742349.760100,627452826.944001,888277692.256602,2673472868.960703,166746,31960,121017,319723
2014-04-01,EDGA (J),88892486,35131077,58478091,182501654,2912804367.614996,1807807279.549403,1766891182.676703,6487502829.841102,724592,148609,421480,1294681
2014-04-01,EDGX (K),215275146,80306999,176950312,472532457,7921344845.559974,3959205986.945606,5922092379.484070,17802643211.989650,1208462,243938,825333,2277733
2014-04-01,CHX (M),14737042,10919760,3511861,29168663,412072331.915400,784178560.310000,210871952.351600,1407122844.577000,940,3046,1266,5252
2014-04-01,NYSE (N),723557854,0,0,723557854,28694062073.908914,0.000000,0.000000,28694062073.908914,2207998,0,0,2207998
2014-04-01,NYSE Arca (P),286015774,216136476,205320608,707472858,12111047553.304990,14106932741.335319,8424749061.193486,34642729355.833795,2253298,567512,1293961,4114771
2014-04-01,NASDAQ (Q),405845689,117802943,559356236,1083004868,17398129919.135974,8330888007.556489,21727353697.618801,47456371624.311264,3158305,459837,3131860,6750002
2014-04-01,CBSX (W),417890,4261826,472428,5152144,20292845.950000,321511035.850000,33354400.650000,375158282.450000,2026,423,2572,5021
2014-04-01,NASDAQ PSX (X),13221086,7955377,10683236,31859699,479987910.720000,504577892.500000,375717115.785000,1360282919.005000,102174,24603,59121,185898
2014-04-01,BATS BYX (Y),81905440,32093857,48580872,162580169,2713837183.289004,1697218236.697798,1666742408.778196,6077797828.764998,643748,141784,355219,1140751
2014-04-01,BATS BZX (Z),207899732,108776637,165714505,482390874,7289199230.674998,7502769135.074203,5714641510.215537,20506609875.964738,1549983,392871,1058227,3001081
2014-03-31,NYSE MKT (A),0,16087106,7065169,23152275,0.000000,90261165.690500,144580439.592000,234841605.282500,0,26973,30787,57760
2014-03-31,NASDAQ BX (B),102529286,38845107,59230804,200605197,3748386381.854996,1994064800.187702,2161514969.928877,7903966151.971575,813666,154151,467522,1435339
2014-03-31,NSX (C),8863594,3492492,5892973,18249059,235109360.955000,104725146.023700,115151246.255100,454985753.233800,69431,13221,40816,123468
2014-03-31,NYSE (DN),119285218,34199454,87007541,240492213,4200466086.781413,1672989247.140605,2858705996.320317,8732161330.242335,501872,98479,307380,907731
2014-03-31,NASDAQ (DQ),967125319,357292312,725368329,2049785960,33737825346.038435,17736715144.009046,20708185412.586056,72182725902.633537,3534620,689491,2078767,6302878
2014-03-31,ADF (D),26465691,10321564,20750534,57537789,1040333137.789999,505408071.025200,701640302.904899,2247381511.720098,157315,28527,109470,295312
2014-03-31,EDGA (J),82910869,42449679,50196577,175557125,2661200158.880007,2116180095.732099,1484908558.852393,6262288813.464499,649377,165211,369748,1184336
2014-03-31,EDGX (K),208855992,82309849,175684575,466850416,7703686452.930011,4202414824.541908,5371217286.401222,17277318563.873141,1172645,259725,790237,2222607
2014-03-31,CHX (M),6908801,7047618,3127250,17083669,238497535.187000,650212692.700200,170914130.599800,1059624358.487000,610,4206,808,5624
2014-03-31,NYSE (N),846955304,0,0,846955304,32713473487.789833,0.000000,0.000000,32713473487.789833,2127657,0,0,2127657
2014-03-31,NYSE Arca (P),252423646,232041699,177916153,662381498,10515506588.540005,14808893157.958227,7038667057.152874,32363066803.651106,1934197,612008,1113399,3659604
2014-03-31,NASDAQ (Q),362604825,126607054,580700915,1069912794,15675480994.852089,8923270579.569869,20965520541.374522,45564272115.796480,2891697,494647,2840628,6226972
2014-03-31,CBSX (W),394464,3841889,618103,4854456,18083189.310000,283835750.460000,39319467.790000,341238407.560000,1706,646,2247,4599
2014-03-31,NASDAQ PSX (X),13179308,7767295,9582602,30529205,472253027.915000,482400625.150000,328283703.686600,1282937356.751600,96078,24954,57267,178299
2014-03-31,BATS BYX (Y),67476148,30150217,36430708,134057073,2308083325.353982,1557813044.995902,1269672150.523699,5135568520.873583,527314,123453,266979,917746
2014-03-31,BATS BZX (Z),207731011,126872339,154469951,489073301,7186016839.954979,8423604629.359189,5257699156.061620,20867320625.375788,1537662,447322,1058482,3043466
2014-03-28,NYSE MKT (A),0,14030022,7051344,21081366,0.000000,70318628.117200,118725145.743000,189043773.860200,0,28496,25670,54166
2014-03-28,NASDAQ BX (B),93296484,35418587,57991612,186706683,3381516250.515014,1841596326.864502,2496037533.817401,7719150111.196917,752368,151596,453853,1357817
2014-03-28,NSX (C),8230911,2611811,5258299,16101021,237656453.940000,51448574.509400,131108270.496400,420213298.945800,66771,9851,39484,116106
2014-03-28,NYSE (DN),109403301,30813287,91948235,232164823,4005290489.561271,1543808998.515101,3242269108.797606,8791368596.873978,463943,89861,297782,851586
2014-03-28,NASDAQ (DQ),890379406,326415396,702206915,1919001717,30842140269.835501,15927834103.601283,21010811378.008778,67780785751.445562,3340290,645055,2059290,6044635
2014-03-28,ADF (D),30149765,9350343,22222204,61722312,1104752589.448701,496484250.678300,777279782.970599,2378516623.097600,164664,25348,116640,306652
2014-03-28,EDGA (J),81629299,39485799,54500345,175615443,2713595323.974997,1913446391.998302,1849194283.750503,6476235999.723802,656647,170087,411846,1238580
2014-03-28,EDGX (K),200914055,81184292,173006430,455104777,7249895568.467501,3895384242.076499,5777886337.875451,16923166148.419451,1110803,253267,788522,2152592
2014-03-28,CHX (M),10099942,9571869,3933613,23605424,384762158.019000,927267604.967200,218819010.885800,1530848773.872000,728,4241,1189,6158
2014-03-28,NYSE (N),639415215,0,0,639415215,23592532408.131920,0.000000,0.000000,23592532408.131920,2024979,0,0,2024979
2014-03-28,NYSE Arca (P),254178346,205926807,191825677,651930830,10434585711.637361,13053949979.352549,8324072014.620235,31812607705.610145,1969816,572716,1178621,3721153
2014-03-28,NASDAQ (Q),398571045,126214236,509854199,1034639480,16381396346.559063,8549995448.114487,19375443215.205521,44306835009.879071,3055705,482793,2976411,6514909
2014-03-28,CBSX (W),320308,1831889,357859,2510056,17078634.010000,67865053.208900,20565221.700000,105508908.918900,1496,646,2140,4282
2014-03-28,NASDAQ PSX (X),12175240,9363087,10115441,31653768,460911104.210000,629451116.470000,356773294.358600,1447135515.038600,92808,28900,60633,182341
2014-03-28,BATS BYX (Y),61447519,29793705,38473945,129715169,2119341859.994006,1543373225.520900,1407952420.733000,5070667506.247906,489384,126120,274127,889631
2014-03-28,BATS BZX (Z),196819493,126168647,163223304,486211444,6786377458.425898,8541564242.946601,5693507467.462128,21021449168.834627,1470376,447731,1068114,2986221
2014-03-27,NYSE MKT (A),0,14608118,8020611,22628729,0.000000,70192914.079400,147880479.174000,218073393.253400,0,31006,29514,60520
2014-03-27,NASDAQ BX (B),117087109,41672021,64456273,223215403,4190963562.408204,2169407794.635799,2680507692.854197,9040879049.898200,902283,169765,503838,1575886
2014-03-27,NSX (C),13458269,3044177,7149434,23651880,388097302.646000,52912221.544400,174022572.652901,615032096.843301,103667,10700,51420,165787
2014-03-27,NYSE (DN),122198446,37524159,99710198,259432803,4616157474.226824,1811021275.459398,3891898565.663970,10319077315.350192,528967,104290,336899,970156
2014-03-27,NASDAQ (DQ),1097529963,363830067,758239711,2219599741,37084502259.032610,17577367009.523874,25018500153.100532,79680369421.657016,3977882,713127,2385195,7076204
2014-03-27,ADF (D),38810430,13333708,31236297,83380435,1374088784.214998,537548320.375900,1047746365.490900,2959383470.081798,196483,30019,144473,370975
2014-03-27,EDGA (J),98402218,52730137,58498615,209630970,3123324571.540004,2399807991.473501,1864357852.979784,7387490415.993289,741087,201211,435078,1377376
2014-03-27,EDGX (K),242907116,98152000,185630001,526689117,8565998387.762389,4746662295.058201,6720423610.689487,20033084293.510077,1326482,306873,949789,2583144
2014-03-27,CHX (M),9522680,14618481,4177332,28318493,291667162.378600,1356351154.200100,218432825.172000,1866451141.750700,943,4762,1174,6879
2014-03-27,NYSE (N),793837398,0,0,793837398,28821169417.955281,0.000000,0.000000,28821169417.955281,2487144,0,0,2487144
2014-03-27,NYSE Arca (P),330825796,267725515,220244136,818795447,13375316028.427075,17729326247.259214,10531989174.552942,41636631450.239231,2448097,716107,1403967,4568171
2014-03-27,NASDAQ (Q),528115622,169956934,586448066,1284520622,21832035863.599554,12588115948.594370,23555389874.066607,57975541686.260531,3945316,658862,3630489,8234667
2014-03-27,CBSX (W),517511,7452898,361358,8331767,20074221.650000,538690330.520000,21917515.330000,580682067.500000,2382,472,2175,5029
2014-03-27,NASDAQ PSX (X),16310224,11999592,11446181,39755997,618757341.750000,808357370.165000,468995849.334999,1896110561.249999,116093,34561,70298,220952
2014-03-27,BATS BYX (Y),76307789,36538643,42202783,155049215,2557954002.566997,1863456968.332800,1594276260.605615,6015687231.505412,584545,149031,303437,1037013
2014-03-27,BATS BZX (Z),267799432,160526578,196620788,624946798,9139501209.082061,11021302157.353599,7139362676.577021,27300166043.012681,1917781,564184,1277171,3759136
2014-03-26,NYSE MKT (A),0,19771824,7071587,26843411,0.000000,79478379.903100,136782022.742000,216260402.645100,0,37354,24979,62333
2014-03-26,NASDAQ BX (B),104771216,42197547,65202474,212171237,3832759228.759980,2122463979.167303,2650760844.988397,8605984052.915680,833116,179223,495646,1507985
2014-03-26,NSX (C),12501475,4317275,7021431,23840181,351798499.995000,76691085.255800,156780307.301300,585269892.552100,99093,15810,51840,166743
2014-03-26,NYSE (DN),117906836,40637959,116142369,274687164,4292253868.371604,1907582060.231798,3866398737.087432,10066234665.690834,505475,107061,360345,972881
2014-03-26,NASDAQ (DQ),1071322500,397473997,880556288,2349352785,36591021777.147526,18421072500.693845,25546283816.700840,80558378094.542211,3803070,752335,2466737,7022142
2014-03-26,ADF (D),40138431,16136743,34519946,90795120,1469883758.685199,655708128.198800,1024321638.964102,3149913525.848101,208648,37056,140149,385853
2014-03-26,EDGA (J),87860399,47134669,59419745,194414813,2882681621.731002,2306330262.875197,1865376340.429393,7054388225.035592,712612,200295,429480,1342387
2014-03-26,EDGX (K),237046400,109537113,208978342,555561855,8466360567.878781,4978491230.343189,6701263562.205533,20146115360.427503,1296943,306683,948862,2552488
2014-03-26,CHX (M),7895393,11669125,5149591,24714109,326441786.023600,905557785.530000,516502866.904900,1748502438.458500,1249,3211,1528,5988
2014-03-26,NYSE (N),752027985,0,0,752027985,28101709804.398940,0.000000,0.000000,28101709804.398940,2238680,0,0,2238680
2014-03-26,NYSE Arca (P),298903344,264592090,221529972,785025406,12408551442.114949,16584770409.019616,9087706308.538427,38081028159.672992,2431520,735204,1349240,4515964
2014-03-26,NASDAQ (Q),478565605,166829804,603901043,1249296452,19868966990.108447,11586691830.760838,22974184203.113399,54429843023.982684,3655682,638876,3489721,7784279
2014-03-26,CBSX (W),491457,4484069,425307,5400833,16320705.910000,271027482.624500,30036796.150000,317384984.684500,2156,583,2572,5311
2014-03-26,NASDAQ PSX (X),14442614,10676567,11940418,37059599,567510753.655000,723953407.112500,444793770.010600,1736257930.778100,109069,32237,69839,211145
2014-03-26,BATS BYX (Y),71014315,38163583,44762058,153939956,2429839728.590008,1982943597.921698,1566162737.663202,5978946064.174908,562224,156354,316434,1035012
2014-03-26,BATS BZX (Z),244330630,152699993,193225020,590255643,8348570227.775011,10584679719.721613,6530795004.425620,25464044951.922244,1819821,549319,1286830,3655970
2014-03-25,NYSE MKT (A),0,15383547,6829075,22212622,0.000000,67437658.579800,117024001.179000,184461659.758800,0,29153,25712,54865
2014-03-25,NASDAQ BX (B),100317270,38616952,63289738,202223960,3829111888.355415,1952965052.118500,2480390930.346680,8262467870.820595,796008,161364,452210,1409582
2014-03-25,NSX (C),13000480,3583039,8420682,25004201,379531008.129300,53402815.698800,154570215.419100,587504039.247200,100321,12928,51204,164453
2014-03-25,NYSE (DN),110344595,32840313,100284637,243469545,4168315053.829736,1595918577.207005,3207399120.141110,8971632751.177851,488159,93274,303836,885269
2014-03-25,NASDAQ (DQ),1003711444,338603494,834036463,2176351401,35824127709.793236,15096621828.145710,23760501827.848377,74681251365.787323,3671428,700015,2271612,6643055
2014-03-25,ADF (D),33519905,13446428,33953653,80919986,1266556677.724600,482936865.228100,932297035.727700,2681790578.680400,176091,27726,125106,328923
2014-03-25,EDGA (J),85381495,42257173,57688394,185327062,2834841211.795394,2055038440.378698,1699758894.370798,6589638546.544890,673911,178802,388428,1241141
2014-03-25,EDGX (K),199460236,90148456,200691358,490300050,7753445876.814221,4251264724.023292,6369063678.836918,18373774279.674431,1153801,267618,859918,2281337
2014-03-25,CHX (M),9825576,10899993,4250025,24975594,415175709.852500,823867939.420000,517076843.579600,1756120492.852100,1025,3111,1053,5189
2014-03-25,NYSE (N),645000536,0,0,645000536,24923870943.071815,0.000000,0.000000,24923870943.071815,2081993,0,0,2081993
2014-03-25,NYSE Arca (P),267970771,241859139,196190201,706020111,11703863208.045582,15235594452.771140,8598227873.371718,35537685534.188440,2160630,650704,1191954,4003288
2014-03-25,NASDAQ (Q),438117340,141917934,536484593,1116519867,18914503369.183848,9884943947.244385,21240855272.609417,50040302589.037650,3392093,558876,3089709,7040678
2014-03-25,CBSX (W),310167,2227431,1569942,4107540,17000332.340000,155572427.558000,72852774.700000,245425534.598000,1864,272,2388,4524
2014-03-25,NASDAQ PSX (X),14668280,8496529,12227326,35392135,581969133.059999,556152927.100000,447500275.430000,1585622335.589999,108733,25877,61697,196307
2014-03-25,BATS BYX (Y),68984350,33711550,43529886,146225786,2483710923.075503,1805623701.071500,1530684662.721901,5820019286.868904,554439,141352,288045,983836
2014-03-25,BATS BZX (Z),217133992,137694909,177392714,532221615,7866239787.545009,9248663604.448028,6011012026.422273,23125915418.415310,1641031,463823,1129920,3234774
2014-03-24,NYSE MKT (A),0,21270695,6266170,27536865,0.000000,83389015.213600,116441438.000000,199830453.213600,0,39464,26608,66072
2014-03-24,NASDAQ BX (B),105933465,45455587,65643605,217032657,3945456597.195417,2305960630.278796,2862723672.559593,9114140900.033806,824614,195700,485901,1506215
2014-03-24,NSX (C),12488371,6123247,7263804,25875422,320787732.827800,82302381.828500,169676288.964700,572766403.621000,94481,19932,54022,168435
2014-03-24,NYSE (DN),115790854,37274198,99301716,252366768,4248637722.878610,1711966966.544199,3831861351.964997,9792466041.387806,501383,97116,340714,939213
2014-03-24,NASDAQ (DQ),1000179984,405342504,867953595,2273476083,34383438001.039930,17828942410.185532,29563811682.757738,81776192093.983200,3802306,840356,2612869,7255531
2014-03-24,ADF (D),38348531,19303822,35831311,93483664,1382286623.807500,619050186.805701,1127529990.225999,3128866800.839200,201507,39867,148985,390359
2014-03-24,EDGA (J),86761691,48503642,59011974,194277307,2831582506.069698,2311358630.499799,2005393474.048396,7148334610.617893,679988,201545,433217,1314750
2014-03-24,EDGX (K),210076608,111002879,190999970,512079457,7582847513.223843,5007966770.387006,7212942490.189428,19803756773.800277,1187630,319118,957586,2464334
2014-03-24,CHX (M),12164674,7340998,4668963,24174635,377751975.033500,646985481.813500,203592944.847100,1228330401.694100,792,3242,1320,5354
2014-03-24,NYSE (N),729513573,0,0,729513573,28225475147.769130,0.000000,0.000000,28225475147.769130,2246309,0,0,2246309
2014-03-24,NYSE Arca (P),287750327,281736073,211058794,780545194,12297629753.212001,17647219624.363340,9940393265.891404,39885242643.466745,2309820,767067,1390947,4467834
2014-03-24,NASDAQ (Q),486008434,162402149,638009303,1286419886,20556698312.212267,11823758628.285600,26665979253.492903,59046436193.990770,3771250,654009,3712931,8138190
2014-03-24,CBSX (W),393800,11249158,598097,12241055,14804459.890000,861730530.190000,32663046.390000,909198036.470000,1733,532,2245,4510
2014-03-24,NASDAQ PSX (X),15467407,11123407,12640357,39231171,590441868.470000,748034396.053000,541946403.320000,1880422667.843000,110442,34507,70434,215383
2014-03-24,BATS BYX (Y),70604731,37533664,44205234,152343629,2419073325.281006,1985673643.347703,1726594970.203502,6131341938.832211,552880,161275,309638,1023793
2014-03-24,BATS BZX (Z),238147740,156257400,194254164,588659304,8195141137.990013,10768208264.180559,7382823453.960114,26346172856.130686,1766757,567257,1284321,3618335
2014-03-21,NYSE MKT (A),0,63010792,6406643,69417435,0.000000,341651538.706000,115354007.499000,457005546.205000,0,40083,24688,64771
2014-03-21,NASDAQ BX (B),126969063,44449814,74438965,245857842,4741844832.359627,2264120914.743604,3098966695.904545,10104932443.007776,950704,181905,552296,1684905
2014-03-21,NSX (C),13154205,5533827,7180564,25868596,335634853.377000,97183438.457800,153781324.518400,586599616.353200,97480,19826,51829,169135
2014-03-21,NYSE (DN),124102289,37277972,95127564,256507825,4499083394.010483,1601781102.286299,3417649464.582738,9518513960.879520,540529,97356,336607,974492
2014-03-21,NASDAQ (DQ),1398125344,450943269,1054885798,2903954411,46684562257.550765,21725067255.054201,34004518533.693875,102414148046.298841,4071012,753266,2445136,7269414
2014-03-21,ADF (D),41527753,19263646,35635013,96426412,1435194766.809603,698154019.237501,1074490413.981396,3207839200.028500,195704,37144,137326,370174
2014-03-21,EDGA (J),103000719,50508982,64917235,218426936,3395254193.732006,2442212778.152107,2100417886.098095,7937884857.982208,777811,198375,456730,1432916
2014-03-21,EDGX (K),242581160,112118390,192194284,546893834,8851509895.332542,5003172238.933889,6749018656.610058,20603700790.876489,1327056,310185,908002,2545243
2014-03-21,CHX (M),8923087,13916284,5608281,28447652,331258052.017300,1130048122.530001,394254220.779100,1855560395.326401,1570,3971,1618,7159
2014-03-21,NYSE (N),2002842479,0,0,2002842479,83614234290.286461,0.000000,0.000000,83614234290.286461,2565264,0,0,2565264
2014-03-21,NYSE Arca (P),325773972,291716664,209573964,827064600,13570611164.947135,19033189691.653869,9793040286.138254,42396841142.739258,2414224,754771,1305217,4474212
2014-03-21,NASDAQ (Q),553394421,163978404,1258479623,1975852448,23145545494.313629,11739881553.792002,50309511035.922554,85194938084.028185,4048000,640170,3700885,8389055
2014-03-21,CBSX (W),434363,1387737,566325,2388425,19591569.740000,50262638.384900,33366462.690000,103220670.814900,2183,361,2863,5407
2014-03-21,NASDAQ PSX (X),17942972,11169839,13319271,42432082,697743790.875000,734602864.367000,534655630.640000,1967002285.882000,126172,33838,72014,232024
2014-03-21,BATS BYX (Y),82021717,38278809,47731501,168032027,2895379338.656593,2082941904.556797,1697453959.340500,6675775202.553890,631947,152192,324994,1109133
2014-03-21,BATS BZX (Z),268597479,157387599,184760251,610745329,9461138513.764880,10961667076.371108,6863064085.320597,27285869675.456585,1941169,535061,1212084,3688314
2014-03-20,NYSE MKT (A),0,23925071,5957532,29882603,0.000000,102877459.075900,104635506.866000,207512965.941900,0,44158,22273,66431
2014-03-20,NASDAQ BX (B),107451281,40155833,52954938,200562052,3902562990.009994,1926032436.685602,2211328591.409698,8039924018.105294,847601,167714,418430,1433745
2014-03-20,NSX (C),11941067,6030739,7526435,25498241,327860539.770800,85775298.464400,120633523.874700,534269362.109900,93376,15049,43755,152180
2014-03-20,NYSE (DN),125853566,39700958,80794904,246349428,4572308176.509097,1537979266.486001,2752144619.914418,8862432062.909516,529758,102372,278275,910405
2014-03-20,NASDAQ (DQ),1058585842,403260020,662990834,2124836696,34295443512.951398,16380282300.252995,19763104733.980702,70438830547.185095,3631295,748330,1929484,6309109
2014-03-20,ADF (D),40951837,25323625,27987196,94262658,1359237670.390301,530744251.184700,845688607.792401,2735670529.367402,190972,41759,109120,341851
2014-03-20,EDGA (J),91923094,48351365,48296836,188571295,2904715631.657190,2115083761.976204,1541080468.690797,6560879862.324191,691302,189940,350907,1232149
2014-03-20,EDGX (K),219588193,115401797,156530846,491520836,7704378303.397418,4061632962.983910,5042755472.420289,16808766738.801617,1148362,282049,723287,2153698
2014-03-20,CHX (M),11927960,16404732,6054408,34387100,482855826.314200,956845960.718200,398116979.000200,1837818766.032600,989,3956,953,5898
2014-03-20,NYSE (N),632864540,0,0,632864540,22980278143.545435,0.000000,0.000000,22980278143.545435,1963787,0,0,1963787
2014-03-20,NYSE Arca (P),278133374,243668329,161770994,683572697,11038408480.971955,14388644111.716272,6729040843.855980,32156093436.544207,2067296,656950,1036896,3761142
2014-03-20,NASDAQ (Q),454890896,148384624,456223440,1059498960,18425142039.613432,9799934641.691585,17114032845.405644,45339109526.710661,3346439,545169,2632495,6524103
2014-03-20,CBSX (W),343312,3678954,363955,4386221,15624637.320000,271073969.735200,21770403.450000,308469010.505200,2054,576,2040,4670
2014-03-20,NASDAQ PSX (X),15581039,14254606,10776045,40611690,604666310.111400,672787268.875000,436293539.985900,1713747118.972300,111071,31128,60876,203075
2014-03-20,BATS BYX (Y),70593303,34646034,33553291,138792628,2454494724.190002,1748187311.502999,1225048079.919696,5427730115.612697,554126,136937,243664,934727
2014-03-20,BATS BZX (Z),225195648,130859397,139657528,495712573,7650848685.363376,8125240849.749317,4751223583.780001,20527313118.892694,1608774,460005,927546,2996325
2014-03-19,NYSE MKT (A),0,21462737,7693620,29156357,0.000000,104160765.780100,144743039.177000,248903804.957100,0,43035,29948,72983
2014-03-19,NASDAQ BX (B),104465648,45856971,54153931,204476550,3762570274.665010,2257304447.460698,2041456804.136298,8061331526.262006,815836,203482,418185,1437503
2014-03-19,NSX (C),12150142,4267332,7122380,23539854,312060618.350700,74363268.079000,127744306.520600,514168192.950300,92845,13219,47555,153619
2014-03-19,NYSE (DN),116756196,41121696,79650580,237528472,4121839931.689277,1823413925.895598,2712445185.009159,8657699042.594034,477662,109776,278286,865724
2014-03-19,NASDAQ (DQ),987613788,427510729,700114969,2115239486,31987400383.267887,25373439990.950315,19983492371.210126,77344332745.428328,3523433,814840,2019332,6357605
2014-03-19,ADF (D),39638221,22791370,33521020,95950611,1337582001.064000,649104394.413900,905286046.960301,2891972442.438201,185774,43580,122486,351840
2014-03-19,EDGA (J),85573252,52800321,48550739,186924312,2718681092.134692,2462727963.534201,1500809716.066595,6682218771.735488,660769,220178,354654,1235601
2014-03-19,EDGX (K),217693737,120884366,173960599,512538702,7680500384.388986,5121150487.625397,5556934412.199714,18358585284.214097,1177253,336118,771297,2284668
2014-03-19,CHX (M),7445286,17510511,3504878,28460675,304137220.967100,1739310461.890000,252860913.797000,2296308596.654100,843,6963,1138,8944
2014-03-19,NYSE (N),663902983,0,0,663902983,25112476342.393052,0.000000,0.000000,25112476342.393052,2072382,0,0,2072382
2014-03-19,NYSE Arca (P),274683223,292700177,179572648,746956048,11226281690.620852,18277335182.607756,7591995742.081716,37095612615.310324,2187120,804995,1146587,4138702
2014-03-19,NASDAQ (Q),455677180,182550689,507723453,1145951322,18730526032.612181,12584330634.958718,19131479843.869485,50446336511.440384,3585498,709197,2897172,7191867
2014-03-19,CBSX (W),880473,3876332,303791,5060596,31576482.590000,269503203.530000,22221418.250000,323301104.370000,1986,603,1964,4553
2014-03-19,NASDAQ PSX (X),14632165,13263117,11259621,39154903,550692607.790000,812978020.628000,437857149.731000,1801527778.149000,106455,37260,61424,205139
2014-03-19,BATS BYX (Y),69788015,39996927,37233781,147018723,2384065531.599800,1957442510.444703,1296153668.880302,5637661710.924805,545612,163665,255436,964713
2014-03-19,BATS BZX (Z),238112381,162649438,154462939,555224758,8244049313.718035,10765803405.653323,5373718413.123114,24383571132.494472,1773224,571183,1014257,3358664
2014-03-18,NYSE MKT (A),0,14410974,7233192,21644166,0.000000,68623221.928000,129761672.686000,198384894.614000,0,30734,27668,58402
2014-03-18,NASDAQ BX (B),96161911,36722609,55173815,188058335,3366084661.150011,1827368992.252200,2186464079.812795,7379917733.215006,781957,172202,439699,1393858
2014-03-18,NSX (C),9755252,2609916,6432096,18797264,271294979.700000,37443506.828100,121774545.222200,430513031.750300,79454,10062,42759,132275
2014-03-18,NYSE (DN),105569750,32229218,84873738,222672706,3819910805.987476,1454204304.357002,2755613493.982395,8029728604.326873,464697,96298,283531,844526
2014-03-18,NASDAQ (DQ),945000062,312835511,734702154,1992537727,31273841730.794742,15166635754.942529,20401127609.664360,66841605095.401631,3519025,703742,2143692,6366459
2014-03-18,ADF (D),33610360,12305875,33649715,79565950,1143561673.317600,454854028.819200,813153960.967102,2411569663.103902,163095,29677,115767,308539
2014-03-18,EDGA (J),77022728,40967226,48466644,166456598,2398359192.098390,2028442731.639301,1456854936.396301,5883656860.133992,608473,183099,363153,1154725
2014-03-18,EDGX (K),187995842,77589540,167011162,432596544,6741560319.887299,3719184994.432300,5057165460.143085,15517910774.462684,1032018,248479,749668,2030165
2014-03-18,CHX (M),11490616,12756424,3936624,28183664,383475424.415600,927583922.131500,628440500.753500,1939499847.300600,802,2792,998,4592
2014-03-18,NYSE (N),585684314,0,0,585684314,21318278436.012011,0.000000,0.000000,21318278436.012011,1829042,0,0,1829042
2014-03-18,NYSE Arca (P),228819097,211852144,159991183,600662424,9271141537.801050,13540450821.008465,6286686192.064703,29098278550.874218,1802203,594978,1029394,3426575
2014-03-18,NASDAQ (Q),385325278,122064868,478808137,986198283,16120822012.509835,8709030385.737669,17574957196.248698,42404809594.496202,3019157,492697,2671632,6183486
2014-03-18,CBSX (W),299178,3261797,318240,3879215,12956165.230000,102425451.640000,21100926.210000,136482543.080000,1595,553,2216,4364
2014-03-18,NASDAQ PSX (X),12161968,8054905,9647521,29864394,463422390.830400,497203376.772000,347918889.718800,1308544657.321200,96191,26524,60005,182720
2014-03-18,BATS BYX (Y),62219981,29131066,36340916,127691963,2127413869.645899,1498776514.859302,1217989425.185304,4844179809.690505,501321,128101,257698,887120
2014-03-18,BATS BZX (Z),190849108,109787130,139741056,440377294,6624127900.988903,7323867195.824412,4721920819.059996,18669915915.873311,1463713,411667,942246,2817626
2014-03-17,NYSE MKT (A),0,16109199,7211711,23320910,0.000000,79100638.043900,119677824.280000,198778462.323900,0,33227,28350,61577
2014-03-17,NASDAQ BX (B),89597579,34566005,50780488,174944072,3261634247.595005,1720675726.755099,2047334688.253910,7029644662.604014,738112,157656,412376,1308144
2014-03-17,NSX (C),9653667,1838083,5086840,16578590,261823417.700000,34585413.435000,108422255.288900,404831086.423900,77253,8156,36849,122258
2014-03-17,NYSE (DN),99306897,29903418,76493080,205703395,3674792028.515112,1496488532.948102,2907889523.528929,8079170084.992143,453301,91195,283834,828330
2014-03-17,NASDAQ (DQ),857106198,317364113,635636543,1810106854,28353882624.496841,14433936405.396839,18714117199.314148,61501936229.207828,3463836,677858,2074876,6216570
2014-03-17,ADF (D),34598917,13816872,30876199,79291988,1229464609.520100,534747406.165400,888251401.665595,2652463417.351095,178888,30527,124803,334218
2014-03-17,EDGA (J),72335868,39506375,44743920,156586163,2347618903.045007,1987468643.557501,1508371397.361899,5843458943.964407,592340,174445,349042,1115827
2014-03-17,EDGX (K),184002190,78587449,157443600,420033239,6678716462.804998,3795886548.581501,5225005381.788837,15699608393.175336,1039784,249514,751496,2040794
2014-03-17,CHX (M),9276474,8152777,3041798,20471049,375745817.664600,713171912.690000,242821419.875000,1331739150.229600,942,4009,1284,6235
2014-03-17,NYSE (N),605834449,0,0,605834449,23236831879.802730,0.000000,0.000000,23236831879.802730,1855571,0,0,1855571
2014-03-17,NYSE Arca (P),233491825,223477439,157217481,614186745,9696540392.779957,13922361919.006545,6640421305.145783,30259323616.932285,1889722,613644,1059736,3563102
2014-03-17,NASDAQ (Q),395062469,132954253,469544197,997560919,16717897947.795892,9166903960.454321,18516115094.845256,44400917003.095469,3147012,544892,2791733,6483637
2014-03-17,CBSX (W),344942,5702291,633971,6681204,10575859.270000,457069439.410000,38796122.140000,506441420.820000,1551,586,2539,4676
2014-03-17,NASDAQ PSX (X),12999264,9299393,9305698,31604355,511372120.665000,531088959.820000,364390292.950000,1406851373.435000,94188,26791,56223,177202
2014-03-17,BATS BYX (Y),61640060,29908468,33649751,125198279,2163748004.175008,1598133110.648000,1225455541.018003,4987336655.841011,498967,129227,246268,874462
2014-03-17,BATS BZX (Z),197064974,119153170,134727513,450945657,7011221431.775032,8244059689.984416,4802750123.841478,20058031245.600926,1539643,436995,978921,2955559
2014-03-14,NYSE MKT (A),0,14975613,6977442,21953055,0.000000,67528573.148400,105306388.341000,172834961.489400,0,30191,25306,55497
2014-03-14,NASDAQ BX (B),100320024,41913666,64227000,206460690,3550544039.869994,2234776341.853103,2369602995.898486,8154923377.621583,787852,192849,426034,1406735
2014-03-14,NSX (C),10092894,2168464,5416167,17677525,286102791.928900,43251078.453600,117476597.670500,446830468.053000,78412,9327,39101,126840
2014-03-14,NYSE (DN),108628660,35550781,88307981,232487422,3972686550.118137,1852010379.179199,3031362226.913326,8856059156.210662,467361,99229,288276,854866
2014-03-14,NASDAQ (DQ),1013302860,331440881,772654228,2117397969,33602471847.489149,16229482203.725853,20928700237.644867,70760654288.859869,3634311,733645,2104105,6472061
2014-03-14,ADF (D),38071273,14022318,35503254,87596845,1301561161.942297,582784763.410800,909796960.678803,2794142886.031900,192602,36101,131558,360261
2014-03-14,EDGA (J),85318045,49663834,55136889,190118768,2768486115.373000,2430569826.350402,1765324236.897398,6964380178.620800,655974,201560,378491,1236025
2014-03-14,EDGX (K),212588523,90380863,173544275,476513661,7690267129.634982,4693355936.307491,5700463352.700521,18084086418.642994,1206995,301983,792904,2301882
2014-03-14,CHX (M),9263237,15712338,5600967,30576542,332386330.442900,1477499796.123200,200325374.791000,2010211501.357100,808,6094,1012,7914
2014-03-14,NYSE (N),640479949,0,0,640479949,24576548233.477341,0.000000,0.000000,24576548233.477341,2032282,0,0,2032282
2014-03-14,NYSE Arca (P),279418038,262648987,222236345,764303370,11473212573.157060,17873000014.023507,8054285610.557371,37400498197.737938,2163490,796568,1181194,4141252
2014-03-14,NASDAQ (Q),475697419,176565790,539342054,1191605263,19387158311.283836,13693416722.071668,19920303329.966868,53000878363.322372,3652348,727307,2982822,7362477
2014-03-14,CBSX (W),482099,2217621,647273,3346993,16091088.190000,83353117.955400,28997016.080000,128441222.225400,1737,675,2440,4852
2014-03-14,NASDAQ PSX (X),14511922,11568956,16626038,42706916,541353632.725000,774083023.137200,476429480.781000,1791866136.643200,99225,35851,66708,201784
2014-03-14,BATS BYX (Y),69355981,36767813,43058157,149181951,2373326043.885007,2076757155.781497,1426604278.203104,5876687477.869608,541381,158809,280359,980549
2014-03-14,BATS BZX (Z),245873417,158228960,173841532,577943909,8494131968.845019,11567706446.257960,5816053489.505678,25877891904.608657,1816442,593489,1081368,3491299
2014-03-13,NYSE MKT (A),0,14964588,8783677,23748265,0.000000,80283734.496101,148622892.898000,228906627.394101,0,32602,31977,64579
2014-03-13,NASDAQ BX (B),113065903,53623902,66089339,232779144,4129689381.335010,2671252275.667506,2441534416.972206,9242476073.974722,894077,227457,484057,1605591
2014-03-13,NSX (C),10789353,3162042,5934650,19886045,303802599.270000,56850794.376700,124687122.078900,485340515.725600,87080,12125,44433,143638
2014-03-13,NYSE (DN),133353477,43183571,102738615,279275663,4875314609.878617,2241468597.550952,3495514299.087817,10612297506.517386,577200,131865,335080,1044145
2014-03-13,NASDAQ (DQ),1112871889,432838181,829926428,2375636498,37674998704.660277,20679982571.813513,23314309832.912676,81669291109.386466,4096309,899069,2406448,7401826
2014-03-13,ADF (D),45189396,18232847,39407151,102829394,1557891916.881596,787602626.784600,1012857512.174500,3358352055.840696,220976,43506,144583,409065
2014-03-13,EDGA (J),89834372,57107584,57209539,204151495,2945440276.874998,2554144240.291001,1734227476.219194,7233811993.385193,709429,228514,413099,1351042
2014-03-13,EDGX (K),248106767,108212168,208710066,565029001,8981926301.869985,5261250352.089415,6469496106.829734,20712672760.789134,1363296,336180,942178,2641654
2014-03-13,CHX (M),11935866,10953344,5440533,28329743,401385235.941800,902806812.430000,379148985.313000,1683341033.684800,1045,5341,1355,7741
2014-03-13,NYSE (N),692725742,0,0,692725742,25783265434.175247,0.000000,0.000000,25783265434.175247,2252157,0,0,2252157
2014-03-13,NYSE Arca (P),309286485,303326687,208755677,821368849,12838018898.179995,19769986300.900739,8414814788.922378,41022819988.003112,2356703,825143,1298603,4480449
2014-03-13,NASDAQ (Q),541743912,193524304,604336531,1339604747,22556787104.333887,14227048318.744748,22215998028.530813,58999833451.609448,4196632,768620,3454350,8419602
2014-03-13,CBSX (W),577621,7639393,654381,8871395,25561354.420000,491495496.752000,47136000.650000,564192851.822000,2768,775,3069,6612
2014-03-13,NASDAQ PSX (X),15915333,14022398,13044674,42982405,611153989.325000,887511258.045000,460668271.164001,1959333518.534001,107339,39315,66880,213534
2014-03-13,BATS BYX (Y),76753674,44954190,45112615,166820479,2735824037.822006,2419702692.275400,1514588494.480413,6670115224.577819,605542,183252,312104,1100898
2014-03-13,BATS BZX (Z),269275032,178908454,191073777,639257263,9470968927.359992,12336548873.134578,6477354836.768578,28284872637.263148,2007789,631039,1258294,3897122
2014-03-12,NYSE MKT (A),0,13311340,6510594,19821934,0.000000,73370152.377600,105167957.054000,178538109.431600,0,27818,26817,54635
2014-03-12,NASDAQ BX (B),100700505,38231944,57928324,196860773,3698583403.339998,1879477676.233602,2086069612.312719,7664130691.886319,788947,164564,423718,1377229
2014-03-12,NSX (C),8360009,2086851,4985094,15431954,218116337.695000,37452197.857700,98484525.903600,354053061.456300,62223,8144,34980,105347
2014-03-12,NYSE (DN),110229295,30289421,85793086,226311802,4332207439.513674,1452625379.014792,2749160691.528202,8533993510.056668,512558,120301,284284,917143
2014-03-12,NASDAQ (DQ),1000123334,319541970,783600205,2103265509,34326888127.459620,14622579918.095677,19782641990.748514,68732110036.303811,3629334,684388,2098344,6412066
2014-03-12,ADF (D),36539766,14056161,37780450,88376377,1239149169.313498,535891132.046600,840270912.411799,2615311213.771897,177249,30327,127295,334871
2014-03-12,EDGA (J),80719650,39119425,49919115,169758190,2672159752.459115,1815935717.101502,1401619445.416508,5889714914.977125,656354,165814,361932,1184100
2014-03-12,EDGX (K),210370826,81251982,190189304,481812112,7701555642.229793,3733115359.344293,5433271670.329520,16867942671.903606,1166128,252709,799665,2218502
2014-03-12,CHX (M),11256182,13135425,2479833,26871440,408386379.890000,1123320292.495000,136363671.265000,1668070343.650000,1211,2931,948,5090
2014-03-12,NYSE (N),657937618,0,0,657937618,25010509877.115483,0.000000,0.000000,25010509877.115483,1991395,0,0,1991395
2014-03-12,NYSE Arca (P),285786280,209608823,185549391,680944494,12042666245.800019,13720442254.527142,7106984522.508641,32870093022.835802,2206474,598828,1123766,3929068
2014-03-12,NASDAQ (Q),465714081,131862940,522873994,1120451015,19328344562.545725,9375534486.464087,18074914568.711108,46778793617.720920,3471264,531477,2774208,6776949
2014-03-12,CBSX (W),538111,1702966,269050,2510127,24839232.990000,58888575.920000,20505531.820000,104233340.730000,2140,524,1896,4560
2014-03-12,NASDAQ PSX (X),14379074,9989697,11796471,36165242,549442535.380000,598785546.945000,416028650.865000,1564256733.190000,98784,27517,65686,191987
2014-03-12,BATS BYX (Y),69374091,31561444,40993491,141929026,2499353019.066990,1662597005.552500,1337534822.095304,5499484846.714794,547246,133707,280245,961198
2014-03-12,BATS BZX (Z),219202789,115844337,155167694,490214820,7641124702.359958,7789725586.517574,4812001445.999626,20242851734.877158,1600459,428818,1007906,3037183
2014-03-11,NYSE MKT (A),0,17327145,8882969,26210114,0.000000,84997367.996900,125812959.951000,210810327.947900,0,35085,33637,68722
2014-03-11,NASDAQ BX (B),104456175,36650977,60833959,201941111,3652078003.589997,1871463480.611500,2016311195.756197,7539852679.957694,811038,162610,444348,1417996
2014-03-11,NSX (C),8551968,2438577,6438370,17428915,229623294.855000,43117826.886300,102288857.806200,375029979.547500,65634,9561,39957,115152
2014-03-11,NYSE (DN),122115441,31949735,108416893,262482069,4400382538.670156,1574466114.669694,3178316147.119988,9153164800.459838,490608,92162,338807,921577
2014-03-11,NASDAQ (DQ),1051646535,331385967,890222256,2273254758,34108009502.022241,14891242417.747675,22038220671.552024,71037472591.321940,3762595,666199,2491105,6919899
2014-03-11,ADF (D),43038069,16832039,54465109,114335217,1382538153.137498,588230382.183300,1085661355.907997,3056429891.228795,190319,35704,160015,386038
2014-03-11,EDGA (J),83361574,44008666,55857380,183227620,2609851643.542793,2003116818.061900,1461152129.603201,6074120591.207894,640350,173947,399920,1214217
2014-03-11,EDGX (K),223904667,87306915,248408739,559620321,7962519471.337797,4082191579.264902,6218128862.993802,18262839913.596501,1204102,260054,933743,2397899
2014-03-11,CHX (M),11910579,13470440,3955428,29336447,363588886.073400,928297597.903000,271562315.582500,1563448799.558900,902,2756,1047,4705
2014-03-11,NYSE (N),642772206,0,0,642772206,23243006915.362976,0.000000,0.000000,23243006915.362976,2046362,0,0,2046362
2014-03-11,NYSE Arca (P),291000690,217847159,215487948,724335797,12002902389.994974,14060547053.439301,7828449335.484570,33891898778.918845,2216585,621223,1280479,4118287
2014-03-11,NASDAQ (Q),495195097,142957076,598198448,1236350621,20089866370.202803,9934309499.070765,19686325407.865297,49710501277.138865,3700913,546202,3156913,7404028
2014-03-11,CBSX (W),728604,3214138,424931,4367673,20381718.330000,184960724.830000,28975743.280000,234318186.440000,2212,664,2530,5406
2014-03-11,NASDAQ PSX (X),15414877,9715914,13206684,38337475,610177132.800000,588152515.530000,430838011.444999,1629167659.774999,104521,28617,80193,213331
2014-03-11,BATS BYX (Y),71746645,32898673,46135195,150780513,2430016425.685993,1770081650.612701,1354284663.638904,5554382739.937598,548515,140595,305200,994310
2014-03-11,BATS BZX (Z),229102887,128469095,172168503,529740485,7753569253.649991,8494895948.074720,5133626984.275389,21382092186.000100,1655771,452784,1115356,3223911
2014-03-10,NYSE MKT (A),0,14629616,8338811,22968427,0.000000,67938103.417100,116831283.227000,184769386.644100,0,27389,31690,59079
2014-03-10,NASDAQ BX (B),94504332,32900584,55747953,183152869,3272015843.745006,1673340322.382298,1983134656.111714,6928490822.239018,735112,142111,398844,1276067
2014-03-10,NSX (C),7877806,2115521,5192734,15186061,199037807.355000,29251302.981300,95655139.998800,323944250.335100,59983,8045,35782,103810
2014-03-10,NYSE (DN),97258870,26721137,88731953,212711960,3479500880.680180,1298651991.507304,2816961431.901978,7595114304.089462,426071,80429,279628,786128
2014-03-10,NASDAQ (DQ),925397990,271331812,767800915,1964530717,29806273541.600434,11381878789.460922,19326790846.842781,60514943177.904137,3427926,615144,2198771,6241841
2014-03-10,ADF (D),36271843,14711672,40593718,91577233,1122074009.647302,512837847.683100,879057669.066499,2513969526.396901,159297,28930,124255,312482
2014-03-10,EDGA (J),74516327,33825906,48831357,157173590,2330215324.599985,1587798791.299197,1328931435.289005,5246945551.188187,575320,142545,346824,1064689
2014-03-10,EDGX (K),199323748,73790409,215508994,488623151,7021578032.582348,3225717611.148704,5733112174.931729,15980407818.662781,1071841,212909,835003,2119753
2014-03-10,CHX (M),14062890,6159796,2622836,22845522,405484188.082900,602318537.218000,118635735.311800,1126438460.612700,805,2017,888,3710
2014-03-10,NYSE (N),628219519,0,0,628219519,23084859556.927250,0.000000,0.000000,23084859556.927250,1890906,0,0,1890906
2014-03-10,NYSE Arca (P),241406400,177096637,173828101,592331138,9664582687.239982,11199290912.279974,6225170644.935510,27089044244.455466,1802713,516712,1069121,3388546
2014-03-10,NASDAQ (Q),423518280,112943223,523199848,1059661351,17268159336.792095,7538278447.056631,18176620253.361540,42983058037.210266,3164030,427930,2679856,6271816
2014-03-10,CBSX (W),371140,3371191,522057,4264388,20721993.820000,363359602.230000,25227918.560000,409309514.610000,1620,617,2492,4729
2014-03-10,NASDAQ PSX (X),12532178,7330713,10707951,30570842,448924678.570000,429854547.677000,382524567.505000,1261303793.752000,84101,22197,63870,170168
2014-03-10,BATS BYX (Y),61482990,26348253,37624665,125455908,2157371136.235006,1355478471.966299,1187029733.761000,4699879341.962305,491383,116074,251658,859115
2014-03-10,BATS BZX (Z),207506348,98863494,149767893,456137735,6796763063.760066,6453488925.024987,4547657626.249290,17797909615.034343,1473505,356521,998615,2828641
2014-03-07,NYSE MKT (A),0,14855275,7344673,22199948,0.000000,77573120.983500,120863863.079000,198436984.062500,0,27956,29026,56982
2014-03-07,NASDAQ BX (B),100262708,42184919,54633703,197081330,3723878418.109988,2284707027.221399,2257819789.835690,8266405235.167077,782787,182045,425691,1390523
2014-03-07,NSX (C),8356411,2908214,5547115,16811740,219175133.835000,59996353.344100,118412716.801600,397584203.980700,66533,10738,34887,112158
2014-03-07,NYSE (DN),121980775,33208446,86385876,241575097,4256135717.637822,1683271459.649201,2988875000.213338,8928282177.500361,480518,96449,285669,862636
2014-03-07,NASDAQ (DQ),1107826255,337480039,783471542,2228777836,35440718344.024377,14580826832.649198,22335562814.131528,72357107990.805103,3791513,701660,2226895,6720068
2014-03-07,ADF (D),45455313,14824383,42567893,102847589,1479140307.175001,589274465.724600,1047429262.085903,3115844034.985504,203548,31627,146441,381616
2014-03-07,EDGA (J),90273065,42902222,53637185,186812472,2926144427.391002,2108528486.086695,1749249995.079807,6783922908.557504,695908,182704,396504,1275116
2014-03-07,EDGX (K),244900103,88644659,201574092,535118854,8642954643.821222,4348750466.002486,6329857081.179311,19321562191.003019,1273140,275074,838373,2386587
2014-03-07,CHX (M),7555775,10800451,3656643,22012869,286885148.780000,1109514008.870000,297483302.755200,1693882460.405200,684,3574,1014,5272
2014-03-07,NYSE (N),723609479,0,0,723609479,26420724301.038306,0.000000,0.000000,26420724301.038306,2159454,0,0,2159454
2014-03-07,NYSE Arca (P),300425188,236926410,187232635,724584233,12175835273.264986,16002502011.768644,8210009874.978564,36388347160.012194,2198217,658431,1187641,4044289
2014-03-07,NASDAQ (Q),496883015,146997473,541583234,1185463722,20577529287.902709,10505947344.304482,20981994280.913881,52065470913.121072,3654153,551294,2966128,7171575
2014-03-07,CBSX (W),437677,3408489,447327,4293493,19917491.550000,183495520.147000,32177466.650000,235590478.347000,1990,602,2627,5219
2014-03-07,NASDAQ PSX (X),13259910,11648380,9893478,34801768,472245006.005000,718639089.460000,422201045.520000,1613085140.985000,80953,31950,57109,170012
2014-03-07,BATS BYX (Y),74923409,33275061,40178310,148376780,2613916096.483004,1830308168.716098,1449781276.596404,5894005541.795506,587739,143264,284664,1015667
2014-03-07,BATS BZX (Z),242889513,137525615,160094339,540509467,8124144970.440028,9379700879.902604,5663191575.367251,23167037425.709883,1738185,493608,1068699,3300492
2014-03-06,NYSE MKT (A),0,15229974,6967709,22197683,0.000000,80622435.012500,120298862.856000,200921297.868500,0,29945,24532,54477
2014-03-06,NASDAQ BX (B),98415297,38266967,56746769,193429033,3576229421.139993,1827320199.270000,2290937265.493408,7694486885.903401,768455,157722,437956,1364133
2014-03-06,NSX (C),7704699,3157655,4351831,15214185,206438001.795000,59619168.338200,111062628.264201,377119798.397401,58092,12456,29506,100054
2014-03-06,NYSE (DN),134943848,31357616,88656369,254957833,4416814973.287091,1372837705.002499,3045114262.357694,8834766940.647284,507372,99216,311574,918162
2014-03-06,NASDAQ (DQ),1091132205,334323744,777943100,2203399049,36199274249.714728,14050169296.352922,22594999077.305212,72844442623.372862,3717701,699851,2261660,6679212
2014-03-06,ADF (D),44963676,18365227,41239643,104568546,1441199382.414999,537940436.687200,1088097950.592398,3067237769.694597,190204,34765,145326,370295
2014-03-06,EDGA (J),83443491,41541765,50060761,175046017,2609939334.188304,1811338483.303197,1550595220.425294,5971873037.916795,627894,168143,362584,1158621
2014-03-06,EDGX (K),225447927,84790609,195993760,506232296,8102881950.910169,3547858862.510700,6191423656.228032,17842164469.648901,1164013,234479,826204,2224696
2014-03-06,CHX (M),10264222,9643163,6684863,26592248,364524465.603000,513398718.418400,444622824.703000,1322546008.724400,1164,2363,791,4318
2014-03-06,NYSE (N),675373102,0,0,675373102,25824852137.983065,0.000000,0.000000,25824852137.983065,1967005,0,0,1967005
2014-03-06,NYSE Arca (P),267318307,218369839,187321649,673009795,10989057046.737977,12595622761.549507,7596590679.243152,31181270487.530636,1997056,557198,1169190,3723444
2014-03-06,NASDAQ (Q),435944237,128987477,522561189,1087492903,18124828372.147072,8915339960.181173,19751687624.942361,46791855957.270606,3223344,455134,2827790,6506268
2014-03-06,CBSX (W),492360,3220767,437542,4150669,17942816.080000,161287071.190000,27328895.440000,206558782.710000,1853,472,2446,4771
2014-03-06,NASDAQ PSX (X),11831985,11000149,10004220,32836354,443985303.150000,580340300.320000,386514797.629999,1410840401.099999,76505,27438,57601,161544
2014-03-06,BATS BYX (Y),68841362,28831122,39580186,137252670,2409219487.657007,1502450438.152096,1406588681.892104,5318258607.701207,540427,121583,278068,940078
2014-03-06,BATS BZX (Z),212726946,122658571,151318257,486703774,7178650721.695594,7614477632.920920,5179356046.380590,19972484400.997104,1527369,406099,1016926,2950394
2014-03-05,NYSE MKT (A),0,15425335,7933993,23359328,0.000000,76718478.238300,132338051.285000,209056529.523300,0,29302,27874,57176
2014-03-05,NASDAQ BX (B),99867150,32907203,54335231,187109584,3613653566.769994,1707859260.176198,1868578167.626495,7190090994.572687,772204,145426,407071,1324701
2014-03-05,NSX (C),5863856,3258219,3385805,12507880,190079053.780000,48543208.029300,105279902.492200,343902164.301500,40683,11280,21715,73678
2014-03-05,NYSE (DN),115922292,27972328,90117784,234012404,4188122869.988475,1332108607.004004,2835468965.448322,8355700442.440801,514531,85278,295790,895599
2014-03-05,NASDAQ (DQ),1119678403,311251575,823373419,2254303397,36337321068.856681,14544697475.975287,21868137151.851804,72750155696.683772,3806579,627196,2267963,6701738
2014-03-05,ADF (D),41895605,13581390,35258022,90735017,1406158275.207499,491232306.105900,910374697.510503,2807765278.823902,192634,30674,138530,361838
2014-03-05,EDGA (J),88616309,35159866,51850538,175626713,2847706361.424995,1718368990.061399,1466648956.523505,6032724308.009899,685396,156716,373288,1215400
2014-03-05,EDGX (K),229904960,79955898,214827773,524688631,8171608535.489996,3467319643.999397,6059003540.835333,17697931720.324726,1205455,226791,837128,2269374
2014-03-05,CHX (M),12004014,9140793,4661683,25806490,408740254.447600,713391168.456000,329424848.976200,1451556271.879800,1292,2061,850,4203
2014-03-05,NYSE (N),666468052,0,0,666468052,24852934589.548910,0.000000,0.000000,24852934589.548910,1986761,0,0,1986761
2014-03-05,NYSE Arca (P),272389023,190667002,192170973,655226998,11500847785.980150,12203196090.182240,7052230957.356385,30756274833.518775,2072878,535415,1173020,3781313
2014-03-05,NASDAQ (Q),448936162,113799057,540540534,1103275753,18810188836.666934,8041440555.718433,18965855151.790968,45817484544.176335,3337209,438318,2762211,6537738
2014-03-05,CBSX (W),488286,1673316,806600,2968202,19460702.480000,78801026.145000,33894090.540000,132155819.165000,2458,406,2339,5203
2014-03-05,NASDAQ PSX (X),10524819,8091957,9488229,28105005,371581530.385000,513256733.680000,339696618.841000,1224534882.906000,65902,25064,47407,138373
2014-03-05,BATS BYX (Y),66617355,25732801,38391737,130741893,2306844168.725999,1442482986.624898,1168570413.289102,4917897568.639999,515890,111236,258611,885737
2014-03-05,BATS BZX (Z),216303318,111065815,152777650,480146783,7385963096.329981,7780210250.373490,4824341877.975479,19990515224.678950,1568381,410273,1029529,3008183
2014-03-04,NYSE MKT (A),0,18050524,8013857,26064381,0.000000,103361449.532400,130786330.316000,234147779.848400,0,29132,26733,55865
2014-03-04,NASDAQ BX (B),108758849,45539544,65840723,220139116,3968856084.733109,2815194196.135402,2473902614.643988,9257952895.512499,886351,195459,528288,1610098
2014-03-04,NSX (C),6225604,4492039,3937418,14655061,181995548.566600,83442577.041300,131317086.505800,396755212.113700,43975,15508,26565,86048
2014-03-04,NYSE (DN),127565779,39902690,94683925,262152394,4542342774.867929,2190793923.598099,2911026060.310694,9644162758.776722,578371,123309,367552,1069232
2014-03-04,NASDAQ (DQ),1155790111,573268972,891386996,2620446079,38810885365.187974,38249061089.753371,24143432741.664165,101203379196.605510,4047489,793363,2503215,7344067
2014-03-04,ADF (D),43466293,18596826,38108059,100171178,1495442820.342680,726837151.260700,982962530.435696,3205242502.039076,210360,43814,151213,405387
2014-03-04,EDGA (J),94450504,54872272,59138138,208460914,3057299736.818213,3590161546.527703,1643293599.660796,8290754883.006712,753529,227127,436566,1417222
2014-03-04,EDGX (K),254489248,109523885,216797362,580810495,9249916252.937001,6017990500.622907,6249557351.338315,21517464104.898223,1343734,321049,921201,2585984
2014-03-04,CHX (M),9219951,13670848,4412378,27303177,457393381.480000,1236798551.430300,742698575.680000,2436890508.590300,644,4364,1014,6022
2014-03-04,NYSE (N),852535617,0,0,852535617,31860058365.134910,0.000000,0.000000,31860058365.134910,2286985,0,0,2286985
2014-03-04,NYSE Arca (P),296772622,276210783,207937648,780921053,12603578287.962955,21228016171.531248,7927805937.893437,41759400397.387640,2323090,740508,1340784,4404382
2014-03-04,NASDAQ (Q),496450246,170492050,674696262,1341638558,20774973620.507254,14581864586.267271,23025318255.640831,58382156462.415356,3766801,635809,3251558,7654168
2014-03-04,CBSX (W),563997,5706183,711950,6982130,27355146.220000,421465967.830000,34043934.490000,482865048.540000,2909,873,2936,6718
2014-03-04,NASDAQ PSX (X),12014915,12296352,9344522,33655789,406912089.520000,900386379.300999,333902249.347800,1641200718.168799,76856,37808,54246,168910
2014-03-04,BATS BYX (Y),70250023,35271539,43984440,149506002,2427574772.529013,2273358484.614701,1357317847.601902,6058251104.745616,558341,147960,316212,1022513
2014-03-04,BATS BZX (Z),240230916,160331298,173451883,574014097,8169854176.634966,12678928637.287038,5445235304.794424,26294018118.716428,1787689,579273,1199124,3566086
2014-03-03,NYSE MKT (A),0,15985088,6483453,22468541,0.000000,80998210.425500,137825602.950000,218823813.375500,0,28179,25547,53726
2014-03-03,NASDAQ BX (B),105697720,50396861,57154837,213249418,4038899145.683003,2734744375.319700,2262175982.520194,9035819503.522897,865614,236605,449603,1551822
2014-03-03,NSX (C),15060443,5410702,9139251,29610396,486288920.402200,267922587.153400,235872616.741599,990084124.297199,130985,32821,59592,223398
2014-03-03,NYSE (DN),120086120,41881799,81779889,243747808,4428641944.197300,2304036504.069005,2947788425.208593,9680466873.474898,542795,132804,307185,982784
2014-03-03,NASDAQ (DQ),999325154,450324940,700309001,2149959095,33385005013.841728,24418325831.245967,21553301704.978739,79356632550.066434,3827730,919435,2215398,6962563
2014-03-03,ADF (D),42677413,18544286,31764008,92985707,1454462928.707299,854424232.504000,895001995.028701,3203889156.240000,214300,51268,132458,398026
2014-03-03,EDGA (J),85292714,57057679,53344201,195694594,2781912004.212005,2960785407.249402,1663990667.231305,7406688078.692712,687833,249237,403952,1341022
2014-03-03,EDGX (K),245357407,111341989,190680916,547380312,8873117531.864224,5635351540.631515,6118743845.280403,20627212917.776142,1351510,362672,855197,2569379
2014-03-03,CHX (M),5552671,12704526,3589109,21846306,246652700.672000,1181738938.440000,192535272.794400,1620926911.906400,580,5028,873,6481
2014-03-03,NYSE (N),685965356,0,0,685965356,26100578175.395981,0.000000,0.000000,26100578175.395981,2313513,0,0,2313513
2014-03-03,NYSE Arca (P),295735078,299841599,190895450,786472127,12690194913.386746,20276567628.044369,8354897491.381763,41321660032.812878,2376118,856422,1272896,4505436
2014-03-03,NASDAQ (Q),502584138,182116510,540851592,1225552240,21296729738.824880,14035484204.803479,21213592295.290905,56545806238.919264,3954707,746408,3095855,7796970
2014-03-03,CBSX (W),1765714,6852234,1111513,9729461,56345977.940000,350799370.000000,43626893.060000,450772241.000000,10558,1467,5840,17865
2014-03-03,NASDAQ PSX (X),12799456,14024444,9792666,36616566,436131693.755000,965508061.926600,391566496.106401,1793206251.788001,82184,47563,54647,184394
2014-03-03,BATS BYX (Y),71079546,40749445,40170651,151999642,2446606200.048000,2310692628.352100,1403179318.806304,6160478147.206404,565320,183416,292959,1041695
2014-03-03,BATS BZX (Z),242624972,174191222,164346792,581162986,8312364049.932872,12485064221.993827,5648763244.179779,26446191516.106478,1840486,668091,1131627,3640204
2014-02-28,NYSE MKT (A),0,14751659,7032438,21784097,0.000000,85824501.713800,139708350.006000,225532851.719800,0,27315,28421,55736
2014-02-28,NASDAQ BX (B),109491317,42488501,65880668,217860486,4036223792.064989,2351247031.161301,2955266580.898220,9342737404.124510,850311,188032,491805,1530148
2014-02-28,NSX (C),7672509,3662242,8198501,19533252,260697228.507900,186195458.138000,152877938.878800,599770625.524700,63826,22397,36475,122698
2014-02-28,NYSE (DN),129478147,38296929,99076390,266851466,4812438941.758596,1945579976.141295,3949056790.382499,10707075708.282390,583219,116876,356745,1056840
2014-02-28,NASDAQ (DQ),1136215191,371036822,961029538,2468281551,39206227194.076601,19156695617.391582,29884307873.479261,88247230684.947444,3963316,735833,2472713,7171862
2014-02-28,ADF (D),44348296,14326526,31953183,90628005,1606049373.363499,690441769.625300,997514232.900699,3294005375.889498,229535,35343,145219,410097
2014-02-28,EDGA (J),98009810,49501800,61394083,208905693,3253392033.219304,2566799073.372503,2037319418.339999,7857510524.931806,772219,200066,446589,1418874
2014-02-28,EDGX (K),240063933,98750562,220108246,558922741,8601176265.371680,4869013159.993019,7216614583.624231,20686804008.988930,1291753,293598,914215,2499566
2014-02-28,CHX (M),8449955,7107985,6099661,21657601,303520795.333400,676335762.990000,350308960.826300,1330165519.149700,772,4410,1292,6474
2014-02-28,NYSE (N),959964462,0,0,959964462,38203091259.286655,0.000000,0.000000,38203091259.286655,2370098,0,0,2370098
2014-02-28,NYSE Arca (P),334807645,269647577,221936976,826392198,14192514648.496602,19123865635.277042,10169782528.231381,43486162812.005025,2510262,690968,1430638,4631868
2014-02-28,NASDAQ (Q),504031967,163989698,706707258,1374728923,21058446174.141822,12912579855.329356,27898121299.451288,61869147328.922466,3890927,636580,3327827,7855334
2014-02-28,CBSX (W),8709562,4159744,5551603,18420909,258334968.430000,398725643.220000,159983844.400000,817044456.050000,67939,11641,41625,121205
2014-02-28,NASDAQ PSX (X),13320514,12467121,11668359,37455994,449173967.350000,819721770.575000,496927014.195000,1765822752.120000,85592,37542,65402,188536
2014-02-28,BATS BYX (Y),78135549,37051080,44246936,159433565,2726989818.567009,2114018293.805002,1656639589.179604,6497647701.551615,611462,151144,323912,1086518
2014-02-28,BATS BZX (Z),245137557,155071695,169337949,569547201,8529906978.964034,11386421409.274777,6473036245.015962,26389364633.254773,1823565,538823,1159687,3522075
2014-02-27,NYSE MKT (A),0,14907138,5223674,20130812,0.000000,74515775.878500,109550951.647000,184066727.525500,0,28811,23990,52801
2014-02-27,NASDAQ BX (B),97828668,33980879,54116449,185925996,3590104276.270010,1657628442.985001,2153926229.220114,7401658948.475125,783311,155494,425592,1364397
2014-02-27,NSX (C),7499824,2755303,5720725,15975852,236377268.428600,124347493.147200,123664813.404800,484389574.980600,61706,15281,35399,112386
2014-02-27,NYSE (DN),128251632,28415874,81764712,238432218,4471936120.670716,1404038575.443602,3145887616.292998,9021862312.407316,549736,90679,313853,954268
2014-02-27,NASDAQ (DQ),1118060294,268511871,736119547,2122691712,36634214715.060972,11787498179.852743,24475098210.772619,72896811105.686334,3723382,597078,2225913,6546373
2014-02-27,ADF (D),39105451,12073423,27182112,78360986,1333976562.940400,464683891.898000,891338087.472800,2689998542.311200,197266,26712,126271,350249
2014-02-27,EDGA (J),90002490,39774770,53091684,182868944,2986035564.121996,1824098418.789293,1743588160.553106,6553722143.464395,702975,170731,400353,1274059
2014-02-27,EDGX (K),238234188,77889458,179997128,496120774,7937664866.167974,3291521041.047603,6459243168.161494,17688429075.377071,1198078,228128,828438,2254644
2014-02-27,CHX (M),16571812,10655841,10180412,37408065,539589565.046400,1023399754.070000,488919005.546600,2051908324.663000,858,2632,847,4337
2014-02-27,NYSE (N),696695504,0,0,696695504,26389293375.894072,0.000000,0.000000,26389293375.894072,2139376,0,0,2139376
2014-02-27,NYSE Arca (P),313233699,192132632,184136895,689503226,12944136276.675074,12155357797.128074,8259178090.582619,33358672164.385767,2283565,566768,1242869,4093202
2014-02-27,NASDAQ (Q),481489608,123943435,511385478,1116818521,19695632070.093837,8545807706.008211,21146821486.856938,49388261262.958986,3623420,477073,2948236,7048729
2014-02-27,CBSX (W),11287599,3035829,6064891,20388319,334009531.630000,240917657.380000,169185576.980000,744112765.990000,83883,10500,45325,139708
2014-02-27,NASDAQ PSX (X),12788350,9520054,9298173,31606577,433396125.715000,554618283.275000,345028781.515000,1333043190.505000,78475,29451,55115,163041
2014-02-27,BATS BYX (Y),71622063,28887124,37647226,138156413,2506271144.898002,1526881392.322296,1419011243.982097,5452163781.202395,579763,126874,290858,997495
2014-02-27,BATS BZX (Z),227529470,113031879,150316979,490878328,7727514852.425019,7367516821.333513,5244022417.625617,20339054091.384149,1694365,412241,1067005,3173611
2014-02-26,NYSE MKT (A),0,15165153,6887458,22052611,0.000000,71072930.879800,150097358.559000,221170289.438800,0,24709,28291,53000
2014-02-26,NASDAQ BX (B),106820927,39095846,56878108,202794881,3894828896.115002,1860779739.742200,2646139884.170496,8401748520.027698,839364,171945,448679,1459988
2014-02-26,NSX (C),7215767,2456171,3987048,13658986,231392698.115000,82507472.826700,128617892.833500,442518063.775200,58200,11437,30226,99863
2014-02-26,NYSE (DN),126175253,29807051,83705950,239688254,4667682222.375109,1407715930.831397,3524268123.239113,9599666276.445619,539162,86887,309097,935146
2014-02-26,NASDAQ (DQ),1158592527,336982606,753346472,2248921605,39791561313.687557,14198820119.204460,27214411630.193336,81204793063.085353,4097688,663962,2350045,7111695
2014-02-26,ADF (D),44349132,13088359,29299930,86737421,1564966371.362900,486919303.352600,964907077.055997,3016792751.771497,225223,31424,139628,396275
2014-02-26,EDGA (J),94428110,45090734,51754519,191273363,2990099668.809999,2229594099.683901,1684952472.143195,6904646240.637095,722974,190417,388175,1301566
2014-02-26,EDGX (K),274655711,93674131,197254902,565584744,9857063250.798063,3903844182.046605,7478379151.451853,21239286584.296521,1433749,262515,915904,2612168
2014-02-26,CHX (M),16500983,6564684,6963264,30028931,529623130.745000,580164502.970000,420595763.904700,1530383397.619700,821,3428,1107,5356
2014-02-26,NYSE (N),670764256,0,0,670764256,25381832704.874844,0.000000,0.000000,25381832704.874844,2259543,0,0,2259543
2014-02-26,NYSE Arca (P),314227926,202335973,184110677,700674576,12992166564.439865,12845739233.906185,8828952164.920828,34666857963.266878,2342174,611202,1230876,4184252
2014-02-26,NASDAQ (Q),550957156,138157332,519218581,1208333069,23184491470.568991,9848795895.834307,21735219859.133123,54768507225.536421,4179483,551097,3094481,7825061
2014-02-26,CBSX (W),11531638,3981554,6316526,21829718,340099366.340000,303121818.410000,182077071.800000,825298256.550000,89226,11611,48535,149372
2014-02-26,NASDAQ PSX (X),13422549,11365610,10294560,35082719,458171774.525000,691035808.635000,391718191.240000,1540925774.400000,85690,33777,60339,179806
2014-02-26,BATS BYX (Y),75395052,33085916,39206721,147687689,2644243833.355008,1704651937.499397,1538902710.717314,5887798481.571719,592159,140683,291633,1024475
2014-02-26,BATS BZX (Z),255446991,133835441,163332355,552614787,8699053162.444785,8973148895.221504,5911350700.658457,23583552758.324746,1866092,484431,1100661,3451184
2014-02-25,NYSE MKT (A),0,14435621,8236091,22671712,0.000000,65727286.296200,156113696.261000,221840982.557200,0,23907,32474,56381
2014-02-25,NASDAQ BX (B),98511936,37449824,54127401,190089161,3762448163.200014,1876124027.243400,2276023653.789478,7914595844.232892,783770,165101,419732,1368603
2014-02-25,NSX (C),7242193,2170858,4135813,13548864,224043196.853600,96885796.053500,109311726.606201,430240719.513301,54585,9183,30255,94023
2014-02-25,NYSE (DN),117483025,29897946,82937776,230318747,4576515895.923998,1433263118.007704,3415758050.969218,9425537064.900920,503553,89776,305907,899236
2014-02-25,NASDAQ (DQ),1149490937,333287139,767323142,2250101218,39933941663.309435,14671561466.924632,25950812030.201973,80556315160.436040,3771202,675915,2295940,6743057
2014-02-25,ADF (D),35068483,13017166,26270616,74356265,1283048254.968800,442054899.114401,859259597.582999,2584362751.666200,183657,30013,122743,336413
2014-02-25,EDGA (J),86842093,45869433,51148150,183859676,2877363129.237598,2099652772.344099,1654495308.115392,6631511209.697089,661682,179157,375055,1215894
2014-02-25,EDGX (K),226705696,92968806,198140575,517815077,8567778189.738487,3818667199.570695,7214176631.229504,19600622020.538686,1262885,254945,875533,2393363
2014-02-25,CHX (M),11092058,9277060,5555630,25924748,459444270.724800,717806124.528200,293206185.996000,1470456581.249000,629,2505,713,3847
2014-02-25,NYSE (N),646943043,0,0,646943043,25596750893.877350,0.000000,0.000000,25596750893.877350,2112428,0,0,2112428
2014-02-25,NYSE Arca (P),289021045,211147050,188169026,688337121,12390541138.792707,13487019181.613371,8538553140.866272,34416113461.272350,2124866,614864,1216683,3956413
2014-02-25,NASDAQ (Q),509112294,140550552,526558853,1176221699,21909005582.200985,9989159323.976866,21398857064.130482,53297021970.308333,3843837,535019,2970055,7348911
2014-02-25,CBSX (W),10513717,5742238,6288840,22544795,334286448.060000,414855835.400000,187894283.980000,937036567.440000,86534,12211,48760,147505
2014-02-25,NASDAQ PSX (X),14290221,11726979,11616239,37633439,506206918.470000,676703047.655000,397136568.418200,1580046534.543200,86305,32070,61822,180197
2014-02-25,BATS BYX (Y),69247314,33223995,40274101,142745410,2524858155.869002,1725330872.243698,1497088511.331299,5747277539.443999,550699,140215,291970,982884
2014-02-25,BATS BZX (Z),246296946,131431939,169498859,547227744,8685124893.430045,8754860570.096689,5840116563.080463,23280102026.607197,1758783,472500,1077647,3308930
2014-02-24,NYSE MKT (A),0,15793118,7865191,23658309,0.000000,95329072.358600,169702956.575000,265032028.933600,0,27605,30850,58455
2014-02-24,NASDAQ BX (B),109115637,36556753,55300196,200972586,4267502895.099999,1863217319.971699,2407476011.261789,8538196226.333487,851564,150536,426978,1429078
2014-02-24,NSX (C),7391604,2382081,4681784,14455469,238260128.837200,100474826.470700,116218004.024700,454952959.332600,57848,10135,31260,99243
2014-02-24,NYSE (DN),144456018,36834775,89971687,271262480,5504395176.603839,1678599710.127696,3395146494.606397,10578141381.337932,609745,107185,323146,1040076
2014-02-24,NASDAQ (DQ),1393087310,400326481,760601229,2554015020,52830204269.718567,19494993590.843988,23879452388.101768,96204650248.664323,3992087,737326,2261821,6991234
2014-02-24,ADF (D),40413363,16484660,28812311,85710334,1533800818.314500,566836003.893600,881836497.090799,2982473319.298899,194607,35582,124216,354405
2014-02-24,EDGA (J),90061194,46210161,54714834,190986189,3096911464.632000,2239625926.897300,1760848917.777392,7097386309.306692,704550,180369,399191,1284110
2014-02-24,EDGX (K),231968236,88406889,189333025,509708150,8895018309.752992,3824793553.714302,6315953774.300941,19035765637.768235,1284855,255847,834332,2375034
2014-02-24,CHX (M),15328712,9923912,6030941,31283565,581197671.265000,807566034.821000,404861306.450000,1793625012.536000,686,3353,945,4984
2014-02-24,NYSE (N),844780642,0,0,844780642,35092891187.807117,0.000000,0.000000,35092891187.807117,2119892,0,0,2119892
2014-02-24,NYSE Arca (P),283886025,209001152,180833194,673720371,12563149366.811489,14124335401.060009,7696922191.826723,34384406959.698221,2154705,589893,1173605,3918203
2014-02-24,NASDAQ (Q),504613664,139933132,555685712,1200232508,22071376656.480066,9970593408.013589,21722357935.588448,53764328000.082103,3796191,529009,2933089,7258289
2014-02-24,CBSX (W),11867537,4598647,6810123,23276307,360849744.320000,270969932.807200,192885489.540000,824705166.667200,92422,12172,52219,156813
2014-02-24,NASDAQ PSX (X),13979426,11614333,11119802,36713561,493516667.325000,626806843.692000,391125542.150000,1511449053.167000,88815,30564,59570,178949
2014-02-24,BATS BYX (Y),74339228,32981838,40045795,147366861,2783155726.481001,1731773638.420598,1483137673.353907,5998067038.255506,598963,136264,291045,1026272
2014-02-24,BATS BZX (Z),249911852,127093727,173911906,550917485,8911667813.938831,8696426448.792026,5605194608.561407,23213288871.292264,1790937,450864,1112250,3354051
2014-02-21,NYSE MKT (A),0,13420634,7745599,21166233,0.000000,89322340.125700,132493778.676000,221816118.801700,0,22730,27736,50466
2014-02-21,NASDAQ BX (B),92209117,34983102,53854504,181046723,3453072564.584997,1609246029.110101,2202520073.113808,7264838666.808906,731305,142824,403072,1277201
2014-02-21,NSX (C),5853943,2203230,3368787,11425960,187274730.625000,85759430.552300,88116787.869000,361150949.046300,46570,7789,23970,78329
2014-02-21,NYSE (DN),117776883,26503338,82344449,226624670,4498928910.756700,1208307594.991600,3082568601.248644,8789805106.996944,516081,77887,308898,902866
2014-02-21,NASDAQ (DQ),1001068743,330204278,718918661,2050191682,34944256879.104938,17210643686.705418,23418321623.424833,75573222189.235189,3718080,581328,2252995,6552403
2014-02-21,ADF (D),32510212,12403433,27412510,72326155,1125496348.761500,398260950.756800,816219144.717002,2339976444.235302,163089,27178,115083,305350
2014-02-21,EDGA (J),83380851,39685370,54653490,177719711,2768498866.353992,1709284717.647698,1747219808.717891,6225003392.719581,654133,151871,391650,1197654
2014-02-21,EDGX (K),204239902,76789194,180025974,461055070,7548560446.120020,3308294812.199296,6140090782.411242,16996946040.730558,1152554,213434,806683,2172671
2014-02-21,CHX (M),7984579,13618232,6916632,28519443,351335969.820000,1094991670.590000,485015819.884000,1931343460.294000,625,2395,698,3718
2014-02-21,NYSE (N),808576638,0,0,808576638,32586371414.024972,0.000000,0.000000,32586371414.024972,2061488,0,0,2061488
2014-02-21,NYSE Arca (P),258531059,201540350,180952168,641023577,11092204573.158511,13451350088.068558,8332895069.814708,32876449731.041777,1973294,534492,1163233,3671019
2014-02-21,NASDAQ (Q),478869115,121787811,610663781,1211320707,20564877841.729119,8307321224.046483,25229253202.333685,54101452268.109287,3650998,448658,2949903,7049559
2014-02-21,CBSX (W),12001935,2531241,6916696,21449872,372710039.270000,201109414.550000,188528344.740000,762347798.560000,96811,11231,52081,160123
2014-02-21,NASDAQ PSX (X),12245605,9924263,11185103,33354971,427061499.425000,542751238.840000,426278308.065900,1396091046.330900,81856,26591,66423,174870
2014-02-21,BATS BYX (Y),65857033,27773349,38777998,132408380,2362663710.895006,1373825539.005298,1431731268.977105,5168220518.877409,526245,117683,278382,922310
2014-02-21,BATS BZX (Z),226005082,108993794,157627595,492626471,7796162079.805008,7109114448.730898,5503191762.030807,20408468290.566713,1663117,392806,1059190,3115113
2014-02-20,NYSE MKT (A),0,11307742,7698339,19006081,0.000000,71268153.566800,140044112.204000,211312265.770800,0,24278,25753,50031
2014-02-20,NASDAQ BX (B),103187439,38839070,53386918,195413427,3752512533.785006,1845670986.319800,2571948451.538085,8170131971.642891,797644,164976,420020,1382640
2014-02-20,NSX (C),6376068,2111670,3169589,11657327,193063478.720000,91197597.818400,94054426.860700,378315503.399100,43317,7147,21253,71717
2014-02-20,NYSE (DN),115864241,31026923,79566531,226457695,4366989526.113111,1449108515.363897,3383453255.825522,9199551297.302530,514314,93204,306135,913653
2014-02-20,NASDAQ (DQ),1037635216,319018358,675509129,2032162703,36473469740.359770,15331546704.783301,24428951637.456590,76233968082.599661,3872235,638925,2207704,6718864
2014-02-20,ADF (D),31112761,12306044,24351817,67770622,1067003806.597300,505913402.887900,847033255.959203,2419950465.444403,149496,29195,106392,285083
2014-02-20,EDGA (J),86763783,43538299,50117806,180419888,2816841249.850307,2014596092.735301,1760106658.502307,6591544001.087915,684757,182126,375958,1242841
2014-02-20,EDGX (K),224226401,86019057,180115382,490360840,8394714581.154005,4056571165.958206,7160415462.809247,19611701209.921458,1266954,260762,854280,2381996
2014-02-20,CHX (M),11242027,12689321,6258166,30189514,536984565.918100,873393217.712000,348173208.480000,1758550992.110100,805,3538,676,5019
2014-02-20,NYSE (N),673472963,0,0,673472963,26088137028.112833,0.000000,0.000000,26088137028.112833,2146344,0,0,2146344
2014-02-20,NYSE Arca (P),282087866,208750874,188927054,679765794,11905163964.374702,13321114882.972488,8990901838.418865,34217180685.766055,2114911,595499,1221213,3931623
2014-02-20,NASDAQ (Q),504762720,140657984,519818295,1165238999,21600823178.369090,9951901754.369525,22072880938.978060,53625605871.716675,3833249,562146,3028328,7423723
2014-02-20,CBSX (W),10973992,5774138,6607975,23356105,327565284.220000,359289157.877600,211145096.743000,897999538.840600,84318,11951,47161,143430
2014-02-20,NASDAQ PSX (X),12672779,11009470,9640902,33323151,417712894.950000,622413502.285400,417527319.365000,1457653716.600400,76688,30491,54352,161531
2014-02-20,BATS BYX (Y),69506476,31201316,37356002,138063794,2467432251.941999,1636967147.807696,1516701810.559600,5621101210.309295,550882,134540,273134,958556
2014-02-20,BATS BZX (Z),237798063,129824709,153998651,521621423,8270954121.276991,8531766718.107979,5949005722.146155,22751726561.531125,1747784,464325,1068313,3280422
2014-02-19,NYSE MKT (A),0,12565975,8879632,21445607,0.000000,68126764.919500,234259750.274999,302386515.194499,0,26648,31479,58127
2014-02-19,NASDAQ BX (B),109000971,47015332,52073692,208089995,4043943027.000004,2253142166.573498,2227126718.749005,8524211912.322507,833250,193130,414068,1440448
2014-02-19,NSX (C),10050102,2906217,4730779,17687098,322768981.253400,114031978.739300,132684400.780300,569485360.773000,77618,9273,31591,118482
2014-02-19,NYSE (DN),115539359,37817590,70464497,223821446,4363862502.314317,1753192140.572996,3042689644.996210,9159744287.883523,531691,113098,274473,919262
2014-02-19,NASDAQ (DQ),1099026418,392166657,650749002,2141942077,38232116951.907579,19060149845.446068,22246932661.769955,79539199459.123602,4014989,756570,2092892,6864451
2014-02-19,ADF (D),31271625,15616215,21053647,67941487,1100446122.366297,589254270.729300,743227789.214801,2432928182.310398,145764,37111,97145,280020
2014-02-19,EDGA (J),92522098,55238453,49655580,197416131,3026236280.650001,2578972470.908700,1643247485.185990,7248456236.744691,728889,227267,376350,1332506
2014-02-19,EDGX (K),242152628,111043593,171866163,525062384,9176446409.745023,5047257146.905198,6802647269.542957,21026350826.193178,1349040,323600,836400,2509040
2014-02-19,CHX (M),10496871,13558483,8137195,32192549,497496490.768300,1019581938.210000,570170814.203700,2087249243.182000,2968,3839,1454,8261
2014-02-19,NYSE (N),702739986,0,0,702739986,26983030809.739246,0.000000,0.000000,26983030809.739246,2346664,0,0,2346664
2014-02-19,NYSE Arca (P),325680311,254200474,184733626,764614411,13960846732.626515,15534343183.862949,9069683105.521644,38564873022.011108,2344420,710804,1240364,4295588
2014-02-19,NASDAQ (Q),556081947,174382821,522370183,1252834951,23870726170.204222,12376314398.237160,21630419592.166521,57877460160.607903,4161600,656863,3104903,7923366
2014-02-19,CBSX (W),12910724,12419464,6354485,31684673,377211712.250000,662883420.812400,188616338.533000,1228711471.595400,92117,16016,49283,157416
2014-02-19,NASDAQ PSX (X),15230256,13914690,10237917,39382863,483453357.520000,753549866.030000,410456784.495000,1647460008.045000,85490,37141,56967,179598
2014-02-19,BATS BYX (Y),72798257,38270345,35230126,146298728,2596553930.276002,2050133716.723596,1349758247.311904,5996445894.311502,587468,161369,274908,1023745
2014-02-19,BATS BZX (Z),269000223,158868804,164067709,591936736,9331402267.488551,10306444529.534598,5942620932.813971,25580467729.837120,1942267,556850,1101696,3600813
2014-02-18,NYSE MKT (A),0,16744523,5808630,22553153,0.000000,87443806.742800,133491501.386000,220935308.128800,0,27044,26232,53276
2014-02-18,NASDAQ BX (B),93884457,34711130,47810885,176406472,3533654349.129990,1574250158.902601,2237122994.662198,7345027502.694789,730259,140394,370094,1240747
2014-02-18,NSX (C),7604113,2410210,4104628,14118951,249444533.310000,48655856.340600,103068904.403600,401169294.054200,56276,5671,27049,88996
2014-02-18,NYSE (DN),117268035,34021211,73313011,224602257,4494045743.000284,1545855281.993108,2923589300.402314,8963490325.395706,531336,101909,292381,925626
2014-02-18,NASDAQ (DQ),1054321091,343317361,638786880,2036425332,38120109254.737062,15568841066.664081,21168262263.038219,74857212584.439362,4035033,690770,2132294,6858097
2014-02-18,ADF (D),23229338,8664073,18162565,50055976,819910025.435800,343102348.224200,626852652.605600,1789865026.265600,120897,21640,86681,229218
2014-02-18,EDGA (J),82536524,38926392,47896355,169359271,2816115385.934191,1763831911.110799,1658931363.636197,6238878660.681187,666982,159404,360076,1186462
2014-02-18,EDGX (K),232954989,80300477,167648517,480903983,8899612546.386926,3434230562.134104,6227369751.437001,18561212859.958031,1264318,239358,793666,2297342
2014-02-18,CHX (M),5997693,10492720,3653301,20143714,239097926.966000,718864545.667000,218618747.669800,1176581220.302800,853,3213,1204,5270
2014-02-18,NYSE (N),721807419,0,0,721807419,27995439210.549050,0.000000,0.000000,27995439210.549050,2094604,0,0,2094604
2014-02-18,NYSE Arca (P),284203550,205678532,167004392,656886474,12599660987.398074,12094657405.792041,7539074896.548119,32233393289.738234,2161446,569445,1118046,3848937
2014-02-18,NASDAQ (Q),473687040,119259475,521033385,1113979900,20830871969.457943,7843429687.650568,21534052186.464861,50208353843.573372,3623400,436533,2804961,6864894
2014-02-18,CBSX (W),12690223,3583384,6358392,22631999,399971931.110000,288830141.940000,185134996.350000,873937069.400000,93439,12718,45737,151894
2014-02-18,NASDAQ PSX (X),10526528,7666508,8404160,26597196,371558580.715000,417639874.761400,355453779.135000,1144652234.611400,67261,22079,46809,136149
2014-02-18,BATS BYX (Y),66010678,26959957,32351384,125322019,2466402148.194007,1309443752.197501,1320203681.817401,5096049582.208909,539037,119119,255455,913611
2014-02-18,BATS BZX (Z),235185745,109258303,147627581,492071629,8290347260.813160,6530040739.684804,5284117968.002517,20104505968.500481,1701130,373805,994888,3069823
2014-02-14,NYSE MKT (A),0,13785453,6066122,19851575,0.000000,62170405.205000,141125003.662000,203295408.867000,0,26613,25136,51749
2014-02-14,NASDAQ BX (B),90888359,35985803,49132119,176006281,3455083368.255008,1747036233.022399,2099152662.071913,7301272263.349320,739274,153935,387629,1280838
2014-02-14,NSX (C),4433331,3751739,3154418,11339488,148130328.520000,91906789.364500,84787165.819100,324824283.703600,23610,6257,15296,45163
2014-02-14,NYSE (DN),110477068,32148615,79763692,222389375,4297990031.926200,1415873784.609999,2850446459.256216,8564310275.792415,494424,94533,283269,872226
2014-02-14,NASDAQ (DQ),1007420532,320638777,693504360,2021563669,35487918655.377456,15496683003.821934,22139362699.266892,73123964358.466282,3674692,676406,1968022,6319120
2014-02-14,ADF (D),15949237,7071876,12409844,35430957,585504813.253000,357549508.447400,366159694.245300,1309214015.945700,85355,19227,54524,159106
2014-02-14,EDGA (J),79358767,38834088,47281701,165474556,2701773585.571996,1839418364.631799,1606931368.565495,6148123318.769290,648680,165011,346772,1160463
2014-02-14,EDGX (K),204954994,82556709,162935729,450447432,7648421811.372168,3559753899.126194,5453011773.826158,16661187484.324520,1150819,255242,730344,2136405
2014-02-14,CHX (M),9017564,12975088,5777657,27770309,435574919.393000,1163088845.290800,420218204.166000,2018881968.849800,1411,3948,862,6221
2014-02-14,NYSE (N),621666408,0,0,621666408,24256502613.206182,0.000000,0.000000,24256502613.206182,1930766,0,0,1930766
2014-02-14,NYSE Arca (P),252630902,198864970,155757120,607252992,10836272451.535154,11795219296.480254,7400242372.892902,30031734120.908310,1918987,557051,1010385,3486423
2014-02-14,NASDAQ (Q),424242481,121201566,478188364,1023632411,18426872921.637798,8276179442.261336,18779626671.292813,45482679035.191947,3268372,457077,2502073,6227522
2014-02-14,CBSX (W),10848252,8496205,6333713,25678170,333571819.950000,664841820.840000,196766830.670000,1195180471.460000,86870,14297,46603,147770
2014-02-14,NASDAQ PSX (X),10916167,8877190,9225072,29018429,343437577.935000,560454262.310000,315615707.320000,1219507547.565000,68873,26380,51471,146724
2014-02-14,BATS BYX (Y),59650939,27245042,33506039,120402020,2149384527.321598,1392110874.909599,1243149238.208813,4784644640.440010,496816,123057,244833,864706
2014-02-14,BATS BZX (Z),217558983,114853778,145924960,478337721,7616193123.123221,7546195829.900494,5283873208.336006,20446262161.359721,1585925,418271,941406,2945602
2014-02-13,NYSE MKT (A),0,9679432,7036790,16716222,0.000000,54209771.190500,168007310.567000,222217081.757500,0,23460,30199,53659
2014-02-13,NASDAQ BX (B),92145693,38810608,56429078,187385379,3526060810.765007,1920743556.178698,2657181073.256273,8103985440.199978,749995,155851,425543,1331389
2014-02-13,NSX (C),6210487,5237253,7029514,18477254,198074412.238000,153977877.494900,163715906.498100,515768196.231000,30854,9428,25302,65584
2014-02-13,NYSE (DN),131324090,38627394,100229689,270181173,4958024456.705298,1770057195.211797,3903321701.728691,10631403353.645786,596998,113907,382674,1093579
2014-02-13,NASDAQ (DQ),1065631997,329787582,813508201,2208927780,37336889057.710064,15170973739.061245,25916274202.520186,78424136999.291495,3852102,667119,2291714,6810935
2014-02-13,ADF (D),5926750,3105003,6327126,15358879,216973700.465000,204120505.389000,146635143.429000,567729349.283000,30624,8275,21219,60118
2014-02-13,EDGA (J),78668271,47086957,55702892,181458120,2524919612.817393,2188066475.181399,1822176324.545794,6535162412.544586,629868,181315,386972,1198155
2014-02-13,EDGX (K),220076430,84687897,192870418,497634745,8302670564.985594,3774861981.188306,6764080461.781904,18841613007.955804,1256205,251941,856922,2365068
2014-02-13,CHX (M),6039493,8117344,4056615,18213452,303967242.986500,661060118.084100,171636231.974500,1136663593.045100,1348,3335,993,5676
2014-02-13,NYSE (N),639121455,0,0,639121455,24070289350.859941,0.000000,0.000000,24070289350.859941,2056368,0,0,2056368
2014-02-13,NYSE Arca (P),283118380,208870615,206911322,698900317,12559500273.349080,12781762052.947973,8961609146.845647,34302871473.142700,2188302,574694,1218496,3981492
2014-02-13,NASDAQ (Q),460466021,130052255,568652037,1159170313,19674767411.131550,9178222313.243413,22847493263.692411,51700482988.067374,3463692,478593,3019315,6961600
2014-02-13,CBSX (W),8956590,9251767,7082280,25290637,264839747.330000,771856990.945100,218952208.050000,1255648946.325100,67334,13847,50457,131638
2014-02-13,NASDAQ PSX (X),11143153,9953973,12475688,33572814,365257756.080000,573110440.897000,415432757.278900,1353800954.255900,68780,28489,59198,156467
2014-02-13,BATS BYX (Y),61550198,29706913,39693566,130950677,2183454346.236006,1525865845.650499,1493827451.826106,5203147643.712611,493026,132233,282102,907361
2014-02-13,BATS BZX (Z),229626496,126990232,180956811,537573539,7880589053.730784,8418510653.441803,6582435421.005270,22881535128.177857,1707179,452260,1120699,3280138
2014-02-12,NYSE MKT (A),0,11453168,7502174,18955342,0.000000,61560128.595200,141162256.445000,202722385.040200,0,24661,24879,49540
2014-02-12,NASDAQ BX (B),94834386,36430858,54333293,185598537,3393047137.709991,1734553825.827000,2139768027.492212,7267368991.029203,745095,159046,413422,1317563
2014-02-12,NSX (C),8730034,6681643,8678092,24089769,291678235.045000,229026122.446700,220853841.816100,741558199.307800,42743,12505,32053,87301
2014-02-12,NYSE (DN),131797435,38232897,93937558,263967890,4875943502.214800,1875528477.032590,3446872456.537031,10198344435.784421,609675,115667,367107,1092449
2014-02-12,NASDAQ (DQ),1045346451,315165627,700222017,2060734095,36233875170.273508,14621767645.687694,21850061153.749081,72705703969.710283,3931235,686989,2194194,6812418
2014-02-12,ADF (D),68894,1166,649086,719146,2347304.580000,95783.270000,5998493.980000,8441581.830000,444,11,1650,2105
2014-02-12,EDGA (J),84197454,42986270,50306986,177490710,2712074430.356999,2038753407.633198,1566040059.042010,6316867897.032207,676891,180337,362537,1219765
2014-02-12,EDGX (K),221322490,81325395,179608233,482256118,8320570761.070012,3803315852.149002,6115391698.011748,18239278311.230762,1260520,240886,828823,2330229
2014-02-12,CHX (M),8227502,9847866,7240789,25316157,343354218.342000,681789223.123200,693178988.839100,1718322430.304300,1166,3615,1201,5982
2014-02-12,NYSE (N),639838872,0,0,639838872,24072410281.081661,0.000000,0.000000,24072410281.081661,2093152,0,0,2093152
2014-02-12,NYSE Arca (P),290285121,212421721,194553697,697260539,12198389596.076323,13085709113.508261,8406278050.153112,33690376759.737696,2157543,599215,1176108,3932866
2014-02-12,NASDAQ (Q),478289201,128411788,525302255,1132003244,19911740446.326818,8676237524.218579,20462590230.348261,49050568200.893658,3605681,475185,2822772,6903638
2014-02-12,CBSX (W),13760111,8354664,7558380,29673155,402442934.790000,660200871.272291,218270297.930000,1280914103.992291,105155,15913,54463,175531
2014-02-12,NASDAQ PSX (X),11667957,10375767,10634098,32677822,378522151.095000,592665356.164000,397684265.175000,1368871772.434000,75979,28904,57302,162185
2014-02-12,BATS BYX (Y),61344190,27698843,36809794,125852827,2105011749.719307,1491408573.422094,1277408730.858999,4873829054.000400,499047,129333,266877,895257
2014-02-12,BATS BZX (Z),239973183,124399801,163551675,527924659,8332152736.407684,8239466692.742691,5563083870.156901,22134703299.307276,1788196,455789,1037555,3281540
2014-02-11,NYSE MKT (A),0,15590751,5635701,21226452,0.000000,75847865.229400,113508316.215000,189356181.444400,0,28894,22782,51676
2014-02-11,NASDAQ BX (B),103508865,44936731,54387574,202833170,3772743610.414983,2252558176.097501,2451791954.904291,8477093741.416775,809541,186955,418502,1414998
2014-02-11,NSX (C),9724467,9656498,7318116,26699081,300272607.582000,324394899.401500,197715783.740600,822383290.724100,44180,17019,28658,89857
2014-02-11,NYSE (DN),131385504,43688224,84216883,259290611,4682446605.842032,1934828086.845208,2998650381.094877,9615925073.782117,572628,120750,306589,999967
2014-02-11,NASDAQ (DQ),1201385701,420545837,701536810,2323468348,40127011735.224068,18935407623.198632,21886871582.555098,80949290940.977798,4429341,839053,2214977,7483371
2014-02-11,ADF (D),0,0,247241,247241,0.000000,0.000000,1140067.855000,1140067.855000,0,0,480,480
2014-02-11,EDGA (J),92810783,52982909,52141319,197935011,2981035340.877402,2529757931.529303,1716362796.820595,7227156069.227300,750483,219274,387502,1357259
2014-02-11,EDGX (K),251411799,98192089,172095861,521699749,9065274935.239132,4268145501.560408,6257787782.871354,19591208219.670894,1360167,285836,808909,2454912
2014-02-11,CHX (M),8314192,12914212,3898628,25127032,423165836.654600,1043597121.341400,337736036.842000,1804498994.838000,863,3849,864,5576
2014-02-11,NYSE (N),709837931,0,0,709837931,27129793671.294970,0.000000,0.000000,27129793671.294970,2187499,0,0,2187499
2014-02-11,NYSE Arca (P),317361287,259013886,188123089,764498262,12829472768.005070,15654163669.916397,7785277172.742606,36268913610.664073,2323681,695186,1147063,4165930
2014-02-11,NASDAQ (Q),521830322,152499206,508260049,1182589577,21400491587.803281,10459746519.547267,20146015626.092190,52006253733.442738,3863531,547708,2826047,7237286
2014-02-11,CBSX (W),15827594,10755723,8710758,35294075,455199165.300000,829370297.400000,228003053.940000,1512572516.640000,124087,20996,62137,207220
2014-02-11,NASDAQ PSX (X),14932748,11985166,13131352,40049266,522540968.700001,726358830.545000,436357698.015000,1685257497.260001,100067,33848,55091,189006
2014-02-11,BATS BYX (Y),68539293,34838346,35413482,138791121,2298125997.724005,1831445625.932700,1320809848.643305,5450381472.300010,543504,155650,266190,965344
2014-02-11,BATS BZX (Z),260117278,148764686,162653664,571535628,8791685959.711354,9508675848.255083,5578214765.461602,23878576573.428039,1894258,524807,1039671,3458736
2014-02-10,NYSE MKT (A),0,13421460,5217902,18639362,0.000000,60089704.868400,104677972.418000,164767677.286400,0,25073,24631,49704
2014-02-10,NASDAQ BX (B),94264937,35455416,50409764,180130117,3485362574.765006,1586908866.692398,2090737113.035591,7163008554.492995,745203,150266,393390,1288859
2014-02-10,NSX (C),7876256,6951851,6688555,21516662,251250494.125000,171278316.894500,183250936.982300,605779748.001800,38071,12010,26370,76451
2014-02-10,NYSE (DN),127601126,40618707,83279420,251499253,4671363364.630920,1729023502.861499,3069566746.512811,9469953614.005230,617706,127405,335946,1081057
2014-02-10,NASDAQ (DQ),1049193459,384636326,610942872,2044772657,35766173709.301915,18771074017.212761,19859763213.141113,74397010939.655789,3883782,674996,2000524,6559302
2014-02-10,EDGA (J),85629986,41141864,47192511,173964361,2761314241.270814,1834362568.153801,1553502378.047486,6149179187.472101,709986,167945,372852,1250783
2014-02-10,EDGX (K),212338509,85020195,157029202,454387906,7771206973.722998,3446649517.435801,5685305562.661624,16903162053.820423,1209692,232791,752283,2194766
2014-02-10,CHX (M),5258203,11643285,4058745,20960233,227703353.391400,1132675148.596200,480081475.213800,1840459977.201400,1775,2414,1439,5628
2014-02-10,NYSE (N),654002835,0,0,654002835,24934603412.478592,0.000000,0.000000,24934603412.478592,2083975,0,0,2083975
2014-02-10,NYSE Arca (P),274070038,200449432,164019798,638539268,11293216911.520374,11573725393.984038,7391273644.408420,30258215949.912832,2196145,535241,1087196,3818582
2014-02-10,NASDAQ (Q),468693194,122525499,487501912,1078720605,19601014012.938547,8049787084.951705,19103316849.187862,46754117947.078114,3620738,447117,2821515,6889370
2014-02-10,CBSX (W),17668856,5378357,9670454,32717667,483227300.220000,408872699.610000,251074678.100000,1143174677.930000,140548,18163,71654,230365
2014-02-10,NASDAQ PSX (X),13834463,8687960,8912735,31435158,482285068.590000,455098935.929000,311621154.000000,1249005158.519000,93359,25095,50522,168976
2014-02-10,BATS BYX (Y),60837370,26435774,31623629,118896773,2058332130.415004,1244738249.157600,1168142466.523693,4471212846.096297,492265,116126,232157,840548
2014-02-10,BATS BZX (Z),241600408,114994757,148061200,504656365,8489138096.620076,6785192312.929601,5219424947.427027,20493755356.976704,1804509,404270,1002871,3211650
2014-02-07,NYSE MKT (A),0,10969412,5512475,16481887,0.000000,63055681.625900,102086634.009000,165142315.634900,0,22666,21823,44489
2014-02-07,NASDAQ BX (B),110159035,43996219,56649355,210804609,3999524329.505009,2361862223.014101,2652758884.090110,9014145436.609220,827335,174937,438300,1440572
2014-02-07,NSX (C),8945893,8251794,7576931,24774618,333733125.560000,345062594.449300,212395719.674500,891191439.683800,45135,13632,31747,90514
2014-02-07,NYSE (DN),149277754,42160067,95926026,287363847,5624890967.844537,2097363143.214199,3802202416.956618,11524456528.015354,694435,129173,377222,1200830
2014-02-07,NASDAQ (DQ),1147484179,340975505,660961647,2149421331,39727019145.413778,19114278664.566827,22227536240.374888,81068834050.355493,3827266,711486,2050138,6588890
2014-02-07,EDGA (J),99036382,46457853,54416542,199910777,3203263702.155005,2563066436.075799,1918192811.797797,7684522950.028601,773637,198534,417017,1389188
2014-02-07,EDGX (K),241722981,93526398,173179694,508429073,9199657564.824837,5009181030.069890,6590024540.886194,20798863135.780921,1382075,287564,851581,2521220
2014-02-07,CHX (M),11107627,12449151,3920043,27476821,560903238.552700,1530281673.160000,438888545.275500,2530073456.988200,745,4993,1183,6921
2014-02-07,NYSE (N),764179192,0,0,764179192,28661107326.898365,0.000000,0.000000,28661107326.898365,2297602,0,0,2297602
2014-02-07,NYSE Arca (P),331312128,258629640,201840454,791782222,14288818923.872992,17391406320.188528,9792895258.614399,41473120502.675919,2470989,696763,1312205,4479957
2014-02-07,NASDAQ (Q),548832390,161245595,566776678,1276854663,22846534912.949632,12523560904.408678,23123702694.736639,58493798512.094949,4107911,586710,3153796,7848417
2014-02-07,CBSX (W),23892061,7691201,12260597,43843859,643755627.830001,671968585.640000,308678812.820000,1624403026.290001,181992,24899,88067,294958
2014-02-07,NASDAQ PSX (X),13511714,13520600,10785630,37817944,397367382.125000,850487841.459999,392174856.885000,1640030080.469999,76790,35739,55450,167979
2014-02-07,BATS BYX (Y),66801222,33191492,37223230,137215944,2305424286.822998,1922238651.847799,1429625730.000301,5657288668.671098,523235,145281,272131,940647
2014-02-07,BATS BZX (Z),260117939,142112821,171160233,573390993,9004862253.439974,10248038318.821746,6270481032.120966,25523381604.382686,1886064,516800,1116841,3519705
2014-02-06,NYSE MKT (A),0,8903299,4751880,13655179,0.000000,57421421.753100,90102851.613000,147524273.366100,0,21275,19528,40803
2014-02-06,NASDAQ BX (B),107279417,41634135,55052843,203966395,3882849845.625014,2141723553.336800,2252425690.391194,8276999089.353008,846203,169426,424798,1440427
2014-02-06,NSX (C),8954357,8025793,6861877,23842027,328162067.540000,321350058.953000,209473766.472100,858985892.965100,46669,12907,28880,88456
2014-02-06,NYSE (DN),155953556,37969360,87104961,281027877,5883926065.761733,2001036746.604502,3337693386.760294,11222656199.126529,719915,118488,361757,1200160
2014-02-06,NASDAQ (DQ),1187106178,379574171,653479462,2220159811,41061664140.640716,22227767328.703834,20769805285.902328,84059236755.246878,4113487,680138,1985995,6779620
2014-02-06,EDGA (J),98297928,47841626,51875954,198015508,3146623518.449994,2369830021.948902,1632885969.964895,7149339510.363791,785618,204487,389025,1379130
2014-02-06,EDGX (K),258695582,83581253,158922667,501199502,9660382492.244305,4280178341.211595,5447193035.124472,19387753868.580372,1424519,263565,790021,2478105
2014-02-06,CHX (M),11983809,15980642,4887659,32852110,565378537.120000,1130604725.290000,346884863.836900,2042868126.246900,1384,2997,1129,5510
2014-02-06,NYSE (N),743363455,0,0,743363455,28379636677.142658,0.000000,0.000000,28379636677.142658,2285395,0,0,2285395
2014-02-06,NYSE Arca (P),343503190,255624951,193833543,792961684,14356580321.973078,15651795634.994249,8371391954.304851,38379767911.272178,2488057,653926,1226087,4368070
2014-02-06,NASDAQ (Q),556574829,149986132,509649737,1216210698,22662280861.038252,10446177006.447405,19904233990.676442,53012691858.162099,4093372,555583,2947190,7596145
2014-02-06,CBSX (W),18484022,12444522,11503730,42432274,487568002.620000,736810542.550000,276035562.580000,1500414107.750000,144138,22473,81053,247664
2014-02-06,NASDAQ PSX (X),12617078,13698110,11567536,37882724,349951380.525000,723668058.380000,339927635.800000,1413547074.705000,69014,34217,51350,154581
2014-02-06,BATS BYX (Y),64038582,31607776,33453445,129099803,2225929526.089589,1709045332.256802,1211942765.019002,5146917623.365393,508539,137544,247032,893115
2014-02-06,BATS BZX (Z),270126215,141687313,163857572,575671100,9213802478.953983,9202048849.026764,5601391184.700686,24017242512.681433,1971092,524348,1093775,3589215
2014-02-05,NYSE MKT (A),0,10198080,4754914,14952994,0.000000,61167442.491500,73999638.880000,135167081.371500,0,22126,17543,39669
2014-02-05,NASDAQ BX (B),111836184,43158178,57438042,212432404,4120529846.110203,2419124950.628702,2592120862.771520,9131775659.510425,878594,175919,441718,1496231
2014-02-05,NSX (C),10199812,9604019,8324949,28128780,363329339.770000,388189396.678900,205228486.304100,956747222.753000,52881,14860,30710,98451
2014-02-05,NYSE (DN),163839939,45071764,98393695,307305398,5873452218.004637,2306405144.723205,3536433677.591994,11716291040.319836,752133,134870,391966,1278969
2014-02-05,NASDAQ (DQ),1211084684,370081198,729835649,2311001531,41272136444.388357,20006508993.202144,23243551313.180496,84522196750.770997,4345275,719089,2162571,7226935
2014-02-05,EDGA (J),107926228,55571520,59924265,223422013,3477038391.015007,2888064816.899303,1928435926.321700,8293539134.236010,841096,230568,430757,1502421
2014-02-05,EDGX (K),273196779,96743668,177067003,547007450,10100741739.516512,5229598895.152991,6204970453.363178,21535311088.032681,1529540,305061,868511,2703112
2014-02-05,CHX (M),11663450,13828348,6162691,31654489,368835030.843600,1045169217.985000,507489529.695700,1921493778.524300,1174,5047,1058,7279
2014-02-05,NYSE (N),755487524,0,0,755487524,28684064392.133796,0.000000,0.000000,28684064392.133796,2475086,0,0,2475086
2014-02-05,NYSE Arca (P),355665388,271116625,209527133,836309146,15042778867.486174,18238056186.747693,9071635912.884913,42352470967.118780,2636207,774052,1313517,4723776
2014-02-05,NASDAQ (Q),596231793,180526363,575284630,1352042786,24245517019.010045,13790715105.721832,22182741862.759983,60218973987.491860,4463766,691918,3321419,8477103
2014-02-05,CBSX (W),13943584,5708732,7640047,27292363,392304988.180000,485119731.658600,194931114.190000,1072355834.028600,104608,17369,51634,173611
2014-02-05,NASDAQ PSX (X),13884449,13845944,11443162,39173555,426667687.255000,811524358.611100,394075595.125000,1632267640.991100,82226,38663,57836,178725
2014-02-05,BATS BYX (Y),69728863,36303906,37129637,143162406,2289620881.934990,1985663361.559100,1258613531.263202,5533897774.757292,548432,157314,264888,970634
2014-02-05,BATS BZX (Z),300531524,182773525,189847021,673152070,9989947139.954967,12398609316.545829,6353754867.515982,28742311324.016778,2172731,688191,1209630,4070552
2014-02-04,NYSE MKT (A),0,9919095,4780092,14699187,0.000000,60256449.718900,87796522.997000,148052972.715900,0,21725,20926,42651
2014-02-04,NASDAQ BX (B),115621189,47553820,60392260,223567269,4287964548.879998,2479501759.582900,2534311145.307387,9301777453.770285,918801,194806,458980,1572587
2014-02-04,NSX (C),9122157,10568053,7323325,27013535,306749458.404000,399043232.820699,193400636.763600,899193327.988299,46382,15932,29497,91811
2014-02-04,NYSE (DN),158113282,50122094,96423729,304659105,5670614861.822343,2687517756.368903,3554076734.309610,11912209352.500856,726954,151067,369125,1247146
2014-02-04,NASDAQ (DQ),1226879525,415531656,723123137,2365534318,41973890497.161901,22461137694.445982,22381250653.467034,86816278845.074917,4515146,835991,2177628,7528765
2014-02-04,EDGA (J),104143166,62753648,56004584,222901398,3305363103.871398,3107359184.113499,1784492983.522185,8197215271.507082,820339,248227,406936,1475502
2014-02-04,EDGX (K),270030048,99599886,178715014,548344948,9941793725.984367,5235305462.862201,6294282306.699484,21471381495.546052,1595180,314266,927663,2837109
2014-02-04,CHX (M),10763265,21050442,7858032,39671739,427487158.324100,1250481440.422000,1179633382.425000,2857601981.171100,1252,4121,1093,6466
2014-02-04,NYSE (N),836889463,0,0,836889463,31860673979.046934,0.000000,0.000000,31860673979.046934,2594942,0,0,2594942
2014-02-04,NYSE Arca (P),339912173,290362656,195634071,825908900,14088473178.052940,19062463113.147079,8399812769.267644,41550749060.467663,2589416,772258,1215875,4577549
2014-02-04,NASDAQ (Q),598716499,190682258,592302070,1381700827,24858575250.147393,14525182350.912158,22662640896.816396,62046398497.875947,4583496,719558,3283424,8586478
2014-02-04,CBSX (W),14464273,10241505,8129048,32834826,411240554.090000,740043608.860000,211026480.580000,1362310643.530000,112953,22642,55562,191157
2014-02-04,NASDAQ PSX (X),14790524,13828031,12580049,41198604,439236657.730000,796185412.468000,474383236.530000,1709805306.728000,92810,38025,65062,195897
2014-02-04,BATS BYX (Y),71244610,40314167,37457073,149015850,2421537632.709001,2213196997.200899,1354502404.049708,5989237033.959608,571653,177100,274815,1023568
2014-02-04,BATS BZX (Z),306619105,185907585,198617873,691144563,10270744832.839913,12855239112.324466,6388010188.636654,29513994133.801033,2231829,690507,1248214,4170550
2014-02-03,NYSE MKT (A),0,11684342,5028593,16712935,0.000000,74616034.174800,120186239.561000,194802273.735800,0,25435,22565,48000
2014-02-03,NASDAQ BX (B),160023403,67306914,84236309,311566626,6234305041.515008,3905604060.590699,3979362945.154546,14119272047.260253,1333329,278736,666796,2278861
2014-02-03,NSX (C),12964554,12201823,10089053,35255430,447147596.493000,656398273.221502,286734767.655700,1390280637.370202,66978,20206,41983,129167
2014-02-03,NYSE (DN),176610651,51675157,105054047,333339855,6396150617.117294,3087085521.042085,3739287676.108307,13222523814.267686,908433,176607,454461,1539501
2014-02-03,NASDAQ (DQ),1343926622,842581371,847053272,3033561265,45370938193.056483,56583704788.515850,28456220789.561609,130410863771.133942,5222009,1248237,2672112,9142358
2014-02-03,EDGA (J),127031074,85043377,68267030,280341481,4000872919.638804,5167248668.867177,2215104969.106686,11383226557.612667,1021213,333309,504142,1858664
2014-02-03,EDGX (K),358437654,156359704,241916841,756714199,13413143207.541063,10109637989.327320,8776379573.768236,32299160770.636619,2063669,517524,1236305,3817498
2014-02-03,CHX (M),9810555,19830337,6164440,35805332,489831421.562500,1823859131.833400,363763062.854000,2677453616.249900,1718,7555,1405,10678
2014-02-03,NYSE (N),921645380,0,0,921645380,35556714754.179600,0.000000,0.000000,35556714754.179600,3069825,0,0,3069825
2014-02-03,NYSE Arca (P),393190798,423002410,232172139,1048365347,16162691640.489299,30364451024.364430,10027322090.961306,56554464755.815035,3078226,1143022,1521240,5742488
2014-02-03,NASDAQ (Q),713509401,278974538,707537273,1700021212,28646336422.844144,22905774534.722971,27927551616.837789,79479662574.404904,5433607,1052317,4088923,10574847
2014-02-03,CBSX (W),15494213,11441199,8376971,35312383,431135152.510000,928972356.920000,221375429.830000,1581482939.260000,119941,29289,59222,208452
2014-02-03,NASDAQ PSX (X),19773672,20160396,15258570,55192638,620611306.380000,1371405182.890002,559576819.491400,2551593308.761402,137374,58042,84389,279805
2014-02-03,BATS BYX (Y),89564884,52887948,46284273,188737105,2984901399.667997,3329937600.647801,1724392703.262806,8039231703.578604,730502,242069,340238,1312809
2014-02-03,BATS BZX (Z),388674315,273906024,244241296,906821635,13154376424.134992,20654997802.289197,8442988102.662685,42252362329.086874,2814925,990516,1576556,5381997
2014-01-31,NYSE MKT (A),0,12453925,5629532,18083457,0.000000,63341599.616000,115913651.801000,179255251.417000,0,20571,25900,46471
2014-01-31,NASDAQ BX (B),115873213,50718368,63071882,229663463,4323587667.969994,2745651023.415495,2842498957.321611,9911737648.707100,916563,205584,463958,1586105
2014-01-31,NSX (C),14368274,11824079,11858497,38050850,514824326.155000,588001745.093200,324711511.970001,1427537583.218201,76346,21078,44494,141918
2014-01-31,NYSE (DN),163281861,49357063,105158076,317797000,6154954340.329853,2694023406.751185,4474560533.917547,13323538280.998585,775206,154975,404134,1334315
2014-01-31,NASDAQ (DQ),1174069394,424282969,755277073,2353629436,40374675192.545907,23828827011.257608,26579857086.140358,90783359289.943873,4196769,806799,2216247,7219815
2014-01-31,EDGA (J),101817969,53636396,55912722,211367087,3295608032.140186,2772899825.870298,1869287342.538094,7937795200.548578,798748,211919,401267,1411934
2014-01-31,EDGX (K),269471318,104860682,191995717,566327717,10195831001.363190,5170594146.066923,7570949243.043448,22937374390.473561,1513716,319648,913827,2747191
2014-01-31,CHX (M),8946936,15859365,7884821,32691122,348426008.521000,1073725484.895000,1487233348.685800,2909384842.101800,1031,4638,1142,6811
2014-01-31,NYSE (N),952370011,0,0,952370011,36239259119.354713,0.000000,0.000000,36239259119.354713,2406972,0,0,2406972
2014-01-31,NYSE Arca (P),309265510,294135473,201477609,804878592,12773902769.604998,20411625689.283330,10157601659.163358,43343130118.051686,2318884,722308,1224505,4265697
2014-01-31,NASDAQ (Q),573875902,188777054,659034132,1421687088,23562354105.917106,14879665715.709408,27748251918.989340,66190271740.615854,4307026,687430,3252548,8247004
2014-01-31,CBSX (W),11731623,7983848,7525324,27240795,344991897.890000,631570054.200000,188731542.310000,1165293494.400000,90296,19476,45323,155095
2014-01-31,NASDAQ PSX (X),13073459,13203456,10429899,36706814,402487150.315000,804149225.165000,386938985.661000,1593575361.141000,86229,38587,57848,182664
2014-01-31,BATS BYX (Y),67635981,38250678,38586132,144472791,2316189508.545992,2165373249.853101,1554903360.525194,6036466118.924287,546463,166688,279750,992901
2014-01-31,BATS BZX (Z),300880754,181006253,190809370,672696377,10208325251.344138,11890574239.963250,7190121504.364387,29289020995.671775,2128295,633508,1209941,3971744
2014-01-30,NYSE MKT (A),0,10654971,5697257,16352228,0.000000,51856874.834700,122305547.710000,174162422.544700,0,20059,24552,44611
2014-01-30,NASDAQ BX (B),101071958,40381342,57084922,198538222,3850802469.620000,2073520927.813199,2923862215.976078,8848185613.409277,837574,172094,457425,1467093
2014-01-30,NSX (C),13061294,11359260,11685527,36106081,464044397.293000,427596301.642300,367204353.017801,1258845051.953101,66809,19348,45084,131241
2014-01-30,NYSE (DN),158432109,45327532,108188838,311948479,6056676433.218104,2266512596.624912,4642609585.379755,12965798615.222771,717641,144814,423636,1286091
2014-01-30,NASDAQ (DQ),1144835100,359057402,788655589,2292548091,40467680064.395123,16624691733.808338,30139333038.980016,87231704837.183477,4018106,709443,2247966,6975515
2014-01-30,EDGA (J),89860544,45794731,51664958,187320233,3035360897.225295,2237365993.614900,2025942046.583190,7298668937.423385,735753,185772,391966,1313491
2014-01-30,EDGX (K),238874890,91451500,186688877,517015267,8962562092.686893,4206159535.176700,8078695324.209563,21247416952.073156,1341511,273072,904528,2519111
2014-01-30,CHX (M),8634756,15155134,10822299,34612189,395726691.715000,922599667.454400,3943648621.397400,5261974980.566800,817,4351,640,5808
2014-01-30,NYSE (N),654561759,0,0,654561759,25372853152.816805,0.000000,0.000000,25372853152.816805,2119643,0,0,2119643
2014-01-30,NYSE Arca (P),285233676,233282397,190957424,709473497,12130502313.464875,14698410980.423282,10212387885.680542,37041301179.568699,2216630,604614,1179976,4001220
2014-01-30,NASDAQ (Q),500861748,153394180,537658411,1191914339,20775977105.571714,10539691893.167590,24719673134.679311,56035342133.418615,3798982,557268,3050000,7406250
2014-01-30,CBSX (W),10944042,8095249,6648029,25687320,339087752.300000,563463597.650000,206424171.420000,1108975521.370000,87427,14708,46386,148521
2014-01-30,NASDAQ PSX (X),11285036,13680441,9911876,34877353,372473920.685000,748474155.580000,388296122.425000,1509244198.690000,79695,33573,53251,166519
2014-01-30,BATS BYX (Y),61927642,34529677,35773754,132231073,2164220422.305997,1877280052.971400,1473569830.757807,5515070306.035204,510777,151341,264347,926465
2014-01-30,BATS BZX (Z),268549465,147396996,170190391,586136852,9145296238.008491,9370222600.814497,6305159008.017157,24820677846.840145,1958034,518113,1101493,3577640
2014-01-29,NYSE MKT (A),0,11600390,6976404,18576794,0.000000,67990145.077000,158642180.780000,226632325.857000,0,25975,27187,53162
2014-01-29,NASDAQ BX (B),118895007,53361300,63310999,235567306,4503444152.554987,2826097153.016497,2635359461.702703,9964900767.274187,951011,222994,470067,1644072
2014-01-29,NSX (C),13574516,12697528,13318044,39590088,471160839.535000,763343607.923602,352711988.747401,1587216436.206003,68089,24505,45545,138139
2014-01-29,NYSE (DN),153386470,54106255,101586029,309078754,5654942525.295540,2937688185.920402,4044923643.005928,12637554354.221870,698005,169825,401427,1269257
2014-01-29,NASDAQ (DQ),1152107453,441348988,717111929,2310568370,39922050959.651034,23459759655.633830,23678829939.901607,87060640555.186471,4204826,860397,2229398,7294621
2014-01-29,EDGA (J),103035198,61608453,57287858,221931509,3501196848.389984,3219108954.642101,1969372754.220793,8689678557.252878,803851,257436,420434,1481721
2014-01-29,EDGX (K),270512708,120378983,204881618,595773309,9940139035.266310,6463077068.271801,7523370298.930698,23926586402.468809,1513411,380730,954117,2848258
2014-01-29,CHX (M),10949632,22515510,4713437,38178579,448296622.985600,1967330191.485899,283659624.163200,2699286438.634699,870,8496,945,10311
2014-01-29,NYSE (N),736476883,0,0,736476883,27994241027.332872,0.000000,0.000000,27994241027.332872,2518515,0,0,2518515
2014-01-29,NYSE Arca (P),343374649,361982539,212043751,917400939,14002404996.659456,23877594624.595042,9460741049.695114,47340740670.949612,2511263,914894,1300552,4726709
2014-01-29,NASDAQ (Q),635914156,230955501,596009787,1462879444,25503261299.975944,16686789552.448566,23984058448.978413,66174109301.402923,4800563,857995,3457024,9115582
2014-01-29,CBSX (W),13480761,8157672,8373286,30011719,386375377.290000,645409623.010000,217074850.808100,1248859851.108100,100954,21732,52084,174770
2014-01-29,NASDAQ PSX (X),14071124,16183788,11813953,42068865,449213624.285000,991001392.558800,518185147.163600,1958400164.007400,94073,46946,65185,206204
2014-01-29,BATS BYX (Y),73941719,46081254,41296715,161319688,2510783070.501988,2591795111.013795,1482797821.408501,6585376002.924284,586847,205700,290449,1082996
2014-01-29,BATS BZX (Z),330952990,232864651,197423199,761240840,11042632990.909871,15664318666.514358,7051172019.564786,33758123676.989015,2336688,819535,1277642,4433865
2014-01-28,NYSE MKT (A),0,9916306,4999255,14915561,0.000000,53943360.351000,95412430.659000,149355791.010000,0,21089,21786,42875
2014-01-28,NASDAQ BX (B),102237806,38922123,55941991,197101920,3667990051.509982,1917818841.693898,2838259306.652007,8424068199.855887,844496,166034,449571,1460101
2014-01-28,NSX (C),11700876,8686202,10975289,31362367,434998222.725100,351973629.872199,358118666.844702,1145090519.442001,65794,17120,43551,126465
2014-01-28,NYSE (DN),142362266,37074750,93797884,273234900,5169806315.090016,1963061143.937899,4627588018.637350,11760455477.665265,663150,123875,386125,1173150
2014-01-28,NASDAQ (DQ),1119728395,328187020,774640112,2222555527,37494685096.490275,16752057554.871297,28382334659.577017,82629077310.938589,3896483,676871,2215805,6789159
2014-01-28,EDGA (J),87766847,41138250,48812455,177717552,2833969209.631495,1954692249.673701,1780087047.953298,6568748507.258494,706619,170669,364330,1241618
2014-01-28,EDGX (K),227190309,80022888,168537533,475750730,8387349659.044046,3950355145.997597,7590550773.947293,19928255578.988936,1312585,255163,863633,2431381
2014-01-28,CHX (M),11220302,9936564,4538816,25695682,481041770.019000,791799964.124000,290141017.172200,1562982751.315200,477,3833,665,4975
2014-01-28,NYSE (N),622418196,0,0,622418196,23949519047.744613,0.000000,0.000000,23949519047.744613,2029254,0,0,2029254
2014-01-28,NYSE Arca (P),277529005,213278446,177855856,668663307,11445755775.898588,13504679647.330036,9302736011.791382,34253171435.020006,2167063,592785,1134697,3894545
2014-01-28,NASDAQ (Q),494859929,140682729,533100676,1168643334,19872540313.878056,10289222469.127791,23930839131.458845,54092601914.464692,3753296,549106,3052832,7355234
2014-01-28,CBSX (W),13344705,8911048,8221794,30477547,382140841.420000,662398753.995400,273517968.650000,1318057564.065400,106223,14517,53461,174201
2014-01-28,NASDAQ PSX (X),11410265,10825156,9239444,31474865,363959791.675000,628643486.980800,395797357.752399,1388400636.408199,77786,31222,53653,162661
2014-01-28,BATS BYX (Y),62501628,30208232,34687809,127397669,2114658588.952001,1604601747.309700,1656393662.063995,5375653998.325696,512845,137265,262687,912797
2014-01-28,BATS BZX (Z),256371233,136510554,168995281,561877068,8515004498.872795,8817868476.359314,6670021042.770741,24002894018.002850,1880124,487626,1107129,3474879
2014-01-27,NYSE MKT (A),0,13567801,6216068,19783869,0.000000,65314136.148300,114631134.383000,179945270.531300,0,27362,25410,52772
2014-01-27,NASDAQ BX (B),120438720,55094179,67669042,243201941,4315279412.646093,2985368801.027499,2890707202.252797,10191355415.926389,951675,244052,518923,1714650
2014-01-27,NSX (C),15419997,14110603,15620039,45150639,511720689.972900,632972345.442000,369529103.382499,1514222138.797399,79144,28607,56848,164599
2014-01-27,NYSE (DN),179157550,61782561,122060610,363000721,6476353550.377937,3462966755.061816,4703805700.085925,14643126005.525678,813124,196629,466655,1476408
2014-01-27,NASDAQ (DQ),1239250248,460743600,816384838,2516378686,42381700665.814365,23533862817.488120,26757449042.200927,92673012525.503412,4477109,924205,2499551,7900865
2014-01-27,EDGA (J),104889943,64502556,57639320,227031819,3413873280.809195,3411273700.766397,2032511953.992890,8857658935.568482,834844,269715,428157,1532716
2014-01-27,EDGX (K),276246544,118439279,214398280,609084103,9986868100.895759,6035674073.404500,8090850505.508659,24113392679.808918,1574871,383256,1054416,3012543
2014-01-27,CHX (M),14266784,13672068,5778439,33717291,447808867.553000,1040639494.390000,330411732.504400,1818860094.447400,750,5040,1232,7022
2014-01-27,NYSE (N),779684626,0,0,779684626,29633022157.323895,0.000000,0.000000,29633022157.323895,2540103,0,0,2540103
2014-01-27,NYSE Arca (P),323801295,313655692,207224949,844681936,13335795119.396641,20088539157.896168,10033380109.762979,43457714387.055788,2497790,911791,1327314,4736895
2014-01-27,NASDAQ (Q),577703959,211805097,616711334,1406220390,23124236274.275383,15866671750.640802,26536079992.337894,65526988017.254079,4453651,822503,3527989,8804143
2014-01-27,CBSX (W),14354108,9172585,8760188,32286881,415196197.510000,734828434.620000,241771872.930000,1391796505.060000,109536,20409,64518,194463
2014-01-27,NASDAQ PSX (X),14304862,17803750,12180870,44289482,464077764.990001,1073780286.180001,570749497.384002,2108607548.554004,96486,50284,68888,215658
2014-01-27,BATS BYX (Y),76366857,48361036,42287535,167015428,2568420205.122996,2717304787.624800,1622503501.673007,6908228494.420803,604876,209266,302771,1116913
2014-01-27,BATS BZX (Z),319327288,211988350,209372930,740688568,10511145752.761026,14550228946.575170,7454340004.429321,32515714703.765517,2323912,794049,1361239,4479200
2014-01-24,NYSE MKT (A),0,16104195,5747973,21852168,0.000000,99751811.925200,88409422.631000,188161234.556200,0,30352,18519,48871
2014-01-24,NASDAQ BX (B),137549312,58911062,67325863,263786237,4902283424.379994,3265161311.280798,2968938072.478187,11136382808.138979,1054897,243358,516473,1814728
2014-01-24,NSX (C),20559432,15142150,16065035,51766617,630861782.180500,643213006.681302,366643054.707600,1640717843.569402,92650,31956,55853,180459
2014-01-24,NYSE (DN),208221161,63272830,129657239,401151230,7308193361.245378,3500423588.547793,4761247744.428429,15569864694.221600,949220,209229,492597,1651046
2014-01-24,NASDAQ (DQ),1435103817,492019815,861646539,2788770171,47109657747.499418,27193743578.918574,27194513100.470579,101497914426.888571,5199195,1048227,2632578,8880000
2014-01-24,EDGA (J),118680052,63730389,58955363,241365804,3882464637.504402,3302987497.552198,2018365505.404090,9203817640.460690,904234,253909,433870,1592013
2014-01-24,EDGX (K),327548866,127049222,224183630,678781718,11748406382.591298,6569862164.799782,7821162891.076076,26139431438.467156,1791196,388897,1073680,3253773
2014-01-24,CHX (M),14905730,11985277,3598242,30489249,546275309.548000,1117882018.660000,203635596.216000,1867792924.424000,548,4429,728,5705
2014-01-24,NYSE (N),919412817,0,0,919412817,34390562262.539679,0.000000,0.000000,34390562262.539679,2678039,0,0,2678039
2014-01-24,NYSE Arca (P),371245884,335273891,214553122,921072897,15034281053.937524,21970091271.475561,10207639520.482165,47212011845.895250,2673781,897211,1350185,4921177
2014-01-24,NASDAQ (Q),644175519,215778892,639993485,1499947896,25573653543.897224,15701262799.454033,26381469755.670487,67656386099.021744,4703945,788441,3368372,8860758
2014-01-24,CBSX (W),15356272,10462765,8929495,34748532,439445599.232800,764722880.710000,242990165.220000,1447158645.162800,112207,21993,64649,198849
2014-01-24,NASDAQ PSX (X),15170116,17210931,12336678,44717725,461829783.255000,1007818593.664999,547764257.590000,2017412634.509999,98066,46076,67576,211718
2014-01-24,BATS BYX (Y),85282391,49755917,45393628,180431936,2804115881.176992,2917839366.993592,1674547160.212400,7396502408.382984,653580,209494,324316,1187390
2014-01-24,BATS BZX (Z),346459311,212757672,204841564,764058547,11317970838.926642,14699876948.483551,7284024556.897126,33301872344.307319,2400541,741099,1341325,4482965
2014-01-23,NYSE MKT (A),0,14906666,5149241,20055907,0.000000,72232432.347200,96416441.405000,168648873.752200,0,28291,21011,49302
2014-01-23,NASDAQ BX (B),115041923,42866092,56573041,214481056,4128578125.205009,2106498520.018305,2519464176.227795,8754540821.451109,894339,172183,447041,1513563
2014-01-23,NSX (C),19107220,12230976,13007658,44345854,609359187.360000,355671320.911900,343454962.000800,1308485470.272700,79417,25345,48950,153712
2014-01-23,NYSE (DN),183747031,48061742,103889577,335698350,6397772669.904577,2518342331.360006,4280649538.480416,13196764539.744999,817784,156311,442184,1416279
2014-01-23,NASDAQ (DQ),1316717089,390516322,789331700,2496565111,44434301762.829355,20290665074.558866,27838955978.762932,92563922816.151153,4565867,848535,2371430,7785832
2014-01-23,EDGA (J),100631341,49784931,49079409,199495681,3256541898.555004,2389087427.031695,1718255552.577601,7363884878.164300,766958,195765,376245,1338968
2014-01-23,EDGX (K),276689604,101658238,192325281,570673123,10187167570.813424,4619522191.090877,7132823185.646347,21939512947.550648,1475999,287743,911380,2675122
2014-01-23,CHX (M),10731972,21049518,6722001,38503491,364195690.439000,1276001256.684600,423836975.052600,2064033922.176200,476,3287,663,4426
2014-01-23,NYSE (N),780243188,0,0,780243188,29345263952.398606,0.000000,0.000000,29345263952.398606,2345851,0,0,2345851
2014-01-23,NYSE Arca (P),307568795,252313786,188065146,747947727,12550991229.993020,15665997306.997591,8959428195.180880,37176416732.171491,2178761,648294,1186173,4013228
2014-01-23,NASDAQ (Q),526385009,147527524,571163258,1245075791,20898735987.614972,10320627399.284646,24913026805.431728,56132390192.331346,3845526,540591,2958957,7345074
2014-01-23,CBSX (W),14267436,5682940,7315658,27266034,390839660.420000,370060679.240000,211721217.630000,972621557.290000,105320,17711,54847,177878
2014-01-23,NASDAQ PSX (X),13328290,11796252,8722479,33847021,382253001.695000,686684715.377900,343425636.813000,1412363353.885900,82311,32293,51911,166515
2014-01-23,BATS BYX (Y),71091489,33413982,36102267,140607738,2397923408.868001,1627779346.606598,1425456741.996096,5451159497.470695,553749,138141,270134,962024
2014-01-23,BATS BZX (Z),277490739,144278484,167120340,588889563,9095771238.005016,9283862450.489305,5870833914.858725,24250467603.353046,1947451,513066,1114568,3575085
2014-01-22,NYSE MKT (A),0,14674487,5268055,19942542,0.000000,78613792.999800,100209230.936000,178823023.935800,0,26667,21875,48542
2014-01-22,NASDAQ BX (B),94401418,30745569,48389344,173536331,3316700233.964993,1403749538.173397,2061868315.016891,6782318087.155281,731510,128072,381039,1240621
2014-01-22,NSX (C),14536518,10475803,15889288,40901609,428539925.195000,221825027.635300,287048390.977700,937413343.808000,63437,19545,47722,130704
2014-01-22,NYSE (DN),152047394,35262400,104452253,291762047,5448961113.275613,1503296112.761600,3836802096.316961,10789059322.354174,709135,113376,401004,1223515
2014-01-22,NASDAQ (DQ),1168259795,291253309,747460409,2206973513,38495985593.091426,11449881337.921004,24116538542.201122,74062405473.213552,4045964,650831,2219042,6915837
2014-01-22,EDGA (J),84870170,32750968,44421047,162042185,2772897160.693898,1486863373.413801,1452476052.596102,5712236586.703801,657906,135973,327807,1121686
2014-01-22,EDGX (K),222648289,73404965,193789493,489842747,7964905753.718408,2869045684.851591,6493386434.336728,17327337872.906727,1205054,203777,876514,2285345
2014-01-22,CHX (M),10797316,8085780,5342410,24225506,431953241.155500,525894019.775000,541987060.744100,1499834321.674600,1212,1648,977,3837
2014-01-22,NYSE (N),629170635,0,0,629170635,24393742529.728785,0.000000,0.000000,24393742529.728785,1966325,0,0,1966325
2014-01-22,NYSE Arca (P),256351838,168409939,170418399,595180176,10668334577.225913,9557100946.384898,7519346451.405254,27744781975.016065,1875281,455324,1052728,3383333
2014-01-22,NASDAQ (Q),429834228,101494032,498399822,1029728082,18058775817.820775,6967249144.193768,19877768037.100481,44903792999.115024,3213187,376809,2595671,6185667
2014-01-22,CBSX (W),14472991,4787254,7623643,26883888,469939898.820000,337195130.010000,212760847.460000,1019895876.290000,109809,12887,57807,180503
2014-01-22,NASDAQ PSX (X),11704630,7466974,8771862,27943466,350999224.710000,411427000.237800,340034958.370000,1102461183.317800,70829,22525,49586,142940
2014-01-22,BATS BYX (Y),59893025,25796595,31616067,117305687,2092765356.226998,1146268382.485398,1172419523.762600,4411453262.474996,484911,100501,236326,821738
2014-01-22,BATS BZX (Z),231356657,90517038,150065200,471938895,7529316923.748901,5591772209.005396,5000057327.327284,18121146460.081581,1614580,332366,975593,2922539
2014-01-21,NYSE MKT (A),0,20266403,5409427,25675830,0.000000,85863417.266800,97713411.202000,183576828.468800,0,31719,21894,53613
2014-01-21,NASDAQ BX (B),95511761,33763645,50658050,179933456,3413030147.685010,1603083232.578602,2016653172.169399,7032766552.433011,742066,146065,392813,1280944
2014-01-21,NSX (C),20648220,13186016,13910785,47745021,557082720.023100,323209244.370600,315895484.900200,1196187449.293900,71700,26191,48348,146239
2014-01-21,NYSE (DN),166942146,41726363,105371137,314039646,5904555472.437215,1952711001.408703,3811622898.685201,11668889372.531119,742639,132955,426726,1302320
2014-01-21,NASDAQ (DQ),1275537041,345358129,729074136,2349969306,42310973245.751929,15191501572.903813,22376736880.275421,79879211698.931163,4315101,758526,2262198,7335825
2014-01-21,EDGA (J),86701865,36270237,45330243,168302345,2816747052.165000,1733812187.824104,1406990329.976007,5957549569.965111,666176,149827,333643,1149646
2014-01-21,EDGX (K),259889155,82245206,188133609,530267970,9319316268.024919,3279723418.475493,6100280252.306978,18699319938.807390,1363106,236579,863059,2462744
2014-01-21,CHX (M),11034941,7585544,4978712,23599197,529217907.752900,421885536.650400,224763493.316100,1175866937.719400,664,2475,779,3918
2014-01-21,NYSE (N),753311235,0,0,753311235,29083577640.213984,0.000000,0.000000,29083577640.213984,2052049,0,0,2052049
2014-01-21,NYSE Arca (P),281633911,211032715,163221490,655888116,11721996845.919920,13046243279.102142,6831021746.130042,31599261871.152104,2110847,559851,1033809,3704507
2014-01-21,NASDAQ (Q),471311787,112933784,522249590,1106495161,19478544548.642573,7791706108.816780,20348290431.495208,47618541088.954561,3384997,432944,2730874,6548815
2014-01-21,CBSX (W),14771719,4556659,8586097,27914475,490884229.930000,337966407.280000,233292547.030000,1062143184.240000,115048,15697,61873,192618
2014-01-21,NASDAQ PSX (X),12137508,8442286,8422189,29001983,376654324.575000,519943906.600000,338471596.055000,1235069827.230000,75189,26931,48941,151061
2014-01-21,BATS BYX (Y),63181393,25739882,32515843,121437118,2130265619.856004,1223957411.001900,1189037605.032696,4543260635.890600,496528,111242,245601,853371
2014-01-21,BATS BZX (Z),274619390,101619393,159293783,535532566,8658509771.594998,6524135681.337676,5245330850.138228,20427976303.070902,1797085,388344,1026860,3212289
2014-01-17,NYSE MKT (A),0,13518303,5690720,19209023,0.000000,92186089.503400,98679954.175000,190866043.678400,0,25807,22203,48010
2014-01-17,NASDAQ BX (B),101672528,38094711,55520689,195287928,3655296350.534998,1735529722.906602,2291914531.915603,7682740605.357203,766014,131037,403880,1300931
2014-01-17,NSX (C),15055446,11200111,14827740,41083297,478088502.733400,348366620.134200,297364479.976300,1123819602.843900,64920,20008,47647,132575
2014-01-17,NYSE (DN),155199969,36064373,102873732,294138074,5766382041.386385,1757834925.210397,3527740979.866798,11051957946.463580,700136,115856,400111,1216103
2014-01-17,NASDAQ (DQ),1160287901,333807461,768379786,2262475148,39600140492.642357,16739717699.884723,23495038907.554360,79834897100.081440,3963188,685396,2233612,6882196
2014-01-17,EDGA (J),87505779,38543893,49319010,175368682,2923135479.285999,1762148186.240101,1530623430.183397,6215907095.709497,671532,140054,359521,1171107
2014-01-17,EDGX (K),237683440,74585535,188233930,500502905,8617518706.341481,3322994159.326889,6016438997.499461,17956951863.167831,1243076,211393,845715,2300184
2014-01-17,CHX (M),11564938,18936601,9292712,39794251,495274836.149000,1059399068.100000,529484458.346400,2084158362.595400,507,1986,652,3145
2014-01-17,NYSE (N),893132885,0,0,893132885,37441995725.224807,0.000000,0.000000,37441995725.224807,2009053,0,0,2009053
2014-01-17,NYSE Arca (P),265229251,200737910,168195483,634162644,11332206469.733781,12597723648.475991,7302423913.202352,31232354031.412124,1985193,478838,1050277,3514308
2014-01-17,NASDAQ (Q),424792994,110229268,639985253,1175007515,17838013495.713045,7837541693.963309,27071453052.742747,52747008242.419101,3098236,398723,2709682,6206641
2014-01-17,CBSX (W),15572887,4344628,8849133,28766648,524393686.810000,324407024.800000,237845842.950000,1086646554.560000,116566,14377,61732,192675
2014-01-17,NASDAQ PSX (X),12159968,8765165,9652354,30577487,401867540.315000,575899172.740000,380248526.964999,1358015240.019999,79906,25546,50070,155522
2014-01-17,BATS BYX (Y),62695404,25378867,34358438,122432709,2191656919.600008,1270434800.845601,1217460653.453313,4679552373.898922,482686,100271,244254,827211
2014-01-17,BATS BZX (Z),231635708,101865696,160315353,493816757,7964484496.510781,6798262104.993205,5442989920.424907,20205736521.928893,1620019,365174,1014224,2999417
2014-01-16,NYSE MKT (A),0,11013397,4433662,15447059,0.000000,63499651.502100,71450866.838000,134950518.340100,0,21631,16779,38410
2014-01-16,NASDAQ BX (B),93943935,30543869,50372716,174860520,3359594409.772287,1357379367.883498,1945551129.750207,6662524907.405992,739965,115110,379591,1234666
2014-01-16,NSX (C),16157624,9600995,16658118,42416737,498013235.708300,315016008.963100,290020728.968700,1103049973.640100,67303,17079,49604,133986
2014-01-16,NYSE (DN),152985616,32421295,95941252,281348163,5451818043.549410,1559747615.078200,3216277791.466689,10227843450.094299,666806,104110,380807,1151723
2014-01-16,NASDAQ (DQ),1188208506,298020467,759693707,2245922680,39741232016.333761,13473404706.133899,21890946215.737179,75105582938.204839,4019455,651133,2178858,6849446
2014-01-16,EDGA (J),81451387,31912558,42847052,156210997,2632589231.519601,1438996837.687997,1276272837.499996,5347858906.707594,608062,115056,307947,1031065
2014-01-16,EDGX (K),253053451,65131201,186464367,504649019,9089275509.748210,2842373774.372903,5688479578.211371,17620128862.332484,1323189,183501,829115,2335805
2014-01-16,CHX (M),10934620,15770905,10707657,37413182,384354139.556800,747882260.607000,1000780609.870000,2133017010.033800,498,1907,743,3148
2014-01-16,NYSE (N),654112070,0,0,654112070,24492008206.266840,0.000000,0.000000,24492008206.266840,1935070,0,0,1935070
2014-01-16,NYSE Arca (P),276423880,165413284,161298954,603136118,11262273838.329751,10369720103.992263,6238273891.836870,27870267834.158884,1936083,422926,1006133,3365142
2014-01-16,NASDAQ (Q),439922753,97607320,478457031,1015987104,17481589087.602519,6597977173.348000,17387102810.650331,41466669071.600850,3104103,334810,2509737,5948650
2014-01-16,CBSX (W),14384685,7177687,10270153,31832525,437856498.430000,438089249.890000,270842194.590000,1146787942.910000,111255,13669,60028,184952
2014-01-16,NASDAQ PSX (X),11408487,8073216,9466523,28948226,345197929.360000,455099442.380000,338428824.105000,1138726195.845000,70676,21765,48363,140804
2014-01-16,BATS BYX (Y),60733563,23765751,31954829,116454143,2040040937.586996,1125611850.808800,1029446343.047404,4195099131.443200,482492,96559,230383,809434
2014-01-16,BATS BZX (Z),240851981,95106480,151386756,487345217,7878097516.066397,6045381649.976396,4771414954.883231,18694894120.926024,1664816,330850,963191,2958857
2014-01-15,NYSE MKT (A),0,13884100,6294143,20178243,0.000000,107330499.626900,110586410.668000,217916910.294900,0,22820,24777,47597
2014-01-15,NASDAQ BX (B),107919537,33077651,56815589,197812777,3766884291.035020,1525342268.494200,2396955414.415317,7689181973.944537,830336,125424,447721,1403481
2014-01-15,NSX (C),19150072,11643261,15663816,46457149,550195035.144300,341148468.377000,326462289.035300,1217805792.556600,68328,20928,50145,139401
2014-01-15,NYSE (DN),167746110,39457064,104175418,311378592,6143715739.914414,1855373651.677804,3932485015.556272,11931574407.148490,735670,128941,415358,1279969
2014-01-15,NASDAQ (DQ),1255503885,322762737,774758023,2353024645,42394195755.517581,15819425184.601707,24304331591.868889,82517952531.988177,4126304,670084,2271020,7067408
2014-01-15,EDGA (J),91991595,33845070,48804390,174641055,2872554029.884990,1586772660.510300,1549600313.614207,6008927004.009497,661155,131948,351539,1144642
2014-01-15,EDGX (K),262955436,73696123,194660443,531312002,9174433304.012816,3067595482.758603,6627547811.999851,18869576598.771270,1295217,198437,880046,2373700
2014-01-15,CHX (M),12497952,15203752,4337511,32039215,588503013.438500,1069981853.668400,231346245.059300,1889831112.166200,658,2617,720,3995
2014-01-15,NYSE (N),717895451,0,0,717895451,27337075886.670042,0.000000,0.000000,27337075886.670042,2088238,0,0,2088238
2014-01-15,NYSE Arca (P),295731164,173531390,170172043,639434597,12012794871.107563,11112157716.552901,7548861189.021227,30673813776.681691,2031191,475991,1084811,3591993
2014-01-15,NASDAQ (Q),462495722,104398676,510551230,1077445628,18411134533.556469,7272782479.947602,20359456849.424135,46043373862.928206,3211464,380215,2778358,6370037
2014-01-15,CBSX (W),15862087,5017874,10359790,31239751,457676629.500000,387870797.190000,235253032.730000,1080800459.420000,115139,15474,68161,198774
2014-01-15,NASDAQ PSX (X),13566015,8854271,9684674,32104960,401586991.555000,543876501.336000,416478804.428400,1361942297.319400,78667,25497,54779,158943
2014-01-15,BATS BYX (Y),71634360,26270397,34479206,132383963,2337316170.899999,1238896772.619298,1260085395.105003,4836298338.624300,542860,107547,255245,905652
2014-01-15,BATS BZX (Z),287626438,104536593,163758395,555921426,9230874495.838357,6929368596.943695,5682399394.675669,21842642487.457721,1807360,380707,1029011,3217078
2014-01-14,NYSE MKT (A),0,19089421,5138517,24227938,0.000000,85266262.540400,95378657.198000,180644919.738400,0,31189,20938,52127
2014-01-14,NASDAQ BX (B),104332067,35460764,57069470,196862301,3759163856.339001,1597547129.710900,2442814594.781809,7799525580.831710,836110,140441,446823,1423374
2014-01-14,NSX (C),13690450,16602659,13772307,44065416,454873288.682400,439121593.366700,343663936.256299,1237658818.305399,65958,24619,48990,139567
2014-01-14,NYSE (DN),154311705,44650626,108735527,307697858,5770083198.798044,2092700221.263799,4122125078.712961,11984908498.774804,698150,138065,404741,1240956
2014-01-14,NASDAQ (DQ),1105353054,367332953,734942995,2207629002,37853683667.078272,15693552383.395451,23288882391.951555,76836118442.425278,3953439,719465,2240142,6913046
2014-01-14,EDGA (J),80978360,40927434,45464100,167369894,2577870653.155497,1862063661.147807,1449311362.489398,5889245676.792702,602676,157203,320834,1080713
2014-01-14,EDGX (K),224806002,97121009,182983293,504910304,8349411617.360613,3688771985.140391,6434438162.935650,18472621765.436654,1270517,251538,852550,2374605
2014-01-14,CHX (M),13188957,10188054,5671264,29048275,488447799.495600,741676765.129500,435603750.653000,1665728315.278100,486,3043,623,4152
2014-01-14,NYSE (N),649763722,0,0,649763722,25445235993.369905,0.000000,0.000000,25445235993.369905,2054795,0,0,2054795
2014-01-14,NYSE Arca (P),260324979,217856395,168131775,646313149,10938659243.954824,13165669051.032037,7458028045.290408,31562356340.277269,1911068,576069,1047430,3534567
2014-01-14,NASDAQ (Q),409511226,123616904,493658816,1026786946,17114511454.005618,8342378000.936858,20726409197.714565,46183298652.657041,3152180,455910,2763474,6371564
2014-01-14,CBSX (W),13685665,6774457,9187438,29647560,398557358.190000,379889779.599400,274859110.080000,1053306247.869400,99400,16283,68632,184315
2014-01-14,NASDAQ PSX (X),10215725,8825807,8714499,27756031,318378015.165000,575264666.576000,399887296.475000,1293529978.216000,67441,29043,45449,141933
2014-01-14,BATS BYX (Y),59232339,31321967,32062699,122617005,1967237965.588608,1378421208.891402,1167712066.280501,4513371240.760511,462062,122761,233651,818474
2014-01-14,BATS BZX (Z),254855231,130703794,172103656,557662681,8375650439.812899,8148473869.432283,5724977285.960461,22249101595.205643,1792696,475651,1076372,3344719
2014-01-13,NYSE MKT (A),0,17876347,5013120,22889467,0.000000,82428743.381300,83081672.520000,165510415.901300,0,31194,20252,51446
2014-01-13,NASDAQ BX (B),112846281,42105530,65986789,220938600,4142324478.265988,2162695170.456598,2699262156.364481,9004281805.087067,901273,175202,494449,1570924
2014-01-13,NSX (C),15811940,18289315,16348068,50449323,509253702.448200,385951759.557001,352945904.443200,1248151366.448401,73318,28553,56122,157993
2014-01-13,NYSE (DN),156919031,50553917,128412312,335885260,5703660405.781616,2555114526.006706,4228362352.321355,12487137284.109677,729437,157956,460405,1347798
2014-01-13,NASDAQ (DQ),1110177896,411405872,807722669,2329306437,38071895371.643894,20656198724.613243,24515206205.739509,83243300301.996646,4056008,824843,2425792,7306643
2014-01-13,EDGA (J),87946598,46839708,54406466,189192772,2844003292.006596,2308866899.803211,1656411934.541600,6809282126.351407,667291,179423,373924,1220638
2014-01-13,EDGX (K),254649121,109029289,214789830,578468240,9278110689.161760,4723128121.608794,6721066983.923511,20722305794.694065,1405798,299469,975383,2680650
2014-01-13,CHX (M),6642379,7022794,4542267,18207440,254537940.273600,535010326.526600,250355457.718900,1039903724.519100,422,3626,772,4820
2014-01-13,NYSE (N),733607327,0,0,733607327,28818364860.421649,0.000000,0.000000,28818364860.421649,2278766,0,0,2278766
2014-01-13,NYSE Arca (P),284826308,250799093,197589421,733214822,11917071394.584291,16311013251.785835,8241005448.376929,36469090094.747055,2072774,676780,1230158,3979712
2014-01-13,NASDAQ (Q),463544570,146395270,574684076,1184623916,18961750912.867084,10873582276.929113,22384768931.594838,52220102121.391035,3509583,551615,3099201,7160399
2014-01-13,CBSX (W),14667483,5431125,10420773,30519381,415000244.560000,446291915.248800,293973918.870000,1155266078.678800,103171,18396,73853,195420
2014-01-13,NASDAQ PSX (X),11415554,11482922,10556172,33454648,372832602.230000,707970386.993500,405459570.495000,1486262559.718500,78770,33053,55865,167688
2014-01-13,BATS BYX (Y),66245220,33946333,38817641,139009194,2223017347.903802,1820795113.012099,1282138693.778099,5325951154.694000,528292,145179,285375,958846
2014-01-13,BATS BZX (Z),274184226,145540762,195555419,615280407,9162017847.897619,9625021885.972609,6369483798.221766,25156523532.091994,1938525,520478,1182808,3641811
2014-01-10,NYSE MKT (A),0,13504016,5048567,18552583,0.000000,84023214.142800,79209414.053000,163232628.195800,0,24605,18693,43298
2014-01-10,NASDAQ BX (B),95572514,36870643,55678199,188121356,3370657908.019992,1815014555.603599,2140148479.574572,7325820943.198163,754878,153928,413267,1322073
2014-01-10,NSX (C),13163051,10339079,17337114,40839244,420897364.603700,339152473.222499,275010759.100999,1035060596.927198,61737,19727,49331,130795
2014-01-10,NYSE (DN),143664009,40647129,117335612,301646750,4944389617.771117,1995891967.735698,3417136618.783140,10357418204.289955,635828,126928,385359,1148115
2014-01-10,NASDAQ (DQ),1075078003,319909220,803682788,2198670011,35480402392.980275,14764996638.336686,21156427657.204581,71401826688.521542,3789998,684079,2158423,6632500
2014-01-10,EDGA (J),79390966,39254331,47245920,165891217,2529885331.387596,1917044499.081205,1370265447.711301,5817195278.180102,614112,153248,317411,1084771
2014-01-10,EDGX (K),237719648,86766590,194536934,519023172,8592002163.819973,4024814083.708005,5944290233.157954,18561106480.685932,1324621,247275,879116,2451012
2014-01-10,CHX (M),14449600,8888447,4656433,27994480,425339376.150000,919316205.968500,292483777.577400,1637139359.695900,479,3534,721,4734
2014-01-10,NYSE (N),669207850,0,0,669207850,25277277402.652421,0.000000,0.000000,25277277402.652421,2092451,0,0,2092451
2014-01-10,NYSE Arca (P),269286068,231454187,180259129,680999384,10988732203.913139,14456885371.749135,7212118748.886956,32657736324.549230,1976472,583849,1073403,3633724
2014-01-10,NASDAQ (Q),413770986,136602423,504074922,1054448331,16486533369.828044,9485115532.920809,18980190490.032628,44951839392.781481,3150836,474538,2686744,6312118
2014-01-10,CBSX (W),13748972,4852244,8831746,27432962,390216587.090000,414206677.800000,209548861.591500,1013972126.481500,100874,15966,58874,175714
2014-01-10,NASDAQ PSX (X),10972152,10601110,9808919,31382181,355869790.595000,653476638.852000,368426343.710000,1377772773.157000,73311,31010,55179,159500
2014-01-10,BATS BYX (Y),62759686,29622760,35633756,128016202,2047206885.126991,1482150814.623103,1145711911.666995,4675069611.417089,502636,124247,248393,875276
2014-01-10,BATS BZX (Z),240815972,131824038,164270230,536910240,7721996304.832410,8228437487.599102,5244351219.033183,21194785011.464695,1711630,443178,995027,3149835
2014-01-09,NYSE MKT (A),0,11277405,4754439,16031844,0.000000,57003258.888300,85728868.365000,142732127.253300,0,21361,19045,40406
2014-01-09,NASDAQ BX (B),99530575,35742524,53486831,188759930,3396462092.794962,1679487214.349608,2055772800.403504,7131722107.548074,765558,148044,399553,1313155
2014-01-09,NSX (C),14423720,10075534,17329755,41829009,443868687.381800,343125757.226401,318021853.489000,1105016298.097201,66574,19192,50791,136557
2014-01-09,NYSE (DN),154471622,37147759,116012519,307631900,5272355288.446923,1878361078.390694,3484183245.166207,10634899612.003824,698888,127020,408241,1234149
2014-01-09,NASDAQ (DQ),1186667282,283335131,794820499,2264822912,38554763661.483722,13926439987.290939,21561729105.555638,74042932754.330299,4149815,675866,2323137,7148818
2014-01-09,EDGA (J),83749030,37574327,49006024,170329381,2486904810.403404,1777505177.351902,1306527110.323991,5570937098.079297,625425,149071,328383,1102879
2014-01-09,EDGX (K),253210914,72119866,210513407,535844187,8854678351.936412,3361740077.352403,6133241214.268128,18349659643.556943,1372783,220019,946864,2539666
2014-01-09,CHX (M),17741554,10269225,4124700,32135479,573568607.036000,615114973.394300,262425171.475000,1451108751.905300,317,1797,590,2704
2014-01-09,NYSE (N),696527985,0,0,696527985,25822999606.453929,0.000000,0.000000,25822999606.453929,2141083,0,0,2141083
2014-01-09,NYSE Arca (P),265874279,178193924,189165245,633233448,10575192092.469504,11368591752.204848,7566602771.665798,29510386616.340150,1948999,514115,1103311,3566425
2014-01-09,NASDAQ (Q),454517419,115810450,540117259,1110445128,17822887245.750949,8106406158.112711,19706988954.265419,45636282358.129079,3311526,429462,2820192,6561180
2014-01-09,CBSX (W),14462877,5580815,9148745,29192437,394059339.010000,392275533.400000,213219804.720000,999554677.130000,94705,17370,58342,170417
2014-01-09,NASDAQ PSX (X),11078148,9360995,10098175,30537318,324025947.265000,545570290.049100,353455122.781000,1223051360.095100,69851,27308,55416,152575
2014-01-09,BATS BYX (Y),66233659,28572065,36226767,131032491,2101275518.403979,1491524257.370002,1114457513.575795,4707257289.349776,520390,121828,254946,897164
2014-01-09,BATS BZX (Z),264539786,117578530,182612654,564730970,8294542637.645846,7525000650.512213,5669724642.203403,21489267930.361462,1835186,414427,1097834,3347447
2014-01-08,NYSE MKT (A),0,10505914,5922106,16428020,0.000000,64287274.525900,103185508.990000,167472783.515900,0,20116,23834,43950
2014-01-08,NASDAQ BX (B),101668602,34312642,62281758,198263002,3723951177.770011,1704037067.285299,2145084409.801600,7573072654.856910,810055,138938,440724,1389717
2014-01-08,NSX (C),16047345,7988199,17904017,41939561,480657139.982600,247685189.140100,300102140.639799,1028444469.762499,68188,18428,49909,136525
2014-01-08,NYSE (DN),157752495,36083056,116702975,310538526,5636475743.052533,1852446576.157801,3523331752.821442,11012254072.031776,708713,122320,414032,1245065
2014-01-08,NASDAQ (DQ),1203589605,297046476,861706927,2362343008,41005577145.559773,15387999041.665276,22647844064.718411,79041420251.943460,4168974,653672,2378472,7201118
2014-01-08,EDGA (J),84747577,37486374,54433870,176667821,2612459108.729092,1894460507.825996,1388793345.170093,5895712961.725181,627557,151540,355207,1134304
2014-01-08,EDGX (K),251842519,74023089,222007309,547872917,8939576481.737393,3779332685.821109,6100468936.663613,18819378104.222115,1377941,235157,936899,2549997
2014-01-08,CHX (M),16485100,6549868,5303171,28338139,676375415.193200,520231784.564000,344180938.276600,1540788138.033800,373,2454,597,3424
2014-01-08,NYSE (N),758812923,0,0,758812923,29099499060.299574,0.000000,0.000000,29099499060.299574,2251972,0,0,2251972
2014-01-08,NYSE Arca (P),273418216,184912284,194072203,652402703,11006001040.844582,11866555547.966446,7000901342.028242,29873457930.839270,2033190,529188,1115065,3677443
2014-01-08,NASDAQ (Q),449844384,121269869,564772097,1135886350,18333133218.696946,8753812200.578409,19865033798.188957,46951979217.464312,3374508,455012,2853254,6682774
2014-01-08,CBSX (W),13060372,10211078,10114031,33385481,367246844.900000,831115973.110000,217461437.260000,1415824255.270000,91146,13673,55947,160766
2014-01-08,NASDAQ PSX (X),10099990,9741585,9212455,29054030,300469512.670000,616592195.150000,272539874.151000,1189601581.971000,60061,27184,42890,130135
2014-01-08,BATS BYX (Y),68156783,30227998,41393472,139778253,2249988416.494704,1604660921.461996,1186214774.823310,5040864112.780010,540378,121005,268303,929686
2014-01-08,BATS BZX (Z),248984740,117994814,182743806,549723360,8230040331.977153,7984494366.786258,5430802539.755011,21645337238.518422,1797814,437555,1111350,3346719
2014-01-07,NYSE MKT (A),0,12487603,7472417,19960020,0.000000,82607022.942100,121009307.023000,203616329.965100,0,24217,25556,49773
2014-01-07,NASDAQ BX (B),97680875,32433133,61336054,191450062,3387383133.802207,1504573931.733597,2161265227.758191,7053222293.293995,769091,126574,433418,1329083
2014-01-07,NSX (C),13935091,7997241,15499057,37431389,416904958.345500,206146462.614700,284252903.218100,907304324.178300,60078,17602,45272,122952
2014-01-07,NYSE (DN),143366727,36512486,116891794,296771007,4926486100.031821,1904480909.865301,3565750693.414558,10396717703.311680,650281,117662,413168,1181111
2014-01-07,NASDAQ (DQ),1215242074,294563467,848596991,2358402532,38987148318.861862,13756499483.730213,21936294639.435925,74679942442.028000,4040376,648014,2343150,7031540
2014-01-07,EDGA (J),79836139,33288133,52709714,165833986,2407551022.925197,1519672198.104204,1351109169.618000,5278332390.647401,597672,129939,344298,1071909
2014-01-07,EDGX (K),247800655,74815979,212071820,534688454,8579133924.478844,3518655847.124106,6059802526.057799,18157592297.660749,1316568,211860,881331,2409759
2014-01-07,CHX (M),7910415,15755296,7580841,31246552,277406901.371100,1222246910.740000,602084048.734000,2101737860.845100,360,2032,601,2993
2014-01-07,NYSE (N),699294011,0,0,699294011,25508697515.779201,0.000000,0.000000,25508697515.779201,2055001,0,0,2055001
2014-01-07,NYSE Arca (P),262869252,160569711,184890162,608329125,10669571365.627983,10168228104.519171,6793766271.242287,27631565741.389441,1998095,465550,1039729,3503374
2014-01-07,NASDAQ (Q),420719626,96445576,530951826,1048117028,16516474515.886164,6801209362.808681,18511237407.594091,41828921286.288936,3050301,367560,2732620,6150481
2014-01-07,CBSX (W),12295446,4757330,10288796,27341572,375740587.965000,402895658.890000,210474559.850000,989110806.705000,89358,15126,55710,160194
2014-01-07,NASDAQ PSX (X),10061823,8012612,10098084,28172519,286770111.970000,509208683.835000,268029066.900000,1064007862.705000,54801,23697,44644,123142
2014-01-07,BATS BYX (Y),64121132,24699290,41434247,130254669,2075551104.232809,1224244354.488400,1160519212.857297,4460314671.578506,504221,102374,269326,875921
2014-01-07,BATS BZX (Z),239738235,94537972,181600180,515876387,7545793935.846393,6114051855.480430,5205156016.611811,18865001807.938634,1659759,361229,1075648,3096636
2014-01-06,NYSE MKT (A),0,11538025,7999257,19537282,0.000000,107198953.755800,101448333.109000,208647286.864800,0,21507,20533,42040
2014-01-06,NASDAQ BX (B),96432586,36115533,69139481,201687600,3357560018.305012,1709099731.683002,2202562428.409192,7269222178.397206,762577,144307,453236,1360120
2014-01-06,NSX (C),13361673,9677945,14592116,37631734,388515457.827901,309553247.545300,273429145.802899,971497851.176100,55428,20035,43048,118511
2014-01-06,NYSE (DN),134296515,36197308,110561865,281055688,4468589145.942194,1855487479.563805,3494300647.060748,9818377272.566747,619246,120783,379768,1119797
2014-01-06,NASDAQ (DQ),1082268445,326793251,841349007,2250410703,35992171571.233399,17727397080.645388,21859944891.093077,75579513542.971864,3884035,688036,2226475,6798546
2014-01-06,EDGA (J),76353426,35801891,58960339,171115656,2274474013.884604,1782679552.295799,1387305107.807003,5444458673.987406,582074,148519,339188,1069781
2014-01-06,EDGX (K),260278589,74504425,209262912,544045926,9115512583.585767,3712891425.050995,6103564774.646895,18931968783.283657,1441432,240164,879048,2560644
2014-01-06,CHX (M),8390487,11514433,6097249,26002169,267268439.100700,803881551.578000,209756553.790100,1280906544.468800,274,3182,564,4020
2014-01-06,NYSE (N),668732153,0,0,668732153,24693707731.769369,0.000000,0.000000,24693707731.769369,1910346,0,0,1910346
2014-01-06,NYSE Arca (P),240622480,193222551,197148577,630993608,9385245068.634934,12237086072.784480,6598127779.348251,28220458920.767665,1806135,546885,1022506,3375526
2014-01-06,NASDAQ (Q),402254371,115768062,545264956,1063287389,15464047011.171897,8323184619.166904,18823984676.740460,42611216307.079261,3047116,437400,2572363,6056879
2014-01-06,CBSX (W),12371806,4093333,11214645,27679784,345475028.860000,333084322.637200,230827499.310000,909386850.807200,89019,15556,59270,163845
2014-01-06,NASDAQ PSX (X),9591223,8822916,12587663,31001802,289624763.880000,549365815.507800,299219100.965000,1138209680.352800,55980,26157,45232,127369
2014-01-06,BATS BYX (Y),63766185,28715089,40419039,132900313,2055002242.793303,1448306654.902897,1178238787.210295,4681547684.906495,511122,119010,260057,890189
2014-01-06,BATS BZX (Z),227980153,118624068,172695996,519300217,7248456687.668343,7760932003.633432,4780712129.696336,19790100820.998111,1647764,442442,968388,3058594
2014-01-03,NYSE MKT (A),0,9665333,4896445,14561778,0.000000,67380865.125000,80667861.788000,148048726.913000,0,21440,17605,39045
2014-01-03,NASDAQ BX (B),81173434,29811319,48236509,159221262,2768804196.884590,1421052164.517099,1956128896.718194,6145985258.119883,651565,121882,366256,1139703
2014-01-03,NSX (C),13105465,7870570,13504820,34480855,361027925.277000,288882799.832799,229427208.682800,879337933.792599,50556,18096,39944,108596
2014-01-03,NYSE (DN),127144945,34164488,86036707,247346140,4104841126.625909,1735953577.208598,2774394061.534832,8615188765.369339,561122,113678,321492,996292
2014-01-03,NASDAQ (DQ),871546076,292277826,602014547,1765838449,27465270171.149079,15123597252.147893,16959847149.470718,59548714572.767690,3450659,646211,1886503,5983373
2014-01-03,EDGA (J),66602110,34074294,39546534,140222938,1953324294.604401,1659108252.101301,1077024722.838001,4689457269.543703,498804,134385,266048,899237
2014-01-03,EDGX (K),218653264,64434532,170725410,453813206,7318972394.665024,3223453214.983992,4962967331.514965,15505392941.163981,1156194,198347,741402,2095943
2014-01-03,CHX (M),6121430,5472624,6885289,18479343,344199337.400600,430348515.785000,332660162.388400,1107208015.574000,255,1604,597,2456
2014-01-03,NYSE (N),544264648,0,0,544264648,19593340987.425334,0.000000,0.000000,19593340987.425334,1672300,0,0,1672300
2014-01-03,NYSE Arca (P),211187917,170604760,128468764,510261441,8194960411.612060,10712262560.574668,5279593967.357444,24186816939.544172,1514727,453773,802963,2771463
2014-01-03,NASDAQ (Q),356962271,99096281,398431741,854490293,13405351490.254409,6804119873.637575,14794749787.274327,35004221151.166311,2573304,346988,2077616,4997908
2014-01-03,CBSX (W),12154114,3764340,6974427,22892881,349147177.460000,356402323.970000,173855101.410000,879404602.840000,93265,13232,54979,161476
2014-01-03,NASDAQ PSX (X),9565921,7197242,7485393,24248556,279233079.080000,474525963.973500,232006473.001000,985765516.054500,58571,22681,35135,116387
2014-01-03,BATS BYX (Y),57196814,26906909,32545557,116649280,1799864151.966001,1325960674.620600,1061229840.096006,4187054666.682607,466737,104909,232295,803941
2014-01-03,BATS BZX (Z),199308120,100790845,126059375,426158340,6252891295.136628,6468408388.119204,4045401002.135381,16766700685.391213,1401984,359065,779024,2540073
2014-01-02,NYSE MKT (A),0,10682845,4991952,15674797,0.000000,63339983.049700,85222404.427000,148562387.476700,0,24898,18209,43107
2014-01-02,NASDAQ BX (B),87503346,40979160,48777383,177259889,3041779190.115101,2152851779.620500,1833067038.791707,7027698008.527308,690678,170138,362783,1223599
2014-01-02,NSX (C),14893549,9211835,11268833,35374217,431654880.176400,360761728.029400,231943734.440900,1024360342.646700,57896,21523,37385,116804
2014-01-02,NYSE (DN),140533221,47436667,90873788,278843676,4649827563.282726,2406748821.303397,2917410215.923103,9973986600.509226,644268,166235,354036,1164539
2014-01-02,NASDAQ (DQ),955888020,406114262,602731731,1964734013,30638824522.927982,22771669034.923800,17173583308.962451,70584076866.814233,3718059,868973,1953780,6540812
2014-01-02,EDGA (J),73692062,50117012,40343132,164152206,2156671824.496904,2417152639.211895,1083229311.365103,5657053775.073902,551832,200131,269270,1021233
2014-01-02,EDGX (K),242019697,91394782,168623548,502038027,8339562713.255678,4770308962.055991,5102969754.297579,18212841429.609248,1305012,291716,791955,2388683
2014-01-02,CHX (M),3476419,10990579,3204746,17671744,138587981.138200,883447974.235400,193711867.588500,1215747822.962100,278,2269,677,3224
2014-01-02,NYSE (N),624006397,0,0,624006397,23135804806.294828,0.000000,0.000000,23135804806.294828,1854741,0,0,1854741
2014-01-02,NYSE Arca (P),235000387,266181949,137078137,638260473,9030248410.732373,15763351653.734887,5428262391.494075,30221862455.961335,1742142,652836,887263,3282241
2014-01-02,NASDAQ (Q),400363439,143179784,447367382,990910605,15278149467.488949,9791542748.965416,16137588113.628842,41207280330.083207,2962196,513013,2331914,5807123
2014-01-02,CBSX (W),11175256,5811284,7059848,24046388,315198578.310000,478965621.620001,178960542.620000,973124742.550001,84097,17822,50801,152720
2014-01-02,NASDAQ PSX (X),9953716,10301738,7398348,27653802,280161004.910000,680121500.528100,263709638.060000,1223992143.498100,61907,33132,36651,131690
2014-01-02,BATS BYX (Y),63684705,37660665,32824603,134169973,2015536197.399698,1924033352.280401,1115415113.418400,5054984663.098499,509451,149136,240350,898937
2014-01-02,BATS BZX (Z),220444721,139933466,138061295,498439482,6970959096.513710,9089876527.652475,4232477102.948800,20293312727.114985,1571830,497870,858623,2928323
