Day,Market Participant,Tape A Shares,Tape B Shares,Tape C Shares,Total Shares,Tape A Notional,Tape B Notional,Tape C Notional,Total Notional,Tape A Trade Count,Tape B Trade Count,Tape C Trade Count,Total Trade Count
2017-12-29,NYSE American (A),2428538,16820591,1988839,21237968,93578910.080000,196063856.861000,95730836.907000,385373603.848000,24448,45308,20309,90065
2017-12-29,NASDAQ BX (B),90077661,30601168,55435859,176114688,3345472768.728700,1563501394.050300,2090602356.376600,6999576519.155600,944343,149075,567170,1660588
2017-12-29,NYSE (DN),63371650,32210451,59930835,155512936,1787663198.571300,1149980932.074600,1740529324.954600,4678173455.600500,169131,84977,185251,439359
2017-12-29,NASDAQ (DQ),793832069,407766687,587618201,1789216957,26356600215.736104,24959576982.530488,23542134016.948597,74858311215.215189,2916551,816401,1893124,5626076
2017-12-29,EDGA Equities (J),29672298,18834557,16555141,65061996,1018392137.369900,1240313473.654300,756128107.267000,3014833718.291200,249923,83162,136755,469840
2017-12-29,EDGX Equities (K),121571218,62240050,125025114,308836382,4433915262.488001,3519199834.438501,4850239668.685200,12803354765.611702,774162,230693,696101,1700956
2017-12-29,CHX (M),6796455,8091649,3548597,18436701,375282144.818400,1608126863.792700,613315841.348000,2596724849.959100,1806,3412,1331,6549
2017-12-29,NYSE (N),710203862,0,0,710203862,30400842083.864202,0.000000,0.000000,30400842083.864202,1818038,0,0,1818038
2017-12-29,NYSE Arca (P),120699045,216278915,101801383,438779343,5071955274.342900,14098675257.258806,4945129085.675400,24115759617.277106,899588,558368,737138,2195094
2017-12-29,NASDAQ (Q),196422077,103622236,453877686,753921999,8681275922.039299,7685032674.001702,23928313140.018106,40294621736.059107,1771210,383457,2225533,4380200
2017-12-29,IEX (V),51761931,15318105,25518479,92598515,2088033482.652600,892029781.952800,1334158141.536500,4314221406.141900,356177,64172,183012,603361
2017-12-29,NASDAQ PSX (X),8879748,11542648,9376489,29798885,350033441.155500,890423996.484800,562122384.410100,1802579822.050400,79893,46731,81147,207771
2017-12-29,BYX Equities (Y),133362096,59647562,66611536,259621194,3939155324.365700,2829187118.337101,2392327233.492000,9160669676.194801,1106487,254435,590106,1951028
2017-12-29,BZX Equities (Z),118685979,72250240,68011335,258947554,4077538932.371600,4827163455.784200,3302164214.616301,12206866602.772101,952752,285968,562523,1801243
2017-12-28,NYSE American (A),2512987,15123597,1858237,19494821,93925759.149400,122437389.458700,95919133.721300,312282282.329400,23438,41012,18957,83407
2017-12-28,NASDAQ BX (B),85742892,25987701,46961901,158692494,3357568081.186700,1261525257.463000,1910594229.563300,6529687568.213000,930932,129871,502425,1563228
2017-12-28,NYSE (DN),56878846,28302305,56278624,141459775,1680124442.696200,813257860.789800,1579519579.934900,4072901883.420900,151780,76048,180649,408477
2017-12-28,NASDAQ (DQ),775964145,342432029,534293916,1652690090,27321994634.079705,18772595552.277504,21900954994.712005,67995545181.069214,2809844,837542,1810360,5457746
2017-12-28,EDGA Equities (J),24965756,14049788,13857203,52872747,882277704.400000,818459014.252900,619152183.521800,2319888902.174700,224156,63416,118083,405655
2017-12-28,EDGX Equities (K),114656650,48844051,115077771,278578472,4204858786.903199,2343920971.543200,4255478734.360100,10804258492.806499,718555,180703,637071,1536329
2017-12-28,CHX (M),8495021,8854366,5526910,22876297,601832939.740000,845829476.579000,431896657.036500,1879559073.355500,1490,2551,1003,5044
2017-12-28,NYSE (N),527124258,0,0,527124258,21378455620.642500,0.000000,0.000000,21378455620.642500,1642025,0,0,1642025
2017-12-28,NYSE Arca (P),108977726,161505460,84438709,354921895,4811782771.570900,9020561623.951101,4057497723.122501,17889842118.644502,832322,432790,652585,1917697
2017-12-28,NASDAQ (Q),177393227,74268694,312780302,564442223,8061833676.100201,4593518782.295400,15685968820.319801,28341321278.715402,1670909,295692,1988151,3954752
2017-12-28,IEX (V),55080661,13088671,28104826,96274158,2203747931.909200,846572656.706600,1612612708.960100,4662933297.575900,357004,57602,197165,611771
2017-12-28,NASDAQ PSX (X),8516787,8933074,8006733,25456594,335321437.150000,646873082.728400,457066633.784600,1439261153.663000,78217,42743,74636,195596
2017-12-28,BYX Equities (Y),119148710,46161643,55339305,220649658,3683812041.313300,2128905328.576300,2091711404.783200,7904428774.672800,1050884,202271,530393,1783548
2017-12-28,BZX Equities (Z),109432943,55062082,57354629,221849654,3888222037.573900,3296210950.647500,2753802040.513700,9938235028.735100,888439,235518,488226,1612183
2017-12-27,NYSE American (A),2326769,15713712,2034714,20075195,87778423.117800,142938105.221900,98995337.749200,329711866.088900,24545,43247,21935,89727
2017-12-27,NASDAQ BX (B),82987968,26123434,47695254,156806656,3244103033.406800,1385101401.729700,1950118646.046700,6579323081.183200,878193,145646,497342,1521181
2017-12-27,NYSE (DN),57100634,27904540,64451879,149457053,1781782523.417900,868270395.924900,1862513592.890600,4512566512.233400,154719,74292,182634,411645
2017-12-27,NASDAQ (DQ),808201394,348525983,576071171,1732798548,30157177382.541101,18927970149.969198,24078992211.035192,73164139743.545491,2684458,804664,1799000,5288122
2017-12-27,EDGA Equities (J),26387042,15446762,14429760,56263564,922466340.271500,982485057.519000,636049132.597400,2541000530.387900,237124,74173,124316,435613
2017-12-27,EDGX Equities (K),108016992,55533964,115582487,279133443,4191554324.017401,2788296899.112501,4571016702.957700,11550867926.087602,730622,213259,665496,1609377
2017-12-27,CHX (M),9640790,9254080,7213575,26108445,433713861.446000,1094188301.736000,677027720.991300,2204929884.173300,1408,1819,1088,4315
2017-12-27,NYSE (N),548073498,0,0,548073498,22403269205.483599,0.000000,0.000000,22403269205.483599,1661024,0,0,1661024
2017-12-27,NYSE Arca (P),107221341,180097457,89870519,377189317,4779022074.862401,10403564244.940898,4207850626.504201,19390436946.307500,833156,517614,669471,2020241
2017-12-27,NASDAQ (Q),174889035,82943977,339578789,597411801,7992949814.847298,5306939736.684901,17987107647.197309,31286997198.729508,1658689,348029,2093054,4099772
2017-12-27,IEX (V),50243735,13735210,25383220,89362165,2014496949.389400,757537810.776900,1382034641.172000,4154069401.338300,330857,63864,181649,576370
2017-12-27,NASDAQ PSX (X),7996286,9468767,8383353,25848406,330669998.480600,732746514.641800,488238990.178100,1551655503.300500,74251,44504,76051,194806
2017-12-27,BYX Equities (Y),114196489,52142147,57081045,223419681,3530254179.569400,2602070269.303500,2139782053.104400,8272106501.977300,1015512,241110,532256,1788878
2017-12-27,BZX Equities (Z),105624562,60798843,63239858,229663263,3784764787.213700,4062072291.115100,3090344255.746500,10937181334.075300,871069,274887,533094,1679050
2017-12-26,NYSE American (A),1996276,17860668,1804894,21661838,77120592.550000,135927311.052500,100064614.316900,313112517.919400,19900,42984,18182,81066
2017-12-26,NASDAQ BX (B),71568425,22826078,50953530,145348033,2661278154.855900,1044012474.491400,1933154417.945700,5638445047.293000,757527,114681,480865,1353073
2017-12-26,NYSE (DN),57741734,28623139,54973812,141338685,1786016304.764900,681502093.632100,1914210549.580301,4381728947.977301,153598,75018,176304,404920
2017-12-26,NASDAQ (DQ),663176581,316779460,484294867,1464250908,22539394184.400607,15592030635.391402,20828109401.034206,58959534220.826215,2529134,769531,1732278,5030943
2017-12-26,EDGA Equities (J),24360554,13031692,13682707,51074953,850017834.028400,750128440.444400,649668408.226300,2249814682.699100,226749,65304,121837,413890
2017-12-26,EDGX Equities (K),106018331,49557597,107169980,262745908,3969638418.161400,2250088405.886300,4424703790.856700,10644430614.904400,700234,193467,636618,1530319
2017-12-26,CHX (M),9686917,7928793,6775076,24390786,568815466.909000,1073273559.656800,547130715.436800,2189219742.002600,1438,2334,1233,5005
2017-12-26,NYSE (N),528147685,0,0,528147685,20625949809.167300,0.000000,0.000000,20625949809.167300,1545566,0,0,1545566
2017-12-26,NYSE Arca (P),98137718,182472293,85026187,365636198,4301118016.800000,9717921109.776107,4269773679.318201,18288812805.894308,777262,478094,639082,1894438
2017-12-26,NASDAQ (Q),154660986,75071454,345376876,575109316,6837002136.745699,4324226462.845100,17983293450.761102,29144522050.351901,1454261,314844,2000298,3769403
2017-12-26,IEX (V),43374037,11123082,25411567,79908686,1772456541.445300,639965655.031800,1447645000.173800,3860067196.650900,299689,53677,174019,527385
2017-12-26,NASDAQ PSX (X),7551890,8428570,8990747,24971207,304386779.123900,561208394.516200,519164207.672500,1384759381.312600,69595,40102,78428,188125
2017-12-26,BYX Equities (Y),99244301,42792749,58234089,200271139,2991353002.627700,2073753101.146900,2083244145.691100,7148350249.465700,896042,208284,516691,1621017
2017-12-26,BZX Equities (Z),105001074,51702325,58310780,215014179,3826640133.044500,3179209068.037302,2850263750.285000,9856112951.366802,848345,240150,499871,1588366
2017-12-22,NYSE American (A),2386947,12741511,1871045,16999503,98118721.045000,125959045.449600,95087191.553200,319164958.047800,23645,36570,18643,78858
2017-12-22,NASDAQ BX (B),90366871,26920505,54942725,172230101,3558061543.207000,1397187233.737100,2113616647.670800,7068865424.614900,931966,132560,533837,1598363
2017-12-22,NYSE (DN),64653719,26139780,65648293,156441792,2314254883.193800,856235534.914200,1812585107.462300,4983075525.570300,160281,66143,171478,397902
2017-12-22,NASDAQ (DQ),839790548,363073515,583162724,1786026787,32027509112.672799,24257129557.849407,22965251598.553607,79249890269.075813,2988036,730045,1933348,5651429
2017-12-22,EDGA Equities (J),28067283,16813103,16168900,61049286,1089051551.637200,1006264895.721600,744502884.290000,2839819331.648800,260539,73017,137752,471308
2017-12-22,EDGX Equities (K),124810158,52298079,127585779,304694016,4957131618.872701,2755473210.583598,4685571776.116499,12398176605.572798,834376,204336,718766,1757478
2017-12-22,CHX (M),8730674,9015537,5401750,23147961,741839012.408100,1337532579.810000,488699569.113400,2568071161.331500,1932,2153,1085,5170
2017-12-22,NYSE (N),598683460,0,0,598683460,25533075104.016102,0.000000,0.000000,25533075104.016102,1821913,0,0,1821913
2017-12-22,NYSE Arca (P),124137074,192107148,103891958,420136180,5782463946.640800,11198304813.722902,4611963985.991899,21592732746.355601,967752,510546,737039,2215337
2017-12-22,NASDAQ (Q),198839418,84832934,398188193,681860545,9211633944.628901,5941758289.430996,19947491592.377297,35100883826.437194,1801488,348162,2210166,4359816
2017-12-22,IEX (V),57105957,15424907,33541476,106072340,2664249085.334200,992401208.003300,1730206245.166700,5386856538.504200,391571,60478,217738,669787
2017-12-22,NASDAQ PSX (X),9775689,9783379,10209866,29768934,412921005.899000,722771552.355400,550735961.201400,1686428519.455800,88449,42006,85717,216172
2017-12-22,BYX Equities (Y),126666391,51604792,67279365,245550548,4049538120.456700,2383396084.082000,2481091639.217600,8914025843.756300,1117005,230397,593232,1940634
2017-12-22,BZX Equities (Z),127017963,63308009,73994509,264320481,4874039920.908599,4205924473.289500,3446742455.334201,12526706849.532300,1022879,276913,582350,1882142
2017-12-21,NYSE American (A),3272743,15138250,2242009,20653002,125220208.280200,149780255.069200,115503252.298700,390503715.648100,29482,45828,21796,97106
2017-12-21,NASDAQ BX (B),117822715,29897645,62195407,209915767,4775702430.182300,1577845481.767600,2616267073.842500,8969814985.792400,1157008,154797,641823,1953628
2017-12-21,NYSE (DN),88427817,31768996,71081208,191278021,3244017160.935999,983841703.220100,2229973111.082300,6457831975.238399,201054,77476,205003,483533
2017-12-21,NASDAQ (DQ),1178876574,384000518,704022169,2266899261,44681160620.437309,22551572676.797201,28714249294.027901,95946982591.262411,3869740,832487,2366557,7068784
2017-12-21,EDGA Equities (J),40063546,18663351,20558102,79284999,1478488589.141700,1088495248.547000,911529772.009400,3478513609.698100,351265,88253,176899,616417
2017-12-21,EDGX Equities (K),178055782,61062789,150624033,389742604,7122134692.184699,3189260502.691001,5707831853.369400,16019227048.245100,1161016,231114,885944,2278074
2017-12-21,CHX (M),12952041,18759796,6347486,38059323,981946891.814700,2198964682.180000,490721112.777200,3671632686.771900,2286,3275,1196,6757
2017-12-21,NYSE (N),779839188,0,0,779839188,32959812037.770901,0.000000,0.000000,32959812037.770901,2244213,0,0,2244213
2017-12-21,NYSE Arca (P),176734450,219279432,127430838,523444720,7943853232.237999,12290052231.785699,5615063323.281703,25848968787.305401,1302297,591194,919135,2812626
2017-12-21,NASDAQ (Q),282112100,97757528,464716840,844586468,12830460418.761100,6237207198.301997,23261665496.975800,42329333114.038897,2411328,386643,2719009,5516980
2017-12-21,IEX (V),85769392,16377900,41383009,143530301,3956350170.854700,947812086.910100,2129071606.356400,7033233864.121200,529279,68459,274207,871945
2017-12-21,NASDAQ PSX (X),13907194,12051636,12806312,38765142,584785853.011700,827502002.112100,690103098.609400,2102390953.733200,121357,51817,112072,285246
2017-12-21,BYX Equities (Y),167891264,59394753,77786001,305072018,5260388360.396199,2730970499.642200,2938067095.470300,10929425955.508699,1415882,278939,713501,2408322
2017-12-21,BZX Equities (Z),167414101,71351995,86223358,324989454,6249383362.219900,4461962794.090401,4023298332.996100,14734644489.306401,1283356,307492,698995,2289843
2017-12-20,NYSE American (A),3163909,15472225,2435117,21071251,128624960.995000,158337261.161200,135683979.012000,422646201.168200,30697,46499,23044,100240
2017-12-20,NASDAQ BX (B),122261540,32391624,64700179,219353343,5054996500.141700,1705040459.967200,2911372436.075200,9671409396.184100,1199851,162333,655316,2017500
2017-12-20,NYSE (DN),81181518,31513528,69190897,181885943,2840214055.413600,1015577989.207300,2344999780.217000,6200791824.837900,185661,77076,203633,466370
2017-12-20,NASDAQ (DQ),1130732826,416616149,723716828,2271065803,43756441118.923707,25294760748.769803,30968560765.653393,100019762633.346903,3868292,833329,2361991,7063612
2017-12-20,EDGA Equities (J),42090672,20010563,22928215,85029450,1586963175.679200,1208586569.637800,1099918034.629600,3895467779.946600,371356,90093,190983,652432
2017-12-20,EDGX Equities (K),173617411,63859070,157349055,394825536,7076521910.425602,3296978911.166300,6298126401.850402,16671627223.442304,1153528,248333,899711,2301572
2017-12-20,CHX (M),11774234,15146555,11308882,38229671,753522045.961600,1448756465.560000,1146973830.840000,3349252342.361600,2404,2892,1515,6811
2017-12-20,NYSE (N),776532833,0,0,776532833,33104215126.506200,0.000000,0.000000,33104215126.506200,2329062,0,0,2329062
2017-12-20,NYSE Arca (P),176721558,245195371,134278484,556195413,8069950786.875598,13821403425.533801,6444722574.661004,28336076787.070403,1336464,645537,982004,2964005
2017-12-20,NASDAQ (Q),283336734,108108465,476655802,868101001,13120918444.074301,6920792788.855600,25065307723.004695,45107018955.934596,2484086,432965,2853104,5770155
2017-12-20,IEX (V),88182843,19490120,42579841,150252804,4002170039.295800,1054742708.350600,2470868042.075900,7527780789.722300,563660,73615,285726,923001
2017-12-20,NASDAQ PSX (X),14245850,13726832,13835536,41808218,631532390.732600,996260318.017700,899312059.892700,2527104768.643000,124219,56732,123243,304194
2017-12-20,BYX Equities (Y),167358550,60482355,78510622,306351527,5422787676.132800,2855916832.895300,3157211712.317000,11435916221.345100,1422307,279224,714528,2416059
2017-12-20,BZX Equities (Z),175031053,76108457,90657648,341797158,6727733993.236100,4961911187.778302,4592764338.141202,16282409519.155604,1400168,343102,759695,2502965
2017-12-19,NYSE American (A),3486570,19116282,2700257,25303109,148734235.900000,162822820.704500,144218228.438500,455775285.043000,34420,50881,26873,112174
2017-12-19,NASDAQ BX (B),123997422,32438003,69285968,225721393,4978851646.737000,1725231197.586600,2909097015.505900,9613179859.829500,1236363,154345,704350,2095058
2017-12-19,NYSE (DN),81490714,34416969,75098545,191006228,2841479866.009500,1016302685.344400,2606241272.907300,6464023824.261200,195393,85351,219894,500638
2017-12-19,NASDAQ (DQ),1185980875,436930763,777430932,2400342570,43950333511.154307,26339726606.525396,32198125242.138598,102488185359.818301,3849810,873281,2452503,7175594
2017-12-19,EDGA Equities (J),41225783,19800895,25125334,86152012,1546906300.252300,1328209837.502700,1200562000.016900,4075678137.771900,371982,88873,209535,670390
2017-12-19,EDGX Equities (K),175208035,68397243,172610161,416215439,7179814244.450100,3460284306.639200,7127551762.013000,17767650313.102300,1180607,253148,983848,2417603
2017-12-19,CHX (M),12479970,16183362,12730843,41394175,690113280.958800,1507236253.630000,1090910582.730000,3288260117.318800,2522,4357,1796,8675
2017-12-19,NYSE (N),844053698,0,0,844053698,36261426637.509001,0.000000,0.000000,36261426637.509001,2429355,0,0,2429355
2017-12-19,NYSE Arca (P),185486641,234250956,146301812,566039409,8421742150.670401,13494854796.201711,6903138535.608596,28819735482.480708,1388657,628612,1035160,3052429
2017-12-19,NASDAQ (Q),292548176,110235947,553476721,956260844,13506756384.475397,7476737996.253502,28730431037.693697,49713925418.422596,2529033,433156,3080391,6042580
2017-12-19,IEX (V),95167593,16267249,46613832,158048674,4187736092.912500,968977732.552000,2552984115.758700,7709697941.223200,592102,72188,308261,972551
2017-12-19,NASDAQ PSX (X),13521980,12176563,15009631,40708174,600562409.986000,926284185.835500,871346629.713000,2398193225.534500,121994,52332,131450,305776
2017-12-19,BYX Equities (Y),171777033,60586864,87554199,319918096,5441960267.759800,2954971097.487400,3279255711.985100,11676187077.232300,1458733,272120,773757,2504610
2017-12-19,BZX Equities (Z),181263374,76663892,100255253,358182519,7035575266.690801,5124252438.496500,4945344300.822799,17105172006.010100,1426507,333494,815752,2575753
2017-12-18,NYSE American (A),3748419,22380649,2970894,29099962,150828923.234800,184844271.908200,148684909.016200,484358104.159200,36807,54946,29286,121039
2017-12-18,NASDAQ BX (B),132665144,36374802,75125145,244165091,5226884886.114400,1863049239.208000,3130760781.939900,10220694907.262300,1285433,176880,760848,2223161
2017-12-18,NYSE (DN),92422169,40940829,80107973,213470971,3254568965.622100,1007658252.418500,2864833169.202101,7127060387.242701,221748,95041,237548,554337
2017-12-18,NASDAQ (DQ),1269572118,481108129,809914410,2560594657,46824966710.023906,26864916322.774909,34972094975.285404,108661978008.084219,4083878,990415,2624666,7698959
2017-12-18,EDGA Equities (J),46199988,20649442,24298978,91148408,1660342186.991100,1298852105.440200,1141943648.780000,4101137941.211300,404469,94026,207257,705752
2017-12-18,EDGX Equities (K),201879583,78344951,172286225,452510759,7936850523.409300,3625923300.444299,7328418075.294099,18891191899.147698,1296081,279087,1021226,2596394
2017-12-18,CHX (M),11808324,15971230,7867459,35647013,582788123.615000,2299214292.300299,807092874.244000,3689095290.159299,2519,4187,1686,8392
2017-12-18,NYSE (N),921202472,0,0,921202472,37702120630.742202,0.000000,0.000000,37702120630.742202,2582422,0,0,2582422
2017-12-18,NYSE Arca (P),215412905,269161135,148751796,633325836,9110292708.296201,15241582994.549699,7169009637.320701,31520885340.166601,1513751,714296,1083365,3311412
2017-12-18,NASDAQ (Q),320878670,117064981,569929848,1007873499,14353285808.239900,7119560682.501299,30116492505.595607,51589338996.336806,2651969,456523,3248345,6356837
2017-12-18,IEX (V),97105101,18918527,47570653,163594281,4200510705.543301,1098089367.312400,2337612947.282600,7636213020.138301,628382,82300,324670,1035352
2017-12-18,NASDAQ PSX (X),18332369,13278969,15675269,47286607,706277567.275500,907944282.614300,893187910.184100,2507409760.073900,140246,58774,135601,334621
2017-12-18,BYX Equities (Y),198344499,71075240,94660643,364080382,6156735438.733700,3277172673.440200,3576796569.603900,13010704681.777800,1642230,320606,853142,2815978
2017-12-18,BZX Equities (Z),198204541,82325701,101429318,381959560,7258974979.684901,5400451651.733401,4879996395.615800,17539423027.034102,1488715,357111,835706,2681532
2017-12-15,NYSE American (A),4526134,61815037,3624201,69965372,184769587.895500,435048097.094300,194949233.308100,814766918.297900,44068,48578,35104,127750
2017-12-15,NASDAQ BX (B),145397658,47032640,91922967,284353265,5935573384.172200,2570741592.424700,3938252963.338700,12444567939.935600,1398944,205942,871078,2475964
2017-12-15,NYSE (DN),95374474,42690877,81218612,219283963,3354687093.397199,1403812932.143600,2796067295.356899,7554567320.897698,255841,97468,226472,579781
2017-12-15,NASDAQ (DQ),1729779852,561194034,1178768397,3469742283,69497972428.658993,45183810602.036004,52863713324.472878,167545496355.167875,4059857,891971,2676323,7628151
2017-12-15,EDGA Equities (J),50402876,31119130,28901698,110423704,1842979365.727000,1849716906.439900,1389630732.074200,5082327004.241100,422310,119711,238188,780209
2017-12-15,EDGX Equities (K),188363864,79682686,173846442,441892992,7690741159.241999,4659535259.225299,7612760974.764000,19963037393.231298,1268980,293441,1071995,2634416
2017-12-15,CHX (M),14252390,25089738,11819392,51161520,1159168691.475000,2262687986.905000,1254186097.428800,4676042775.808800,3275,4641,2081,9997
2017-12-15,NYSE (N),2420952221,0,0,2420952221,107165063973.480096,0.000000,0.000000,107165063973.480096,2720291,0,0,2720291
2017-12-15,NYSE Arca (P),213664973,294267981,174638202,682571156,9649418091.513999,18205714407.683296,8692192052.003198,36547324551.200493,1615298,730414,1233505,3579217
2017-12-15,NASDAQ (Q),334705603,137283330,1469935428,1941924361,15305070536.611801,9614709128.231207,72154093345.556154,97073873010.399162,2815576,512852,3654231,6982659
2017-12-15,IEX (V),112059603,23839531,60867151,196766285,4821828389.637700,1488698252.073600,3193843133.340800,9504369775.052100,702197,92935,393522,1188654
2017-12-15,NASDAQ PSX (X),18870030,16397187,19950767,55217984,847898896.705200,1306286022.654500,1183345586.289100,3337530505.648800,158841,64950,166339,390130
2017-12-15,BYX Equities (Y),209960840,86305541,114713388,410979769,6627104129.037199,4135606343.262900,4282571095.809000,15045281568.109099,1739306,358652,977628,3075586
2017-12-15,BZX Equities (Z),198605650,100715802,119390726,418712178,7715327604.054900,7356755372.857503,6076162907.630502,21148245884.542905,1561162,402063,950714,2913939
2017-12-14,NYSE American (A),3521420,19682390,2656745,25860555,136540702.780000,220206054.899800,129563894.005400,486310651.685200,33060,48941,25130,107131
2017-12-14,NASDAQ BX (B),127050293,35515027,71591442,234156762,5220614206.577700,1870917393.805100,3016688140.466601,10108219740.849401,1273429,171725,732984,2178138
2017-12-14,NYSE (DN),89418695,43456355,71176031,204051081,3231870665.806100,1221453085.906800,2442789525.339500,6896113277.052400,247378,100259,196492,544129
2017-12-14,NASDAQ (DQ),1194195837,488593945,746576470,2429366252,45494750366.818890,29560063329.330296,32066335202.312894,107121148898.462080,3816412,847828,2302541,6966781
2017-12-14,EDGA Equities (J),43229560,25924480,22789064,91943104,1590121269.571300,1447129206.490700,1034887031.052800,4072137507.114800,391426,110185,197966,699577
2017-12-14,EDGX Equities (K),179106718,78579995,148664576,406351289,7380185220.849700,4171049513.905500,6496435765.157600,18047670499.912800,1235674,291884,962017,2489575
2017-12-14,CHX (M),20392853,22564960,13061229,56019042,1190512588.979800,2190430291.255000,1016820460.959500,4397763341.194300,2820,7201,1896,11917
2017-12-14,NYSE (N),813801598,0,0,813801598,34242356701.850503,0.000000,0.000000,34242356701.850503,2476451,0,0,2476451
2017-12-14,NYSE Arca (P),202439678,267414620,138436532,608290830,9050747490.550102,15029040283.301400,6929865892.953598,31009653666.805100,1523756,713059,1072970,3309785
2017-12-14,NASDAQ (Q),310341333,120941353,532443561,963726247,14459701982.536299,8059137998.762002,28096359740.126190,50615199721.424491,2795975,481036,3237822,6514833
2017-12-14,IEX (V),92108684,19111293,46451527,157671504,4048317185.938200,1230370030.967600,2476826297.139100,7755513514.044900,585329,76268,310266,971863
2017-12-14,NASDAQ PSX (X),15441248,14375654,14697693,44514595,698666916.461700,989708156.143200,884751913.974400,2573126986.579300,142105,58360,140483,340948
2017-12-14,BYX Equities (Y),179499415,72065282,88420735,339985432,5766012788.488900,3430393356.983200,3341961248.440199,12538367393.912299,1542711,326863,808498,2678072
2017-12-14,BZX Equities (Z),172220237,91293853,93126931,356641021,6698536494.024299,6890784602.483098,4768413041.361799,18357734137.869196,1430122,403678,825483,2659283
2017-12-13,NYSE American (A),3515636,18328408,2655816,24499860,130328594.572000,256964973.357900,132221471.376200,519515039.306100,32277,51017,25508,108802
2017-12-13,NASDAQ BX (B),130165902,41197806,70055220,241418928,5193607087.750600,2047543419.205900,3019116194.565801,10260266701.522301,1282092,187311,713509,2182912
2017-12-13,NYSE (DN),89383684,38438143,67084373,194906200,3243773713.804600,1145252333.378800,2479133220.439100,6868159267.622500,236476,94735,199390,530601
2017-12-13,NASDAQ (DQ),1203282731,511746121,702696550,2417725402,45167935191.783293,32472509785.832205,30695755259.643403,108336200237.258901,3764527,908552,2319009,6992088
2017-12-13,EDGA Equities (J),46133154,28567748,22651114,97352016,1670785834.225400,1565814601.803400,1158480831.420400,4395081267.449200,415137,122829,202391,740357
2017-12-13,EDGX Equities (K),187442902,86004076,152647111,426094089,7453471954.228498,4311361687.848300,6615241585.686505,18380075227.763303,1280725,322069,981330,2584124
2017-12-13,CHX (M),17748374,21800911,7771904,47321189,1217687067.426800,2276704852.739999,724400927.261900,4218792847.428699,2842,6261,1788,10891
2017-12-13,NYSE (N),875343171,0,0,875343171,35809295155.251608,0.000000,0.000000,35809295155.251608,2570862,0,0,2570862
2017-12-13,NYSE Arca (P),208881278,329955101,141289658,680126037,9150953679.502201,17465540607.029497,7376148005.851699,33992642292.383397,1570691,758710,1097759,3427160
2017-12-13,NASDAQ (Q),317146451,138416858,522921813,978485122,14142410932.695703,8235493814.947400,28030914935.272804,50408819682.915907,2789844,522768,3183713,6496325
2017-12-13,IEX (V),100285268,21964567,47303709,169553544,4406782613.383700,1301098934.981200,2483619600.229000,8191501148.593900,624412,85118,323382,1032912
2017-12-13,NASDAQ PSX (X),16599089,15941915,16102220,48643224,710405402.610300,1021723192.615100,956024353.775300,2688152949.000700,145764,60270,142964,348998
2017-12-13,BYX Equities (Y),186983122,78242841,83339838,348565801,5792504246.041900,3559339435.345001,3282403447.370300,12634247128.757201,1570934,344009,765723,2680666
2017-12-13,BZX Equities (Z),185451216,97251671,94574959,377277846,7032137179.264199,6393765742.016500,4765563616.419299,18191466537.699998,1519332,427317,826010,2772659
2017-12-12,NYSE American (A),3574778,15086475,2652543,21313796,136302522.180000,168151293.921900,153138369.527600,457592185.629500,32935,42804,25045,100784
2017-12-12,NASDAQ BX (B),125622923,33447363,67100913,226171199,4873541793.341600,1670330070.651600,2768001836.392401,9311873700.385601,1222952,159751,685024,2067727
2017-12-12,NYSE (DN),103210714,37553833,71892289,212656836,3690798365.804700,1089717617.748400,2488886875.023500,7269402858.576600,244717,92241,212647,549605
2017-12-12,NASDAQ (DQ),1210487297,415622798,696834849,2322944944,43977671871.857512,26488898352.306904,29269578626.663696,99736148850.828112,3824344,808629,2319433,6952406
2017-12-12,EDGA Equities (J),44425619,20517914,20544724,85488257,1551704326.025500,1118037910.144400,963866018.319000,3633608254.488900,389857,91978,179242,661077
2017-12-12,EDGX Equities (K),183600043,70716139,153913857,408230039,7291669245.930803,3410256105.712000,6398838852.536099,17100764204.178902,1228135,258873,952282,2439290
2017-12-12,CHX (M),17008616,18732115,6774356,42515087,914301239.976700,2304722304.354999,649766535.293900,3868790079.625599,2391,5459,1665,9515
2017-12-12,NYSE (N),854838747,0,0,854838747,35621041522.525498,0.000000,0.000000,35621041522.525498,2448286,0,0,2448286
2017-12-12,NYSE Arca (P),209487524,251009756,136594473,597091753,8948964881.600297,13410369547.390200,6530686809.349499,28890021238.339996,1539513,632839,1043635,3215987
2017-12-12,NASDAQ (Q),312237642,105854568,482393660,900485870,14070785654.177995,6370466879.799302,25357284839.606104,45798537373.583401,2693586,419701,3006060,6119347
2017-12-12,IEX (V),107565766,18981559,47639245,174186570,4654666419.061100,1117925960.909600,2553333214.509900,8325925594.480600,636260,68866,304073,1009199
2017-12-12,NASDAQ PSX (X),17257896,14443327,14885065,46586288,682047317.681400,916684736.313800,861654673.533200,2460386727.528400,142148,54612,125911,322671
2017-12-12,BYX Equities (Y),194149568,65704422,83528966,343382956,5986944942.783699,3063568190.424000,3204824737.567500,12255337870.775199,1616469,298971,782828,2698268
2017-12-12,BZX Equities (Z),185450382,76492668,88059115,350002165,7088505063.770100,5033777812.249399,4305071872.448002,16427354748.467501,1521749,371109,771555,2664413
2017-12-11,NYSE American (A),3018481,15659337,2384961,21062779,110295174.854800,164267199.317500,133530301.814900,408092675.987200,29364,40326,23085,92775
2017-12-11,NASDAQ BX (B),109837113,29160899,65390600,204388612,4348546148.994300,1493113596.685900,2678625506.804400,8520285252.484600,1119658,148117,673158,1940933
2017-12-11,NYSE (DN),79757046,34499948,69102411,183359405,2851665782.432400,947554070.078100,2650084413.639700,6449304266.150200,224042,83541,217010,524593
2017-12-11,NASDAQ (DQ),1108479737,396335331,701252822,2206067890,40373300932.248397,27492863066.418209,32081580156.164785,99947744154.831391,3480348,778491,2346747,6605586
2017-12-11,EDGA Equities (J),36874153,17597613,19874523,74346289,1278220736.028600,1032038533.693500,943997755.554100,3254257025.276200,331487,83810,172951,588248
2017-12-11,EDGX Equities (K),157657965,62058218,149385095,369101278,6203756766.516300,3137143596.145401,6551482114.817699,15892382477.479400,1086123,236332,963812,2286267
2017-12-11,CHX (M),7203795,14272301,7598705,29074801,511850750.981200,1480468009.655000,485032528.765300,2477351289.401500,2298,7190,1586,11074
2017-12-11,NYSE (N),782513277,0,0,782513277,32115693882.815904,0.000000,0.000000,32115693882.815904,2221667,0,0,2221667
2017-12-11,NYSE Arca (P),171715179,218683582,125153145,515551906,7562288794.288300,12312329480.790400,6205845366.086302,26080463641.165002,1328612,556064,987937,2872613
2017-12-11,NASDAQ (Q),261722935,91155119,472101338,824979392,11756547386.209901,5560718338.583699,25497428494.394309,42814694219.187909,2310930,375999,2947561,5634490
2017-12-11,IEX (V),83079798,14982223,47312658,145374679,3546778699.981500,875201530.907400,2483148223.471700,6905128454.360600,540825,64637,310577,916039
2017-12-11,NASDAQ PSX (X),14228991,12318153,14637325,41184469,595276500.727400,749204545.733100,836269788.989900,2180750835.450400,126072,51284,129668,307024
2017-12-11,BYX Equities (Y),168707999,54459207,80293195,303460401,5304396934.561300,2517807468.855499,3097156137.172900,10919360540.589699,1466842,262768,753509,2483119
2017-12-11,BZX Equities (Z),156684838,67338270,82303221,306326329,6075102416.554400,4687053743.623600,4062983619.826098,14825139780.004098,1318776,310647,734089,2363512
2017-12-08,NYSE American (A),2735201,14463796,2326406,19525403,111579681.331200,150263685.526100,127653942.048400,389497308.905700,27255,44905,22717,94877
2017-12-08,NASDAQ BX (B),118218433,29254162,68971254,216443849,4747687257.932299,1632871514.184500,2939013527.163100,9319572299.279899,1174793,148472,688838,2012103
2017-12-08,NYSE (DN),89536277,33726864,73449161,196712302,3396770819.782800,962959558.718700,2729344420.178901,7089074798.680401,223837,84453,203196,511486
2017-12-08,NASDAQ (DQ),1090704477,385523004,687020554,2163248035,41394772178.955108,22941089549.251099,30627087374.408397,94962949102.614604,3496179,744283,2236088,6476550
2017-12-08,EDGA Equities (J),40739582,18656769,22167571,81563922,1500129656.081100,1123228899.619800,1041496212.818000,3664854768.518900,368325,87585,191324,647234
2017-12-08,EDGX Equities (K),165097051,63216574,149348689,377662314,6632405698.928200,3142391677.355900,6604878937.713300,16379676313.997400,1115194,242220,941213,2298627
2017-12-08,CHX (M),11711431,13413059,7485096,32609586,583818497.286800,1533862165.440000,816105395.185100,2933786057.911900,2238,5529,2215,9982
2017-12-08,NYSE (N),740397473,0,0,740397473,31298823104.599397,0.000000,0.000000,31298823104.599397,2252846,0,0,2252846
2017-12-08,NYSE Arca (P),178339527,224926854,126825216,530091597,8037970044.434699,13108258494.707502,6451101588.338499,27597330127.480700,1372983,579754,980783,2933520
2017-12-08,NASDAQ (Q),259450156,89209062,459338291,807997509,11985387753.103802,5862090380.613003,25181358661.472802,43028836795.189607,2248281,382478,2888206,5518965
2017-12-08,IEX (V),87361703,15094937,44887688,147344328,3929229948.159701,983702462.026900,2413755266.209900,7326687676.396501,563135,66645,295738,925518
2017-12-08,NASDAQ PSX (X),14596952,12284973,14694716,41576641,604686574.244800,841188369.300200,835572666.728000,2281447610.273000,122329,48607,121684,292620
2017-12-08,BYX Equities (Y),165017044,55566592,81619961,302203597,5273261258.153200,2677693666.083200,3026561632.486500,10977516556.722900,1439773,271724,741836,2453333
2017-12-08,BZX Equities (Z),162853680,72434942,87510147,322798769,6231998320.948099,4974366695.616500,4546704920.276299,15753069936.840898,1340574,337827,767614,2446015
2017-12-07,NYSE American (A),2682064,18659630,2224043,23565737,97264202.517800,182450230.346100,112699708.841600,392414141.705500,25695,49888,21204,96787
2017-12-07,NASDAQ BX (B),117448140,36925282,66063209,220436631,4639305503.788204,1772691081.304299,2865892454.025900,9277889039.118403,1171459,166509,687001,2024969
2017-12-07,NYSE (DN),84842419,42158387,75816608,202817414,3190333529.460405,1053808260.486900,2741159971.469296,6985301761.416601,214100,90428,193991,498519
2017-12-07,NASDAQ (DQ),1122219486,466485605,742651632,2331356723,41354333210.960915,25863993542.665520,33021056547.620438,100239383301.246873,3546262,878929,2228322,6653513
2017-12-07,EDGA Equities (J),42957570,24066197,24053105,91076872,1535311298.225700,1274026446.254000,1165827313.291499,3975165057.771199,384261,111336,209028,704625
2017-12-07,EDGX Equities (K),171544030,82774642,155901042,410219714,6973757390.604707,3682919990.567596,7113851803.466804,17770529184.639107,1196582,302894,987809,2487285
2017-12-07,CHX (M),13037059,10989580,9920659,33947298,801087969.280200,900053400.321000,1182917322.443000,2884058692.044200,2376,6042,2378,10796
2017-12-07,NYSE (N),823693481,0,0,823693481,33489062536.464575,0.000000,0.000000,33489062536.464575,2353095,0,0,2353095
2017-12-07,NYSE Arca (P),187805465,264338630,136062235,588206330,8313447809.874284,14654425915.049585,7049576271.438022,30017449996.361891,1453124,673891,1052947,3179962
2017-12-07,NASDAQ (Q),286650746,114783747,506827874,908262367,12960599767.412373,6945127932.355591,27519470216.610948,47425197916.378912,2492190,461017,3085902,6039109
2017-12-07,IEX (V),86119692,18816560,42817897,147754149,3687892900.396401,1122721880.723900,2403524876.110699,7214139657.231000,548991,74835,288913,912739
2017-12-07,NASDAQ PSX (X),15386360,15602359,15136694,46125413,640397096.553700,962143876.502099,923984278.210100,2526525251.265899,132407,58306,131296,322009
2017-12-07,BYX Equities (Y),173068562,70713971,83477652,327260185,5417011604.607213,3142070602.114401,3289088842.349411,11848171049.071025,1480684,320792,785289,2586765
2017-12-07,BZX Equities (Z),169607744,87190811,92788869,349587424,6627816935.537849,5425302097.780305,4836320226.437899,16889439259.756053,1417457,389051,822073,2628581
2017-12-06,NYSE American (A),2555214,20178720,2352307,25086241,96108202.360000,184934058.044400,127815645.251100,408857905.655500,24994,53702,22872,101568
2017-12-06,NASDAQ BX (B),115211624,35958175,66664911,217834710,4565085855.371192,1756215564.451799,2829100024.785704,9150401444.608695,1158407,169916,693651,2021974
2017-12-06,NYSE (DN),74055626,36767572,67403507,178226705,2762164581.934400,948789968.029300,2460986678.395999,6171941228.359699,173329,81533,177390,432252
2017-12-06,NASDAQ (DQ),1076972597,447706374,705808778,2230487749,40325707840.341875,24025444862.903176,29959205967.792007,94310358671.037058,3631120,921457,2314067,6866644
2017-12-06,EDGA Equities (J),43332005,24664487,23252046,91248538,1587407272.317200,1261347744.180299,1102454991.932998,3951210008.430497,392015,116862,207185,716062
2017-12-06,EDGX Equities (K),176342545,79347070,154299154,409988769,7168842772.994403,3559560771.384497,6881068833.772100,17609472378.151000,1268674,306118,1005352,2580144
2017-12-06,CHX (M),13092519,16860724,13470966,43424209,688386386.815300,1131592294.955000,1409467416.770800,3229446098.541100,2217,5565,2204,9986
2017-12-06,NYSE (N),801040941,0,0,801040941,33408271894.646542,0.000000,0.000000,33408271894.646542,2519360,0,0,2519360
2017-12-06,NYSE Arca (P),195516496,294948619,138490275,628955390,8978863605.819710,16716763570.590848,7178448903.982947,32874076080.393505,1547794,761911,1082875,3392580
2017-12-06,NASDAQ (Q),290701817,119483292,489102496,899287605,13361104536.310367,7023110226.133581,27111940293.114114,47496155055.558062,2601176,506531,3155321,6263028
2017-12-06,IEX (V),93316957,18667590,46827058,158811605,3996934733.900097,976409240.139400,2509467801.351201,7482811775.390698,591984,80262,311205,983451
2017-12-06,NASDAQ PSX (X),14638962,16092802,15979070,46710834,594457262.325700,1068933523.583700,969911164.830901,2633301950.740301,128446,60516,137372,326334
2017-12-06,BYX Equities (Y),180227553,69841614,83033049,333102216,5545970968.365493,3053681870.725500,3205221393.321106,11804874232.412099,1537857,328225,781093,2647175
2017-12-06,BZX Equities (Z),176082757,84588526,95091966,355763249,6997587030.554518,5232824972.186005,4802490872.909223,17032902875.649746,1530321,402052,846874,2779247
2017-12-05,NYSE American (A),3782108,21405495,2970202,28157805,199136323.530000,209565612.275500,159731191.107000,568433126.912500,37861,49025,28620,115506
2017-12-05,NASDAQ BX (B),126822679,35487640,71953146,234263465,5278863979.183405,1940622450.095300,3206727804.970596,10426214234.249301,1253193,177132,723938,2154263
2017-12-05,NYSE (DN),80590350,40390148,74788703,195769201,3212668928.806302,1047669530.611302,2985074705.978100,7245413165.395704,184766,84850,198166,467782
2017-12-05,NASDAQ (DQ),1134345231,504112064,751526073,2389983368,44256111037.250532,26195542818.159690,34263382444.854209,104715036300.264431,3918403,960020,2513871,7392294
2017-12-05,EDGA Equities (J),45831423,26235088,24844216,96910727,1744806347.150598,1453064151.820001,1191859925.151099,4389730424.121698,409806,125627,216174,751607
2017-12-05,EDGX Equities (K),190555281,86263179,166418763,443237223,8071499018.007414,4415771565.731402,7789223176.902983,20276493760.641799,1340372,335689,1095486,2771547
2017-12-05,CHX (M),9297121,10169192,14570627,34036940,530494164.674800,1029614766.900000,1422855466.369500,2982964397.944300,2441,7708,2030,12179
2017-12-05,NYSE (N),886582815,0,0,886582815,38336075817.532916,0.000000,0.000000,38336075817.532916,2741274,0,0,2741274
2017-12-05,NYSE Arca (P),226739883,287271624,150301512,664313019,10566605033.987182,16340879276.324138,8106600442.914202,35014084753.225522,1707786,817288,1174098,3699172
2017-12-05,NASDAQ (Q),330114218,133186885,555542782,1018843885,15908193348.458891,8635281565.115316,31482631859.012550,56026106772.586757,2914125,555423,3556062,7025610
2017-12-05,IEX (V),109140577,20032318,55360147,184533042,5301273538.887403,1388131733.862600,3164418134.550396,9853823407.300399,660278,77688,354018,1091984
2017-12-05,NASDAQ PSX (X),17992888,19559891,17744928,55297707,773418530.302000,1364831904.680300,1063629658.661400,3201880093.643700,146963,73592,145136,365691
2017-12-05,BYX Equities (Y),194188288,73779393,91534611,359502292,6453795659.977412,3459431067.890210,3611608469.729908,13524835197.597530,1658421,352805,864094,2875320
2017-12-05,BZX Equities (Z),191588778,96617029,108209828,396415635,7968632931.486192,6627501437.445738,5658797695.215807,20254932064.147737,1612579,455221,946423,3014223
2017-12-04,NYSE American (A),4373443,18886302,4082897,27342642,208436675.460000,269727257.635001,253396048.268500,731559981.363501,43306,58504,37459,139269
2017-12-04,NASDAQ BX (B),145507892,43731071,80784677,270023640,6171743305.650099,2494006458.312202,3830653773.402720,12496403537.365021,1397464,209347,824264,2431075
2017-12-04,NYSE (DN),98334164,40565665,81847657,220747486,4320205857.747598,1226118654.141000,3868446331.255517,9414770843.144115,230382,91962,252301,574645
2017-12-04,NASDAQ (DQ),1285427413,495691933,870806486,2651925832,54652706945.146022,26671137866.042309,43858355479.700003,125182200290.888334,4478370,1067524,2897065,8442959
2017-12-04,EDGA Equities (J),56675148,32574659,29262394,118512201,2211852960.114498,1957365214.915801,1524438356.351902,5693656531.382201,507069,157736,258378,923183
2017-12-04,EDGX Equities (K),223631127,101575176,197707277,522913580,10221896801.339106,5493612920.365675,10000400270.038022,25715909991.742803,1607187,401464,1323956,3332607
2017-12-04,CHX (M),13245108,9929254,13111547,36285909,858315258.935300,1056795684.647700,724101439.120800,2639212382.703800,2507,7003,1774,11284
2017-12-04,NYSE (N),987310702,0,0,987310702,43760801762.861180,0.000000,0.000000,43760801762.861180,3268206,0,0,3268206
2017-12-04,NYSE Arca (P),257536452,335641619,179174900,772352971,13336063007.476231,20212394790.159270,10173752765.561493,43722210563.196994,2064375,970854,1432068,4467297
2017-12-04,NASDAQ (Q),379322380,151680415,646474213,1177477008,19333086108.092545,10161455975.047101,37854876455.409213,67349418538.548859,3401777,658536,4349977,8410290
2017-12-04,IEX (V),120405882,21920956,65566204,207893042,6187200871.957788,1532594402.833402,4189463077.554322,11909258352.345512,746468,97708,414994,1259170
2017-12-04,NASDAQ PSX (X),19030278,21375280,21465809,61871367,861549307.189600,1616280393.506601,1380071121.660999,3857900822.357200,167526,86529,179269,433324
2017-12-04,BYX Equities (Y),222194111,89375416,108174378,419743905,7548075655.993240,4367578185.173797,4529114721.398525,16444768562.565562,1910752,423203,1013070,3347025
2017-12-04,BZX Equities (Z),212854826,110281620,128716153,451852599,9302179560.095458,7721396805.757882,7137622395.759989,24161198761.613329,1850303,527022,1133324,3510649
2017-12-01,NYSE American (A),4046062,18946414,3565785,26558261,182627023.770000,333804358.980400,183880175.335700,700311558.086100,39817,63640,33087,136544
2017-12-01,NASDAQ BX (B),147753887,55598601,80249447,283601935,5787775765.825996,3474773441.516097,3820022577.036715,13082571784.378808,1452225,252963,826084,2531272
2017-12-01,NYSE (DN),91617759,47686897,73815658,213120314,3384742137.542297,1768707597.633598,3281158107.427803,8434607842.603698,197942,96803,209449,504194
2017-12-01,NASDAQ (DQ),1210387501,572358970,784659553,2567406024,45696832415.455074,33753716404.713956,38621260841.941477,118071809662.110507,4297252,1178269,2729061,8204582
2017-12-01,EDGA Equities (J),57018832,45956649,31220969,134196450,2021224545.092997,3189082961.545400,1690964558.525401,6901272065.163798,518101,212224,269310,999635
2017-12-01,EDGX Equities (K),224884483,140597801,195304715,560786999,8928296003.643400,9111937014.329770,9633351718.741985,27673584736.715155,1607952,618759,1332312,3559023
2017-12-01,CHX (M),13210950,17993144,10906969,42111063,685506525.236500,2537600882.699999,1335569368.746900,4558676776.683399,2616,7353,1981,11950
2017-12-01,NYSE (N),971827352,0,0,971827352,39950863881.292851,0.000000,0.000000,39950863881.292851,3438898,0,0,3438898
2017-12-01,NYSE Arca (P),259525032,470703465,181950492,912178989,11616407433.928204,30835761199.442840,10295044382.994239,52747213016.365283,2066980,1460868,1436284,4964132
2017-12-01,NASDAQ (Q),397357965,243509587,617102477,1257970029,18043423560.927479,18036374137.784124,36023672505.027521,72103470203.739124,3558129,1137986,4295002,8991117
2017-12-01,IEX (V),105591416,31214731,54343489,191149636,4636047916.823504,2376313151.631200,3200135931.505498,10212496999.960202,686232,122262,379046,1187540
2017-12-01,NASDAQ PSX (X),21024887,36966822,23637289,81628998,894989211.526001,3163990644.597400,1519333965.441500,5578313821.564901,180329,145271,186346,511946
2017-12-01,BYX Equities (Y),224451311,111006575,108377111,443834997,7073937524.062332,5901817810.474991,4576623204.018838,17552378538.556161,1940215,533344,1016594,3490153
2017-12-01,BZX Equities (Z),222236573,179970931,137008164,539215668,8980413601.885507,13560046753.135240,7886558016.523965,30427018371.544712,1939851,878288,1204963,4023102
2017-11-30,NYSE American (A),3442877,17820800,2724336,23988013,128624129.654200,265411126.474600,161703200.109600,555738456.238400,32134,47720,25689,105543
2017-11-30,NASDAQ BX (B),149742233,51685278,77166566,278594077,5972163572.559224,2786416092.448798,3615639891.074597,12374219556.082619,1442602,226994,784761,2454357
2017-11-30,NYSE (DN),105167731,40264628,73651000,219083359,4064197093.250185,1358649142.403001,3297121672.204004,8719967907.857190,221327,81290,198169,500786
2017-11-30,NASDAQ (DQ),1570008094,575058580,854849377,2999916051,62697450666.160313,33532290003.672449,42943291055.245855,139173031725.078617,4611138,1029982,2698573,8339693
2017-11-30,EDGA Equities (J),61140946,36747732,28159418,126048096,2153912973.264402,2181291248.634700,1450217105.315001,5785421327.214103,534188,157165,246273,937626
2017-11-30,EDGX Equities (K),242883576,113645726,177757856,534287158,10017234145.684779,6558591078.104200,9215655584.992929,25791480808.781908,1700024,426048,1211458,3337530
2017-11-30,CHX (M),12106055,16367675,17296373,45770103,893252205.533600,1853253123.113999,1908233745.809100,4654739074.456699,2831,8163,2567,13561
2017-11-30,NYSE (N),1513670567,0,0,1513670567,68626613611.402628,0.000000,0.000000,68626613611.402628,3255329,0,0,3255329
2017-11-30,NYSE Arca (P),282101299,379851466,161750386,823703151,12528914730.882027,23156267986.284350,9487335124.327411,45172517841.493788,2100995,974852,1269135,4344982
2017-11-30,NASDAQ (Q),411752010,182419494,773730323,1367901827,19147780765.795620,12450974343.797986,46179089635.397157,77777844744.990763,3511693,686145,3851817,8049655
2017-11-30,IEX (V),117465115,26123810,53550810,197139735,5079279678.805101,1643729553.939999,3093218372.492999,9816227605.238099,709369,100106,353528,1163003
2017-11-30,NASDAQ PSX (X),20377806,25181778,19035789,64595373,887040969.748600,1784872671.239799,1268034056.594999,3939947697.583398,177357,86172,162871,426400
2017-11-30,BYX Equities (Y),239312675,103599503,106382575,449294753,7473428358.323314,5141427317.315094,4447189270.808511,17062044946.446919,2022370,464472,986538,3473380
2017-11-30,BZX Equities (Z),236529557,133018300,122477416,492025273,9538329009.564090,9422015470.504810,6903674502.549006,25864018982.617906,1949115,571746,1057683,3578544
2017-11-29,NYSE American (A),3281841,14940456,3342445,21564742,132648319.707000,189820388.769200,237918218.320500,560386926.796700,31614,44727,28023,104364
2017-11-29,NASDAQ BX (B),143221343,43167194,83723965,270112502,5721141628.935394,2135586876.083603,4352341105.635613,12209069610.654610,1416447,200101,881094,2497642
2017-11-29,NYSE (DN),107339652,39446499,89684348,236470499,4165376552.912596,1200715766.795697,5113979105.417814,10480071425.126107,235221,85872,280863,601956
2017-11-29,NASDAQ (DQ),1359510591,494416037,874454427,2728381055,51957311379.013768,27038441618.349028,50182090148.786166,129177843146.148962,4568468,986016,3195428,8749912
2017-11-29,EDGA Equities (J),59594916,32883233,30481481,122959630,2086571197.696399,1756644348.463400,1791301499.172099,5634517045.331898,508777,145175,274195,928147
2017-11-29,EDGX Equities (K),242174820,95471774,205082420,542729014,9962459256.427632,5253192543.726805,11628757067.473018,26844408867.627455,1711791,379639,1446942,3538372
2017-11-29,CHX (M),11061820,15572243,6380524,33014587,683831351.962500,1303443598.791701,732285508.994600,2719560459.748801,3144,6446,2670,12260
2017-11-29,NYSE (N),921906176,0,0,921906176,37082590112.155152,0.000000,0.000000,37082590112.155152,3100035,0,0,3100035
2017-11-29,NYSE Arca (P),262452664,338397736,188292389,789142789,11772555743.891996,18419152061.212666,11803601996.277291,41995309801.381953,1972271,876548,1501391,4350210
2017-11-29,NASDAQ (Q),392054767,155502178,633120063,1180677008,18181030422.301974,9517881533.696676,41145842246.455139,68844754202.453789,3360534,606438,4532689,8499661
2017-11-29,IEX (V),116199850,23884703,64961775,205046328,5098735263.493500,1363205829.867401,4614000118.397789,11075941211.758690,717946,99756,426319,1244021
2017-11-29,NASDAQ PSX (X),19869690,19940086,22728976,62538752,831740568.056900,1227504808.669099,1562702875.750698,3621948252.476697,173891,73112,196870,443873
2017-11-29,BYX Equities (Y),219241087,86495804,111388228,417125119,6901063032.931423,4006607792.040093,4991292183.778339,15898963008.749855,1909676,407042,1079745,3396463
2017-11-29,BZX Equities (Z),232729969,117222107,143352575,493304651,9068454360.117726,7397202715.597387,8992746782.906842,25458403858.621955,1896246,504455,1231873,3632574
2017-11-28,NYSE American (A),2708884,15272580,2068305,20049769,96723665.730000,149134536.518000,100322060.631900,346180262.879900,24804,38355,20606,83765
2017-11-28,NASDAQ BX (B),130123276,34178903,71456701,235758880,4949458937.708698,1862034205.024699,3000613298.773398,9812106441.506795,1267724,161920,723989,2153633
2017-11-28,NYSE (DN),83503174,35440189,71869388,190812751,3002749952.338799,1109438101.751302,2844613152.235007,6956801206.325108,186309,75611,200529,462449
2017-11-28,NASDAQ (DQ),1209816696,449836437,758479813,2418132946,45583435061.472680,27321149079.525445,34083618108.097993,106988202249.096118,3844828,871728,2413189,7129745
2017-11-28,EDGA Equities (J),46301088,24825679,23237352,94364119,1605991510.636399,1478540612.755601,1040921603.553399,4125453726.945399,405935,111805,195710,713450
2017-11-28,EDGX Equities (K),176964228,79399782,166532018,422896028,7042860866.732694,4210854084.833293,7309904543.902109,18563619495.468096,1205500,290895,1004638,2501033
2017-11-28,CHX (M),9733778,15701195,7860140,33295113,510004208.056800,2189062204.857001,966549104.784500,3665615517.698301,2172,2694,1276,6142
2017-11-28,NYSE (N),833600514,0,0,833600514,33950114058.589724,0.000000,0.000000,33950114058.589724,2498610,0,0,2498610
2017-11-28,NYSE Arca (P),202913008,258505056,137270241,598688305,9069292058.772693,15140233709.486261,6880170386.680088,31089696154.939042,1556030,664971,1026114,3247115
2017-11-28,NASDAQ (Q),310283746,117673070,506177150,934133966,14160128172.029882,7886228362.954933,26874651109.365430,48921007644.350245,2719555,451194,3173880,6344629
2017-11-28,IEX (V),103227237,20543774,52520751,176291762,4452627197.329802,1607852104.369300,2930876908.993601,8991356210.692703,636337,87426,329052,1052815
2017-11-28,NASDAQ PSX (X),15492960,15388567,15624944,46506471,622086392.320000,1005851026.267900,829208660.245501,2457146078.833401,135649,58207,127066,320922
2017-11-28,BYX Equities (Y),187426081,73016319,91983268,352425668,5899989808.425890,3601555233.903104,3510563556.382602,13012108598.711596,1627999,334851,846610,2809460
2017-11-28,BZX Equities (Z),181254019,94254140,98761063,374269222,6970121164.835113,6533061739.900938,4801562696.085302,18304745600.821353,1459143,405881,810270,2675294
2017-11-27,NYSE American (A),2106752,17522524,1712746,21342022,71126132.770700,125669411.818400,84495807.164200,281291351.753300,22432,43094,18789,84315
2017-11-27,NASDAQ BX (B),108808821,30438400,60893301,200140522,4189532407.201502,1411273890.452198,2549102697.951502,8149908995.605202,1108163,134731,635811,1878705
2017-11-27,NYSE (DN),72129957,29945487,66996781,169072225,2405343465.543395,741652664.983999,2762934180.328892,5909930310.856286,192666,74133,205620,472419
2017-11-27,NASDAQ (DQ),1029127068,361675680,677138217,2067940965,36947804823.329667,18657057267.306733,30643322099.719509,86248184190.355909,3551702,806138,2274492,6632332
2017-11-27,EDGA Equities (J),39009765,20025422,19830521,78865708,1336331657.280300,1021572600.897600,950030312.352500,3307934570.530400,356734,93601,176043,626378
2017-11-27,EDGX Equities (K),156047749,64030726,145990607,366069082,5870010054.659099,2611260270.622703,6474781973.036997,14956052298.318799,1069636,229880,910597,2210113
2017-11-27,CHX (M),8619176,14742251,12261259,35622686,464120217.814000,1301345277.916700,1057917032.946000,2823382528.676700,1823,3446,1371,6640
2017-11-27,NYSE (N),766078112,0,0,766078112,30180361394.431170,0.000000,0.000000,30180361394.431170,2186584,0,0,2186584
2017-11-27,NYSE Arca (P),164519373,217149505,116198207,497867085,7048356994.517819,11241001371.828617,5911357124.801693,24200715491.148129,1294733,570756,893367,2758856
2017-11-27,NASDAQ (Q),262044611,89574956,468264965,819884532,11616819589.819500,5216881628.693929,25903071644.743876,42736772863.257305,2307675,365476,2823309,5496460
2017-11-27,IEX (V),83521043,15549284,41874496,140944823,3454968951.876301,930420026.095400,2211165163.132802,6596554141.104503,539454,64613,289717,893784
2017-11-27,NASDAQ PSX (X),12688111,9811653,12512347,35012111,494573944.759500,644496422.514900,737549902.203200,1876620269.477600,114886,41798,109071,265755
2017-11-27,BYX Equities (Y),157265721,56202882,75210103,288678706,4866845022.160693,2468728602.107799,2855110563.903694,10190684188.172186,1405577,267567,721969,2395113
2017-11-27,BZX Equities (Z),155756794,60128656,82671237,298556687,5890449381.189088,3634426427.310402,4209479078.395484,13734354886.894974,1290352,278516,721859,2290727
2017-11-24,NYSE American (A),1144402,10329239,959146,12432787,41562276.750000,72425573.696300,46927763.775200,160915614.221500,13363,19401,11466,44230
2017-11-24,NASDAQ BX (B),48494088,14466914,28274139,91235141,1840961738.567492,657094443.784400,1139512998.660198,3637569181.012090,519284,65315,308820,893419
2017-11-24,NYSE (DN),32674076,13304142,30745186,76723404,1033937169.213300,372827165.324800,1258082569.425300,2664846903.963400,85278,30051,103839,219168
2017-11-24,NASDAQ (DQ),450407676,187527903,325914467,963850046,15407358394.073667,8440963268.079922,14066394009.586177,37914715671.739766,1648314,390703,1164459,3203476
2017-11-24,EDGA Equities (J),17285909,9958832,8914509,36159250,581995163.471700,513024868.691101,428573711.776900,1523593743.939701,162797,48823,81089,292709
2017-11-24,EDGX Equities (K),77516968,36404989,80522528,194444485,2796801754.819000,1430680904.761799,3255255886.733030,7482738546.313829,502097,118898,459146,1080141
2017-11-24,CHX (M),963592,6061556,3690285,10715433,61298107.100000,431127461.220000,655212238.305000,1147637806.625000,821,1774,1006,3601
2017-11-24,NYSE (N),362951248,0,0,362951248,13285725490.484886,0.000000,0.000000,13285725490.484886,1091918,0,0,1091918
2017-11-24,NYSE Arca (P),80900724,118442060,59604802,258947586,3171834105.946795,6342103600.029794,2843047450.041815,12356985156.018404,615034,290805,447366,1353205
2017-11-24,NASDAQ (Q),129263294,48777867,234778196,412819357,5513129369.728903,3012639896.909407,12480761490.348081,21006530756.986391,1102178,188153,1412875,2703206
2017-11-24,IEX (V),34066257,8445556,18404762,60916575,1260266748.068500,462340281.985800,975480374.886898,2698087404.941198,235128,38802,138660,412590
2017-11-24,NASDAQ PSX (X),6303161,5369513,5412037,17084711,238537409.710800,327950967.542300,336878486.617100,903366863.870200,56942,21639,47962,126543
2017-11-24,BYX Equities (Y),74056318,29662176,36373126,140091620,2162278074.322505,1290207109.875400,1359547872.799302,4812033056.997207,678325,141237,355590,1175152
2017-11-24,BZX Equities (Z),69864188,35407077,38522197,143793462,2459240894.544209,1898636615.497003,2014263179.291999,6372140689.333211,598933,154142,342531,1095606
2017-11-22,NYSE American (A),2043596,11683128,1697638,15424362,69981246.568000,109078929.191000,75733221.131200,254793396.890200,21101,31844,17799,70744
2017-11-22,NASDAQ BX (B),99212702,28652839,55721986,183587527,3820694020.361493,1326789180.487702,2298044202.104598,7445527402.953793,1049041,137254,619379,1805674
2017-11-22,NYSE (DN),71386367,22396384,60217031,153999782,2591486176.168298,709940478.214300,2443434456.714899,5744861111.097497,173800,57489,182267,413556
2017-11-22,NASDAQ (DQ),942883422,338364093,596653710,1877901225,33175693621.280648,17831212032.571258,25921860390.706117,76928766044.558023,3325860,705000,2092408,6123268
2017-11-22,EDGA Equities (J),35939632,19823855,17257317,73020804,1248841466.052300,1042939892.850700,789354651.104000,3081136010.007000,327102,95951,156825,579878
2017-11-22,EDGX Equities (K),148549272,56627343,135097711,340274326,5656586560.518812,2730734346.559901,5645537148.061710,14032858055.140423,1007147,227795,831352,2066294
2017-11-22,CHX (M),8601122,8202403,7991136,24794661,499195377.043000,592196486.142800,714324641.895900,1805716505.081700,1653,2579,1240,5472
2017-11-22,NYSE (N),668842452,0,0,668842452,26323409981.893705,0.000000,0.000000,26323409981.893705,2049354,0,0,2049354
2017-11-22,NYSE Arca (P),158887060,195006448,105665981,459559489,6725473029.810886,10209988012.095691,5083704635.617915,22019165677.524492,1216715,535486,817758,2569959
2017-11-22,NASDAQ (Q),239775520,88526407,408577934,736879861,10393824113.292298,5451440145.345112,21476872144.632381,37322136403.269791,2056615,373279,2533577,4963471
2017-11-22,IEX (V),79699217,14391229,41661079,135751525,3268315321.337612,805464442.630300,2371811199.120197,6445590963.088109,506289,61898,277711,845898
2017-11-22,NASDAQ PSX (X),11673547,9646406,10996372,32316325,448860500.736600,585983240.219400,588486065.410900,1623329806.366900,106136,39814,94866,240816
2017-11-22,BYX Equities (Y),148986343,55016508,69848118,273850969,4511196686.001190,2529209938.363105,2592539568.193105,9632946192.557400,1304748,272933,673971,2251652
2017-11-22,BZX Equities (Z),147632247,63933998,77770108,289336353,5303680623.907596,3750069652.740396,3772415180.248203,12826165456.896195,1178140,300217,665117,2143474
2017-11-21,NYSE American (A),2566902,11818524,2149920,16535346,89573354.320000,135355525.447800,96013915.613300,320942795.381100,26370,34837,21892,83099
2017-11-21,NASDAQ BX (B),124196287,32401477,68761795,225359559,4896466414.794606,1646065304.245800,2768322006.314906,9310853725.355312,1301102,156659,756647,2214408
2017-11-21,NYSE (DN),83502139,25977282,69922204,179401625,3084343373.631997,849380310.817400,2682679082.359000,6616402766.808397,202413,61871,201130,465414
2017-11-21,NASDAQ (DQ),1129733134,357087455,712372127,2199192716,42130500594.371057,21039411622.797340,30642206072.149928,93812118289.318325,3788904,778627,2397908,6965439
2017-11-21,EDGA Equities (J),43993922,21061094,20869886,85924902,1556132651.460003,1213733061.725600,918998350.130001,3688864063.315604,396318,109282,185403,691003
2017-11-21,EDGX Equities (K),172669132,60505357,152362633,385537122,6910185003.507311,3360688780.077209,6692952029.384213,16963825812.968733,1154511,250878,932643,2338032
2017-11-21,CHX (M),16324710,8244554,8176189,32745453,959315490.600600,1022221624.140000,851631212.290800,2833168327.031400,2099,3503,1437,7039
2017-11-21,NYSE (N),828066678,0,0,828066678,32958260567.029449,0.000000,0.000000,32958260567.029449,2393826,0,0,2393826
2017-11-21,NYSE Arca (P),191392911,226191776,125569872,543154559,8417359506.289093,13796857547.658061,6055946289.936086,28270163343.883240,1442675,620242,955631,3018548
2017-11-21,NASDAQ (Q),288826761,97073986,489431241,875331988,12864501866.516285,6517330306.592559,25817763237.183403,45199595410.292247,2498147,408994,3004555,5911696
2017-11-21,IEX (V),103271263,16309310,48318907,167899480,4283208164.948304,964461991.732800,2483797884.841998,7731468041.523102,615213,72164,319463,1006840
2017-11-21,NASDAQ PSX (X),13974451,12215163,13097154,39286768,559713111.188200,802563478.898900,694507663.662200,2056784253.749300,125355,49561,112942,287858
2017-11-21,BYX Equities (Y),181742100,58147750,86947250,326837100,5623203634.614710,2866744353.171403,3165638147.293795,11655586135.079908,1567738,286939,817542,2672219
2017-11-21,BZX Equities (Z),170974105,69971593,93989665,334935363,6384670548.429507,4633401517.089010,4546229290.912131,15564301356.430648,1379289,330520,798411,2508220
2017-11-20,NYSE American (A),2348207,11207980,2059265,15615452,82285742.913000,139751978.216200,96861614.678100,318899335.807300,24135,33799,20551,78485
2017-11-20,NASDAQ BX (B),111902062,26159344,63876780,201938186,4374592661.505498,1275728829.301999,2734815922.748001,8385137413.555498,1192998,137859,711333,2042190
2017-11-20,NYSE (DN),79988653,23339059,66899905,170227617,2966236879.809695,755205795.405101,2547208333.867995,6268651009.082791,192097,57879,196438,446414
2017-11-20,NASDAQ (DQ),1027764114,316189610,671421274,2015374998,39583785751.528898,17143509669.557497,27836543963.647878,84563839384.734273,3569142,710818,2287615,6567575
2017-11-20,EDGA Equities (J),39094165,18295916,20821130,78211211,1393208689.853199,1066193825.821099,926113830.184800,3385516345.859098,376151,96427,190019,662597
2017-11-20,EDGX Equities (K),156910320,57804685,146900804,361615809,6386554275.694893,2790385455.490004,6075517632.196216,15252457363.381113,1068333,234920,908764,2212017
2017-11-20,CHX (M),18890346,10661234,8050221,37601801,988375117.179800,861228095.311600,801587961.162300,2651191173.653700,1957,2382,1395,5734
2017-11-20,NYSE (N),732807386,0,0,732807386,30066310108.836295,0.000000,0.000000,30066310108.836295,2264329,0,0,2264329
2017-11-20,NYSE Arca (P),166790643,204598415,122415688,493804746,7437736462.389500,11367028784.712516,5660250154.750313,24465015401.852329,1307825,597509,928894,2834228
2017-11-20,NASDAQ (Q),262327426,85696038,465305074,813328538,12080604654.879258,5404992160.595004,23715067184.253739,41200663999.728001,2339589,378258,2954437,5672284
2017-11-20,IEX (V),92742389,14183376,50066410,156992175,3957429027.117802,737970935.950001,2534726052.285204,7230126015.353007,572853,66123,326456,965432
2017-11-20,NASDAQ PSX (X),12213697,11413416,12827007,36454120,481251802.073400,679935490.680400,694301790.877200,1855489083.631000,110302,44612,110910,265824
2017-11-20,BYX Equities (Y),161979895,52849584,86482248,301311727,5068209888.751994,2424286834.985795,3198849394.009114,10691346117.746903,1455181,263323,821245,2539749
2017-11-20,BZX Equities (Z),158185876,65848233,94633186,318667295,6067391345.665315,3886661341.521796,4300953369.705502,14255006056.892613,1293959,303845,800730,2398534
2017-11-17,NYSE American (A),2835672,16002695,2219354,21057721,106510977.491000,180833946.795000,111109227.148100,398454151.434100,28642,36145,22241,87028
2017-11-17,NASDAQ BX (B),113622499,29858006,63611620,207092125,4350050073.665086,1560174878.524000,2798625424.405587,8708850376.594673,1138489,156353,655908,1950750
2017-11-17,NYSE (DN),75536684,23076839,71138713,169752236,2656279442.683296,812467467.595599,2649817404.169600,6118564314.448495,188986,58545,206690,454221
2017-11-17,NASDAQ (DQ),1065682402,370442366,771198637,2207323405,38397553712.184098,23665072858.188860,34179537278.213918,96242163848.586876,3764130,755283,2351578,6870991
2017-11-17,EDGA Equities (J),42006082,20431303,22524882,84962267,1465375851.901998,1158094406.021300,1049429285.153499,3672899543.076797,382495,103103,199814,685412
2017-11-17,EDGX Equities (K),165555105,64602428,154523370,384680903,6476507283.676398,3490765498.735489,6595039648.564284,16562312430.976171,1206005,259284,967215,2432504
2017-11-17,CHX (M),41752297,16957798,7745621,66455716,2141242745.517000,1350175031.970000,623516638.792800,4114934416.279800,2011,3060,1748,6819
2017-11-17,NYSE (N),874993374,0,0,874993374,35204314761.134991,0.000000,0.000000,35204314761.134991,2391285,0,0,2391285
2017-11-17,NYSE Arca (P),190637243,232540353,135341637,558519233,8111176632.066503,14226391694.025350,6638028508.764593,28975596834.856446,1437790,635921,973737,3047448
2017-11-17,NASDAQ (Q),273949375,96342959,524383075,894675409,11978320630.004074,6681033728.631629,28133870908.299208,46793225266.934911,2494706,419605,3118729,6033040
2017-11-17,IEX (V),95719292,19172671,50568027,165459990,3790737040.841493,1081429187.829800,2547645857.129801,7419812085.801094,586537,86615,329545,1002697
2017-11-17,NASDAQ PSX (X),13793241,12858641,13703784,40355666,528487803.151400,856193102.166600,721072374.090500,2105753279.408500,124164,52864,113858,290886
2017-11-17,BYX Equities (Y),178672633,63332001,91268605,333273239,5419873026.194488,3091815748.370504,3372159726.334205,11883848500.899197,1561353,320276,866816,2748445
2017-11-17,BZX Equities (Z),175050215,72459907,101001707,348511829,6616539494.745303,4735713906.539398,4999338501.199775,16351591902.484476,1437131,343946,843269,2624346
2017-11-16,NYSE American (A),2398260,10940800,2084553,15423613,93683505.636800,153804615.504200,103312026.274400,350800147.415400,25723,35601,21011,82335
2017-11-16,NASDAQ BX (B),127559301,31892700,73922120,233374121,5075485720.132497,1806879470.559603,3027021728.618188,9909386919.310288,1288756,156660,741893,2187309
2017-11-16,NYSE (DN),82463809,26199975,72447859,181111643,3157186381.424195,1012716759.839798,2908951687.091501,7078854828.355494,191423,62145,208569,462137
2017-11-16,NASDAQ (DQ),1101241585,347884965,755346203,2204472753,41547695395.776771,19006459601.264086,32510893237.002853,93065048234.043710,3861317,793935,2443692,7098944
2017-11-16,EDGA Equities (J),43944583,21829186,23509653,89283422,1572809213.772201,1310933684.523002,1052403626.151399,3936146524.446602,399687,102638,204880,707205
2017-11-16,EDGX Equities (K),170660019,62884096,161590034,395134149,7016094915.461114,3667386008.305500,6950410476.209097,17633891399.975711,1189411,260957,989359,2439727
2017-11-16,CHX (M),33574282,10634784,8126981,52336047,1860023836.965400,1181737500.170000,740580007.250000,3782341344.385400,2226,3316,1336,6878
2017-11-16,NYSE (N),776202972,0,0,776202972,30763594420.711010,0.000000,0.000000,30763594420.711010,2494730,0,0,2494730
2017-11-16,NYSE Arca (P),203318915,232903194,148478219,584700328,9060693399.389177,14241183092.498739,6943769658.585890,30245646150.473806,1564007,646530,1042232,3252769
2017-11-16,NASDAQ (Q),299188234,106727125,506409054,912324413,13742214480.415172,7564284023.110386,25722847395.447420,47029345898.972978,2650362,447063,3161795,6259220
2017-11-16,IEX (V),103154080,16909760,53605246,173669086,4265038640.726200,1109023482.965600,2624582991.000502,7998645114.692302,628312,73051,344907,1046270
2017-11-16,NASDAQ PSX (X),14539642,13227285,14515930,42282857,588738453.873900,903238890.553600,750884494.821900,2242861839.249400,133288,53208,120419,306915
2017-11-16,BYX Equities (Y),189282285,62355481,96065113,347702879,5877563181.494469,3036067712.897108,3470622185.258496,12384253079.650073,1617740,291107,874812,2783659
2017-11-16,BZX Equities (Z),182205606,80958726,104282800,367447132,7072760889.863387,5372705895.025598,4992757044.052510,17438223828.941495,1506905,370251,869689,2746845
2017-11-15,NYSE American (A),2525178,13580030,2079948,18185156,94217768.351600,176560807.365701,109357595.346000,380136171.063301,26462,41061,20709,88232
2017-11-15,NASDAQ BX (B),133192049,33499889,66671153,233363091,5059426775.823578,1794691156.184898,2846909301.722596,9701027233.731072,1317178,166989,664836,2149003
2017-11-15,NYSE (DN),88233576,31473528,66920110,186627214,3034697098.048692,1155158634.269200,2592292340.183102,6782148072.500994,195497,70340,197700,463537
2017-11-15,NASDAQ (DQ),1202450858,385924637,725822371,2314197866,42045336020.344898,21574055634.402684,30305440230.019849,93924831884.767431,3875442,816623,2304518,6996583
2017-11-15,EDGA Equities (J),50006477,25517186,23084767,98608430,1621504263.256496,1409006036.227901,971733280.565901,4002243580.050298,437131,121355,195585,754071
2017-11-15,EDGX Equities (K),182927896,74007889,156892007,413827792,7018315027.874090,4024488803.979092,6727929006.244052,17770732838.097234,1263581,311669,972556,2547806
2017-11-15,CHX (M),29191697,12440838,3907314,45539849,1618573534.418800,1408225868.342200,360835108.139200,3387634510.900200,2533,3684,1376,7593
2017-11-15,NYSE (N),849825692,0,0,849825692,32300263184.743097,0.000000,0.000000,32300263184.743097,2615006,0,0,2615006
2017-11-15,NYSE Arca (P),214043324,262101839,135426458,611571621,8988871928.601615,16017300685.030084,6558360720.967515,31564533334.599214,1589538,795765,995699,3381002
2017-11-15,NASDAQ (Q),316827762,119603949,491954857,928386568,13531562266.098587,8283069853.137515,25249275802.431553,47063907921.667655,2755560,545076,3119532,6420168
2017-11-15,IEX (V),108779249,17365638,46351102,172495989,4383411850.974103,955133978.254400,2310049037.857306,7648594867.085809,616903,74252,294572,985727
2017-11-15,NASDAQ PSX (X),16795686,15336837,13809395,45941918,596659426.254100,1014984052.424900,731162470.228800,2342805948.907800,144608,61096,115465,321169
2017-11-15,BYX Equities (Y),196794500,69290763,91570768,357656031,5807299666.347310,3305884497.617494,3267972192.232495,12381156356.197299,1652911,327864,830392,2811167
2017-11-15,BZX Equities (Z),194996956,92589976,99240373,386827305,7202919104.991278,6018943049.828515,4768011262.118290,17989873416.938083,1602347,439078,848419,2889844
2017-11-14,NYSE American (A),2943117,14866242,2170922,19980281,102335366.960000,163228465.727000,96017733.347900,361581566.034900,29549,43664,23012,96225
2017-11-14,NASDAQ BX (B),132896795,34895518,68658332,236450645,4911835769.848982,1668011874.735698,2803029207.835897,9382876852.420577,1311482,179424,697370,2188276
2017-11-14,NYSE (DN),97711899,29116973,77613017,204441889,3354468850.821602,977463160.744099,2938267746.456307,7270199758.022008,211304,67300,211328,489932
2017-11-14,NASDAQ (DQ),1219654669,395775093,743312594,2358742356,41486746198.311261,19800545185.097576,29840641686.675197,91127933070.084034,4067963,837647,2405066,7310676
2017-11-14,EDGA Equities (J),51993820,24910811,23932753,100837384,1643782416.315002,1306440014.874901,1007475189.183703,3957697620.373606,455615,120172,209981,785768
2017-11-14,EDGX Equities (K),192663917,77775358,170150400,440589675,6975355051.549605,3862103949.694501,6865665471.198572,17703124472.442678,1256841,311137,1005109,2573087
2017-11-14,CHX (M),23797260,17133899,9212663,50143822,1379892332.596300,2172599420.810000,1037759056.771900,4590250810.178200,3189,871,1160,5220
2017-11-14,NYSE (N),841869642,0,0,841869642,30885146140.986514,0.000000,0.000000,30885146140.986514,2548491,0,0,2548491
2017-11-14,NYSE Arca (P),214289554,244520606,136974505,595784665,8617151634.505392,13369197484.167413,6345699715.992719,28332048834.665524,1583363,729228,999804,3312395
2017-11-14,NASDAQ (Q),329173661,116443892,493241927,938859480,13523869194.390883,6865699511.504985,24275590706.183136,44665159412.079004,2744776,504404,3109577,6358757
2017-11-14,IEX (V),107547936,20125180,49801182,177474298,4158914001.862593,1044446510.620700,2306686218.762602,7510046731.245895,617190,86416,307409,1011015
2017-11-14,NASDAQ PSX (X),17850534,14680175,15126695,47657404,659658218.984800,881541511.322500,724707418.613600,2265907148.920900,153884,63182,122514,339580
2017-11-14,BYX Equities (Y),207285159,67859886,94307186,369452231,6043844563.738544,2992986847.455107,3328521695.118400,12365353106.312051,1738842,328488,863716,2931046
2017-11-14,BZX Equities (Z),203911000,92979706,103732978,400623684,7317417680.946295,5571714268.984997,4860690942.404008,17749822892.335300,1618683,427399,864318,2910400
2017-11-13,NYSE American (A),2667714,15154928,2160693,19983335,91189306.735700,150032513.151200,97970763.115500,339192583.002400,26978,39597,22166,88741
2017-11-13,NASDAQ BX (B),122458459,26394417,66206174,215059050,4556744974.846303,1275136944.263403,2816593713.250299,8648475632.360005,1184844,134661,671053,1990558
2017-11-13,NYSE (DN),89651367,26786204,84563757,201001328,3053766486.612398,809541843.570200,2789344298.587997,6652652628.770595,213075,68252,238377,519704
2017-11-13,NASDAQ (DQ),1154852327,329057901,756856625,2240766853,40685797775.121232,16206498119.877596,29221569534.002838,86113865429.001666,3713254,712575,2358892,6784721
2017-11-13,EDGA Equities (J),45963094,18956346,22359841,87279281,1476532851.958000,1006932684.293700,878565616.210300,3362031152.462000,401590,87609,189399,678598
2017-11-13,EDGX Equities (K),179075962,56942177,164579830,400597969,6514537666.562801,2682100723.968601,6129966495.319354,15326604885.850756,1175922,222942,939764,2338628
2017-11-13,CHX (M),23251512,10388078,8257512,41897102,1216083018.571000,1415300279.770000,506955443.649200,3138338741.990200,2569,832,1060,4461
2017-11-13,NYSE (N),791467489,0,0,791467489,30368273078.914980,0.000000,0.000000,30368273078.914980,2388128,0,0,2388128
2017-11-13,NYSE Arca (P),197776850,207133824,132111004,537021678,8258295511.672396,11151933381.049612,5673397907.034411,25083626799.756419,1475371,552644,939498,2967513
2017-11-13,NASDAQ (Q),296219553,86195372,485853263,868268188,12438215058.652695,5402019515.466087,22906182657.709711,40746417231.828493,2525074,370300,2900792,5796166
2017-11-13,IEX (V),111358145,17126651,50573299,179058095,4593103565.521492,878066748.534200,2338027464.390308,7809197778.446000,607442,64555,316044,988041
2017-11-13,NASDAQ PSX (X),15718241,12174831,14151024,42044096,564401172.955300,803298353.442600,620393815.572800,1988093341.970700,131054,45251,113646,289951
2017-11-13,BYX Equities (Y),189571144,52733340,92810115,335114599,5522252245.341201,2398197317.393798,3159888302.815879,11080337865.550878,1608819,246266,841159,2696244
2017-11-13,BZX Equities (Z),185173248,66689447,95979389,347842084,6618197940.892719,3984087845.677308,4068424527.863387,14670710314.433414,1478425,304455,791468,2574348
2017-11-10,NYSE American (A),2659688,15370513,2168535,20198736,88281895.895000,150448198.376800,97855173.369900,336585267.641700,28406,45110,22963,96479
2017-11-10,NASDAQ BX (B),117378061,31482385,64531180,213391626,4413263091.560620,1512370020.471599,2616288294.950493,8541921406.982712,1163403,159130,658143,1980676
2017-11-10,NYSE (DN),84839769,33663311,80603276,199106356,2852938724.790699,992697525.449299,3006327418.824408,6851963669.064406,196729,75741,231332,503802
2017-11-10,NASDAQ (DQ),1179422380,359907151,750705444,2290034975,40691535807.179970,17946312587.366684,30646819348.093983,89284667742.640637,3735630,754777,2378111,6868518
2017-11-10,EDGA Equities (J),45527434,20823083,21698537,88049054,1481976060.469602,1102162301.529199,900774299.183399,3484912661.182200,410362,100433,187781,698576
2017-11-10,EDGX Equities (K),178319257,63764333,160762706,402846296,6314003579.044399,3144774251.917405,6341354028.860221,15800131859.822025,1175685,250046,936500,2362231
2017-11-10,CHX (M),25027212,13634926,9554257,48216395,1327861549.938000,2000259791.300000,708526744.875000,4036648086.113000,2062,430,1125,3617
2017-11-10,NYSE (N),853300758,0,0,853300758,32096914232.621908,0.000000,0.000000,32096914232.621908,2461036,0,0,2461036
2017-11-10,NYSE Arca (P),197871789,233428700,131148400,562448889,8254810659.086710,12981771880.148553,6341359802.872378,27577942342.107641,1481843,629645,958418,3069906
2017-11-10,NASDAQ (Q),292980662,98617213,496232082,887829957,12298026372.403208,6238597353.745813,24671827031.923916,43208450758.072937,2513174,444001,3034787,5991962
2017-11-10,IEX (V),114311292,17192250,53830567,185334109,5129015262.761004,926517912.810300,2823435544.435399,8878968720.006703,641448,68974,326831,1037253
2017-11-10,NASDAQ PSX (X),14388914,12537115,13908737,40834766,521218672.952700,770747470.050700,649013045.081300,1940979188.084700,122164,50504,111660,284328
2017-11-10,BYX Equities (Y),197413943,56277450,93698884,347390277,5751927887.124488,2537519931.901995,3183968486.422502,11473416305.448985,1692652,275150,870826,2838628
2017-11-10,BZX Equities (Z),186307910,72707276,100282886,359298072,6659872113.093690,4588406887.494902,4499697468.895903,15747976469.484495,1481988,356953,815381,2654322
2017-11-09,NYSE American (A),3228915,20183662,2987663,26400240,119873784.073500,278383641.587200,161267705.721100,559525131.381800,32703,48923,29557,111183
2017-11-09,NASDAQ BX (B),137306166,39432746,75642875,252381787,5265926725.461614,2154040927.946202,3316514224.473907,10736481877.881723,1320239,202129,739293,2261661
2017-11-09,NYSE (DN),95354932,39079877,87927844,222362653,3155398329.873900,1464399926.688898,3457705464.669322,8077503721.232120,218655,82410,253684,554749
2017-11-09,NASDAQ (DQ),1236728735,467995194,811544556,2516268485,42119354379.465428,23809333441.880088,33340681697.040126,99269369518.385642,4134091,907754,2689667,7731512
2017-11-09,EDGA Equities (J),56865960,28917720,27900184,113683864,1826209764.335001,1645456616.886099,1240080995.356801,4711747376.577901,477047,138963,233003,849013
2017-11-09,EDGX Equities (K),222599758,98903244,197182651,518685653,8171764961.209789,5507460512.066892,8620807221.036762,22300032694.313443,1488818,391411,1189323,3069552
2017-11-09,CHX (M),18083748,17363689,4522061,39969498,925261047.369500,2189754874.728600,562939682.840700,3677955604.938800,2670,513,1355,4538
2017-11-09,NYSE (N),886329128,0,0,886329128,32687786526.048349,0.000000,0.000000,32687786526.048349,2987134,0,0,2987134
2017-11-09,NYSE Arca (P),247608744,323030214,167047528,737686486,10116322758.045287,19462987610.385946,8268952741.645814,37848263110.077047,1855063,979364,1239687,4074114
2017-11-09,NASDAQ (Q),366373777,153143264,563757270,1083274311,15650363821.978920,10717375351.410581,28900481046.596231,55268220219.985732,3137427,686691,3810773,7634891
2017-11-09,IEX (V),109174868,20978642,54732585,184886095,4301501363.895903,1260340115.337400,2650130849.431305,8211972328.664608,649439,93848,346199,1089486
2017-11-09,NASDAQ PSX (X),17145043,17630713,17718561,52494317,657860715.039800,1241090753.245901,905083759.968199,2804035228.253900,148189,72379,141314,361882
2017-11-09,BYX Equities (Y),222820397,75514419,110123461,408458277,6470396646.689204,3681698687.445102,3874595317.446410,14026690651.580716,1848829,388484,974805,3212118
2017-11-09,BZX Equities (Z),224486693,115140496,122416720,462043909,8211787900.763986,7948107312.881711,5980487598.927432,22140382812.573129,1796056,543199,1020110,3359365
2017-11-08,NYSE American (A),2916292,15605029,2328742,20850063,100618642.870000,135797400.744400,106549116.265100,342965159.879500,29967,41559,25141,96667
2017-11-08,NASDAQ BX (B),129234530,26804385,67243381,223282296,4853411668.035400,1360834706.415803,2687411971.118906,8901658345.570109,1260683,137813,682295,2080791
2017-11-08,NYSE (DN),105022561,44731822,85483997,235238380,3322634912.622305,922495763.371301,2898843172.187420,7143973848.181026,224332,80928,251873,557133
2017-11-08,NASDAQ (DQ),1349532616,382207675,807157853,2538898144,47529659477.542934,19696993923.288628,32145892671.062346,99372546071.893908,4159644,726923,2579744,7466311
2017-11-08,EDGA Equities (J),58090650,22108426,25303444,105502520,1870546384.723796,1218582113.320600,976886229.841998,4066014727.886394,477811,94892,211126,783829
2017-11-08,EDGX Equities (K),214837016,70362058,181612019,466811093,7187489452.670896,3163142797.398105,6954130486.219919,17304762736.288920,1325861,244400,1062959,2633220
2017-11-08,CHX (M),20326616,12471017,3737169,36534802,961973319.582400,821084654.225000,449784238.926000,2232842212.733400,2364,525,1217,4106
2017-11-08,NYSE (N),880989309,0,0,880989309,32649830739.083998,0.000000,0.000000,32649830739.083998,2658146,0,0,2658146
2017-11-08,NYSE Arca (P),242433970,229012110,148790673,620236753,9409831245.155012,11933869921.315588,6238479103.040836,27582180269.511436,1702526,606381,1089600,3398507
2017-11-08,NASDAQ (Q),344473847,97550161,534918212,976942220,14041300695.426167,5623929267.957867,25957776633.952060,45623006597.336094,2861120,411893,3354940,6627953
2017-11-08,IEX (V),111515794,15616192,51815990,178947976,4466807809.404795,888175751.694000,2518588238.708199,7873571799.806994,666232,63418,339201,1068851
2017-11-08,NASDAQ PSX (X),15631349,11856835,14180904,41669088,571692254.636600,718200827.154900,651499164.732100,1941392246.523600,137140,44761,120464,302365
2017-11-08,BYX Equities (Y),215335502,54660891,96039923,366036316,6235933472.902381,2517689046.867198,3187122414.451804,11940744934.221383,1803173,259450,872573,2935196
2017-11-08,BZX Equities (Z),208119158,77209179,102731191,388059528,7193582010.505891,4878469252.187903,4545477609.676508,16617528872.370302,1607935,326499,867120,2801554
2017-11-07,NYSE American (A),3598212,13863581,2548402,20010195,130519066.195000,151348547.683900,130335229.328500,412202843.207400,39633,43717,28091,111441
2017-11-07,NASDAQ BX (B),132170580,32772875,74107934,239051389,4810239673.054009,1615180630.370201,3179569360.191402,9604989663.615612,1321498,159432,765366,2246296
2017-11-07,NYSE (DN),101444791,30908048,88625107,220977946,3010618970.888499,1048100152.870501,2969083589.587793,7027802713.346793,237866,84140,278477,600483
2017-11-07,NASDAQ (DQ),1257885978,376418705,803603583,2437908266,42667668108.683674,19722107380.404449,32556115029.691673,94945890518.779796,4110112,776125,2592535,7478772
2017-11-07,EDGA Equities (J),56135879,22998897,26694937,105829713,1781930326.676297,1267198748.762801,1102629565.472101,4151758640.911199,473095,103539,226031,802665
2017-11-07,EDGX Equities (K),210982869,67415236,192528945,470927050,7416261401.357309,3534382041.179896,7602593520.957021,18553236963.494226,1367486,273539,1139149,2780174
2017-11-07,CHX (M),18162908,14496713,7763955,40423576,963935220.103700,2160361808.380000,621963559.262100,3746260587.745800,2654,1838,1470,5962
2017-11-07,NYSE (N),904374503,0,0,904374503,33779770194.715059,0.000000,0.000000,33779770194.715059,2818878,0,0,2818878
2017-11-07,NYSE Arca (P),234907310,244343531,164474756,643725597,9125381377.787594,13083564392.170471,7266238053.981098,29475183823.939163,1720864,682483,1183679,3587026
2017-11-07,NASDAQ (Q),350231519,99757089,561622883,1011611491,14152141375.954264,6138416436.368828,28121933921.385518,48412491733.708610,2975866,448123,3521814,6945803
2017-11-07,IEX (V),109114449,16366587,57369881,182850917,4106090946.502700,882381126.981800,3037268224.400402,8025740297.884902,663826,70953,362382,1097161
2017-11-07,NASDAQ PSX (X),15326157,12908374,15457245,43691776,539830595.984800,830416365.513400,793305790.565000,2163552752.063200,138826,52250,133157,324233
2017-11-07,BYX Equities (Y),215755480,63293709,104959523,384008712,6173572170.190409,2891351413.549600,3537646985.677180,12602570569.417189,1834456,296381,956795,3087632
2017-11-07,BZX Equities (Z),205106504,82570392,109526061,397202957,7175811901.552420,5340197991.452484,4946448646.968122,17462458539.973026,1624860,362703,919188,2906751
2017-11-06,NYSE American (A),3502943,10353589,2288200,16144732,129296483.125000,161049281.888900,110646047.875900,400991812.889800,38752,30890,24797,94439
2017-11-06,NASDAQ BX (B),126960668,28990485,69888020,225839173,4698983363.019609,1291069144.375701,3070931371.860100,9060983879.255410,1241000,138593,715625,2095218
2017-11-06,NYSE (DN),91494558,29379787,91642636,212516981,2909789597.567197,871234636.294501,3222744450.412603,7003768684.274301,228628,76925,287672,593225
2017-11-06,NASDAQ (DQ),1176051557,367823626,807337463,2351212646,39970736034.068143,19334787798.973449,34923993852.723154,94229517685.764746,4081982,760722,2647999,7490703
2017-11-06,EDGA Equities (J),49950966,21823565,25339580,97114111,1557317053.132300,1020757463.268200,1073594401.089902,3651668917.490402,431368,101111,216652,749131
2017-11-06,EDGX Equities (K),188412397,65933282,181914209,436259888,6621287687.428122,2862872264.277904,7620226538.104398,17104386489.810424,1237339,237187,1103810,2578336
2017-11-06,CHX (M),23181774,7773550,10510983,41466307,1051396260.062500,973114993.488800,1143963004.186700,3168474257.738000,2372,402,1148,3922
2017-11-06,NYSE (N),852624785,0,0,852624785,32565384257.590678,0.000000,0.000000,32565384257.590678,2605290,0,0,2605290
2017-11-06,NYSE Arca (P),206263407,238668467,160401100,605332974,8394809436.100007,11815088773.760049,7503978110.422797,27713876320.282853,1571403,598187,1157723,3327313
2017-11-06,NASDAQ (Q),315242580,92834007,547809222,955885809,13306091474.853619,5040321347.385378,28531170406.497913,46877583228.736910,2747249,378499,3445611,6571359
2017-11-06,IEX (V),95003092,16546956,52624942,164174990,3642058295.588899,814513161.986600,2840785339.329400,7297356796.904899,566327,68503,330254,965084
2017-11-06,NASDAQ PSX (X),15713225,11600069,16044481,43357775,567813695.514400,623908356.531200,787085309.036199,1978807361.081799,138316,44860,134602,317778
2017-11-06,BYX Equities (Y),203584208,58372490,98152942,360109640,5487157376.810598,2457590208.732093,3335583939.025095,11280331524.567786,1682952,267906,890015,2840873
2017-11-06,BZX Equities (Z),193988495,73024291,109172061,376184847,6771345726.120884,3903431513.311595,5102638836.539914,15777416075.972393,1555972,306714,932086,2794772
2017-11-03,NYSE American (A),3732456,12299313,2765897,18797666,146948570.431100,190360364.748900,135060743.940500,472369679.120500,38815,39592,28222,106629
2017-11-03,NASDAQ BX (B),128763388,28276510,73996748,231036646,4826949301.924183,1431969683.633499,3417421171.253404,9676340156.811086,1245420,145175,728675,2119270
2017-11-03,NYSE (DN),93565586,26975455,85898356,206439397,3013676061.480997,854511789.566500,3492256266.390114,7360444117.437611,213412,68698,270036,552146
2017-11-03,NASDAQ (DQ),1181221455,334362702,815516398,2331100555,39054871950.992323,18705102470.683969,37435212557.895896,95195186979.572188,4046165,704997,2690962,7442124
2017-11-03,EDGA Equities (J),53285757,22087045,28362390,103735192,1620556061.306500,1133478347.188000,1273143376.556798,4027177785.051298,437520,100863,233140,771523
2017-11-03,EDGX Equities (K),190548643,60570910,181753676,432873229,6905884572.340195,3213951725.639012,8294733256.159279,18414569554.138486,1244083,242726,1111845,2598654
2017-11-03,CHX (M),16170572,14788584,8899385,39858541,691684557.212500,1366763649.252400,962062423.942000,3020510630.406900,2175,621,1227,4023
2017-11-03,NYSE (N),812900695,0,0,812900695,30590536033.791438,0.000000,0.000000,30590536033.791438,2657008,0,0,2657008
2017-11-03,NYSE Arca (P),225443826,226227438,161478735,613149999,8884806233.003598,12885184378.953467,8499698525.199737,30269689137.156802,1621493,641341,1186345,3449179
2017-11-03,NASDAQ (Q),331797291,94580225,551894224,978271740,14303270323.374780,6216673356.903086,30375315969.794209,50895259650.072075,2839147,422891,3555481,6817519
2017-11-03,IEX (V),102790936,16084541,59294700,178170177,3884310955.445296,835918604.537200,3231910301.644596,7952139861.627092,596109,68422,356846,1021377
2017-11-03,NASDAQ PSX (X),16500296,12055284,16449525,45005105,594015643.347400,744428011.505500,854976363.509501,2193420018.362401,143777,49439,138839,332055
2017-11-03,BYX Equities (Y),211300123,58649783,106659283,376609189,5921660538.032722,2605521075.329502,3905820437.088894,12433002050.451118,1731709,283307,951427,2966443
2017-11-03,BZX Equities (Z),200695556,73315875,110920650,384932081,7032013510.635610,4394490523.222796,5745009679.833917,17171513713.692323,1551701,327690,927536,2806927
2017-11-02,NYSE American (A),4356678,12581887,3058136,19996701,191856988.856800,162181708.507400,151063277.860100,505101975.224300,56761,39999,32490,129250
2017-11-02,NASDAQ BX (B),141194625,30570105,77075805,248840535,5472441899.184408,1686163320.541101,3421920135.438697,10580525355.164206,1360816,163023,762399,2286238
2017-11-02,NYSE (DN),105621760,31483844,84222816,221328420,3808461779.477223,986920553.440097,3341749915.355998,8137132248.273318,234308,69129,252644,556081
2017-11-02,NASDAQ (DQ),1318198791,416576431,827213329,2561988551,48232541923.734992,22125981691.853380,37567332236.442466,107925855852.030838,4521827,793781,2742915,8058523
2017-11-02,EDGA Equities (J),60929070,22971460,30194446,114094976,2020261277.119100,1394381222.808802,1354369499.203302,4769011999.131204,525959,112233,256675,894867
2017-11-02,EDGX Equities (K),225997958,69535198,180997767,476530923,8915041541.342206,3819863542.695002,8809059343.498929,21543964427.536137,1551176,283643,1186234,3021053
2017-11-02,CHX (M),17148509,13101371,9159442,39409322,818232535.751400,926469276.926400,1036733508.769600,2781435321.447400,2395,588,1660,4643
2017-11-02,NYSE (N),911073187,0,0,911073187,35774896275.339952,0.000000,0.000000,35774896275.339952,3163809,0,0,3163809
2017-11-02,NYSE Arca (P),266414721,236134794,173345952,675895467,11809248189.052795,13278807184.274577,8818395059.966514,33906450433.293886,2011199,715126,1288905,4015230
2017-11-02,NASDAQ (Q),394813802,106709423,575925167,1077448392,18198751566.934437,6976691973.597504,31159789879.971069,56335233420.503010,3468613,495782,3900477,7864872
2017-11-02,IEX (V),117183105,18316820,62154185,197654110,4859354385.470506,1020836161.208100,3168073397.771598,9048263944.450204,678779,73257,383837,1135873
2017-11-02,NASDAQ PSX (X),19337492,14222718,16438032,49998242,744558813.776000,948215199.809600,781486972.341101,2474260985.926701,167192,60749,134429,362370
2017-11-02,BYX Equities (Y),233464776,64086931,115552742,413104449,6846690654.611368,3105998285.378293,4166149479.169885,14118838419.159546,1951187,322007,1037767,3310961
2017-11-02,BZX Equities (Z),234412328,89074600,126970896,450457824,8870862057.694138,5778729036.560004,6214438360.111037,20864029454.365179,1882868,415888,1037938,3336694
2017-11-01,NYSE American (A),4362015,13756130,2690998,20809143,195174873.265000,148056789.446600,145370637.044100,488602299.755700,64033,41047,32389,137469
2017-11-01,NASDAQ BX (B),139452485,32752758,74303215,246508458,5245931955.699330,1676436329.753199,3486706934.283803,10409075219.736332,1357003,166622,756121,2279746
2017-11-01,NYSE (DN),92950382,29132928,76267323,198350633,3250493233.301912,1038487054.531998,3390769304.213904,7679749592.047814,227318,73014,238391,538723
2017-11-01,NASDAQ (DQ),1242830858,363540642,746426715,2352798215,43656173300.142460,19053982075.434245,34622711972.929310,97332867348.506015,4292923,801714,2529219,7623856
2017-11-01,EDGA Equities (J),57923741,24636885,25643581,108204207,1851950034.238604,1341764720.226998,1231364602.482000,4425079356.947602,495500,118949,230289,844738
2017-11-01,EDGX Equities (K),212795524,67995010,170366001,451156535,8003349695.961994,3630827683.127996,8444732748.961806,20078910128.051796,1455958,281908,1112624,2850490
2017-11-01,CHX (M),14327712,9586661,7847616,31761989,576463783.352000,1227669144.240000,833543139.653600,2637676067.245600,2239,3680,2268,8187
2017-11-01,NYSE (N),873779546,0,0,873779546,33058388289.087635,0.000000,0.000000,33058388289.087635,2988900,0,0,2988900
2017-11-01,NYSE Arca (P),252345142,245435079,151830914,649611135,10581447286.260181,13852653538.880093,8495828937.957581,32929929763.097855,1908429,741637,1172235,3822301
2017-11-01,NASDAQ (Q),369071495,110821147,533111405,1013004047,16479454218.517531,7471052808.840140,30975569061.817145,54926076089.174816,3281435,506701,3693381,7481517
2017-11-01,IEX (V),111817390,15545924,53513784,180877098,4465288550.111800,887251677.615600,2908992929.421806,8261533157.149206,656725,68375,339796,1064896
2017-11-01,NASDAQ PSX (X),17859064,13681130,15060970,46601164,698684918.452500,856253056.332399,804145472.050100,2359083446.834999,160836,57576,130925,349337
2017-11-01,BYX Equities (Y),230795397,68545864,104409979,403751240,6568296810.098098,3186156127.319697,3982711018.427582,13737163955.845377,1949902,320811,990478,3261191
2017-11-01,BZX Equities (Z),220891172,85295917,112764302,418951391,8159647258.050269,5234285112.855390,5856897788.490008,19250830159.395667,1786972,391801,972572,3151345
2017-10-31,NYSE American (A),3954401,14410849,2570516,20935766,172211576.508600,143535391.001500,140542354.728800,456289322.238900,49438,38652,28785,116875
2017-10-31,NASDAQ BX (B),134177096,28216124,70841460,233234680,5345284837.339961,1441680399.413104,3358018139.348983,10144983376.102048,1366790,140855,734162,2241807
2017-10-31,NYSE (DN),87617388,26555272,73730551,187903211,3070061882.165999,795610222.981500,3209408188.861116,7075080294.008615,203339,65079,206630,475048
2017-10-31,NASDAQ (DQ),1304080431,380783781,748268286,2433132498,44341753142.418339,20909671984.996380,33834483574.729683,99085908702.144402,4213842,730847,2529139,7473828
2017-10-31,EDGA Equities (J),54196571,21675313,24648430,100520314,1825079329.854596,1182401167.053599,1154129922.826900,4161610419.735095,468180,98717,220321,787218
2017-10-31,EDGX Equities (K),193436872,59394265,158209077,411040214,7329783249.090807,2900174009.524697,7370534012.063266,17600491270.678770,1289125,224952,997721,2511798
2017-10-31,CHX (M),13227184,12674986,9746144,35648314,652179775.766500,1160914760.970000,809266598.261800,2622361134.998300,2195,2287,1443,5925
2017-10-31,NYSE (N),959355943,0,0,959355943,38349449549.653154,0.000000,0.000000,38349449549.653154,2774693,0,0,2774693
2017-10-31,NYSE Arca (P),223439618,228093516,143001109,594534243,9285007047.834845,13057095521.609686,7311044290.961566,29653146860.406097,1661134,594015,1072824,3327973
2017-10-31,NASDAQ (Q),323691737,91492745,542086940,957271422,14622661972.118659,6071016684.038599,29977785918.408420,50671464574.565678,2857280,374712,3298317,6530309
2017-10-31,IEX (V),106284823,15940739,55323715,177549277,4309903292.711600,893426301.001101,2933615917.286796,8136945510.999497,628154,66807,340648,1035609
2017-10-31,NASDAQ PSX (X),16892665,11095742,14976994,42965401,662218535.473502,719614040.764100,811298363.017900,2193130939.255502,146625,44409,125565,316599
2017-10-31,BYX Equities (Y),222882193,59543853,103742293,386168339,6704433407.847983,2859046631.506998,3931054218.607633,13494534257.962614,1908544,279205,977679,3165428
2017-10-31,BZX Equities (Z),201183731,74413194,107081861,382678786,7362546410.769380,4387459074.625207,5321661370.223162,17071666855.617749,1572068,307358,890123,2769549
2017-10-30,NYSE American (A),3464224,13659317,2652233,19775774,145199219.475200,159108359.794900,157803166.200000,462110745.470100,39629,40360,28171,108160
2017-10-30,NASDAQ BX (B),138336601,28877631,68352305,235566537,5300582616.631481,1489286553.115201,3379480986.678516,10169350156.425198,1340306,150299,709829,2200434
2017-10-30,NYSE (DN),90466457,29420019,81067218,200953694,3205316814.853519,889180952.205199,3719060860.476016,7813558627.534734,212848,75190,241833,529871
2017-10-30,NASDAQ (DQ),1190341319,318933769,732485562,2241760650,41410042735.381515,17329174152.423818,35594194678.495995,94333411566.301328,3952339,712686,2358534,7023559
2017-10-30,EDGA Equities (J),57307700,22485820,28097321,107890841,1837213361.397198,1284901939.514302,1354172607.024202,4476287907.935702,484584,111601,236196,832381
2017-10-30,EDGX Equities (K),187902002,63276368,162015128,413193498,7066733672.255024,3310248278.612602,7699545160.493084,18076527111.360710,1256265,256277,1007190,2519732
2017-10-30,CHX (M),8497636,6751099,10013607,25262342,397715658.790500,635792396.259500,1042168399.628500,2075676454.678500,2604,3000,1737,7341
2017-10-30,NYSE (N),870733452,0,0,870733452,33993064339.077056,0.000000,0.000000,33993064339.077056,2796842,0,0,2796842
2017-10-30,NYSE Arca (P),221683916,232015629,145697821,599397366,9359251154.899474,13510615634.878684,8167104082.551798,31036970872.329956,1664309,673501,1099774,3437584
2017-10-30,NASDAQ (Q),334393354,96221645,510907614,941522613,14808470734.426503,6424027428.762382,30144591052.296949,51377089215.485834,2915164,443648,3389639,6748451
2017-10-30,IEX (V),102668397,14854682,46833052,164356131,4120624571.950615,841192058.251302,2725391547.566904,7687208177.768821,599719,66529,309904,976152
2017-10-30,NASDAQ PSX (X),17109730,11969871,15908538,44988139,643817839.286299,771826911.384800,930819951.853301,2346464702.524400,148923,52021,130794,331738
2017-10-30,BYX Equities (Y),228984234,61707459,103615587,394307280,6505819621.310558,2854403838.693695,3981673360.451182,13341896820.455435,1872515,295574,951043,3119132
2017-10-30,BZX Equities (Z),208343533,79815923,108274046,396433502,7485448653.584987,4799400129.898289,5723713875.203708,18008562658.686984,1617077,348677,899600,2865354
2017-10-27,NYSE American (A),3636975,14384286,2578181,20599442,148704363.620000,174332040.051900,162335922.039800,485372325.711700,42228,38105,27579,107912
2017-10-27,NASDAQ BX (B),133223325,31440971,74939545,239603841,5302527628.290028,1627949339.472401,4384226350.277174,11314703318.039603,1292382,159174,763948,2215504
2017-10-27,NYSE (DN),100760801,32185011,96527564,229473376,3689770275.698133,963670758.533699,4908520118.963839,9561961153.195671,225663,78875,280716,585254
2017-10-27,NASDAQ (DQ),1323474397,414838092,879660782,2617973271,46525354403.547057,23298729334.111409,50544542941.470745,120368626679.129211,4145480,771546,2777835,7694861
2017-10-27,EDGA Equities (J),57507430,24682856,31698492,113888778,1929082375.168607,1353345247.542299,1885945245.707199,5168372868.418105,489020,119542,268862,877424
2017-10-27,EDGX Equities (K),206188577,74890652,188358567,469437796,7803094109.041067,3794790031.403395,11273963109.684934,22871847250.129396,1330231,284056,1203903,2818190
2017-10-27,CHX (M),12487880,14686327,5901127,33075334,658249250.464800,1866534812.152300,744025750.699000,3268809813.316100,2418,4548,1846,8812
2017-10-27,NYSE (N),892643939,0,0,892643939,35074139840.285420,0.000000,0.000000,35074139840.285420,2854252,0,0,2854252
2017-10-27,NYSE Arca (P),229541535,282315054,180793467,692650056,9751633622.454957,16619330700.312998,11723593618.096208,38094557940.864163,1707396,737446,1311496,3756338
2017-10-27,NASDAQ (Q),356327334,122789375,608703683,1087820392,15992095073.250009,7981903219.317082,42749727325.212745,66723725617.779836,3022114,498225,3953342,7473681
2017-10-27,IEX (V),115019682,16927492,72467185,204414359,5013397629.597578,978571614.153699,4780908221.568893,10772877465.320170,632360,75083,395487,1102930
2017-10-27,NASDAQ PSX (X),18004712,14700726,20650440,53355878,718964916.006898,958409643.354099,1285406119.153899,2962780678.514896,156916,60108,155298,372322
2017-10-27,BYX Equities (Y),223394712,69503759,112683002,405581473,6339793492.020881,3111646390.891402,4769161677.037128,14220601559.949411,1780484,318383,985849,3084716
2017-10-27,BZX Equities (Z),223898351,98851714,139560267,462310332,8253665115.626894,5963710007.983797,8922226952.502871,23139602076.113562,1718133,399484,1127968,3245585
2017-10-26,NYSE American (A),3579075,11761743,2256254,17597072,149425592.535000,146995510.156200,112105736.552800,408526839.244000,37170,35860,23153,96183
2017-10-26,NASDAQ BX (B),130281077,30961593,67365181,228607851,5313486047.997986,1536675673.375901,3237173584.356686,10087335305.730573,1243917,157031,679655,2080603
2017-10-26,NYSE (DN),103165032,26421470,84520250,214106752,3742719544.612219,836671176.266896,3253299670.710298,7832690391.589413,231652,72068,247056,550776
2017-10-26,NASDAQ (DQ),1332783472,380301760,790279826,2503365058,48361694607.025069,21175325313.909561,35614877347.553010,105151897268.487640,4245148,747181,2484846,7477175
2017-10-26,EDGA Equities (J),57117193,23409011,26252184,106778388,1966584728.276906,1255116128.293400,1222150227.079404,4443851083.649710,470431,109723,217047,797201
2017-10-26,EDGX Equities (K),206540259,70652117,171834250,449026626,8010988385.108736,3891552848.715093,8134915743.590499,20037456977.414328,1336204,289950,1027361,2653515
2017-10-26,CHX (M),16928967,12935992,8677774,38542733,1026796241.126000,1457393556.060000,787450973.178100,3271640770.364100,2449,3018,1746,7213
2017-10-26,NYSE (N),876926532,0,0,876926532,34518013773.709507,0.000000,0.000000,34518013773.709507,2809324,0,0,2809324
2017-10-26,NYSE Arca (P),237733360,262657948,159343266,659734574,10498072303.208820,14799711034.854169,9047653127.811335,34345436465.874324,1736694,685185,1124113,3545992
2017-10-26,NASDAQ (Q),362806787,106003956,531120556,999931299,16506176635.931777,6601296441.406603,30208374974.691498,53315848052.029878,3046476,451890,3379624,6877990
2017-10-26,IEX (V),104952001,16826475,52270170,174048646,4594107307.706278,879522384.129399,3015268268.100204,8488897959.935881,604194,68994,328897,1002085
2017-10-26,NASDAQ PSX (X),17622765,12730844,15435527,45789136,723317549.745100,826480955.541500,857191775.542800,2406990280.829400,151265,51581,127729,330575
2017-10-26,BYX Equities (Y),217496086,63699040,102948129,384143255,6404624402.884242,2956916007.889804,3794241601.220091,13155782011.994137,1748052,306230,909923,2964205
2017-10-26,BZX Equities (Z),223819042,86988163,113342267,424149472,8423188088.655007,5193394256.345997,5701592554.430815,19318174899.431819,1703705,384446,924930,3013081
2017-10-25,NYSE American (A),3486986,15190597,2576279,21253862,154792753.188800,199319501.633100,127093322.870500,481205577.692400,39254,43456,25550,108260
2017-10-25,NASDAQ BX (B),131289140,35323891,67222498,233835529,5398329347.884004,1889537132.598701,2989400194.399184,10277266674.881889,1315918,174112,696111,2186141
2017-10-25,NYSE (DN),100187802,36532498,99604915,236325215,3905744366.427242,1233852735.971802,3210195913.607830,8349793016.006874,234467,89834,271809,596110
2017-10-25,NASDAQ (DQ),1315870383,440227915,820854562,2576952860,49657955207.805856,25704150392.482938,33436915446.646371,108799021046.935165,4249560,932716,2471335,7653611
2017-10-25,EDGA Equities (J),54111716,28827318,29243494,112182528,1912530203.873800,1681695261.266799,1268904943.884799,4863130409.025398,475250,144840,235357,855447
2017-10-25,EDGX Equities (K),200127039,83807115,189234183,473168337,8055622573.485915,4676418237.609104,7127369371.595965,19859410182.690984,1372363,359467,1026828,2758658
2017-10-25,CHX (M),12337996,9131240,10148829,31618065,531121594.705100,1140159781.100000,987886926.009300,2659168301.814400,1694,1988,1171,4853
2017-10-25,NYSE (N),910009873,0,0,910009873,37067591620.833013,0.000000,0.000000,37067591620.833013,2866660,0,0,2866660
2017-10-25,NYSE Arca (P),226796305,304531256,156303163,687630724,10511138122.509659,18441627502.710770,7307632732.281943,36260398357.502372,1713046,945184,1089471,3747701
2017-10-25,NASDAQ (Q),358443191,133415438,538694902,1030553531,17496926581.578856,9313787315.073977,28145556558.495453,54956270455.148286,3169003,612244,3369355,7150602
2017-10-25,IEX (V),106732446,17040082,51575430,175347958,4573980297.651803,1067016840.844710,2581912262.693608,8222909401.190121,622756,77793,321338,1021887
2017-10-25,NASDAQ PSX (X),17651702,16302409,15829592,49783703,746491444.382300,1197427960.986699,844545592.180400,2788464997.549399,153486,67608,122436,343530
2017-10-25,BYX Equities (Y),227451758,76420757,109304852,413177367,6812128219.388236,3575654436.218406,3894695669.515093,14282478325.121735,1891364,367803,953325,3212492
2017-10-25,BZX Equities (Z),220979783,114768776,115198104,450946663,8617277479.417744,7638292790.266706,5544344376.756571,21799914646.441021,1763138,517329,928191,3208658
2017-10-24,NYSE American (A),2747055,10374927,1962714,15084696,125109464.190000,135028871.822500,103786884.367800,363925220.380300,30397,33148,22056,85601
2017-10-24,NASDAQ BX (B),122454421,28592392,63762079,214808892,5128343215.044728,1399091398.002303,2807391705.278212,9334826318.325243,1223777,138224,650052,2012053
2017-10-24,NYSE (DN),90976377,26847337,84945920,202769634,3638888483.043609,862957552.864003,2831822339.800706,7333668375.708318,203828,73426,223259,500513
2017-10-24,NASDAQ (DQ),1207141156,388058599,704033113,2299232868,47360198034.571028,21859998128.616232,28895689838.024597,98115886001.211857,3876412,725929,2133226,6735567
2017-10-24,EDGA Equities (J),49854134,20361695,23946670,94162499,1787142250.097700,1169252325.852100,1007374894.414198,3963769470.363998,430194,103626,201365,735185
2017-10-24,EDGX Equities (K),173054822,62115066,153203804,388373692,7259066644.164562,3409406006.141001,5725285838.624022,16393758488.929585,1138988,249249,857116,2245353
2017-10-24,CHX (M),15488890,10264088,5778668,31531646,781791763.782600,842626487.590000,467767544.275000,2092185795.647600,1288,1069,464,2821
2017-10-24,NYSE (N),776744942,0,0,776744942,31620311265.725268,0.000000,0.000000,31620311265.725268,2408730,0,0,2408730
2017-10-24,NYSE Arca (P),199646946,212101464,126065589,537813999,9522851055.136827,12268693842.583026,5798075326.615101,27589620224.334954,1482551,593698,905610,2981859
2017-10-24,NASDAQ (Q),298921957,89723601,444887428,833532986,14660461415.795384,5751908901.737899,22625839443.684198,43038209761.217481,2594071,392612,2787990,5774673
2017-10-24,IEX (V),93757713,13890206,43500968,151148887,4110186832.055793,767079474.248000,2212324943.451107,7089591249.754900,542729,59678,268823,871230
2017-10-24,NASDAQ PSX (X),15341724,10526645,12730374,38598743,654184127.924301,728097919.969000,665128475.782699,2047410523.676000,134517,44213,105564,284294
2017-10-24,BYX Equities (Y),203911000,57121746,97192059,358224805,6301748709.327391,2606750895.996085,3473520410.534606,12382020015.858082,1698146,279775,864648,2842569
2017-10-24,BZX Equities (Z),185625954,74313661,90605867,350545482,7319442342.698374,4813832589.235802,4237775324.682098,16371050256.616274,1452362,332942,760487,2545791
2017-10-23,NYSE American (A),2857869,11818491,1865442,16541802,126611725.786200,126780034.969800,107206328.075000,360598088.831000,33299,31909,20318,85526
2017-10-23,NASDAQ BX (B),113056426,29387790,59069254,201513470,4637460172.531179,1488289161.073803,2691866586.798403,8817615920.403385,1137337,140317,613430,1891084
2017-10-23,NYSE (DN),83537341,28067926,75723726,187328993,2791319465.171917,883085019.001698,2646582995.430996,6320987479.604611,196632,74779,229027,500438
2017-10-23,NASDAQ (DQ),1104074091,333269859,699181785,2136525735,39522599209.773114,18712047349.493322,30349314218.038579,88583960777.305015,3517859,715959,2096353,6330171
2017-10-23,EDGA Equities (J),48209129,19160443,23425139,90794711,1715712783.942696,1066329978.713200,1034809152.453900,3816851915.109796,419024,96546,198928,714498
2017-10-23,EDGX Equities (K),165322491,56921774,146739149,368983414,6326299562.743874,2828502718.311899,6102084385.011996,15256886666.067769,1052315,223177,854588,2130080
2017-10-23,CHX (M),13483447,17445734,5899478,36828659,537382703.504800,847971965.220000,486442868.406300,1871797537.131100,2258,2081,1401,5740
2017-10-23,NYSE (N),757368573,0,0,757368573,30719790518.683503,0.000000,0.000000,30719790518.683503,2199273,0,0,2199273
2017-10-23,NYSE Arca (P),185969884,208754031,119724658,514448573,7919480500.626863,12392904610.331943,5959414700.516709,26271799811.475515,1342551,590477,871314,2804342
2017-10-23,NASDAQ (Q),275119973,82024604,442546119,799690696,12454667289.130488,4982851799.949896,23821315373.645063,41258834462.725447,2352946,363252,2708981,5425179
2017-10-23,IEX (V),84401423,13434809,42848698,140684930,3397191402.162798,756191271.317100,2270204506.921603,6423587180.401501,492670,61465,257312,811447
2017-10-23,NASDAQ PSX (X),14055385,8867555,13331495,36254435,552210408.009200,630623749.676700,643858539.819900,1826692697.505800,127711,39191,106456,273358
2017-10-23,BYX Equities (Y),190962646,54580964,91018659,336562269,5897487757.246692,2542167735.245491,3474208678.397594,11913864170.889777,1581392,261559,819511,2662462
2017-10-23,BZX Equities (Z),176061002,63715125,91709497,331485624,6711138918.533998,3939249568.438599,4496689716.507396,15147078203.479993,1381877,290170,763143,2435190
2017-10-20,NYSE American (A),2597876,17213333,1736764,21547973,108210499.064200,122980463.582900,82248004.750800,313438967.397900,30221,36195,17523,83939
2017-10-20,NASDAQ BX (B),109014908,26522889,57914597,193452394,4426841083.398096,1386402131.711902,2824563981.211292,8637807196.321290,1097045,127502,598958,1823505
2017-10-20,NYSE (DN),86363339,31565702,71063643,188992684,3007798267.511020,821119373.726498,2536614634.667496,6365532275.905014,195269,74206,204857,474332
2017-10-20,NASDAQ (DQ),1108612269,375322566,667903159,2151837994,39640504409.863032,25855014382.701225,30056461778.012674,95551980570.576931,3665809,721794,2131377,6518980
2017-10-20,EDGA Equities (J),46308399,19009325,23132794,88450518,1624404862.902312,1169678283.032799,1101855709.534002,3895938855.469113,400940,91557,191202,683699
2017-10-20,EDGX Equities (K),167586728,57675973,138828763,364091464,6360369080.671958,2963191858.003012,6084182421.990680,15407743360.665650,1046058,212682,817128,2075868
2017-10-20,CHX (M),22152803,15787119,7490079,45430001,883083628.785300,1541118150.245000,622372122.017600,3046573901.047900,1776,2696,1170,5642
2017-10-20,NYSE (N),900202293,0,0,900202293,39103304127.244249,0.000000,0.000000,39103304127.244249,2246784,0,0,2246784
2017-10-20,NYSE Arca (P),200742467,223235271,117837262,541815000,8429258639.388293,13170112004.213548,5957294200.766111,27556664844.367952,1388475,575882,868434,2832791
2017-10-20,NASDAQ (Q),283981223,89937449,490315053,864233725,12926607976.360651,6131196291.113125,27275542674.908653,46333346942.382429,2381761,370958,2697667,5450386
2017-10-20,IEX (V),91279665,14333292,43547191,149160148,3917689523.176898,895687020.446499,2263631005.695704,7077007549.319101,507891,61835,266729,836455
2017-10-20,NASDAQ PSX (X),14539011,10317443,11109236,35965690,564395801.698399,760542335.464200,656113114.454400,1981051251.616999,120858,42090,97728,260676
2017-10-20,BYX Equities (Y),180736324,56489982,90473474,327699780,5645257373.213179,2830605777.986194,3521669210.242407,11997532361.441780,1535166,281196,829370,2645732
2017-10-20,BZX Equities (Z),180336456,63627132,90877219,334840807,7157207560.751434,4376573834.771298,4753395150.568290,16287176546.091022,1420946,279592,770570,2471108
2017-10-19,NYSE American (A),2542348,10944684,1849306,15336338,118190941.695000,105053732.971200,98759713.877700,322004388.543900,28317,32963,19101,80381
2017-10-19,NASDAQ BX (B),106770558,26075753,57420742,190267053,4379143718.662383,1357568148.577398,2710754580.440305,8447466447.680086,1110620,125586,598782,1834988
2017-10-19,NYSE (DN),75207698,30527308,81142260,186877266,2794235163.752400,915241479.800197,2863434327.300312,6572910970.852909,180083,74720,221269,476072
2017-10-19,NASDAQ (DQ),1026534720,348489380,697901925,2072926025,40780181501.794912,17627322556.653612,30753071842.466867,89160575900.915391,3480843,725329,2176829,6383001
2017-10-19,EDGA Equities (J),43626221,19744772,23776189,87147182,1540329670.872602,1124093659.776400,1083572002.008201,3747995332.657203,385850,97884,199683,683417
2017-10-19,EDGX Equities (K),153002124,59783622,146943544,359729290,6167866771.460518,2965699803.973701,6565188850.539461,15698755425.973680,1026257,227784,868049,2122090
2017-10-19,CHX (M),13828490,13752582,6763132,34344204,610330345.757200,1289709977.540400,527082507.876700,2427122831.174300,1891,3284,1520,6695
2017-10-19,NYSE (N),706325709,0,0,706325709,29121901540.139239,0.000000,0.000000,29121901540.139239,2242748,0,0,2242748
2017-10-19,NYSE Arca (P),178780235,213666456,132755648,525202339,8036337077.409070,11857486272.371382,6713552694.599399,26607376044.379851,1345768,601353,945126,2892247
2017-10-19,NASDAQ (Q),270761669,88851993,457379285,816992947,12780414884.250715,5637563922.319508,24497063681.959604,42915042488.529827,2425200,390522,2862990,5678712
2017-10-19,IEX (V),86457562,14577633,43594920,144630115,3904431847.242613,786541347.886501,2301398658.927800,6992371854.056914,497565,55164,272030,824759
2017-10-19,NASDAQ PSX (X),13025323,10168785,12705522,35899630,525264345.858000,703036627.209800,743307740.532600,1971608713.600400,117476,40808,107177,265461
2017-10-19,BYX Equities (Y),173445875,52956653,90654415,317056943,5545171186.541665,2538015133.739004,3513548480.784779,11596734801.065448,1524163,256340,834805,2615308
2017-10-19,BZX Equities (Z),169214652,66827117,94134782,330176551,6772934748.020981,4235037222.964697,4870824235.740589,15878796206.726267,1365718,308580,789101,2463399
2017-10-18,NYSE American (A),2733532,15176106,1617178,19526816,131765097.281000,111097664.986700,84652694.882600,327515457.150300,31844,42168,18141,92153
2017-10-18,NASDAQ BX (B),108616055,21050032,56493612,186159699,4550675324.534782,1026098975.026501,2386596207.392204,7963370506.953487,1148725,108849,616161,1873735
2017-10-18,NYSE (DN),78143539,30058594,76750970,184953103,3319998795.810513,795395555.139999,2686216885.786890,6801611236.737402,181647,79730,215678,477055
2017-10-18,NASDAQ (DQ),1041298204,333886856,674066824,2049251884,40739408742.578213,15384354619.646349,27318778961.043002,83442542323.267564,3517914,688456,2115817,6322187
2017-10-18,EDGA Equities (J),40531826,19016990,22277281,81826097,1499302855.121506,946297406.441401,934427494.348500,3380027755.911407,371365,86275,191555,649195
2017-10-18,EDGX Equities (K),154216984,54140337,138353067,346710388,6513355516.601435,2269736804.628406,5626091186.394411,14409183507.624252,1041483,192028,806224,2039735
2017-10-18,CHX (M),10544849,18254655,6164872,34964376,664433843.929000,1615762717.445000,534190784.412400,2814387345.786400,1528,2279,1155,4962
2017-10-18,NYSE (N),678897819,0,0,678897819,29014814178.380652,0.000000,0.000000,29014814178.380652,2140684,0,0,2140684
2017-10-18,NYSE Arca (P),175980001,188271646,120920695,485172342,8365705871.705668,9945522459.547342,5754810137.491714,24066038468.744724,1351396,502063,884104,2737563
2017-10-18,NASDAQ (Q),270455639,76708602,410427508,757591749,13565907860.894467,4320184075.906899,21063321156.686086,38949413093.487452,2412078,319885,2639240,5371203
2017-10-18,IEX (V),80796616,12322396,44844137,137963149,3783944529.396423,609539525.666200,2466932165.623199,6860416220.685822,488675,52337,262279,803291
2017-10-18,NASDAQ PSX (X),12929879,9105281,11575635,33610795,556415110.448799,577199135.396900,634265910.212100,1767880156.057799,119587,35445,100061,255093
2017-10-18,BYX Equities (Y),174315418,46032359,89344717,309692494,5522224341.238313,2031277339.751393,3195533413.833696,10749035094.823402,1545728,221840,843751,2611319
2017-10-18,BZX Equities (Z),169865969,54019274,85231817,309117060,6969829654.537273,3232414820.918793,4149109567.069892,14351354042.525958,1382794,247468,738730,2368992
2017-10-17,NYSE American (A),2540581,21447076,1671888,25659545,119795222.710000,179739991.313700,86759736.441100,386294950.464800,29138,53997,18191,101326
2017-10-17,NASDAQ BX (B),108514251,23588156,53949803,186052210,4541732530.923643,1096649388.936901,2372435726.616194,8010817646.476738,1108346,116040,583806,1808192
2017-10-17,NYSE (DN),71662672,33895590,74373491,179931753,2780200729.758008,797036591.937500,2618117542.670309,6195354864.365817,176787,91080,220959,488826
2017-10-17,NASDAQ (DQ),985186888,362202960,638743651,1986133499,38639284609.484479,14089811136.938527,26825000565.115446,79554096311.538452,3323711,821191,2019032,6163934
2017-10-17,EDGA Equities (J),42106947,19547024,20625313,82279284,1542439678.437198,960972662.812200,883832765.754000,3387245107.003398,384046,95722,185390,665158
2017-10-17,EDGX Equities (K),144667814,63456127,132882508,341006449,5978911901.810018,2387920790.646595,5490568309.122292,13857401001.578905,956701,226546,770918,1954165
2017-10-17,CHX (M),11648464,7011342,8950842,27610648,627275140.619600,758688729.640000,466878447.707900,1852842317.967500,1786,1861,1094,4741
2017-10-17,NYSE (N),691479764,0,0,691479764,28461869555.440675,0.000000,0.000000,28461869555.440675,2079041,0,0,2079041
2017-10-17,NYSE Arca (P),167540708,196795735,110340262,474676705,7885142793.815162,9674075633.619728,5235483353.328496,22794701780.763386,1253647,547998,828900,2630545
2017-10-17,NASDAQ (Q),253674711,81718407,395050126,730443244,12435267268.460111,4177241159.627710,20373274748.957961,36985783177.045782,2258691,338186,2475694,5072571
2017-10-17,IEX (V),76757124,14004746,39644699,130406569,3364079580.662413,688644859.009201,2073024228.389304,6125748668.060918,473339,60935,252505,786779
2017-10-17,NASDAQ PSX (X),13736211,8796700,11212599,33745510,589936204.032700,522169195.568000,617257766.664300,1729363166.265000,124998,36381,100253,261632
2017-10-17,BYX Equities (Y),168887212,51417444,83144313,303448969,5410342535.178875,2218028323.034005,3064878215.767493,10693249073.980373,1472826,247213,790506,2510545
2017-10-17,BZX Equities (Z),163486831,64446324,82576907,310510062,6415543158.232699,3679212572.410810,3872214543.284302,13966970273.927811,1280443,287997,706315,2274755
2017-10-16,NYSE American (A),2341220,19127169,1615771,23084160,100606283.029800,147724918.222300,78227923.161200,326559124.413300,29835,48761,18828,97424
2017-10-16,NASDAQ BX (B),105911856,23653310,54573061,184138227,4196849837.995986,1153571511.044401,2338647081.563704,7689068430.604091,1083981,124749,585439,1794169
2017-10-16,NYSE (DN),77635767,31590165,69475005,178700937,2830251708.722893,833999284.456998,2699571990.648701,6363822983.828592,186826,82804,220625,490255
2017-10-16,NASDAQ (DQ),977677262,345486463,624408403,1947572128,35729109841.226014,16279484270.671462,27504931186.126866,79513525298.024342,3333960,743029,2022057,6099046
2017-10-16,EDGA Equities (J),42134732,20609370,19762596,82506698,1450205477.205097,1047027987.638301,890183188.767402,3387416653.610800,375125,98090,183537,656752
2017-10-16,EDGX Equities (K),149321486,61345590,130914163,341581239,5512807876.049532,2582598180.685505,5809516207.759693,13904922264.494730,949651,222328,774987,1946966
2017-10-16,CHX (M),8067631,11153614,6587657,25808902,337248864.433400,791498548.810700,439220413.504900,1567967826.749000,1871,1982,1461,5314
2017-10-16,NYSE (N),695005335,0,0,695005335,27906869139.891525,0.000000,0.000000,27906869139.891525,2111925,0,0,2111925
2017-10-16,NYSE Arca (P),169143852,208872368,107760899,485777119,7274864161.108797,10497598121.399401,5626235883.928300,23398698166.436498,1236461,532073,821502,2590036
2017-10-16,NASDAQ (Q),259590237,84940979,396533368,741064584,11942660668.241214,4576199205.645675,21196544478.890747,37715404352.777636,2283801,349299,2533231,5166331
2017-10-16,IEX (V),74420945,13306162,40109444,127836551,3166513018.670702,698122920.618200,2085915147.838704,5950551087.127606,444219,58779,246884,749882
2017-10-16,NASDAQ PSX (X),13292330,9237954,11038058,33568342,522462997.051999,565647750.772500,621750132.300800,1709860880.125299,115931,38436,98718,253085
2017-10-16,BYX Equities (Y),176636782,53004911,85409710,315051403,5398559372.695785,2385650440.644300,3162090608.389515,10946300421.729600,1519038,251622,813301,2583961
2017-10-16,BZX Equities (Z),166851333,64118660,84060637,315030630,6205171770.354058,3639578749.965597,4153261282.960494,13998011803.280149,1298209,282115,718224,2298548
2017-10-13,NYSE American (A),2607960,10795856,1840352,15244168,123292836.410000,108635929.268700,92830246.089700,324759011.768400,29622,30765,19736,80123
2017-10-13,NASDAQ BX (B),109002875,23224659,56548075,188775609,4385615394.036087,1176800601.734298,2347386981.725302,7909802977.495687,1091532,111601,590692,1793825
2017-10-13,NYSE (DN),77999142,25875078,75319544,179193764,2978367555.465794,826895181.162298,2428158041.990407,6233420778.618499,188580,66616,224231,479427
2017-10-13,NASDAQ (DQ),1058372959,308941597,679384454,2046699010,38456177310.009183,16546902679.864397,26708558154.354761,81711638144.228341,3349313,652426,2032079,6033818
2017-10-13,EDGA Equities (J),42763996,18405106,20523173,81692275,1438634331.598299,1037420478.372700,873464274.607701,3349519084.578700,373448,82232,179288,634968
2017-10-13,EDGX Equities (K),166811889,54530036,140642029,361983954,6255501686.721599,2663719814.965300,5476816749.206710,14396038250.893609,1028727,196683,793816,2019226
2017-10-13,CHX (M),10317609,8332617,6424878,25075104,624652421.936800,668172873.769000,582241577.615900,1875066873.321700,1918,2181,1424,5523
2017-10-13,NYSE (N),768100678,0,0,768100678,31088150985.122373,0.000000,0.000000,31088150985.122373,2186855,0,0,2186855
2017-10-13,NYSE Arca (P),189983577,196350511,116510766,502844854,8232715980.313503,11344794619.840543,5519570826.663106,25097081426.817152,1318707,509930,851318,2679955
2017-10-13,NASDAQ (Q),275328096,80439150,440851718,796618964,12453164958.960129,5415263242.424001,21768932213.364699,39637360414.748829,2331269,318971,2572995,5223235
2017-10-13,IEX (V),78514953,13797318,38928418,131240689,3487122128.102120,767887456.581500,2062855577.497797,6317865162.181417,451675,54809,238089,744573
2017-10-13,NASDAQ PSX (X),14061250,9522653,11564091,35147994,563220579.488100,621596325.563100,638973598.764700,1823790503.815900,121433,37020,102077,260530
2017-10-13,BYX Equities (Y),176978020,48773060,86457133,312208213,5418823379.897600,2273387647.276703,3096121392.726694,10788332419.900997,1498215,234248,803075,2535538
2017-10-13,BZX Equities (Z),179631168,66167713,86707707,332506588,6792495170.359158,3950104010.728703,4236793631.566883,14979392812.654744,1373707,263212,731938,2368857
2017-10-12,NYSE American (A),2698321,12203760,2005610,16907691,127843513.925000,151375861.392800,96574335.881800,375793711.199600,30776,30764,21919,83459
2017-10-12,NASDAQ BX (B),108556907,21706289,64393533,194656729,4330912274.328603,1113595213.259599,2691413822.620092,8135921310.208294,1112271,112238,665831,1890340
2017-10-12,NYSE (DN),80679594,26711258,89631726,197022578,3009283241.870814,816606058.653602,2844655840.492904,6670545141.017320,189066,66621,243798,499485
2017-10-12,NASDAQ (DQ),1050805905,324137182,763255138,2138198225,37647565946.815699,17093803805.884630,27911107429.833935,82652477182.534264,3412347,647638,2205486,6265471
2017-10-12,EDGA Equities (J),45186029,17544163,27948965,90679157,1527793537.395901,964179551.141600,1086951351.149099,3578924439.686600,401009,87940,224204,713153
2017-10-12,EDGX Equities (K),165019345,53513435,164026855,382559635,6423149822.918929,2610209468.589106,6038984164.394377,15072343455.902412,1053766,204222,894519,2152507
2017-10-12,CHX (M),10856591,9635078,5059506,25551175,538873910.916200,682114536.800000,457120547.712700,1678108995.428900,2348,2303,1383,6034
2017-10-12,NYSE (N),787814941,0,0,787814941,31731129773.050396,0.000000,0.000000,31731129773.050396,2173518,0,0,2173518
2017-10-12,NYSE Arca (P),184885991,191183167,139300306,515369464,8236297266.289192,10737008244.237883,6177270811.212216,25150576321.739291,1345146,501499,962051,2808696
2017-10-12,NASDAQ (Q),268400868,74048174,505800992,848250034,12218011090.352675,4855464013.365897,24374306857.819195,41447781961.537767,2348903,313750,2771575,5434228
2017-10-12,IEX (V),80493304,12199105,46963803,139656212,3356122931.641098,683798125.023100,2191679627.574000,6231600684.238198,468588,53230,286976,808794
2017-10-12,NASDAQ PSX (X),13617900,8633934,13165296,35417130,565029123.764600,562542655.955500,675462415.902000,1803034195.622100,124836,35746,112061,272643
2017-10-12,BYX Equities (Y),177418717,49765841,98956491,326141049,5395240512.445651,2316071403.689193,3328851510.336408,11040163426.471252,1498202,236646,886824,2621672
2017-10-12,BZX Equities (Z),180850900,61528695,99824358,342203953,7059635237.084198,3803748940.704193,4616556998.148902,15479941175.937293,1432566,258217,836701,2527484
2017-10-11,NYSE American (A),2255050,10570225,1869860,14695135,98326205.256600,114232914.202800,82786636.425100,295345755.884500,26843,29072,19669,75584
2017-10-11,NASDAQ BX (B),107321359,23223073,58441027,188985459,4230191682.267601,1140613409.966603,2277960928.907704,7648766021.141908,1085863,118940,588006,1792809
2017-10-11,NYSE (DN),71138570,26391087,80576847,178106504,2487676525.605713,766587050.660102,2610016809.063303,5864280385.329118,168852,68749,237425,475026
2017-10-11,NASDAQ (DQ),1017882467,342489510,718585864,2078957841,36979412193.541403,19194752782.280954,27070732633.521550,83244897609.343907,3146861,684827,2053090,5884778
2017-10-11,EDGA Equities (J),41863681,19081624,21994674,82939979,1418809360.322496,1050386823.389400,879931314.626501,3349127498.338397,384180,91431,196298,671909
2017-10-11,EDGX Equities (K),148390319,52251280,145102157,345743756,5412890372.845684,2563649677.247108,5386412282.522587,13362952332.615379,954876,202915,824638,1982429
2017-10-11,CHX (M),7013850,14378261,3708875,25100986,375884426.216400,1490507525.900000,287055727.623000,2153447679.739400,2222,2242,1255,5719
2017-10-11,NYSE (N),742517699,0,0,742517699,29270459686.832252,0.000000,0.000000,29270459686.832252,2044402,0,0,2044402
2017-10-11,NYSE Arca (P),170038803,192872946,124395703,487307452,7196345937.973396,10106125586.127230,5403604293.025602,22706075817.126228,1228178,503925,884849,2616952
2017-10-11,NASDAQ (Q),259726532,74974251,449342293,784043076,11574382526.468631,4470998454.746495,21889805238.128712,37935186219.343838,2276177,320181,2588260,5184618
2017-10-11,IEX (V),75523451,13809279,41283894,130616624,2989228669.710395,710032028.325901,2010289805.352000,5709550503.388296,452177,58041,256756,766974
2017-10-11,NASDAQ PSX (X),13385572,9109563,11744708,34239843,548262847.907800,584472713.695800,613669723.149200,1746405284.752800,122696,38112,107315,268123
2017-10-11,BYX Equities (Y),168193045,51725623,90330347,310249015,5173006287.874043,2458233700.714302,3060623447.914190,10691863436.502535,1458374,248402,814974,2521750
2017-10-11,BZX Equities (Z),166073765,62198061,90489810,318761636,6210969472.370836,3610546319.279497,3978549445.837801,13800065237.488134,1325469,272926,756581,2354976
2017-10-10,NYSE American (A),2260742,10106406,1890647,14257795,92063831.211000,104655016.209200,84759452.252100,281478299.672300,24430,26295,19908,70633
2017-10-10,NASDAQ BX (B),104019015,25094721,57848061,186961797,4183284295.802973,1279717449.463402,2413537259.205795,7876539004.472170,1073792,123396,607698,1804886
2017-10-10,NYSE (DN),67947285,27315323,82231350,177493958,2453116543.885001,849546631.316701,2713468694.328599,6016131869.530301,169191,66429,235123,470743
2017-10-10,NASDAQ (DQ),1023989764,352285833,692821346,2069096943,35950019877.504274,19089821745.402117,27226348628.008402,82266190250.914793,3154764,674710,2082859,5912333
2017-10-10,EDGA Equities (J),42155146,20045738,22311648,84512532,1391151377.660102,1050016146.009001,879940389.432898,3321107913.102001,383294,90915,198819,673028
2017-10-10,EDGX Equities (K),149329574,56971314,152008484,358309372,5820198030.145707,2785653162.963098,5876242274.570520,14482093467.679325,1067770,219066,898790,2185626
2017-10-10,CHX (M),7214520,16336956,7813822,31365298,338743877.571900,1401571972.857700,505521016.983200,2245836867.412800,2039,2178,1514,5731
2017-10-10,NYSE (N),708878315,0,0,708878315,27279657406.523533,0.000000,0.000000,27279657406.523533,2085631,0,0,2085631
2017-10-10,NYSE Arca (P),170275556,207187037,122840797,500303390,7372914645.201199,11121583762.992431,5902531185.736379,24397029593.930009,1240033,542783,889720,2672536
2017-10-10,NASDAQ (Q),254577058,80817930,426260603,761655591,11798289468.254094,4888640157.773821,21457737865.075190,38144667491.103105,2270589,345269,2683803,5299661
2017-10-10,IEX (V),75422737,13512500,39654301,128589538,3161328397.616296,735216120.473301,1793182377.776999,5689726895.866596,444347,55938,247672,747957
2017-10-10,NASDAQ PSX (X),13364802,9777764,12398708,35541274,538024851.708400,619257631.183100,685919888.691901,1843202371.583401,120400,40614,110605,271619
2017-10-10,BYX Equities (Y),177402553,55014609,92182545,324599707,5422489078.538251,2561955877.264901,3184504406.178390,11168949361.981542,1545260,256712,870335,2672307
2017-10-10,BZX Equities (Z),165775131,64827438,92219006,322821575,6287922801.789075,3945426694.997998,4178077377.748585,14411426874.535658,1328306,287740,782960,2399006
2017-10-09,NYSE American (A),2111688,9990885,1585514,13688087,89681934.438200,80867133.814300,70536080.917900,241085149.170400,22942,25411,16764,65117
2017-10-09,NASDAQ BX (B),88130121,18050162,46920082,153100365,3344971647.065803,893489283.774102,1986586053.893610,6225046984.733515,905922,96857,520422,1523201
2017-10-09,NYSE (DN),66325694,26769899,75329165,168424758,2208675850.021506,742371306.754401,2518307946.973989,5469355103.749896,163585,68114,226071,457770
2017-10-09,NASDAQ (DQ),849574579,239985591,566495089,1656055259,30275004015.037763,11563418843.694017,22911884916.740587,64750307775.472367,2753144,544433,1802362,5099939
2017-10-09,EDGA Equities (J),35150098,13682031,17159003,65991132,1125409837.324103,747786830.719600,675362420.763001,2548559088.806704,316220,67341,158786,542347
2017-10-09,EDGX Equities (K),126603749,43252062,127449182,297304993,4740108655.417390,2091019637.285901,4975357442.426581,11806485735.129872,818009,168523,734450,1720982
2017-10-09,CHX (M),7735064,4504160,2793543,15032767,349199015.860800,453621493.900000,334345538.480200,1137166048.241000,1668,2043,885,4596
2017-10-09,NYSE (N),620162512,0,0,620162512,24515515951.388942,0.000000,0.000000,24515515951.388942,1814147,0,0,1814147
2017-10-09,NYSE Arca (P),139924240,154585808,97366899,391876947,5946143860.436937,8290647548.415869,4651480834.552300,18888272243.405106,1020305,420725,731037,2172067
2017-10-09,NASDAQ (Q),209783722,61037314,377467499,648288535,9239780585.100355,3532759119.676799,19038913504.125523,31811453208.902677,1884166,266849,2340995,4492010
2017-10-09,IEX (V),61952269,8939982,30952804,101845055,2434628563.411910,450062370.702700,1551097617.371502,4435788551.486112,370459,42117,206777,619353
2017-10-09,NASDAQ PSX (X),10246983,6739356,9730201,26716540,390945707.486600,443404059.238700,533746513.741600,1368096280.466900,91236,29477,89596,210309
2017-10-09,BYX Equities (Y),134915753,35908679,69485801,240310233,4109412656.601468,1682170354.678902,2456364359.009291,8247947370.289661,1202039,183627,680500,2066166
2017-10-09,BZX Equities (Z),134327815,45102184,71426208,250856207,5008579920.286397,2737265721.033802,3337932659.803114,11083778301.123313,1085277,207694,627369,1920340
2017-10-06,NYSE American (A),2344216,16825490,1704584,20874290,98965923.485000,145257252.307400,82121021.775200,326344197.567600,26922,36645,17399,80966
2017-10-06,NASDAQ BX (B),107182365,26513153,54126180,187821698,4065965228.738432,1334001459.146195,2285992278.776590,7685958966.661217,1074460,131477,578836,1784773
2017-10-06,NYSE (DN),67432747,31733811,82828262,181994820,2315441613.810515,873007322.689698,2542665729.547885,5731114666.048098,166167,78100,240272,484539
2017-10-06,NASDAQ (DQ),986381648,398167532,675731324,2060280504,35548988893.302365,24121332839.018215,27840255034.239786,87510576766.560366,3087754,794503,1968595,5850852
2017-10-06,EDGA Equities (J),41461928,22135684,20545171,84142783,1319836206.381401,1158659789.486599,884449741.967401,3362945737.835401,375473,101965,179650,657088
2017-10-06,EDGX Equities (K),144900733,70853597,145987270,361741600,5327149661.238277,3431395421.294892,5770481231.921878,14529026314.455047,947800,255865,807729,2011394
2017-10-06,CHX (M),5536041,8851025,4687073,19074139,246011626.017200,1012625591.990000,405878189.970300,1664515407.977500,1940,2088,1458,5486
2017-10-06,NYSE (N),728078318,0,0,728078318,28765855433.318318,0.000000,0.000000,28765855433.318318,2022860,0,0,2022860
2017-10-06,NYSE Arca (P),165378291,246225171,114319195,525922657,6831613343.801897,12960898333.698591,5691797913.836813,25484309591.337301,1195508,630143,833525,2659176
2017-10-06,NASDAQ (Q),242181955,97973454,436614580,776769989,10729167307.936796,6179237757.479973,22130589888.000617,39038994953.417386,2141469,389318,2530398,5061185
2017-10-06,IEX (V),73007059,17332906,35516086,125856051,2860493723.171094,837910429.715601,1819411030.395896,5517815183.282591,448988,69794,232669,751451
2017-10-06,NASDAQ PSX (X),13128496,12658515,11307017,37094028,491863581.600999,716815017.133201,643750334.750700,1852428933.484900,114511,47487,101820,263818
2017-10-06,BYX Equities (Y),167203162,62266629,84238869,313708660,5022069361.800922,2764271785.322399,3021545450.675504,10807886597.798825,1432821,283987,797242,2514050
2017-10-06,BZX Equities (Z),154054890,77030120,84573840,315658850,5751584417.523117,4573201638.870596,4334785279.562997,14659571335.956710,1251972,322157,720996,2295125
2017-10-05,NYSE American (A),2155755,15907929,1633796,19697480,89534765.386200,215008414.038900,72384743.016300,376927922.441400,23570,35216,18042,76828
2017-10-05,NASDAQ BX (B),111166681,27741256,59057681,197965618,4505650306.527598,1486118294.028602,2646806017.083304,8638574617.639504,1169502,130417,641644,1941563
2017-10-05,NYSE (DN),75711786,29694569,88622383,194028738,2822572923.436000,905028496.219800,2514977429.595897,6242578849.251697,176201,74108,249026,499335
2017-10-05,NASDAQ (DQ),1050992251,371075913,730833550,2152901714,38731355690.583971,19392986771.772119,29037906383.388566,87162248845.744656,3216824,735671,2089201,6041696
2017-10-05,EDGA Equities (J),44122213,21482515,22741580,88346308,1412193742.874398,1232081786.193301,923524138.879302,3567799667.947001,398206,95730,194867,688803
2017-10-05,EDGX Equities (K),147839428,62414641,157864438,368118507,5727458556.082689,3404027515.001501,6067604488.861000,15199090559.945190,990984,236622,868176,2095782
2017-10-05,CHX (M),15075697,11539948,9558822,36174467,1032884015.262000,1376131873.012601,517350733.334700,2926366621.609301,2275,2047,1356,5678
2017-10-05,NYSE (N),745841099,0,0,745841099,29497640146.407614,0.000000,0.000000,29497640146.407614,2161378,0,0,2161378
2017-10-05,NYSE Arca (P),171082112,230172725,128358476,529613313,7431284715.900008,13324135984.479704,5963771230.916607,26719191931.296319,1286439,581791,915561,2783791
2017-10-05,NASDAQ (Q),259883048,85189829,452535006,797607883,11869587672.396916,5776613258.031991,22991293032.792083,40637493963.220990,2353240,352219,2737002,5442461
2017-10-05,IEX (V),76772494,18235752,40713919,135722165,3055975646.776299,1020330540.645199,2048398563.856205,6124704751.277703,469844,66434,253889,790167
2017-10-05,NASDAQ PSX (X),13991372,10517649,12573323,37082344,549176102.606700,709461282.625600,708561940.069500,1967199325.301800,131837,43829,116048,291714
2017-10-05,BYX Equities (Y),178658039,59010852,91710819,329379710,5491456486.644015,2766064411.235206,3301080066.281406,11558600964.160627,1558305,261210,858559,2678074
2017-10-05,BZX Equities (Z),166441068,68696579,92774223,327911870,6279822397.746475,4481518916.555188,4582652680.716298,15343993995.017961,1360253,291406,793384,2445043
2017-10-04,NYSE American (A),2170692,10743685,1896158,14810535,89306823.270000,123767226.102000,89322764.930800,302396814.302800,30166,31978,21561,83705
2017-10-04,NASDAQ BX (B),107431859,23867119,60091578,191390556,4315144525.508319,1234236027.325598,2417609746.113387,7966990298.947304,1148520,125622,664679,1938821
2017-10-04,NYSE (DN),75496867,26836344,84998401,187331612,2630479009.575915,862700034.902501,2202413163.055696,5695592207.534112,175118,66195,233194,474507
2017-10-04,NASDAQ (DQ),1019009623,346439198,764439226,2129888047,35321235777.063310,19976681547.723540,27365083446.350421,82663000771.137271,3280670,700057,2160170,6140897
2017-10-04,EDGA Equities (J),43896049,20186413,22919154,87001616,1424053052.118403,1044563604.660701,871695406.314601,3340312063.093705,399760,96159,198064,693983
2017-10-04,EDGX Equities (K),156886332,55246640,167207399,379340371,6123352271.630207,2765159090.660298,5738870412.453598,14627381774.744103,1061745,210938,894988,2167671
2017-10-04,CHX (M),16706933,14474115,3781272,34962320,1144067461.798200,1352025015.659999,315723590.454100,2811816067.912299,2348,2433,1288,6069
2017-10-04,NYSE (N),735780367,0,0,735780367,29071468005.839764,0.000000,0.000000,29071468005.839764,2152594,0,0,2152594
2017-10-04,NYSE Arca (P),177963116,201507214,135050482,514520812,7464383958.289843,11271318855.547603,5705470119.746098,24441172933.583544,1311894,540275,949745,2801914
2017-10-04,NASDAQ (Q),260231272,79212014,459545481,798988767,11672051091.669834,5239305559.010074,21266884523.303762,38178241173.983670,2346229,330462,2719945,5396636
2017-10-04,IEX (V),73815569,15524427,43877453,133217449,3095345789.112202,770023671.711201,2053794913.152099,5919164373.975502,459812,59030,267308,786150
2017-10-04,NASDAQ PSX (X),12858667,10755858,12931382,36545907,527085689.187000,680998678.808800,681555546.274000,1889639914.269800,123508,43129,114690,281327
2017-10-04,BYX Equities (Y),173965899,51893217,89128282,314987398,5272924367.847964,2423275025.749690,3118432073.905693,10814631467.503347,1512630,251770,831491,2595891
2017-10-04,BZX Equities (Z),164563399,63105948,95611365,323280712,6270620915.661925,3795966480.226892,4247383939.398096,14313971335.286913,1348140,272604,793634,2414378
2017-10-03,NYSE American (A),2182980,11065408,1978101,15226489,94864425.510000,127046653.099600,84621720.585400,306532799.195000,25000,32472,20178,77650
2017-10-03,NASDAQ BX (B),110852254,24517285,61964781,197334320,4377783588.476827,1290285210.072491,2530767538.799793,8198836337.349111,1194980,126986,684020,2005986
2017-10-03,NYSE (DN),74795761,26414687,84453714,185664162,2728375479.610598,884280047.379198,2462479794.888897,6075135321.878693,171926,71717,240645,484288
2017-10-03,NASDAQ (DQ),1049406322,369273666,763589975,2182269963,36808229267.654554,23311818886.875368,26567723650.197062,86687771804.726984,3453794,866242,2274533,6594569
2017-10-03,EDGA Equities (J),44780600,20577218,24308732,89666550,1469515426.975406,1139685827.050599,900487103.084898,3509688357.110903,417496,96214,206319,720029
2017-10-03,EDGX Equities (K),159224763,51609726,167195581,378030070,5983393054.883428,2759629259.964607,5440937199.370106,14183959514.218141,1068097,205759,888628,2162484
2017-10-03,CHX (M),13616020,10866160,5376396,29858576,712791777.340600,1325720247.656700,386647463.992600,2425159488.989900,2317,2195,1368,5880
2017-10-03,NYSE (N),724548639,0,0,724548639,27820338379.858859,0.000000,0.000000,27820338379.858859,2230416,0,0,2230416
2017-10-03,NYSE Arca (P),175256312,208312757,150287865,533856934,7490491251.405353,12169864243.185956,5743288573.328204,25403644067.919513,1351097,556185,996501,2903783
2017-10-03,NASDAQ (Q),269111414,73340809,460419880,802872103,11926573979.388199,4824168556.134084,20442296391.414293,37193038926.936576,2479654,314375,2818477,5612506
2017-10-03,IEX (V),87941579,15523227,49901229,153366035,3538824596.297435,806496491.047200,2205216587.525406,6550537674.870041,523383,64711,290818,878912
2017-10-03,NASDAQ PSX (X),13475063,10302842,14477728,38255633,530464777.202300,665861625.175300,683864298.425100,1880190700.802700,126244,41399,115779,283422
2017-10-03,BYX Equities (Y),176054906,52680724,94812234,323547864,5231802399.108924,2490842126.235804,3158041863.835831,10880686389.180559,1585949,253089,892655,2731693
2017-10-03,BZX Equities (Z),172237356,59618142,93997724,325853222,6260778264.668720,3776017076.603722,3996991433.686715,14033786774.959157,1394954,263976,792017,2450947
2017-10-02,NYSE American (A),2313462,10316355,2058685,14688502,101047046.660600,149507904.164800,103817041.274000,354371992.099400,26833,32543,22864,82240
2017-10-02,NASDAQ BX (B),115524223,30746054,64940062,211210339,4523395669.607059,1663057742.941305,2759399280.479092,8945852693.027456,1236989,150873,726075,2113937
2017-10-02,NYSE (DN),77936103,35029529,76842344,189807976,2646284360.564082,1302246249.724404,2457061266.514088,6405591876.802574,174985,83251,230842,489078
2017-10-02,NASDAQ (DQ),1108715885,473870684,756829999,2339416568,38359354039.714124,25089383106.227684,30925081987.857016,94373819133.798824,3586141,876143,2309123,6771407
2017-10-02,EDGA Equities (J),50041730,26496440,25829200,102367370,1614448760.119594,1561367258.447202,1111763495.899705,4287579514.466501,458716,121714,240039,820469
2017-10-02,EDGX Equities (K),166218401,68290575,162172928,396681904,6131369756.133641,3632045972.629298,6341695666.662599,16105111395.425538,1144600,272134,973670,2390404
2017-10-02,CHX (M),10275915,5962186,5920503,22158604,540267929.102000,524623338.440200,367770926.024600,1432662193.566800,2494,3579,1678,7751
2017-10-02,NYSE (N),753826518,0,0,753826518,29718790032.368225,0.000000,0.000000,29718790032.368225,2409239,0,0,2409239
2017-10-02,NYSE Arca (P),188112290,267933075,144816845,600862210,7946258405.947345,16051249741.081230,6766482376.496557,30763990523.525132,1473510,681159,1098772,3253441
2017-10-02,NASDAQ (Q),282562939,99421124,475480756,857464819,12589529156.396926,6438585472.181800,23616563512.058429,42644678140.637155,2682169,435315,3137074,6254558
2017-10-02,IEX (V),88335299,19117787,47939012,155392098,3496312886.144676,1071480057.741200,2318577324.199993,6886370268.085869,546240,74527,298474,919241
2017-10-02,NASDAQ PSX (X),13894072,13233805,14738240,41866117,548162919.499001,881302407.676900,825064339.387099,2254529666.563000,133584,53923,134670,322177
2017-10-02,BYX Equities (Y),184664329,63446632,100932461,349043422,5509092629.474398,3086966614.608502,3592594090.522768,12188653334.605668,1670606,298716,968722,2938044
2017-10-02,BZX Equities (Z),183952259,75841916,105904555,365698730,6776462940.130382,4673415550.757990,5104958875.753696,16554837366.642068,1529143,328054,926927,2784124
2017-09-29,NYSE American (A),2189330,11045689,1996278,15231297,95582631.250000,174771240.305100,99933715.367500,370287586.922600,28144,30078,21798,80020
2017-09-29,NASDAQ BX (B),108635252,29200611,63334822,201170685,4243376241.617275,1620762359.105899,2808164575.567489,8672303176.290663,1145237,146448,683946,1975631
2017-09-29,NYSE (DN),62061902,24134305,70789356,156985563,2106041218.091698,843959956.732599,2406826867.000801,5356828041.825098,144049,63321,219123,426493
2017-09-29,NASDAQ (DQ),1012266570,365353515,725036070,2102656155,36535212660.033021,25993756305.116609,30735775793.503535,93264744758.653165,3363222,733247,2254864,6351333
2017-09-29,EDGA Equities (J),46434862,23519955,24301519,94256336,1472493439.170610,1347291568.681402,1094170621.160110,3913955629.012122,415066,110281,216216,741563
2017-09-29,EDGX Equities (K),149558861,56489663,149816524,355865048,5687085722.071855,3270590211.935598,6215486725.500599,15173162659.508052,1095804,231402,924481,2251687
2017-09-29,CHX (M),8964803,15293548,5609437,29867788,455368392.905000,1272809887.634800,602031601.772900,2330209882.312700,2875,2396,1468,6739
2017-09-29,NYSE (N),936131774,0,0,936131774,37531466027.467800,0.000000,0.000000,37531466027.467800,2263935,0,0,2263935
2017-09-29,NYSE Arca (P),179437638,238287165,139547009,557271812,7681163591.455916,14780075790.344406,6781322526.699777,29242561908.500099,1381103,607929,1009433,2998465
2017-09-29,NASDAQ (Q),263233537,91300449,526407175,880941161,12146503087.299803,6688150136.928673,27793206324.827726,46627859549.056202,2482861,386271,2930623,5799755
2017-09-29,IEX (V),78471850,16980679,43178015,138630544,3092230031.649390,954130717.824600,2155806216.932904,6202166966.406894,475537,69285,282999,827821
2017-09-29,NASDAQ PSX (X),13700571,11547241,15021152,40268964,545659912.059199,806161216.615700,864137306.629799,2215958435.304698,125619,47637,133865,307121
2017-09-29,BYX Equities (Y),177372974,62806974,97946408,338126356,5320676279.703608,3105278835.604501,3635945621.254481,12061900736.562590,1523365,287266,908158,2718789
2017-09-29,BZX Equities (Z),181801964,71006743,107743002,360551709,6788226265.082854,4617333304.577015,5294706750.458875,16700266320.118744,1470357,312469,879503,2662329
2017-09-28,NYSE American (A),2455232,8846366,2444918,13746516,110285727.655000,86884969.785700,108158297.572600,305328995.013300,28732,29361,23938,82031
2017-09-28,NASDAQ BX (B),111979255,23529190,62779837,198288282,4394667948.992204,1191783592.733798,2448536162.778106,8034987704.504108,1132269,120095,632863,1885227
2017-09-28,NYSE (DN),71974459,25965998,73980724,171921181,2360365712.273502,840646670.466797,2287232615.583408,5488244998.323707,151888,63405,214372,429665
2017-09-28,NASDAQ (DQ),1063520931,336562691,690384298,2090467920,36896794822.501301,19005324225.988850,26941163569.354357,82843282617.844508,3417470,682805,2158898,6259173
2017-09-28,EDGA Equities (J),48322487,18053233,23787308,90163028,1499032644.355190,949469242.743697,943650372.355001,3392152259.453888,417625,88766,210847,717238
2017-09-28,EDGX Equities (K),166820857,53402436,151728681,371951974,6080532032.558319,2789259442.273103,5862250480.484598,14732041955.316020,1091439,216167,921020,2228626
2017-09-28,CHX (M),7024645,12568963,5204515,24798123,366344299.306000,795582323.700000,518766081.429400,1680692704.435400,2692,2557,1602,6851
2017-09-28,NYSE (N),767151058,0,0,767151058,30323250399.161337,0.000000,0.000000,30323250399.161337,2310093,0,0,2310093
2017-09-28,NYSE Arca (P),187105229,204863647,143181208,535150084,7827300826.592131,11217016601.870929,6278849102.147827,25323166530.610887,1419257,550332,1048203,3017792
2017-09-28,NASDAQ (Q),277054631,78032871,470540702,825628204,12355967091.029052,4847777431.473792,22009011277.454613,39212755799.957457,2549302,349943,2924621,5823866
2017-09-28,IEX (V),85498466,13970023,46525790,145994279,3626556952.766204,740907304.042400,2285424848.577398,6652889105.386002,524955,59254,285434,869643
2017-09-28,NASDAQ PSX (X),14091101,9714078,13963694,37768873,561598542.437400,598641683.753300,736308906.665300,1896549132.856000,132768,42730,123256,298754
2017-09-28,BYX Equities (Y),181971825,49236369,95113373,326321567,5351635717.971138,2262401836.791402,3268309738.798424,10882347293.560964,1573301,241691,886324,2701316
2017-09-28,BZX Equities (Z),188062153,62059547,103156839,353278539,6727617019.619042,3662000334.662600,4615521127.641178,15005138481.922820,1458343,278889,849994,2587226
2017-09-27,NYSE American (A),2600259,10838250,2215190,15653699,105274476.840000,147653282.964200,115385352.864400,368313112.668600,30164,32316,21369,83849
2017-09-27,NASDAQ BX (B),122712971,31233410,67320577,221266958,4775030445.484427,1816075439.891603,2792855356.948800,9383961242.324830,1219173,144881,678424,2042478
2017-09-27,NYSE (DN),80757034,31142128,79496029,191395191,2752634788.561810,1044073199.796102,2592625727.467804,6389333715.825716,174334,71221,210481,456036
2017-09-27,NASDAQ (DQ),1178638929,440081930,780224758,2398945617,41730592206.339137,27851889195.376919,32575548960.875784,102158030362.591840,3707651,777862,2269521,6755034
2017-09-27,EDGA Equities (J),49750039,24926754,26032530,100709323,1615041919.892087,1451673132.834798,1131511758.926203,4198226811.653088,441412,109984,217310,768706
2017-09-27,EDGX Equities (K),176125005,70255309,165741017,412121331,6552507913.519478,4148793233.496991,6673172101.113991,17374473248.130460,1179772,281758,962197,2423727
2017-09-27,CHX (M),8280740,12747946,4737927,25766613,581575587.400000,1327721262.557500,647438078.099900,2556734928.057400,3149,3066,1981,8196
2017-09-27,NYSE (N),835545439,0,0,835545439,32395153167.679379,0.000000,0.000000,32395153167.679379,2545829,0,0,2545829
2017-09-27,NYSE Arca (P),204257270,257963869,151933357,614154496,8632309273.817379,15490030101.842562,7292653436.241713,31414992811.901654,1541136,691320,1100314,3332770
2017-09-27,NASDAQ (Q),307744207,104872591,502819238,915436036,13789217343.936803,7482008240.905121,25968141384.549968,47239366969.391892,2817088,446991,3192359,6456438
2017-09-27,IEX (V),93775687,17415486,48158996,159350169,3958154670.576597,1023547688.493400,2437368274.587805,7419070633.657802,564421,69483,302851,936755
2017-09-27,NASDAQ PSX (X),15677401,14371269,14793707,44842377,618481999.898399,976339410.986201,829680247.916200,2424501658.800800,137655,57982,128066,323703
2017-09-27,BYX Equities (Y),203653529,66616526,109905078,380175133,5897258283.483614,3362155334.043602,3813211538.395565,13072625155.922781,1711815,304535,991079,3007429
2017-09-27,BZX Equities (Z),205559841,84251212,115030089,404841142,7486666014.713819,5829175529.528820,5516064443.676791,18831905987.919430,1630162,371641,945559,2947362
2017-09-26,NYSE American (A),2599021,11226073,2074523,15899617,108475075.150000,100728616.382600,102228384.537500,311432076.070100,31612,32649,22884,87145
2017-09-26,NASDAQ BX (B),113900619,27834635,61803828,203539082,4634930191.004475,1423785977.001600,2661655504.195701,8720371672.201776,1163609,134280,642898,1940787
2017-09-26,NYSE (DN),71963730,27851689,79420492,179235911,2424464719.778311,938069284.595400,2771974704.471207,6134508708.844918,154811,66950,215622,437383
2017-09-26,NASDAQ (DQ),1039634106,331867733,726557610,2098059449,37978461987.635770,18367054311.997839,30979332160.068615,87324848459.702224,3367355,781386,2153106,6301847
2017-09-26,EDGA Equities (J),47019915,21519967,26211899,94751781,1537144979.964511,1211843093.369900,1087393751.554797,3836381824.889208,430485,99951,224551,754987
2017-09-26,EDGX Equities (K),155556190,58797280,158178179,372531649,5902844498.870576,3104243474.892501,6310596064.399266,15317684038.162343,1040646,230463,898004,2169113
2017-09-26,CHX (M),7918142,13413169,6862215,28193526,500308900.001200,1091125480.280000,778126220.047900,2369560600.329100,2777,2528,1956,7261
2017-09-26,NYSE (N),737672291,0,0,737672291,28595712326.615301,0.000000,0.000000,28595712326.615301,2214024,0,0,2214024
2017-09-26,NYSE Arca (P),176581818,241306464,148189722,566078004,7720544290.453176,13528346706.430890,7216444016.918093,28465335013.802159,1353498,590259,1046096,2989853
2017-09-26,NASDAQ (Q),264933279,88788849,466475269,820197397,12059110955.386283,5764147081.296491,24405261819.297577,42228519855.980351,2444219,386713,2906249,5737181
2017-09-26,IEX (V),80616506,16325445,42433354,139375305,3193448311.632390,881188756.853700,2117819091.862206,6192456160.348296,492126,64821,268568,825515
2017-09-26,NASDAQ PSX (X),13621970,11722344,15099984,40444298,571117618.834999,696223647.194801,842953712.430400,2110294978.460200,124179,48874,129370,302423
2017-09-26,BYX Equities (Y),177046049,57676196,96846713,331568958,5391621388.462751,2697868954.300892,3480064167.012294,11569554509.775937,1546818,270825,894288,2711931
2017-09-26,BZX Equities (Z),181711224,70276366,105841650,357829240,6713680337.175191,4261042312.371306,5149616067.384298,16124338716.930795,1429098,314718,864329,2608145
2017-09-25,NYSE American (A),3002743,11752312,2599551,17354606,127756946.730000,142622397.174300,140947082.346000,411326426.250300,33329,32574,27905,93808
2017-09-25,NASDAQ BX (B),113133238,33920902,63284808,210338948,4517577281.909512,1626236446.218699,2820411715.011097,8964225443.139308,1126555,151613,632053,1910221
2017-09-25,NYSE (DN),80370840,33020223,81728867,195119930,2872944540.378901,1217191458.357203,3307921671.819399,7398057670.555503,181574,80466,244050,506090
2017-09-25,NASDAQ (DQ),1094325173,438936602,757205125,2290466900,40671975276.198990,22046960530.636527,37741080788.323571,100460016595.159088,3562146,854294,2341574,6758014
2017-09-25,EDGA Equities (J),51395987,27223487,28427453,107046927,1703549243.925033,1437372122.924204,1244240117.820296,4385161484.669533,453182,128102,236929,818213
2017-09-25,EDGX Equities (K),169464838,72414623,171196628,413076089,6609301152.562049,3571681752.197993,7709138818.977617,17890121723.737659,1120389,280461,991466,2392316
2017-09-25,CHX (M),9371847,9565600,4990410,23927857,407835962.227700,634258625.180000,482045356.375000,1524139943.782700,3063,2706,2717,8486
2017-09-25,NYSE (N),842279043,0,0,842279043,33734983112.403670,0.000000,0.000000,33734983112.403670,2377436,0,0,2377436
2017-09-25,NYSE Arca (P),187214401,286769025,148977931,622961357,8103490444.342853,15311845623.992258,8383220092.673702,31798556161.008813,1406910,731532,1078335,3216777
2017-09-25,NASDAQ (Q),288412781,107546688,524056755,920016224,13306834093.269103,7037929628.964881,30724845470.732726,51069609192.966710,2609013,469836,3214364,6293213
2017-09-25,IEX (V),83247306,20265390,43551110,147063806,3382023543.612400,1010792180.190100,2512702956.711998,6905518680.514498,513175,76827,282898,872900
2017-09-25,NASDAQ PSX (X),15085015,15256497,17372190,47713702,608403531.924601,892234436.324800,1055977074.418501,2556615042.667902,133271,61517,137947,332735
2017-09-25,BYX Equities (Y),190000568,65170714,101445325,356616607,5588714861.565477,2899493570.150994,3771480536.182181,12259688967.898652,1620156,290168,932088,2842412
2017-09-25,BZX Equities (Z),187234448,86597767,116318844,390151059,7082709176.459413,5042283712.545791,6186725197.882995,18311718086.888199,1487379,391738,942391,2821508
2017-09-22,NYSE American (A),2396580,8591769,1933874,12922223,93349080.160000,98389129.622200,97320687.855800,289058897.638000,28054,25795,21869,75718
2017-09-22,NASDAQ BX (B),103474175,20173012,56273982,179921169,4039906113.535623,1108076057.466903,2335953087.780996,7483935258.783522,1028059,100033,562493,1690585
2017-09-22,NYSE (DN),68309895,24452553,64655039,157417487,2457342095.533408,835460208.784700,2293164908.954502,5585967213.272610,150973,62955,193276,407204
2017-09-22,NASDAQ (DQ),978143326,298965317,614957485,1892066128,35687160831.440843,17312954267.341164,26036073531.504130,79036188630.286137,3117702,579230,1944788,5641720
2017-09-22,EDGA Equities (J),42092002,15982111,20862459,78936572,1342215201.557699,903008857.803600,888577127.938400,3133801187.299699,374991,76014,186160,637165
2017-09-22,EDGX Equities (K),142258462,43445862,128576705,314281029,5252797573.963708,2555353282.254699,5626904678.616009,13435055534.834416,927214,175957,778660,1881831
2017-09-22,CHX (M),4072846,10144848,2126492,16344186,226344536.985900,751087345.080800,263766025.534900,1241197907.601600,2373,1644,1629,5646
2017-09-22,NYSE (N),722119261,0,0,722119261,28739130519.884935,0.000000,0.000000,28739130519.884935,2088324,0,0,2088324
2017-09-22,NYSE Arca (P),159011523,176663036,112875480,448550039,6822237405.116520,10033534784.322787,5667339818.948934,22523112008.388241,1189608,451603,840554,2481765
2017-09-22,NASDAQ (Q),239331669,66771960,416299213,722402842,11039114309.295312,5028038271.282101,21725822345.320893,37792974925.898306,2196246,297292,2534636,5028174
2017-09-22,IEX (V),67983729,13005687,35814201,116803617,2887564347.735598,683178338.289100,1727995204.080500,5298737890.105198,424834,48751,222217,695802
2017-09-22,NASDAQ PSX (X),12649293,8812263,12373994,33835550,509328909.593300,571625663.262300,661891243.801499,1742845816.657099,108871,36940,104030,249841
2017-09-22,BYX Equities (Y),172582304,41043907,88446353,302072564,5134335936.348053,2003412772.996903,3075304118.438326,10213052827.783282,1463867,195453,795197,2454517
2017-09-22,BZX Equities (Z),163561377,52998051,93497502,310056930,6154297018.490839,3472748485.418299,4602610695.727800,14229656199.636938,1281922,253054,762583,2297559
2017-09-21,NYSE American (A),2248245,8868038,1890808,13007091,97352045.115000,92542296.904400,89776696.930000,279671038.949400,25365,25920,20371,71656
2017-09-21,NASDAQ BX (B),103629021,20948576,57217098,181794695,3870223518.567780,1080309731.188200,2337363907.047395,7287897156.803375,1034421,106334,581941,1722696
2017-09-21,NYSE (DN),73502970,26216636,73286098,173005704,2392349426.673706,905484036.829700,2453309365.102411,5751142828.605817,146293,69506,203878,419677
2017-09-21,NASDAQ (DQ),974223884,329096693,667903243,1971223820,34436050362.109841,17619768352.773377,27498056734.608982,79553875449.492200,3113394,643240,2022061,5778695
2017-09-21,EDGA Equities (J),44271829,18726706,21930625,84929160,1372431117.071698,950150677.170200,885883866.822700,3208465661.064598,383352,93597,186878,663827
2017-09-21,EDGX Equities (K),152171238,54630496,151561678,358363412,5478574016.407123,2557630261.947395,6085851036.920810,14122055315.275328,984078,203310,848108,2035496
2017-09-21,CHX (M),23978103,7011843,3979565,34969511,692441027.920200,694219229.812000,415467270.701200,1802127528.433400,2785,2590,1567,6942
2017-09-21,NYSE (N),726145061,0,0,726145061,27238907113.740961,0.000000,0.000000,27238907113.740961,2133309,0,0,2133309
2017-09-21,NYSE Arca (P),163008098,192799736,130078859,485886693,6467933174.696788,10371295779.815446,5825181596.163299,22664410550.675533,1179173,522261,892558,2593992
2017-09-21,NASDAQ (Q),258191011,76033827,427946731,762171569,11327621396.397782,4740181214.303200,22653636394.590636,38721439005.291618,2337012,332005,2711184,5380201
2017-09-21,IEX (V),78474451,13954889,38592384,131021724,3146374580.947124,724781724.668300,1874156520.839497,5745312826.454921,472919,57741,252857,783517
2017-09-21,NASDAQ PSX (X),13049897,10534884,14021281,37606062,501177316.001700,635119094.971800,743361390.528201,1879657801.501701,111132,42203,114865,268200
2017-09-21,BYX Equities (Y),184129892,43616933,92119980,319866805,5251217752.963640,1995075198.465496,3241133576.700207,10487426528.129343,1538070,205983,845056,2589109
2017-09-21,BZX Equities (Z),168568855,62693844,99076500,330339199,5876526176.871120,3575233492.147397,4660171708.363284,14111931377.381801,1275087,283667,782078,2340832
2017-09-20,NYSE American (A),2721621,12346516,2079826,17147963,104803901.955000,110905835.349200,99934758.790000,315644496.094200,28892,32025,21769,82686
2017-09-20,NASDAQ BX (B),114748480,30281164,60031645,205061289,4341942548.407582,1462300673.225799,2509103801.090100,8313347022.723481,1127815,138391,626901,1893107
2017-09-20,NYSE (DN),90660216,32610563,77722150,200992929,2812305425.798609,1075609067.497998,2836969732.673398,6724884225.970005,174961,83977,224477,483415
2017-09-20,NASDAQ (DQ),1233433027,404435519,786283050,2424151596,44480110263.100281,20543623623.043738,34544520188.891085,99568254075.035104,3566009,792754,2289493,6648256
2017-09-20,EDGA Equities (J),54353649,26283347,26263882,106900878,1698054768.878719,1347844904.110499,1122164465.877102,4168064138.866320,460503,125024,222225,807752
2017-09-20,EDGX Equities (K),193718101,77939219,180926942,452584262,6801545685.470796,3942025464.528605,7478004787.798360,18221575937.797761,1231402,294986,995793,2522181
2017-09-20,CHX (M),9354145,8884360,8568516,26807021,617842372.654000,835037989.065001,727782614.798700,2180662976.517701,2659,3179,1581,7419
2017-09-20,NYSE (N),837071758,0,0,837071758,32537130418.622057,0.000000,0.000000,32537130418.622057,2531491,0,0,2531491
2017-09-20,NYSE Arca (P),209528137,266844476,155515341,631887954,8525536894.615313,14375614376.362291,7440063021.794006,30341214292.771610,1544966,728407,1077856,3351229
2017-09-20,NASDAQ (Q),319378781,115213696,512242536,946835013,13487464999.792555,6895163456.449904,26850217084.281397,47232845540.523856,2781637,488196,3163051,6432884
2017-09-20,IEX (V),89940965,16679320,43304258,149924543,3634903495.503227,904238664.036600,2185916930.630297,6725059090.170124,540794,64849,276242,881885
2017-09-20,NASDAQ PSX (X),15743587,16396308,15486531,47626426,626620325.218400,971479761.222000,866421611.635101,2464521698.075501,133573,62574,124715,320862
2017-09-20,BYX Equities (Y),201444410,61940776,96781485,360166671,5646608351.796324,2712081665.674404,3412857999.056981,11771548016.527709,1686958,280839,886147,2853944
2017-09-20,BZX Equities (Z),212477833,97389130,118377274,428244237,7542730991.511968,5713079127.244500,5746114859.462978,19001924978.219446,1625341,421642,947345,2994328
2017-09-19,NYSE American (A),2574490,9341520,1862660,13778670,107973731.565000,92803263.956300,85717475.656900,286494471.178200,28463,26390,20218,75071
2017-09-19,NASDAQ BX (B),113482626,24822132,61300982,199605740,4535008106.305998,1228197440.211803,2515141340.872901,8278346887.390702,1151493,121847,632061,1905401
2017-09-19,NYSE (DN),82528484,22372016,77133691,182034191,2761592200.703297,781382762.246699,2602840633.967393,6145815596.917389,175083,63566,205992,444641
2017-09-19,NASDAQ (DQ),1076400024,318423448,687575726,2082399198,40626803498.855786,18214282240.603654,27895696641.013571,86736782380.473011,3572668,677905,2136674,6387247
2017-09-19,EDGA Equities (J),47840465,16549546,21989831,86379842,1548764342.879186,899150945.867501,889286106.591399,3337201395.338086,410232,81257,194872,686361
2017-09-19,EDGX Equities (K),172631515,45451630,144089831,362172976,6386881603.535397,2287171195.744897,5920434632.716874,14594487431.997168,1093736,181348,843985,2119069
2017-09-19,CHX (M),8886577,11704823,3621374,24212774,516137866.903000,1037643641.490000,289960392.609100,1843741901.002100,2714,1754,1536,6004
2017-09-19,NYSE (N),809299565,0,0,809299565,32014462125.649233,0.000000,0.000000,32014462125.649233,2273413,0,0,2273413
2017-09-19,NYSE Arca (P),188167062,173278276,122895543,484340881,8116140283.928387,9713036234.614292,5933231141.173220,23762407659.715899,1384128,461527,906147,2751802
2017-09-19,NASDAQ (Q),281544076,65243425,451466330,798253831,13380773765.227038,4174936780.583106,23768096919.994432,41323807465.804576,2573116,288271,2717558,5578945
2017-09-19,IEX (V),84009538,12622242,40919066,137550846,3562430435.654595,655158861.921700,1947350739.484801,6164940037.061096,517305,52832,266322,836459
2017-09-19,NASDAQ PSX (X),16104812,9267522,13978122,39350456,661716510.721301,536123380.744001,746825680.856101,1944665572.321403,139576,38944,118158,296678
2017-09-19,BYX Equities (Y),189920335,41971692,93037158,324929185,5893138770.705129,1932300761.774098,3349728234.201491,11175167766.680718,1658727,196558,870769,2726054
2017-09-19,BZX Equities (Z),180379779,56394202,96219285,332993266,6814565704.890052,3275121256.265201,4474098479.726824,14563785440.882077,1411645,254479,792107,2458231
2017-09-18,NYSE American (A),2224810,12073366,2237372,16535548,85404635.835000,106146555.430200,93965844.402100,285517035.667300,26264,30376,23690,80330
2017-09-18,NASDAQ BX (B),104401334,24571855,60492232,189465421,4008891935.210507,1270362339.493700,2557224813.084893,7836479087.789100,1088155,133077,633922,1855154
2017-09-18,NYSE (DN),74966060,28988144,71103010,175057214,2616387884.064006,1008062123.934604,3102214515.340201,6726664523.338811,173974,76572,221775,472321
2017-09-18,NASDAQ (DQ),1087222034,352694570,724660519,2164577123,41706844138.388251,18339499160.851763,33221099253.451433,93267442552.691447,3524073,790507,2275781,6590361
2017-09-18,EDGA Equities (J),45540280,20849180,22593822,88983282,1540344281.425503,1106900860.515998,1028357922.425391,3675603064.366892,414998,106020,203556,724574
2017-09-18,EDGX Equities (K),167397438,60550639,150834983,378783060,6182261687.988645,3027624089.520006,6821803976.800107,16031689754.308758,1068688,241596,895089,2205373
2017-09-18,CHX (M),9467294,9452840,5050023,23970157,424050237.581500,917447233.755000,337273658.894000,1678771130.230500,2499,2257,1579,6335
2017-09-18,NYSE (N),821730488,0,0,821730488,32938501205.560303,0.000000,0.000000,32938501205.560303,2259653,0,0,2259653
2017-09-18,NYSE Arca (P),181841158,216194215,125429229,523464602,7675672650.444118,11333357149.051180,6317810322.894796,25326840122.390094,1336778,564758,927744,2829280
2017-09-18,NASDAQ (Q),262442126,81847038,471466563,815755727,11854844196.109680,5176945419.802418,25554677007.684383,42586466623.596481,2392730,363514,2799238,5555482
2017-09-18,IEX (V),84233068,13776286,39802129,137811483,3466169851.126189,726286338.742900,1990594555.588897,6183050745.457986,540196,60616,274685,875497
2017-09-18,NASDAQ PSX (X),13977391,11119101,14271721,39368213,534580721.911701,643417691.834800,779354572.408900,1957352986.155401,123444,47957,118701,290102
2017-09-18,BYX Equities (Y),173747235,50040213,94059622,317847070,5223291865.804317,2356988467.795886,3446173717.841524,11026454051.441727,1530194,249293,882271,2661758
2017-09-18,BZX Equities (Z),175511232,69709524,99903172,345123928,6329250695.967392,4148792765.312685,4822166296.743788,15300209758.023865,1354200,325941,824224,2504365
2017-09-15,NYSE American (A),3056556,44452179,2273133,49781868,130174815.544200,317980028.800500,116026226.546200,564181070.890900,35287,30461,24976,90724
2017-09-15,NASDAQ BX (B),118095632,27457886,68358447,213911965,4734875042.466008,1580179316.777698,3036291622.414120,9351345981.657826,1204483,136773,703276,2044532
2017-09-15,NYSE (DN),66415724,23181925,64665042,154262691,2320722898.935504,811740584.659698,2602122625.226504,5734586108.821706,158892,62382,188790,410064
2017-09-15,NASDAQ (DQ),1323242022,362610167,879219169,2565071358,50240680977.509380,25844907602.545160,38801608835.001913,114887197415.056453,3514443,699478,2232947,6446868
2017-09-15,EDGA Equities (J),49648810,20943593,25399396,95991799,1752592555.181804,1282882370.581000,1233586908.057202,4269061833.820006,444623,97668,220537,762828
2017-09-15,EDGX Equities (K),162499755,56030350,143011090,361541195,6113733155.762213,3244379148.738410,6366620632.310304,15724732936.810927,1090577,222553,880512,2193642
2017-09-15,CHX (M),10524913,11951435,10488841,32965189,561028441.069600,1108242762.062700,1088152673.812200,2757423876.944500,2665,2214,1466,6345
2017-09-15,NYSE (N),2166384554,0,0,2166384554,92027681628.651332,0.000000,0.000000,92027681628.651332,2386909,0,0,2386909
2017-09-15,NYSE Arca (P),194609604,217039832,133265245,544914681,8508796758.923893,13223226280.061725,6915902489.846371,28647925528.831989,1443761,530533,974018,2948312
2017-09-15,NASDAQ (Q),282522239,80750116,1221316334,1584588689,13036893855.083667,5871109474.581323,59776561176.618796,78684564506.283786,2557941,334753,2916559,5809253
2017-09-15,IEX (V),85700782,15883194,44263440,145847416,3805337769.372509,893412172.200200,2226272980.413197,6925022921.985906,539018,61654,287252,887924
2017-09-15,NASDAQ PSX (X),16071048,10880848,15209315,42161211,643251975.128502,781418867.510000,903136557.896301,2327807400.534803,144217,44594,133506,322317
2017-09-15,BYX Equities (Y),193364751,55639971,110095620,359100342,5991244790.684797,2777896080.772801,3938267088.334705,12707407959.792303,1686362,258474,974083,2918919
2017-09-15,BZX Equities (Z),190835825,65446079,110350733,366632637,7171247933.010901,4224420739.474003,5357609306.461497,16753277978.946401,1475321,289422,882437,2647180
2017-09-14,NYSE American (A),2758284,11382579,2137512,16278375,116101627.030000,133989582.041900,104700124.034900,354791333.106800,31867,31301,23489,86657
2017-09-14,NASDAQ BX (B),123962671,23131174,61154428,208248273,4853695179.754796,1260914917.025399,2576662054.463491,8691272151.243686,1225886,123569,625410,1974865
2017-09-14,NYSE (DN),81975368,25464934,81282430,188722732,2906487159.136305,842435815.210300,2211312546.585594,5960235520.932199,167997,64181,185626,417804
2017-09-14,NASDAQ (DQ),1119051604,364938166,660017249,2144007019,40413898665.713201,25682310102.299223,27730319960.197373,93826528728.209797,3727518,673295,2046516,6447329
2017-09-14,EDGA Equities (J),51095052,20526619,24155398,95777069,1707288436.302576,1171810286.878200,1078945299.238603,3958044022.419379,447001,98162,211417,756580
2017-09-14,EDGX Equities (K),177543453,59407328,150749632,387700413,6754566515.690917,3331373446.876191,5856604693.094985,15942544655.662093,1156944,237900,824726,2219570
2017-09-14,CHX (M),9690408,12774535,9690394,32155337,490132009.868000,1380944418.276000,851359602.193900,2722436030.337900,2522,2931,1847,7300
2017-09-14,NYSE (N),856303681,0,0,856303681,33687176823.591006,0.000000,0.000000,33687176823.591006,2275947,0,0,2275947
2017-09-14,NYSE Arca (P),202025509,206405732,126008563,534439804,8354594495.153859,12342329305.602879,6058414131.571896,26755337932.328634,1447235,561977,879621,2888833
2017-09-14,NASDAQ (Q),298685519,79477777,458546946,836710242,13643506212.399866,5265521706.609381,24505983453.670996,43415011372.680243,2673115,352652,2609841,5635608
2017-09-14,IEX (V),92789005,14026678,39745418,146561101,3842232708.892964,750422445.940500,1998857872.660999,6591513027.494463,562836,61546,257316,881698
2017-09-14,NASDAQ PSX (X),17564467,10825124,13362648,41752239,656407581.411601,694320072.328300,772011134.660600,2122738788.400501,147653,46163,118526,312342
2017-09-14,BYX Equities (Y),199616097,47661769,93378467,340656333,5976441934.462303,2275211966.776502,3282763926.361489,11534417827.600294,1686075,240711,850440,2777226
2017-09-14,BZX Equities (Z),189412884,65535678,97613876,352562438,6936993887.698363,4149109561.236504,4618063854.105181,15704167303.040048,1465836,304290,777120,2547246
2017-09-13,NYSE American (A),2689872,11252377,2243020,16185269,113161763.970000,114979526.774200,109599336.302900,337740627.047100,32731,32524,23203,88458
2017-09-13,NASDAQ BX (B),120208426,25610115,62060612,207879153,4648228798.514615,1292058284.320497,2537935515.706493,8478222598.541605,1218829,125985,635538,1980352
2017-09-13,NYSE (DN),83871676,26093949,99170214,209135839,2729701723.592704,791434794.076096,2491004734.784111,6012141252.452911,169985,68418,200534,438937
2017-09-13,NASDAQ (DQ),1098742868,351583988,719994455,2170321311,38322038399.510136,20584035700.661145,28371831182.918053,87277905283.089334,3586717,724101,2147942,6458760
2017-09-13,EDGA Equities (J),50647920,21040255,23185738,94873913,1625968851.536786,1071973317.887000,957109295.397502,3655051464.821288,440982,92112,196563,729657
2017-09-13,EDGX Equities (K),184703165,63928918,161501714,410133797,6519020943.361524,2956400095.913504,5996089839.114501,15471510878.389529,1144274,249257,865571,2259102
2017-09-13,CHX (M),11571510,12564411,8601885,32737806,599867510.008900,1071400071.100000,657551682.174400,2328819263.283300,2862,2517,1536,6915
2017-09-13,NYSE (N),823623628,0,0,823623628,31484110610.160503,0.000000,0.000000,31484110610.160503,2307516,0,0,2307516
2017-09-13,NYSE Arca (P),195635848,224667420,141109869,561413137,7986249714.382140,11929193742.076143,6288277387.531787,26203720843.990070,1446065,579856,938844,2964765
2017-09-13,NASDAQ (Q),299086846,86778133,471692585,857557564,13141694339.522762,5243677508.087693,23057505022.349021,41442876869.959476,2656946,368743,2724466,5750155
2017-09-13,IEX (V),91091479,15800297,40429903,147321679,3750447558.481199,800951315.240200,1979994864.634097,6531393738.355496,551256,64351,263863,879470
2017-09-13,NASDAQ PSX (X),16412857,11829486,15998561,44240904,631596897.524900,821484725.524499,843137742.668599,2296219365.717998,146374,50196,129489,326059
2017-09-13,BYX Equities (Y),198328836,53958176,93507320,345794332,5670480713.945511,2401050289.461100,3288384562.024716,11359915565.431327,1698320,261373,863205,2822898
2017-09-13,BZX Equities (Z),194762334,69443689,105138443,369344466,6836255318.659016,3910104111.350287,4877030653.996998,15623390084.006301,1474654,316158,815959,2606771
2017-09-12,NYSE American (A),2765665,9225807,2213867,14205339,123574713.570000,125496002.472400,127668030.347800,376738746.390200,33451,31633,23396,88480
2017-09-12,NASDAQ BX (B),123924265,25620937,65564022,215109224,4678341826.066119,1356311028.910197,2723661110.447231,8758313965.423547,1219956,135069,691699,2046724
2017-09-12,NYSE (DN),82594266,25810997,69297521,177702784,2663093404.909094,927032311.163998,2686614476.516523,6276740192.589615,172147,64456,204633,441236
2017-09-12,NASDAQ (DQ),1029996098,328506424,634758952,1993261474,35464685741.080752,17586176006.227368,28382593985.048369,81433455732.356489,3554401,714352,2175185,6443938
2017-09-12,EDGA Equities (J),48555368,19887143,21410582,89853093,1611808733.882520,1099296698.493798,986892166.272401,3697997598.648719,419898,90988,196779,707665
2017-09-12,EDGX Equities (K),183814499,64051743,143220695,391086937,6723824192.220992,3382472416.701301,6466521830.528090,16572818439.450383,1154290,252322,881753,2288365
2017-09-12,CHX (M),10503924,11915695,6407729,28827348,799892724.991500,1006436983.831799,543205311.848000,2349535020.671299,2589,3274,1522,7385
2017-09-12,NYSE (N),767352768,0,0,767352768,28598124120.811039,0.000000,0.000000,28598124120.811039,2279636,0,0,2279636
2017-09-12,NYSE Arca (P),194703109,211124099,127983170,533810378,8112833374.017858,12149885797.271374,7167390036.571977,27430109207.861209,1429742,567840,973158,2970740
2017-09-12,NASDAQ (Q),300745904,88476704,429866715,819089323,13261763751.067865,5981268816.505188,23980395121.354976,43223427688.928029,2667829,382154,2819868,5869851
2017-09-12,IEX (V),86575129,17049419,38846267,142470815,3639034964.637197,973315932.551600,1934056828.061399,6546407725.250196,512783,69263,260283,842329
2017-09-12,NASDAQ PSX (X),16864053,12165567,14829816,43859436,647807731.005900,777576616.343700,892250538.144201,2317634885.493801,149935,50081,130018,330034
2017-09-12,BYX Equities (Y),187432021,52722227,89909466,330063714,5481305461.745772,2499127486.007601,3348747335.829827,11329180283.583200,1572929,256948,842441,2672318
2017-09-12,BZX Equities (Z),198462365,73426319,103312240,375200924,7165433115.225547,4508571350.276098,5173828685.785287,16847833151.286932,1510795,320693,851787,2683275
2017-09-11,NYSE American (A),1792706,6247248,995341,9035295,88426175.610000,76162248.517900,53054261.085000,217642685.212900,26102,16305,11952,54359
2017-09-11,NASDAQ BX (B),122257603,27780726,65738800,215777129,4759039975.505211,1515043050.276001,2695825034.708606,8969908060.489818,1252678,146512,685584,2084774
2017-09-11,NYSE (DN),81078128,26122331,75895602,183096061,2993807869.925008,923064434.226199,2457609995.567202,6374482299.718409,183502,70338,199971,453811
2017-09-11,NASDAQ (DQ),1083796702,340424514,660850372,2085071588,40151153854.123320,18518191856.825252,27734022494.822152,86403368205.770724,3652729,769519,2166280,6588528
2017-09-11,EDGA Equities (J),47142270,21339741,23061744,91543755,1677591337.360593,1246272543.752800,1030618578.177900,3954482459.291293,431903,103234,203300,738437
2017-09-11,EDGX Equities (K),174877146,65595888,145129796,385602830,6757381538.262110,3514212784.567203,6137143850.777430,16408738173.606743,1181572,263624,887998,2333194
2017-09-11,CHX (M),6954767,6318426,5258482,18531675,441574035.688100,633475692.740000,513469350.105000,1588519078.533100,2295,4157,1376,7828
2017-09-11,NYSE (N),794898041,0,0,794898041,32617969168.064987,0.000000,0.000000,32617969168.064987,2344439,0,0,2344439
2017-09-11,NYSE Arca (P),200429941,255494407,129636748,585561096,8814119360.544194,14957017118.966767,6834702064.740394,30605838544.251355,1536160,621577,978355,3136092
2017-09-11,NASDAQ (Q),304337473,95040105,460869284,860246862,13770687708.762276,6399515794.502206,24750890786.482894,44921094289.747376,2786144,405519,2843815,6035478
2017-09-11,IEX (V),88247999,15349068,41344036,144941103,3807926164.762697,864353858.782600,2034892383.037693,6707172406.582990,553829,65789,270298,889916
2017-09-11,NASDAQ PSX (X),16063317,13103190,15211611,44378118,635177635.936199,816125904.982400,836272296.078500,2287575836.997099,146003,52722,131331,330056
2017-09-11,BYX Equities (Y),179265908,56795904,90864395,326926207,5413797651.750204,2765844843.746200,3364380459.151867,11544022954.648271,1565847,271745,842490,2680082
2017-09-11,BZX Equities (Z),192322087,72911541,104460256,369693884,7148153434.779344,4574225932.206785,5165646930.147907,16888026297.134036,1545387,334459,867403,2747249
2017-09-08,NYSE American (A),2928820,9383144,2235346,14547310,128890204.694900,109365387.636300,105427220.762400,343682813.093600,33129,29742,22863,85734
2017-09-08,NASDAQ BX (B),125725239,27387911,65582376,218695526,4923891754.065313,1392166046.511398,2602774547.353502,8918832347.930213,1273013,138954,675848,2087815
2017-09-08,NYSE (DN),80056418,29156361,81042301,190255080,2901133594.713607,1011997220.226901,2101614840.558201,6014745655.498709,165300,70419,183265,418984
2017-09-08,NASDAQ (DQ),1059392110,344240790,659174715,2062807615,38826191657.628054,18293672353.306959,25694750781.093061,82814614792.028074,3629772,748720,2069044,6447536
2017-09-08,EDGA Equities (J),48748281,21357841,23895403,94001525,1646157451.116317,1045765138.859603,983087904.718999,3675010494.694919,433381,97737,200913,732031
2017-09-08,EDGX Equities (K),180866467,66779525,145976259,393622251,6635772726.317986,3335125018.757101,5860589212.499380,15831486957.574467,1199655,260637,883634,2343926
2017-09-08,CHX (M),6471760,7754360,4598121,18824241,330822722.744500,752513073.050800,495053716.234500,1578389512.029800,3321,3320,1591,8232
2017-09-08,NYSE (N),801156090,0,0,801156090,30933226211.934478,0.000000,0.000000,30933226211.934478,2441058,0,0,2441058
2017-09-08,NYSE Arca (P),207495615,241744493,127235037,576475145,8958771133.120461,13895677553.980046,6143566721.069594,28998015408.170101,1587669,618429,969190,3175288
2017-09-08,NASDAQ (Q),315518426,93895361,432731253,842145040,14193051001.902526,5901816538.202832,21213648139.143569,41308515679.248927,2851193,408514,2776356,6036063
2017-09-08,IEX (V),88125593,15106055,39541895,142773543,3741769657.616713,851618532.459100,1801921525.530097,6395309715.605910,541423,63212,255190,859825
2017-09-08,NASDAQ PSX (X),16199699,11643666,15115105,42958470,642414055.203499,679473032.134400,767367888.538801,2089254975.876700,143795,49062,126280,319137
2017-09-08,BYX Equities (Y),174667763,50988481,85081334,310737578,5027209396.524390,2220159241.625504,2912062350.673003,10159430988.822897,1496362,246774,777612,2520748
2017-09-08,BZX Equities (Z),201011050,74704083,103863660,379578793,7425648983.318488,4242303168.634903,4867075467.736103,16535027619.689494,1593446,350435,856070,2799951
2017-09-07,NYSE American (A),2691669,9769067,2010502,14471238,127423558.890000,96696522.428100,87276732.776000,311396814.094100,31365,30564,21131,83060
2017-09-07,NASDAQ BX (B),122858285,29258589,66064294,218181168,4829073421.216604,1478372842.054699,2761155308.420089,9068601571.691392,1287617,140907,704682,2133206
2017-09-07,NYSE (DN),80283979,28483719,119404792,228172490,2856638559.444809,961891183.263201,2512246228.676304,6330775971.384314,185705,68050,199855,453610
2017-09-07,NASDAQ (DQ),1104164040,339193301,742102568,2185459909,41179892685.552136,17922299596.144112,27489107244.259542,86591299525.955790,3782406,719711,2226417,6728534
2017-09-07,EDGA Equities (J),50894913,22899462,26716677,100511052,1729739539.373792,1149363224.309501,1038487474.871997,3917590238.555290,450078,98256,212455,760789
2017-09-07,EDGX Equities (K),190359222,69270677,165447727,425077626,7196282364.504577,3587327693.805198,6305035134.397994,17088645192.707769,1296445,278426,980840,2555711
2017-09-07,CHX (M),8098838,9510746,5696875,23306459,427269728.923000,984214795.497000,494476038.220000,1905960562.640000,3168,2890,1397,7455
2017-09-07,NYSE (N),786712628,0,0,786712628,30696924702.378625,0.000000,0.000000,30696924702.378625,2577913,0,0,2577913
2017-09-07,NYSE Arca (P),215182323,243052834,138926909,597162066,9255971713.623817,12707718697.624654,6810094657.281319,28773785068.529790,1667732,633090,1043310,3344132
2017-09-07,NASDAQ (Q),317137586,101938593,462389661,881465840,14427411309.332853,6492637583.949987,22962784779.550423,43882833672.833263,2962509,446247,3059642,6468398
2017-09-07,IEX (V),87365048,16723649,46352628,150441325,3644402682.450008,843060691.730401,2135373095.895198,6622836470.075607,539157,68624,276400,884181
2017-09-07,NASDAQ PSX (X),16558567,14042590,15648294,46249451,679636146.931301,816307616.735800,852416702.947801,2348360466.614902,149916,56513,134933,341362
2017-09-07,BYX Equities (Y),174910138,56528780,91583303,323022221,5309339930.364085,2434125040.285200,3191344670.591490,10934809641.240775,1590197,249066,904864,2744127
2017-09-07,BZX Equities (Z),208568527,82936808,118570130,410075465,8021447859.861597,4839983169.515125,5464140124.317175,18325571153.693897,1691911,388139,966733,3046783
2017-09-06,NYSE American (A),3017679,10142939,2311443,15472061,135501110.627500,125043559.483400,99249058.093400,359793728.204300,33836,32974,23585,90395
2017-09-06,NASDAQ BX (B),121544031,33885147,65202875,220632053,4710950992.654330,1762365117.195897,2721411582.965315,9194727692.815542,1226722,161229,669710,2057661
2017-09-06,NYSE (DN),72321123,26166473,113803000,212290596,2627717750.028398,1003137380.146500,2170195337.879106,5801050468.054004,166192,70270,187068,423530
2017-09-06,NASDAQ (DQ),1156328169,393492272,695888667,2245709108,43140238484.036081,19404294660.066881,27382658222.941433,89927191367.044395,3741469,818041,2139584,6699094
2017-09-06,EDGA Equities (J),49911162,24012681,26143893,100067736,1646491637.532705,1314810374.435600,953567294.942501,3914869306.910806,429663,106165,198361,734189
2017-09-06,EDGX Equities (K),177669721,70217334,158763857,406650912,6743185077.701490,3717371285.252306,5911610975.276104,16372167338.229900,1178993,275774,884243,2339010
2017-09-06,CHX (M),5271099,12571153,3050894,20893146,307941202.780500,1019754581.310000,315094238.681000,1642790022.771500,2697,3207,1251,7155
2017-09-06,NYSE (N),813409288,0,0,813409288,31991633051.635515,0.000000,0.000000,31991633051.635515,2338494,0,0,2338494
2017-09-06,NYSE Arca (P),206551357,265751426,135073666,607376449,8764941232.537585,14801777142.604376,6482794413.659654,30049512788.801615,1588376,668777,1019750,3276903
2017-09-06,NASDAQ (Q),307634193,104124726,452145099,863904018,13557526260.455820,6504672423.245819,22770134982.768949,42832333666.470588,2678959,458595,2709036,5846590
2017-09-06,IEX (V),88332988,18472067,40494034,147299089,3670315623.902295,1048642042.496301,2010331312.379189,6729288978.777785,554129,75483,261096,890708
2017-09-06,NASDAQ PSX (X),16815088,14014484,15359560,46189132,660717342.555799,902340232.947199,864335411.790000,2427392987.292998,152779,59947,137504,350230
2017-09-06,BYX Equities (Y),176738991,67382214,88449838,332571043,5292138025.357487,3124063428.449295,3204650030.631478,11620851484.438260,1534099,319875,809958,2663932
2017-09-06,BZX Equities (Z),204660671,88402202,106042794,399105667,7494799132.605383,5208477432.978818,4919387913.726989,17622664479.311190,1583406,399276,853816,2836498
2017-09-05,NYSE American (A),3969135,12296071,2838547,19103753,186184015.645000,158380859.241700,143276850.039200,487841724.925900,43063,37621,29068,109752
2017-09-05,NASDAQ BX (B),126300448,40446871,67697126,234444445,4833990302.576618,2119631933.886297,2839104752.076903,9792726988.539818,1266426,197986,686225,2150637
2017-09-05,NYSE (DN),68704392,35162457,71073991,174940840,2264086527.815299,1437913337.562803,2369355846.042196,6071355711.420298,170608,96805,200577,467990
2017-09-05,NASDAQ (DQ),1069181671,462846416,656488243,2188516330,38709105297.640548,25154274273.008580,29375100444.139914,93238480014.789042,3723787,1088343,2176897,6989027
2017-09-05,EDGA Equities (J),52801683,29236373,25603532,107641588,1752952225.899817,1609829582.721100,1165717364.575201,4528499173.196118,456082,140139,218083,814304
2017-09-05,EDGX Equities (K),194712842,93494798,166120024,454327664,7246839795.029361,5117392626.687919,7120788095.014449,19485020516.731729,1324207,395354,1003442,2723003
2017-09-05,CHX (M),4083661,9745169,4368960,18197790,266126456.311000,1057051252.790000,399495029.849900,1722672738.950900,2888,4786,1522,9196
2017-09-05,NYSE (N),907047351,0,0,907047351,33705747119.208416,0.000000,0.000000,33705747119.208416,2647620,0,0,2647620
2017-09-05,NYSE Arca (P),225913862,320269754,145319510,691503126,9590759620.955117,18701382972.013483,7514243869.356178,35806386462.324778,1743132,977027,1127618,3847777
2017-09-05,NASDAQ (Q),340704985,137453892,479935948,958094825,15055475423.026243,9213911311.977576,25811774360.345764,50081161095.349583,3021984,635843,3076130,6733957
2017-09-05,IEX (V),85285949,22278222,39879809,147443980,3518729859.317900,1249504086.959000,2055423046.546896,6823656992.823796,533935,92690,264747,891372
2017-09-05,NASDAQ PSX (X),17598137,17704881,16944042,52247060,703472814.533600,1156129344.926101,1006372576.133701,2865974735.593402,159654,79934,147146,386734
2017-09-05,BYX Equities (Y),190541037,81346631,93419247,365306915,5619190509.781761,3752480255.120299,3579202345.716787,12950873110.618847,1630862,370177,865436,2866475
2017-09-05,BZX Equities (Z),215345468,114732365,119934718,450012551,7857814515.918705,7122002639.230908,5974435020.445858,20954252175.595471,1684499,570614,980633,3235746
2017-09-01,NYSE American (A),2775766,8733923,1774699,13284388,109306473.810000,110490401.616600,91546480.136200,311343355.562800,32191,26298,18728,77217
2017-09-01,NASDAQ BX (B),100801896,25134515,53378032,179314443,3647011185.359117,1427164823.289499,2231028632.089394,7305204640.738010,1063651,134576,571190,1769417
2017-09-01,NYSE (DN),69196631,26345366,66155597,161697594,1997908600.849691,1085949185.791199,2041905858.915790,5125763645.556680,159374,71126,188808,419308
2017-09-01,NASDAQ (DQ),877260814,358611977,538030054,1773902845,29061484726.193610,20711187008.161429,23296493306.778542,73069165041.133581,3158677,769294,1902816,5830787
2017-09-01,EDGA Equities (J),39988819,18221514,18609758,76820091,1233562550.845293,1071623114.184602,809040092.814199,3114225757.844094,351747,87202,161688,600637
2017-09-01,EDGX Equities (K),152712119,57977358,129769939,340459416,5266171143.295213,3161194144.145389,5386501715.377714,13813867002.818316,962262,228298,754916,1945476
2017-09-01,CHX (M),4599362,15900371,1943099,22442832,337206810.181400,1118372535.135000,165935094.294200,1621514439.610600,1965,2323,1277,5565
2017-09-01,NYSE (N),651466183,0,0,651466183,23969745277.085821,0.000000,0.000000,23969745277.085821,2030306,0,0,2030306
2017-09-01,NYSE Arca (P),167946624,220493681,105307802,493748107,6807236460.636895,13256494662.800970,5630065745.284491,25693796868.722356,1253840,549417,804414,2607671
2017-09-01,NASDAQ (Q),249074850,87855964,372217260,709148074,10758247088.639494,6111005086.671712,20287968988.229617,37157221163.540823,2259897,355294,2433745,5048936
2017-09-01,IEX (V),65877238,14363859,29464428,109705525,2636564301.898395,856577142.201999,1561862290.100293,5055003734.200687,406717,62085,203851,672653
2017-09-01,NASDAQ PSX (X),12928392,11489489,11570433,35988314,485463833.950500,716005322.019600,647594217.377300,1849063373.347400,115579,48353,101605,265537
2017-09-01,BYX Equities (Y),154208836,48411784,72277541,274898161,4460692224.642238,2258223540.981302,2778683275.988922,9497599041.612462,1376373,232511,710110,2318994
2017-09-01,BZX Equities (Z),163944445,72314662,88626906,324886013,5794167797.651203,4362866195.248895,4445265775.601308,14602299768.501406,1281930,319502,728731,2330163
2017-08-31,NYSE American (A),3363473,10763034,2286878,16413385,147686148.263800,207672436.362500,130033929.790000,485392514.416300,40423,31369,25254,97046
2017-08-31,NASDAQ BX (B),120913323,30304161,66288527,217506011,4624293852.644654,1639116030.267999,2964812431.120291,9228222314.032944,1232603,151580,677228,2061411
2017-08-31,NYSE (DN),68850027,28687866,82723368,180261261,2248014587.711503,1011449185.138004,2478680165.139594,5738143937.989101,166694,74389,212469,453552
2017-08-31,NASDAQ (DQ),1054031932,411749077,666224107,2132005116,38969176662.702994,28304060434.816467,30324183870.193569,97597420967.713030,3490717,768786,2140021,6399524
2017-08-31,EDGA Equities (J),46422650,23156120,24307291,93886061,1541566834.014898,1412910247.979600,1174639522.542802,4129116604.537300,413941,104051,206404,724396
2017-08-31,EDGX Equities (K),165438469,72567730,156553849,394560048,6255753171.599100,4139272235.300802,6962855679.979016,17357881086.878918,1143013,283148,907127,2333288
2017-08-31,CHX (M),7697456,7646442,5187650,20531548,418538927.006000,597294489.180000,444905505.250000,1460738921.436000,2402,2719,1352,6473
2017-08-31,NYSE (N),941742167,0,0,941742167,40354746383.178657,0.000000,0.000000,40354746383.178657,2310588,0,0,2310588
2017-08-31,NYSE Arca (P),192339330,254301719,131526799,578167848,8092468773.751502,15264005218.120687,7043008814.492530,30399482806.364719,1461638,643713,967675,3073026
2017-08-31,NASDAQ (Q),290855479,103652952,509158951,903667382,13298080777.818936,6966944462.136808,30293807137.331627,50558832377.287371,2636096,431391,2819179,5886666
2017-08-31,IEX (V),79311605,16317088,39725626,135354319,3404539085.319203,1035980325.231499,2156984147.855600,6597503558.406302,514132,67541,260436,842109
2017-08-31,NASDAQ PSX (X),15955281,13098597,14356902,43410780,613023517.795003,827414564.709000,879380216.474499,2319818298.978502,142256,54193,128060,324509
2017-08-31,BYX Equities (Y),177925640,60821780,86507878,325255298,5356729974.982899,2979024982.730499,3386713178.128713,11722468135.842111,1522112,273210,783784,2579106
2017-08-31,BZX Equities (Z),189020813,88982009,104658797,382661619,6953631667.411049,5901594161.308394,5441829342.235414,18297055170.954857,1491942,398651,856275,2746868
2017-08-30,NYSE American (A),2727630,8115719,2352575,13195924,105116014.778600,111179193.098100,126326707.695000,342621915.571700,30586,27906,23961,82453
2017-08-30,NASDAQ BX (B),102000569,23427227,62381106,187808902,3819721820.978624,1374999412.998802,2569163851.643801,7763885085.621227,1088189,121674,629928,1839791
2017-08-30,NYSE (DN),66828059,24354450,81295404,172477913,2197466124.637996,910409041.520800,2215435036.575004,5323310202.733800,158542,62989,199787,421318
2017-08-30,NASDAQ (DQ),854585515,289446032,624382559,1768414106,29982320382.960073,15738191066.746483,25950807911.037548,71671319360.744104,3085652,611088,2007563,5704303
2017-08-30,EDGA Equities (J),38307002,16473698,23871969,78652669,1201715225.866001,980552378.708200,951972275.258199,3134239879.832400,343807,75937,182827,602571
2017-08-30,EDGX Equities (K),138690289,52950179,148936937,340577405,5094343958.313246,2988922717.409298,5840680957.307900,13923947633.030444,947898,210122,815349,1973369
2017-08-30,CHX (M),8118318,8021273,5012130,21151721,427715171.261600,1072968013.832000,472156899.896200,1972840084.989800,2097,2507,1329,5933
2017-08-30,NYSE (N),646344262,0,0,646344262,24679426488.850333,0.000000,0.000000,24679426488.850333,2005558,0,0,2005558
2017-08-30,NYSE Arca (P),157684810,181565320,127750837,467000967,6629474927.593921,10728275439.905997,6378490956.498005,23736241323.997923,1242466,505293,915379,2663138
2017-08-30,NASDAQ (Q),244249004,78057334,411267281,733573619,10797814238.423031,5260936792.208617,21738060947.460939,37796811978.092587,2258067,341820,2600650,5200537
2017-08-30,IEX (V),64099877,12043018,38044852,114187747,2688616486.585208,659059147.725800,2051910928.278291,5399586562.589299,410429,50194,240894,701517
2017-08-30,NASDAQ PSX (X),13060850,10741716,14779207,38581773,507065546.271298,772437213.206199,840382977.668500,2119885737.145997,119078,47645,123275,289998
2017-08-30,BYX Equities (Y),143494169,44741689,80813010,269048868,4260890910.525107,2206170798.811802,3071541695.251481,9538603404.588390,1260197,212606,721110,2193913
2017-08-30,BZX Equities (Z),157599186,65420636,96176284,319196106,5544859093.295320,4184724340.496797,4803892717.937011,14533476151.729128,1249268,302135,778082,2329485
2017-08-29,NYSE American (A),2590292,10299861,1978375,14868528,117661855.047300,116476574.981100,98052643.760400,332191073.788800,30227,31701,20886,82814
2017-08-29,NASDAQ BX (B),99526304,26632602,58303735,184462641,3584735957.773689,1362550400.919102,2459057361.567003,7406343720.259794,1005035,136626,581350,1723011
2017-08-29,NYSE (DN),75870660,33477811,93445729,202794200,2367924833.742410,1190155546.058097,2001547250.513700,5559627630.314207,158711,77076,184195,419982
2017-08-29,NASDAQ (DQ),871524214,333477746,575529299,1780531259,29878230975.861976,15769629743.016186,22214359379.173613,67862220098.051775,3149616,714106,1869301,5733023
2017-08-29,EDGA Equities (J),40950101,24102262,22878523,87930886,1313842045.956394,1187123877.871300,878335587.456900,3379301511.284594,374321,107904,175967,658192
2017-08-29,EDGX Equities (K),148946293,66728388,144186613,359861294,5339142619.905884,3373301631.290304,5196826532.657321,13909270783.853509,990737,277360,775946,2044043
2017-08-29,CHX (M),5006121,7008920,4791488,16806529,301880799.246800,640886008.220000,531147878.304500,1473914685.771300,1931,2388,1176,5495
2017-08-29,NYSE (N),680704354,0,0,680704354,24785307808.292843,0.000000,0.000000,24785307808.292843,2107159,0,0,2107159
2017-08-29,NYSE Arca (P),166304707,211916724,111325380,489546811,6882951316.229071,11621065609.367945,5458525700.375322,23962542625.972338,1266657,640569,822003,2729229
2017-08-29,NASDAQ (Q),251801576,95185336,410650548,757637460,11111275594.840710,5847616585.495411,20603656198.461028,37562548378.797149,2322810,432898,2485993,5241701
2017-08-29,IEX (V),69759230,14028735,33986015,117773980,3263915545.043210,728653833.665300,1751168796.190300,5743738174.898810,419925,57743,221956,699624
2017-08-29,NASDAQ PSX (X),13006713,12645887,13125276,38777876,493342101.883900,833347408.280201,762298773.499200,2088988283.663301,115741,53279,115764,284784
2017-08-29,BYX Equities (Y),146050289,52706381,77105128,275861798,4218362359.763450,2344979116.321903,2978138412.228592,9541479888.313945,1278294,260248,697011,2235553
2017-08-29,BZX Equities (Z),167421239,84145219,92513752,344080210,5657224501.750895,4884054224.319394,4482935393.415406,15024214119.485695,1297229,400737,768988,2466954
2017-08-28,NYSE American (A),2723939,9513099,2170680,14407718,118514197.287000,103508460.551800,101909946.230200,323932604.069000,31193,28983,21142,81318
2017-08-28,NASDAQ BX (B),96391112,26025409,53725924,176142445,3493296831.412678,1194668729.653002,2260681020.293794,6948646581.359474,975736,126851,562231,1664818
2017-08-28,NYSE (DN),78305062,30631773,70673795,179610630,2314030963.091608,975073296.103701,1854561853.477001,5143666112.672310,158800,73173,173107,405080
2017-08-28,NASDAQ (DQ),873816583,324476137,559552589,1757845309,32074913033.563615,14598933482.337285,22739160719.032691,69413007234.933591,3023621,724067,1803193,5550881
2017-08-28,EDGA Equities (J),37093319,18724144,21004626,76822089,1165138768.945396,924796935.461800,750152000.145899,2840087704.553095,336911,88266,164820,589997
2017-08-28,EDGX Equities (K),137663364,63907002,140625736,342196102,4906555727.049135,2970370855.980197,5180569039.767020,13057495622.796352,915611,250896,754190,1920697
2017-08-28,CHX (M),7017167,9995887,2731554,19744608,298337112.201800,665441488.940000,267013849.565000,1230792450.706800,2011,1851,1086,4948
2017-08-28,NYSE (N),705056239,0,0,705056239,28863205214.679458,0.000000,0.000000,28863205214.679458,1981817,0,0,1981817
2017-08-28,NYSE Arca (P),146188370,214433193,109232189,469853752,6095644720.752230,10999073949.211638,5358709375.381905,22453428045.345773,1139303,570066,796907,2506276
2017-08-28,NASDAQ (Q),234555697,86941984,410186626,731684307,10391701186.950495,4783996965.849882,21068000689.336995,36243698842.137372,2234623,387534,2410128,5032285
2017-08-28,IEX (V),63250587,14653835,29628092,107532514,2569477092.330569,683627082.849300,1587693611.676303,4840797786.856172,401075,59284,206866,667225
2017-08-28,NASDAQ PSX (X),12055435,11217383,11607053,34879871,462850688.885200,626073814.517500,656655504.958600,1745580008.361300,111467,49375,106093,266935
2017-08-28,BYX Equities (Y),139958699,48473515,70948120,259380334,3985279261.935507,2048622759.569491,2607627066.153610,8641529087.658608,1207469,237692,663569,2108730
2017-08-28,BZX Equities (Z),148844687,70743047,83032162,302619896,5161098110.378931,3703585871.106379,3888891441.298806,12753575422.784116,1197452,333922,692042,2223416
2017-08-25,NYSE American (A),1953163,7390458,1786366,11129987,79393469.019400,99033027.033300,90186003.225000,268612499.277700,23715,26074,19038,68827
2017-08-25,NASDAQ BX (B),98420805,27559640,55980787,181961232,3651298790.436773,1451709263.957296,2423794548.877300,7526802603.271369,1019636,136102,593917,1749655
2017-08-25,NYSE (DN),70356970,26525958,58985274,155868202,2095218035.156416,984088010.353200,1936827114.423798,5016133159.933414,152345,62264,167503,382112
2017-08-25,NASDAQ (DQ),815352757,280018850,503109506,1598481113,28803406642.946462,15437146837.084961,22190696938.853215,66431250418.884638,2935661,639837,1760078,5335576
2017-08-25,EDGA Equities (J),39913919,19642897,19967473,79524289,1315405288.086190,1177186336.011900,887381854.259198,3379973478.357288,369339,94317,180601,644257
2017-08-25,EDGX Equities (K),140713283,59281598,119623899,319618780,5333451634.240771,3467872910.349336,5282817568.710711,14084142113.300818,954959,241218,742260,1938437
2017-08-25,CHX (M),5684701,6082356,11380435,23147492,340625559.000000,584036602.630000,1247379151.431900,2172041313.061900,1813,2681,1307,5801
2017-08-25,NYSE (N),663406231,0,0,663406231,24636267256.465769,0.000000,0.000000,24636267256.465769,2040207,0,0,2040207
2017-08-25,NYSE Arca (P),150341003,201417819,101375836,453134658,6454843327.664747,12344344032.413823,5475074760.764049,24274262120.842619,1193211,625027,797932,2616170
2017-08-25,NASDAQ (Q),243348547,91250804,371508708,706108059,10933656391.665544,6442204862.718493,20419488039.276424,37795349293.660461,2274381,414144,2456855,5145380
2017-08-25,IEX (V),60816723,14498423,29248192,104563338,2691311334.205679,852844354.764600,1664137593.481999,5208293282.452278,397229,57088,203432,657749
2017-08-25,NASDAQ PSX (X),12355840,11037081,12759089,36152010,490846014.567300,762299219.528800,755150353.453000,2008295587.549100,113539,49830,114191,277560
2017-08-25,BYX Equities (Y),140135880,50998981,73446085,264580946,4223679652.021906,2488300681.768901,2841497703.032585,9553478036.823392,1241541,239825,688749,2170115
2017-08-25,BZX Equities (Z),150552020,72585358,86425816,309563194,5407388059.018174,4739949328.745091,4345748739.642214,14493086127.405479,1207473,354886,728604,2290963
2017-08-24,NYSE American (A),2078839,7926679,2013991,12019509,98966193.681000,94226800.505700,114658293.988100,307851288.174800,25084,28056,19826,72966
2017-08-24,NASDAQ BX (B),104078180,26678042,59629230,190385452,4099873179.520467,1402217153.065305,2633278626.381206,8135368958.966978,1069056,141311,601377,1811744
2017-08-24,NYSE (DN),80873242,29146623,70132174,180152039,2320868856.509510,1107443779.900202,2200040100.536308,5628352736.946020,159146,66563,177770,403479
2017-08-24,NASDAQ (DQ),913633619,307404057,581935496,1802973172,30592050027.106474,15597340094.376905,26511193515.779155,72700583637.262534,3066112,658464,1818549,5543125
2017-08-24,EDGA Equities (J),42159353,18650602,22736870,83546825,1346961933.680503,1046472009.542098,942283166.679900,3335717109.902501,382634,95168,193562,671364
2017-08-24,EDGX Equities (K),151423720,61052894,136824788,349301402,5622830186.313886,3412201111.647906,5925404193.296789,14960435491.258581,1020429,268260,814345,2103034
2017-08-24,CHX (M),5939460,8394682,7856547,22190689,403626449.350000,637501285.290000,560941414.858700,1602069149.498700,2180,2569,1493,6242
2017-08-24,NYSE (N),718878397,0,0,718878397,26880887244.595571,0.000000,0.000000,26880887244.595571,2133853,0,0,2133853
2017-08-24,NYSE Arca (P),165886143,195624641,114653338,476164122,6841384469.438135,10938734421.284514,5891002879.355917,23671121770.078566,1285528,630568,884234,2800330
2017-08-24,NASDAQ (Q),272786873,87263509,401317146,761367528,12107349095.018031,5534380471.643464,22066998181.295542,39708727747.957037,2517159,444979,2684388,5646526
2017-08-24,IEX (V),67226358,12839250,33656931,113722539,2717604935.663396,721798718.168400,1876547086.764203,5315950740.595999,430031,55181,217805,703017
2017-08-24,NASDAQ PSX (X),14208986,12096547,14027885,40333418,552045530.571000,765535520.740000,854417608.626399,2171998659.937399,129757,56798,124673,311228
2017-08-24,BYX Equities (Y),147405605,47460431,77961507,272827543,4383356010.657549,2289750899.775291,3074124989.718033,9747231900.150873,1301120,235060,708691,2244871
2017-08-24,BZX Equities (Z),163104956,69952447,95919800,328977203,5835475653.502530,4332595497.642413,4669352531.536988,14837423682.681931,1294748,388084,790213,2473045
2017-08-23,NYSE American (A),2450987,8787466,1821486,13059939,106793891.995000,94269332.142000,98716236.883700,299779461.020700,28408,28520,19751,76679
2017-08-23,NASDAQ BX (B),100850737,23619321,55351619,179821677,3694451768.265831,1215076901.592599,2230855092.727896,7140383762.586326,1027774,123319,574637,1725730
2017-08-23,NYSE (DN),72049211,26505716,63710109,162265036,2248702621.280203,968191359.087194,1940158818.512007,5157052798.879404,160496,64679,173368,398543
2017-08-23,NASDAQ (DQ),934636466,283797491,562172495,1780606452,32909027351.625730,14413541939.030640,24064614539.097582,71387183829.753952,3198212,616432,1802555,5617199
2017-08-23,EDGA Equities (J),41350033,17333674,20848372,79532079,1305221295.250701,953348579.104500,823545928.839803,3082115803.195004,369345,87357,177038,633740
2017-08-23,EDGX Equities (K),152639909,55983554,129698879,338322342,5517511416.423534,2953324067.834188,5107522261.697779,13578357745.955501,1006099,252363,755946,2014408
2017-08-23,CHX (M),8790426,9812910,4713680,23317016,387234587.663000,824548127.030000,428300116.222300,1640082830.915300,2240,2276,1378,5894
2017-08-23,NYSE (N),681996140,0,0,681996140,25069088061.724776,0.000000,0.000000,25069088061.724776,2085737,0,0,2085737
2017-08-23,NYSE Arca (P),159644521,182512089,109022797,451179407,6628193643.437899,10662801874.391320,5222391923.274083,22513387441.103302,1238759,532909,816672,2588340
2017-08-23,NASDAQ (Q),255298700,82514832,378321032,716134564,11072279138.196292,5467086315.718801,19402018714.458929,35941384168.374022,2291410,403894,2382119,5077423
2017-08-23,IEX (V),62334913,12376443,31117696,105829052,2430101516.350189,705220128.740800,1521446092.744699,4656767737.835688,405546,52974,204672,663192
2017-08-23,NASDAQ PSX (X),12790448,9827714,13825621,36443783,481960753.760599,695235741.606399,744366502.201500,1921562997.568498,114562,45857,120635,281054
2017-08-23,BYX Equities (Y),148937002,43410169,73962241,266309412,4274000205.433276,2065098534.821701,2713655908.083797,9052754648.338774,1280490,223093,689938,2193521
2017-08-23,BZX Equities (Z),163185701,64499696,90758286,318443683,5678453908.587008,4149703176.436503,4155271838.513481,13983428923.536992,1290632,336296,733679,2360607
2017-08-22,NYSE American (A),2180772,7604995,1735319,11521086,92603928.083000,96992491.375000,87080636.584200,276677056.042200,25744,25327,19527,70598
2017-08-22,NASDAQ BX (B),104074536,27353247,57956865,189384648,3870668314.725413,1393966692.425103,2386404497.481695,7651039504.632211,1059592,133627,586460,1779679
2017-08-22,NYSE (DN),70780891,26722889,78440658,175944438,2252229769.899312,918839716.013504,1887601766.707897,5058671252.620713,153776,65422,176136,395334
2017-08-22,NASDAQ (DQ),931058015,317365360,583674967,1832098342,31804670632.168228,15309426232.165946,24315739246.032994,71429836110.367168,3306306,707440,1897578,5911324
2017-08-22,EDGA Equities (J),41805728,22865142,21198146,85869016,1360782962.320797,1218082726.349701,902091159.664797,3480956848.335295,378348,100502,178982,657832
2017-08-22,EDGX Equities (K),146418350,61549936,138885935,346854221,5454999708.630531,3353041531.744988,5436889241.404204,14244930481.779723,990082,232274,775586,1997942
2017-08-22,CHX (M),10648378,10488687,5172626,26309691,632911987.649100,873349560.255000,393317562.537700,1899579110.441800,2501,2797,1374,6672
2017-08-22,NYSE (N),688327902,0,0,688327902,25627904175.626045,0.000000,0.000000,25627904175.626045,2173799,0,0,2173799
2017-08-22,NYSE Arca (P),156454518,216200710,108348826,481004054,6624486782.124514,12023840200.225048,5434446364.652711,24082773347.002273,1239780,547731,822626,2610137
2017-08-22,NASDAQ (Q),245429826,92747131,392898237,731075194,10921340118.009324,6016645924.914970,21099031569.906383,38037017612.830677,2270050,375082,2454314,5099446
2017-08-22,IEX (V),65638415,14751661,31984402,112374478,2576495832.849999,875730421.616100,1618761301.009898,5070987555.475997,428778,59446,217221,705445
2017-08-22,NASDAQ PSX (X),12180897,11422431,13333323,36936651,465599285.494000,795860456.018300,755734124.921001,2017193866.433301,110558,48397,112440,271395
2017-08-22,BYX Equities (Y),145705092,55177573,76035401,276918066,4319557474.143915,2430052323.771496,2944414629.115884,9694024427.031295,1272780,249570,686945,2209295
2017-08-22,BZX Equities (Z),160290200,71835645,90095408,322221253,5700182621.481189,4517739248.943395,4323701954.099182,14541623824.523766,1273175,313787,735892,2322854
2017-08-21,NYSE American (A),2362743,7506848,1561370,11430961,91496206.490000,106551044.609100,71974658.495000,270021909.594100,28266,26436,18713,73415
2017-08-21,NASDAQ BX (B),103076755,28151513,54493986,185722254,3651900643.559083,1362909680.833100,2194339646.377101,7209149970.769284,1035950,139764,578489,1754203
2017-08-21,NYSE (DN),75327927,31568718,83399533,190296178,2101664885.247516,1112609177.166801,2210271469.430204,5424545531.844521,152839,69705,175584,398128
2017-08-21,NASDAQ (DQ),914499731,323082353,549483952,1787066036,31666037565.406512,17879984921.919647,24201034346.689218,73747056834.015377,3151857,730310,1791692,5673859
2017-08-21,EDGA Equities (J),42865128,22824258,21287545,86976931,1344689930.457097,1157851315.922599,899533762.009800,3402075008.389496,378799,95748,184267,658814
2017-08-21,EDGX Equities (K),144702724,65794869,139894441,350392034,5153627780.356085,3403432702.669497,5187184570.941094,13744245053.966676,979672,260506,756116,1996294
2017-08-21,CHX (M),5128115,15905863,3971625,25005603,286166770.425000,891900914.960000,313086873.993000,1491154559.378000,2375,3418,1607,7400
2017-08-21,NYSE (N),713495757,0,0,713495757,26615805854.099705,0.000000,0.000000,26615805854.099705,2130833,0,0,2130833
2017-08-21,NYSE Arca (P),158553213,207296347,110114163,475963723,6416186487.143645,10879714701.289229,5262485460.337489,22558386648.770363,1249838,622590,822720,2695148
2017-08-21,NASDAQ (Q),255111584,100721512,410296498,766129594,10938756060.233609,5916266324.050015,21186469359.688912,38041491743.972536,2327896,425491,2501355,5254742
2017-08-21,IEX (V),65242199,14018794,32936265,112197258,2493585239.114586,790387632.587000,1613793179.971100,4897766051.672686,439853,58965,223965,722783
2017-08-21,NASDAQ PSX (X),12622085,12624582,13357321,38603988,468835716.204999,804343408.120700,775706757.884800,2048885882.210499,112469,50595,114921,277985
2017-08-21,BYX Equities (Y),144931247,50652052,70076747,265660046,4199766269.976970,2116949371.792502,2633657677.993795,8950373319.763267,1227024,230461,657807,2115292
2017-08-21,BZX Equities (Z),165737094,80198143,92116772,338052009,5620519780.501382,4731541485.283095,4491642717.597927,14843703983.382404,1304735,352254,751655,2408644
2017-08-18,NYSE American (A),2909280,10621057,2325653,15855990,127587127.460000,169306007.417100,119326415.196300,416219550.073400,33976,35640,24494,94110
2017-08-18,NASDAQ BX (B),115569027,43641267,59482454,218692748,4148200199.913903,2145478357.932201,2482996904.768900,8776675462.615004,1123198,194710,603555,1921463
2017-08-18,NYSE (DN),87747773,36920426,129664276,254332475,2526157922.997806,1448491307.605098,2304505805.173895,6279155035.776799,172092,83176,195912,451180
2017-08-18,NASDAQ (DQ),1050921014,455468414,673464409,2179853837,35017131610.202704,29030928944.601134,25482857426.107862,89530917980.911700,3505070,911292,1915174,6331536
2017-08-18,EDGA Equities (J),49755734,37625924,28280746,115662404,1517564481.096010,1987792193.196602,1025273778.734297,4530630453.026909,427454,146735,197624,771813
2017-08-18,EDGX Equities (K),177876168,101744707,170070822,449691697,6165718190.885772,5753170025.104708,5989439824.795489,17908328040.785969,1130020,404261,849358,2383639
2017-08-18,CHX (M),12876263,13707426,11660840,38244529,768721197.102500,1987749145.355201,1352840655.663000,4109310998.120701,2674,4936,2319,9929
2017-08-18,NYSE (N),924628769,0,0,924628769,36175191782.738357,0.000000,0.000000,36175191782.738357,2556783,0,0,2556783
2017-08-18,NYSE Arca (P),222125365,340310595,133684034,696119994,8331324469.014815,19154338981.227079,6662392079.579219,34148055529.821113,1468801,946662,959283,3374746
2017-08-18,NASDAQ (Q),310862726,159717224,518742966,989322916,13153847821.317001,10000805167.538402,26531704638.825401,49686357627.680804,2772993,646656,2867402,6287051
2017-08-18,IEX (V),74626540,19855689,32087908,126570137,2992490463.213111,1165070136.942400,1706839528.612299,5864400128.767810,462860,79803,218954,761617
2017-08-18,NASDAQ PSX (X),21549761,18988097,14951355,55489213,641871376.967000,1336872546.596901,906282481.744199,2885026405.308100,133832,73437,125878,333147
2017-08-18,BYX Equities (Y),173036350,80368351,84328279,337732980,4872006319.092094,3526879062.509094,3130566143.775008,11529451525.376196,1423504,327046,736784,2487334
2017-08-18,BZX Equities (Z),202486299,131881303,109728639,444096241,6911284772.556293,8026833270.074184,5530965679.662420,20469083722.292897,1517021,544733,877949,2939703
2017-08-17,NYSE American (A),3372971,10100240,2704951,16178162,160341689.655000,155632850.150700,135252816.166700,451227355.972400,43527,37537,27941,109005
2017-08-17,NASDAQ BX (B),120256052,46547217,68952594,235755863,4559910694.108283,2217643409.616602,2816564162.054994,9594118265.779879,1209584,201918,704000,2115502
2017-08-17,NYSE (DN),82580233,40820166,116805827,240206226,2708065890.397307,1648931924.519299,2388543568.710814,6745541383.627420,175267,90635,210765,476667
2017-08-17,NASDAQ (DQ),996120826,448597156,731995572,2176713554,35843690699.229398,25977529995.360875,30784537510.713979,92605758205.304252,3423703,919540,2060662,6403905
2017-08-17,EDGA Equities (J),51915974,34235896,29659090,115810960,1716138900.298989,1900917791.915402,1206742429.097000,4823799121.311391,463751,142817,237241,843809
2017-08-17,EDGX Equities (K),178889935,103095171,181817810,463802916,6976592245.182978,5595111004.445252,6991409604.392018,19563112854.020248,1220268,420520,987087,2627875
2017-08-17,CHX (M),10007313,20303926,4205312,34516551,658355495.686100,2242424943.449999,443590149.014700,3344370588.150799,3030,3816,1822,8668
2017-08-17,NYSE (N),766630180,0,0,766630180,29241326651.831849,0.000000,0.000000,29241326651.831849,2565934,0,0,2565934
2017-08-17,NYSE Arca (P),200743118,355072101,150519307,706334526,9027548682.848443,19465641168.634425,7659286165.434453,36152476016.917321,1521712,1040052,1115378,3677142
2017-08-17,NASDAQ (Q),303307185,166853297,493498945,963659427,13755101485.923748,10408796183.866518,26170597700.844332,50334495370.634598,2751357,686550,3170544,6608451
2017-08-17,IEX (V),73257645,20776329,37265059,131299033,3185234957.746403,1288896356.950900,2004590024.132802,6478721338.830105,479215,86516,250574,816305
2017-08-17,NASDAQ PSX (X),14659000,22045235,19566989,56271224,578749230.215001,1434345882.057202,1174667237.409500,3187762349.681703,133583,81609,165610,380802
2017-08-17,BYX Equities (Y),169218371,85237663,91295976,345752010,5083442960.292424,3861980694.354416,3464987875.794311,12410411530.441151,1441140,349533,815322,2605995
2017-08-17,BZX Equities (Z),193995928,137127019,124656167,455779114,7099441140.701777,8207318538.472311,6327683758.233888,21634443437.407976,1547255,578156,1003186,3128597
2017-08-16,NYSE American (A),3382403,7041031,1890589,12314023,142673797.790000,94462806.069200,97443718.798200,334580322.657400,39903,27227,20880,88010
2017-08-16,NASDAQ BX (B),108976352,28731076,59580857,197288285,4047001842.414182,1408773469.896797,2384284835.142105,7840060147.453084,1101548,133942,619715,1855205
2017-08-16,NYSE (DN),81942410,29977697,97846806,209766913,2570271593.806232,1076556386.042703,2137666658.053494,5784494637.902429,167046,70685,199062,436793
2017-08-16,NASDAQ (DQ),940971236,329175080,664197420,1934343736,31928953943.219422,15442389805.613701,24741859823.928286,72113203572.761409,3203021,750313,1917976,5871310
2017-08-16,EDGA Equities (J),45848882,24572071,23564366,93985319,1441748741.923809,1283448188.786800,889294773.000501,3614491703.711110,398918,107437,196678,703033
2017-08-16,EDGX Equities (K),165870235,70950081,164610379,401430695,6028892538.507087,3601351048.365409,6042687114.507589,15672930701.380085,1118486,285070,872885,2276441
2017-08-16,CHX (M),10921364,12378818,4583652,27883834,484658092.968000,1009383868.510000,457915664.657600,1951957626.135600,2757,2930,2481,8168
2017-08-16,NYSE (N),730995964,0,0,730995964,27062834823.340983,0.000000,0.000000,27062834823.340983,2315652,0,0,2315652
2017-08-16,NYSE Arca (P),179169457,251880191,127540683,558590331,7227216906.691884,12395436548.145557,6216855540.726912,25839508995.564353,1356862,645274,938633,2940769
2017-08-16,NASDAQ (Q),272642290,111175403,425415029,809232722,11773117203.371110,6350505186.986292,21777059121.002961,39900681511.360363,2420322,453207,2741996,5615525
2017-08-16,IEX (V),71710220,14808645,36369532,122888397,2995553289.953001,828073517.931900,1803149505.828005,5626776313.712906,447394,61298,236549,745241
2017-08-16,NASDAQ PSX (X),13599080,13665137,14709365,41973582,492095497.632400,952216339.164599,792904887.458800,2237216724.255799,118376,50912,124237,293525
2017-08-16,BYX Equities (Y),151736239,59580381,83193041,294509661,4430490612.709205,2445235575.532499,2915195782.350587,9790921970.592291,1295828,247780,727830,2271438
2017-08-16,BZX Equities (Z),178810327,86983478,105574271,371368076,6232023302.841798,4988770540.865716,4915890590.818093,16136684434.525607,1403550,384497,853352,2641399
2017-08-15,NYSE American (A),2748001,7421987,1563954,11733942,106288697.920000,81745323.891900,76397624.261500,264431646.073400,30952,25222,17443,73617
2017-08-15,NASDAQ BX (B),105902793,24055124,58234020,188191937,4103050387.881520,1196929460.126100,2361223138.359302,7661202986.366922,1089840,115462,616142,1821444
2017-08-15,NYSE (DN),79139374,27859450,66560913,173559737,2486978996.803105,996925712.411200,2262634863.255097,5746539572.469402,174129,66637,181843,422609
2017-08-15,NASDAQ (DQ),961988748,304043873,572691339,1838723960,33450224419.028342,15679152089.086190,24034523371.473683,73163899879.588215,3304956,718521,1846159,5869636
2017-08-15,EDGA Equities (J),43673771,19184628,21212006,84070405,1408707704.598198,987962543.388998,869300775.550899,3265971023.538095,401907,83933,191952,677792
2017-08-15,EDGX Equities (K),163463950,54951867,131524371,349940188,6035001035.418695,2893625966.218294,5373369975.982314,14301996977.619303,1078501,219924,792036,2090461
2017-08-15,CHX (M),7266833,10657347,5312545,23236725,404748252.447400,1258943040.260000,486796933.290600,2150488225.998000,2160,1671,2660,6491
2017-08-15,NYSE (N),700914785,0,0,700914785,26313141751.186152,0.000000,0.000000,26313141751.186152,2254848,0,0,2254848
2017-08-15,NYSE Arca (P),175981667,200939517,109453726,486374910,7262152448.836414,10009566601.046744,5379279915.659999,22650998965.543157,1314048,516813,823863,2654724
2017-08-15,NASDAQ (Q),267752797,78788359,395490241,742031397,11637129733.678085,4805947047.463602,20651910355.993265,37094987137.134952,2419175,337244,2548639,5305058
2017-08-15,IEX (V),76416483,13475885,37639195,127531563,3032216136.359722,681511951.994900,2080440442.838696,5794168531.193318,485979,56285,245325,787589
2017-08-15,NASDAQ PSX (X),14605131,9677500,13137892,37420523,547198214.282799,622327530.279000,693661068.704900,1863186813.266699,125446,38579,115263,279288
2017-08-15,BYX Equities (Y),146869834,47481940,76905598,271257372,4450247049.879118,2020756499.761500,2814205688.375812,9285209238.016430,1294699,207299,714015,2216013
2017-08-15,BZX Equities (Z),175714815,65150628,92839369,333704812,6087839936.035809,3856060708.672685,4216120911.073905,14160021555.782399,1381197,289989,763153,2434339
2017-08-14,NYSE American (A),2994696,8384921,1882236,13261853,132912706.060000,112168685.172100,95176766.362600,340258157.594700,35519,26905,21003,83427
2017-08-14,NASDAQ BX (B),104706356,28478734,59535139,192720229,3977758369.209714,1427281898.800797,2376633573.355401,7781673841.365912,1077692,135925,621753,1835370
2017-08-14,NYSE (DN),70475737,28299239,67963096,166738072,2124789491.392413,1027029337.569098,2497167854.129702,5648986683.091213,158560,70702,183081,412343
2017-08-14,NASDAQ (DQ),904320424,324781811,611484224,1840586459,30534298444.505466,17023054457.613775,26212532530.404870,73769885432.524111,3112933,751128,1955451,5819512
2017-08-14,EDGA Equities (J),42190842,20900904,22705661,85797407,1304921361.285099,1198764564.535701,910014182.835401,3413700108.656201,380436,94248,189293,663977
2017-08-14,EDGX Equities (K),146293798,64443704,141355425,352092927,5160031521.202189,3563412430.309187,6076430909.314401,14799874860.825777,978659,243407,829216,2051282
2017-08-14,CHX (M),4669994,12182917,3945813,20798724,240574404.461400,1765716748.130000,280788662.164200,2287079814.755600,2237,3587,2404,8228
2017-08-14,NYSE (N),744056218,0,0,744056218,28097742854.960055,0.000000,0.000000,28097742854.960055,2205547,0,0,2205547
2017-08-14,NYSE Arca (P),161416868,244791812,115901929,522110609,6676053760.769564,13530419280.321367,6028356971.485197,26234830012.576128,1227279,621181,857494,2705954
2017-08-14,NASDAQ (Q),246135838,93864192,445759436,785759466,10636610090.312334,6152600265.077833,23710146369.258453,40499356724.648620,2265946,382099,2666302,5314347
2017-08-14,IEX (V),67472924,15321109,36672733,119466766,2733965694.779491,823191214.104600,1718327153.165902,5275484062.049993,436885,64583,238031,739499
2017-08-14,NASDAQ PSX (X),12417734,12021030,13261002,37699766,472506487.900899,806360823.323900,740318340.820200,2019185652.044999,114010,46364,114222,274596
2017-08-14,BYX Equities (Y),149526231,56035788,80432134,285994153,4424776888.000228,2518703004.177000,2900417921.132800,9843897813.310028,1288466,235549,716483,2240498
2017-08-14,BZX Equities (Z),167642539,76155237,101674664,345472440,5746637650.112138,4786266305.890107,4824801616.470198,15357705572.472443,1316159,326176,810913,2453248
2017-08-11,NYSE American (A),2882222,9282962,2102079,14267263,97098002.330000,117045402.543700,105830122.368200,319973527.241900,30572,33321,22024,85917
2017-08-11,NASDAQ BX (B),118101360,35029570,67688938,220819868,4194788828.716998,1737130071.454503,2796980541.182114,8728899441.353615,1173124,160753,692354,2026231
2017-08-11,NYSE (DN),86503919,32647532,66170246,185321697,2336131872.214802,1238128987.265001,2441423740.079297,6015684599.559100,174007,79082,194618,447707
2017-08-11,NASDAQ (DQ),959489022,402368103,613234133,1975091258,29815982026.679123,21385319335.277563,26025802012.378900,77227103374.335586,3308775,842800,2042290,6193865
2017-08-11,EDGA Equities (J),51922561,28254987,26670667,106848215,1553317951.423212,1482804518.311101,1151986315.477500,4188108785.211813,443894,122941,224747,791582
2017-08-11,EDGX Equities (K),177955034,81725115,151769894,411450043,5840290195.414144,4503249842.680025,6464344641.959220,16807884680.053389,1140688,343891,941209,2425788
2017-08-11,CHX (M),6061015,8682300,6862101,21605416,249493638.007000,775160319.510000,583172384.522700,1607826342.039700,2817,3463,2291,8571
2017-08-11,NYSE (N),792229242,0,0,792229242,27726962742.365588,0.000000,0.000000,27726962742.365588,2505719,0,0,2505719
2017-08-11,NYSE Arca (P),201471198,298645093,141771907,641888198,7755028686.388072,16377221766.697975,7283124162.043785,31415374615.129832,1490042,819357,1044095,3353494
2017-08-11,NASDAQ (Q),293845757,124599775,457450844,875896376,12269402566.730576,7937058427.490091,23951303367.776682,44157764361.997349,2617281,526649,3037278,6181208
2017-08-11,IEX (V),82433104,20075317,40974643,143483064,3097706350.551502,1118963445.697401,2068892663.637298,6285562459.886201,501623,79351,269117,850091
2017-08-11,NASDAQ PSX (X),15110837,15627137,15847595,46585569,554050992.815900,994859606.357800,906790950.317100,2455701549.490800,130726,58629,128353,317708
2017-08-11,BYX Equities (Y),173076847,69168866,87945417,330191130,4914822122.234809,2957725055.300499,3202636226.933720,11075183404.469028,1442040,295079,785499,2522618
2017-08-11,BZX Equities (Z),200750657,102726782,121298732,424776171,6722765258.995987,6018639506.741500,5806776673.653287,18548181439.390774,1535271,451346,972465,2959082
2017-08-10,NYSE American (A),3354540,12199489,2320352,17874381,129764452.588300,176302838.384200,107870214.048100,413937505.020600,37719,38885,25039,101643
2017-08-10,NASDAQ BX (B),130260850,47842802,73957580,252061232,4810903486.653595,2255486160.423501,3112547229.766805,10178936876.843901,1250389,213008,717096,2180493
2017-08-10,NYSE (DN),99362315,46858251,102319801,248540367,2800856588.239703,1790292355.491705,3658201883.318400,8249350827.049808,209985,106719,256003,572707
2017-08-10,NASDAQ (DQ),1177939367,563867265,788155166,2529961798,39527093067.513689,29586378764.826037,36375435743.415498,105488907575.755224,3921891,1107770,2499621,7529282
2017-08-10,EDGA Equities (J),55523237,38563707,30062929,124149873,1725671913.326497,2020132379.565899,1334015553.176092,5079819846.068488,478263,171353,248446,898062
2017-08-10,EDGX Equities (K),208289507,114662346,186979180,509931033,7115691602.875003,6268269342.144190,8970703223.284514,22354664168.303707,1321005,464561,1116365,2901931
2017-08-10,CHX (M),11642717,15602746,6259935,33505398,469271134.326800,1181598269.569999,424200694.178000,2075070098.074799,2771,4482,2702,9955
2017-08-10,NYSE (N),859548556,0,0,859548556,31671693205.266358,0.000000,0.000000,31671693205.266358,2900083,0,0,2900083
2017-08-10,NYSE Arca (P),229881280,428936129,165631261,824448670,9066816735.052914,22866381454.498255,9151982364.387440,41085180553.938609,1686542,1148045,1220377,4054964
2017-08-10,NASDAQ (Q),342790405,171699341,547902035,1062391781,14583978776.507200,10687001045.396977,31548126922.471470,56819106744.375647,3046031,697702,3666850,7410583
2017-08-10,IEX (V),91126754,28709890,49945121,169781765,3611890985.568979,1603479503.571395,2601763445.429595,7817133934.569969,565384,113747,322423,1001554
2017-08-10,NASDAQ PSX (X),17133588,20983931,19732744,57850263,685852078.905199,1401171731.848600,1158654545.235301,3245678355.989100,152023,80250,160770,393043
2017-08-10,BYX Equities (Y),185945052,97871639,102274379,386091070,5427787214.363211,4278737036.118901,3903224025.792421,13609748276.274533,1551088,409531,877719,2838338
2017-08-10,BZX Equities (Z),223021868,144503568,139450978,506976414,7822057148.569428,8845339873.859920,7194345679.157887,23861742701.587235,1745066,603579,1108751,3457396
2017-08-09,NYSE American (A),2731898,10323102,1987011,15042011,104526017.070000,112924509.678400,89060654.849200,306511181.597600,29862,32759,20784,83405
2017-08-09,NASDAQ BX (B),116105501,29752736,69141238,214999475,4289042262.150307,1486748830.284203,2814896930.411505,8590688022.846015,1145338,143236,677662,1966236
2017-08-09,NYSE (DN),90160446,34071501,86761418,210993365,2726876506.929000,1163486378.525102,2707771303.874600,6598134189.328702,179882,79961,213081,472924
2017-08-09,NASDAQ (DQ),1072731570,407886424,742910140,2223528134,37699569023.851665,19164063235.344425,31277815886.979927,88141448146.176017,3708733,809548,2382148,6900429
2017-08-09,EDGA Equities (J),49414780,24793643,27430275,101638698,1556445473.031200,1244593961.699201,1153911671.600703,3954951106.331104,424847,112597,224332,761776
2017-08-09,EDGX Equities (K),176647358,75874154,164525070,417046582,6370758165.105085,3812149889.070519,6811597470.559114,16994505524.734718,1181050,300582,975684,2457316
2017-08-09,CHX (M),22327327,8856215,4503297,35686839,526227934.419500,738735106.982000,413481369.865200,1678444411.266700,2436,4004,2029,8469
2017-08-09,NYSE (N),805958128,0,0,805958128,29316212990.464884,0.000000,0.000000,29316212990.464884,2576239,0,0,2576239
2017-08-09,NYSE Arca (P),198181941,275823550,151144039,625149530,8503283904.909566,14146902617.779421,7442265526.048461,30092452048.737448,1531714,708650,1089703,3330067
2017-08-09,NASDAQ (Q),300951524,109520895,503637900,914110319,13380707662.844899,6608808436.282101,26025997492.197349,46015513591.324349,2743406,461048,3258825,6463279
2017-08-09,IEX (V),87548926,16615906,53605662,157770494,3526574529.197409,899320587.640999,2721727502.540505,7147622619.378913,533054,68726,326557,928337
2017-08-09,NASDAQ PSX (X),13999726,13331241,16918077,44249044,570263897.610000,858662340.924100,965310103.228400,2394236341.762500,132239,53598,141337,327174
2017-08-09,BYX Equities (Y),170395564,61948802,91908443,324252809,5041626016.394277,2590375380.294496,3468045744.273917,11100047140.962690,1434727,266638,811148,2512513
2017-08-09,BZX Equities (Z),203808492,89381386,123343573,416533451,7408751293.110490,5189381113.825488,5855915653.305003,18454048060.240981,1613131,390591,989575,2993297
2017-08-08,NYSE American (A),2798891,8694188,1719008,13212087,116128974.769000,105862673.111900,80983966.815000,302975614.695900,28181,28633,17299,74113
2017-08-08,NASDAQ BX (B),118416312,30332126,66741080,215489518,4506359434.869859,1465690978.877300,2762103145.277099,8734153559.024258,1174733,136630,680001,1991364
2017-08-08,NYSE (DN),96385297,31010012,88563041,215958350,2804808283.746119,1083910604.787002,2829777498.508116,6718496387.041237,195118,75132,217318,487568
2017-08-08,NASDAQ (DQ),1098731589,346598706,708470158,2153800453,38074585578.736847,18003518121.058886,30418723008.380949,86496826708.176682,3660199,771632,2270967,6702798
2017-08-08,EDGA Equities (J),52047191,21977030,25443745,99467966,1630392438.470891,1164057706.574100,1032023703.885799,3826473848.930790,449924,96053,216586,762563
2017-08-08,EDGX Equities (K),188084308,66847493,153848471,408780272,6544410403.032027,3386676525.357306,6748006161.376991,16679093089.766324,1231155,267463,955957,2454575
2017-08-08,CHX (M),8571154,8563493,4700786,21835433,371359065.479300,886414178.880000,460814285.667500,1718587530.026800,3031,3715,1657,8403
2017-08-08,NYSE (N),772306626,0,0,772306626,28409430556.770388,0.000000,0.000000,28409430556.770388,2625570,0,0,2625570
2017-08-08,NYSE Arca (P),207556005,246027058,139361505,592944568,8381988553.403011,13388062932.903520,7351943643.136165,29121995129.442696,1561044,625769,1033641,3220454
2017-08-08,NASDAQ (Q),322658375,101388000,477959793,902006168,13859041822.395953,6266751429.626690,25139435807.312734,45265229059.335377,2861138,422063,3221843,6505044
2017-08-08,IEX (V),84866495,15891404,43352279,144110178,3483646728.754905,887789116.267900,2289054487.465796,6660490332.488601,505038,68977,276265,850280
2017-08-08,NASDAQ PSX (X),15907788,13406765,15884798,45199351,589570082.506501,850240157.426600,883294605.415900,2323104845.349001,141539,51892,135074,328505
2017-08-08,BYX Equities (Y),172209870,61101922,90825107,324136899,5110636522.163919,2544111768.785908,3463286950.152387,11118035241.102214,1454812,264771,821868,2541451
2017-08-08,BZX Equities (Z),206944251,78456358,114629436,400030045,7102597680.578221,4551876901.542218,5286290274.878286,16940764856.998725,1628219,349293,939265,2916777
2017-08-07,NYSE American (A),2146377,13796721,1333159,17276257,91623513.355000,85295098.036800,55694999.725000,232613611.116800,21396,30262,14306,65964
2017-08-07,NASDAQ BX (B),103597064,19210191,60623953,183431208,4061029957.735906,879933879.943601,2474266169.526102,7415230007.205609,1051641,94217,620510,1766368
2017-08-07,NYSE (DN),88483395,24677951,77526426,190687772,2485027566.651911,726862951.941400,2445613537.394099,5657504055.987410,185523,69392,199964,454879
2017-08-07,NASDAQ (DQ),954823046,267481385,631589979,1853894410,32457092077.323591,12513201668.463064,25659269574.637280,70629563320.423935,3303461,643196,2041339,5987996
2017-08-07,EDGA Equities (J),42477537,15308105,21321241,79106883,1387091594.230395,727117524.758500,888868975.343501,3003078094.332396,380072,69337,190171,639580
2017-08-07,EDGX Equities (K),156199281,45241605,135616489,337057375,5721019626.786415,2001306485.459102,5582356550.777495,13304682663.023012,1042710,171499,816126,2030335
2017-08-07,CHX (M),11630198,7122350,4959549,23712097,277602312.963300,645009700.839600,357032681.334500,1279644695.137400,2286,1737,1169,5192
2017-08-07,NYSE (N),743952993,0,0,743952993,28562928141.522470,0.000000,0.000000,28562928141.522470,2236591,0,0,2236591
2017-08-07,NYSE Arca (P),167003993,160531652,113761050,441296695,6949304469.138286,8693995960.512799,5379436738.668614,21022737168.319699,1294578,388280,852360,2535218
2017-08-07,NASDAQ (Q),255341714,59146994,427201326,741690034,11450662740.540413,3147208106.929199,21647685287.495778,36245556134.965390,2351228,258870,2714388,5324486
2017-08-07,IEX (V),78888816,12318831,43201993,134409640,3311307329.073795,567665215.230000,2206849139.688905,6085821683.992700,474476,51562,265937,791975
2017-08-07,NASDAQ PSX (X),12520645,7871433,12824994,33217072,486834338.470000,439251671.800900,677028869.550100,1603114879.821000,117098,32491,112059,261648
2017-08-07,BYX Equities (Y),147895861,37598029,78224151,263718041,4499693887.690390,1627453003.006201,2858098806.509190,8985245697.205781,1293498,169672,712461,2175631
2017-08-07,BZX Equities (Z),170171448,47384841,95831035,313387324,6097186718.466446,2581573383.932696,4283599901.058111,12962360003.457253,1388646,215696,799555,2403897
2017-08-04,NYSE American (A),2440788,11850067,1692717,15983572,112505588.785000,129017813.741400,78669537.250000,320192939.776400,25883,31756,16089,73728
2017-08-04,NASDAQ BX (B),116195604,28421276,64718969,209335849,4432800805.829864,1273771757.486404,2630102795.266402,8336675358.582670,1151898,120100,652649,1924647
2017-08-04,NYSE (DN),87597303,31649584,89498530,208745417,2510126963.963423,957616639.144901,2572075442.991001,6039819046.099325,182816,73477,206600,462893
2017-08-04,NASDAQ (DQ),1047500037,351503830,700300077,2099303944,35357845584.909460,17923197825.205991,28134887395.634404,81415930805.749855,3559700,693252,2253782,6506734
2017-08-04,EDGA Equities (J),49169923,22241272,25095785,96506980,1569182665.165501,1152419446.573302,969026701.244701,3690628812.983504,417643,94571,204566,716780
2017-08-04,EDGX Equities (K),181398125,61296453,156181984,398876562,6497889037.856131,2932176129.090903,6280131510.630626,15710196677.577660,1160593,233760,917562,2311915
2017-08-04,CHX (M),6478654,9322792,5286740,21088186,256173315.142800,754907042.800600,619208453.113500,1630288811.056900,2927,2907,1394,7228
2017-08-04,NYSE (N),784972298,0,0,784972298,29334410273.368321,0.000000,0.000000,29334410273.368321,2476400,0,0,2476400
2017-08-04,NYSE Arca (P),196333917,226219639,134779354,557332910,8127135487.398121,11610878445.414524,6561747425.331817,26299761358.144462,1459186,539399,996160,2994745
2017-08-04,NASDAQ (Q),305649674,92865397,472490276,871005347,13405528135.373222,5337005438.939283,23979122506.707870,42721656081.020375,2696010,370272,3038656,6104938
2017-08-04,IEX (V),83152449,14880341,47483750,145516540,3472715377.747793,768064316.973599,2152796326.329103,6393576021.050495,497847,58218,287705,843770
2017-08-04,NASDAQ PSX (X),16044789,11787926,16203874,44036589,621905266.448200,751317707.788700,847098294.290600,2220321268.527500,137344,45686,131566,314596
2017-08-04,BYX Equities (Y),162534903,52814901,83642322,298992126,4818930588.739345,2294540091.700201,2956552315.500005,10070022995.939551,1344995,218887,737540,2301422
2017-08-04,BZX Equities (Z),200518837,68798289,111559190,380876316,7165546194.614997,4018186249.593300,5159758834.428994,16343491278.637291,1555147,308829,904614,2768590
2017-08-03,NYSE American (A),3066403,8347440,1792616,13206459,146119325.140000,71916900.390900,75911229.978000,293947455.508900,32273,26678,17340,76291
2017-08-03,NASDAQ BX (B),123264611,25508474,66726943,215500028,4756977039.661747,1239600145.642796,2853198202.375608,8849775387.680151,1221783,121288,666187,2009258
2017-08-03,NYSE (DN),96862658,27174887,117292365,241329910,2889994192.242904,857510773.036899,2654374890.267692,6401879855.547495,194488,63855,214824,473167
2017-08-03,NASDAQ (DQ),1241975625,323833422,794079180,2359888227,42842303411.575191,15243270183.656457,30746250653.932487,88831824249.164135,4085039,664194,2297219,7046452
2017-08-03,EDGA Equities (J),52853171,19357369,29231972,101442512,1705301132.198508,1027061214.259601,1123262292.092500,3855624638.550609,458456,85564,212224,756244
2017-08-03,EDGX Equities (K),206249647,56466876,180588736,443305259,7247381544.214964,2834861295.217096,6603821420.431702,16686064259.863762,1355952,227937,970858,2554747
2017-08-03,CHX (M),8348531,10107924,5050542,23506997,348947733.626000,883240074.734000,462622334.842600,1694810143.202600,3144,2784,1582,7510
2017-08-03,NYSE (N),836134643,0,0,836134643,30954213960.845681,0.000000,0.000000,30954213960.845681,2804479,0,0,2804479
2017-08-03,NYSE Arca (P),228961597,214365820,147676806,591004223,9397878124.591130,11568449677.211218,7110323808.226072,28076651610.028420,1723304,516737,1044840,3284881
2017-08-03,NASDAQ (Q),351704632,80045537,502495899,934246068,15521486680.732722,4709038419.043009,25351753556.951713,45582278656.727444,3143990,340323,3243985,6728298
2017-08-03,IEX (V),98287188,14567095,48421029,161275312,4136075054.622101,838917477.955600,2461832816.625303,7436825349.203004,596696,58176,297319,952191
2017-08-03,NASDAQ PSX (X),17880714,11052430,18259011,47192155,689038516.061701,662124796.099401,897380202.277499,2248543514.438601,154376,45908,139368,339652
2017-08-03,BYX Equities (Y),174135279,51027212,91949601,317112092,5259403414.586629,2257599453.934904,3287839499.317494,10804842367.839027,1479366,222602,770365,2472333
2017-08-03,BZX Equities (Z),222686645,66803309,120537353,410027307,8063947671.857983,3834525180.514799,5570809326.285179,17469282178.657961,1779164,286632,959964,3025760
2017-08-02,NYSE American (A),3209574,11799093,1938445,16947112,150052898.795000,102779757.537200,91557708.281000,344390364.613200,32967,27963,18585,79515
2017-08-02,NASDAQ BX (B),115132620,27457620,65111268,207701508,4395510603.346941,1359339242.023199,2971167522.257906,8726017367.628046,1127756,131425,670890,1930071
2017-08-02,NYSE (DN),96300268,30190296,103481190,229971754,3197612695.466820,1062656145.319801,3477313678.957520,7737582519.744141,198167,71059,232522,501748
2017-08-02,NASDAQ (DQ),1126620154,345204031,765497891,2237322076,41307971243.438199,17152797883.025428,34819584612.372767,93280353738.836394,3903657,788928,2361385,7053970
2017-08-02,EDGA Equities (J),52017701,22896939,29188883,104103523,1741691201.662302,1141174697.911998,1239291338.743996,4122157238.318296,458889,91577,233724,784190
2017-08-02,EDGX Equities (K),190973888,62869093,187828866,441671847,7232194470.570773,3183378449.061389,7920724186.085153,18336297105.717315,1317827,255527,1029565,2602919
2017-08-02,CHX (M),18867768,9601105,6945605,35414478,490017313.156900,917284300.380000,704343099.075200,2111644712.612100,3010,3145,1290,7445
2017-08-02,NYSE (N),833165870,0,0,833165870,32320075138.253940,0.000000,0.000000,32320075138.253940,2784682,0,0,2784682
2017-08-02,NYSE Arca (P),209400545,220277890,152193332,581871767,9177361313.153565,11829337036.381322,8813403513.301331,29820101862.836218,1634377,586322,1101094,3321793
2017-08-02,NASDAQ (Q),335886522,93431596,521781924,951100042,15571103590.716574,5560894035.856905,29640544654.146561,50772542280.720040,3075481,405429,3426859,6907769
2017-08-02,IEX (V),95392708,15416781,46288998,157098487,4025100908.429594,843173304.923498,2662578729.171492,7530852942.524584,549520,62124,293891,905535
2017-08-02,NASDAQ PSX (X),16589401,11872499,18649409,47111309,680399952.368002,727828688.291200,1087772132.747799,2496000773.407001,140844,51549,145312,337705
2017-08-02,BYX Equities (Y),170741409,57199299,89103813,317044521,5126284926.378803,2394286080.212904,3556658235.880126,11077229242.471833,1427244,240856,793715,2461815
2017-08-02,BZX Equities (Z),222855657,70618247,127864962,421338866,8336740006.773710,4115920090.443297,6540499321.240692,18993159418.457699,1798519,321458,1045830,3165807
2017-08-01,NYSE American (A),3089179,9245715,1684105,14018999,145159521.270000,109519815.437700,76341406.629300,331020743.337000,31011,27356,16193,74560
2017-08-01,NASDAQ BX (B),121147805,27764281,62603605,211515691,4673541796.081744,1333173881.623401,2709376708.368190,8716092386.073335,1255662,129664,664857,2050183
2017-08-01,NYSE (DN),98995791,35115052,75747499,209858342,3292060825.894895,1095933925.214601,2581269090.138903,6969263841.248399,192635,78488,193090,464213
2017-08-01,NASDAQ (DQ),1130576351,417290074,683579224,2231445649,41144990976.655229,21432371573.177938,28732810722.727850,91310173272.561017,3803759,798862,2158280,6760901
2017-08-01,EDGA Equities (J),51858218,25281539,24004698,101144455,1740175196.169312,1156661757.234200,1015221482.563102,3912058435.966614,457078,95216,204347,756641
2017-08-01,EDGX Equities (K),189220989,65797365,149079814,404098168,7110015500.648924,3145652961.394002,6553462108.708968,16809130570.751894,1272352,251605,890099,2414056
2017-08-01,CHX (M),26573132,9710978,6195609,42479719,732492957.900800,789129005.800600,496295752.230100,2017917715.931500,2619,3181,1379,7179
2017-08-01,NYSE (N),826605092,0,0,826605092,31850226102.292540,0.000000,0.000000,31850226102.292540,2635962,0,0,2635962
2017-08-01,NYSE Arca (P),208134320,241121958,122374739,571631017,8937286092.806120,12945862511.258648,6626954501.630820,28510103105.695588,1581757,558993,928633,3069383
2017-08-01,NASDAQ (Q),321860574,89959629,449391207,861211410,14904559091.929525,5380553756.220987,24388330476.539478,44673443324.689990,2893278,366855,2874867,6135000
2017-08-01,IEX (V),93044726,18120354,44991708,156156788,3959782227.393714,956840920.279400,2472147002.375200,7388770150.048314,555769,71855,286178,913802
2017-08-01,NASDAQ PSX (X),16245239,12196576,14664438,43106253,641762892.555000,676471001.728800,822138690.246900,2140372584.530700,137409,48318,122597,308324
2017-08-01,BYX Equities (Y),170633317,60618530,84203959,315455806,5199541263.145337,2619822179.013403,3184790405.873393,11004153848.032133,1469100,246318,769174,2484592
2017-08-01,BZX Equities (Z),212277963,71782667,103265364,387325994,8054054995.838513,4019330380.582300,4988087855.208499,17061473231.629312,1695276,297559,862421,2855256
2017-07-31,NYSE American (A),3051828,10186258,2011901,15249987,140773155.900000,105440288.316200,94398935.305200,340612379.521400,32503,29004,19974,81481
2017-07-31,NASDAQ BX (B),112098685,28197209,61378425,201674319,4319120098.268401,1404188730.384296,2821575768.639991,8544884597.292688,1099619,126953,634006,1860578
2017-07-31,NYSE (DN),56988334,16660165,57212602,130861101,1857119655.460605,552685897.713199,1696786108.210903,4106591661.384707,141897,49852,167841,359590
2017-07-31,NASDAQ (DQ),1094036033,375800891,699307763,2169144687,38757430427.229386,21023557840.616963,33997620264.017378,93778608531.863727,3530482,759523,2160529,6450534
2017-07-31,EDGA Equities (J),50246665,23669030,24488133,98403828,1669273993.630903,1161489473.311700,1266029194.172800,4096792661.115403,438083,96935,208156,743174
2017-07-31,EDGX Equities (K),182371677,67205618,154261860,403839155,6644078882.262282,3506201505.161508,7306472602.273526,17456752989.697316,1193463,259300,924861,2377624
2017-07-31,CHX (M),10530245,4704733,8693236,23928214,440573019.076400,491768967.668000,546826309.384600,1479168296.129000,2174,3247,1744,7165
2017-07-31,NYSE (N),1011964145,0,0,1011964145,40783797389.341672,0.000000,0.000000,40783797389.341672,2504877,0,0,2504877
2017-07-31,NYSE Arca (P),190461770,230140447,127860576,548462793,7977037415.205924,12674335599.534814,7154737780.637334,27806110795.378072,1439341,561516,952265,2953122
2017-07-31,NASDAQ (Q),297919446,90807313,509156516,897883275,13260223447.447486,5498602368.179821,29242212624.059389,48001038439.686696,2651374,370022,2970416,5991812
2017-07-31,IEX (V),78385111,18411798,43011058,139807967,3242338660.923102,904021468.628701,2607775673.939699,6754135803.491502,473457,67549,263562,804568
2017-07-31,NASDAQ PSX (X),14997832,11738233,16382100,43118165,590123248.821601,692250151.046900,1025849281.308301,2308222681.176802,131255,47246,136328,314829
2017-07-31,BYX Equities (Y),170095886,57969860,83580840,311646586,5174765164.308697,2467040795.334294,3355826868.464715,10997632828.107706,1381571,234999,736099,2352669
2017-07-31,BZX Equities (Z),202783266,68799785,111491067,383074118,7554870824.432461,4062104062.061397,6023427368.432706,17640402254.926564,1601796,298654,920607,2821057
2017-07-28,NYSE American (A),2784284,8195913,1724033,12704230,117370597.695000,99396132.147200,80690450.085000,297457179.927200,26915,27293,16602,70810
2017-07-28,NASDAQ BX (B),108252106,25340688,59425839,193018633,4245929393.145589,1246541697.157202,2727280289.253113,8219751379.555904,1083777,121081,607863,1812721
2017-07-28,NYSE (DN),87450596,26082284,86889895,200422775,2792764139.895602,842840168.081301,2786632325.868708,6422236633.845611,182809,65039,212565,460413
2017-07-28,NASDAQ (DQ),1093705104,314140590,687187200,2095032894,40236938887.209628,15953014210.295168,32408072319.751579,88598025417.256375,3648896,665139,2176582,6490617
2017-07-28,EDGA Equities (J),50763144,21860172,25223043,97846359,1726120992.493508,1129027200.376898,1088035451.905801,3943183644.776207,440578,97633,206196,744407
2017-07-28,EDGX Equities (K),183722395,68667158,157709184,410098737,6803991191.438522,3481018576.399503,6892010074.528703,17177019842.366728,1212080,277403,911493,2400976
2017-07-28,CHX (M),9963508,7980854,6728527,24672889,517746404.914800,533584083.560000,652198188.071400,1703528676.546200,2960,2760,3154,8874
2017-07-28,NYSE (N),772132743,0,0,772132743,30001364617.624217,0.000000,0.000000,30001364617.624217,2524286,0,0,2524286
2017-07-28,NYSE Arca (P),197892668,227155073,133371941,558419682,8629564822.359316,12051654806.702440,7251003263.024591,27932222892.086347,1502181,584299,976000,3062480
2017-07-28,NASDAQ (Q),320010514,89291406,463900672,873202592,14984718265.184906,5436043711.798296,26134692037.571640,46555454014.554842,2862718,385474,2955476,6203668
2017-07-28,IEX (V),86320007,14269862,45856650,146446519,3732867125.436785,811100395.660400,2648625406.310300,7192592927.407485,500795,57402,279869,838066
2017-07-28,NASDAQ PSX (X),15972960,11550713,16677086,44200759,645003957.915399,678192560.325000,970455372.394801,2293651890.635200,134787,46997,127462,309246
2017-07-28,BYX Equities (Y),159721195,55757581,79661433,295140209,4885791767.546854,2441425275.785798,3265683955.144495,10592900998.477147,1353260,246036,719737,2319033
2017-07-28,BZX Equities (Z),214166046,75051099,112750009,401967154,7839761076.850152,4221444464.249102,6005512226.570187,18066717767.669441,1633514,332442,905545,2871501
2017-07-27,NYSE American (A),3562255,9800981,2038172,15401408,171023096.360000,104882650.016100,104045850.264400,379951596.640500,36020,28747,20324,85091
2017-07-27,NASDAQ BX (B),131610881,31899792,79578192,243088865,5255903264.401281,1600157604.670199,4037644366.658504,10893705235.729984,1245100,149582,743228,2137910
2017-07-27,NYSE (DN),109018100,33795515,102139064,244952679,3403040869.693896,1217606958.387102,4827479588.109089,9448127416.190087,233347,79800,295271,608418
2017-07-27,NASDAQ (DQ),1324673665,369669161,912062507,2606405333,49616811426.278302,18011208150.350866,49536031335.148386,117164050911.777554,4117290,811504,2680581,7609375
2017-07-27,EDGA Equities (J),65635996,29860942,33473713,128970651,2170639960.958613,1567927851.604301,1681360433.421604,5419928245.984518,529150,126017,264916,920083
2017-07-27,EDGX Equities (K),222631695,93006132,207311341,522949168,8162720359.259182,4950507429.877585,10869383356.804104,23982611145.940871,1442399,370709,1238212,3051320
2017-07-27,CHX (M),20283916,7493949,9961904,37739769,414071546.985300,885230830.290000,969146322.407000,2268448699.682300,3067,3735,2450,9252
2017-07-27,NYSE (N),926651633,0,0,926651633,35810139332.590468,0.000000,0.000000,35810139332.590468,3058624,0,0,3058624
2017-07-27,NYSE Arca (P),259342223,314389366,187512990,761244579,10984867826.348180,16868735657.021332,11622610615.274218,39476214098.643730,1907285,808336,1334384,4050005
2017-07-27,NASDAQ (Q),405710636,125605090,615951606,1147267332,18829720604.128450,7761733019.261204,40093840207.963921,66685293831.353575,3545422,525219,4126920,8197561
2017-07-27,IEX (V),102504725,16464448,63399710,182368883,4793352350.951012,933782046.300900,4431870221.649203,10159004618.901115,589968,72243,335799,998010
2017-07-27,NASDAQ PSX (X),19984117,16435262,26237045,62656424,828737286.350200,1005511765.240300,1679028373.612299,3513277425.202799,170260,63313,189449,423022
2017-07-27,BYX Equities (Y),188233883,69568843,105431159,363233885,5782229761.924745,3055465959.739899,4587590398.494099,13425286120.158743,1526284,302569,882643,2711496
2017-07-27,BZX Equities (Z),255903097,105469994,156307010,517680101,9445898391.848300,6045780127.518077,9043474309.040442,24535152828.406819,1944569,442765,1235195,3622529
2017-07-26,NYSE American (A),2784787,8279720,1238781,12303288,112329672.490000,81167372.600900,60745171.855000,254242216.945900,26938,25867,13253,66058
2017-07-26,NASDAQ BX (B),117101082,28300509,60871763,206273354,4491881270.558802,1274268410.496500,2577648674.547598,8343798355.602900,1128367,127329,591664,1847360
2017-07-26,NYSE (DN),96718784,29049812,100146169,225914765,3175397859.400303,928293647.505600,3014390899.653490,7118082406.559393,213954,72296,238388,524638
2017-07-26,NASDAQ (DQ),1185937345,342880293,765961364,2294779002,42611397343.395993,15894062103.657039,31053344358.839644,89558803805.892676,3821973,791462,2146504,6759939
2017-07-26,EDGA Equities (J),55280846,24171968,25818677,105271491,1798647302.459097,1213745590.610997,1085395953.223901,4097788846.293995,473179,105138,208918,787235
2017-07-26,EDGX Equities (K),207028888,75341009,177310562,459680459,7421558419.759310,3796538545.355113,6878407032.479182,18096503997.593605,1296459,260798,893803,2451060
2017-07-26,CHX (M),13627714,17410716,8157356,39195786,578309807.303200,1461705777.400000,618916670.461400,2658932255.164600,3465,2600,1654,7719
2017-07-26,NYSE (N),826651322,0,0,826651322,31681801250.280580,0.000000,0.000000,31681801250.280580,2603490,0,0,2603490
2017-07-26,NYSE Arca (P),223745693,254485595,144325933,622557221,9495014460.920991,12657258351.362900,7036474160.686322,29188746972.970213,1653049,595160,959086,3207295
2017-07-26,NASDAQ (Q),343486889,102973224,456350793,902810906,15400156026.101795,5880139615.906888,24166038191.494338,45446333833.503021,2957574,384991,2827721,6170286
2017-07-26,IEX (V),88333098,16792177,42844008,147969283,3887701754.521795,823993114.372100,2221894331.502298,6933589200.396193,527468,67678,255149,850295
2017-07-26,NASDAQ PSX (X),18509464,12681047,16627974,47818485,757887562.200200,686003007.655500,875857549.799299,2319748119.654999,157281,50806,124685,332772
2017-07-26,BYX Equities (Y),179425732,60281635,81848750,321556117,5333705091.741604,2424714477.090504,3042145850.232823,10800565419.064931,1482373,247515,699758,2429646
2017-07-26,BZX Equities (Z),239199928,80637763,115180410,435018101,8467909243.324320,4368306490.448390,5240119979.699098,18076335713.471808,1781216,323497,873264,2977977
2017-07-25,NYSE American (A),2209527,8579564,970849,11759940,109838682.060000,74403529.806600,45128957.950000,229371169.816600,21441,23530,10035,55006
2017-07-25,NASDAQ BX (B),124980950,27991941,61491797,214464688,4791613676.639718,1392119140.692101,2810113728.156093,8993846545.487912,1197746,129756,630294,1957796
2017-07-25,NYSE (DN),93500823,29203376,79371440,202075639,3048457088.604484,870297317.819199,2737524425.445600,6656278831.869283,200484,68779,212002,481265
2017-07-25,NASDAQ (DQ),1399360395,346033527,702942754,2448336676,49935250626.813703,18568160938.514097,31337485289.182684,99840896854.510484,3849671,770629,2149892,6770192
2017-07-25,EDGA Equities (J),56229894,23319855,24846858,104396607,1894536344.642198,1176109079.828600,1123341219.383200,4193986643.853998,482635,97884,206082,786601
2017-07-25,EDGX Equities (K),199815508,68072834,162362450,430250792,7260608427.894020,3468109783.372394,6617386894.957502,17346105106.223916,1254807,244272,897093,2396172
2017-07-25,CHX (M),7765154,12505851,5073273,25344278,332914042.045900,1123493165.918100,415747844.183000,1872155052.147000,3372,2842,1426,7640
2017-07-25,NYSE (N),1116639794,0,0,1116639794,43543399958.440792,0.000000,0.000000,43543399958.440792,2632998,0,0,2632998
2017-07-25,NYSE Arca (P),224124718,222520621,141078478,587723817,9590588157.234867,12269876945.962758,7007245595.670091,28867710698.867716,1625056,575254,987730,3188040
2017-07-25,NASDAQ (Q),359895887,88831854,502136532,950864273,16691221905.003803,5734575953.203503,27839286317.137831,50265084175.345137,3175553,373091,3052747,6601391
2017-07-25,IEX (V),91025589,14900419,40793456,146719464,3842622514.820702,809705465.689500,2228399035.279797,6880727015.789999,532639,60891,252836,846366
2017-07-25,NASDAQ PSX (X),18916205,11578562,16772162,47266929,740239570.974600,674563139.319100,882513061.261999,2297315771.555699,159504,47495,129347,336346
2017-07-25,BYX Equities (Y),186532679,59420397,82719133,328672209,5521749713.033440,2588760144.552603,3244674330.813790,11355184188.399833,1518266,254600,732380,2505246
2017-07-25,BZX Equities (Z),235363046,76925284,110290310,422578640,8472646533.136412,4280686594.343695,5483472718.870214,18236805846.350321,1780177,311620,897504,2989301
2017-07-24,NYSE American (A),871167,9090509,587768,10549444,49479770.110000,172352829.494300,31471288.730000,253303888.334300,9698,20983,7469,38150
2017-07-24,NASDAQ BX (B),107758953,22193646,55795364,185747963,4250114072.981305,1121176125.931999,2482237012.846395,7853527211.759699,1061195,111197,571428,1743820
2017-07-24,NYSE (DN),78088338,25486653,82269630,185844621,2354716227.977995,777852390.201100,2706212200.972202,5838780819.151297,175815,68500,210888,455203
2017-07-24,NASDAQ (DQ),953590880,327017456,659201609,1939809945,36174150685.490559,17586915548.729011,29957062989.886759,83718129224.106329,3254991,689687,1962110,5906788
2017-07-24,EDGA Equities (J),45586240,17119112,21944396,84649748,1561267994.568998,905206392.607300,933906892.076599,3400381279.252897,401969,84667,183608,670244
2017-07-24,EDGX Equities (K),152338083,56937425,146134789,355410297,5882900113.149790,2907784825.769295,6163008018.559197,14953692957.478282,1029576,215266,787396,2032238
2017-07-24,CHX (M),10549291,7921956,5792764,24264011,492805764.625400,525039396.480000,422161348.485100,1440006509.590500,2747,1936,1443,6126
2017-07-24,NYSE (N),821242724,0,0,821242724,35363301788.800724,0.000000,0.000000,35363301788.800724,2199179,0,0,2199179
2017-07-24,NYSE Arca (P),161818285,187778385,117458156,467054826,7155400929.158658,10035376370.530510,6273580013.310231,23464357312.999399,1286759,476405,848433,2611597
2017-07-24,NASDAQ (Q),270378278,75351636,438715280,784445194,12894936176.008928,4728767199.040496,25234146152.877805,42857849527.927229,2482797,332583,2687717,5503097
2017-07-24,IEX (V),73207768,14291615,37659176,125158559,3248863425.582401,752571834.245300,1937158681.592499,5938593941.420200,448078,57339,227105,732522
2017-07-24,NASDAQ PSX (X),14578058,9386617,15481348,39446023,566019334.095700,550156014.094400,833054966.238600,1949230314.428700,126105,41678,115283,283066
2017-07-24,BYX Equities (Y),155184949,46092638,75236264,276513851,4779565920.422407,2025507442.573302,2846302210.876898,9651375573.872607,1289203,207286,648073,2144562
2017-07-24,BZX Equities (Z),174730091,56211296,91872426,322813813,6595926278.939278,3233246514.662397,4554539089.136201,14383711882.737876,1374112,253843,743378,2371333
2017-07-21,NYSE American (A),0,10862414,0,10862414,0.000000,100047934.896200,0.000000,100047934.896200,0,16380,0,16380
2017-07-21,NASDAQ BX (B),105013405,26471595,55624076,187109076,4074191219.073631,1326285660.672700,2305528472.804294,7706005352.550625,1027767,119439,562786,1709992
2017-07-21,NYSE (DN),73476697,27582612,73429688,174488997,2256276122.388802,884087124.058301,2188302246.207593,5328665492.654696,165170,64937,187036,417143
2017-07-21,NASDAQ (DQ),940566591,343300194,659469038,1943335823,35335488255.325138,23589716461.113063,28097780194.357605,87022984910.795806,3238049,681792,1898356,5818197
2017-07-21,EDGA Equities (J),45927166,21971447,22064703,89963316,1538107995.233901,1178627832.246401,878601755.561902,3595337583.042204,406103,101884,181936,689923
2017-07-21,EDGX Equities (K),150293370,59180206,143791442,353265018,5676572154.986475,3124228005.481504,5583770465.782394,14384570626.250373,1011624,234679,793183,2039486
2017-07-21,CHX (M),13694082,11477216,8198913,33370211,771488977.010000,1391261238.860000,768147556.556100,2930897772.426100,2616,2472,1460,6548
2017-07-21,NYSE (N),836970734,0,0,836970734,33994217396.207379,0.000000,0.000000,33994217396.207379,2288645,0,0,2288645
2017-07-21,NYSE Arca (P),183272177,205823876,119254646,508350699,8155798160.473894,11785452448.456097,5573442880.876718,25514693489.806709,1364913,531871,854232,2751016
2017-07-21,NASDAQ (Q),279829875,81930002,498674204,860434081,13175410182.741637,5328247524.385486,26295673319.974794,44799331027.101917,2524317,342377,2714817,5581511
2017-07-21,IEX (V),76050691,16827764,36355815,129234270,3217229172.717103,918930169.156000,1933826307.853599,6069985649.726702,433967,64841,222278,721086
2017-07-21,NASDAQ PSX (X),15562588,11059392,16281370,42903350,595054115.743301,692740004.515499,828216327.913000,2116010448.171800,127801,44494,120710,293005
2017-07-21,BYX Equities (Y),159776635,56081269,74760931,290618835,4658206481.287540,2390259900.100090,2693580144.312411,9742046525.700041,1313675,226157,642861,2182693
2017-07-21,BZX Equities (Z),186452638,66025194,99213976,351691808,6988374258.102918,4130584776.027490,4809071307.204692,15928030341.335100,1462077,291087,786166,2539330
2017-07-20,NYSE American (A),0,7679519,0,7679519,0.000000,58249722.214800,0.000000,58249722.214800,0,18122,0,18122
2017-07-20,NASDAQ BX (B),110912879,25252390,61817946,197983215,4364572177.301288,1253242681.193498,2587514307.341603,8205329165.836389,1077817,127149,626496,1831462
2017-07-20,NYSE (DN),86006043,28585864,71705163,186297070,2810425320.929598,948503629.810201,2533358122.488599,6292287073.228398,170844,61746,174989,407579
2017-07-20,NASDAQ (DQ),1079775205,340504669,706579133,2126859007,41406435555.168173,17731394201.412911,30778654070.942450,89916483827.523534,3416251,687085,2035271,6138607
2017-07-20,EDGA Equities (J),49893351,22378014,26710493,98981858,1749551619.182503,1162257851.915900,1101077633.713100,4012887104.811503,442957,105577,219713,768247
2017-07-20,EDGX Equities (K),169124298,61540116,152051741,382716155,6588077978.328896,3113948059.238095,6451366178.263562,16153392215.830553,1135274,249658,884808,2269740
2017-07-20,CHX (M),13871470,10630949,9641798,34144217,602931082.361700,711165674.080000,1181843335.411200,2495940091.852900,2855,3094,2253,8202
2017-07-20,NYSE (N),752236310,0,0,752236310,30502680092.609835,0.000000,0.000000,30502680092.609835,2418943,0,0,2418943
2017-07-20,NYSE Arca (P),194569780,222496201,132703710,549769691,8771426963.167877,11980184717.772102,6475893886.744528,27227505567.684507,1452505,576423,943673,2972601
2017-07-20,NASDAQ (Q),309019442,83816743,448372347,841208532,14978669328.324088,5247160676.141994,24044711908.090090,44270541912.556172,2808767,368327,2880180,6057274
2017-07-20,IEX (V),79969284,14280129,38475018,132724431,3538185473.727393,767167115.439200,2012732541.938997,6318085131.105590,471544,63877,238069,773490
2017-07-20,NASDAQ PSX (X),16162665,11521938,16269763,43954366,633174986.794000,677430177.223300,893797387.841199,2204402551.858499,136630,51020,131438,319088
2017-07-20,BYX Equities (Y),162100381,52001581,80655749,294757711,4926779459.118432,2237465441.737598,3042206680.330100,10206451581.186130,1337759,225732,692571,2256062
2017-07-20,BZX Equities (Z),200182880,70733038,105025967,375941885,7498272129.500338,4068224892.141388,5093443118.680407,16659940140.322133,1547534,316190,845508,2709232
2017-07-19,NYSE American (A),0,9149444,0,9149444,0.000000,58371868.741800,0.000000,58371868.741800,0,20022,0,20022
2017-07-19,NASDAQ BX (B),108371690,25189948,60427696,193989334,4175644747.658515,1182358155.396599,2612127466.665293,7970130369.720407,1088954,121477,619635,1830066
2017-07-19,NYSE (DN),84246814,26193485,91079053,201519352,2586490177.599599,856968366.748599,2945505706.974997,6388964251.323195,189323,70548,212797,472668
2017-07-19,NASDAQ (DQ),1037139243,325379586,706633265,2069152094,37336428318.742010,16847332551.236159,30776279434.246452,84960040304.224621,3296556,714927,2082558,6094041
2017-07-19,EDGA Equities (J),47582402,20523637,24763290,92869329,1572402816.859297,1040520807.096200,993053506.620401,3605977130.575898,433222,100278,200822,734322
2017-07-19,EDGX Equities (K),166692841,57947639,158204956,382845436,6248164443.665878,2638201236.071894,6580377699.069203,15466743378.806975,1102286,225366,885209,2212861
2017-07-19,CHX (M),11780852,12994607,7413147,32188606,597175947.416400,946647559.290000,541721567.054800,2085545073.761200,2851,3313,1586,7750
2017-07-19,NYSE (N),709732621,0,0,709732621,27495978786.535567,0.000000,0.000000,27495978786.535567,2276679,0,0,2276679
2017-07-19,NYSE Arca (P),181277285,205954295,135014598,522246178,7777565812.974610,11342988750.406789,6749319544.494614,25869874107.876013,1351964,532011,951574,2835549
2017-07-19,NASDAQ (Q),284835434,75166185,449711075,809712694,13074265901.469888,4581963393.131406,24660851425.229956,42317080719.831250,2601524,326087,2914063,5841674
2017-07-19,IEX (V),74067431,12823923,38320840,125212194,3094181027.040697,665950555.561700,2047126047.013603,5807257629.616000,439273,54063,242498,735834
2017-07-19,NASDAQ PSX (X),14000207,10014547,16020581,40035335,560716201.375000,524677170.895600,925744867.341500,2011138239.612100,124624,45696,131493,301813
2017-07-19,BYX Equities (Y),152353467,49922032,78510542,280786041,4385890893.871021,2068793885.505598,2901850019.496096,9356534798.872715,1274928,217309,675440,2167677
2017-07-19,BZX Equities (Z),191735854,63698463,101377835,356812152,6908051084.725951,3517854788.230405,5021022403.672008,15446928276.628364,1475076,273633,829211,2577920
2017-07-18,NYSE American (A),0,10623677,0,10623677,0.000000,65518306.791800,0.000000,65518306.791800,0,23341,0,23341
2017-07-18,NASDAQ BX (B),107201888,27304796,57730058,192236742,4044383878.710025,1218842435.255505,2515770166.606411,7778996480.571941,1046232,121731,580400,1748363
2017-07-18,NYSE (DN),80204382,30985357,83436397,194626136,2365614338.012313,900047010.792500,2750148059.869409,6015809408.674222,155003,66651,166795,388449
2017-07-18,NASDAQ (DQ),988545679,348397453,683773271,2020716403,35367475100.683141,16265728230.166290,28279486887.808716,79912690218.658147,3217569,754309,1928193,5900071
2017-07-18,EDGA Equities (J),46486617,21652305,23792019,91930941,1521354148.806704,1083498203.379999,964699787.965599,3569552140.152302,421746,97157,187053,705956
2017-07-18,EDGX Equities (K),163063854,64077101,157993190,385134145,6070247066.479454,2918446473.028391,6307386817.098589,15296080356.606434,1054433,242709,807304,2104446
2017-07-18,CHX (M),7863797,16668282,4102493,28634572,398040598.355000,1067123940.040000,342477595.559700,1807642133.954700,2996,3215,1734,7945
2017-07-18,NYSE (N),695717017,0,0,695717017,26596113968.156491,0.000000,0.000000,26596113968.156491,2132233,0,0,2132233
2017-07-18,NYSE Arca (P),180373678,221462912,127989347,529825937,7597318071.018138,11451203426.597399,6405051420.690771,25453572918.306308,1296585,570280,871809,2738674
2017-07-18,NASDAQ (Q),282499266,85305062,413926167,781730495,13261026309.741935,5088261220.302009,22834932484.557015,41184220014.600959,2534853,370328,2631791,5536972
2017-07-18,IEX (V),70928052,17913734,32945584,121787370,2952303831.939503,914639603.641700,1770478277.266099,5637421712.847302,412842,70307,210823,693972
2017-07-18,NASDAQ PSX (X),15779139,11955332,15717515,43451986,612434936.278900,639414342.481700,924958882.186600,2176808160.947200,128746,49277,122744,300767
2017-07-18,BYX Equities (Y),150929876,53803269,74862188,279595333,4487839474.373014,2178773130.850198,2753872084.116004,9420484689.339216,1259435,221850,634748,2116033
2017-07-18,BZX Equities (Z),184499995,70722322,96957894,352180211,6744709854.393831,3964274034.185193,4857045641.350786,15566029529.929810,1432381,303309,769791,2505481
2017-07-17,NYSE American (A),0,11361198,0,11361198,0.000000,71914505.517500,0.000000,71914505.517500,0,21311,0,21311
2017-07-17,NASDAQ BX (B),95160322,25981889,51714431,172856642,3652140962.362398,1184187336.038997,2187033540.821898,7023361839.223293,944032,123362,534956,1602350
2017-07-17,NYSE (DN),66799189,27240106,57053766,151093061,1948030411.960402,853501901.814598,2284938980.817790,5086471294.592790,138713,64934,136877,340524
2017-07-17,NASDAQ (DQ),943780760,312298443,608532211,1864611414,33384388878.535593,15855607261.574468,27638404332.285543,76878400472.395604,3157876,720903,1875243,5754022
2017-07-17,EDGA Equities (J),43458362,21483366,19877230,84818958,1428895376.756793,988449420.157000,880058518.045998,3297403314.959791,381442,95474,176758,653674
2017-07-17,EDGX Equities (K),142716992,52660880,127931621,323309493,5278760465.229569,2271693242.836801,5583627220.105885,13134080928.172255,956368,203465,752748,1912581
2017-07-17,CHX (M),8985779,7208455,6253098,22447332,440400636.404200,530838670.749200,541165104.463400,1512404411.616800,2911,2289,1327,6527
2017-07-17,NYSE (N),690303926,0,0,690303926,26495088045.377105,0.000000,0.000000,26495088045.377105,2080056,0,0,2080056
2017-07-17,NYSE Arca (P),157527940,191688961,104255823,453472724,6692736296.455205,9436139397.060391,5783909839.222881,21912785532.738477,1189180,493151,815639,2497970
2017-07-17,NASDAQ (Q),255720432,71244326,390961000,717925758,11628994513.920234,3909008093.684292,21956800398.948297,37494803006.552823,2341927,312651,2565055,5219633
2017-07-17,IEX (V),71851560,13650248,31477706,116979514,3061458580.017406,727051980.725501,1695316773.847100,5483827334.590007,427246,61204,209215,697665
2017-07-17,NASDAQ PSX (X),14913788,9306804,12996165,37216757,540369543.500000,508755240.810000,786880417.154800,1836005201.464800,109739,38997,107448,256184
2017-07-17,BYX Equities (Y),142277102,50492840,66513955,259283897,4233799660.133082,1999798538.726604,2543466004.033999,8777064202.893685,1203292,211708,606574,2021574
2017-07-17,BZX Equities (Z),167089635,56376449,85825101,309291185,5933437484.508811,2997800974.256004,4213831760.771310,13145070219.536125,1313372,263422,727140,2303934
2017-07-14,NYSE American (A),0,8941949,0,8941949,0.000000,56239961.485400,0.000000,56239961.485400,0,18527,0,18527
2017-07-14,NASDAQ BX (B),92416930,29365885,52094510,173877325,3409137376.659724,1460632063.994299,2105979429.349196,6975748870.003219,947873,131476,529666,1609015
2017-07-14,NYSE (DN),72006826,28957932,67411049,168375807,2039106123.858104,1019591313.515198,2094890170.071605,5153587607.444907,141533,64060,150622,356215
2017-07-14,NASDAQ (DQ),901825463,356227315,608472722,1866525500,31438074766.603409,18342221409.611309,25466441543.237214,75246737719.451932,2990681,759752,1849121,5599554
2017-07-14,EDGA Equities (J),43747627,23324262,21482227,88554116,1445348632.814906,1201521369.644297,902809882.235801,3549679884.695004,397803,108003,185112,690918
2017-07-14,EDGX Equities (K),145238093,62577383,137426110,345241586,5272711885.485586,3015123482.755594,5452297975.774409,13740133344.015589,967211,231798,781022,1980031
2017-07-14,CHX (M),6684680,8996489,5582139,21263308,271474138.346000,734618177.977700,355286018.366200,1361378334.689900,2394,3091,1568,7053
2017-07-14,NYSE (N),674503026,0,0,674503026,25800932156.550934,0.000000,0.000000,25800932156.550934,2020632,0,0,2020632
2017-07-14,NYSE Arca (P),163985492,232663544,116554233,513203269,6787622834.352941,12365908939.665417,5731710397.272702,24885242171.291060,1216555,561442,837581,2615578
2017-07-14,NASDAQ (Q),242535920,85014587,393151092,720701599,10433361877.963326,5272351466.230177,20137020895.792750,35842734239.986253,2175322,339645,2369438,4884405
2017-07-14,IEX (V),69827315,17869426,33931201,121627942,2776006766.727392,941067568.906400,1682944791.753500,5400019127.387292,427337,71704,215866,714907
2017-07-14,NASDAQ PSX (X),13277581,11654932,14176791,39109304,522657428.100000,705995578.910600,794507319.494699,2023160326.505299,115850,46765,112731,275346
2017-07-14,BYX Equities (Y),138795664,56991594,70835132,266622390,4142127784.676037,2393292668.281502,2632174721.125200,9167595174.082739,1216980,227188,622278,2066446
2017-07-14,BZX Equities (Z),173623935,71918205,94329223,339871363,6099191138.190892,4226674077.378397,4540370478.764112,14866235694.333401,1373724,302269,764499,2440492
2017-07-13,NYSE American (A),0,8922921,0,8922921,0.000000,71279442.323900,0.000000,71279442.323900,0,22790,0,22790
2017-07-13,NASDAQ BX (B),102236102,27147245,56645389,186028736,3679253038.169899,1269063551.455303,2368679494.338004,7316996083.963206,1005344,130087,574975,1710406
2017-07-13,NYSE (DN),80294718,27002466,65470605,172767789,2257650420.671100,891707992.459800,2626943857.084910,5776302270.215810,142186,57839,143493,343518
2017-07-13,NASDAQ (DQ),985426911,324784275,690529112,2000740298,32647664358.552678,15025939071.507449,28269935374.755275,75943538804.815402,3232569,738067,2031114,6001750
2017-07-13,EDGA Equities (J),47189374,21327265,24003847,92520486,1499980137.202001,1065075908.865001,1048413408.000900,3613469454.067902,418952,99296,208340,726588
2017-07-13,EDGX Equities (K),162867342,57902698,146458542,367228582,5769745841.492891,2634805245.300197,6124310803.525165,14528861890.318253,1097934,227191,876057,2201182
2017-07-13,CHX (M),12412125,6776036,5622993,24811154,541207132.903300,533312291.515000,484107913.717500,1558627338.135800,2842,2644,1742,7228
2017-07-13,NYSE (N),768358176,0,0,768358176,28081926998.986448,0.000000,0.000000,28081926998.986448,2291415,0,0,2291415
2017-07-13,NYSE Arca (P),183095156,226112530,134387485,543595171,7212236322.587091,11406662309.062531,6665368369.294885,25284267000.944507,1355919,570456,968321,2894696
2017-07-13,NASDAQ (Q),295324091,87317640,449771011,832412742,12449603737.923054,4933025464.192910,23815885056.858399,41198514258.974363,2642397,368305,2921993,5932695
2017-07-13,IEX (V),76313308,16917573,38496871,131727752,2966585526.949595,901943076.471099,1913166391.999298,5781694995.419992,453570,70742,245099,769411
2017-07-13,NASDAQ PSX (X),14818368,11534704,16426644,42779716,563225382.019000,624730667.290000,902578352.509400,2090534401.818400,128013,48134,128482,304629
2017-07-13,BYX Equities (Y),151833844,51677331,75276739,278787914,4349791979.785209,2087324896.953896,2730612503.579611,9167729380.318716,1270914,217693,660835,2149442
2017-07-13,BZX Equities (Z),188348710,63735636,103078625,355162971,6420617980.040291,3514482132.636309,5034350502.411989,14969450615.088589,1467344,289564,856028,2612936
2017-07-12,NYSE American (A),0,12204311,0,12204311,0.000000,69916772.588700,0.000000,69916772.588700,0,24009,0,24009
2017-07-12,NASDAQ BX (B),102258754,33254565,59094812,194608131,3635943509.165622,1510271208.979495,2441800764.603394,7588015482.748511,1020201,146006,592615,1758822
2017-07-12,NYSE (DN),79456635,31731124,78180257,189368016,2175645148.582816,972729930.067300,2446625103.771806,5595000182.421922,147138,64795,154881,366814
2017-07-12,NASDAQ (DQ),1022244489,419641043,665106488,2106992020,33766440742.681810,20511000398.545536,27645843923.986358,81923285065.213704,3372284,832144,1999406,6203834
2017-07-12,EDGA Equities (J),50907921,28369588,25572877,104850386,1602360741.032995,1405960821.010700,1062546248.064500,4070867810.108195,450281,124106,210632,785019
2017-07-12,EDGX Equities (K),168508461,79035366,161529583,409073410,5863032316.234897,3691534903.286214,6605385486.424000,16159952705.945111,1137324,289034,885827,2312185
2017-07-12,CHX (M),8880954,10473139,5262156,24616249,381620968.380000,861728488.850000,573172407.945000,1816521865.175000,2894,3774,1795,8463
2017-07-12,NYSE (N),794254859,0,0,794254859,28904622024.126152,0.000000,0.000000,28904622024.126152,2450393,0,0,2450393
2017-07-12,NYSE Arca (P),191839167,274105863,140783560,606728590,7627848417.592522,13913536566.828053,6626176794.291384,28167561778.711959,1438398,672282,944740,3055420
2017-07-12,NASDAQ (Q),298252525,112036334,456097176,866386035,12622511964.880735,6391855520.676827,24403804633.618676,43418172119.176238,2676432,430568,2894319,6001319
2017-07-12,IEX (V),77117773,20043347,35399173,132560293,2994916096.724397,1001096101.789300,1833973099.589200,5829985298.102897,463693,79670,223322,766685
2017-07-12,NASDAQ PSX (X),16373160,14694445,16749708,47817313,615945057.015000,814053241.859700,954792503.473500,2384790802.348200,138030,58948,134160,331138
2017-07-12,BYX Equities (Y),160834486,69725362,77672042,308231890,4568638038.413228,2769810337.433096,2983930142.908103,10322378518.754427,1360211,267965,687448,2315624
2017-07-12,BZX Equities (Z),205975034,87714283,106294410,399983727,7155304632.163028,4833168486.257394,5420314657.079420,17408787775.499842,1629746,365900,884788,2880434
2017-07-11,NYSE American (A),0,14094587,0,14094587,0.000000,70318692.314500,0.000000,70318692.314500,0,24086,0,24086
2017-07-11,NASDAQ BX (B),100468472,27290791,55960091,183719354,3577158468.949914,1285535567.347501,2225178988.237598,7087873024.535013,1018355,130729,566881,1715965
2017-07-11,NYSE (DN),84289113,34586883,76455653,195331649,2451448512.590800,1010369209.503301,2161638301.865002,5623456023.959103,142979,68005,143000,353984
2017-07-11,NASDAQ (DQ),1015098461,369237797,703007784,2087344042,33634721229.481919,16194977691.684788,26741201099.452406,76570900020.619113,3227593,776925,1854519,5859037
2017-07-11,EDGA Equities (J),48626538,22668688,25878442,97173668,1522770978.144098,1097911829.289400,997439451.772499,3618122259.205997,438065,112145,203402,753612
2017-07-11,EDGX Equities (K),162873205,68822843,156322385,388018433,5739716692.621924,3015956407.925296,5590320337.754825,14345993438.302045,1121280,267853,825857,2214990
2017-07-11,CHX (M),10201730,9857959,5486366,25546055,467119119.875000,923411614.770000,353623867.710700,1744154602.355700,3145,3960,1790,8895
2017-07-11,NYSE (N),784243969,0,0,784243969,28589568463.019295,0.000000,0.000000,28589568463.019295,2334364,0,0,2334364
2017-07-11,NYSE Arca (P),178635170,225169462,115549129,519353761,7094767613.821120,11271731213.200634,5646848211.070707,24013347038.092461,1346063,611818,870684,2828565
2017-07-11,NASDAQ (Q),290483368,91383721,454981809,836848898,12359738864.153626,5215087403.918484,23321117477.912019,40895943745.984129,2657358,398457,2835847,5891662
2017-07-11,IEX (V),74975085,17850074,32889930,125715089,2851974034.019899,886605481.270199,1747143572.609699,5485723087.899797,469806,75631,222089,767526
2017-07-11,NASDAQ PSX (X),14490671,13044064,15576679,43111414,549910934.005999,729474046.655400,895303024.553200,2174688005.214599,128508,53690,129544,311742
2017-07-11,BYX Equities (Y),155901242,57801653,74069307,287772202,4425540827.961632,2243916051.670904,2651215865.167803,9320672744.800339,1341464,239853,646633,2227950
2017-07-11,BZX Equities (Z),188513883,74478548,96391291,359383722,6536731313.134811,4119121750.077797,4530291822.173594,15186144885.386202,1492494,334687,816002,2643183
2017-07-10,NYSE American (A),0,16634083,0,16634083,0.000000,85256039.468400,0.000000,85256039.468400,0,25839,0,25839
2017-07-10,NASDAQ BX (B),102479032,25279443,55197380,182955855,3626402790.220118,1109956718.449599,2182064735.385495,6918424244.055212,1021246,126918,569098,1717262
2017-07-10,NYSE (DN),76663299,30194507,64232316,171090122,2086284738.495405,872441364.176602,2044178373.509101,5002904476.181108,137520,66137,141988,345645
2017-07-10,NASDAQ (DQ),944340780,365033450,627154007,1936528237,31722752691.664287,15169711100.617170,25510381583.924842,72402845376.206299,3123041,796049,1869971,5789061
2017-07-10,EDGA Equities (J),50674326,23199843,23577610,97451779,1614812945.957700,1103953099.533098,1003542069.015399,3722308114.506197,457776,114971,211025,783772
2017-07-10,EDGX Equities (K),155257982,70515987,138437179,364211148,5405360148.809615,2851093765.011101,5569135720.899497,13825589634.720213,1079038,263161,820282,2162481
2017-07-10,CHX (M),5483406,9283613,3920591,18687610,254289709.421000,647874022.551300,300832838.663900,1202996570.636200,2922,3510,1838,8270
2017-07-10,NYSE (N),799072642,0,0,799072642,29519935312.254762,0.000000,0.000000,29519935312.254762,2309358,0,0,2309358
2017-07-10,NYSE Arca (P),175140642,237824193,112637660,525602495,6939884367.064570,11306301505.660961,5654646274.554567,23900832147.280098,1330748,572258,868505,2771511
2017-07-10,NASDAQ (Q),267399142,86320647,433354233,787074022,11750128941.212085,4549826520.135888,22714739072.680564,39014694534.028537,2569576,366248,2773060,5708884
2017-07-10,IEX (V),73912977,16607100,36434302,126954379,2838049774.259108,710394307.056500,1805553802.732200,5353997884.047808,455090,71354,232439,758883
2017-07-10,NASDAQ PSX (X),13974210,12626965,15451187,42052362,542994422.593799,633556710.224401,836194250.878700,2012745383.696900,125335,52708,127127,305170
2017-07-10,BYX Equities (Y),157813564,54270545,75286440,287370549,4430636318.847450,2045613026.291900,2702021728.572984,9178271073.712334,1331576,235620,676700,2243896
2017-07-10,BZX Equities (Z),187668105,71859623,95596758,355124486,6339457179.840046,3563033776.496792,4447230350.775096,14349721307.111934,1476664,323512,804731,2604907
2017-07-07,NYSE American (A),0,10783626,0,10783626,0.000000,65554777.159600,0.000000,65554777.159600,0,21771,0,21771
2017-07-07,NASDAQ BX (B),102049298,31328575,54893118,188270991,3660530853.776595,1445070857.735902,2171437429.518297,7277039141.030794,1030304,147471,562851,1740626
2017-07-07,NYSE (DN),78865674,31385668,71641996,181893338,2080760008.436498,960067676.001902,1859499961.814099,4900327646.252499,137952,67305,148151,353408
2017-07-07,NASDAQ (DQ),931527879,499318270,645371311,2076217460,30848343050.804285,23078963781.830271,24120880368.982901,78048187201.617457,3226499,883904,1890965,6001368
2017-07-07,EDGA Equities (J),45214853,29010084,22873766,97098703,1381454600.190799,1435231243.876498,940921461.752001,3757607305.819298,404976,128708,190986,724670
2017-07-07,EDGX Equities (K),156189624,77017530,145616832,378823986,5254195106.506832,3455464408.935914,5568291387.601173,14277950903.043919,1081107,293139,803198,2177444
2017-07-07,CHX (M),7164369,9585553,6133779,22883701,272358712.800000,666584524.510000,709575843.299500,1648519080.609500,3195,4339,1852,9386
2017-07-07,NYSE (N),735349879,0,0,735349879,26865826335.663741,0.000000,0.000000,26865826335.663741,2199529,0,0,2199529
2017-07-07,NYSE Arca (P),173508077,277704542,117722256,568934875,6716802860.931253,13875057286.552413,5725530858.877800,26317391006.361466,1315452,662788,859864,2838104
2017-07-07,NASDAQ (Q),270875241,104916228,426775126,802566595,11423114928.973026,5802776175.985290,22489860192.947590,39715751297.905906,2530402,427228,2666459,5624089
2017-07-07,IEX (V),75014754,23280772,34231755,132527281,2815010509.123290,1105607376.657901,1774244184.410100,5694862070.191291,467687,93310,220350,781347
2017-07-07,NASDAQ PSX (X),14896443,14895990,15435598,45228031,548412521.198000,794406076.213399,858851060.142700,2201669657.554099,137066,62595,126298,325959
2017-07-07,BYX Equities (Y),156773485,67511112,75278237,299562834,4318707912.598704,2644900036.416483,2629627040.619992,9593234989.635179,1343014,278585,653239,2274838
2017-07-07,BZX Equities (Z),181968678,84289546,96518267,362776491,6085970784.192927,4423509853.027709,4715290293.376022,15224770930.596658,1436704,362194,785589,2584487
2017-07-06,NYSE American (A),0,10981503,0,10981503,0.000000,76363717.748900,0.000000,76363717.748900,0,25871,0,25871
2017-07-06,NASDAQ BX (B),115599894,37161623,65801328,218562845,4057480524.973861,1730537715.130405,2606594634.511599,8394612874.615865,1160433,175066,651739,1987238
2017-07-06,NYSE (DN),87498822,35945093,67933898,191377813,2305943286.524414,1211992130.753004,2125725047.552405,5643660464.829823,146936,73133,136813,356882
2017-07-06,NASDAQ (DQ),1026208907,474485277,700201782,2200895966,34152652994.426269,21924793698.989160,27627332259.769564,83704778953.184993,3454109,1001196,2064317,6519622
2017-07-06,EDGA Equities (J),54537356,34603495,27453105,116593956,1661734365.022603,1761779289.085501,1106102760.213901,4529616414.322005,473261,159607,219108,851976
2017-07-06,EDGX Equities (K),182889322,94597089,165131114,442617525,6338566015.277151,4485449822.123802,6587528945.852296,17411544783.253249,1274767,370963,949791,2595521
2017-07-06,CHX (M),4167027,13324030,6584514,24075571,178952837.281400,906194044.073400,448760147.053100,1533907028.407900,4176,5357,2136,11669
2017-07-06,NYSE (N),877951586,0,0,877951586,32857633342.530275,0.000000,0.000000,32857633342.530275,2698893,0,0,2698893
2017-07-06,NYSE Arca (P),202937474,329254486,141311039,673502999,8083773485.592398,16413537149.456518,7029483162.515463,31526793797.564379,1545646,837493,1032665,3415804
2017-07-06,NASDAQ (Q),328256625,131777368,553460225,1013494218,14122769585.584295,7678830436.440562,27902206902.166296,49703806924.191153,3047866,542812,3360633,6951311
2017-07-06,IEX (V),83174594,25494587,41009670,149678851,3132084957.760106,1265225098.814000,2191803095.657699,6589113152.231805,494273,102326,263860,860459
2017-07-06,NASDAQ PSX (X),17166065,19795199,19286722,56247986,635567491.429997,999128970.709700,1122579717.471799,2757276179.611496,155020,77551,156770,389341
2017-07-06,BYX Equities (Y),180690708,80011624,92315295,353017627,4961693289.909370,3217895634.786705,3144252297.988703,11323841222.684778,1512430,332320,769110,2613860
2017-07-06,BZX Equities (Z),207635811,107793537,112803343,428232691,7031339022.988795,5863113771.481105,5448682950.373718,18343135744.843618,1651733,460765,923890,3036388
2017-07-05,NYSE American (A),0,10270471,0,10270471,0.000000,73858899.857500,0.000000,73858899.857500,0,22311,0,22311
2017-07-05,NASDAQ BX (B),116867736,35469067,64523949,216860752,4122843418.517881,1618833807.516898,2709858135.628707,8451535361.663486,1147771,162393,667444,1977608
2017-07-05,NYSE (DN),80652828,33092651,63932390,177677869,2206002662.546806,1193192868.123003,2440760274.695501,5839955805.365310,138547,68893,139773,347213
2017-07-05,NASDAQ (DQ),999662396,515661316,668107479,2183431191,33781559796.568745,24258412675.255075,28553554486.628004,86593526958.451824,3477723,1050354,2155877,6683954
2017-07-05,EDGA Equities (J),53333820,33151277,26890471,113375568,1606932027.829607,1573091171.504401,1194874432.097300,4374897631.431308,458517,146956,230019,835492
2017-07-05,EDGX Equities (K),189762544,88259259,158887801,436909604,6517077895.533289,3967481758.016385,6285573540.288087,16770133193.837761,1305671,345762,957855,2609288
2017-07-05,CHX (M),9967986,10138304,4720035,24826325,459671937.939000,627369509.240000,479721373.227800,1566762820.406800,3538,4393,2216,10147
2017-07-05,NYSE (N),886280907,0,0,886280907,33375815429.832790,0.000000,0.000000,33375815429.832790,2659757,0,0,2659757
2017-07-05,NYSE Arca (P),210186558,317974515,132867628,661028701,8103730443.455830,15104012877.582760,6908690599.913867,30116433920.952457,1549991,779544,1014680,3344215
2017-07-05,NASDAQ (Q),328104715,117811034,496737969,942653718,13974184583.327247,6718510766.996999,27237965956.576947,47930661306.901193,3003988,506278,3333164,6843430
2017-07-05,IEX (V),85117713,23889804,42055066,151062583,3166808202.817203,1107348636.094801,2295084746.649805,6569241585.561809,516732,96136,266459,879327
2017-07-05,NASDAQ PSX (X),17937645,17528613,18444283,53910541,666828186.961401,880162271.579998,1065116686.009899,2612107144.551298,152880,71599,153538,378017
2017-07-05,BYX Equities (Y),175267813,77991953,86308587,339568353,4818096112.269979,2976715934.121299,3089751403.316490,10884563449.707768,1474247,311223,754684,2540154
2017-07-05,BZX Equities (Z),215015187,97300454,110570560,422886201,7361729019.925530,4974356463.635987,5367927705.513786,17704013189.075303,1697908,427808,927878,3053594
2017-07-03,NYSE American (A),0,6442975,0,6442975,0.000000,46953726.560800,0.000000,46953726.560800,0,13916,0,13916
2017-07-03,NASDAQ BX (B),60376330,20429562,33440710,114246602,2311797169.901493,1069531390.392300,1503801304.158999,4885129864.452792,605263,96447,330349,1032059
2017-07-03,NYSE (DN),53682365,22370887,37381122,113434374,1378386625.085800,796067193.288500,1400919456.753503,3575373275.127803,94443,46702,91046,232191
2017-07-03,NASDAQ (DQ),581824656,291132411,374679958,1247637025,19987072192.113234,14447708506.597761,16363141736.543178,50797922435.254173,2024605,632719,1207769,3865093
2017-07-03,EDGA Equities (J),28776292,21440693,14909084,65126069,932446608.208600,1127724413.870500,751809992.649300,2811981014.728400,256582,94440,122036,473058
2017-07-03,EDGX Equities (K),112703523,56665558,101121323,270490404,3976661614.574006,2865769443.293497,4249265392.331002,11091696450.198505,772765,216605,603906,1593276
2017-07-03,CHX (M),4110138,4066775,2903158,11080071,189487117.670000,299191377.240000,359382116.466000,848060611.376000,2680,2400,1333,6413
2017-07-03,NYSE (N),492058164,0,0,492058164,19035645103.059548,0.000000,0.000000,19035645103.059548,1567784,0,0,1567784
2017-07-03,NYSE Arca (P),121717071,225792937,82975778,430485786,4912413542.805385,12040114034.726728,4461599257.477010,21414126835.009123,930003,515563,605454,2051020
2017-07-03,NASDAQ (Q),185475279,76901677,298841014,561217970,7995904678.548667,4752990379.665402,17114707391.503733,29863602449.717802,1655068,318271,1909947,3883286
2017-07-03,IEX (V),43111506,12665593,21361815,77138914,1653214289.782299,726568632.534600,1186611696.596698,3566394618.913597,279405,54127,143326,476858
2017-07-03,NASDAQ PSX (X),10846097,12166884,11458857,34471838,431977396.254900,675026773.193200,712912739.754300,1819916909.202400,93030,45775,92701,231506
2017-07-03,BYX Equities (Y),89566031,46410819,47555729,183532579,2720718126.831114,2064892538.765201,1861754810.277601,6647365475.873916,807114,193643,434500,1435257
2017-07-03,BZX Equities (Z),117233246,56973357,64408936,238615539,4220893547.339504,3353390632.347000,3374966333.538113,10949250513.224617,967843,249849,549992,1767684
2017-06-30,NYSE American (A),0,12133713,0,12133713,0.000000,83640753.968900,0.000000,83640753.968900,0,20365,0,20365
2017-06-30,NASDAQ BX (B),111945422,33986325,65250225,211181972,4064049981.913108,1722013176.965398,2581334215.679799,8367397374.558305,1111882,147881,640761,1900524
2017-06-30,NYSE (DN),74040413,31320691,62487044,167848148,1913550975.698309,1086400736.338203,1866316926.247400,4866268638.283912,139175,60390,131948,331513
2017-06-30,NASDAQ (DQ),1025570029,413658712,738730110,2177958851,34651407959.981387,22539147911.889150,28692840979.559498,85883396851.430035,3284532,822422,2006489,6113443
2017-06-30,EDGA Equities (J),55652828,31245462,27980323,114878613,1764586107.182599,1648578963.641798,1126613521.828200,4539778592.652597,482710,130100,215193,828003
2017-06-30,EDGX Equities (K),174123684,83295682,162900717,420320083,6085587702.319885,4334628209.248998,6043840238.346907,16464056149.915790,1194379,320546,901486,2416411
2017-06-30,CHX (M),16622859,7587290,7025095,31235244,1305806402.706001,602063175.740000,783894735.484900,2691764313.930901,3028,4213,2388,9629
2017-06-30,NYSE (N),952198679,0,0,952198679,36858283039.286143,0.000000,0.000000,36858283039.286143,2517110,0,0,2517110
2017-06-30,NYSE Arca (P),188721032,314368256,143124111,646213399,7712118947.892200,16892709950.187984,6788087566.751603,31392916464.831787,1452756,730530,955952,3139238
2017-06-30,NASDAQ (Q),298549029,118879694,546692404,964121127,12940461416.035257,7709464288.905952,28983021470.393736,49632947175.334945,2692657,468785,2896774,6058216
2017-06-30,IEX (V),77205966,20980159,39569705,137755830,2926314489.671897,1090298339.633600,1940140179.566296,5956753008.871793,481837,79160,238492,799489
2017-06-30,NASDAQ PSX (X),17656987,19163987,20449502,57270476,650550507.145001,1021477830.988399,1135176055.363100,2807204393.496500,148648,73615,147654,369917
2017-06-30,BYX Equities (Y),175715040,80938284,86965937,343619261,4956513387.945060,3318157688.185995,3025242576.974007,11299913653.105062,1455351,294878,718646,2468875
2017-06-30,BZX Equities (Z),198031293,95498924,110552361,404082578,6792898424.807164,5476987720.749808,5367930673.686093,17637816819.243065,1526095,387098,862865,2776058
2017-06-29,NYSE American (A),0,9192982,0,9192982,0.000000,55838910.754100,0.000000,55838910.754100,0,21624,0,21624
2017-06-29,NASDAQ BX (B),123148966,50661085,75706039,249516090,4387708559.971310,2479691130.362102,3126331562.808881,9993731253.142293,1175580,213879,714613,2104072
2017-06-29,NYSE (DN),102670239,48515598,83034792,234220629,2704961366.901392,1665196650.838603,2971135447.018208,7341293464.758203,182841,86782,190882,460505
2017-06-29,NASDAQ (DQ),1207642985,526598584,824419152,2558660721,39060525927.560758,25402773991.162511,35035503070.818296,99498802989.541565,3773329,1055203,2439371,7267903
2017-06-29,EDGA Equities (J),64639990,45384808,35694053,145718851,1994150109.786096,2352401281.092499,1551713017.019102,5898264407.897697,549523,185622,280427,1015572
2017-06-29,EDGX Equities (K),228791603,126576715,217239874,572608192,7860946361.212874,6529963680.468310,9097309231.049308,23488219272.730492,1493758,491800,1240006,3225564
2017-06-29,CHX (M),6455277,10271065,7553692,24280034,355976341.663400,1261355604.393000,765450307.868900,2382782253.925300,3722,8594,3873,16189
2017-06-29,NYSE (N),947675944,0,0,947675944,34802699247.305725,0.000000,0.000000,34802699247.305725,2952170,0,0,2952170
2017-06-29,NYSE Arca (P),255815436,421139763,231599508,908554707,9838648282.154107,21927165782.086191,10327287029.058823,42093101093.299121,1795012,1113686,1294663,4203361
2017-06-29,NASDAQ (Q),379149321,175717042,589921333,1144787696,16361370767.350454,11439009899.007332,31489067840.604707,59289448506.962493,3332773,715627,3757398,7805798
2017-06-29,IEX (V),90189672,30238420,52605566,173033658,3490972575.403794,1668028345.096399,2639707688.979904,7798708609.480097,545730,118830,308618,973178
2017-06-29,NASDAQ PSX (X),22895391,28556044,34026740,85478175,861770387.175500,1569010299.031997,1648303923.018199,4079084609.225696,187826,112621,212769,513216
2017-06-29,BYX Equities (Y),198422437,108905435,105824364,413152236,5576479523.731920,4467945468.081102,3869384684.247297,13913809676.060319,1618273,434107,864480,2916860
2017-06-29,BZX Equities (Z),242064046,147754635,152888908,542707589,8680769976.512743,8527652072.420312,7797260122.451469,25005682171.384524,1901975,608322,1188169,3698466
2017-06-28,NYSE American (A),0,9046360,0,9046360,0.000000,57958091.261600,0.000000,57958091.261600,0,20130,0,20130
2017-06-28,NASDAQ BX (B),110036255,34429220,67180139,211645614,3998098461.928401,1748868538.859903,2900819911.816911,8647786912.605215,1091005,148494,648669,1888168
2017-06-28,NYSE (DN),92449815,31513342,79305098,203268255,2415998805.437212,984656053.511099,2441212004.886597,5841866863.834908,159745,62400,157756,379901
2017-06-28,NASDAQ (DQ),1156287613,438211460,789895847,2384394920,37232366399.382147,24905228715.261864,30873139314.215242,93010734428.859253,3524231,844163,2189000,6557394
2017-06-28,EDGA Equities (J),55794413,26864367,29391759,112050539,1791857097.368599,1521745525.641801,1265043303.140799,4578645926.151199,491946,122658,241505,856109
2017-06-28,EDGX Equities (K),194243785,79096154,175964062,449304001,6552068480.265271,4462636306.816184,6823462090.265020,17838166877.346475,1264089,302092,971981,2538162
2017-06-28,CHX (M),8769242,9021122,6790770,24581134,378694324.282800,800203702.325900,519845082.858100,1698743109.466800,3345,4080,2979,10404
2017-06-28,NYSE (N),853980109,0,0,853980109,30343601807.267348,0.000000,0.000000,30343601807.267348,2476147,0,0,2476147
2017-06-28,NYSE Arca (P),208853783,250249528,149298045,608401356,8222319925.858743,14001428820.874190,7962003081.843389,30185751828.576322,1524764,656571,1032993,3214328
2017-06-28,NASDAQ (Q),313498544,102477286,499828900,915804730,13232155066.916823,7003513104.713197,26362646937.703494,46598315109.333514,2763322,422765,3025715,6211802
2017-06-28,IEX (V),85222207,19662912,47007608,151892727,3264864097.238595,1152642255.518901,2324813086.451796,6742319439.209292,498380,73848,272813,845041
2017-06-28,NASDAQ PSX (X),18983146,17159365,20545378,56687889,672294187.084999,1035489965.202702,1218460903.619900,2926245055.907601,155471,72105,156281,383857
2017-06-28,BYX Equities (Y),169966292,70899656,93332249,334198197,4992694416.247019,3107837386.145402,3358079220.211397,11458611022.603818,1442465,272603,762414,2477482
2017-06-28,BZX Equities (Z),211897917,88062083,118858655,418818655,7411975291.992742,5355967341.607491,5906427433.702300,18674370067.302533,1652461,366128,951088,2969677
2017-06-27,NYSE American (A),0,11059189,0,11059189,0.000000,70182801.943700,0.000000,70182801.943700,0,21200,0,21200
2017-06-27,NASDAQ BX (B),111240905,40963652,68182743,220387300,3844503095.016517,2093827336.938998,2834872763.459005,8773203195.414520,1110385,170876,686400,1967661
2017-06-27,NYSE (DN),103693964,38041597,97723377,239458938,2791140910.322499,1337499361.081701,2878105097.379798,7006745368.783998,175937,73272,180945,430154
2017-06-27,NASDAQ (DQ),1153611589,440402022,794979869,2388993480,36679618720.668301,21940405961.853364,31003790053.048935,89623814735.570600,3545748,848674,2186787,6581209
2017-06-27,EDGA Equities (J),54411917,30686988,32044891,117143796,1704750853.216602,1693404052.301000,1299066579.970699,4697221485.488301,485807,144589,242151,872547
2017-06-27,EDGX Equities (K),200897749,85048735,201817873,487764357,6606136836.259439,4635199138.227398,7324211844.562484,18565547819.049321,1316222,330552,1045692,2692466
2017-06-27,CHX (M),8760142,12303644,8954807,30018593,372808753.439800,950456144.917800,566740875.343900,1890005773.701500,3905,5046,2342,11293
2017-06-27,NYSE (N),886019263,0,0,886019263,31039913344.113560,0.000000,0.000000,31039913344.113560,2660451,0,0,2660451
2017-06-27,NYSE Arca (P),214409028,279556074,153888675,647853777,8208455547.069287,15254146553.853346,7639503125.210733,31102105226.133366,1586997,738809,1080208,3406014
2017-06-27,NASDAQ (Q),320560671,115344457,536590805,972495933,13377056091.058104,7686225007.155096,28321959804.971822,49385240903.185022,2850585,473811,3318108,6642504
2017-06-27,IEX (V),93983601,25130698,47542671,166656970,3513953166.423096,1426133194.930899,2384100267.587700,7324186628.941695,540661,93420,291987,926068
2017-06-27,NASDAQ PSX (X),19159813,18979160,21736543,59875516,652477848.464000,1037028332.084800,1301103015.202297,2990609195.751097,156265,75249,164711,396225
2017-06-27,BYX Equities (Y),177207277,82292512,97702277,357202066,4918944502.843099,3533667222.552308,3472407182.115513,11925018907.510920,1472675,316203,791869,2580747
2017-06-27,BZX Equities (Z),220817609,98645944,128092573,447556126,7474666852.986982,6025344408.316908,6324551261.594989,19824562522.898879,1702213,404945,1017641,3124799
2017-06-26,NYSE American (A),0,9296106,0,9296106,0.000000,59805088.971400,0.000000,59805088.971400,0,21045,0,21045
2017-06-26,NASDAQ BX (B),99881866,29701412,65428717,195011995,3361775135.186202,1465549988.360599,2489946148.516795,7317271272.063596,973417,138009,611173,1722599
2017-06-26,NYSE (DN),92896984,30801088,93124521,216822593,2494668544.567407,1050317178.973900,2708776341.292493,6253762064.833800,166235,65621,164474,396330
2017-06-26,NASDAQ (DQ),1069290776,397274588,834386284,2300951648,33754221374.383137,18966551543.069235,27701057625.065811,80421830542.518183,3295925,782631,2109313,6187869
2017-06-26,EDGA Equities (J),47794507,23677851,29973518,101445876,1456800744.445500,1202441406.867800,1096901664.498503,3756143815.811803,423154,107552,226490,757196
2017-06-26,EDGX Equities (K),182597006,70005347,206550757,459153110,5823075033.311485,3525595212.241593,6515277992.159885,15863948237.712963,1179493,269872,972051,2421416
2017-06-26,CHX (M),7316301,10789711,4825930,22931942,365881133.843100,935586440.000000,369885623.671200,1671353197.514300,3341,3857,1923,9121
2017-06-26,NYSE (N),794876817,0,0,794876817,28666593883.163912,0.000000,0.000000,28666593883.163912,2465740,0,0,2465740
2017-06-26,NYSE Arca (P),197653248,239987095,143724678,581365021,7571123909.899284,12955895803.862849,6680602156.739309,27207621870.501442,1459836,611770,986771,3058377
2017-06-26,NASDAQ (Q),289661746,89197905,500425986,879285637,12017147304.588749,5775283861.232189,24079081724.443779,41871512890.264717,2584530,385929,3017024,5987483
2017-06-26,IEX (V),81668665,20419519,47030044,149118228,2936344246.558807,1059510169.806201,2079789618.461001,6075644034.826009,485119,76572,272429,834120
2017-06-26,NASDAQ PSX (X),18928540,14585177,18568959,52082676,628191068.794799,817623694.153100,1018601598.652399,2464416361.600298,152220,63467,142281,357968
2017-06-26,BYX Equities (Y),157108388,60744339,92861487,310714214,4406206048.368306,2555856258.382895,3005185093.708609,9967247400.459810,1307380,250866,729657,2287903
2017-06-26,BZX Equities (Z),203990738,75346070,118566983,397903791,6857017907.892399,4211180241.951800,5363859051.376882,16432057201.221081,1560302,323238,924030,2807570
2017-06-23,NYSE American (A),0,94534247,0,94534247,0.000000,411604893.746600,0.000000,411604893.746600,0,30751,0,30751
2017-06-23,NASDAQ BX (B),115742523,32532506,76601712,224876741,4007328000.307282,1490595906.354097,2638764257.332399,8136688163.993778,1130543,151183,677323,1959049
2017-06-23,NYSE (DN),85542336,30068743,98595125,214206204,2562837344.938892,1003955776.227405,2450856451.233304,6017649572.399601,156392,67357,168368,392117
2017-06-23,NASDAQ (DQ),1734780716,376966007,1753569143,3865315866,63556660264.777200,17288034823.671762,53466097205.484317,134310792293.933279,3526476,731797,2321007,6579280
2017-06-23,EDGA Equities (J),59311464,25321874,37337084,121970422,1892576702.873099,1361588135.627101,1147607361.973400,4401772200.473600,531051,116882,255698,903631
2017-06-23,EDGX Equities (K),176681471,68394251,230653658,475729380,6082862783.455026,3565208552.662103,6360301169.428452,16008372505.545581,1189326,262555,980000,2431881
2017-06-23,CHX (M),8607888,21831445,6014326,36453659,511481452.144600,1761087058.955999,612773846.723500,2885342357.824099,5149,3501,2564,11214
2017-06-23,NYSE (N),2081398292,0,0,2081398292,71112696730.709880,0.000000,0.000000,71112696730.709880,2558653,0,0,2558653
2017-06-23,NYSE Arca (P),201112382,244440582,157327840,602880804,7976617812.555071,13403222144.124443,6394208468.001552,27774048424.681066,1467750,592927,1004821,3065498
2017-06-23,NASDAQ (Q),314970482,90384848,1491339059,1896694389,13367232271.824611,5705378010.465181,50650585160.934791,69723195443.224583,2746708,356573,3157869,6261150
2017-06-23,IEX (V),92315093,16857238,52382923,161555254,3391338216.681713,872078104.601100,2190787834.092898,6454204155.375711,554528,75167,306312,936007
2017-06-23,NASDAQ PSX (X),18476947,12820214,20146873,51444034,685190535.801801,717975761.391000,968662050.316600,2371828347.509401,157673,51762,143011,352446
2017-06-23,BYX Equities (Y),182633425,66007739,117163211,365804375,5215940479.569620,2842687421.311697,3356122593.680686,11414750494.562003,1568875,267074,847396,2683345
2017-06-23,BZX Equities (Z),210896577,75406579,123181012,409484168,7169216994.072638,4312732813.492377,5262067961.099003,16744017768.664018,1599491,303708,910521,2813720
2017-06-22,NYSE American (A),0,11652001,0,11652001,0.000000,61949468.254400,0.000000,61949468.254400,0,21397,0,21397
2017-06-22,NASDAQ BX (B),108597834,28132803,66251763,202982400,3866055137.073001,1216129220.823293,2454644740.698592,7536829098.594886,1065824,130084,632772,1828680
2017-06-22,NYSE (DN),91134812,31458050,101259768,223852630,2620523270.830401,1060700170.013999,2388657533.873204,6069880974.717604,164914,64600,169930,399444
2017-06-22,NASDAQ (DQ),1163248937,371306450,852026234,2386581621,38321661721.172926,17319219206.748466,27364204017.111035,83005084945.032427,3557103,758635,2159767,6475505
2017-06-22,EDGA Equities (J),56593134,24071016,31775106,112439256,1834004651.213701,1177146803.783899,1132567503.530199,4143718958.527799,503221,111902,239179,854302
2017-06-22,EDGX Equities (K),181584784,70539631,192873707,444998122,6363597981.634621,3278383706.998698,6112292377.167303,15754274065.800622,1225247,263689,925307,2414243
2017-06-22,CHX (M),11617957,12204333,5624639,29446929,540716337.226300,982980980.319000,381690554.214200,1905387871.759500,4042,3373,2299,9714
2017-06-22,NYSE (N),852809182,0,0,852809182,31684537727.426270,0.000000,0.000000,31684537727.426270,2478789,0,0,2478789
2017-06-22,NYSE Arca (P),206966801,255628997,149683326,612279124,8290660825.526975,12546840164.312538,6406654925.425729,27244155915.265242,1529110,608819,1003075,3141004
2017-06-22,NASDAQ (Q),310895062,88516187,497517059,896928308,12994328428.197470,5067701929.427607,23408093561.195303,41470123918.820380,2724850,373247,2893292,5991389
2017-06-22,IEX (V),88941597,18606240,47854662,155402499,3489650262.523505,945755262.661101,2196996249.767399,6632401774.952005,537281,70661,277727,885669
2017-06-22,NASDAQ PSX (X),19173224,13407958,18472680,51053862,717062494.611200,652798945.479700,936148678.761000,2306010118.851900,160711,55933,140248,356892
2017-06-22,BYX Equities (Y),167255689,60579188,97713430,325548307,4768260589.051353,2447843570.503997,3058586962.267685,10274691121.823035,1427902,248612,775547,2452061
2017-06-22,BZX Equities (Z),218433648,78233103,116385253,413052004,7504827939.686516,4015619420.335825,5006828280.834521,16527275640.856862,1672810,316018,902154,2890982
2017-06-21,NYSE American (A),0,9181331,0,9181331,0.000000,59346006.225600,0.000000,59346006.225600,0,21068,0,21068
2017-06-21,NASDAQ BX (B),118779176,33594050,67711653,220084879,4132658135.075779,1398811528.352596,2678405019.078103,8209874682.506478,1127008,151040,664931,1942979
2017-06-21,NYSE (DN),100464456,32436738,105439567,238340761,2785392652.572625,1064761256.961800,2559225794.199106,6409379703.733531,176554,67409,166463,410426
2017-06-21,NASDAQ (DQ),1176476990,418186047,946565915,2541228952,39464870643.331851,18505086941.498144,28820832444.723688,86790790029.553683,3743991,833264,2199302,6776557
2017-06-21,EDGA Equities (J),60627966,28185133,40080120,128893219,1927751015.683798,1376546194.366602,1258055864.611598,4562353074.661998,528390,133781,257351,919522
2017-06-21,EDGX Equities (K),196529805,83820728,241858828,522209361,6783761745.090827,4101143005.241597,6870597898.202642,17755502648.535066,1297179,322241,989801,2609221
2017-06-21,CHX (M),11119706,14222957,7229931,32572594,475365204.451600,1045136127.841200,607849624.972700,2128350957.265500,4417,4223,2192,10832
2017-06-21,NYSE (N),828999010,0,0,828999010,29393523557.285225,0.000000,0.000000,29393523557.285225,2646712,0,0,2646712
2017-06-21,NYSE Arca (P),216732100,278939305,175531041,671202446,8649151414.543330,14071589811.076807,7039827597.895284,29760568823.515421,1610983,728640,1063729,3403352
2017-06-21,NASDAQ (Q),346329159,107376142,526278451,979983752,14759575693.059807,6163054070.644903,24928187125.710336,45850816889.415046,3045219,448329,3099029,6592577
2017-06-21,IEX (V),102752905,20553953,46979794,170286652,3850291915.150196,1038925899.576401,2355997795.879602,7245215610.606199,583614,79362,279753,942729
2017-06-21,NASDAQ PSX (X),20073184,16506476,20597414,57177074,732501987.650000,747969114.112599,1042664677.535501,2523135779.298100,171477,67426,152125,391028
2017-06-21,BYX Equities (Y),186035317,69429389,102279108,357743814,5129056910.838013,2718954627.205791,3253285143.414516,11101296681.458320,1518038,291463,788596,2598097
2017-06-21,BZX Equities (Z),234279381,89449420,128248858,451977659,8085612968.654553,4860984905.153488,5656479349.965121,18603077223.773162,1791025,386645,962755,3140425
2017-06-20,NYSE American (A),0,9353747,0,9353747,0.000000,62264847.344100,0.000000,62264847.344100,0,21547,0,21547
2017-06-20,NASDAQ BX (B),115118812,30802449,62682694,208603955,3908802841.803394,1317421799.032601,2550067505.965200,7776292146.801195,1072437,145909,603700,1822046
2017-06-20,NYSE (DN),88078527,33431914,109628399,231138840,2522410417.345694,1125764402.142102,2530630106.404797,6178804925.892593,165255,71219,165597,402071
2017-06-20,NASDAQ (DQ),1107517186,410142861,1108279494,2625939541,36522172187.013244,18631936583.424042,31433681233.043934,86587790003.481220,3489515,826708,2097484,6413707
2017-06-20,EDGA Equities (J),57709476,26653905,49105310,133468691,1761949512.103293,1234469250.452401,1162454568.912799,4158873331.468493,491746,125320,238716,855782
2017-06-20,EDGX Equities (K),183728982,77800625,264885659,526415266,6265804117.644990,3737938261.326400,6745202132.647656,16748944511.619046,1197088,297185,966577,2460850
2017-06-20,CHX (M),13676979,24029999,11216676,48923654,656744220.188600,1473680013.823000,887505174.093600,3017929408.105200,4499,3780,2199,10478
2017-06-20,NYSE (N),812959592,0,0,812959592,29090411554.616606,0.000000,0.000000,29090411554.616606,2390225,0,0,2390225
2017-06-20,NYSE Arca (P),204473295,271978871,159213518,635665684,8296972213.248817,13841647545.376203,7005324797.853663,29143944556.478683,1505362,667024,983664,3156050
2017-06-20,NASDAQ (Q),331885273,102299610,535401224,969586107,13852277165.660918,6088518564.144510,25545575033.208437,45486370763.013865,2842240,413587,2923263,6179090
2017-06-20,IEX (V),88844328,19017304,40583172,148444804,3258552614.616097,1008228111.975900,2150617280.977302,6417398007.569299,522728,74995,255930,853653
2017-06-20,NASDAQ PSX (X),19150336,14496184,18721577,52368097,689484166.207199,671010104.449500,1050253328.647500,2410747599.304199,160270,60262,145108,365640
2017-06-20,BYX Equities (Y),179435628,66349105,100741003,346525736,4906304331.442714,2668275002.237399,3116043872.984178,10690623206.664291,1447222,270490,752114,2469826
2017-06-20,BZX Equities (Z),220125532,79009738,119987726,419122996,7301759318.026823,4245829474.139903,5291475880.065617,16839064672.232343,1640005,339177,900934,2880116
2017-06-19,NYSE American (A),0,9846941,0,9846941,0.000000,64446057.773800,0.000000,64446057.773800,0,23034,0,23034
2017-06-19,NASDAQ BX (B),111859793,28371019,65131167,205361979,4027796433.286605,1365403011.530307,2595799211.203506,7988998656.020418,1094797,142935,631209,1868941
2017-06-19,NYSE (DN),87159522,29720346,62477491,179357359,2567484484.039707,1060706886.404501,2558371950.456502,6186563320.900710,154357,61890,131590,347837
2017-06-19,NASDAQ (DQ),1064589781,417568157,777093205,2259251143,38144106402.929293,22355443084.363983,29845448113.876966,90344997601.170242,3494585,808975,2115473,6419033
2017-06-19,EDGA Equities (J),54240611,25370464,29505514,109116589,1727315557.121901,1312945065.100200,1096724422.988599,4136985045.210700,473796,121169,219352,814317
2017-06-19,EDGX Equities (K),173995258,70735364,171344725,416075347,6269596883.182007,3510116473.784096,6829998105.095413,16609711462.061516,1183163,284977,913857,2381997
2017-06-19,CHX (M),5805680,23904581,5441451,35151712,395811627.586000,1385114154.360000,495389971.910900,2276315753.856900,4224,3642,2281,10147
2017-06-19,NYSE (N),800918689,0,0,800918689,31298149927.046910,0.000000,0.000000,31298149927.046910,2487929,0,0,2487929
2017-06-19,NYSE Arca (P),190824118,257253043,137291818,585368979,8068537522.049399,13634952041.469175,6962692796.799201,28666182360.317775,1467351,629962,952935,3050248
2017-06-19,NASDAQ (Q),307766891,94336213,480698663,882801767,13499640333.343052,6037594092.437516,26282944979.125795,45820179404.906363,2763709,395581,2922273,6081563
2017-06-19,IEX (V),77796131,18971863,43462107,140230101,2989428254.568305,1009441203.583900,2229690180.028200,6228559638.180405,485885,83353,263711,832949
2017-06-19,NASDAQ PSX (X),17432210,14240301,16709934,48382445,672934981.275001,706786462.737600,938944631.267002,2318666075.279603,152651,58835,134893,346379
2017-06-19,BYX Equities (Y),171680284,64740247,88557389,324977920,5029235359.583079,2695602219.553686,3233985000.487499,10958822579.624264,1458255,274495,755696,2488446
2017-06-19,BZX Equities (Z),207419821,75989770,111576654,394986245,7350765527.207775,4334018073.481197,5472947604.760707,17157731205.449679,1626161,329539,890604,2846304
2017-06-16,NYSE American (A),0,187307745,0,187307745,0.000000,615801107.222900,0.000000,615801107.222900,0,29432,0,29432
2017-06-16,NASDAQ BX (B),124196379,35768793,77548492,237513664,4515296552.782424,1778491297.274602,3382897095.322213,9676684945.379239,1197226,174680,717292,2089198
2017-06-16,NYSE (DN),87619202,27595764,53189785,168404751,2560667269.357999,921966131.236298,2618922029.519798,6101555430.114095,154325,56146,130721,341192
2017-06-16,NASDAQ (DQ),1406517617,402793441,1000361476,2809672534,49723379238.492139,24340639920.199464,45943975494.556971,120007994653.248574,3874980,828826,2270313,6974119
2017-06-16,EDGA Equities (J),71885594,33439385,36440895,141765874,2323709726.949904,1744183030.689799,1645110129.258302,5713002886.898005,599805,157003,273261,1030069
2017-06-16,EDGX Equities (K),189028714,76341544,158706524,424076782,6780900504.134705,4124607252.815588,7392309919.470384,18297817676.420677,1295237,318946,977369,2591552
2017-06-16,CHX (M),7066098,13979735,23198569,44244402,391344591.366500,1545060879.518600,1584524236.105000,3520929706.990100,4960,3597,2587,11144
2017-06-16,NYSE (N),2267389450,0,0,2267389450,83846661321.518219,0.000000,0.000000,83846661321.518219,2794553,0,0,2794553
2017-06-16,NYSE Arca (P),230750339,276905853,141908921,649565113,9473005354.939652,16078979915.968472,8172468732.959603,33724454003.867727,1672809,718342,1015060,3406211
2017-06-16,NASDAQ (Q),359000662,112050162,1334084654,1805135478,15102583239.194639,7214030710.469667,67063382542.586171,89379996492.250477,2993279,454937,3298101,6746317
2017-06-16,IEX (V),101165676,23167721,50910412,175243809,3776610087.753581,1250153667.359900,2721141169.820404,7747904924.933885,579221,98069,311040,988330
2017-06-16,NASDAQ PSX (X),20757763,15729688,21588328,58075779,808011946.108099,854397742.270800,1275001626.744102,2937411315.123001,176915,64869,169156,410940
2017-06-16,BYX Equities (Y),196262802,77815120,105722720,379800642,5674407393.119865,3395148358.666206,4071487409.167109,13141043160.953180,1638385,341325,854097,2833807
2017-06-16,BZX Equities (Z),237746222,86669894,129344454,453760570,8534452882.368815,5095612399.770575,6855305146.014291,20485370428.153681,1825651,382175,1008438,3216264
2017-06-15,NYSE American (A),0,9459218,0,9459218,0.000000,59646439.257600,0.000000,59646439.257600,0,19966,0,19966
2017-06-15,NASDAQ BX (B),118083694,37088396,71726259,226898349,4381619935.374279,1682309700.847499,3161881034.001195,9225810670.222973,1194465,172995,717572,2085032
2017-06-15,NYSE (DN),85161809,35702441,51643515,172507765,2509456400.722409,1188920893.375297,2638694936.039802,6337072230.137508,144832,65924,122778,333534
2017-06-15,NASDAQ (DQ),1059829172,455358088,666210628,2181397888,36463297502.346969,22024187555.576811,30176306951.586623,88663792009.510403,3517737,902556,2091875,6512168
2017-06-15,EDGA Equities (J),60088549,33910101,28782962,122781612,1883025740.351602,1653810915.415298,1262138918.403203,4798975574.170103,517082,156264,243255,916601
2017-06-15,EDGX Equities (K),182835244,86358055,156258759,425452058,6614458848.743345,4588462069.223901,7192463208.637699,18395384126.604945,1288626,354796,1001772,2645194
2017-06-15,CHX (M),8870057,17846355,14616975,41333387,405032584.249900,1483227760.270000,1129655293.367000,3017915637.886900,4851,6101,3050,14002
2017-06-15,NYSE (N),828753043,0,0,828753043,31119012538.177660,0.000000,0.000000,31119012538.177660,2626792,0,0,2626792
2017-06-15,NYSE Arca (P),207187808,303305030,137741479,648234317,8458874682.572780,15956841480.689733,7623708153.979497,32039424317.242010,1586404,793146,1033060,3412610
2017-06-15,NASDAQ (Q),322436408,121416793,468163696,912016897,13725628262.166443,7458422092.146605,26182243390.236996,47366293744.550044,2914437,508473,3120645,6543555
2017-06-15,IEX (V),90687318,24211419,46214075,161112812,3417102902.563207,1282410715.339599,2587707587.869999,7287221205.772805,542390,100639,294168,937197
2017-06-15,NASDAQ PSX (X),19251226,18340565,20530022,58121813,717276982.762598,965104545.091899,1324500585.146900,3006882113.001397,166340,74522,155141,396003
2017-06-15,BYX Equities (Y),172279025,79634413,90351096,342264534,5004838374.323523,3273782533.561399,3492062018.960507,11770682926.845429,1470997,331304,789718,2592019
2017-06-15,BZX Equities (Z),216524175,98675310,117774495,432973980,7551574396.382989,5549691362.074002,6116940911.637007,19218206670.093998,1693262,427396,963431,3084089
2017-06-14,NYSE American (A),0,13950648,0,13950648,0.000000,94390998.539900,0.000000,94390998.539900,0,25394,0,25394
2017-06-14,NASDAQ BX (B),126663852,47205842,76492055,250361749,4640888319.480276,2099659077.309902,3412085453.088381,10152632849.878559,1244682,217304,737655,2199641
2017-06-14,NYSE (DN),80613704,39447505,56157223,176218432,2359968489.683609,1251257734.826101,2737204161.415597,6348430385.925307,141527,71976,122715,336218
2017-06-14,NASDAQ (DQ),1062911391,522102825,678132957,2263147173,34802352723.641230,25016139766.228345,29180182371.052265,88998674860.921840,3473327,966387,2026748,6466462
2017-06-14,EDGA Equities (J),63981833,38965720,31171178,134118731,1978262687.327695,1943903860.441000,1394455395.667100,5316621943.435795,549914,178478,256342,984734
2017-06-14,EDGX Equities (K),200152052,113714104,166988616,480854772,6825278889.496412,5425764597.431908,7505047907.459002,19756091394.387322,1318868,441732,1010395,2770995
2017-06-14,CHX (M),11985672,13021444,12686756,37693872,452253949.098500,1192227192.600001,921423100.650000,2565904242.348501,4209,7540,2412,14161
2017-06-14,NYSE (N),881736447,0,0,881736447,32229166555.534967,0.000000,0.000000,32229166555.534967,2769861,0,0,2769861
2017-06-14,NYSE Arca (P),228461417,384811687,147037761,760310865,8986646846.676354,18687580684.602025,8349372695.888678,36023600227.167057,1698611,1014551,1100375,3813537
2017-06-14,NASDAQ (Q),367635696,171069860,498514718,1037220274,15111968860.315859,9614416419.397516,28076618917.231982,52803004196.945357,3253113,678555,3328141,7259809
2017-06-14,IEX (V),83956778,25477800,41174807,150609385,3208702035.796714,1393475565.443001,2171582722.387400,6773760323.627115,508397,99101,264435,871933
2017-06-14,NASDAQ PSX (X),21744477,24268515,20636746,66649738,815166557.095199,1229823846.004699,1250346556.326400,3295336959.426298,188114,93874,164710,446698
2017-06-14,BYX Equities (Y),190445043,97659307,95601633,383705983,5501310896.009417,3859958777.747994,3765650551.073011,13126920224.830422,1623279,400241,827442,2850962
2017-06-14,BZX Equities (Z),238360729,131962906,124454655,494778290,8075689430.187330,7210311006.040991,6664000123.876386,21950000560.104707,1869266,564966,1028875,3463107
2017-06-13,NYSE American (A),0,10162214,0,10162214,0.000000,64507367.176500,0.000000,64507367.176500,0,21197,0,21197
2017-06-13,NASDAQ BX (B),116448181,30103139,73103330,219654650,4353360165.481980,1437568588.715599,3157120359.297516,8948049113.495095,1134737,150049,695928,1980714
2017-06-13,NYSE (DN),76327790,32072291,57659403,166059484,2392566687.248805,1059862732.023798,2867843196.092406,6320272615.365009,134849,60264,131060,326173
2017-06-13,NASDAQ (DQ),989377786,376065746,724375120,2089818652,34012188974.212125,18221128036.097605,30751186792.759961,82984503803.069691,3450771,775497,2172498,6398766
2017-06-13,EDGA Equities (J),58182645,26563023,33495546,118241214,1922226801.035904,1327200033.645997,1376149095.116300,4625575929.798201,510246,121538,253152,884936
2017-06-13,EDGX Equities (K),174726098,77473255,179682917,431882270,6399917643.805137,3663444440.129007,7600661387.218811,17664023471.152955,1204189,300522,1025189,2529900
2017-06-13,CHX (M),9934927,12896334,9024833,31856094,474169221.236900,904904019.834200,886299314.934700,2265372556.005800,4835,4927,2528,12290
2017-06-13,NYSE (N),825733287,0,0,825733287,30907064426.468768,0.000000,0.000000,30907064426.468768,2547207,0,0,2547207
2017-06-13,NYSE Arca (P),205800148,251319615,148927397,606047160,8546721674.396217,13429118389.199540,8118012998.959496,30093853062.555253,1553866,666879,1076077,3296822
2017-06-13,NASDAQ (Q),323473676,101060195,553520687,978054558,14393245803.568998,6139528326.813114,31073716869.300711,51606490999.682823,2925970,427048,3194360,6547378
2017-06-13,IEX (V),85975656,18932798,44642796,149551250,3320560401.676392,1097378205.069001,2270605029.917399,6688543636.662792,520451,76847,281058,878356
2017-06-13,NASDAQ PSX (X),19509851,15068358,20389536,54967745,737219752.804000,752343968.556100,1195026488.618399,2684590209.978499,171544,61279,158949,391772
2017-06-13,BYX Equities (Y),182253534,69428117,97361210,349042861,5438818831.006590,2888275822.631791,3798130773.128920,12125225426.767301,1558524,296114,835359,2689997
2017-06-13,BZX Equities (Z),210505045,81579837,121752600,413837482,7580646278.855884,4594606105.791406,6066945785.482092,18242198170.129382,1663125,356651,977765,2997541
2017-06-12,NYSE American (A),0,10420110,0,10420110,0.000000,78850578.064300,0.000000,78850578.064300,0,24366,0,24366
2017-06-12,NASDAQ BX (B),140920571,38362090,89462249,268744910,5249238246.849857,1863736347.549499,4165299989.822386,11278274584.221742,1341292,185455,850895,2377642
2017-06-12,NYSE (DN),97446144,33082201,69728243,200256588,3133181214.113113,1098842667.878501,4117841689.297307,8349865571.288921,160259,64713,168083,393055
2017-06-12,NASDAQ (DQ),1201891832,410960210,912894704,2525746746,43105888540.078975,23001127244.330583,43868891807.105199,109975907591.514757,3969436,861196,2694551,7525183
2017-06-12,EDGA Equities (J),73486650,33139261,41184249,147810160,2411120568.527096,1831278012.293999,1681775593.493100,5924174174.314195,623488,160777,295303,1079568
2017-06-12,EDGX Equities (K),231082187,95034305,239528015,565644507,8489926603.662332,5203727604.602820,10455581925.822439,24149236134.087591,1599721,421786,1376931,3398438
2017-06-12,CHX (M),7769108,11544642,8347747,27661497,419526762.216500,1013364744.770000,737344019.501000,2170235526.487500,4938,7075,3644,15657
2017-06-12,NYSE (N),951099121,0,0,951099121,35899642904.163304,0.000000,0.000000,35899642904.163304,3130063,0,0,3130063
2017-06-12,NYSE Arca (P),269525202,312729197,203754478,786008877,11399540605.940032,17036420195.806513,12417225956.016284,40853186757.762829,2002930,921303,1446188,4370421
2017-06-12,NASDAQ (Q),435573796,129490893,648499406,1213564095,19512689684.497910,8260188761.060183,40203883690.244119,67976762135.802212,3849252,585861,4401384,8836497
2017-06-12,IEX (V),106513333,22636153,59794676,188944162,4254229676.031699,1253492844.280800,3673482396.540307,9181204916.852806,625225,96526,378427,1100178
2017-06-12,NASDAQ PSX (X),24608733,18982443,27731319,71322495,987176984.956301,993955817.990099,1826280457.118000,3807413260.064400,217122,81129,213408,511659
2017-06-12,BYX Equities (Y),223266153,85575343,121427000,430268496,6465154517.524548,3772447692.757284,4900527874.250042,15138130084.531874,1829503,374955,1017286,3221744
2017-06-12,BZX Equities (Z),268666152,104470416,166514655,539651223,9905224796.322548,6292047723.891905,9309331380.908975,25506603901.123428,2092008,485159,1327081,3904248
2017-06-09,NYSE American (A),0,10512219,0,10512219,0.000000,92893366.527600,0.000000,92893366.527600,0,23266,0,23266
2017-06-09,NASDAQ BX (B),133120797,45204334,91535282,269860413,4876229374.959024,2422279280.813203,4323032881.328774,11621541537.101001,1271901,210148,871312,2353361
2017-06-09,NYSE (DN),98663514,41306304,98408262,238378080,3016494201.449097,1496332105.127401,4939640259.355904,9452466565.932402,176551,75734,225159,477444
2017-06-09,NASDAQ (DQ),1243666161,512686873,1236693157,2993046191,43202571079.626643,29418041569.901205,49093367006.922988,121713979656.450836,3964805,1002427,2922389,7889621
2017-06-09,EDGA Equities (J),70777844,42780235,58626212,172184291,2286157511.401306,2572562163.306800,1896125912.745399,6754845587.453505,603188,187787,325698,1116673
2017-06-09,EDGX Equities (K),226560625,112922028,332297632,671780285,8118530478.216041,6728301291.587988,11931280644.539727,26778112414.343756,1522363,465686,1445490,3433539
2017-06-09,CHX (M),6478644,14632351,8557273,29668268,295708099.551000,1696138333.708499,641672585.899700,2633519019.159199,5476,8304,4272,18052
2017-06-09,NYSE (N),984287365,0,0,984287365,37233817155.601438,0.000000,0.000000,37233817155.601438,3168261,0,0,3168261
2017-06-09,NYSE Arca (P),263050865,380696443,217195198,860942506,10687909289.129988,22944935574.075767,12863635860.454921,46496480723.660676,1942068,1046104,1441026,4429198
2017-06-09,NASDAQ (Q),402428900,159085925,718823319,1280338144,17528425244.716612,11849776209.792120,43361556683.552401,72739758138.061133,3601544,679461,4454011,8735016
2017-06-09,IEX (V),95345387,25871724,52049118,173266229,3539338653.993699,1742668464.276499,3265538130.339099,8547545248.609297,550902,104318,331537,986757
2017-06-09,NASDAQ PSX (X),23541541,24200563,31293727,79035831,887861179.528401,1517471742.929701,2070336930.947199,4475669853.405301,200643,98043,216330,515016
2017-06-09,BYX Equities (Y),214353754,106214157,131059394,451627305,6039555851.290944,4737342569.361209,5242654290.576423,16019552711.228576,1747884,411352,1048006,3207242
2017-06-09,BZX Equities (Z),267591023,125087095,178059512,570737630,9665905458.828779,8258046829.383009,9989373739.925311,27913326028.137099,2078692,544832,1352257,3975781
2017-06-08,NYSE American (A),0,11694249,0,11694249,0.000000,66690996.249700,0.000000,66690996.249700,0,22947,0,22947
2017-06-08,NASDAQ BX (B),132213561,36099773,72904777,241218111,4820360734.232429,1718221294.710300,2950482768.632691,9489064797.575420,1256611,171524,725080,2153215
2017-06-08,NYSE (DN),95201173,35537007,68008073,198746253,3039010340.254013,1158776907.241399,2540575916.166709,6738363163.662121,158048,68060,140225,366333
2017-06-08,NASDAQ (DQ),1169472654,422989738,831592719,2424055111,43010459732.102358,20785487969.710612,28996941769.392745,92792889471.205715,3712913,811108,2097953,6621974
2017-06-08,EDGA Equities (J),60374474,28939023,28927115,118240612,2027836157.351403,1544193244.634402,1087833574.951701,4659862976.937506,512880,133178,219014,865072
2017-06-08,EDGX Equities (K),215932974,85829587,200974374,502736935,8832777901.338799,4096050478.725294,7016887396.796188,19945715776.860281,1446411,321291,995084,2762786
2017-06-08,CHX (M),6936215,13169927,11151242,31257384,494057714.618400,1062960252.390000,899108082.720500,2456126049.728900,5010,4479,2635,12124
2017-06-08,NYSE (N),910598253,0,0,910598253,35114035601.424635,0.000000,0.000000,35114035601.424635,2818354,0,0,2818354
2017-06-08,NYSE Arca (P),244975997,284744552,145841285,675561834,11222079970.396999,14538775601.428282,6782048649.751101,32542904221.576382,1770986,733793,1011219,3515998
2017-06-08,NASDAQ (Q),358122970,115806685,506390988,980320643,16220282528.501845,7163551136.864418,25364470259.649710,48748303925.015973,3155288,470996,3135856,6762140
2017-06-08,IEX (V),98175620,18402806,46198616,162777042,3988784167.578000,982645221.676800,2321786934.272504,7293216323.527304,583184,73404,296547,953135
2017-06-08,NASDAQ PSX (X),19394113,15289545,19700264,54383922,773554681.150102,825630338.058200,1083702851.777601,2682887870.985903,170432,63523,152830,386785
2017-06-08,BYX Equities (Y),190065497,75524596,89406633,354996726,5610328601.911532,3054634814.232392,3274916851.493904,11939880267.637828,1551217,300051,790221,2641489
2017-06-08,BZX Equities (Z),234519388,88481773,113258482,436259643,8638064777.986672,4852842039.912289,5198902617.418492,18689809435.317453,1774905,375343,899105,3049353
2017-06-07,NYSE American (A),0,11757802,0,11757802,0.000000,65378041.218500,0.000000,65378041.218500,0,21896,0,21896
2017-06-07,NASDAQ BX (B),135238275,33062475,66867546,235168296,4658947073.832993,1447087453.451997,2841826604.899092,8947861132.184082,1275299,167923,690337,2133559
2017-06-07,NYSE (DN),93432075,35497178,64178089,193107342,2485547147.145107,1091715017.223500,2441256974.090601,6018519138.459208,151716,69483,134669,355868
2017-06-07,NASDAQ (DQ),1121509623,425217878,670230610,2216958111,35785750112.307318,18868304423.543436,25787331856.705788,80441386392.556542,3513587,822702,2012453,6348742
2017-06-07,EDGA Equities (J),60135047,30036815,25675016,115846878,1836629778.237193,1335347697.265901,977787695.155201,4149765170.658295,511449,130105,211557,853111
2017-06-07,EDGX Equities (K),199789291,84460560,157106871,441356722,6764944309.367785,3607913850.048304,6039071315.591195,16411929475.007284,1332036,321349,920212,2573597
2017-06-07,CHX (M),6449757,9008865,13110631,28569253,259756512.860000,633476154.420000,1048326913.304700,1941559580.584700,5101,3211,2027,10339
2017-06-07,NYSE (N),884131564,0,0,884131564,31786646468.655148,0.000000,0.000000,31786646468.655148,2510456,0,0,2510456
2017-06-07,NYSE Arca (P),217352496,286251225,127027507,630631228,8321640470.952557,13638834373.589024,5809246633.217299,27769721477.758880,1602381,719250,921496,3243127
2017-06-07,NASDAQ (Q),345707945,114360830,456261329,916330104,14070192708.390017,6466770180.797114,22873865148.002715,43410828037.189846,3025347,468289,2766117,6259753
2017-06-07,IEX (V),85863422,19953402,39492295,145309119,3189867138.666293,1063440638.861700,1916301816.610100,6169609594.138093,496496,77255,247959,821710
2017-06-07,NASDAQ PSX (X),18494122,16050182,17155126,51699430,660070050.394999,802388109.284800,868454446.404500,2330912606.084299,164424,67264,131096,362784
2017-06-07,BYX Equities (Y),178896465,72552362,81935923,333384750,5000469698.521037,2805386619.826106,2948358289.455984,10754214607.803127,1478281,297975,719776,2496032
2017-06-07,BZX Equities (Z),229221661,89394478,108181963,426798102,7669521764.629740,4480035737.260007,4738354139.192395,16887911641.082142,1734172,377279,855859,2967310
2017-06-06,NYSE American (A),0,15014333,0,15014333,0.000000,101556302.622800,0.000000,101556302.622800,0,22090,0,22090
2017-06-06,NASDAQ BX (B),110807684,31153015,65090388,207051087,3908508185.144282,1400052802.840603,2593288584.986401,7901849572.971286,1094767,155270,646713,1896750
2017-06-06,NYSE (DN),88248529,35776930,62823634,186849093,2295773838.598691,1103229269.844399,2693452831.877202,6092455940.320292,153662,72553,138721,364936
2017-06-06,NASDAQ (DQ),1087906171,422519299,713521685,2223947155,36045566343.580153,19564471810.030400,28514603582.372039,84124641735.982592,3422795,890821,2119748,6433364
2017-06-06,EDGA Equities (J),53851538,28931130,27566555,110349223,1655463594.583203,1341372517.954802,1026549330.066601,4023385442.604606,473412,131772,217363,822547
2017-06-06,EDGX Equities (K),181110606,80728711,158980742,420820059,6233341557.875901,3693058938.715104,6137622551.747697,16064023048.338702,1270678,315678,930221,2516577
2017-06-06,CHX (M),5797783,9597846,12733120,28128749,295922759.801800,973525202.823000,918364562.785900,2187812525.410700,4665,4218,2146,11029
2017-06-06,NYSE (N),833517603,0,0,833517603,30078276148.693413,0.000000,0.000000,30078276148.693413,2377091,0,0,2377091
2017-06-06,NYSE Arca (P),205614352,279748058,138526575,623888985,7954058789.649386,13345786334.921835,6366380066.992089,27666225191.563310,1503097,688589,959390,3151076
2017-06-06,NASDAQ (Q),317603224,105575850,453436607,876615681,13028929028.953795,5894746038.600475,23455466900.037425,42379141967.591695,2783193,439258,2830597,6053048
2017-06-06,IEX (V),84903291,17807523,44768956,147479770,3240766634.004594,960611899.847600,2251014545.530902,6452393079.383096,510672,75324,271580,857576
2017-06-06,NASDAQ PSX (X),17246259,14530067,18821733,50598059,604508874.094099,712406900.171500,901331819.513199,2218247593.778798,153851,62996,134980,351827
2017-06-06,BYX Equities (Y),175482626,70980719,84175561,330638906,4950854204.796527,2855078481.444533,3034760069.880598,10840692756.121658,1493043,301735,756039,2550817
2017-06-06,BZX Equities (Z),214669603,87801088,112666017,415136708,7170331130.245777,4294051255.268979,4927429434.019508,16391811819.534264,1622948,375406,868881,2867235
2017-06-05,NYSE American (A),0,11156370,0,11156370,0.000000,73600684.594100,0.000000,73600684.594100,0,20146,0,20146
2017-06-05,NASDAQ BX (B),111788189,25588808,65832097,203209094,3997446685.269509,1187496440.083999,2480417449.472300,7665360574.825808,1105011,136952,663931,1905894
2017-06-05,NYSE (DN),71937382,32368412,60050966,164356760,2090210042.501504,950485873.084600,2467335782.090910,5508031697.677014,136131,66267,136441,338839
2017-06-05,NASDAQ (DQ),934808160,345964177,656910945,1937683282,32992972667.527686,17280248709.759063,25873888813.030467,76147110190.317216,3167326,799704,1969924,5936954
2017-06-05,EDGA Equities (J),43516632,18902661,22020901,84440194,1416097724.438997,896594994.332902,835342495.919400,3148035214.691299,385389,87371,182267,655027
2017-06-05,EDGX Equities (K),153246487,61072592,150045361,364364440,5765022497.039502,2689086075.947097,5462979620.208402,13917088193.195001,1086148,241223,836075,2163446
2017-06-05,CHX (M),14502825,7297961,8318463,30119249,584439887.761500,529839744.370000,762665898.478000,1876945530.609500,4040,2717,1459,8216
2017-06-05,NYSE (N),699719137,0,0,699719137,25795542647.947292,0.000000,0.000000,25795542647.947292,2198009,0,0,2198009
2017-06-05,NYSE Arca (P),175609042,214841455,128134909,518585406,7221759143.023542,11519937167.308790,5372823692.153296,24114520002.485628,1343655,525319,852625,2721599
2017-06-05,NASDAQ (Q),282552040,77564782,417673015,777789837,12418002018.463966,4413908551.839172,20474534229.403189,37306444799.706327,2590207,329204,2628097,5547508
2017-06-05,IEX (V),77846130,14253139,40981745,133081014,3000199339.422801,742177693.609401,1934717813.441801,5677094846.474003,474697,61755,262658,799110
2017-06-05,NASDAQ PSX (X),14476496,10585991,13716401,38778888,540866263.687901,510547375.380400,704520159.650700,1755933798.719001,131469,48588,115240,295297
2017-06-05,BYX Equities (Y),152190679,48374091,78919100,279483870,4446780509.967162,2039823022.006394,2723703857.000601,9210307388.974157,1305045,225472,714001,2244518
2017-06-05,BZX Equities (Z),184527118,61502073,99559369,345588560,6421982392.905499,3200251339.161199,4129721128.109514,13751954860.176212,1427160,270324,773092,2470576
2017-06-02,NYSE American (A),0,9111859,0,9111859,0.000000,58279972.979200,0.000000,58279972.979200,0,20616,0,20616
2017-06-02,NASDAQ BX (B),134096842,34497016,72379595,240973453,4882668459.447132,1864013374.010094,2950902280.955601,9697584114.412827,1250932,174606,705116,2130654
2017-06-02,NYSE (DN),83971266,33128595,59370017,176469878,2551227962.832007,1139587152.402494,2468512174.722209,6159327289.956710,153586,67899,130938,352423
2017-06-02,NASDAQ (DQ),1072046347,409958115,636334701,2118339163,35489171820.910534,25246361721.262886,26744130597.529029,87479664139.702449,3446516,846752,2020876,6314144
2017-06-02,EDGA Equities (J),56540394,28958480,24817401,110316275,1800746321.214909,1561450732.640698,1090124060.209198,4452321114.064805,467890,126921,203894,798705
2017-06-02,EDGX Equities (K),177955819,79716562,150571737,408244118,6372881979.680276,4445730235.978506,6643007755.573118,17461619971.231900,1202107,313664,895460,2411231
2017-06-02,CHX (M),11437676,9851572,5693272,26982520,463838308.734000,813954199.435000,463494344.199200,1741286852.368200,4525,4265,2280,11070
2017-06-02,NYSE (N),866398154,0,0,866398154,32367845617.058550,0.000000,0.000000,32367845617.058550,2460715,0,0,2460715
2017-06-02,NYSE Arca (P),222260748,275815623,136393601,634469972,8856347349.545907,15469391913.695566,6833857868.718898,31159597131.960371,1611461,694246,926721,3232428
2017-06-02,NASDAQ (Q),338454022,107016843,481937920,927408785,14649691980.746265,7410062928.114783,26172548653.199784,48232303562.060832,2966829,439751,2945365,6351945
2017-06-02,IEX (V),87039127,17958501,41436844,146434472,3393965195.263096,1062520853.778000,2279088686.860700,6735574735.901796,514401,73701,258925,847027
2017-06-02,NASDAQ PSX (X),18351154,15639920,17703239,51694313,677337234.082999,906729011.300801,908974328.477499,2493040573.861299,158184,66352,133102,357638
2017-06-02,BYX Equities (Y),176582439,69410795,84604523,330597757,5221798754.263560,3197580461.102202,3263988989.767399,11683368205.133161,1447602,287334,742455,2477391
2017-06-02,BZX Equities (Z),220366356,85679023,114208197,420253576,7781600855.963254,5372703569.254077,5662398859.383604,18816703284.600935,1670198,360860,871776,2902834
2017-06-01,NYSE American (A),0,10738338,0,10738338,0.000000,70045681.672300,0.000000,70045681.672300,0,21720,0,21720
2017-06-01,NASDAQ BX (B),138397523,35670668,73703597,247771788,5024301250.005961,1819839904.082905,2824146652.159494,9668287806.248360,1355516,181001,729507,2266024
2017-06-01,NYSE (DN),96476462,37246734,64264354,197987550,2786855515.909824,1327159467.934505,2463124153.309902,6577139137.154231,220387,78921,159947,459255
2017-06-01,NASDAQ (DQ),1222358183,434508152,686740672,2343607007,38731177536.113171,23214425350.295857,25968125061.814143,87913727948.223171,3685227,858060,2062775,6606062
2017-06-01,EDGA Equities (J),59441653,30015914,27594447,117052014,1902510534.748808,1563236903.530101,1038454005.313199,4504201443.592108,512554,128666,219462,860682
2017-06-01,EDGX Equities (K),202042519,81496838,155536074,439075431,7554955246.081840,4381751407.823389,6197141841.071020,18133848494.976249,1378380,323177,947272,2648829
2017-06-01,CHX (M),15505977,9351713,5443287,30300977,800545342.729200,842246674.080000,470563943.189700,2113355959.998900,5118,4618,2247,11983
2017-06-01,NYSE (N),974216758,0,0,974216758,34102642897.197121,0.000000,0.000000,34102642897.197121,2700029,0,0,2700029
2017-06-01,NYSE Arca (P),248583341,296456992,145392842,690433175,9994860048.971897,17617733238.263764,6416111022.722630,34028704309.958291,1822211,729244,1012878,3564333
2017-06-01,NASDAQ (Q),374839904,109930773,522700129,1007470806,16306443382.865405,7318316786.604889,25395150767.935038,49019910937.405332,3316215,452451,2975324,6743990
2017-06-01,IEX (V),86644722,18483187,43541819,148669728,3385444155.034811,1018892363.622800,2031542149.717400,6435878668.375011,527760,76352,270514,874626
2017-06-01,NASDAQ PSX (X),19377562,16012199,17789372,53179133,714596698.357401,893863598.391100,843722830.209401,2452183126.957902,173741,65002,140871,379614
2017-06-01,BYX Equities (Y),183319162,68103396,85120926,336543484,5395499348.724680,3102333605.253993,3024449773.059314,11522282727.037987,1558222,293087,757844,2609153
2017-06-01,BZX Equities (Z),239421567,90764558,118174955,448361080,8607752127.764175,5299710972.318996,5207515391.038081,19114978491.121252,1856210,379872,923558,3159640
2017-05-31,NYSE American (A),0,15205303,0,15205303,0.000000,124296984.365000,0.000000,124296984.365000,0,21960,0,21960
2017-05-31,NASDAQ BX (B),130685443,38249059,71426611,240361113,4675595735.284522,1799981065.759706,2982388646.984002,9457965448.028230,1261896,170034,714772,2146702
2017-05-31,NYSE (DN),107166191,42077694,66583316,215827201,3041220613.507208,1514164812.380795,2893848261.531004,7449233687.419007,258340,85356,191622,535318
2017-05-31,NASDAQ (DQ),1286506350,446519247,738466380,2471491977,42344740874.865232,25725801984.942736,31446493896.752455,99517036756.560423,3793895,834289,2028274,6656458
2017-05-31,EDGA Equities (J),75510174,34296525,32428029,142234728,2345294327.116093,1758274535.077800,1277973678.211497,5381542540.405390,621561,148949,264393,1034903
2017-05-31,EDGX Equities (K),214209491,86802295,152709535,453721321,7589644333.204967,4423735567.638294,6405292434.297900,18418672335.141161,1379432,327727,933661,2640820
2017-05-31,CHX (M),11187006,10901213,3999015,26087234,526953378.709600,839433711.832300,416077801.820000,1782464892.361900,6039,4763,1992,12794
2017-05-31,NYSE (N),1449897558,0,0,1449897558,58438553153.185998,0.000000,0.000000,58438553153.185998,2775394,0,0,2775394
2017-05-31,NYSE Arca (P),272008940,315752177,143518306,731279423,10536374720.837318,17437141514.034053,6935340012.909340,34908856247.780711,1935619,792420,1047604,3775643
2017-05-31,NASDAQ (Q),391434053,128206303,726170974,1245811330,16209892588.706557,8209605384.759876,36876370867.416905,61295868840.883338,3280061,509937,3031932,6821930
2017-05-31,IEX (V),93295346,18826522,44329800,156451668,3364975978.442800,993895578.565902,2152666791.162496,6511538348.171198,574742,77587,279829,932158
2017-05-31,NASDAQ PSX (X),23225592,18051348,19214526,60491466,814214719.402100,1005835095.706399,1019969776.759601,2840019591.868100,194950,73307,152678,420935
2017-05-31,BYX Equities (Y),200930448,77594552,91261589,369786589,5659512602.109968,3384664933.225895,3329413683.740802,12373591219.076665,1648998,296859,805355,2751212
2017-05-31,BZX Equities (Z),261985281,99521791,122024747,483531819,8907706897.514053,5653992718.303788,5523521398.087697,20085221013.905538,1911190,407780,935569,3254539
2017-05-30,NYSE American (A),0,10189700,0,10189700,0.000000,126497813.161200,0.000000,126497813.161200,0,25515,0,25515
2017-05-30,NASDAQ BX (B),104255293,23376094,59652041,187283428,3687158995.298709,1043857947.206300,2324925209.193605,7055942151.698614,1030188,120011,605267,1755466
2017-05-30,NYSE (DN),95620476,29426250,60278189,185324915,2530525709.306607,1007081892.314503,2367383972.253001,5904991573.874111,199233,65388,152324,416945
2017-05-30,NASDAQ (DQ),1071166779,307781510,627374795,2006323084,33882472548.488378,13823438852.588612,24816606452.822357,72522517853.899347,3286001,690584,1916581,5893166
2017-05-30,EDGA Equities (J),55184655,20731651,25400753,101317059,1613515908.736203,1006342341.978598,938323554.250301,3558181804.965102,471017,100889,211120,783026
2017-05-30,EDGX Equities (K),164451578,58906022,139400117,362757717,5372828458.587581,2807112519.662499,5387911814.138711,13567852792.388791,1035441,238969,796251,2070661
2017-05-30,CHX (M),8550986,6312982,7229552,22093520,431087080.311600,467580647.958000,572015230.817300,1470682959.086900,4163,3289,1424,8876
2017-05-30,NYSE (N),770455232,0,0,770455232,27765571793.907598,0.000000,0.000000,27765571793.907598,2158855,0,0,2158855
2017-05-30,NYSE Arca (P),185114522,196631154,120818608,502564284,7068541248.567008,10229927029.855462,5294693811.440211,22593162089.862681,1345640,522694,809331,2677665
2017-05-30,NASDAQ (Q),305866467,74109405,422461302,802437174,12609951016.859641,4423506271.548895,21927002073.418474,38960459361.827010,2674013,332159,2563058,5569230
2017-05-30,IEX (V),75272374,12442877,38141666,125856917,2631424392.701599,627302693.320700,1709668507.349502,4968395593.371801,455587,55219,235336,746142
2017-05-30,NASDAQ PSX (X),16656360,10256811,15627755,42540926,553592826.836599,517578021.603500,742359728.123200,1813530576.563299,135497,46397,118238,300132
2017-05-30,BYX Equities (Y),154279483,47920478,73936361,276136322,4281692409.723309,1957466988.699501,2642736948.846203,8881896347.269013,1299685,218042,660156,2177883
2017-05-30,BZX Equities (Z),198987378,62824226,100615345,362426949,6582324580.570468,3402997406.237604,4365554814.685987,14350876801.494059,1483758,285781,769318,2538857
2017-05-26,NYSE American (A),0,15748332,0,15748332,0.000000,164229434.350400,0.000000,164229434.350400,0,25970,0,25970
2017-05-26,NASDAQ BX (B),98671269,27621751,56840109,183133129,3607384711.532502,1330255729.022001,2246015769.567398,7183656210.121901,986301,130859,582988,1700148
2017-05-26,NYSE (DN),77428013,26843537,55320585,159592135,2281433571.244311,936835499.372300,2342357825.332998,5560626895.949609,187477,59248,145090,391815
2017-05-26,NASDAQ (DQ),894226165,299533045,586194993,1779954203,28896709367.902178,14516123845.717193,22817582593.040255,66230415806.659626,3098257,674171,1825705,5598133
2017-05-26,EDGA Equities (J),52213165,23857171,25410237,101480573,1528164849.924202,1219286406.800299,937323223.593398,3684774480.317899,447176,111308,213772,772256
2017-05-26,EDGX Equities (K),145191942,57325010,129080313,331597265,5083466922.873895,2798979992.102596,4835023958.518788,12717470873.495279,963260,224118,736084,1923462
2017-05-26,CHX (M),8425255,6789739,8926695,24141689,454723894.073300,420368163.100000,960188517.885200,1835280575.058500,4494,2972,2326,9792
2017-05-26,NYSE (N),682818586,0,0,682818586,24070963067.074646,0.000000,0.000000,24070963067.074646,2048520,0,0,2048520
2017-05-26,NYSE Arca (P),169373341,217010521,113102592,499486454,6818765717.441215,11565081540.937444,5038589118.875692,23422436377.254351,1265704,539674,771625,2577003
2017-05-26,NASDAQ (Q),274513159,73069655,389093737,736676551,11495926299.402752,4439927371.901304,19676192530.238259,35612046201.542315,2455147,322727,2433234,5211108
2017-05-26,IEX (V),63904030,12836757,32325886,109066673,2450361396.166611,623521828.384500,1507397578.328003,4581280802.879114,386344,55292,199641,641277
2017-05-26,NASDAQ PSX (X),15527087,10218273,13215014,38960374,537428770.326699,510736786.783300,597098119.640900,1645263676.750899,130631,44379,107610,282620
2017-05-26,BYX Equities (Y),143007021,51370355,70959565,265336941,4126000886.843933,2135833415.395606,2484055646.064295,8745889948.303834,1211196,226815,644274,2082285
2017-05-26,BZX Equities (Z),181640409,60008304,92731817,334380530,6121408818.990110,3267497008.195203,4134420779.703595,13523326606.888908,1383319,263442,727214,2373975
2017-05-25,NYSE American (A),0,9493937,0,9493937,0.000000,63401636.210600,0.000000,63401636.210600,0,19278,0,19278
2017-05-25,NASDAQ BX (B),108551330,30759156,61138897,200449383,3892096651.580800,1359546029.938702,2505788272.239404,7757430953.758906,1046673,150299,634872,1831844
2017-05-25,NYSE (DN),106873839,37313613,61614822,205802274,3113725281.624527,1300838918.672301,2947158887.397798,7361723087.694626,232074,77328,165463,474865
2017-05-25,NASDAQ (DQ),1168668606,413559641,661411734,2243639981,38378644104.543253,19220458202.971495,28442846793.085009,86041949100.599757,3608005,821197,2090378,6519580
2017-05-25,EDGA Equities (J),61934250,31010675,27884318,120829243,1888174840.593907,1456168142.008000,1098438419.441701,4442781402.043608,524434,137896,235167,897497
2017-05-25,EDGX Equities (K),190757475,77753402,144619166,413130043,6424377389.072690,3516427875.788206,5649569006.929394,15590374271.790290,1187447,294494,844002,2325943
2017-05-25,CHX (M),10799319,9600415,8069562,28469296,614164560.846500,747432479.652400,713058732.475600,2074655772.974500,4209,3576,1901,9686
2017-05-25,NYSE (N),814536148,0,0,814536148,29188581794.799425,0.000000,0.000000,29188581794.799425,2523813,0,0,2523813
2017-05-25,NYSE Arca (P),219550887,262550333,131328163,613429383,8411728649.322686,13451004136.521233,6246107277.496787,28108840063.340706,1579285,698232,909430,3186947
2017-05-25,NASDAQ (Q),359588492,104494680,444400883,908484055,14870879676.844662,5968880105.321379,22925069449.438514,43764829231.604555,3102630,425890,2808974,6337494
2017-05-25,IEX (V),86309680,17753586,38474915,142538181,3346436694.216797,815288660.105300,1951441466.561400,6113166820.883497,480803,73005,237039,790847
2017-05-25,NASDAQ PSX (X),18285231,13867538,15293330,47446099,634740159.239500,726051046.675400,792449031.435600,2153240237.350500,150095,57195,122409,329699
2017-05-25,BYX Equities (Y),167874239,65231748,78172527,311278514,4740751884.473009,2637871854.089397,2919390127.467597,10298013866.030003,1393016,276394,704685,2374095
2017-05-25,BZX Equities (Z),224488367,83584420,103350178,411422965,7388865983.912776,4395953387.462507,4828588858.748098,16613408230.123381,1654288,356018,830751,2841057
2017-05-24,NYSE American (A),0,12519388,0,12519388,0.000000,88341294.608900,0.000000,88341294.608900,0,23047,0,23047
2017-05-24,NASDAQ BX (B),109823724,30807702,59454715,200086141,3884139413.422690,1308904798.516205,2359793209.540898,7552837421.479793,1056494,146364,606093,1808951
2017-05-24,NYSE (DN),103759857,35430016,63041968,202231841,2981668507.314703,1208677408.418301,2623962141.789698,6814308057.522702,223567,76233,157826,457626
2017-05-24,NASDAQ (DQ),1084444072,364266568,614519335,2063229975,35191989968.784394,15973398306.680153,24745759133.153975,75911147408.618522,3344433,765066,1918489,6027988
2017-05-24,EDGA Equities (J),61802764,28878817,26140671,116822252,1854737758.545397,1359228069.529401,1051163689.546200,4265129517.620998,519608,139745,225513,884866
2017-05-24,EDGX Equities (K),181767674,75646887,133745183,391159744,6082148396.998018,3416051909.562301,5378734605.406498,14876934911.966817,1142354,284205,811881,2238440
2017-05-24,CHX (M),12038206,10751340,6306517,29096063,556156978.893800,734615533.440000,407553271.212400,1698325783.546200,4847,3035,1698,9580
2017-05-24,NYSE (N),797294341,0,0,797294341,27177983841.449399,0.000000,0.000000,27177983841.449399,2315711,0,0,2315711
2017-05-24,NYSE Arca (P),217347039,255834676,125725468,598907183,8157068088.051791,12855902629.602140,5594161048.807202,26607131766.461133,1504164,672502,867839,3044505
2017-05-24,NASDAQ (Q),348835597,97481864,422813787,869131248,14278669581.759711,5708039451.178993,20989443229.997458,40976152262.936162,2924305,417160,2673540,6015005
2017-05-24,IEX (V),74032494,15796423,36177454,126006371,2753246598.788309,710327456.507600,1876882007.098700,5340456062.394609,421436,66228,222154,709818
2017-05-24,NASDAQ PSX (X),18107520,13706415,15105018,46918953,618594692.433700,705050859.206800,717196504.452800,2040842056.093300,149267,57165,119450,325882
2017-05-24,BYX Equities (Y),161036269,62095442,71282335,294414046,4450439797.006777,2457580006.879196,2630851492.857411,9538871296.743384,1322550,267482,647239,2237271
2017-05-24,BZX Equities (Z),218955124,79279533,98071307,396305964,7064060315.843372,4142419487.960386,4478191678.231013,15684671482.034771,1570689,343924,784928,2699541
2017-05-23,NYSE American (A),0,11034780,0,11034780,0.000000,69582412.487900,0.000000,69582412.487900,0,21730,0,21730
2017-05-23,NASDAQ BX (B),104827582,27496192,59211506,191535280,3770374012.138088,1237478306.365701,2272978628.902702,7280830947.406491,1042504,137977,612347,1792828
2017-05-23,NYSE (DN),93043095,32519707,65037843,190600645,2869363896.502022,1176471371.164200,2635358961.779896,6681194229.446118,205563,74587,163326,443476
2017-05-23,NASDAQ (DQ),1045881486,387151835,629342279,2062375600,35535809812.201604,17351020638.840491,24983767071.908614,77870597522.950709,3274969,745981,1963602,5984552
2017-05-23,EDGA Equities (J),57976639,27437113,27108338,112522090,1750818492.494195,1192325684.335002,1004440149.044801,3947584325.873998,492873,123303,232374,848550
2017-05-23,EDGX Equities (K),159992474,69782716,138886928,368662118,5776176614.854090,3177848032.586991,5374816945.413202,14328841592.854283,1067788,270953,835023,2173764
2017-05-23,CHX (M),15284754,12821575,4018102,32124431,760833546.681000,862081794.584800,396529161.919800,2019444503.185600,4427,3646,2348,10421
2017-05-23,NYSE (N),767389888,0,0,767389888,27540415868.054951,0.000000,0.000000,27540415868.054951,2303820,0,0,2303820
2017-05-23,NYSE Arca (P),198892763,245133243,126184221,570210227,7989901854.569675,12026683588.902966,5677216370.581777,25693801814.054418,1439182,628833,890432,2958447
2017-05-23,NASDAQ (Q),325407071,91117823,432392547,848917441,13944564773.340851,5330824517.110107,21327925522.893292,40603314813.344250,2849952,377521,2795438,6022911
2017-05-23,IEX (V),71730536,14078636,37572345,123381517,2796885896.027601,659881210.156100,1881049411.763803,5337816517.947504,424917,59139,232787,716843
2017-05-23,NASDAQ PSX (X),17184484,12304704,14761330,44250518,590719815.926200,660054266.762000,732815567.633800,1983589650.322000,140775,54106,122463,317344
2017-05-23,BYX Equities (Y),161478706,57570406,74756811,293805923,4552770547.125717,2255371466.807104,2695512915.167196,9503654929.100017,1344796,242532,685296,2272624
2017-05-23,BZX Equities (Z),197479441,76636478,99870197,373986116,6788776028.193278,3935857459.699489,4395037375.752111,15119670863.644878,1495587,324288,797294,2617169
2017-05-22,NYSE American (A),0,9557384,0,9557384,0.000000,63315681.409000,0.000000,63315681.409000,0,20036,0,20036
2017-05-22,NASDAQ BX (B),106901126,25681925,61190566,193773617,3915421018.334702,1178977242.624899,2393134122.687300,7487532383.646901,1053739,131162,614828,1799729
2017-05-22,NYSE (DN),90368240,34075173,64446301,188889714,2669177657.242113,1219301166.453499,2524526581.842301,6413005405.537913,211515,72786,168677,452978
2017-05-22,NASDAQ (DQ),1022373947,357819210,634477037,2014670194,34523792264.134076,18674831968.846940,25375428369.416873,78574052602.397889,3347244,761429,2037033,6145706
2017-05-22,EDGA Equities (J),54929595,25763407,27753833,108446835,1677989950.093395,1227894530.713099,1046514480.142799,3952398960.949293,477770,124538,233393,835701
2017-05-22,EDGX Equities (K),158856552,67509277,142500948,368866777,5600560963.046191,3300814652.583800,5520848871.221316,14422224486.851307,1053252,265865,830815,2149932
2017-05-22,CHX (M),19120383,17185037,3994282,40299702,1060474579.016800,907267769.597000,334648633.692400,2302390982.306200,5357,3369,1997,10723
2017-05-22,NYSE (N),792169669,0,0,792169669,28937770224.221863,0.000000,0.000000,28937770224.221863,2307549,0,0,2307549
2017-05-22,NYSE Arca (P),192638439,242697702,121867644,557203785,7567755905.294953,12222376258.758083,5534009654.542596,25324141818.595632,1392327,614703,865341,2872371
2017-05-22,NASDAQ (Q),311193730,87320142,443411985,841925857,13387974025.108251,5223809238.099803,21815462907.774002,40427246170.982056,2760872,378568,2729072,5868512
2017-05-22,IEX (V),70396459,14911498,35672867,120980824,2688310716.526902,706238924.029000,1664142769.563899,5058692410.119801,439207,63672,238683,741562
2017-05-22,NASDAQ PSX (X),16999476,12239637,14821885,44060998,608309172.719000,620552616.503900,689540754.315699,1918402543.538599,143053,51256,122429,316738
2017-05-22,BYX Equities (Y),156911082,54005945,77367279,288284306,4632562848.379251,2204561418.780692,2800500857.185698,9637625124.345641,1341798,241529,705650,2288977
2017-05-22,BZX Equities (Z),183721425,68858293,100686146,353265864,6402199290.259379,3579830081.396005,4238438891.969495,14220468263.624879,1407451,294023,783437,2484911
2017-05-19,NYSE American (A),0,14685040,0,14685040,0.000000,109862533.742800,0.000000,109862533.742800,0,20319,0,20319
2017-05-19,NASDAQ BX (B),124462926,33806305,67712697,225981928,4429633357.003834,1791106441.680298,2660921522.834205,8881661321.518337,1173263,169202,664070,2006535
2017-05-19,NYSE (DN),97454803,36516924,62003582,195975309,2980379935.541491,1408327564.270101,2554331274.281999,6943038774.093591,226927,78781,157226,462934
2017-05-19,NASDAQ (DQ),1178867455,474169333,650338489,2303375277,39766641983.270504,28973411471.356836,27218790158.172045,95958843612.799385,3701472,872713,2061312,6635497
2017-05-19,EDGA Equities (J),70991873,34889974,30376232,136258079,2114753659.099006,1836015622.983499,1236946445.019000,5187715727.101505,582001,166590,261028,1009619
2017-05-19,EDGX Equities (K),193916008,91521555,150045799,435483362,6914026510.412589,5049415727.272594,6154342694.489504,18117784932.174687,1296613,358488,919320,2574421
2017-05-19,CHX (M),15786504,12225769,8419250,36431523,805545979.199200,1297182154.672800,724380411.405500,2827108545.277500,4856,5130,1968,11954
2017-05-19,NYSE (N),1029082366,0,0,1029082366,40757205194.866802,0.000000,0.000000,40757205194.866802,2678655,0,0,2678655
2017-05-19,NYSE Arca (P),237073981,329175941,139627654,705877576,9483234548.010643,18310176997.296527,6894333121.145109,34687744666.452279,1699841,872096,991426,3563363
2017-05-19,NASDAQ (Q),366809286,128861290,546728901,1042399477,15629527702.915005,8643387766.582993,29106070273.359822,53378985742.857820,3106228,505453,3036110,6647791
2017-05-19,IEX (V),83497168,21861710,36704206,142063084,3166014216.379697,1198142494.555799,1746141677.828500,6110298388.763996,471197,89397,234898,795492
2017-05-19,NASDAQ PSX (X),19114025,16825130,17317386,53256541,687917083.477801,1002381707.721399,814342990.464999,2504641781.664199,160087,71592,132557,364236
2017-05-19,BYX Equities (Y),188255246,75099325,83983885,347338456,5235159803.733218,3292221300.108503,3079464418.197005,11606845522.038726,1492819,326736,743571,2563126
2017-05-19,BZX Equities (Z),226388904,99261741,114772910,440423555,7869938507.634582,5924592843.061212,5405416886.702097,19199948237.397891,1702489,424538,902346,3029373
2017-05-18,NYSE American (A),0,10620906,0,10620906,0.000000,73784860.938200,0.000000,73784860.938200,0,23480,0,23480
2017-05-18,NASDAQ BX (B),133036070,43623742,76212116,252871928,4779635917.309427,2155282680.071006,3248608122.431802,10183526719.812235,1229303,206010,739533,2174846
2017-05-18,NYSE (DN),118252871,53134963,79579181,250967015,3422349855.473298,1991055201.844199,3264086388.294599,8677491445.612096,288436,113297,224741,626474
2017-05-18,NASDAQ (DQ),1370115308,550502341,759932017,2680549666,43657676827.503309,27177305589.178441,31074338212.518980,101909320629.200730,4152511,1178120,2356898,7687529
2017-05-18,EDGA Equities (J),84004011,46997078,37155295,168156384,2437307103.148595,2346085380.058098,1559804353.931199,6343196837.137892,675302,215812,306849,1197963
2017-05-18,EDGX Equities (K),230278619,124447888,167465541,522192048,7705895135.177580,6526146808.100002,7088553218.855194,21320595162.132776,1507458,494761,1060826,3063045
2017-05-18,CHX (M),8666179,14956362,6121941,29744482,386929864.602600,1278311553.989999,601356921.881000,2266598340.473599,5079,6694,2384,14157
2017-05-18,NYSE (N),1017606968,0,0,1017606968,34449009409.702765,0.000000,0.000000,34449009409.702765,3154913,0,0,3154913
2017-05-18,NYSE Arca (P),307719738,470438535,162825441,940983714,10881976097.713735,23634198182.009456,8233875055.230558,42750049334.953749,2010239,1289720,1172898,4472857
2017-05-18,NASDAQ (Q),448693776,191948615,548274801,1188917192,18394223688.845505,11530315656.625236,27961982991.319759,57886522336.790500,3787211,739649,3586397,8113257
2017-05-18,IEX (V),104663982,26846908,49648461,181159351,3633442969.953295,1494873821.170600,2234239544.837695,7362556335.961590,583268,106523,311444,1001235
2017-05-18,NASDAQ PSX (X),26119468,23485863,21309124,70914455,929475980.429599,1440204712.858599,1111804168.386501,3481484861.674699,209141,92228,165932,467301
2017-05-18,BYX Equities (Y),208029452,90152948,97468790,395651190,5678987556.146495,3829071810.637385,3735709049.059583,13243768415.843463,1634642,380252,855396,2870290
2017-05-18,BZX Equities (Z),262259984,135991313,128624469,526875766,8591447279.456883,7999159672.584480,6288182811.014813,22878789763.056176,1922732,579108,1027056,3528896
2017-05-17,NYSE American (A),0,11326054,0,11326054,0.000000,73698008.780499,0.000000,73698008.780499,0,25908,0,25908
2017-05-17,NASDAQ BX (B),135026022,50687619,79856722,265570363,5020899570.546669,2551029178.398797,3220365847.128495,10792294596.073961,1282097,222338,758932,2263367
2017-05-17,NYSE (DN),125057742,60005699,92794812,277858253,4024882273.699911,2387636662.616313,3999652332.922398,10412171269.238622,323780,135326,267405,726511
2017-05-17,NASDAQ (DQ),1283097664,627196361,811451243,2721745268,43926841422.788261,37797558505.270209,35464984121.255167,117189384049.313637,4384923,1216955,2642862,8244740
2017-05-17,EDGA Equities (J),82444993,51445651,39639073,173529717,2572850600.013696,2816728299.367498,1670131149.108602,7059710048.489796,673805,232450,321274,1227529
2017-05-17,EDGX Equities (K),226583835,132920581,200790795,560295211,8269395998.123891,7488621591.932318,8904950791.172690,24662968381.228899,1551546,550300,1242468,3344314
2017-05-17,CHX (M),13235853,14548135,4622536,32406524,578659238.121400,1354341112.606800,358528158.761000,2291528509.489200,5455,8198,2427,16080
2017-05-17,NYSE (N),990660117,0,0,990660117,36368759786.600982,0.000000,0.000000,36368759786.600982,3070281,0,0,3070281
2017-05-17,NYSE Arca (P),274802068,442724926,185353712,902880706,10906293874.595035,25847372791.693180,9603675949.604776,46357342615.892991,1962424,1193899,1276549,4432872
2017-05-17,NASDAQ (Q),430887016,194282248,608805371,1233974635,19281037244.478062,13790624742.531601,32751585938.459811,65823247925.469474,3858870,770043,3843215,8472128
2017-05-17,IEX (V),99242307,26813718,47257713,173313738,3987464479.352897,1716777261.514802,2294254778.803199,7998496519.670898,561324,110612,291534,963470
2017-05-17,NASDAQ PSX (X),24017831,25489078,24179297,73686206,885219923.297998,1651456866.421499,1324782450.325200,3861459240.044697,195915,101904,178707,476526
2017-05-17,BYX Equities (Y),209624987,103217941,109699750,422542678,6295033826.376335,4578325004.847508,4083434031.111515,14956792862.335358,1729947,428926,929875,3088748
2017-05-17,BZX Equities (Z),270083145,152558028,151016240,573657413,9655079780.719486,9735370956.059456,7491656007.386360,26882106744.165302,2103738,636049,1176076,3915863
2017-05-16,NYSE American (A),0,9599207,0,9599207,0.000000,61041273.084500,0.000000,61041273.084500,0,21134,0,21134
2017-05-16,NASDAQ BX (B),110994541,26607513,66469888,204071942,4100701223.867611,1215290450.887700,2427275155.021107,7743266829.776418,1077528,133812,646638,1857978
2017-05-16,NYSE (DN),106373189,34398303,79527814,220299306,3374429197.858804,1257352453.061800,2914839220.812917,7546620871.733521,274350,84237,218146,576733
2017-05-16,NASDAQ (DQ),1135882873,352770241,757689033,2246342147,38534172558.118469,17193491751.128160,27925832440.941806,83653496750.188435,3836732,769247,2298511,6904490
2017-05-16,EDGA Equities (J),61268963,25877004,31665518,118811485,1945970728.722297,1212973380.519299,1118094221.775500,4277038331.017096,521122,118118,253849,893089
2017-05-16,EDGX Equities (K),178032919,67368746,166646241,412047906,6452921446.355590,3294808897.383708,6116404505.719678,15864134849.458976,1207955,273093,966658,2447706
2017-05-16,CHX (M),13525798,11237059,10589288,35352145,757386083.302200,1037572069.615800,909452929.415200,2704411082.333200,5294,3547,2131,10972
2017-05-16,NYSE (N),792355560,0,0,792355560,28803229567.881359,0.000000,0.000000,28803229567.881359,2374479,0,0,2374479
2017-05-16,NYSE Arca (P),218638408,213741361,141054591,573434360,8723539542.991313,11667294272.320921,6123719380.700091,26514553196.012325,1566901,578592,978746,3124239
2017-05-16,NASDAQ (Q),328097962,85121038,479696950,892915950,14492600105.573864,5201735198.954194,22475588611.372887,42169923915.900945,2883158,364656,2907574,6155388
2017-05-16,IEX (V),85308823,15364790,46834618,147508231,3397744433.319695,800151637.303400,2031929588.622001,6229825659.245096,504260,62860,273516,840636
2017-05-16,NASDAQ PSX (X),17561500,12785958,18414091,48761549,632568706.580399,706401805.003800,768756293.318500,2107726804.902699,152519,56161,138143,346823
2017-05-16,BYX Equities (Y),162414659,56082326,89091124,307588109,4897580787.996610,2400914979.277094,3077446080.899802,10375941848.173506,1373765,250092,762814,2386671
2017-05-16,BZX Equities (Z),211361704,74629653,119307260,405298617,7499148605.237220,4280179058.044107,5009749344.648318,16789077007.929645,1640134,319325,919415,2878874
2017-05-15,NYSE American (A),0,11334444,0,11334444,0.000000,64108478.434000,0.000000,64108478.434000,0,21860,0,21860
2017-05-15,NASDAQ BX (B),102606504,27509559,64358524,194474587,3718973204.284170,1292577936.130105,2332365613.213811,7343916753.628086,1025125,134212,638081,1797418
2017-05-15,NYSE (DN),104531122,40312870,74646149,219490141,3152586934.567914,1389171785.905497,2978610411.263807,7520369131.737218,251303,95754,207513,554570
2017-05-15,NASDAQ (DQ),1218752180,391739326,702803485,2313294991,39894751224.946783,19274909188.279563,28339729033.903863,87509389447.130209,3588243,800094,2164020,6552357
2017-05-15,EDGA Equities (J),55504998,24866929,27688277,108060204,1712669490.123509,1269625857.320798,1026067583.345501,4008362930.789808,475174,111657,236883,823714
2017-05-15,EDGX Equities (K),172204454,65333293,143831634,381369381,5862299094.304382,3228950597.805800,5709781501.411605,14801031193.521787,1115602,259543,898746,2273891
2017-05-15,CHX (M),7734471,9173560,3445930,20353961,492278441.445400,696538708.513000,271723638.071000,1460540788.029400,4197,3791,2049,10037
2017-05-15,NYSE (N),849248407,0,0,849248407,30431787632.343874,0.000000,0.000000,30431787632.343874,2296576,0,0,2296576
2017-05-15,NYSE Arca (P),214864754,245687343,129838583,590390680,8189514786.697383,13870191568.981247,5935332152.285513,27995038507.964143,1475612,602510,928873,3006995
2017-05-15,NASDAQ (Q),314480456,88119628,469710781,872310865,13336275460.549855,5374739687.523296,23415600317.877875,42126615465.951026,2722620,357413,2820920,5900953
2017-05-15,IEX (V),81165697,19397707,44286322,144849726,3152400684.598100,1048586320.280300,2119204270.907401,6320191275.785801,477310,77737,263731,818778
2017-05-15,NASDAQ PSX (X),18469868,13025087,16666154,48161109,643356686.086099,726227548.474700,753748660.753600,2123332895.314399,146261,53670,129820,329751
2017-05-15,BYX Equities (Y),152598026,53104107,83473688,289175821,4572073564.822202,2293786861.823599,2824925826.225404,9690786252.871205,1305140,228933,721809,2255882
2017-05-15,BZX Equities (Z),197924276,72655561,104701946,375281783,6716795642.371279,4161040203.576513,4583840736.721105,15461676582.668897,1528814,310619,849940,2689373
2017-05-12,NYSE American (A),0,15699825,0,15699825,0.000000,86710276.616600,0.000000,86710276.616600,0,26235,0,26235
2017-05-12,NASDAQ BX (B),102733245,26412477,63659385,192805107,3708407088.866421,1136264796.670199,2377860299.009588,7222532184.546208,1018230,131566,614611,1764407
2017-05-12,NYSE (DN),102441524,38626618,70690314,211758456,2950926404.277105,1244889157.148404,2635662979.426412,6831478540.851921,261809,87295,193285,542389
2017-05-12,NASDAQ (DQ),1095239065,395286356,648569196,2139094617,34098369320.469580,18160732599.114475,24283413419.956170,76542515339.540225,3516379,761431,1993575,6271385
2017-05-12,EDGA Equities (J),58488604,25153986,28558821,112201411,1791204425.334793,1092314607.322100,1006679185.165899,3890198217.822792,497842,111396,230558,839796
2017-05-12,EDGX Equities (K),173204850,72410036,137421259,383036145,5824314973.312310,3130066778.879994,5074605657.537604,14028987409.729908,1130015,269924,821443,2221382
2017-05-12,CHX (M),20836037,13236728,5502344,39575109,531486999.262200,783529036.035000,514217636.240000,1829233671.537200,5310,3249,1964,10523
2017-05-12,NYSE (N),776533384,0,0,776533384,27441383442.417233,0.000000,0.000000,27441383442.417233,2267613,0,0,2267613
2017-05-12,NYSE Arca (P),206474341,233273819,124848596,564596756,7725010201.521275,12137473502.395771,5451995247.472703,25314478951.389749,1434856,602372,854897,2892125
2017-05-12,NASDAQ (Q),317873927,87425954,432236727,837536608,13068839434.844525,4833919032.407714,20415699599.550636,38318458066.802875,2740479,364861,2700010,5805350
2017-05-12,IEX (V),80668573,15858659,40717212,137244444,3125208384.493396,749390560.154500,1850011409.406800,5724610354.054696,493430,65834,259402,818666
2017-05-12,NASDAQ PSX (X),16340306,12615245,15004328,43959879,541088688.598299,618582976.955000,666000277.325000,1825671942.878299,135946,50577,118128,304651
2017-05-12,BYX Equities (Y),152639629,53405193,81008451,287053273,4560099905.707809,2113658787.873888,2709096989.331897,9382855682.913594,1307619,230261,706975,2244855
2017-05-12,BZX Equities (Z),201150730,73023496,100799697,374973923,6892340392.768322,3838030532.732100,4349165333.191717,15079536258.692139,1537828,315499,790058,2643385
2017-05-11,NYSE American (A),0,12942459,0,12942459,0.000000,84804171.075800,0.000000,84804171.075800,0,23174,0,23174
2017-05-11,NASDAQ BX (B),116786474,29525537,73686460,219998471,4119250951.791499,1359695598.101601,2669781207.938992,8148727757.832092,1123594,147000,707310,1977904
2017-05-11,NYSE (DN),119697017,41172564,78017421,238887002,3356137416.751014,1437271608.856503,2857409857.617300,7650818883.224817,279388,92762,209767,581917
2017-05-11,NASDAQ (DQ),1244511842,399214574,721887526,2365613942,38170082268.885377,19210635952.837950,27374745972.999740,84755464194.723067,3827189,818952,2144952,6791093
2017-05-11,EDGA Equities (J),66424930,32180392,33429815,132035137,1984631941.344201,1461508469.244101,1248659607.019799,4694800017.608101,548630,136671,271002,956303
2017-05-11,EDGX Equities (K),197642438,78405146,153528959,429576543,6477208368.442391,3950623243.298208,5923986908.751790,16351818520.492389,1261599,313939,933390,2508928
2017-05-11,CHX (M),14474592,9208583,4540890,28224065,725441623.104600,744295363.800000,364072520.694800,1833809507.599400,4640,2965,2124,9729
2017-05-11,NYSE (N),862841310,0,0,862841310,30027128159.740848,0.000000,0.000000,30027128159.740848,2563372,0,0,2563372
2017-05-11,NYSE Arca (P),235304097,272954895,139760915,648019907,8723824966.320176,13633390150.135777,6398252989.051929,28755468105.507882,1635783,707446,1006668,3349897
2017-05-11,NASDAQ (Q),366826710,103127078,475701730,945655518,14808758383.290715,6064557569.814190,22674855386.401626,43548171339.506531,3061736,435680,3050750,6548166
2017-05-11,IEX (V),86385487,17817942,43394144,147597573,3073319581.042792,924167451.508800,1851937512.487302,5849424545.038894,491584,73187,262001,826772
2017-05-11,NASDAQ PSX (X),19141481,14823078,18747231,52711790,638485798.005899,824637376.235000,901481960.240100,2364605134.480999,159002,65122,142145,366269
2017-05-11,BYX Equities (Y),167732510,59341034,92578376,319651920,4870951289.412211,2469020692.319493,3052378102.119303,10392350083.851007,1389562,264984,772600,2427146
2017-05-11,BZX Equities (Z),229947509,85789159,117377040,433113708,7783086183.100883,4772729611.766005,5000227543.553090,17556043338.419978,1746334,375460,931824,3053618
2017-05-10,NYSE American (A),0,10174136,0,10174136,0.000000,74401160.675700,0.000000,74401160.675700,0,21807,0,21807
2017-05-10,NASDAQ BX (B),117832568,26659262,73095371,217587201,4310396831.543198,1234776011.747798,2779520343.833898,8324693187.124894,1177731,134067,710115,2021913
2017-05-10,NYSE (DN),118363932,39557998,82916931,240838861,3436171256.475383,1317407171.901399,3164643520.866801,7918221949.243583,279823,89775,231761,601359
2017-05-10,NASDAQ (DQ),1233393343,369784255,812427288,2415604886,39464499942.946735,18248797722.206550,29446000922.909088,87159298588.062373,3850886,768036,2409286,7028208
2017-05-10,EDGA Equities (J),63295303,25145074,34737539,123177916,1911484555.284699,1151797020.451699,1313209691.806999,4376491267.543397,538201,108767,278433,925401
2017-05-10,EDGX Equities (K),189619857,67214812,159697461,416532130,6219550341.396315,3132712263.573709,6013083934.814407,15365346539.784431,1231097,262022,973511,2466630
2017-05-10,CHX (M),13704689,13617690,6665883,33988262,578127137.146100,1134250424.070600,501848311.116600,2214225872.333300,5286,3524,1919,10729
2017-05-10,NYSE (N),821257612,0,0,821257612,29019088310.889393,0.000000,0.000000,29019088310.889393,2581115,0,0,2581115
2017-05-10,NYSE Arca (P),233420295,232751244,156243057,622414596,8574790468.536285,11344022169.659436,6944812184.008690,26863624822.204411,1628850,615156,1064419,3308425
2017-05-10,NASDAQ (Q),367432180,90083439,503274268,960789887,14896838327.903850,4870891949.987014,23921305396.681682,43689035674.572546,3123003,377889,3219292,6720184
2017-05-10,IEX (V),89187676,16528647,51127075,156843398,3399564203.979816,845406493.056500,2295460269.088497,6540430966.124813,511566,67931,302324,881821
2017-05-10,NASDAQ PSX (X),17355581,12639059,18016602,48011242,572931149.428600,633438998.508100,813386967.003200,2019757114.939900,147569,54724,135427,337720
2017-05-10,BYX Equities (Y),163956197,50172299,90852306,304980802,4876261599.297821,2120109577.277405,3101095188.047503,10097466364.622729,1402806,221756,780113,2404675
2017-05-10,BZX Equities (Z),220559759,75149539,122801205,418510503,7446515910.671596,3887385205.629599,5179808138.550102,16513709254.851297,1681403,317777,944980,2944160
2017-05-09,NYSE American (A),0,10521610,0,10521610,0.000000,64722057.108200,0.000000,64722057.108200,0,21815,0,21815
2017-05-09,NASDAQ BX (B),120575982,31280884,71478913,223335779,4267000390.596498,1444899708.595795,2608233175.676994,8320133274.869287,1180467,148100,705501,2034068
2017-05-09,NYSE (DN),106714491,37561104,80408027,224683622,3096712518.063199,1316173782.271701,3022593400.548696,7435479700.883596,281319,88849,220931,591099
2017-05-09,NASDAQ (DQ),1220164546,422741399,743045089,2385951034,38916962346.993474,20625022471.637902,28670891589.273777,88212876407.905153,3842701,800252,2290193,6933146
2017-05-09,EDGA Equities (J),64972495,30943995,34951750,130868240,1928969778.886001,1460798475.728602,1254486416.787901,4644254671.402504,555727,125674,277289,958690
2017-05-09,EDGX Equities (K),190108488,73100996,162768077,425977561,6246791931.270296,3709452808.908900,6205092958.807774,16161337698.986970,1229976,284452,958115,2472543
2017-05-09,CHX (M),14957054,11978581,5657313,32592948,635302206.025700,800170942.296000,475070224.482500,1910543372.804200,4985,3988,2198,11171
2017-05-09,NYSE (N),861835062,0,0,861835062,29926144290.707118,0.000000,0.000000,29926144290.707118,2627257,0,0,2627257
2017-05-09,NYSE Arca (P),227921757,246655305,148612391,623189453,8502052249.752153,13062352319.933032,6777444210.987284,28341848780.672469,1604461,654316,1012697,3271474
2017-05-09,NASDAQ (Q),358537473,94122450,488891051,941550974,14640758001.161754,5515091736.193202,23330736112.044491,43486585849.399447,3065970,388187,3132999,6587156
2017-05-09,IEX (V),88107799,20736116,44063654,152907569,3261254143.415404,1002621603.674000,1881986185.190299,6145861932.279703,521972,72060,283307,877339
2017-05-09,NASDAQ PSX (X),18456206,14500964,17907936,50865106,593154445.110200,763827176.117100,819300591.168101,2176282212.395401,151515,60617,139391,351523
2017-05-09,BYX Equities (Y),170486638,64350680,90297727,325135045,4983748574.126221,2726540950.710203,3077455594.780008,10787745119.616432,1451194,249516,789198,2489908
2017-05-09,BZX Equities (Z),215003207,85130564,117739981,417873752,7238916556.054815,4864522568.423193,5096131226.787892,17199570351.265900,1662162,347278,917295,2926735
2017-05-08,NYSE American (A),0,10916122,0,10916122,0.000000,82045853.186700,0.000000,82045853.186700,0,20849,0,20849
2017-05-08,NASDAQ BX (B),113532357,25769122,65405209,204706688,3933888103.678990,1158082278.378601,2491574947.019991,7583545329.077582,1101666,128254,645204,1875124
2017-05-08,NYSE (DN),95127189,35316569,76124725,206568483,2854450310.425421,1267674848.375303,3084089115.588113,7206214274.388837,266836,86372,215693,568901
2017-05-08,NASDAQ (DQ),1133420447,372045908,727943959,2233410314,37121872019.933333,18477990516.790205,28661757804.891092,84261620341.614630,3625816,816933,2234600,6677349
2017-05-08,EDGA Equities (J),62702021,25114709,30737854,118554584,1851219108.251994,1159138932.432401,1177647281.605903,4188005322.290298,519924,113068,252792,885784
2017-05-08,EDGX Equities (K),167102451,63505828,145897179,376505458,5539509059.318890,2905008667.543801,5624489015.577952,14069006742.440643,1090250,256774,893455,2240479
2017-05-08,CHX (M),8876600,12092478,3831864,24800942,427441003.298300,1031535447.530000,273134857.008100,1732111307.836400,4221,3513,1804,9538
2017-05-08,NYSE (N),836407805,0,0,836407805,30795133074.523587,0.000000,0.000000,30795133074.523587,2427961,0,0,2427961
2017-05-08,NYSE Arca (P),214229564,219128756,137734740,571093060,7888176274.682176,11406918021.070809,5938607009.558795,25233701305.311780,1436864,578942,946495,2962301
2017-05-08,NASDAQ (Q),337465492,84046011,477456595,898968098,13992434044.832628,4701692639.089506,23355912865.539755,42050039549.461889,2878280,355484,2881394,6115158
2017-05-08,IEX (V),81774565,17300381,43848084,142923030,3097624797.223990,907144176.307099,1906128595.784500,5910897569.315589,468454,70057,266237,804748
2017-05-08,NASDAQ PSX (X),20690682,12272284,16852630,49815596,617054329.990200,640486544.697600,692969644.141800,1950510518.829600,142799,53819,126748,323366
2017-05-08,BYX Equities (Y),160241802,50547394,81332760,292121956,4568396689.334992,2023135167.249597,2823335157.995088,9414867014.579677,1351186,227601,709337,2288124
2017-05-08,BZX Equities (Z),198421258,71850530,104866150,375137938,6607524620.417217,3850623609.424192,4560271928.945069,15018420158.786478,1488007,311228,827721,2626956
2017-05-05,NYSE American (A),0,11174602,0,11174602,0.000000,68207091.003100,0.000000,68207091.003100,0,21870,0,21870
2017-05-05,NASDAQ BX (B),119080113,30588618,67647246,217315977,4231226510.829915,1373637768.557401,2523662614.807997,8128526894.195313,1165319,143746,664327,1973392
2017-05-05,NYSE (DN),103792251,38107124,76452499,218351874,2926677456.416115,1273816544.503794,2651606540.804800,6852100541.724709,270081,86578,208532,565191
2017-05-05,NASDAQ (DQ),1206800691,390191045,742398088,2339389824,37535729805.209226,18123052341.998051,26313831482.726389,81972613629.933666,3787373,841024,2190365,6818762
2017-05-05,EDGA Equities (J),64133067,32211846,31016164,127361077,1928161474.948203,1469752166.955800,1135630890.872499,4533544532.776502,541240,139301,244513,925054
2017-05-05,EDGX Equities (K),177732626,74120384,143234097,395087107,6035503690.054759,3599585965.386506,5307717385.744983,14942807041.186248,1174255,296831,855727,2326813
2017-05-05,CHX (M),8437877,16040393,5662897,30141167,439250985.901300,1265314889.462800,644429403.542200,2348995278.906300,4241,4028,1704,9973
2017-05-05,NYSE (N),830489045,0,0,830489045,29260479261.950636,0.000000,0.000000,29260479261.950636,2581517,0,0,2581517
2017-05-05,NYSE Arca (P),209691676,262112248,127893474,599697398,8003532638.193529,13395170327.779646,5731814463.938715,27130517429.911890,1515199,675762,921257,3112218
2017-05-05,NASDAQ (Q),344600492,96232125,463108687,903941304,14315417510.379355,5829297230.776473,21750494945.942384,41895209687.098212,3016891,398799,2874816,6290506
2017-05-05,IEX (V),89703781,21264974,44149362,155118117,3383361008.606300,991711551.330101,1994417965.462599,6369490525.399000,541178,83097,271139,895414
2017-05-05,NASDAQ PSX (X),17257475,14747116,15305617,47310208,538669771.165000,769554229.961000,670247891.146300,1978471892.272300,141556,60800,118235,320591
2017-05-05,BYX Equities (Y),162908557,62670782,82668577,308247916,4697417495.770118,2537429917.762095,2787056732.314903,10021904145.847116,1359979,259195,711817,2330991
2017-05-05,BZX Equities (Z),208613986,81259966,103512411,393386363,7019737221.214620,4473324121.406105,4545441212.319900,16038502554.940625,1638958,358126,832355,2829439
2017-05-04,NYSE American (A),0,15562627,0,15562627,0.000000,72510975.679700,0.000000,72510975.679700,0,28265,0,28265
2017-05-04,NASDAQ BX (B),131593568,37095137,69560435,238249140,4517653995.745201,1601399798.183505,2641604958.763504,8760658752.692210,1245981,174858,678048,2098887
2017-05-04,NYSE (DN),140171645,49444623,89343614,278959882,3855602149.722035,1605401980.241997,3337166280.739611,8798170410.703643,341531,107689,229828,679048
2017-05-04,NASDAQ (DQ),1452541680,505252253,771872657,2729666590,43351467803.650067,21412308160.078562,27504926536.726975,92268702500.455604,4536707,1097644,2338720,7973071
2017-05-04,EDGA Equities (J),83176266,40115453,35994314,159286033,2353584343.011901,1795340776.670302,1297307512.283902,5446232631.966105,664344,171815,276262,1112421
2017-05-04,EDGX Equities (K),231119709,101166445,157958877,490245031,7394636028.698237,4360099656.079998,5906499828.814184,17661235513.592419,1471990,384998,945935,2802923
2017-05-04,CHX (M),13118316,14948750,6158057,34225123,555604314.281600,1120936079.747000,479255141.285000,2155795535.313600,4656,4554,2118,11328
2017-05-04,NYSE (N),1011940451,0,0,1011940451,33999480353.960898,0.000000,0.000000,33999480353.960898,3201423,0,0,3201423
2017-05-04,NYSE Arca (P),273647612,345745485,143534089,762927186,10012986216.188333,16260427333.937856,6787703820.817961,33061117370.944150,1927907,863305,1063266,3854478
2017-05-04,NASDAQ (Q),447167255,130941719,504949963,1083058937,17736064804.149549,7223205988.420493,24341576003.940094,49300846796.510136,3748415,525568,3307991,7581974
2017-05-04,IEX (V),106529213,26577904,52608346,185715463,3701910972.737600,1177975412.176500,2481102448.698798,7360988833.612898,605706,99853,300086,1005645
2017-05-04,NASDAQ PSX (X),22606867,20615409,18398426,61620702,702228636.241999,1009767966.990000,827178756.411400,2539175359.643399,173075,82211,139068,394354
2017-05-04,BYX Equities (Y),189479435,75258526,88632685,353370646,5204230840.473714,2933902622.906601,3055701127.119999,11193834590.500314,1532338,324160,756289,2612787
2017-05-04,BZX Equities (Z),264774648,107297733,120816431,492888812,8579356422.310942,5435998512.133712,5318397750.776392,19333752685.221046,2042797,459892,968636,3471325
2017-05-03,NYSE American (A),0,14413385,0,14413385,0.000000,87029490.210900,0.000000,87029490.210900,0,22738,0,22738
2017-05-03,NASDAQ BX (B),126577812,38801828,70671370,236051010,4426028874.787434,1624977506.574194,2713950929.219805,8764957310.581433,1217326,175096,678655,2071077
2017-05-03,NYSE (DN),111597349,38304847,89547878,239450074,3359066170.987197,1352465371.197698,3010878488.340805,7722410030.525700,296672,91555,222540,610767
2017-05-03,NASDAQ (DQ),1240289063,436661138,819100640,2496050841,39751449947.766592,21379075425.736254,28009171447.115988,89139696820.618834,4109760,861686,2357010,7328456
2017-05-03,EDGA Equities (J),72428434,33871073,37374271,143673778,2161074420.602797,1574826773.872997,1358953396.374900,5094854590.850694,593277,141971,289317,1024565
2017-05-03,EDGX Equities (K),212574414,82485903,165436932,460497249,7317988281.348166,4241553889.207501,6506780182.712081,18066322353.267748,1431959,323976,1007076,2763011
2017-05-03,CHX (M),6899031,9313219,6745707,22957957,364794261.930000,849312699.080000,518775358.509800,1732882319.519800,4311,4043,1865,10219
2017-05-03,NYSE (N),918851807,0,0,918851807,31888712129.851362,0.000000,0.000000,31888712129.851362,2903720,0,0,2903720
2017-05-03,NYSE Arca (P),251600027,310175345,152798552,714573924,9660903724.264356,16008065539.292070,7333685851.386401,33002655114.942827,1801795,762094,1077143,3641032
2017-05-03,NASDAQ (Q),404450282,112051756,522998277,1039500315,16637377929.414842,6695023123.193882,25015308326.419971,48347709379.028695,3440633,462773,3282226,7185632
2017-05-03,IEX (V),103395109,23583098,56124991,183103198,4007496064.678600,1022204624.990699,2629426297.919100,7659126987.588399,591887,85570,317369,994826
2017-05-03,NASDAQ PSX (X),20760469,17757660,18057046,56575175,659092665.133999,939982126.560900,825897139.515299,2424971931.210198,161100,73197,143628,377925
2017-05-03,BYX Equities (Y),183054754,64444756,93437936,340937446,5230615725.460446,2606546505.796489,3233963947.644717,11071126178.901652,1484624,273685,779275,2537584
2017-05-03,BZX Equities (Z),244282977,90520211,120557791,455360979,8375944643.401757,5230973366.368992,5317864573.758288,18924782583.529037,1909854,406311,963054,3279219
2017-05-02,NYSE American (A),0,13006687,0,13006687,0.000000,67491413.147100,0.000000,67491413.147100,0,22774,0,22774
2017-05-02,NASDAQ BX (B),129209063,30275133,73126988,232611184,4696278969.105128,1386809419.651005,2730843048.928997,8813931437.685130,1235211,145123,695896,2076230
2017-05-02,NYSE (DN),108871228,37089095,93734195,239694518,3365448034.527002,1315073536.510003,3115223859.692471,7795745430.729476,327378,90251,245581,663210
2017-05-02,NASDAQ (DQ),1220823409,399773797,804287045,2424884251,40347323517.666615,18739799274.524549,28299306397.501331,87386429189.692495,4078391,798380,2322954,7199725
2017-05-02,EDGA Equities (J),74978979,32551986,37742511,145273476,2367272776.242799,1542848901.996403,1384180506.576403,5294302184.815605,630014,133456,297468,1060938
2017-05-02,EDGX Equities (K),213411827,74489186,173263030,461164043,7610499749.112572,3566278055.852695,6352119073.715180,17528896878.680447,1420297,283398,984658,2688353
2017-05-02,CHX (M),7257214,12232640,4499390,23989244,380655742.769800,846777583.000000,529331780.042800,1756765105.812600,4467,4308,2401,11176
2017-05-02,NYSE (N),908891816,0,0,908891816,32824874584.166654,0.000000,0.000000,32824874584.166654,2777283,0,0,2777283
2017-05-02,NYSE Arca (P),238940425,246532013,159059361,644531799,9650850336.509988,12690542629.159485,6765981200.265415,29107374165.934888,1767683,616654,1034116,3418453
2017-05-02,NASDAQ (Q),403735435,99265963,519795676,1022797074,17302854329.984985,5705062813.131803,24533435225.942798,47541352369.059586,3471753,401296,3100983,6974032
2017-05-02,IEX (V),98330657,19661968,50995814,168988439,3987197594.599106,907522703.243798,2274184518.945200,7168904816.788104,586085,79835,301040,966960
2017-05-02,NASDAQ PSX (X),20657059,16483181,22075647,59215887,680215563.796201,808842727.286200,896721178.670099,2385779469.752500,164374,63532,156106,384012
2017-05-02,BYX Equities (Y),184994132,58701293,94885432,338580857,5556182224.974337,2392966190.894498,3185749879.042695,11134898294.911530,1557388,239823,787873,2585084
2017-05-02,BZX Equities (Z),251261979,77497860,129149587,457909426,8935925137.198840,4146380863.825501,5357188162.981577,18439494164.005918,1993682,335433,982118,3311233
2017-05-01,NYSE American (A),0,12346094,0,12346094,0.000000,67960269.755100,0.000000,67960269.755100,0,23849,0,23849
2017-05-01,NASDAQ BX (B),113898721,25720164,63334355,202953240,4243962239.325393,1236219773.651001,2648595009.780200,8128777022.756594,1137055,132629,631748,1901432
2017-05-01,NYSE (DN),93950028,38053124,72200074,204203226,2986311746.045014,1447565162.204007,3308885334.147406,7742762242.396427,255206,93248,203334,551788
2017-05-01,NASDAQ (DQ),1017435541,414424136,648971672,2080831349,33026777911.262959,22479400612.783685,28001038347.934452,83507216871.981096,3588655,825661,2060569,6474885
2017-05-01,EDGA Equities (J),60428717,26718848,29651697,116799262,1949609902.828605,1372778186.393300,1241281187.562301,4563669276.784206,524378,124109,246708,895195
2017-05-01,EDGX Equities (K),171862378,72440923,142657765,386961066,6290973381.696299,3558513675.616799,6133827841.194006,15983314898.507104,1196777,288663,894820,2380260
2017-05-01,CHX (M),6943821,7203945,4002936,18150702,411782884.985000,707966554.159000,655322155.781500,1775071594.925500,4241,3740,2032,10013
2017-05-01,NYSE (N),753903848,0,0,753903848,28254106620.646648,0.000000,0.000000,28254106620.646648,2497024,0,0,2497024
2017-05-01,NYSE Arca (P),189400038,259433694,119197185,568030917,7747693363.081687,13721224205.388962,6133291690.540111,27602209259.010760,1432817,653478,879184,2965479
2017-05-01,NASDAQ (Q),340225925,98296949,437244056,875766930,14808561656.684000,5778975723.684808,23478334017.523880,44065871397.892688,3062354,416320,2925700,6404374
2017-05-01,IEX (V),92669063,15721896,49680280,158071239,3976910371.233300,867588294.813200,2494073381.693300,7338572047.739800,543409,72589,277349,893347
2017-05-01,NASDAQ PSX (X),17232051,15450005,17806282,50488338,556046285.859100,821169282.153900,797261238.106100,2174476806.119100,134932,63072,129570,327574
2017-05-01,BYX Equities (Y),150417162,52362499,78200741,280980402,4498628146.678853,2180136750.961698,2842833355.041807,9521598252.682358,1292989,233187,673734,2199910
2017-05-01,BZX Equities (Z),193135300,70526399,100158454,363820153,6949558883.008048,3996323014.471499,4866241164.262510,15812123061.742057,1584674,324129,834134,2742937
2017-04-28,NYSE American (A),0,16916795,0,16916795,0.000000,84308344.265300,0.000000,84308344.265300,0,25580,0,25580
2017-04-28,NASDAQ BX (B),123028107,32340753,70859473,226228333,4520411536.156621,1415719084.266698,2942319573.429112,8878450193.852431,1184982,147242,664011,1996235
2017-04-28,NYSE (DN),90021950,45917478,72145825,208085253,2786409708.485106,1259470124.443399,3115444383.719811,7161324216.648316,249906,91294,208267,549467
2017-04-28,NASDAQ (DQ),1114491630,433678622,698632817,2246803069,37455461166.687099,19957851241.922299,31179655927.972391,88592968336.581789,3656823,803766,2185406,6645995
2017-04-28,EDGA Equities (J),70150039,34200150,34464693,138814882,2183255373.642001,1503038054.569903,1517226364.259701,5203519792.471605,585658,143224,280903,1009785
2017-04-28,EDGX Equities (K),195759412,89217429,158317808,443294649,6809655808.118901,3836944764.535592,6931171850.706239,17577772423.360732,1289500,302047,966288,2557835
2017-04-28,CHX (M),11369692,14336621,8789238,34495551,616336351.060200,1069544265.396000,760962197.566000,2446842814.022200,4192,4952,2013,11157
2017-04-28,NYSE (N),1021063763,0,0,1021063763,38438159549.015550,0.000000,0.000000,38438159549.015550,2666229,0,0,2666229
2017-04-28,NYSE Arca (P),220393383,300121870,144440706,664955959,8936247110.816846,15857587059.177810,7462545075.933699,32256379245.928355,1626303,653464,1016358,3296125
2017-04-28,NASDAQ (Q),369234713,102307146,546307698,1017849557,15801210855.158260,5987286659.960102,29274185469.767228,51062682984.885590,3156648,403613,3125381,6685642
2017-04-28,IEX (V),85198383,18101692,45631278,148931353,3385270677.985708,981408759.014300,2464372352.652701,6831051789.652709,512574,75776,269970,858320
2017-04-28,NASDAQ PSX (X),19270311,16621261,17511683,53403255,633453042.800000,836821262.782999,824266353.054300,2294540658.637299,153002,68047,135663,356712
2017-04-28,BYX Equities (Y),173798789,67961951,91163852,332924592,5121901750.725616,2743819622.871294,3386449549.585600,11252170923.182510,1475387,282805,771624,2529816
2017-04-28,BZX Equities (Z),227571197,80675428,117606586,425853211,8071642412.985765,4369719191.978704,5923696555.552710,18365058160.517179,1771465,343604,950615,3065684
2017-04-27,NYSE American (A),0,17124372,0,17124372,0.000000,75611161.675400,0.000000,75611161.675400,0,24685,0,24685
2017-04-27,NASDAQ BX (B),124040702,31916167,65712302,221669171,4552084202.454616,1302278352.024596,2651128843.014604,8505491397.493816,1170069,147450,629078,1946597
2017-04-27,NYSE (DN),109440226,43555882,66631802,219627910,3415220777.540432,1476672919.173898,2618047053.202897,7509940749.917227,268554,83057,173060,524671
2017-04-27,NASDAQ (DQ),1327161042,434572600,668889741,2430623383,42609469379.725786,17642236097.931467,26229082615.443977,86480788093.101230,4111065,852604,2191050,7154719
2017-04-27,EDGA Equities (J),74558532,33454240,32773269,140786041,2318331009.143202,1379939299.299997,1324377605.152398,5022647913.595597,615280,149105,270181,1034566
2017-04-27,EDGX Equities (K),215556666,82934397,152850029,451341092,7530393321.620568,3689539323.344813,6220613934.433803,17440546579.399184,1392356,296170,940565,2629091
2017-04-27,CHX (M),10129023,9530586,5464373,25123982,495496102.230500,809102142.997200,559524845.450000,1864123090.677700,4349,4056,1843,10248
2017-04-27,NYSE (N),1008277983,0,0,1008277983,35369432051.888106,0.000000,0.000000,35369432051.888106,2891833,0,0,2891833
2017-04-27,NYSE Arca (P),257211072,281981665,148272954,687465691,10306582833.517623,13387076142.043688,7223424554.301920,30917083529.863231,1805634,671136,1038073,3514843
2017-04-27,NASDAQ (Q),414137794,110348361,477664110,1002150265,17717508742.339419,5867538364.188386,23733752703.443380,47318799809.971185,3470442,424255,3027899,6922596
2017-04-27,IEX (V),95316503,18154115,45355854,158826472,3688488548.672306,842875272.336900,2218411806.778703,6749775627.787909,567853,73110,279211,920174
2017-04-27,NASDAQ PSX (X),21355889,18451814,18740912,58548615,695009081.965300,811255950.525000,816258894.611800,2322523927.102100,160691,71070,135434,367195
2017-04-27,BYX Equities (Y),187615972,66458638,88389523,342464133,5504470058.783257,2496638601.799302,3220708126.712098,11221816787.294657,1528720,290248,757016,2575984
2017-04-27,BZX Equities (Z),255145454,84955189,112868465,452969108,8900200539.213215,4325681078.238388,5080178472.655418,18306060090.107021,1955051,358193,917853,3231097
2017-04-26,NYSE American (A),0,15344911,0,15344911,0.000000,83488601.586300,0.000000,83488601.586300,0,25323,0,25323
2017-04-26,NASDAQ BX (B),134585656,38087817,71265092,243938565,5022763023.771896,1713765339.220595,2720933463.983901,9457461826.976392,1267091,180071,691387,2138549
2017-04-26,NYSE (DN),114930650,45664653,68035576,228630879,3830663269.772179,1617490306.687798,2659876139.629198,8108029716.089175,277204,93891,168690,539785
2017-04-26,NASDAQ (DQ),1324615567,523140481,701954844,2549710892,45300441702.010183,24451011919.261200,26523859702.604776,96275313323.876159,4176335,957156,2188561,7322052
2017-04-26,EDGA Equities (J),77461993,36894069,32881684,147237746,2496454629.101596,1699020714.988999,1315763847.678499,5511239191.769094,639587,170590,280114,1090291
2017-04-26,EDGX Equities (K),216027078,91849748,146534159,454410985,7712051368.727365,4291375372.229707,5758376159.340182,17761802900.297254,1380228,334909,929626,2644763
2017-04-26,CHX (M),12727158,11787879,6096763,30611800,730322410.772400,1272421227.760001,393475002.172500,2396218640.704901,4664,5487,1960,12111
2017-04-26,NYSE (N),963133732,0,0,963133732,35247439941.626415,0.000000,0.000000,35247439941.626415,2985223,0,0,2985223
2017-04-26,NYSE Arca (P),264768755,323081653,131562447,719412855,10982254506.962464,17257269186.214578,6352944961.286410,34592468654.463452,1908521,832673,1022495,3763689
2017-04-26,NASDAQ (Q),427158313,129673360,474977960,1031809633,18299266575.013553,7608224951.152992,22962161836.442827,48869653362.609372,3568915,526802,3126255,7221972
2017-04-26,IEX (V),98751270,21322881,43780148,163854299,4080481570.653292,1196206578.102799,2021650605.326703,7298338754.082794,584971,83884,278616,947471
2017-04-26,NASDAQ PSX (X),22354182,20857766,18290887,61502835,720650897.395700,1109137549.350900,843568019.849600,2673356466.596200,164531,83157,133729,381417
2017-04-26,BYX Equities (Y),193400074,72516008,91131312,357047394,5754710467.239922,2896496926.349697,3280024179.799992,11931231573.389611,1568668,318267,797918,2684853
2017-04-26,BZX Equities (Z),261443535,97717552,113068032,472229119,9319616490.981499,5583459154.664804,5029770458.299879,19932846103.946182,2029906,415442,947559,3392907
2017-04-25,NYSE American (A),0,15883274,0,15883274,0.000000,87156688.027200,0.000000,87156688.027200,0,25567,0,25567
2017-04-25,NASDAQ BX (B),129551037,39016644,68173051,236740732,4968006812.072825,1612749321.279097,2666720492.631192,9247476625.983114,1275918,177211,666707,2119836
2017-04-25,NYSE (DN),118617150,49305199,65127250,233049599,3994271798.010798,1733703171.054203,2866449792.878193,8594424761.943194,264375,96025,149368,509768
2017-04-25,NASDAQ (DQ),1341017708,560789040,712825010,2614631758,46332808499.196080,23156595638.292122,28515391039.707375,98004795177.195577,4105889,1051757,2208422,7366068
2017-04-25,EDGA Equities (J),74674900,37689582,33672304,146036786,2439302587.634197,1734265271.538500,1337402964.925902,5510970824.098599,610796,166960,279572,1057328
2017-04-25,EDGX Equities (K),208742857,92912412,148065162,449720431,7674696489.802573,4342844133.425893,5875233056.578805,17892773679.807271,1283907,320040,900066,2504013
2017-04-25,CHX (M),10683061,17666727,5871833,34221621,610272984.225600,1393906322.610000,460876236.140200,2465055542.975800,4901,6020,1952,12873
2017-04-25,NYSE (N),930295503,0,0,930295503,34636644691.616686,0.000000,0.000000,34636644691.616686,2737995,0,0,2737995
2017-04-25,NYSE Arca (P),249905604,330430231,136953402,717289237,11069605953.930025,16565306212.561210,6584684779.253665,34219596945.744900,1786803,754127,990319,3531249
2017-04-25,NASDAQ (Q),404156409,124511092,462697241,991364742,17959126286.031277,7497782674.098297,23117953784.414106,48574862744.543680,3325501,467691,2916420,6709612
2017-04-25,IEX (V),89029386,24023073,43470255,156522714,3808204294.315995,1119881480.638201,2170073798.644503,7098159573.598699,519164,92341,251407,862912
2017-04-25,NASDAQ PSX (X),22332922,20739700,18949368,62021990,743186897.947101,1085489049.952000,820386223.718300,2649062171.617401,159402,79000,136272,374674
2017-04-25,BYX Equities (Y),181720801,80898524,89935246,352554571,5575128745.628305,3176749649.534604,3113373106.737484,11865251501.900393,1522817,346354,784155,2653326
2017-04-25,BZX Equities (Z),245100242,98492704,112389199,455982145,8969412579.136413,5516868439.476690,4916945079.391789,19403226098.004892,1903064,403498,903029,3209591
2017-04-24,NYSE American (A),0,12431430,0,12431430,0.000000,74209612.359700,0.000000,74209612.359700,0,22742,0,22742
2017-04-24,NASDAQ BX (B),126062985,37253419,65639007,228955411,4852681194.557914,1740078168.657402,2497110891.056196,9089870254.271512,1238133,170162,637810,2046105
2017-04-24,NYSE (DN),98551043,41178014,62362586,202091643,3401844161.006612,1889289983.363198,2380318373.171504,7671452517.541314,240846,83378,142266,466490
2017-04-24,NASDAQ (DQ),1187057270,503087540,680132143,2370276953,42654148189.266992,28391518719.360218,24194460128.452796,95240127037.080006,3779255,924109,2092244,6795608
2017-04-24,EDGA Equities (J),69991271,36035269,31911141,137937681,2308433758.483298,1887958472.033202,1253189313.238199,5449581543.754699,585129,161142,261044,1007315
2017-04-24,EDGX Equities (K),186170087,88372210,147428964,421971261,7070616807.114436,4831999156.985607,5449369331.825782,17351985295.925825,1202676,338628,846658,2387962
2017-04-24,CHX (M),9157532,17407943,2502537,29068012,507738822.870000,1432823488.499200,147632975.998600,2088195287.367800,4329,6201,1803,12333
2017-04-24,NYSE (N),907072897,0,0,907072897,34703144776.269661,0.000000,0.000000,34703144776.269661,2671640,0,0,2671640
2017-04-24,NYSE Arca (P),224570019,337398439,127507500,689475958,10008245374.058509,18945398862.676442,6087726106.567507,35041370343.302458,1639385,744446,920739,3304570
2017-04-24,NASDAQ (Q),384085065,127530496,469285529,980901090,17104423928.470130,8469781890.776132,22267253129.352561,47841458948.598823,3209866,488323,2805170,6503359
2017-04-24,IEX (V),86893423,22573684,43199656,152666763,3680622023.560600,1304238744.702799,2067243305.590901,7052104073.854300,519087,85705,256217,861009
2017-04-24,NASDAQ PSX (X),21457359,20284362,16819731,58561452,706543952.915901,1203629187.538500,770814132.666300,2680987273.120701,156864,81168,127203,365235
2017-04-24,BYX Equities (Y),176096071,72374790,86981766,335452627,5477472857.071742,3112096842.237402,2987895819.697408,11577465519.006552,1475723,298911,748371,2523005
2017-04-24,BZX Equities (Z),234010963,95953566,109113400,439077929,8694974442.118683,5879013974.025791,4716859840.544704,19290848256.689178,1842036,396125,867529,3105690
2017-04-21,NYSE American (A),0,11183059,0,11183059,0.000000,70499346.037400,0.000000,70499346.037400,0,18872,0,18872
2017-04-21,NASDAQ BX (B),113057966,33938093,59813317,206809376,4140292180.471898,1536337899.369094,2246292832.022502,7922922911.863494,1108123,166317,600015,1874455
2017-04-21,NYSE (DN),87817032,35382655,56466543,179666230,2792789936.825615,1386856262.108101,1938672910.497596,6118319109.431312,204019,70812,122431,397262
2017-04-21,NASDAQ (DQ),1093641638,463186896,622938076,2179766610,36025060526.925770,27864470084.215942,22405033005.628711,86294563616.770423,3425288,844734,1903949,6173971
2017-04-21,EDGA Equities (J),64767428,32569617,31165897,128502942,2057041646.468798,1522688794.934500,1177612489.224301,4757342930.627599,540702,142624,257008,940334
2017-04-21,EDGX Equities (K),174760390,84119336,130427992,389307718,6224113037.973939,4125088806.784805,4644324026.966718,14993525871.725462,1155328,329010,800004,2284342
2017-04-21,CHX (M),14930959,22214888,5305440,42451287,605492107.604400,1779088955.323599,567654259.422900,2952235322.350899,4154,6129,1767,12050
2017-04-21,NYSE (N),932938196,0,0,932938196,36355948098.208315,0.000000,0.000000,36355948098.208315,2503508,0,0,2503508
2017-04-21,NYSE Arca (P),208674202,270571262,114338259,593583723,8714861706.170757,14687994487.781837,5001836626.787710,28404692820.740304,1524861,717178,851731,3093770
2017-04-21,NASDAQ (Q),357670346,120596311,477316281,955582938,15371977768.292583,7048307166.986920,21831151505.448350,44251436440.727853,3042347,487165,2718452,6247964
2017-04-21,IEX (V),79495478,18964583,41205712,139665773,3084499097.924098,941362045.591401,1775394603.387901,5801255746.903400,478063,77606,262155,817824
2017-04-21,NASDAQ PSX (X),18591306,20473934,17782389,56847629,616552796.194901,1084135201.474000,704618259.751501,2405306257.420402,140006,83754,125069,348829
2017-04-21,BYX Equities (Y),159689516,64606541,78931534,303227591,4889375149.493833,2621419350.327005,2744198471.761495,10254992971.582333,1349680,283387,695412,2328479
2017-04-21,BZX Equities (Z),218128056,90777559,100732837,409638452,7803295772.060402,5096096077.259203,4324708750.914789,17224100600.234394,1695443,397632,827090,2920165
2017-04-20,NYSE American (A),0,11258348,0,11258348,0.000000,63869086.724900,0.000000,63869086.724900,0,20125,0,20125
2017-04-20,NASDAQ BX (B),118991655,37158879,60601862,216752396,4330756469.368503,1702980898.235998,2296044427.946905,8329781795.551406,1137826,174205,595166,1907197
2017-04-20,NYSE (DN),99886063,37196505,58078666,195161234,3099993120.417414,1533687743.069496,2295810735.651101,6929491599.138011,230294,78293,132443,441030
2017-04-20,NASDAQ (DQ),1146529655,458992978,627770840,2233293473,38020635400.489586,23742934312.632194,23023841302.814327,84787411015.936107,3714870,940404,2026698,6681972
2017-04-20,EDGA Equities (J),70368637,36470989,31940543,138780169,2178138769.155701,1767573630.751500,1300784935.442599,5246497335.349800,577436,160925,267156,1005517
2017-04-20,EDGX Equities (K),194205070,89690063,141044783,424939916,6974233485.753017,4658114457.659680,5485027048.333177,17117374991.745874,1241606,363457,860915,2465978
2017-04-20,CHX (M),7625793,15722961,4971229,28319983,405242284.247000,1483963686.621099,377392191.164600,2266598162.032699,4155,6316,1702,12173
2017-04-20,NYSE (N),866094132,0,0,866094132,31823999073.115646,0.000000,0.000000,31823999073.115646,2655010,0,0,2655010
2017-04-20,NYSE Arca (P),238821849,296057325,128350465,663229639,9731075694.250106,16327857586.473229,5809644585.415803,31868577866.139138,1684195,767419,944586,3396200
2017-04-20,NASDAQ (Q),396978265,130580452,446486297,974045014,16953416781.031921,8085724012.101268,21121349142.416212,46160489935.549401,3281494,525621,2833138,6640253
2017-04-20,IEX (V),84867509,18496382,39680235,143044126,3284413179.493998,915121657.546300,1765404073.717003,5964938910.757301,508655,75509,253231,837395
2017-04-20,NASDAQ PSX (X),22061035,21894220,18575037,62530292,676006538.108201,1216711828.705199,811289935.602301,2704008302.415701,154265,89763,134052,378080
2017-04-20,BYX Equities (Y),171086875,71242901,83293042,325622818,5174706665.355437,2957396863.262002,2886101080.721902,11018204609.339341,1437263,308378,722369,2468010
2017-04-20,BZX Equities (Z),231481067,96896474,110706852,439084393,8375385990.282898,5638845594.491785,4838350233.053389,18852581817.828072,1806094,432151,877099,3115344
2017-04-19,NYSE American (A),0,16427866,0,16427866,0.000000,81247283.214400,0.000000,81247283.214400,0,24517,0,24517
2017-04-19,NASDAQ BX (B),114256175,38587107,58979920,211823202,4093070602.517213,1595068605.281299,2142471344.821797,7830610552.620309,1103441,189524,574204,1867169
2017-04-19,NYSE (DN),96173739,45463997,56272092,197909828,2971613194.430113,1667582135.359904,2101184174.018196,6740379503.808213,209234,89515,126081,424830
2017-04-19,NASDAQ (DQ),1151152968,473170950,646822058,2271145976,35617394748.196309,18998001423.626196,22403336872.320288,77018733044.142793,3481893,990684,1976109,6448686
2017-04-19,EDGA Equities (J),68034167,39598168,32089093,139721428,2078958870.470799,1744721574.522001,1157480067.037398,4981160512.030198,562956,182049,258316,1003321
2017-04-19,EDGX Equities (K),180355147,99740931,143300425,423396503,6517022366.490363,4332869315.041598,5121458644.385890,15971350325.917851,1182922,380086,842162,2405170
2017-04-19,CHX (M),10020885,10585968,3609100,24215953,449341972.580000,957414162.030000,237412501.511400,1644168636.121400,4761,6847,1773,13381
2017-04-19,NYSE (N),821245706,0,0,821245706,29898915821.710460,0.000000,0.000000,29898915821.710460,2484928,0,0,2484928
2017-04-19,NYSE Arca (P),211696780,327145899,128424968,667267647,8641035910.878771,15583628799.788470,5418732196.816178,29643396907.483419,1548348,800283,912190,3260821
2017-04-19,NASDAQ (Q),370924927,136573241,434496420,941994588,15716496847.240634,7308629959.382363,19902039367.826000,42927166174.448997,3152435,549277,2789187,6490899
2017-04-19,IEX (V),90211065,24271710,42517561,157000336,3503651795.300909,1054593268.434002,1821261716.053902,6379506779.788813,522951,91869,254794,869614
2017-04-19,NASDAQ PSX (X),18835004,21921191,18575485,59331680,583512365.530098,1127424615.335001,767605193.228800,2478542174.093899,140644,90828,128658,360130
2017-04-19,BYX Equities (Y),167913818,76446839,80061114,324421771,4834917404.441325,2919559190.435592,2712335160.165500,10466811755.042417,1390984,339696,698847,2429527
2017-04-19,BZX Equities (Z),220344589,101029955,109095319,430469863,7725946980.911702,5174253317.009921,4545761347.182509,17445961645.104132,1704875,454459,848884,3008218
2017-04-18,NYSE American (A),0,11571869,0,11571869,0.000000,63778750.303400,0.000000,63778750.303400,0,20320,0,20320
2017-04-18,NASDAQ BX (B),108543294,33714921,54997383,197255598,4104348764.609276,1486223356.769500,2041493417.575797,7632065538.954573,1075931,157327,543017,1776275
2017-04-18,NYSE (DN),90569910,36626947,51103976,178300833,3118750835.415607,1488244561.057801,1880560532.655902,6487555929.129310,217917,79699,114931,412547
2017-04-18,NASDAQ (DQ),1026452504,424321198,574985039,2025758741,35393659397.570033,22594225864.822981,19352343246.470443,77340228508.863457,3524153,900415,1829250,6253818
2017-04-18,EDGA Equities (J),65222815,32647300,32763892,130634007,2118496067.878700,1521825161.221002,1091747865.880599,4732069094.980301,552865,148296,247111,948272
2017-04-18,EDGX Equities (K),173209030,91180314,137892092,402281436,6470173962.117892,4222127522.103199,4473481218.728108,15165782702.949199,1156275,344380,766472,2267127
2017-04-18,CHX (M),7838096,10373840,5821244,24033180,368561828.139900,1095549826.577399,614401901.559500,2078513556.276799,3901,5433,1679,11013
2017-04-18,NYSE (N),762434660,0,0,762434660,28088382899.639927,0.000000,0.000000,28088382899.639927,2393520,0,0,2393520
2017-04-18,NYSE Arca (P),216595422,288146533,117589901,622331856,8973797932.025522,14425431554.465696,4955396815.320891,28354626301.812109,1516705,730171,825490,3072366
2017-04-18,NASDAQ (Q),363248578,124365742,411872511,899486831,15727421671.624242,7312762783.520978,17972314704.271970,41012499159.417190,3072428,499859,2513384,6085671
2017-04-18,IEX (V),74237937,18467176,33739720,126444833,2995723692.932500,908919317.679402,1445573076.886000,5350216087.497902,442833,74453,206440,723726
2017-04-18,NASDAQ PSX (X),18856032,20411916,15778728,55046676,610323587.291400,1118631528.711200,609507352.792100,2338462468.794700,135583,86400,107901,329884
2017-04-18,BYX Equities (Y),158230038,60728943,76425943,295384924,4776509343.991674,2464532787.104002,2487800818.054198,9728842949.149874,1333886,274259,659235,2267380
2017-04-18,BZX Equities (Z),206780582,91518058,97263161,395561801,7550079949.612386,4815528544.094605,4062319791.395697,16427928285.102688,1667092,403366,780154,2850612
2017-04-17,NYSE American (A),0,12450978,0,12450978,0.000000,69935867.280700,0.000000,69935867.280700,0,22487,0,22487
2017-04-17,NASDAQ BX (B),91153553,27373964,46839403,165366920,3285060295.065185,1189953377.864203,1743993416.706402,6219007089.635790,910202,135126,477049,1522377
2017-04-17,NYSE (DN),82789619,39204104,49088637,171082360,2507385219.501311,1481966748.696797,1923869149.768402,5913221117.966510,188012,80261,112523,380796
2017-04-17,NASDAQ (DQ),903860844,424963824,509620318,1838444986,31024577128.622632,19111359033.772158,18457649451.483878,68593585613.878668,3056964,894075,1711989,5663028
2017-04-17,EDGA Equities (J),55766345,26604440,24685177,107055962,1726962699.300700,1257772256.881201,937325873.251400,3922060829.433301,479344,132820,211130,823294
2017-04-17,EDGX Equities (K),139818084,75481285,106075048,321374417,4982301999.572501,3235186030.486013,4015275115.941106,12232763145.999620,944708,290673,661872,1897253
2017-04-17,CHX (M),4973187,7218416,3846063,16037666,228565584.776100,839030942.577000,327345258.327700,1394941785.680800,3352,3987,1468,8807
2017-04-17,NYSE (N),703865871,0,0,703865871,26373594307.262687,0.000000,0.000000,26373594307.262687,2132661,0,0,2132661
2017-04-17,NYSE Arca (P),170259027,255372876,94669651,520301554,7028223954.918906,13305715412.569787,4241685037.634586,24575624405.123279,1251302,626130,717390,2594822
2017-04-17,NASDAQ (Q),293273947,102101260,364135914,759511121,12258880103.280593,5678988561.984202,17139574140.389587,35077442805.654382,2549439,420882,2283915,5254236
2017-04-17,IEX (V),59652361,15823839,29161935,104638135,2341459268.355706,789052940.135800,1325785624.510401,4456297833.001907,368074,68892,185931,622897
2017-04-17,NASDAQ PSX (X),14570603,16985272,13346404,44902279,464628214.248600,927259847.795000,535955280.016800,1927843342.060400,110472,70610,97344,278426
2017-04-17,BYX Equities (Y),136663046,55080266,62372553,254115865,4027223272.860107,2192143625.766903,2094971719.564191,8314338618.191201,1191739,259119,577608,2028466
2017-04-17,BZX Equities (Z),170244800,76983065,79718841,326946706,6005211958.686640,3997694175.611204,3315567941.321402,13318474075.619246,1400193,346051,662092,2408336
2017-04-13,NYSE American (A),0,14814030,0,14814030,0.000000,58590870.915400,0.000000,58590870.915400,0,27287,0,27287
2017-04-13,NASDAQ BX (B),101148495,35692817,55211736,192053048,3497373119.511623,1622045729.727202,2019877419.652099,7139296268.890924,988467,165741,532910,1687118
2017-04-13,NYSE (DN),88990776,44957390,53785982,187734148,2669957242.088111,1774408457.205205,2165881329.823901,6610247029.117217,201831,84270,122749,408850
2017-04-13,NASDAQ (DQ),943085429,508713005,561198232,2012996666,29734359964.860388,22707644247.407245,19504379117.906514,71946383330.174147,3251059,987370,1800572,6039001
2017-04-13,EDGA Equities (J),64009969,37205372,30549934,131765275,1961151961.101708,1807553820.782804,1150820471.201597,4919526253.086109,548519,173921,248184,970624
2017-04-13,EDGX Equities (K),173962236,111467322,132809666,418239224,5937325836.956415,4939793419.357604,4989859512.355891,15866978768.669910,1136592,407402,806655,2350649
2017-04-13,CHX (M),7442434,11578238,2760758,21781430,257298570.460200,1097289133.714300,185170908.772300,1539758612.946800,4549,6640,2148,13337
2017-04-13,NYSE (N),778712962,0,0,778712962,27623721102.900102,0.000000,0.000000,27623721102.900102,2415816,0,0,2415816
2017-04-13,NYSE Arca (P),199845183,327712085,115155760,642713028,7914359276.175456,16718879398.662226,5165144884.387110,29798383559.224792,1473556,864047,847121,3184724
2017-04-13,NASDAQ (Q),343442546,142943242,408206817,894592605,13812617454.644273,8044086963.211176,18927345403.069344,40784049820.924793,2988640,580353,2645120,6214113
2017-04-13,IEX (V),68638604,20370015,31498461,120507080,2509979443.924003,1007162897.836300,1454243535.713301,4971385877.473604,421905,86088,204087,712080
2017-04-13,NASDAQ PSX (X),17763731,24152774,16255683,58172188,551009614.216000,1322872551.792101,691790678.798900,2565672844.807001,133816,99667,115782,349265
2017-04-13,BYX Equities (Y),157215991,70880635,77232206,305328832,4502085465.604199,2913766518.747898,2571859245.842895,9987711230.194992,1356049,318733,685877,2360659
2017-04-13,BZX Equities (Z),202130041,104375531,102491404,408996976,7114650434.839995,5632152450.325187,4425846378.797406,17172649263.962588,1676367,456196,825878,2958441
2017-04-12,NYSE American (A),0,12572566,0,12572566,0.000000,70075540.146400,0.000000,70075540.146400,0,24190,0,24190
2017-04-12,NASDAQ BX (B),105052231,36043348,56480250,197575829,3800111486.382506,1545938727.446695,2137971128.655902,7484021342.485103,1047299,166958,551081,1765338
2017-04-12,NYSE (DN),88720229,41146762,52476015,182343006,2604112688.999803,1467030519.876801,2007061709.512002,6078204918.388606,192359,79942,117206,389507
2017-04-12,NASDAQ (DQ),1013442573,475330433,604828801,2093601807,33116809530.327327,21813971490.188804,20448754383.783798,75379535404.299929,3275004,928408,1865370,6068782
2017-04-12,EDGA Equities (J),61603388,35870962,30450820,127925170,1880352994.799704,1713841046.533001,1148755024.252599,4742949065.585304,529554,163066,252090,944710
2017-04-12,EDGX Equities (K),174573343,100585087,132088211,407246641,5836273277.211114,4392677778.396499,4898882503.873483,15127833559.481096,1106894,377814,815012,2299720
2017-04-12,CHX (M),4565609,8383234,5055486,18004329,195759896.170400,831152407.770000,444898863.810800,1471811167.751200,4775,5884,2262,12921
2017-04-12,NYSE (N),766158261,0,0,766158261,28581512442.770845,0.000000,0.000000,28581512442.770845,2508980,0,0,2508980
2017-04-12,NYSE Arca (P),196388498,314476390,121594599,632459487,8041645043.030273,15145121633.793343,5251223423.142994,28437990099.966610,1485155,838480,879415,3203050
2017-04-12,NASDAQ (Q),348587161,141376922,429996756,919960839,14630007998.257618,7667188854.035615,19794729482.361604,42091926334.654837,3066801,559466,2788385,6414652
2017-04-12,IEX (V),73726776,20310054,35987599,130024429,2678625769.025800,996284126.567799,1583399764.497303,5258309660.090902,447743,86650,224319,758712
2017-04-12,NASDAQ PSX (X),16789624,23404093,16636689,56830406,527792776.750500,1218378156.590001,675855819.516500,2422026752.857001,129492,97094,114601,341187
2017-04-12,BYX Equities (Y),157431446,71958631,77121176,306511253,4598224106.750509,2919601829.470705,2594865611.028615,10112691547.249829,1376956,330976,689838,2397770
2017-04-12,BZX Equities (Z),194261551,99945824,103858837,398066212,6987176953.542109,5322700316.921990,4386410526.891517,16696287797.355616,1642131,438401,856858,2937390
2017-04-11,NYSE American (A),0,12404496,0,12404496,0.000000,72697011.759500,0.000000,72697011.759500,0,27316,0,27316
2017-04-11,NASDAQ BX (B),101703137,38483168,59422225,199608530,3617587327.443976,1661796681.680506,2217846889.108904,7497230898.233386,1004280,185685,577905,1767870
2017-04-11,NYSE (DN),91175291,47335783,63175548,201686622,2733897000.969397,1851664125.064502,2573990456.959606,7159551582.993505,194826,89130,134992,418948
2017-04-11,NASDAQ (DQ),938200126,508060772,664023307,2110284205,30107666449.746104,22969118550.930328,23382867235.174445,76459652235.850877,3125199,1025397,1962482,6113078
2017-04-11,EDGA Equities (J),64114061,39160385,32797656,136072102,1963030100.159493,1808737752.667102,1282529242.813300,5054297095.639895,542259,182789,276378,1001426
2017-04-11,EDGX Equities (K),168932361,107962359,145931015,422825735,5920746121.794517,4912975498.831192,5572703438.897013,16406425059.522722,1129671,414603,901718,2445992
2017-04-11,CHX (M),8454084,12685541,3842842,24982467,273286612.432500,1617435697.549801,311105587.445000,2201827897.427301,4611,6735,1997,13343
2017-04-11,NYSE (N),780708160,0,0,780708160,28053239252.375255,0.000000,0.000000,28053239252.375255,2452783,0,0,2452783
2017-04-11,NYSE Arca (P),195671569,346734703,131133362,673539634,7781129622.789200,16936321772.156379,6013073238.257489,30730524633.203068,1461968,930544,951392,3343904
2017-04-11,NASDAQ (Q),339179824,154373349,480303769,973856942,13982983833.530694,8553954957.255072,21580127092.027719,44117065882.813485,3046573,648350,2981913,6676836
2017-04-11,IEX (V),66734843,21546264,38289942,126571049,2466937993.526001,1075377113.912798,1614787890.854700,5157102998.293499,417793,91362,236936,746091
2017-04-11,NASDAQ PSX (X),17509282,24926990,18968803,61405075,567974876.862000,1390399097.886099,883011801.493599,2841385776.241698,136725,101915,135281,373921
2017-04-11,BYX Equities (Y),157752723,75254679,81482434,314489836,4736555552.283485,3058195935.426094,2817971355.545989,10612722843.255568,1394249,353217,734433,2481899
2017-04-11,BZX Equities (Z),190767127,110615898,111396503,412779528,6808958438.907700,5907721895.483897,4795415867.764482,17512096202.156079,1604543,496612,922092,3023247
2017-04-10,NYSE American (A),0,13169254,0,13169254,0.000000,102650837.089100,0.000000,102650837.089100,0,30460,0,30460
2017-04-10,NASDAQ BX (B),91962667,28289708,52580193,172832568,3390910843.756033,1256308754.456607,1911619155.781195,6558838753.993835,932942,137524,506823,1577289
2017-04-10,NYSE (DN),79943275,39540645,62661281,182145201,2504238015.559193,1465029623.760005,2251926801.453911,6221194440.773109,196142,78370,132170,406682
2017-04-10,NASDAQ (DQ),922463336,409354447,625490619,1957308402,30481646536.252688,18231278751.679364,21528085266.157772,70241010554.089824,3023361,846107,1878496,5747964
2017-04-10,EDGA Equities (J),51567953,26682213,28455679,106705845,1667977420.340998,1221686396.649303,1021739462.810900,3911403279.801201,461225,128003,238221,827449
2017-04-10,EDGX Equities (K),142762586,73581886,130728807,347073279,5022587300.860121,3266343300.443389,4558746183.494187,12847676784.797697,998154,286114,788344,2072612
2017-04-10,CHX (M),5486036,7828637,3406073,16720746,299734182.389200,811304064.060000,243211260.878200,1354249507.327400,3992,4974,1868,10834
2017-04-10,NYSE (N),661913472,0,0,661913472,24908405894.517037,0.000000,0.000000,24908405894.517037,2131310,0,0,2131310
2017-04-10,NYSE Arca (P),165293138,242856399,108675762,516825299,6803091128.005143,12415468163.033202,4704061425.239811,23922620716.278156,1272084,615093,795847,2683024
2017-04-10,NASDAQ (Q),298372330,102277811,410013242,810663383,12551291246.404290,5690603208.875296,18207134966.249428,36449029421.529014,2705541,430586,2619873,5756000
2017-04-10,IEX (V),63438505,16516756,32180763,112136024,2437303640.406705,822795666.613200,1413753245.720300,4673852552.740205,404519,68011,208832,681362
2017-04-10,NASDAQ PSX (X),13838150,16367227,14390415,44595792,462629859.837500,883902630.940100,611035001.125299,1957567491.902899,111343,69398,106192,286933
2017-04-10,BYX Equities (Y),129250138,53789996,69195975,252236109,3990391011.355222,2229348907.057002,2316365775.481408,8536105693.893632,1186146,248653,635042,2069841
2017-04-10,BZX Equities (Z),166288073,73919498,95418252,335625823,6024602005.024614,3840031713.990986,3857786644.244184,13722420363.259784,1394519,322953,772787,2490259
2017-04-07,NYSE American (A),0,12422805,0,12422805,0.000000,87849021.871800,0.000000,87849021.871800,0,24243,0,24243
2017-04-07,NASDAQ BX (B),98968889,31860049,58463238,189292176,3586750121.317982,1406991274.973501,2159580718.885799,7153322115.177282,965792,149608,569348,1684748
2017-04-07,NYSE (DN),82538012,42804925,57050119,182393056,2600244803.339904,1510115201.355203,2038224355.552700,6148584360.247807,194473,73386,127114,394973
2017-04-07,NASDAQ (DQ),997639212,438147744,642317937,2078104893,32754216785.971783,18830834356.816017,21058490793.330087,72643541936.117887,3063979,863021,1848651,5775651
2017-04-07,EDGA Equities (J),57599658,31814080,28796477,118210215,1788508502.180702,1487948431.404399,1049243435.828999,4325700369.414100,492027,143791,239462,875280
2017-04-07,EDGX Equities (K),153024148,90458613,132084704,375567465,5314317044.923424,3913451269.735604,4676481857.150594,13904250171.809622,1030975,333220,800992,2165187
2017-04-07,CHX (M),6888168,12107182,3289028,22284378,287671334.564800,964505840.741000,270199398.023900,1522376573.329700,4191,5498,2043,11732
2017-04-07,NYSE (N),752708820,0,0,752708820,27126946720.080943,0.000000,0.000000,27126946720.080943,2169737,0,0,2169737
2017-04-07,NYSE Arca (P),177159826,273743732,112166277,563069835,7238509579.414472,14136463984.594827,4809480769.468285,26184454333.477584,1330821,732686,798924,2862431
2017-04-07,NASDAQ (Q),321742256,125563396,445804363,893110015,13386653227.829027,7159954107.647761,19408161379.385486,39954768714.862274,2735616,486137,2556527,5778280
2017-04-07,IEX (V),71471980,17053665,37957388,126483033,2695212151.305515,910513543.780200,1662643041.220701,5268368736.306416,450418,73814,229548,753780
2017-04-07,NASDAQ PSX (X),15710609,19525254,14843033,50078896,525710659.380500,1137285152.474000,607897128.015500,2270892939.870000,124238,78565,110192,312995
2017-04-07,BYX Equities (Y),142634751,60252812,73153569,276041132,4321740603.059118,2502939349.894987,2469323901.384511,9294003854.338616,1253669,268526,649428,2171623
2017-04-07,BZX Equities (Z),176616263,87684293,97805934,362106490,6354534630.511429,4696819310.858290,4205924951.562608,15257278892.932327,1473837,386480,790129,2650446
2017-04-06,NYSE American (A),0,9729162,0,9729162,0.000000,55275395.186000,0.000000,55275395.186000,0,20243,0,20243
2017-04-06,NASDAQ BX (B),101032442,30427965,55511067,186971474,3617975358.906097,1402597249.507902,2131984920.680207,7152557529.094206,1011747,144050,551066,1706863
2017-04-06,NYSE (DN),88523279,35055482,65069998,188648759,2699695969.565809,1457144055.942693,2397604869.728799,6554444895.237301,211482,71454,140502,423438
2017-04-06,NASDAQ (DQ),994687544,406170869,696533163,2097391576,32950622857.072299,19571365899.143368,24306487435.962935,76828476192.178602,3316813,899883,2033740,6250436
2017-04-06,EDGA Equities (J),62848359,29518492,32831668,125198519,1935504190.613203,1515285800.676200,1172197936.685400,4622987927.974803,537593,139702,269484,946779
2017-04-06,EDGX Equities (K),165796891,77230857,153377655,396405403,5808611885.691745,3826538936.291509,5356610070.010293,14991760891.993547,1143994,302156,892374,2338524
2017-04-06,CHX (M),9004450,13000362,4247201,26252013,396448113.113100,998266665.351500,298824855.794000,1693539634.258600,4680,6199,2147,13026
2017-04-06,NYSE (N),808083802,0,0,808083802,29777862341.786911,0.000000,0.000000,29777862341.786911,2402767,0,0,2402767
2017-04-06,NYSE Arca (P),199057241,253419728,127730816,580207785,7924475172.308101,14150409545.713207,5719960900.578089,27794845618.599397,1446189,657071,904903,3008163
2017-04-06,NASDAQ (Q),341499948,109725691,470159779,921385418,13983539318.724658,6543723353.690404,21324544337.852300,41851807010.267362,2944019,455219,2840170,6239408
2017-04-06,IEX (V),76534769,15896500,41327426,133758695,2893693751.270903,872287468.585800,1923316721.176199,5689297941.032902,472734,67426,250060,790220
2017-04-06,NASDAQ PSX (X),17626970,18365771,18521171,54513912,567135219.183501,1092947935.367800,793503303.147300,2453586457.698601,138773,77342,127837,343952
2017-04-06,BYX Equities (Y),146033504,55815271,76454100,278302875,4363055148.457227,2444803711.003697,2563182045.458211,9371040904.919135,1336062,262426,710684,2309172
2017-04-06,BZX Equities (Z),192523290,75963609,108035031,376521930,6795605579.080927,4377870373.562500,4524531355.210688,15698007307.854115,1605587,341594,864080,2811261
2017-04-05,NYSE American (A),0,13723522,0,13723522,0.000000,71253038.822900,0.000000,71253038.822900,0,28403,0,28403
2017-04-05,NASDAQ BX (B),117790823,45175618,67642288,230608729,4185672829.992999,2155334682.226406,2587467859.654100,8928475371.873505,1137152,201986,627309,1966447
2017-04-05,NYSE (DN),103762520,45330580,80421119,229514219,3272632630.976504,1786608496.066305,3131474699.060897,8190715826.103706,240130,88860,165766,494756
2017-04-05,NASDAQ (DQ),1146856390,543718751,809319509,2499894650,36941152857.858314,24158177286.067906,27853331169.259415,88952661313.185635,3668796,1050758,2259676,6979230
2017-04-05,EDGA Equities (J),76020151,47996997,38613704,162630852,2270312484.841504,2505733384.462595,1435669419.028301,6211715288.332400,636311,213501,301345,1151157
2017-04-05,EDGX Equities (K),217740193,119895089,180142174,517777456,7511438460.407685,5945889598.514501,6532703607.275207,19990031666.197393,1417157,451111,1026316,2894584
2017-04-05,CHX (M),6312981,18865393,5325115,30503489,366106471.980500,1346815067.175000,487962206.121800,2200883745.277300,5291,7804,2247,15342
2017-04-05,NYSE (N),942487240,0,0,942487240,33533753646.803718,0.000000,0.000000,33533753646.803718,2891299,0,0,2891299
2017-04-05,NYSE Arca (P),237409178,380950293,159246320,777605791,9560448969.980750,22049899735.316442,7621092612.363120,39231441317.660312,1759488,930932,1072244,3762664
2017-04-05,NASDAQ (Q),420374043,172076995,583089968,1175541006,17176098174.195397,10406223061.605712,26402087076.040241,53984408311.841350,3588255,656164,3326930,7571349
2017-04-05,IEX (V),81538473,25097607,43639057,150275137,3109760791.857601,1439336021.402200,2072728110.311000,6621824923.570801,485309,102513,254791,842613
2017-04-05,NASDAQ PSX (X),20803922,28923953,21656366,71384241,677017581.623602,1718875869.312401,986929825.234200,3382823276.170203,163202,112346,152536,428084
2017-04-05,BYX Equities (Y),175111510,88070052,91570021,354751583,5056901647.837288,3859281018.240299,3074371502.216598,11990554168.294185,1540637,381611,792097,2714345
2017-04-05,BZX Equities (Z),234443781,120704692,127940031,483088504,8177013330.307950,7224836672.627701,5541097295.567010,20942947298.502661,1926841,501141,984014,3411996
2017-04-04,NYSE American (A),0,12876442,0,12876442,0.000000,69421294.217600,0.000000,69421294.217600,0,27586,0,27586
2017-04-04,NASDAQ BX (B),101010920,29676944,56105008,186792872,3702583649.982984,1325553786.092503,2105338618.391800,7133476054.467287,1001782,132321,546854,1680957
2017-04-04,NYSE (DN),90987921,37205017,67295851,195488789,2635308343.531602,1353129251.504299,2583376794.663796,6571814389.699697,211906,73429,147026,432361
2017-04-04,NASDAQ (DQ),1024197746,463370049,675589760,2163157555,34356690566.610216,19264697167.296419,23421327949.172981,77042715683.079616,3410779,842338,2053088,6306205
2017-04-04,EDGA Equities (J),64735271,31383983,32688600,128807854,1971200006.746098,1402463376.832798,1105971438.670198,4479634822.249094,547270,133523,254641,935434
2017-04-04,EDGX Equities (K),168244853,81438914,145876180,395559947,5812603558.084198,3574193844.547493,5291465764.698006,14678263167.329697,1125679,295256,866849,2287784
2017-04-04,CHX (M),7222135,9716938,5002389,21941462,418308302.586500,915156252.504000,367826020.998900,1701290576.089400,4717,5334,1851,11902
2017-04-04,NYSE (N),801405336,0,0,801405336,30114923597.630257,0.000000,0.000000,30114923597.630257,2371959,0,0,2371959
2017-04-04,NYSE Arca (P),190074046,239847637,119571328,549493011,7772872891.911609,12442674266.163192,5275527493.913510,25491074651.988311,1418576,607153,854010,2879739
2017-04-04,NASDAQ (Q),334620762,105960416,463561887,904143065,13746971514.547903,5863711100.455819,20683946784.960195,40294629399.963917,2839371,407004,2734498,5980873
2017-04-04,IEX (V),68516581,20044385,36990128,125551094,2756184036.786296,885985613.827301,1683880338.223999,5326049988.837596,423717,58566,224897,707180
2017-04-04,NASDAQ PSX (X),16415638,17488374,16464428,50368440,524526810.979100,992056999.655501,633813235.712100,2150397046.346701,128984,70076,119890,318950
2017-04-04,BYX Equities (Y),149120498,56611723,74574587,280306808,4375223649.015628,2336300239.297500,2472921334.158901,9184445222.472029,1303327,251075,673751,2228153
2017-04-04,BZX Equities (Z),191798182,77743353,101543688,371085223,6760781294.421767,4200202274.590290,4205671402.402112,15166654971.414169,1576284,322464,807230,2705978
2017-04-03,NYSE American (A),0,10832754,0,10832754,0.000000,70434332.491500,0.000000,70434332.491500,0,24068,0,24068
2017-04-03,NASDAQ BX (B),105387081,39777262,63098857,208263200,3897853522.207500,1892788100.127103,2352587126.440293,8143228748.774896,1071653,166256,619748,1857657
2017-04-03,NYSE (DN),87593291,46912500,66956917,201462708,2759610198.348204,1995331524.560803,2580659306.299301,7335601029.208308,217977,102767,153028,473772
2017-04-03,NASDAQ (DQ),1040905750,588241899,675962280,2305109929,35177118243.043429,31004622984.252273,26060832000.741568,92242573228.037270,3511913,1040587,2160078,6712578
2017-04-03,EDGA Equities (J),66980057,42078509,33614545,142673111,2117863208.679288,2053855636.854097,1267818155.211502,5439537000.744887,587418,176144,282238,1045800
2017-04-03,EDGX Equities (K),190368132,98805180,157988798,447162110,7068760164.723609,5052707002.514134,6252088969.678202,18373556136.915945,1441440,389016,1079230,2909686
2017-04-03,CHX (M),10328428,8792513,3919741,23040682,678354311.217800,1064099872.221500,307812486.077800,2050266669.517100,5446,5384,2459,13289
2017-04-03,NYSE (N),924783921,0,0,924783921,34489996808.833404,0.000000,0.000000,34489996808.833404,2720309,0,0,2720309
2017-04-03,NYSE Arca (P),196897262,332814357,122617204,652328823,8162013650.754096,18920229316.541614,5862807527.495395,32945050494.791105,1538919,837148,943506,3319573
2017-04-03,NASDAQ (Q),353368689,136874369,478352690,968595748,15287406468.127238,8027654121.110291,23586664964.132493,46901725553.370022,3228840,547190,3047505,6823535
2017-04-03,IEX (V),75508098,21394808,41562418,138465324,2938118962.352413,1256564216.227694,1902817053.112506,6097500231.692613,492632,85549,268483,846664
2017-04-03,NASDAQ PSX (X),18238069,23563721,17697767,59499557,602597455.336500,1491495661.492999,815019701.855999,2909112818.685498,147185,97997,135853,381035
2017-04-03,BYX Equities (Y),155770793,73054886,85343770,314169449,4799086102.823826,3239298094.385801,2853842273.415694,10892226470.625321,1453848,316073,805126,2575047
2017-04-03,BZX Equities (Z),192604529,97960342,105879809,396444680,7149723801.743581,5743452388.956010,4777769773.312896,17670945964.012487,1698549,425023,886615,3010187
2017-03-31,NYSE American (A),0,11700531,0,11700531,0.000000,105490024.396500,0.000000,105490024.396500,0,22723,0,22723
2017-03-31,NASDAQ BX (B),105376281,31994891,57411336,194782508,3911175576.856064,1533550288.605402,2226867607.561208,7671593473.022674,1100322,149631,594834,1844787
2017-03-31,NYSE (DN),78505569,35572951,58109914,172188434,2475816004.445209,1411779724.918899,2134780413.638105,6022376143.002213,206189,77560,139370,423119
2017-03-31,NASDAQ (DQ),1008975964,464676499,708140073,2181792536,33787300771.711403,22861789613.568205,23069396270.687549,79718486655.967157,3303008,900992,2004385,6208385
2017-03-31,EDGA Equities (J),67361506,32980511,31482254,131824271,2082945762.270093,1612829971.647901,1119522734.888099,4815298468.806093,576301,148890,262391,987582
2017-03-31,EDGX Equities (K),162737464,78660398,144164916,385562778,5957839007.669158,3986746936.356409,4953282589.392396,14897868533.417963,1171491,293100,852736,2317327
2017-03-31,CHX (M),7886878,12922154,4349981,25159013,315370390.815000,1178940645.196800,318553010.309300,1812864046.321100,4482,4872,1964,11318
2017-03-31,NYSE (N),982698628,0,0,982698628,37397239609.989024,0.000000,0.000000,37397239609.989024,2434902,0,0,2434902
2017-03-31,NYSE Arca (P),189379105,274691956,116122428,580193489,7972073508.735799,15346570557.153907,4894543459.159192,28213187525.048898,1427864,665767,849861,2943492
2017-03-31,NASDAQ (Q),327769036,109403428,553566933,990739397,13878553887.665972,6330074422.898114,23920368794.618018,44128997105.182104,2890961,410201,2685871,5987033
2017-03-31,IEX (V),75417086,19317545,38752616,133487247,2849918949.517794,1199541920.774300,1797375127.106199,5846835997.398293,480251,79277,240576,800104
2017-03-31,NASDAQ PSX (X),17723117,17860185,17670256,53253558,619026006.284800,1005238793.833700,731340700.375800,2355605500.494300,153418,74949,136385,364752
2017-03-31,BYX Equities (Y),150542408,65527775,77923391,293993574,4665333035.626822,2859879552.274106,2612801763.779896,10138014351.680824,1374082,285469,713859,2373410
2017-03-31,BZX Equities (Z),182367418,81563021,97459423,361389862,6705992831.230312,4714395862.749802,4042638011.524202,15463026705.504316,1532024,345579,782505,2660108
2017-03-30,NYSE American (A),0,9185636,0,9185636,0.000000,58444082.862300,0.000000,58444082.862300,0,21516,0,21516
2017-03-30,NASDAQ BX (B),100986524,26021850,52784907,179793281,3631360364.991622,1183935982.010701,1867131395.943499,6682427742.945822,1007085,132158,538529,1677772
2017-03-30,NYSE (DN),81229577,34490928,65299527,181020032,2693087743.691515,1304029622.326301,2542351940.364000,6539469306.381816,197020,67473,133033,397526
2017-03-30,NASDAQ (DQ),1057847544,431989127,684280611,2174117282,35798398457.806997,19813591200.270750,21340067226.567617,76952056884.645364,3332835,816072,1983955,6132862
2017-03-30,EDGA Equities (J),67380002,29667086,30566828,127613916,2065936659.474001,1369363666.110900,1010760529.266401,4446060854.851302,573497,137544,248354,959395
2017-03-30,EDGX Equities (K),164663231,76548981,143107987,384320199,5832384942.394479,3570617804.515814,4641648121.390923,14044650868.301216,1119774,288368,812264,2220406
2017-03-30,CHX (M),8847220,11755857,4872407,25475484,410406675.051000,980447674.362400,314217333.101000,1705071682.514400,3974,5418,1809,11201
2017-03-30,NYSE (N),761344018,0,0,761344018,28763157264.285500,0.000000,0.000000,28763157264.285500,2297467,0,0,2297467
2017-03-30,NYSE Arca (P),189194994,242080990,112527543,543803527,7617703562.841280,12607248498.427777,4691893959.211996,24916846020.481053,1384095,633043,803910,2821048
2017-03-30,NASDAQ (Q),316175625,103314944,417478727,836969296,13718913498.900694,5543136711.957513,17718686802.481493,36980737013.339700,2852401,404387,2557170,5813958
2017-03-30,IEX (V),73717556,17708427,34966347,126392330,2848299314.243492,909579190.665001,1482114833.930800,5239993338.839293,448523,69372,214493,732388
2017-03-30,NASDAQ PSX (X),18051136,16812264,18120812,52984212,602324903.142800,930007228.825300,645716351.773300,2178048483.741400,144756,69551,125401,339708
2017-03-30,BYX Equities (Y),141068427,57160391,70158069,268386887,4368823561.272093,2348389216.919498,2297700263.815402,9014913042.006993,1308936,250871,659025,2218832
2017-03-30,BZX Equities (Z),179175806,77972680,97936534,355085020,6518819512.107189,4087313281.046304,3863979079.372694,14470111872.526187,1486379,326479,766030,2578888
2017-03-29,NYSE American (A),0,9769455,0,9769455,0.000000,94744645.714300,0.000000,94744645.714300,0,22827,0,22827
2017-03-29,NASDAQ BX (B),95626241,25008323,51789301,172423865,3402130767.055497,1210200089.297200,1998536419.840499,6610867276.193196,968790,129312,521128,1619230
2017-03-29,NYSE (DN),85890933,33025021,63878743,182794697,2522913403.037505,1186691437.012193,2461363691.362404,6170968531.412102,205780,67417,137672,410869
2017-03-29,NASDAQ (DQ),1002929340,419635176,676548316,2099112832,32234863039.475958,19295308684.270313,22205544949.765937,73735716673.512208,3286294,817368,2014416,6118078
2017-03-29,EDGA Equities (J),67552032,27199621,31663855,126415508,1973238771.207203,1338948109.604199,1141932920.305101,4454119801.116503,585390,131251,261755,978396
2017-03-29,EDGX Equities (K),170303346,72868152,141332727,384504225,5744571300.807522,3574212091.406395,4845397053.208517,14164180445.422434,1118811,285891,820290,2224992
2017-03-29,CHX (M),11813300,13877540,5339222,31030062,574373331.367600,1124407680.128000,494321701.372800,2193102712.868400,4478,4205,1687,10370
2017-03-29,NYSE (N),727738245,0,0,727738245,26224008853.943213,0.000000,0.000000,26224008853.943213,2412522,0,0,2412522
2017-03-29,NYSE Arca (P),197546248,216257345,114575628,528379221,7913646104.804135,11754926701.785619,5038950643.892416,24707523450.482170,1431312,594763,830130,2856205
2017-03-29,NASDAQ (Q),321394930,95449306,414076789,830921025,13167462036.961241,5596737491.932502,18603707881.288031,37367907410.181774,2784328,384269,2594716,5763313
2017-03-29,IEX (V),75320531,17332684,37375267,130028482,2805525105.880203,855572180.659701,1801675491.983300,5462772778.523204,471152,70435,238459,780046
2017-03-29,NASDAQ PSX (X),19506399,17103213,16633472,53243084,614817412.507301,987331380.482100,685968893.408000,2288117686.397401,155863,70327,132605,358795
2017-03-29,BYX Equities (Y),143379941,55281716,74394223,273055880,4342731957.277213,2308184352.847298,2515956195.518108,9166872505.642619,1342709,251560,684705,2278974
2017-03-29,BZX Equities (Z),188677082,72260704,94587227,355525013,6650331434.135756,4141643643.113595,4055680717.084795,14847655794.334146,1569919,322249,785704,2677872
2017-03-28,NYSE American (A),0,10813594,0,10813594,0.000000,59551447.711400,0.000000,59551447.711400,0,22883,0,22883
2017-03-28,NASDAQ BX (B),96170052,32394951,54637179,183202182,3525362648.885728,1579879535.201297,2039505404.042001,7144747588.129026,982438,159574,538440,1680452
2017-03-28,NYSE (DN),91644534,45233814,63384442,200262790,2872249571.619302,1649871153.014198,2419578924.022098,6941699648.655598,214872,81398,139236,435506
2017-03-28,NASDAQ (DQ),1079629858,556154252,698573312,2334357422,37333954201.143520,25905543771.070688,23642699437.250275,86882197409.464483,3478934,983628,2053820,6516382
2017-03-28,EDGA Equities (J),70957679,32921125,33360088,137238892,2162206880.974301,1678645694.485999,1194663125.659500,5035515701.119800,622622,159184,274330,1056136
2017-03-28,EDGX Equities (K),181343837,96147888,150745892,428237617,6449114871.863983,4532144035.173898,5478008420.826701,16459267327.864582,1244088,373156,907842,2525086
2017-03-28,CHX (M),10426972,25094500,7421860,42943332,544641721.518000,2133058122.384999,436935154.403800,3114634998.306799,4484,5944,2037,12465
2017-03-28,NYSE (N),824020134,0,0,824020134,30979221863.172349,0.000000,0.000000,30979221863.172349,2572176,0,0,2572176
2017-03-28,NYSE Arca (P),207904871,297362018,121644525,626911414,8518125738.683003,16004790348.621997,5398149531.494811,29921065618.799811,1566100,775461,888370,3229931
2017-03-28,NASDAQ (Q),354588471,125141409,457935062,937664942,14747715173.283240,7248503434.308588,20767712730.421813,42763931338.013641,3112442,485072,2741889,6339403
2017-03-28,IEX (V),74972697,21468314,37351786,133792797,2954530306.381610,1181941102.513300,1771359024.386200,5907830433.281110,483442,89782,245860,819084
2017-03-28,NASDAQ PSX (X),17722608,20495220,17880577,56098405,573329116.092400,1251283626.939698,752855073.085700,2577467816.117798,145865,88628,135834,370327
2017-03-28,BYX Equities (Y),155136696,70451763,77545453,303133912,4744482329.599378,3022147766.425495,2666153151.374604,10432783247.399477,1410681,314686,703993,2429360
2017-03-28,BZX Equities (Z),204601859,95607582,103124500,403333941,7276654983.046207,5260745433.385389,4520411646.539292,17057812062.970888,1747156,410930,859960,3018046
2017-03-27,NYSE American (A),0,10248638,0,10248638,0.000000,56829076.448300,0.000000,56829076.448300,0,22690,0,22690
2017-03-27,NASDAQ BX (B),94967982,33007607,50208094,178183683,3468980177.134917,1586492813.336802,1908352742.350204,6963825732.821923,957159,159347,503287,1619793
2017-03-27,NYSE (DN),94140479,46376326,62490749,203007554,3133908387.761219,1778716872.739597,2402665789.215307,7315291049.716123,217780,88907,138144,444831
2017-03-27,NASDAQ (DQ),985758878,511496545,605336047,2102591470,33529793108.523615,24063859989.716997,21048902564.826259,78642555663.066871,3378279,1025041,1929083,6332403
2017-03-27,EDGA Equities (J),69118971,32718126,30926132,132763229,2093396571.414093,1736189285.544704,1122139945.554902,4951725802.513699,584944,146554,253064,984562
2017-03-27,EDGX Equities (K),179217830,100272099,140783727,420273656,6236246541.509155,4876474829.156998,4903264942.402293,16015986313.068446,1209531,394104,864461,2468096
2017-03-27,CHX (M),7004484,11536021,3837990,22378495,261754997.875500,1333103047.691301,357960788.203800,1952818833.770601,4526,6990,2178,13694
2017-03-27,NYSE (N),825959914,0,0,825959914,31651202405.278546,0.000000,0.000000,31651202405.278546,2600386,0,0,2600386
2017-03-27,NYSE Arca (P),205544677,311150605,116232268,632927550,8411376934.566690,16405619013.181349,5275157498.817217,30092153446.565256,1522936,813617,871598,3208151
2017-03-27,NASDAQ (Q),341186443,130190003,431342464,902718910,14327626818.193540,7578858463.169605,20109444450.278108,42015929731.641253,3044375,513990,2738777,6297142
2017-03-27,IEX (V),72796026,20111337,34956409,127863772,2843997155.373302,1068136774.158900,1534527884.519602,5446661814.051804,448157,80945,221642,750744
2017-03-27,NASDAQ PSX (X),18392500,22662420,18452142,59507062,619608145.574098,1440433257.028599,783949756.776001,2843991159.378698,153879,85889,138562,378330
2017-03-27,BYX Equities (Y),148514224,71002498,73417511,292934233,4560760631.254482,3009871524.814998,2524440606.042298,10095072762.111778,1360437,308227,676650,2345314
2017-03-27,BZX Equities (Z),199706249,98459433,105086150,403251832,7206653829.588221,5456444266.666998,4405636511.735408,17068734607.990627,1676353,431291,864595,2972239
2017-03-24,NYSE American (A),0,8593666,0,8593666,0.000000,60497724.498100,0.000000,60497724.498100,0,20769,0,20769
2017-03-24,NASDAQ BX (B),92705275,34004943,54058314,180768532,3439265333.919995,1744510777.881602,2059942245.384398,7243718357.185995,928380,158309,517518,1604207
2017-03-24,NYSE (DN),70435096,37500541,64557980,172493617,2413585577.326507,1581236511.021398,2382800144.610602,6377622232.958507,180317,67433,141702,389452
2017-03-24,NASDAQ (DQ),837861585,484199633,676016074,1998077292,29031419386.427011,23228685720.618217,21352999001.676089,73613104108.721317,2921851,813985,1944098,5679934
2017-03-24,EDGA Equities (J),74027116,37150743,36251285,147429144,2245848951.742315,2033055754.437798,1311878028.329199,5590782734.509312,625065,165730,291654,1082449
2017-03-24,EDGX Equities (K),165423638,99846373,153403693,418673704,6002135428.032290,5543543204.529811,5433761713.266794,16979440345.828895,1170632,398230,903704,2472566
2017-03-24,CHX (M),8613934,15144713,2247864,26006511,373600166.156700,1542817894.911000,208125164.103500,2124543225.171200,4215,7221,1766,13202
2017-03-24,NYSE (N),791246528,0,0,791246528,30438602190.220585,0.000000,0.000000,30438602190.220585,2594717,0,0,2594717
2017-03-24,NYSE Arca (P),191623940,302704348,133733525,628061813,7992392077.590300,17215363464.673678,5684574826.924704,30892330369.188682,1441173,809010,943976,3194159
2017-03-24,NASDAQ (Q),328599490,136096547,490544151,955240188,14222180599.548482,9064053731.531001,22206411173.727062,45492645504.806545,2997919,549301,2860882,6408102
2017-03-24,IEX (V),63296837,18917534,35351816,117566187,2467935138.349395,1111476726.194399,1559080099.153800,5138491963.697594,390651,68770,226239,685660
2017-03-24,NASDAQ PSX (X),19861443,27420421,20179334,67461198,691289766.225001,1935070795.891000,858395148.738000,3484755710.854001,162195,103767,149874,415836
2017-03-24,BYX Equities (Y),147500672,76087163,79313690,302901525,4679080242.307328,3421973098.286495,2601530692.833697,10702584033.427520,1332983,331207,697683,2361873
2017-03-24,BZX Equities (Z),187340991,104557782,109389532,401288305,6888240761.378985,6635495828.491020,4733832499.107600,18257569088.977605,1549072,465201,865807,2880080
2017-03-23,NYSE American (A),0,10107740,0,10107740,0.000000,77706414.973500,0.000000,77706414.973500,0,23712,0,23712
2017-03-23,NASDAQ BX (B),97142821,34614840,53670195,185427856,3513895119.517528,1709617605.516294,1983083267.499397,7206595992.533219,967565,158445,512368,1638378
2017-03-23,NYSE (DN),82926325,44835226,60093279,187854830,2514164384.997607,1848231788.222897,2214218941.441208,6576615114.661712,201630,74106,135646,411382
2017-03-23,NASDAQ (DQ),993262784,534958637,646860205,2175081626,33397644258.289474,24691619569.880742,20875311865.477837,78964575693.648053,3191129,919409,1895008,6005546
2017-03-23,EDGA Equities (J),74317395,38549564,36334212,149201171,2258572127.884898,1936696777.752198,1277566780.668300,5472835686.305396,635337,171447,287016,1093800
2017-03-23,EDGX Equities (K),180471166,102462969,148837942,431772077,6317331458.274532,5141070415.973800,5318739292.468614,16777141166.716946,1241442,399381,891401,2532224
2017-03-23,CHX (M),11425572,17432412,1774097,30632081,473623766.781100,1699019281.590001,125209892.131600,2297852940.502701,5059,7650,1982,14691
2017-03-23,NYSE (N),805265915,0,0,805265915,29727787460.052850,0.000000,0.000000,29727787460.052850,2631517,0,0,2631517
2017-03-23,NYSE Arca (P),212603831,296876935,124042019,633522785,8307633226.228680,16719905724.845933,5373803463.714595,30401342414.789208,1536490,821984,863434,3221908
2017-03-23,NASDAQ (Q),345824801,138659563,435814448,920298812,14181235101.527510,8920603784.128519,20142616984.775354,43244455870.431383,3114649,559155,2783044,6456848
2017-03-23,IEX (V),71844165,19892000,37865840,129602005,2735343111.846611,1146300347.055000,1661715585.781398,5543359044.683009,439001,76158,233794,748953
2017-03-23,NASDAQ PSX (X),20781948,23115961,19476370,63374279,692559857.217600,1530887272.803500,776857707.565799,3000304837.586899,168366,91435,145008,404809
2017-03-23,BYX Equities (Y),154733104,72850700,80129268,307713072,4748994610.233407,3199817020.254007,2627127320.433119,10575938950.920533,1386766,313763,698973,2399502
2017-03-23,BZX Equities (Z),211809840,105345192,102101858,419256890,7496103050.164690,6329684652.060492,4341585955.513297,18167373657.738479,1692177,472837,822284,2987298
2017-03-22,NYSE American (A),0,9556897,0,9556897,0.000000,66996821.441700,0.000000,66996821.441700,0,22762,0,22762
2017-03-22,NASDAQ BX (B),108508927,36289292,58656111,203454330,3955473283.643885,1735371075.805896,2229951246.816602,7920795606.266383,1089696,170858,587411,1847965
2017-03-22,NYSE (DN),100059846,43794441,62589585,206443872,2996405667.454621,1771198290.049398,2182334936.682312,6949938894.186331,233875,90007,139239,463121
2017-03-22,NASDAQ (DQ),1070242044,557786803,683051220,2311080067,35686893300.993908,27521397059.861749,21554360216.529215,84762650577.384872,3691677,1048892,2064095,6804664
2017-03-22,EDGA Equities (J),79324102,41489674,37661809,158475585,2444389311.923911,1987244321.018805,1288880361.309603,5720513994.252319,675347,184217,300402,1159966
2017-03-22,EDGX Equities (K),197421042,112760425,157497314,467678781,6978627009.066119,5548213926.540824,5536135841.456183,18062976777.063126,1373031,445929,950637,2769597
2017-03-22,CHX (M),9289093,15163571,4073141,28525805,492115727.419000,1302244899.653600,314957122.241000,2109317749.313600,4931,6891,2199,14021
2017-03-22,NYSE (N),899064513,0,0,899064513,32826922185.678360,0.000000,0.000000,32826922185.678360,3020839,0,0,3020839
2017-03-22,NYSE Arca (P),233415332,340544731,129547437,703507500,9318263358.394925,17852175656.856754,5817339989.463477,32987779004.715156,1667812,903209,925400,3496421
2017-03-22,NASDAQ (Q),383221266,150000967,467854040,1001076273,15870302808.911351,9008851590.525926,20998357546.534569,45877511945.971846,3410690,608439,3049082,7068211
2017-03-22,IEX (V),83743456,22426728,45397247,151567431,3209298075.806900,1187991425.902601,1911703740.435103,6308993242.144604,526921,87736,270470,885127
2017-03-22,NASDAQ PSX (X),22303216,25346089,20224604,67873909,772503648.909699,1423648156.356600,838467738.220799,3034619543.487098,178315,100026,150072,428413
2017-03-22,BYX Equities (Y),162359452,80981014,82747383,326087849,4967437593.873608,3475889063.706596,2716306854.355791,11159633511.935995,1476679,355201,772217,2604097
2017-03-22,BZX Equities (Z),226211051,117482827,110999703,454693581,7987551143.039289,6700718144.667308,4596518131.171417,19284787418.878014,1829426,512318,898978,3240722
2017-03-21,NYSE American (A),0,13194955,0,13194955,0.000000,77025877.305600,0.000000,77025877.305600,0,28814,0,28814
2017-03-21,NASDAQ BX (B),123458377,47935754,68426491,239820622,4592469288.777905,2314448687.601200,2734149004.488501,9641066980.867606,1201925,213437,672061,2087423
2017-03-21,NYSE (DN),132267299,57083833,79945139,269296271,3993188068.793011,2192497441.687905,3374787564.458901,9560473074.939817,282364,111396,178310,572070
2017-03-21,NASDAQ (DQ),1316006667,694545938,794753595,2805306200,43304765957.991275,33606086597.042211,29614708333.659920,106525560888.693406,4213318,1276175,2437821,7927314
2017-03-21,EDGA Equities (J),100642086,59746244,45401242,205789572,3054947828.278204,2891133839.927698,1800816962.458902,7746898630.664804,827703,261789,380380,1469872
2017-03-21,EDGX Equities (K),256876594,149698382,190785016,597359992,9144956077.443030,7286810152.086275,7682315052.491269,24114081282.020574,1685648,552412,1200978,3439038
2017-03-21,CHX (M),12419690,19620367,5764290,37804347,515770176.298500,2000575917.520000,462914530.381300,2979260624.199800,6233,9396,2737,18366
2017-03-21,NYSE (N),1004510148,0,0,1004510148,37120183460.315762,0.000000,0.000000,37120183460.315762,3236215,0,0,3236215
2017-03-21,NYSE Arca (P),273055085,435089928,150965059,859110072,10680134823.072771,23466730881.741944,7589510126.620967,41736375831.435682,1921352,1155000,1126004,4202356
2017-03-21,NASDAQ (Q),472534614,205263251,559567432,1237365297,19804122133.211061,11828225071.032710,27910009341.942369,59542356546.186140,4018080,778233,3772234,8568547
2017-03-21,IEX (V),101568433,31453254,50431848,183453535,3919967724.023605,1755061000.298699,2501743985.398895,8176772709.721199,614538,118862,318253,1051653
2017-03-21,NASDAQ PSX (X),28038367,35153343,24341605,87533315,943100332.028802,2193213230.142600,1141072376.424498,4277385938.595900,215855,131727,178862,526444
2017-03-21,BYX Equities (Y),189169404,101605484,96911339,387686227,5821349590.896895,4492641718.344897,3421289586.987999,13735280896.229791,1678247,438104,923405,3039756
2017-03-21,BZX Equities (Z),268344362,153239453,132632129,554215944,9491575913.771231,9034954709.298001,6098909322.197780,24625439945.267012,2101515,648629,1102908,3853052
2017-03-20,NYSE American (A),0,10834929,0,10834929,0.000000,79113701.980600,0.000000,79113701.980600,0,21713,0,21713
2017-03-20,NASDAQ BX (B),89095508,25341464,49832138,164269110,3248118309.444511,1090227934.856400,1856247818.535701,6194594062.836612,888511,118590,495073,1502174
2017-03-20,NYSE (DN),83291512,32404728,60355575,176051815,2510144460.324300,1250638962.871499,2055322394.916402,5816105818.112201,199456,67964,129831,397251
2017-03-20,NASDAQ (DQ),988393513,411145707,688223778,2087762998,34289787381.456499,17718831483.140135,21394046944.498519,73402665809.095153,3178508,842051,1971241,5991800
2017-03-20,EDGA Equities (J),70592703,30468406,32713230,133774339,2134842054.654297,1390765338.646102,1104985647.588000,4630593040.888399,596225,139283,269782,1005290
2017-03-20,EDGX Equities (K),160210574,73774002,147242542,381227118,5623784524.129388,3197313816.006296,4796436425.499699,13617534765.635383,1090518,270243,808918,2169679
2017-03-20,CHX (M),11492055,12443096,4089454,28024605,667258775.270000,1183464355.260000,282904253.856500,2133627384.386500,3735,4134,1651,9520
2017-03-20,NYSE (N),752125511,0,0,752125511,28712863641.801924,0.000000,0.000000,28712863641.801924,2277011,0,0,2277011
2017-03-20,NYSE Arca (P),182175089,214665616,113760459,510601164,7335833884.672631,10819267755.876561,4567767274.278490,22722868914.827682,1334548,596512,795533,2726593
2017-03-20,NASDAQ (Q),316933783,118877111,422734968,858545862,13571030392.081405,5782292465.153703,18379209024.130029,37732531881.365137,2761971,394465,2560207,5716643
2017-03-20,IEX (V),71774251,16610230,36708895,125093376,2824632629.955998,798864886.370300,1591198294.814901,5214695811.141199,452061,64930,229151,746142
2017-03-20,NASDAQ PSX (X),18664476,16290498,18400320,53355294,655865562.784202,885872559.010701,695565365.191100,2237303486.986003,161714,64616,138237,364567
2017-03-20,BYX Equities (Y),138337308,58495496,71469038,268301842,4203647483.900625,2338742497.877498,2355077486.546604,8897467468.324727,1228438,249018,642034,2119490
2017-03-20,BZX Equities (Z),178475446,75263925,91262982,345002353,6214681928.472284,3949811563.122799,3612904549.181403,13777398040.776486,1383182,305331,713462,2401975
2017-03-17,NYSE American (A),0,78721058,0,78721058,0.000000,333414903.148300,0.000000,333414903.148300,0,23932,0,23932
2017-03-17,NASDAQ BX (B),105248458,34074946,59381377,198704781,3941973770.435228,1634024827.595003,2265581448.384297,7841580046.414528,1078171,154209,571710,1804090
2017-03-17,NYSE (DN),89101614,38078172,63264019,190443805,2578755696.821504,1369240657.150598,2179628139.480103,6127624493.452205,224353,77573,149426,451352
2017-03-17,NASDAQ (DQ),1359608654,489094753,1119858405,2968561812,47584944143.272811,24679698405.078284,34315617529.581665,106580260077.932760,3548866,916060,2153875,6618801
2017-03-17,EDGA Equities (J),81171575,36312258,37217212,154701045,2592978927.457490,1674455002.733799,1368519562.635300,5635953492.826589,700960,163756,303110,1167826
2017-03-17,EDGX Equities (K),182541975,91681898,149432320,423656193,6439491563.685101,4085762071.352501,5329121735.590006,15854375370.627608,1228140,340170,892429,2460739
2017-03-17,CHX (M),9431723,14391162,6822871,30645756,382072749.188300,1348987850.925000,571386921.691100,2302447521.804400,5647,4054,2147,11848
2017-03-17,NYSE (N),2307115312,0,0,2307115312,94844868512.737339,0.000000,0.000000,94844868512.737339,2705247,0,0,2705247
2017-03-17,NYSE Arca (P),213315049,285841920,129323578,628480547,8539013820.861190,15848986554.743877,5611511421.240586,29999511796.845653,1525613,710263,898712,3134588
2017-03-17,NASDAQ (Q),357644729,126388946,1366951855,1850985530,15036686515.318300,6909718065.571718,56522820194.088355,78469224774.978373,3103628,474745,3092560,6670933
2017-03-17,IEX (V),82979476,21630161,42765755,147375392,3106938106.053203,1037309435.724100,1893300973.328602,6037548515.105905,510628,85975,265632,862235
2017-03-17,NASDAQ PSX (X),20801533,20815713,18671725,60288971,730020519.307600,1074354514.696800,771738531.961899,2576113565.966299,175479,80635,144308,400422
2017-03-17,BYX Equities (Y),171294798,75392001,93185685,339872484,5328128372.129401,3085091700.594505,3022584829.490492,11435804902.214398,1573755,328797,777120,2679672
2017-03-17,BZX Equities (Z),199573718,91904832,103101001,394579551,7115368181.666381,4778317221.980300,4375469478.997792,16269154882.644473,1548644,381513,794198,2724355
2017-03-16,NYSE American (A),0,12135345,0,12135345,0.000000,64931702.180700,0.000000,64931702.180700,0,24006,0,24006
2017-03-16,NASDAQ BX (B),109393157,36291397,58531197,204215751,4153983070.285567,1709381277.548302,2197371411.376910,8060735759.210779,1073342,169059,570764,1813165
2017-03-16,NYSE (DN),94613226,42647680,57741079,195001985,2838219993.150708,1600504036.456203,2075663761.193404,6514387790.800315,213170,87203,128565,428938
2017-03-16,NASDAQ (DQ),1052794858,566180889,683686668,2302662415,34593175224.959487,26453872961.799914,22327134672.386040,83374182859.145441,3538344,1014807,2019299,6572450
2017-03-16,EDGA Equities (J),80989877,42328206,35462842,158780925,2557591859.823102,2003837875.850399,1281316880.626601,5842746616.300102,672115,191659,290343,1154117
2017-03-16,EDGX Equities (K),183193329,107699896,145709323,436602548,6600743674.789740,4905601452.683219,5037051796.445881,16543396923.918840,1237474,405489,834841,2477804
2017-03-16,CHX (M),7011363,27665028,5552060,40228451,360555568.635300,2041406349.095000,369408561.797300,2771370479.527600,5000,6182,2179,13361
2017-03-16,NYSE (N),804112547,0,0,804112547,30560673032.315453,0.000000,0.000000,30560673032.315453,2491817,0,0,2491817
2017-03-16,NYSE Arca (P),217587749,333018717,118110046,668716512,8741950194.886040,16936809513.131435,5229643396.300600,30908403104.318075,1562733,806291,852461,3221485
2017-03-16,NASDAQ (Q),366578349,143728781,432418720,942725850,15554431477.796310,7565260830.562407,19832990453.619933,42952682761.978650,3218298,527735,2721472,6467505
2017-03-16,IEX (V),77881487,23069555,41936935,142887977,3106042326.562007,1174206512.592300,1715048432.403999,5995297271.558306,490335,88875,232252,811462
2017-03-16,NASDAQ PSX (X),21358615,23158538,18342582,62859735,757429492.345298,1342451526.481299,763141407.542300,2863022426.368897,183430,90466,139211,413107
2017-03-16,BYX Equities (Y),155682253,83599955,77737026,317019234,4876734386.117950,3596092850.711195,2618518626.735697,11091345863.564842,1375977,367604,689219,2432800
2017-03-16,BZX Equities (Z),197686008,102693671,95414583,395794262,7093005256.369329,5501256735.161611,3967954006.663915,16562215998.194855,1536416,417863,738958,2693237
2017-03-15,NYSE American (A),0,15619652,0,15619652,0.000000,73605417.029900,0.000000,73605417.029900,0,29540,0,29540
2017-03-15,NASDAQ BX (B),120513317,47795820,62527755,230836892,4576498681.564288,2031858167.033194,2356408839.975199,8964765688.572681,1181731,212743,592246,1986720
2017-03-15,NYSE (DN),111254448,58511700,66806473,236572621,3362797218.574627,1918791266.470597,2360526926.947205,7642115411.992429,252577,103819,142681,499077
2017-03-15,NASDAQ (DQ),1247616693,674449995,746352830,2668419518,40441085468.561568,28779156738.926638,25574548797.774857,94794791005.263063,3746083,1262575,2084385,7093043
2017-03-15,EDGA Equities (J),86942877,56977139,37323031,181243047,2584510700.632896,2577615616.812799,1333995479.423601,6496121796.869296,710311,247565,302726,1260602
2017-03-15,EDGX Equities (K),206066839,154732980,155918247,516718066,7116753225.592935,6372245912.611301,5488919370.312831,18977918508.517067,1360620,527143,904625,2792388
2017-03-15,CHX (M),6468774,12607567,5262453,24338794,314029994.875600,1291027244.742799,517153644.501900,2122210884.120299,4591,7644,2366,14601
2017-03-15,NYSE (N),913512153,0,0,913512153,33239497750.020055,0.000000,0.000000,33239497750.020055,2928276,0,0,2928276
2017-03-15,NYSE Arca (P),248204731,463879880,130956918,843041529,10005085427.603727,22113939194.021944,5943439529.671706,38062464151.297377,1779075,1080298,936431,3795804
2017-03-15,NASDAQ (Q),440496814,210292053,494862021,1145650888,18029743411.024792,10216534949.096586,23092994086.090666,51339272446.212044,3727068,738190,3013156,7478414
2017-03-15,IEX (V),88169007,30000380,40216393,158385780,3410248640.753689,1512969521.486599,1698645523.705098,6621863685.945386,544839,118020,248152,911011
2017-03-15,NASDAQ PSX (X),26284958,31607613,20568699,78461270,877292224.136901,1724846803.919999,829945058.446699,3432084086.503599,206360,121227,150925,478512
2017-03-15,BYX Equities (Y),183251198,106103574,83872430,373227202,5425996882.611947,4333081877.293300,2819819409.324788,12578898169.230035,1569971,449441,763550,2782962
2017-03-15,BZX Equities (Z),230718105,146560531,110736822,488015458,8117163560.596302,7316676418.871724,4636042943.894813,20069882923.362839,1812194,576949,862258,3251401
2017-03-14,NYSE American (A),0,14203456,0,14203456,0.000000,56090264.598500,0.000000,56090264.598500,0,28156,0,28156
2017-03-14,NASDAQ BX (B),99116938,31121459,52648148,182886545,3611090091.637199,1293050141.646600,1851929684.185098,6756069917.468897,969928,147158,487812,1604898
2017-03-14,NYSE (DN),81345387,35378937,50232351,166956675,2344093433.489800,1125559650.965800,1742112797.963598,5211765882.419198,213207,72114,122279,407600
2017-03-14,NASDAQ (DQ),984987790,541959400,632105747,2159052937,31126906799.867943,21631200360.517554,19783768387.533252,72541875547.918749,3367562,951721,1929106,6248389
2017-03-14,EDGA Equities (J),73358560,39557891,34806591,147723042,2156425595.992706,1657843756.438199,1140530929.364100,4954800281.795005,622511,177556,278140,1078207
2017-03-14,EDGX Equities (K),166564942,104580197,143071934,414217073,5543256961.593023,4161250841.040699,4449865024.794721,14154372827.428443,1114950,366612,788929,2270491
2017-03-14,CHX (M),7414920,10864184,4163048,22442152,367654178.686500,1074493052.790000,269269598.507100,1711416829.983600,4940,5243,1927,12110
2017-03-14,NYSE (N),748839537,0,0,748839537,26725211666.270995,0.000000,0.000000,26725211666.270995,2378103,0,0,2378103
2017-03-14,NYSE Arca (P),207200343,312594256,116866319,636660918,7907137044.491350,14591972001.096858,4686779042.973698,27185888088.561906,1491775,767487,825193,3084455
2017-03-14,NASDAQ (Q),362768341,134142197,410285415,907195953,14223805609.511145,6307295814.094219,17603762915.841460,38134864339.446824,3102014,504233,2590943,6197190
2017-03-14,IEX (V),82923711,19414798,36236784,138575293,2978317326.403998,889549396.437699,1439086848.743497,5306953571.585194,504398,80271,229913,814582
2017-03-14,NASDAQ PSX (X),20754989,21308029,18061575,60124593,673406448.730401,1126609260.390600,679180394.608599,2479196103.729600,168889,87080,132622,388591
2017-03-14,BYX Equities (Y),149003395,67659382,75399669,292062446,4419827466.021596,2665914760.705103,2368373895.400996,9454116122.127695,1302569,301341,652636,2256546
2017-03-14,BZX Equities (Z),189487310,91247556,91000639,371735505,6295811033.164005,4528328617.351999,3493821731.385611,14317961381.901615,1476900,396831,709918,2583649
2017-03-13,NYSE American (A),0,14521673,0,14521673,0.000000,62709690.234500,0.000000,62709690.234500,0,25111,0,25111
2017-03-13,NASDAQ BX (B),100871175,29996588,56726605,187594368,3789360202.129983,1226973869.900304,2022035237.691299,7038369309.721586,1012719,149207,560102,1722028
2017-03-13,NYSE (DN),91717879,42418011,72394702,206530592,2992290016.983703,1248940895.904200,2333977727.245600,6575208640.133503,224105,79965,143759,447829
2017-03-13,NASDAQ (DQ),1038399516,474902393,714181703,2227483612,37609298846.773077,19286528093.884403,22064173943.307202,78960000883.964682,3375929,930585,2042338,6348852
2017-03-13,EDGA Equities (J),72835053,35432786,35579261,143847100,2342260779.875198,1483278335.868801,1186537356.322899,5012076472.066898,625019,170430,291404,1086853
2017-03-13,EDGX Equities (K),156277370,86073036,147409017,389759423,5549789431.787491,3466725098.884205,4557902959.337813,13574417490.009509,1048923,308514,806097,2163534
2017-03-13,CHX (M),5210204,7013233,4297963,16521400,276457133.939600,699360667.835600,299844122.702400,1275661924.477600,5445,3910,2257,11612
2017-03-13,NYSE (N),738339624,0,0,738339624,28852091054.843102,0.000000,0.000000,28852091054.843102,2263611,0,0,2263611
2017-03-13,NYSE Arca (P),201323100,268841060,125536723,595700883,8261462091.072733,13102088608.850282,4733463637.498312,26097014337.421327,1433753,650027,841335,2925115
2017-03-13,NASDAQ (Q),335722282,112093032,422361399,870176713,14354430839.734467,5215535688.922208,18128508745.260113,37698475273.916788,3089541,420106,2600565,6110212
2017-03-13,IEX (V),76679749,20855902,37000940,134536591,3029550044.120300,942028116.743800,1405039906.312900,5376618067.177000,476394,78294,237242,791930
2017-03-13,NASDAQ PSX (X),19270121,19332532,18802713,57405366,663990821.993299,1019919676.316500,690462238.237201,2374372736.547000,163730,80371,136734,380835
2017-03-13,BYX Equities (Y),153088414,65172095,81736603,299997112,4793600023.715124,2536319542.580297,2505892439.091601,9835812005.387022,1391368,283431,721652,2396451
2017-03-13,BZX Equities (Z),176922403,79575546,96433823,352931772,6431542720.849192,4019304614.016792,3622576465.514314,14073423800.380298,1438613,330500,747051,2516164
2017-03-10,NYSE American (A),0,14188142,0,14188142,0.000000,73274696.924600,0.000000,73274696.924600,0,28000,0,28000
2017-03-10,NASDAQ BX (B),100385279,33613620,57933514,191932413,3691905332.128714,1501508442.544000,2104764029.636402,7298177804.309116,976576,157545,561765,1695886
2017-03-10,NYSE (DN),100895837,48543925,71463066,220902828,3028343307.150101,1673211506.141802,2410728674.000101,7112283487.292004,228951,85875,153173,467999
2017-03-10,NASDAQ (DQ),1076246471,533824011,747471005,2357541487,37466885628.777925,23917036802.401432,24431491130.366761,85815413561.546118,3522493,955369,2163476,6641338
2017-03-10,EDGA Equities (J),79929299,40936183,42043805,162909287,2538731797.833299,1946815614.718603,1434758023.570898,5920305436.122800,665696,191635,326714,1184045
2017-03-10,EDGX Equities (K),182013073,105880276,162446415,450339764,6493939607.005974,4754059505.208809,5177485368.579500,16425484480.794283,1223656,377221,903391,2504268
2017-03-10,CHX (M),11233208,11060275,6151692,28445175,449273509.282000,1031488638.223000,543638701.045500,2024400848.550500,5656,6782,2393,14831
2017-03-10,NYSE (N),838679382,0,0,838679382,31788441122.572188,0.000000,0.000000,31788441122.572188,2523982,0,0,2523982
2017-03-10,NYSE Arca (P),219032514,328483642,141691143,689207299,8968150777.627420,16526658270.854662,5696786776.216294,31191595824.698376,1613941,766014,960847,3340802
2017-03-10,NASDAQ (Q),348739332,128808707,504218827,981766866,14901833313.552347,7068390633.158173,22670740948.198754,44640964894.909274,3281310,477619,2835753,6594682
2017-03-10,IEX (V),82694397,22506849,43933773,149135019,3217244252.546503,1115857178.799199,1911414710.894300,6244516142.240002,495704,76238,257725,829667
2017-03-10,NASDAQ PSX (X),21117223,23178503,20094856,64390582,714823378.562503,1374966970.129400,774869751.441600,2864660100.133503,172324,89705,144981,407010
2017-03-10,BYX Equities (Y),160515768,72357873,85966631,318840272,4843795737.583853,2975195405.294591,2683725390.648001,10502716533.526445,1392518,310253,744575,2447346
2017-03-10,BZX Equities (Z),212925942,96157454,116032225,425115621,7524962670.578691,5296426465.564204,4536104001.757599,17357493137.900494,1709421,406469,883312,2999202
2017-03-09,NYSE American (A),0,12520160,0,12520160,0.000000,69080727.333700,0.000000,69080727.333700,0,26676,0,26676
2017-03-09,NASDAQ BX (B),101606348,33211913,53647729,188465990,3554088123.757313,1446614254.488605,1934017952.258901,6934720330.504819,980802,155358,500700,1636860
2017-03-09,NYSE (DN),112079248,51121750,69373094,232574092,3128911707.649706,1748288072.928002,2207550834.555197,7084750615.132905,263733,87657,155958,507348
2017-03-09,NASDAQ (DQ),1184925079,553622590,729532210,2468079879,37283637198.436104,26278810818.882081,22424218960.476567,85986666977.794752,3903630,1066793,2075197,7045620
2017-03-09,EDGA Equities (J),87683687,41432135,39483348,168599170,2589894080.473721,1934319606.075500,1399249776.020997,5923463462.570218,726223,194449,311823,1232495
2017-03-09,EDGX Equities (K),204115542,104895222,159720235,468730999,6984574504.422906,4792061942.759489,5296937355.631003,17073573802.813398,1375521,385180,907153,2667854
2017-03-09,CHX (M),11549128,14492023,4167510,30208661,610021632.005500,1368348096.133700,354322344.619000,2332692072.758200,5632,5612,2243,13487
2017-03-09,NYSE (N),882629018,0,0,882629018,31518002066.891887,0.000000,0.000000,31518002066.891887,2753567,0,0,2753567
2017-03-09,NYSE Arca (P),241637407,308454355,133086100,683177862,9190709206.743607,17355321677.504728,5524401957.672200,32070432841.920535,1729072,786812,917353,3433237
2017-03-09,NASDAQ (Q),386734019,130351208,444015370,961100597,15614341768.270162,7306786100.332772,19547976838.653263,42469104707.256197,3553366,497535,2835588,6886489
2017-03-09,IEX (V),86712098,20141331,41474260,148327689,3140137303.578991,986358642.402301,1689114847.129998,5815610793.111290,512171,78538,233508,824217
2017-03-09,NASDAQ PSX (X),22186563,23491375,19787796,65465734,727177114.456101,1358341836.341701,838826299.460900,2924345250.258702,180432,93787,145055,419274
2017-03-09,BYX Equities (Y),169999310,71849575,83406094,325254979,4883560045.803772,2934459430.399896,2584302978.993496,10402322455.197164,1519424,313726,729283,2562433
2017-03-09,BZX Equities (Z),226593786,96645930,109094837,432334553,7709995730.221903,5321874435.851688,4377246963.306297,17409117129.379888,1832779,410743,835428,3078950
2017-03-08,NYSE American (A),0,12300266,0,12300266,0.000000,72646583.338200,0.000000,72646583.338200,0,24576,0,24576
2017-03-08,NASDAQ BX (B),104413643,34313955,55899359,194626957,3669312427.760018,1482238653.140900,1993626678.945901,7145177759.846819,1020239,154227,559430,1733896
2017-03-08,NYSE (DN),111897915,52084045,66913316,230895276,3265241421.743801,1773467005.163495,2229796189.636904,7268504616.544200,260684,94578,144969,500231
2017-03-08,NASDAQ (DQ),1254168768,580264385,682050579,2516483732,38882736188.359915,25404738722.142891,21231075144.246303,85518550054.749109,3944903,1043885,2070084,7058872
2017-03-08,EDGA Equities (J),88735508,44213619,38372738,171321865,2735125199.083594,1977424594.904401,1384142274.292900,6096692068.280895,734244,196203,316976,1247423
2017-03-08,EDGX Equities (K),205463266,102803671,150862052,459128989,6882918533.924168,4652744349.132094,5223012126.190993,16758675009.247255,1330345,371024,893686,2595055
2017-03-08,CHX (M),12817551,14746370,3215377,30779298,589580681.585801,1147189052.250000,353151075.914600,2089920809.750401,5583,5109,2197,12889
2017-03-08,NYSE (N),889645399,0,0,889645399,32674516813.831422,0.000000,0.000000,32674516813.831422,2677636,0,0,2677636
2017-03-08,NYSE Arca (P),243860410,302794808,126965441,673620659,9307182920.539594,15674406757.992924,5360049876.920492,30341639555.453010,1706477,750514,912033,3369024
2017-03-08,NASDAQ (Q),391636481,130680297,442839648,965156426,16203740815.238415,7196224391.929420,19400539728.856844,42800504936.024679,3555034,484146,2848272,6887452
2017-03-08,IEX (V),85890403,21104652,39392335,146387390,3130071787.058302,1021825741.601900,1643833064.277999,5795730592.938201,508190,78922,237787,824899
2017-03-08,NASDAQ PSX (X),24050784,22240797,19936433,66228014,783904768.676000,1233683837.285000,802235751.114100,2819824357.075100,190852,90720,146856,428428
2017-03-08,BYX Equities (Y),167956904,71118752,80224666,319300322,4884984970.888197,2785909436.579101,2590096212.692901,10260990620.160199,1471669,291776,732932,2496377
2017-03-08,BZX Equities (Z),233544651,98315198,106412279,438272128,7933342230.264780,5126189330.612508,4305969530.369987,17365501091.247275,1845084,398214,859869,3103167
2017-03-07,NYSE American (A),0,11793186,0,11793186,0.000000,50957550.244800,0.000000,50957550.244800,0,22751,0,22751
2017-03-07,NASDAQ BX (B),96093522,26127336,54243502,176464360,3339196627.529190,1142637977.856301,1875517203.600798,6357351808.986289,962816,134652,536968,1634436
2017-03-07,NYSE (DN),106078625,37996021,64683640,208758286,3055651127.012602,1501216210.629001,2109549029.821908,6666416367.463511,249469,77233,149667,476369
2017-03-07,NASDAQ (DQ),1189315902,491925302,717977327,2399218531,37675280742.682725,22114086838.308260,22091674096.036191,81881041677.027176,3604191,893840,1998231,6496262
2017-03-07,EDGA Equities (J),79390949,33088156,37089635,149568740,2432391837.334611,1528814954.859101,1294385500.751101,5255592292.944813,660413,159500,303583,1123496
2017-03-07,EDGX Equities (K),187877326,85445955,147483755,420807036,6448691519.492893,3785264561.191604,4994332968.324303,15228289049.008800,1219923,323217,876751,2419891
2017-03-07,CHX (M),21332090,12116741,5658546,39107377,1272567764.937600,936050521.084800,410897760.928900,2619516046.951300,4913,4203,2151,11267
2017-03-07,NYSE (N),793401834,0,0,793401834,29588755002.961366,0.000000,0.000000,29588755002.961366,2433824,0,0,2433824
2017-03-07,NYSE Arca (P),230288393,241938068,123735960,595962421,8444613641.697393,13656670623.206233,5175081224.213110,27276365489.116736,1558127,626788,883145,3068060
2017-03-07,NASDAQ (Q),355941435,101147466,436142014,893230915,14953463634.084823,5414349622.895907,19076176225.388377,39443989482.369107,3256664,410151,2748851,6415666
2017-03-07,IEX (V),78624093,16581675,37262349,132468117,2875642771.796400,823038228.163400,1488374862.345102,5187055862.304902,472810,66364,222738,761912
2017-03-07,NASDAQ PSX (X),22230975,17264723,19408536,58904234,674651430.969998,957616878.894500,768602343.816600,2400870653.681098,169872,73079,143828,386779
2017-03-07,BYX Equities (Y),155875396,57940592,78562147,292378135,4609192389.932887,2290173845.877294,2481694939.434910,9381061175.245091,1371976,272842,717641,2362459
2017-03-07,BZX Equities (Z),209853599,77038440,103270486,390162525,7221285368.278384,4101174217.316800,4062945598.070601,15385405183.665785,1663128,349428,827553,2840109
2017-03-06,NYSE American (A),0,11410020,0,11410020,0.000000,51543545.230000,0.000000,51543545.230000,0,21023,0,21023
2017-03-06,NASDAQ BX (B),91012716,26355193,56422415,173790324,3336754137.334198,1066244920.500402,1931698121.067895,6334697178.902495,897980,130956,531275,1560211
2017-03-06,NYSE (DN),101930259,42076920,70167907,214175086,3022613120.993210,1382342292.029802,2336836612.432600,6741792025.455612,244743,80911,151586,477240
2017-03-06,NASDAQ (DQ),1035563579,474751892,657455684,2167771155,34396691107.723792,19017147207.859633,21241518333.701027,74655356649.284452,3483257,999040,2010446,6492743
2017-03-06,EDGA Equities (J),76138285,30861038,38894429,145893752,2424246288.269709,1328535553.723002,1321093640.487199,5073875482.479910,657420,155715,319700,1132835
2017-03-06,EDGX Equities (K),183124463,83712013,148891086,415727562,6475203398.017067,3453063386.778098,4880492100.288901,14808758885.084066,1267783,301248,871879,2440910
2017-03-06,CHX (M),8739174,12909919,5197194,26846287,498237804.355400,1189615667.544000,505103849.945500,2192957321.844900,5487,4415,2224,12126
2017-03-06,NYSE (N),795804752,0,0,795804752,30524983505.803293,0.000000,0.000000,30524983505.803293,2392572,0,0,2392572
2017-03-06,NYSE Arca (P),204227105,267776347,127238206,599241658,8034714274.814183,12940424771.325361,5076639781.630983,26051778827.770527,1470724,635816,885226,2991766
2017-03-06,NASDAQ (Q),319771829,103996571,429139483,852907883,13385193258.022797,5221849486.166601,18864395282.373284,37471438026.562682,2878438,406070,2601658,5886166
2017-03-06,IEX (V),71788226,14814994,36875639,123478859,2897511806.948998,739390076.947400,1480778446.635997,5117680330.532395,433486,63227,224101,720814
2017-03-06,NASDAQ PSX (X),20220205,17772817,19296992,57290014,682433361.274001,909166151.611299,739160353.199401,2330759866.084701,172988,74652,145831,393471
2017-03-06,BYX Equities (Y),148200431,56488328,82017662,286706421,4500067937.104941,2095836177.263997,2457719723.521794,9053623837.890732,1341147,261597,721134,2323878
2017-03-06,BZX Equities (Z),195281227,76359534,102448360,374089121,6695989906.014558,3813240336.742988,3847998003.668811,14357228246.426357,1538874,350307,794796,2683977
2017-03-03,NYSE American (A),0,12190894,0,12190894,0.000000,59084647.074300,0.000000,59084647.074300,0,22283,0,22283
2017-03-03,NASDAQ BX (B),93517243,33206431,52336365,179060039,3399758484.696899,1382038785.514403,1883061004.170996,6664858274.382298,916343,156877,513762,1586982
2017-03-03,NYSE (DN),103358172,44056254,67219501,214633927,3057752985.674793,1533113741.938497,2175738014.517403,6766604742.130693,247711,83054,152286,483051
2017-03-03,NASDAQ (DQ),1186589134,517222485,708731594,2412543213,36347836629.779233,24382788690.226529,21417104352.225656,82147729672.231418,3784303,1005812,2071393,6861508
2017-03-03,EDGA Equities (J),79836271,39978762,38203565,158018598,2472982290.182505,1812255699.262700,1282490329.821999,5567728319.267204,669118,196723,309760,1175601
2017-03-03,EDGX Equities (K),198585060,101067318,157339520,456991898,6895856152.677928,4342177947.619109,4993326768.379698,16231360868.676735,1288827,382320,862662,2533809
2017-03-03,CHX (M),7796852,9580462,4923822,22301136,341480181.430000,811893359.485000,355657731.600000,1509031272.515000,4455,4558,1855,10868
2017-03-03,NYSE (N),825260828,0,0,825260828,30286307909.998363,0.000000,0.000000,30286307909.998363,2590324,0,0,2590324
2017-03-03,NYSE Arca (P),226158045,322962229,133214575,682334849,8816046965.038270,16460397363.095822,5218242589.013403,30494686917.147495,1623392,810219,894376,3327987
2017-03-03,NASDAQ (Q),360240115,120632788,442332257,923205160,14782535771.520220,6427135557.274795,18886204497.796678,40095875826.591693,3178908,474355,2664726,6317989
2017-03-03,IEX (V),78831191,17940934,39098127,135870252,3036721308.761506,848681913.904401,1553333870.976001,5438737093.641908,470373,73525,234215,778113
2017-03-03,NASDAQ PSX (X),21334041,19548549,20555465,61438055,707929456.588498,1059264094.914101,733621969.031000,2500815520.533599,173672,84403,143897,401972
2017-03-03,BYX Equities (Y),156179163,72547119,80900718,309627000,4661024185.502636,2739854416.626906,2526784094.873708,9927662697.003250,1375547,324981,719980,2420508
2017-03-03,BZX Equities (Z),218992140,97713016,108750395,425455551,7469303110.983434,4857165380.163393,4180715679.007995,16507184170.154822,1673476,429221,816664,2919361
2017-03-02,NYSE American (A),0,13023725,0,13023725,0.000000,74852160.133700,0.000000,74852160.133700,0,23527,0,23527
2017-03-02,NASDAQ BX (B),107730813,35940728,58859270,202530811,3984250508.824476,1442298221.080701,2205197203.791000,7631745933.696177,1066251,162792,576469,1805512
2017-03-02,NYSE (DN),112047869,53969550,76666919,242684338,3486111232.639125,1766171873.641596,2549386448.176802,7801669554.457523,291854,99656,180880,572390
2017-03-02,NASDAQ (DQ),1208715213,571063937,784575665,2564354815,40751626796.584553,21956319050.964317,25641219170.013163,88349165017.562033,4235544,1121845,2352564,7709953
2017-03-02,EDGA Equities (J),90965876,42859594,41906485,175731955,2886244308.343583,1910532338.320702,1475556529.099001,6272333175.763286,789434,209594,355190,1354218
2017-03-02,EDGX Equities (K),213952472,105104577,175076371,494133420,7414616896.618628,4668950037.171713,5862196277.803273,17945763211.593614,1403335,380460,1015529,2799324
2017-03-02,CHX (M),17313456,12293751,4569236,34176443,963360250.749700,1024955266.218400,323158937.216700,2311474454.184800,5242,4986,2066,12294
2017-03-02,NYSE (N),911087963,0,0,911087963,33407610485.356553,0.000000,0.000000,33407610485.356553,2870916,0,0,2870916
2017-03-02,NYSE Arca (P),253564230,345815850,152184748,751564828,10169340136.522496,16568161088.151903,6279187025.418594,33016688250.092993,1818733,811156,1067579,3697468
2017-03-02,NASDAQ (Q),389858073,129034432,475683578,994576083,16284917249.225416,6740060899.136009,20858807892.056554,43883786040.417979,3481704,505649,3078517,7065870
2017-03-02,IEX (V),93136507,20582697,45572118,159291322,3542189624.251901,955665179.982500,1912816348.383999,6410671152.618400,563533,84578,278825,926936
2017-03-02,NASDAQ PSX (X),23997675,20654208,22823832,67475715,807684756.283403,1122713843.815200,873426422.523601,2803825022.622204,200441,88711,167483,456635
2017-03-02,BYX Equities (Y),173597877,74414120,88542906,336554903,5259739308.147018,2834355356.015198,2902447309.859809,10996541974.022025,1587645,322161,820025,2729831
2017-03-02,BZX Equities (Z),228064816,99383838,117158657,444607311,8159701024.915576,5065862844.401404,4698677739.304207,17924241608.621187,1840457,420914,939567,3200938
2017-03-01,NYSE American (A),0,13315723,0,13315723,0.000000,77776720.834500,0.000000,77776720.834500,0,25370,0,25370
2017-03-01,NASDAQ BX (B),119598788,39582968,65220173,224401929,4676147835.241122,2013425094.707004,2482274326.695600,9171847256.643726,1200968,179055,647701,2027724
2017-03-01,NYSE (DN),132226959,55413717,80068219,267708895,4508007274.329272,2118796521.889293,3182596099.011498,9809399895.230063,316604,112973,199610,629187
2017-03-01,NASDAQ (DQ),1374181433,657144271,836999829,2868325533,50443200223.289233,38546385639.657935,29271837883.142968,118261423746.090136,4500153,1191822,2557474,8249449
2017-03-01,EDGA Equities (J),104781309,52594741,47194571,204570621,3658299736.294117,2912440096.130401,1897716392.232397,8468456224.656915,923256,246752,415391,1585399
2017-03-01,EDGX Equities (K),243572903,116953334,179297311,539823548,9351348557.796315,6250377363.034784,6890866757.521630,22492592678.352729,1752049,452540,1189921,3394510
2017-03-01,CHX (M),12538331,9864924,4603953,27007208,683430841.785900,1092864651.824000,367561002.488000,2143856496.097900,6348,6482,2301,15131
2017-03-01,NYSE (N),1039165374,0,0,1039165374,41748294666.982910,0.000000,0.000000,41748294666.982910,3306071,0,0,3306071
2017-03-01,NYSE Arca (P),291482296,372121433,159882890,823486619,12566145322.557499,22023230664.097262,7394607442.361329,41983983429.016090,2133116,929655,1180479,4243250
2017-03-01,NASDAQ (Q),444457591,146162267,549523325,1140143183,19886100716.425668,9077296068.084072,24780481830.294127,53743878614.803867,4072360,572163,3423881,8068404
2017-03-01,IEX (V),96064575,23999450,46518619,166582644,3998417405.874103,1338669537.278799,2017234122.710200,7354321065.863102,574984,94456,287420,956860
2017-03-01,NASDAQ PSX (X),28128115,26714663,24699936,79542714,1023824803.322601,1623887280.965900,986759857.682300,3634471941.970801,239424,106239,190696,536359
2017-03-01,BYX Equities (Y),194408554,87819340,97553547,379781441,6324069871.396599,3859106118.964593,3256233810.593698,13439409800.954890,1820732,379716,922333,3122781
2017-03-01,BZX Equities (Z),267028538,116342106,128797279,512167923,10276722606.905447,6932780246.128208,5400543562.332400,22610046415.366055,2246540,499602,1060659,3806801
2017-02-28,NYSE American (A),0,15236199,0,15236199,0.000000,89816056.749200,0.000000,89816056.749200,0,24809,0,24809
2017-02-28,NASDAQ BX (B),111839497,33101616,63745425,208686538,4168034195.626186,1609040147.619004,2405144334.829001,8182218678.074191,1103855,164562,619767,1888184
2017-02-28,NYSE (DN),113631316,47743361,77152779,238527456,3534557124.878620,1677949858.415901,2793082515.003604,8005589498.298125,268829,93703,169375,531907
2017-02-28,NASDAQ (DQ),1303559992,552478150,871909702,2727947844,45335767714.099436,28449294754.123205,28907776650.570489,102692839118.793130,4132422,1035873,2355272,7523567
2017-02-28,EDGA Equities (J),88863312,43286777,43655731,175805820,2982770744.697900,2182644425.194199,1547087776.751298,6712502946.643397,758054,210454,352160,1320668
2017-02-28,EDGX Equities (K),209216013,98228915,166297459,473742387,7655419009.745810,4791869316.887083,5671391065.971787,18118679392.604680,1456458,376190,1006692,2839340
2017-02-28,CHX (M),8335894,16325375,5048602,29709871,354173935.394400,1420252698.836800,482990064.635100,2257416698.866300,5341,4723,2245,12309
2017-02-28,NYSE (N),1192191729,0,0,1192191729,46820509257.108855,0.000000,0.000000,46820509257.108855,2926911,0,0,2926911
2017-02-28,NYSE Arca (P),250295594,321751077,146969244,719015915,10438646700.692406,17247572601.566648,6069648243.129082,33755867545.388136,1862858,785538,1029701,3678097
2017-02-28,NASDAQ (Q),401767386,117006030,640814359,1159587775,17315883006.357666,6869055189.090308,27594398870.510456,51779337065.958430,3660457,469779,3146091,7276327
2017-02-28,IEX (V),91562842,19538851,49172161,160273854,3620687689.667200,974803225.236500,1959773930.486801,6555264845.390501,523071,83585,273360,880016
2017-02-28,NASDAQ PSX (X),24799036,19391067,24165123,68355226,857476745.755100,1182580403.775799,876953373.194101,2917010522.725000,211845,82818,170624,465287
2017-02-28,BYX Equities (Y),181952790,71979706,95290917,349223413,5645065068.189984,3091333841.580702,2964144089.501401,11700542999.272087,1659112,341050,848158,2848320
2017-02-28,BZX Equities (Z),234448810,94250713,119174856,447874379,8472112627.414773,5213813904.356191,4612017923.972709,18297944455.743673,1917057,415647,924766,3257470
2017-02-27,NYSE American (A),0,15312097,0,15312097,0.000000,84248411.533300,0.000000,84248411.533300,0,27072,0,27072
2017-02-27,NASDAQ BX (B),101828866,33050293,55065496,189944655,3685606232.637518,1427171199.943594,2075015856.338900,7187793288.920012,998616,158200,535320,1692136
2017-02-27,NYSE (DN),107339274,44422546,69891472,221653292,3209642989.960899,1462333810.775802,2589280093.309698,7261256894.046399,249921,89020,155320,494261
2017-02-27,NASDAQ (DQ),1143976633,520939153,715707975,2380623761,39404802006.701326,22415311040.622154,25011027064.381960,86831140111.705440,3742137,982739,2120890,6845766
2017-02-27,EDGA Equities (J),79570675,37192187,38921327,155684189,2542615311.824099,1742292650.999301,1350460710.379400,5635368673.202800,683124,190338,319114,1192576
2017-02-27,EDGX Equities (K),185593759,94953325,150565466,431112550,6514793594.450685,4208804088.450181,5343392333.257193,16066990016.158059,1304346,359491,912445,2576282
2017-02-27,CHX (M),6398461,13860083,3892486,24151030,305546515.653500,939579407.958800,245579465.913100,1490705389.525400,4594,3784,1956,10334
2017-02-27,NYSE (N),904973512,0,0,904973512,34501128639.015388,0.000000,0.000000,34501128639.015388,2625298,0,0,2625298
2017-02-27,NYSE Arca (P),217154284,316247021,134734388,668135693,8674460583.320514,15129116711.506114,5668341717.610100,29471919012.436728,1618613,759686,934476,3312775
2017-02-27,NASDAQ (Q),355119915,121439402,468813929,945373246,15039176925.734578,6168634725.176303,22309312107.098017,43517123758.008898,3238504,469670,2795847,6504021
2017-02-27,IEX (V),78610589,18748683,36495239,133854511,2982947955.796798,962101035.784600,1585828958.109897,5530877949.691295,481954,78408,229169,789531
2017-02-27,NASDAQ PSX (X),23450927,21891437,22029997,67372361,775910755.199401,1168190126.068599,776937947.115700,2721038828.383700,196706,92873,155597,445176
2017-02-27,BYX Equities (Y),163845740,65749083,82562370,312157193,4995248157.474088,2652864479.126399,2648428654.018215,10296541290.618702,1504896,305589,753456,2563941
2017-02-27,BZX Equities (Z),216826404,92400968,103936609,413163981,7533852300.549428,4669676396.336810,4123746996.610114,16327275693.496352,1735010,413944,814597,2963551
2017-02-24,NYSE American (A),0,15456910,0,15456910,0.000000,71063947.130200,0.000000,71063947.130200,0,22652,0,22652
2017-02-24,NASDAQ BX (B),109656617,29583483,52579241,191819341,4034422729.374709,1387785477.871900,2022347941.368399,7444556148.615008,1072063,143444,514500,1730007
2017-02-24,NYSE (DN),117552656,44152651,58754644,220459951,3553072911.927113,1535752855.735094,2489748147.254404,7578573914.916611,280894,84064,140340,505298
2017-02-24,NASDAQ (DQ),1206861590,464804540,601594852,2273260982,39624949539.602627,21128481282.611835,22004179691.543967,82757610513.758429,4006393,928747,1942783,6877923
2017-02-24,EDGA Equities (J),86150871,36348390,34787431,157286692,2782274352.190288,1921923887.267600,1425938474.988304,6130136714.446192,728086,180330,298937,1207353
2017-02-24,EDGX Equities (K),207620062,92902345,135255743,435778150,7280319161.417646,4501710870.691393,5532277145.744081,17314307177.853120,1416670,355997,883756,2656423
2017-02-24,CHX (M),11223458,8483961,3111820,22819239,591577144.308200,731284803.260000,255243799.395000,1578105746.963200,4563,3519,1698,9780
2017-02-24,NYSE (N),934629366,0,0,934629366,35390090679.340400,0.000000,0.000000,35390090679.340400,2870955,0,0,2870955
2017-02-24,NYSE Arca (P),248020805,285830912,125795677,659647394,9715608656.610196,16112390435.137099,6310792690.709593,32138791782.456888,1785815,736785,937489,3460089
2017-02-24,NASDAQ (Q),397070529,115446509,441508748,954025786,16589700759.007976,6741264546.229601,22133982842.667048,45464948147.904625,3502169,459047,2838434,6799650
2017-02-24,IEX (V),83042824,18004692,34304656,135352172,3105551845.476003,1002757726.659699,1628933267.761199,5737242839.896901,494094,72713,215433,782240
2017-02-24,NASDAQ PSX (X),25717541,20064781,19910069,65692391,869636565.117103,1203199564.083498,838972942.305600,2911809071.506201,207008,89830,149239,446077
2017-02-24,BYX Equities (Y),169495478,67037873,75772186,312305537,5129730040.708529,2785720590.013201,2638625985.297199,10554076616.018929,1509036,294351,710793,2514180
2017-02-24,BZX Equities (Z),235370787,90079523,101282869,426733179,8378235436.007395,5111713212.713492,4763809520.997489,18253758169.718376,1881981,399551,842918,3124450
2017-02-23,NYSE American (A),0,18960313,0,18960313,0.000000,80986829.227300,0.000000,80986829.227300,0,26576,0,26576
2017-02-23,NASDAQ BX (B),106489569,31684803,54621367,192795739,3879738949.571813,1461747320.061996,2049034417.496402,7390520687.130211,1052611,152882,527716,1733209
2017-02-23,NYSE (DN),125455445,48399473,72274413,246129331,3735482837.787906,1644017158.147195,3067698182.381106,8447198178.316207,296969,86895,166937,550801
2017-02-23,NASDAQ (DQ),1333474766,483961460,708075195,2525511421,44169949437.902652,19467836288.659304,25837651210.124808,89475436936.686764,4238358,949962,2247096,7435416
2017-02-23,EDGA Equities (J),86893706,37762525,38920661,163576892,2806105787.644301,1848526414.252000,1506651971.437198,6161284173.333499,743587,181658,329185,1254430
2017-02-23,EDGX Equities (K),215234936,102516870,155936190,473687996,7355153572.464925,4804838850.691109,5984657533.032521,18144649956.188555,1426315,365559,949770,2741644
2017-02-23,CHX (M),9962533,14019216,4002162,27983911,445543107.066900,1190666540.816200,275850391.947800,1912060039.830900,4695,4624,1944,11263
2017-02-23,NYSE (N),927004459,0,0,927004459,33990711680.331262,0.000000,0.000000,33990711680.331262,3024685,0,0,3024685
2017-02-23,NYSE Arca (P),255551829,282997837,135470115,674019781,9801930867.951620,14962653933.525267,6497636633.453091,31262221434.929978,1815202,727853,987782,3530837
2017-02-23,NASDAQ (Q),419234495,119092334,465620649,1003947478,17082936280.139624,6427891118.261120,22469575241.318730,45980402639.719474,3660968,446985,3039863,7147816
2017-02-23,IEX (V),99313082,16690644,40036478,156040204,3855642785.535399,871439079.426600,1896117962.263603,6623199827.225602,569321,68876,252269,890466
2017-02-23,NASDAQ PSX (X),25866403,20913255,21383270,68162928,838980974.978698,1200387755.183601,854782074.036200,2894150804.198499,206786,88606,155105,450497
2017-02-23,BYX Equities (Y),173919086,68610298,80173171,322702555,5195303813.862638,2786355296.759597,2765120006.914986,10746779117.537221,1549818,307060,742122,2599000
2017-02-23,BZX Equities (Z),243376071,93635865,104986049,441997985,8328463943.794600,4950654930.298196,4556102085.983497,17835220960.076293,1937868,403765,854268,3195901
2017-02-22,NYSE American (A),0,14064891,0,14064891,0.000000,72253245.915000,0.000000,72253245.915000,0,23580,0,23580
2017-02-22,NASDAQ BX (B),90981403,25314940,51456064,167752407,3351288410.867093,1066520921.784700,1863753565.666399,6281562898.318192,920421,123832,493199,1537452
2017-02-22,NYSE (DN),108580400,42159870,74799594,225539864,3456245212.345425,1415056231.591899,2924437876.689508,7795739320.626832,262363,82578,162788,507729
2017-02-22,NASDAQ (DQ),1142480297,455087641,739777245,2337345183,38668998133.360060,18945584318.279069,24308081172.167719,81922663623.806848,3855783,920248,2189394,6965425
2017-02-22,EDGA Equities (J),76285746,36606468,38846092,151738306,2552521309.263301,1670590343.607001,1334621435.130001,5557733088.000303,664419,172928,304309,1141656
2017-02-22,EDGX Equities (K),183524605,87465132,155921649,426911386,6638119660.383212,3639434140.004582,5211547917.190787,15489101717.578581,1236805,319848,861161,2417814
2017-02-22,CHX (M),10040846,15998268,5094402,31133516,540606897.306100,2171260482.268500,295393327.550000,3007260707.124600,4862,3494,1803,10159
2017-02-22,NYSE (N),824943797,0,0,824943797,31470027007.241768,0.000000,0.000000,31470027007.241768,2595108,0,0,2595108
2017-02-22,NYSE Arca (P),224229841,273425464,130548578,628203883,8865762775.584569,13071750065.596230,5561418615.173009,27498931456.353808,1574874,650223,891694,3116791
2017-02-22,NASDAQ (Q),347123804,98498332,440770131,886392267,15175565459.194002,5029533450.668926,19724534929.905938,39929633839.768866,3139671,378276,2662540,6180487
2017-02-22,IEX (V),84137600,15456591,37441900,137036091,3235180331.359993,766805548.085300,1674735131.392699,5676721010.837992,480584,65820,221913,768317
2017-02-22,NASDAQ PSX (X),24044408,16968258,21463074,62475740,776281732.348299,889712652.022002,760146547.786100,2426140932.156401,180214,72359,144168,396741
2017-02-22,BYX Equities (Y),156307713,59044245,77067990,292419948,4744435259.780880,2300356496.258496,2549592798.872605,9594384554.911981,1409027,271225,691942,2372194
2017-02-22,BZX Equities (Z),200496884,79595207,101529765,381621856,7271804727.975394,4006571093.079299,3998380380.113606,15276756201.168299,1654843,342239,777575,2774657
2017-02-21,NYSE American (A),0,14022715,0,14022715,0.000000,60247755.815000,0.000000,60247755.815000,0,21922,0,21922
2017-02-21,NASDAQ BX (B),94470910,30195627,51848926,176515463,3702845799.351875,1281393338.105297,2012867827.467107,6997106964.924279,960428,144110,509654,1614192
2017-02-21,NYSE (DN),113701429,49967492,74648666,238317587,3466803331.602096,1698750110.075894,2697108481.993897,7862661923.671887,269226,96176,164633,530035
2017-02-21,NASDAQ (DQ),1188645177,518939343,756983931,2464568451,42776695497.148319,24785511100.436464,26121692705.299118,93683899302.883901,3905490,1025716,2201859,7133065
2017-02-21,EDGA Equities (J),69319260,36794505,36272421,142386186,2334865951.588098,1604935834.796201,1208260695.243401,5148062481.627700,612318,162736,276369,1051423
2017-02-21,EDGX Equities (K),189380581,91403475,168873255,449657311,7099726850.575051,4172701834.098796,5614229992.414095,16886658677.087942,1310126,330353,933633,2574112
2017-02-21,CHX (M),5604849,11435315,3597077,20637241,313498551.259500,859118648.550000,286836766.628800,1459453966.438300,4464,4551,1894,10909
2017-02-21,NYSE (N),877482882,0,0,877482882,34851634655.646052,0.000000,0.000000,34851634655.646052,2716105,0,0,2716105
2017-02-21,NYSE Arca (P),221706655,281390546,134643869,637741070,9324290107.127614,14769160168.069677,5682926667.319887,29776376942.517178,1607177,668668,900947,3176792
2017-02-21,NASDAQ (Q),352713645,105160568,473483588,931357801,15741903031.448767,5844153850.492900,21800616035.767373,43386672917.709040,3224736,395348,2782962,6403046
2017-02-21,IEX (V),101555012,18052779,40564729,160172520,4317523087.550898,901315339.916900,2072903474.352003,7291741901.819801,555779,71971,244394,872144
2017-02-21,NASDAQ PSX (X),20862387,18137096,19927810,58927293,734895689.459799,1038299874.847800,827663953.280502,2600859517.588101,175418,79896,149501,404815
2017-02-21,BYX Equities (Y),153468457,69280054,76212081,298960592,4829128582.525846,2593329203.026804,2590350617.538206,10012808403.090856,1419661,290313,695480,2405454
2017-02-21,BZX Equities (Z),198615774,82192515,103056934,383865223,7646930191.966889,4434501374.985993,4319345815.991404,16400777382.944286,1684516,348845,813098,2846459
2017-02-17,NYSE American (A),0,19182554,0,19182554,0.000000,99104310.428000,0.000000,99104310.428000,0,21150,0,21150
2017-02-17,NASDAQ BX (B),90563538,27863720,49148673,167575931,3473590741.167180,1274663881.528401,1926186581.239299,6674441203.934880,918649,148068,490488,1557205
2017-02-17,NYSE (DN),110813936,36950248,63638484,211402668,3651237792.723401,1370563668.489298,2579592642.941099,7601394104.153798,248085,74671,149015,471771
2017-02-17,NASDAQ (DQ),1100793128,402245328,701671832,2204710288,40575166881.043753,19743522282.521617,24321246401.712284,84639935565.277654,3623918,815201,2035171,6474290
2017-02-17,EDGA Equities (J),71525625,30591741,36734417,138851783,2408059450.122404,1594169861.713102,1330003469.292302,5332232781.127808,599273,153040,283280,1035593
2017-02-17,EDGX Equities (K),179146865,83832044,147700610,410679519,6714356893.369874,4043857526.146906,5174048637.396391,15932263056.913171,1209695,309773,848041,2367509
2017-02-17,CHX (M),7814439,16306618,5662146,29783203,379363030.073800,1647282235.862600,417936210.211900,2444581476.148300,4080,3161,1822,9063
2017-02-17,NYSE (N),944745872,0,0,944745872,39435565211.787430,0.000000,0.000000,39435565211.787430,2575571,0,0,2575571
2017-02-17,NYSE Arca (P),215364680,258802015,133642500,607809195,9406446818.378374,14446554619.377512,6004332703.116307,29857334140.872193,1556662,638573,902626,3097861
2017-02-17,NASDAQ (Q),349263307,98006910,518379872,965650089,15422903316.581788,5705947450.588030,24758415710.712096,45887266477.881914,3060871,381256,2658944,6101071
2017-02-17,IEX (V),76969147,14219835,33790347,124979329,3268078776.736199,756651226.762000,1653681909.417402,5678411912.915601,450393,63617,213151,727161
2017-02-17,NASDAQ PSX (X),20676400,17536401,19415908,57628709,735140548.769501,1014168868.940601,731598566.392699,2480907984.102801,173386,76386,141455,391227
2017-02-17,BYX Equities (Y),149934546,57019314,70796732,277750592,4704087779.110738,2354408335.398598,2433894487.036799,9492390601.546135,1327055,255459,652602,2235116
2017-02-17,BZX Equities (Z),199218806,76437377,98451253,374107436,7559219805.365195,4184664790.369795,4344909402.722410,16088793998.457400,1603439,326943,777430,2707812
2017-02-16,NYSE American (A),0,13626892,0,13626892,0.000000,64751299.840600,0.000000,64751299.840600,0,22884,0,22884
2017-02-16,NASDAQ BX (B),100491948,30913697,56198424,187604069,3729140804.125481,1461707213.449700,2135583984.105801,7326432001.680982,992459,145564,555016,1693039
2017-02-16,NYSE (DN),122019755,47222650,70838458,240080863,3782686228.298487,1807331171.177696,2775888981.986899,8365906381.463082,266465,93903,165043,525411
2017-02-16,NASDAQ (DQ),1203334614,484388524,725066647,2412789785,40225011820.554287,21781912638.783767,24817919925.503986,86824844384.842040,3884562,971069,2245256,7100887
2017-02-16,EDGA Equities (J),83768151,36154954,44115763,164038868,2786507186.924296,1846282483.957801,1576867234.457501,6209656905.339598,711952,176700,362933,1251585
2017-02-16,EDGX Equities (K),203976006,99173230,168236594,471385830,7156241280.706722,4841683537.413500,5909002712.437828,17906927530.558050,1366032,377848,1010597,2754477
2017-02-16,CHX (M),12947034,13785651,6987557,33720242,525336122.147200,1375623830.617800,419669752.469800,2320629705.234800,4967,4567,1935,11469
2017-02-16,NYSE (N),853135987,0,0,853135987,32260746508.426442,0.000000,0.000000,32260746508.426442,2782313,0,0,2782313
2017-02-16,NYSE Arca (P),228593939,275315553,145238701,649148193,9295770015.406112,15228609095.038376,6328851850.900316,30853230961.344804,1679235,744872,1007360,3431467
2017-02-16,NASDAQ (Q),376798981,123833990,465795196,966428167,16280624872.771724,7163612846.032718,21262503078.623609,44706740797.428051,3417003,485915,3017030,6919948
2017-02-16,IEX (V),84189484,17814146,43324661,145328291,3276953801.373302,993880149.501999,1885585197.008702,6156419147.884003,510529,72964,269190,852683
2017-02-16,NASDAQ PSX (X),24748299,21520280,22053889,68322468,819150992.358200,1239590459.193300,837163597.993500,2895905049.545000,198587,92655,158214,449456
2017-02-16,BYX Equities (Y),162324877,68668205,83057736,314050818,4958406742.997760,2822113280.460692,2759536091.228212,10540056114.686664,1473798,298221,793534,2565553
2017-02-16,BZX Equities (Z),219573023,94139966,114688724,428401713,7887718333.753968,5275832330.274795,4790319488.644691,17953870152.673454,1798499,414114,949784,3162397
2017-02-15,NYSE American (A),0,12474703,0,12474703,0.000000,56987143.411600,0.000000,56987143.411600,0,22026,0,22026
2017-02-15,NASDAQ BX (B),99588244,29387717,57243426,186219387,3698996500.655247,1311656301.430800,2109193025.653999,7119845827.740046,978026,134067,546588,1658681
2017-02-15,NYSE (DN),122416270,44498977,79566154,246481401,4093800092.637510,1582206137.226898,2817694233.739697,8493700463.604105,288667,94428,183675,566770
2017-02-15,NASDAQ (DQ),1271500349,477929886,823804597,2573234832,44460768796.086021,23152606240.713510,26661368015.162609,94274743051.962140,3999552,960722,2368196,7328470
2017-02-15,EDGA Equities (J),87020235,35021781,45609785,167651801,2878827817.375898,1665949384.484700,1543096145.105099,6087873346.965697,722618,164322,356188,1243128
2017-02-15,EDGX Equities (K),206976136,91870727,177548564,476395427,7551825816.907658,4344178046.258690,5905975681.626496,17801979544.792844,1359207,339138,1017149,2715494
2017-02-15,CHX (M),10044166,11347227,5368000,26759393,503960213.262700,935719117.335000,485120617.603400,1924799948.201100,5415,3442,1905,10762
2017-02-15,NYSE (N),844472789,0,0,844472789,33164711979.727448,0.000000,0.000000,33164711979.727448,2764379,0,0,2764379
2017-02-15,NYSE Arca (P),262547526,257826667,156715532,677089725,10006600909.193016,14510706602.080824,6122359430.898097,30639666942.171937,1659872,665714,996129,3321715
2017-02-15,NASDAQ (Q),374667309,117528275,472987759,965183343,16074902708.698184,6986989784.927486,20264202205.581094,43326094699.206764,3288064,441397,2906742,6636203
2017-02-15,IEX (V),94758923,16914665,43155035,154828623,4001163441.172603,840461358.779301,1872082783.457102,6713707583.409006,523161,72417,255828,851406
2017-02-15,NASDAQ PSX (X),29966418,19723849,25476645,75166912,885554898.133799,1122569303.386500,875169234.847401,2883293436.367700,197598,85506,169712,452816
2017-02-15,BYX Equities (Y),161050656,64534424,86193945,311779025,4942741216.780658,2617692743.254005,2783704715.968400,10344138676.003063,1442159,282857,757167,2482183
2017-02-15,BZX Equities (Z),220868128,87490317,120479858,428838303,8351435573.086410,5092104074.112293,4833619784.369003,18277159431.567706,1810260,380961,934400,3125621
2017-02-14,NYSE American (A),0,18555392,0,18555392,0.000000,72003450.946100,0.000000,72003450.946100,0,26157,0,26157
2017-02-14,NASDAQ BX (B),90604838,30015318,55595798,176215954,3500708135.064720,1303389841.755999,2216390341.447402,7020488318.268121,947000,137996,546120,1631116
2017-02-14,NYSE (DN),112127272,48643205,72313265,233083742,3670678001.942590,1586827508.624899,2796469867.855400,8053975378.422889,268345,92524,170757,531626
2017-02-14,NASDAQ (DQ),1189608290,533678825,766230925,2489518040,41401095418.046291,21450378925.879736,27293719305.066048,90145193648.992075,3637085,1001485,2139994,6778564
2017-02-14,EDGA Equities (J),77783411,39507312,40600243,157890966,2573807849.989505,1763435531.292498,1518820532.034100,5856063913.316103,668540,176710,331823,1177073
2017-02-14,EDGX Equities (K),194030485,100449074,163072332,457551891,7058030639.790300,4132466206.857107,6002007962.234597,17192504808.882004,1323073,346744,983759,2653576
2017-02-14,CHX (M),10231128,11715980,8111935,30059043,557454528.967300,886333782.734400,674522609.830600,2118310921.532300,5069,3668,1814,10551
2017-02-14,NYSE (N),813829046,0,0,813829046,31192384212.444862,0.000000,0.000000,31192384212.444862,2666548,0,0,2666548
2017-02-14,NYSE Arca (P),222403285,288942358,139084976,650430619,9247040113.526274,14822342507.589245,6126334814.814192,30195717435.929711,1633426,731782,974496,3339704
2017-02-14,NASDAQ (Q),351264328,122306407,453345067,926915802,15125443801.373501,6573116277.532099,20183957621.891121,41882517700.796721,3230166,447417,2834178,6511761
2017-02-14,IEX (V),84220242,19442343,42635495,146298080,3536830928.170296,807156339.937700,1982372940.010200,6326360208.118196,506866,75905,252431,835202
2017-02-14,NASDAQ PSX (X),22708412,20927313,21559724,65195449,785898072.406201,1091654473.352000,863953387.326000,2741505933.084201,187669,91109,162088,440866
2017-02-14,BYX Equities (Y),152196124,66950438,80175941,299322503,4833681477.334035,2562611766.950690,2763261021.004294,10159554265.289019,1452603,281087,738186,2471876
2017-02-14,BZX Equities (Z),207040835,93263056,109651524,409955415,7638858098.369681,4657215114.411609,4616312142.591002,16912385355.372292,1768041,392375,907958,3068374
2017-02-13,NYSE American (A),0,15312281,0,15312281,0.000000,109703102.531900,0.000000,109703102.531900,0,21887,0,21887
2017-02-13,NASDAQ BX (B),86489112,26969603,51099964,164558679,3207317298.480796,1158237206.002500,1997190712.775303,6362745217.258599,885975,125974,497096,1509045
2017-02-13,NYSE (DN),112785694,43543396,71871832,228200922,3487518268.744295,1524169662.489701,2843146587.040202,7854834518.274198,265469,88090,180680,534239
2017-02-13,NASDAQ (DQ),1122429155,480950518,739064048,2342443721,38606798562.281252,19299615726.892081,27662562057.196974,85568976346.370307,3644414,930906,2195668,6770988
2017-02-13,EDGA Equities (J),72532120,29696612,38339169,140567901,2400899967.735408,1363443501.492802,1449643415.353003,5213986884.581213,629272,144628,314409,1088309
2017-02-13,EDGX Equities (K),180121459,80830868,150582542,411534869,6207725626.658485,3354835372.699598,5484466211.647514,15047027211.005597,1193591,281274,899917,2374782
2017-02-13,CHX (M),9156303,15091196,7068819,31316318,509446338.138200,1227932081.578000,446501959.691200,2183880379.407400,4638,3704,1807,10149
2017-02-13,NYSE (N),798973016,0,0,798973016,29915391553.084405,0.000000,0.000000,29915391553.084405,2468649,0,0,2468649
2017-02-13,NYSE Arca (P),208617750,241337816,131380318,581335884,8170578073.164081,12471493279.615253,5847081777.377620,26489153130.156954,1494860,581332,917951,2994143
2017-02-13,NASDAQ (Q),324993636,96471435,422754723,844219794,13545217320.015812,5034037875.000891,19472557254.691582,38051812449.708285,2956367,362729,2613817,5932913
2017-02-13,IEX (V),76062885,15727339,37237921,129028145,3090908764.674698,735131728.391400,1682430941.330001,5508471434.396099,446264,67696,229365,743325
2017-02-13,NASDAQ PSX (X),22254081,17459424,19892961,59606466,753355548.894800,939540907.353400,807126404.201400,2500022860.449600,190533,76100,152756,419389
2017-02-13,BYX Equities (Y),145887166,55190467,73402822,274480455,4618584528.118586,2106429661.688192,2598153972.821203,9323168162.627981,1415547,234913,692057,2342517
2017-02-13,BZX Equities (Z),192067775,69946297,100787623,362801695,6872965403.919952,3776670995.825994,4273680559.806103,14923316959.552049,1613255,305743,829114,2748112
2017-02-10,NYSE American (A),0,14544150,0,14544150,0.000000,69418081.559000,0.000000,69418081.559000,0,24387,0,24387
2017-02-10,NASDAQ BX (B),91859403,29786829,50512696,172158928,3240670532.946599,1283590581.684698,1964925203.081105,6489186317.712402,893953,141275,488976,1524204
2017-02-10,NYSE (DN),107456912,44736935,72466012,224659859,3296854583.146695,1546061924.628301,2875416013.082505,7718332520.857501,246636,80134,167010,493780
2017-02-10,NASDAQ (DQ),1188550236,480595280,723326520,2392472036,40109568288.601808,21070710244.315961,25801903889.729937,86982182422.647706,3593096,885434,2173778,6652308
2017-02-10,EDGA Equities (J),75832998,31545119,38859759,146237876,2387492249.958400,1457452782.716497,1408012304.236904,5252957336.911801,635389,152584,318673,1106646
2017-02-10,EDGX Equities (K),193520473,91301483,154946274,439768230,6605621199.552727,3704637264.240408,5813001340.928681,16123259804.721816,1252859,311904,937165,2501928
2017-02-10,CHX (M),8793345,9452413,3130113,21375871,643468250.741000,703024888.855000,233749289.837400,1580242429.433400,4289,4108,1731,10128
2017-02-10,NYSE (N),788752906,0,0,788752906,29225453007.074822,0.000000,0.000000,29225453007.074822,2489230,0,0,2489230
2017-02-10,NYSE Arca (P),231122083,262593461,139888802,633604346,9046260543.495920,13272597316.588335,6216766593.862910,28535624453.947165,1539515,664827,975495,3179837
2017-02-10,NASDAQ (Q),347132030,103404199,438447264,888983493,14289626954.903982,5346752180.525118,20408560065.864927,40044939201.294027,3036229,389792,2785268,6211289
2017-02-10,IEX (V),86939733,14899690,42428837,144268260,3332289091.896305,760567006.669099,1886369823.435999,5979225922.001403,485656,66593,245806,798055
2017-02-10,NASDAQ PSX (X),22949905,20021969,21296328,64268202,719531928.342001,987411852.224000,832528604.236600,2539472384.802601,174217,83182,155274,412673
2017-02-10,BYX Equities (Y),149417942,56338257,74671242,280427441,4530147910.712827,2206472186.168699,2527723324.589312,9264343421.470838,1367250,250688,691393,2309331
2017-02-10,BZX Equities (Z),204276617,84059491,107301529,395637637,7291837648.832702,4249558616.262906,4614935577.342999,16156331842.438607,1640581,350130,852076,2842787
2017-02-09,NYSE American (A),0,13289596,0,13289596,0.000000,64081670.892500,0.000000,64081670.892500,0,25206,0,25206
2017-02-09,NASDAQ BX (B),96329896,31514836,52820887,180665619,3581559959.488118,1337314335.849103,2125513955.751294,7044388251.088515,985091,149081,533667,1667839
2017-02-09,NYSE (DN),119253072,43356900,73906919,236516891,3807156888.775602,1531566985.072900,3034465535.053903,8373189408.902405,267457,83121,171676,522254
2017-02-09,NASDAQ (DQ),1227679790,512409721,749626431,2489715942,40300069437.313721,22389978758.879837,27730542119.401344,90420590315.594902,3845959,967605,2224234,7037798
2017-02-09,EDGA Equities (J),83198801,36384044,40537361,160120206,2602001686.069312,1610062149.003699,1470165941.911799,5682229776.984810,713511,168304,327696,1209511
2017-02-09,EDGX Equities (K),207905245,90867036,161011930,459784211,7117258872.168879,3869663677.196097,5946934748.298312,16933857297.663288,1402721,333668,985423,2721812
2017-02-09,CHX (M),9998106,11879828,4238567,26116501,527010771.672700,1135757371.577000,414530399.632000,2077298542.881700,5047,4852,2104,12003
2017-02-09,NYSE (N),844511237,0,0,844511237,31048033135.384143,0.000000,0.000000,31048033135.384143,2770188,0,0,2770188
2017-02-09,NYSE Arca (P),232860399,273223639,147029879,653113917,8990794788.147687,13623658953.551265,6660436079.748404,29274889821.447356,1691821,726062,1027857,3445740
2017-02-09,NASDAQ (Q),374645154,109179818,462982853,946807825,15735706960.227330,5942141181.314417,21410116814.168968,43087964955.710715,3315609,428284,2881142,6625035
2017-02-09,IEX (V),82863186,16299737,42085671,141248594,3267880965.682791,847379750.735100,1928314360.745002,6043575077.162893,478001,71350,245615,794966
2017-02-09,NASDAQ PSX (X),23121272,22379191,22096545,67597008,790328882.980000,1129860954.400200,875945904.813299,2796135742.193499,194497,98275,162299,455071
2017-02-09,BYX Equities (Y),160581833,58669915,78834557,298086305,4880652782.545353,2288260184.562404,2688836492.912707,9857749460.020464,1498143,256776,739272,2494191
2017-02-09,BZX Equities (Z),218654611,83967538,112956005,415578154,7860216426.979832,4298596631.653006,4758995267.297584,16917808325.930422,1816125,362633,898700,3077458
2017-02-08,NYSE American (A),0,13146758,0,13146758,0.000000,64760693.189100,0.000000,64760693.189100,0,24155,0,24155
2017-02-08,NASDAQ BX (B),95222621,30023310,52328457,177574388,3427960583.732988,1272781137.823399,2060868536.005199,6761610257.561586,933681,141947,516599,1592227
2017-02-08,NYSE (DN),110620982,41876342,70289116,222786440,3449347411.731203,1542708840.771900,2822161173.924787,7814217426.427890,251310,81201,168271,500782
2017-02-08,NASDAQ (DQ),1182773876,477523898,752281682,2412579456,39633864795.485280,20039451954.542520,26274020804.492786,85947337554.520586,3818179,949081,2204324,6971584
2017-02-08,EDGA Equities (J),80221201,33569297,40531966,154322464,2569535416.072100,1546120796.210700,1522450318.886701,5638106531.169501,685634,161197,338305,1185136
2017-02-08,EDGX Equities (K),198267544,89140324,161298267,448706135,6882096183.990087,3795472560.117694,5851461976.670285,16529030720.778066,1374026,330719,970255,2675000
2017-02-08,CHX (M),7761711,13158841,7206329,28126881,415535424.170600,1270293921.007000,501868071.665900,2187697416.843500,5190,4321,2112,11623
2017-02-08,NYSE (N),854737997,0,0,854737997,30634417931.007407,0.000000,0.000000,30634417931.007407,2732619,0,0,2732619
2017-02-08,NYSE Arca (P),227569344,249571979,144043256,621184579,9192283297.176470,11984928135.056038,6489735531.091710,27666946963.324218,1678347,674662,1012193,3365202
2017-02-08,NASDAQ (Q),373602964,104351368,466182620,944136952,15540721973.997109,5326700017.612288,21299715354.742729,42167137346.352126,3349367,425553,2949914,6724834
2017-02-08,IEX (V),80967375,16898649,39554002,137420026,3146131181.162004,850603437.617900,1840056382.380998,5836791001.160902,467085,65534,239444,772063
2017-02-08,NASDAQ PSX (X),23463953,19787977,21498991,64750921,775329764.423499,1022424296.915400,885966056.880101,2683720118.219000,191020,89616,162865,443501
2017-02-08,BYX Equities (Y),155568103,57264892,79810848,292643843,4627265145.881894,2242636109.076500,2735364824.531110,9605266079.489504,1411617,263081,742976,2417674
2017-02-08,BZX Equities (Z),221173890,84937072,112077758,418188720,7747345153.003753,4214428725.812997,4823199127.551588,16784973006.368338,1817922,366551,911893,3096366
2017-02-07,NYSE American (A),0,16618344,0,16618344,0.000000,74468467.434700,0.000000,74468467.434700,0,26985,0,26985
2017-02-07,NASDAQ BX (B),87423099,28781999,51719557,167924655,3323291114.692584,1161497990.554301,1978315128.286404,6463104233.533289,863042,135896,490841,1489779
2017-02-07,NYSE (DN),111716359,48221218,75744246,235681823,3652691940.307412,1577835527.820699,2916154029.236299,8146681497.364410,265663,92241,176642,534546
2017-02-07,NASDAQ (DQ),1126315734,514064837,732991511,2373372082,38892179043.865175,21837000437.191373,24321808527.355394,85050988008.411942,3764930,981681,2176193,6922804
2017-02-07,EDGA Equities (J),74961604,32850828,41413937,149226369,2413371421.148097,1385833621.055798,1438822486.621298,5238027528.825193,631776,151188,324926,1107890
2017-02-07,EDGX Equities (K),189247408,88371738,166437124,444056270,6793884105.460869,3342452152.560598,5615718250.284602,15752054508.306069,1331792,310718,948183,2590693
2017-02-07,CHX (M),6907344,13494296,6161237,26562877,350234707.349200,1275455873.925000,586260571.082100,2211951152.356300,4330,4376,1741,10447
2017-02-07,NYSE (N),820557983,0,0,820557983,30678305262.618752,0.000000,0.000000,30678305262.618752,2641825,0,0,2641825
2017-02-07,NYSE Arca (P),211547344,266407718,142497906,620452968,8869558862.989340,12523449148.774530,5960827064.360908,27353835076.124778,1578427,666520,944613,3189560
2017-02-07,NASDAQ (Q),375143799,104148684,457722573,937015056,16359540370.620404,4896343963.436478,20232865765.838349,41488750099.895231,3408541,410960,2828986,6648487
2017-02-07,IEX (V),82535467,16625217,41429613,140590297,3328170237.537597,777714010.884500,1806020405.710300,5911904654.132397,472917,68582,236832,778331
2017-02-07,NASDAQ PSX (X),21186515,19186759,22866327,63239601,737671794.362599,894859853.799100,870983783.983700,2503515432.145399,178672,84615,161027,424314
2017-02-07,BYX Equities (Y),146265925,60108849,74566835,280941609,4430260325.703066,2162045670.548993,2476408986.678592,9068714982.930651,1347575,266677,689667,2303919
2017-02-07,BZX Equities (Z),198652682,80447996,108484691,387585369,7282001459.437559,3871446262.372802,4260518579.693612,15413966301.503973,1662998,351861,832040,2846899
2017-02-06,NYSE American (A),0,15761738,0,15761738,0.000000,73201068.965300,0.000000,73201068.965300,0,27384,0,27384
2017-02-06,NASDAQ BX (B),82240148,27857084,44966195,155063427,3125665636.548386,1115393621.047503,1783428682.625095,6024487940.220984,827336,135523,453318,1416177
2017-02-06,NYSE (DN),94981510,41462180,68444788,204888478,3049970558.289386,1423440261.726196,2380680781.582496,6854091601.598078,223590,86397,147285,457272
2017-02-06,NASDAQ (DQ),1020196513,480869186,683831381,2184897080,35617134317.123093,20678031965.403562,23135280109.503101,79430446392.029756,3419455,973374,2011436,6404265
2017-02-06,EDGA Equities (J),66796307,28796605,34903353,130496265,2120850385.771794,1294299999.703503,1216213759.054499,4631364144.529796,571599,146006,283123,1000728
2017-02-06,EDGX Equities (K),161484010,85487487,142486973,389458470,5715437242.709608,3416557239.058400,4866062026.037993,13998056507.806001,1124402,297164,829852,2251418
2017-02-06,CHX (M),12029921,11341847,3096106,26467874,567289439.493400,707538961.668200,234887085.245400,1509715486.407000,4479,4153,1544,10176
2017-02-06,NYSE (N),769872712,0,0,769872712,29535412698.310064,0.000000,0.000000,29535412698.310064,2404351,0,0,2404351
2017-02-06,NYSE Arca (P),183852530,273600394,123389783,580842707,7736962297.383514,13540834668.756682,5259321784.955317,26537118751.095513,1412919,635172,869005,2917096
2017-02-06,NASDAQ (Q),318457306,97175531,415741534,831374371,13789248233.527753,4970777334.398996,19373759043.670905,38133784611.597654,2957687,384934,2526362,5868983
2017-02-06,IEX (V),72648351,16464922,38446531,127559804,2860855009.139602,771021676.585400,1618918940.721303,5250795626.446305,417960,61483,212613,692056
2017-02-06,NASDAQ PSX (X),19548263,18550218,20314207,58412688,665499923.430801,881746471.034401,751830051.865600,2299076446.330802,164929,84320,145352,394601
2017-02-06,BYX Equities (Y),133704974,53285601,65855428,252846003,4118310367.067385,2013025281.796299,2196599291.939390,8327934940.803074,1260046,247146,631968,2139160
2017-02-06,BZX Equities (Z),176582017,76826257,94667413,348075687,6469399385.234973,3732379409.338606,3823806904.665290,14025585699.238869,1502352,332351,754627,2589330
2017-02-03,NYSE American (A),0,11670677,0,11670677,0.000000,106759839.420900,0.000000,106759839.420900,0,21381,0,21381
2017-02-03,NASDAQ BX (B),93236415,28180825,49145555,170562795,3537253339.819727,1274149654.755500,2008514531.814894,6819917526.390121,919805,136445,490061,1546311
2017-02-03,NYSE (DN),109904028,41155892,64754700,215814620,3679620362.856197,1537691248.567304,2613525460.461706,7830837071.885207,271273,84151,159835,515259
2017-02-03,NASDAQ (DQ),1201141596,471467219,694904978,2367513793,42870840686.594183,22728918764.886561,25621607532.504890,91221366983.985634,3858742,917239,2115162,6891143
2017-02-03,EDGA Equities (J),80328704,31392920,37830702,149552326,2650882395.873410,1587613307.935300,1456835560.292798,5695331264.101508,697621,155428,313587,1166636
2017-02-03,EDGX Equities (K),195057392,84206331,146707004,425970727,7129138790.312586,4196064307.034201,5641520109.478604,16966723206.825391,1313214,313611,886332,2513157
2017-02-03,CHX (M),12554391,13820276,4846960,31221627,718168509.776900,1362862795.440000,364100250.761000,2445131555.977900,4276,6397,1710,12383
2017-02-03,NYSE (N),851479690,0,0,851479690,33053057728.914180,0.000000,0.000000,33053057728.914180,2726970,0,0,2726970
2017-02-03,NYSE Arca (P),225140615,258949969,132297659,616388243,9473170249.166085,14617753296.242234,6417290239.209884,30508213784.618203,1669515,672336,927155,3269006
2017-02-03,NASDAQ (Q),370923855,104545065,432656585,908125505,16112090353.868702,6343936317.390206,20690845914.629495,43146872585.888403,3352376,425271,2702792,6480439
2017-02-03,IEX (V),80308406,16180938,38609378,135098722,3104695030.651099,904178173.341500,2090201174.108899,6099074378.101498,472903,64539,229775,767217
2017-02-03,NASDAQ PSX (X),24433995,17795088,19402308,61631391,817043698.744199,1079379831.015099,861820416.838600,2758243946.597898,196021,82853,149009,427883
2017-02-03,BYX Equities (Y),149518744,60596980,69072002,279187726,4819755044.941391,2514544747.578795,2520426949.672010,9854726742.192196,1401032,261306,655096,2317434
2017-02-03,BZX Equities (Z),211949377,81338682,102110330,395398389,8113388725.308929,4875009276.856404,4602380870.682381,17590778872.847714,1779834,369605,829465,2978904
2017-02-02,NYSE American (A),0,12076654,0,12076654,0.000000,112674993.563300,0.000000,112674993.563300,0,21145,0,21145
2017-02-02,NASDAQ BX (B),99960151,28009325,54716463,182685939,3839651435.860181,1254185592.577899,2268237355.297997,7362074383.736077,986270,139052,542652,1667974
2017-02-02,NYSE (DN),113758716,38946361,75375334,228080411,3810765617.792405,1472769733.025903,3235984673.301290,8519520024.119598,262171,77982,168880,509033
2017-02-02,NASDAQ (DQ),1272549183,434927165,813931626,2521407974,43416291918.445406,20536670802.770600,29461049050.788999,93414011772.005005,4001770,895049,2308809,7205628
2017-02-02,EDGA Equities (J),86236724,29630442,40954305,156821471,2774346604.441102,1388335386.696000,1563024626.306498,5725706617.443600,721929,151875,339508,1213312
2017-02-02,EDGX Equities (K),205800585,82350546,172220235,460371366,7251858225.864521,3908273942.699190,6596644849.767291,17756777018.331002,1355103,313407,1001152,2669662
2017-02-02,CHX (M),6494200,12862004,5093512,24449716,323008905.900400,1032863577.730000,383653173.069000,1739525656.699400,4978,4015,1950,10943
2017-02-02,NYSE (N),879954414,0,0,879954414,33066775675.244412,0.000000,0.000000,33066775675.244412,2829070,0,0,2829070
2017-02-02,NYSE Arca (P),244669506,253840642,158094708,656604856,10043867142.051018,13700482516.186559,7900179262.869101,31644528921.106678,1757273,681508,1084943,3523724
2017-02-02,NASDAQ (Q),404408882,103999153,490017255,998425290,17419128604.981585,6134148810.491514,22818801613.965312,46372079029.438411,3629707,427615,3113611,7170933
2017-02-02,IEX (V),91511455,17570624,45882038,154964117,3839749124.547192,858220381.002000,2352933480.863898,7050902986.413090,522644,66548,262301,851493
2017-02-02,NASDAQ PSX (X),24410146,16787790,21528569,62726505,821116524.789100,925685279.459399,913164961.706700,2659966765.955199,193342,82784,157575,433701
2017-02-02,BYX Equities (Y),154830037,57290147,78218269,290338453,4799162458.446789,2269445456.011800,2689543727.910211,9758151642.368800,1403205,271684,719361,2394250
2017-02-02,BZX Equities (Z),225183636,82695594,120982589,428861819,8241673546.966026,4464697396.347893,5195519995.950500,17901890939.264419,1847183,370860,948066,3166109
2017-02-01,NYSE American (A),0,12100812,0,12100812,0.000000,79886580.619300,0.000000,79886580.619300,0,24471,0,24471
2017-02-01,NASDAQ BX (B),106535356,37873548,60119383,204528287,4052054409.466207,1701760388.331801,2435604496.753807,8189419294.551815,1063136,178325,583069,1824530
2017-02-01,NYSE (DN),120428217,47158193,83485058,251071468,4156496004.312114,2026537043.281602,3812759635.003000,9995792682.596716,293717,99510,193962,587189
2017-02-01,NASDAQ (DQ),1257629246,505087227,820228128,2582944601,43493802068.639496,23699393714.309305,32571151594.722404,99764347377.671205,4093314,1024635,2507849,7625798
2017-02-01,EDGA Equities (J),90254232,42338401,48987996,181580629,2959504886.022020,1996100572.722998,1998393831.639804,6953999290.384822,785001,198638,397319,1380958
2017-02-01,EDGX Equities (K),221451241,106105253,206943339,534499833,7829294085.014397,5123903940.475495,8247371039.099998,21200569064.589890,1530690,399871,1179686,3110247
2017-02-01,CHX (M),7810970,18329310,8413494,34553774,375425238.308000,1560178574.415001,720817940.389300,2656421753.112301,5016,5095,2302,12413
2017-02-01,NYSE (N),902908693,0,0,902908693,34195979350.867796,0.000000,0.000000,34195979350.867796,3266635,0,0,3266635
2017-02-01,NYSE Arca (P),257457449,333387278,184512366,775357093,10444237474.000900,17846325863.058941,9463513189.768238,37754076526.828079,1951224,852158,1240456,4043838
2017-02-01,NASDAQ (Q),428812342,139120472,531031646,1098964460,17977570208.373118,8066175574.451714,26086725429.005746,52130471211.830578,3913946,567851,3399347,7881144
2017-02-01,IEX (V),90053517,19943620,46441867,156439004,3677702792.739509,1029239107.201600,2286304744.761797,6993246644.702906,535748,79142,269778,884668
2017-02-01,NASDAQ PSX (X),28239512,22349665,25611026,76200203,960294429.838600,1216595070.285701,1074806010.256200,3251695510.380501,229601,102914,182139,514654
2017-02-01,BYX Equities (Y),163454414,74778828,85013839,323247081,5060625068.219425,3098666994.192204,3000871544.461106,11160163606.872735,1496662,346917,782120,2625699
2017-02-01,BZX Equities (Z),244155321,106196888,138785229,489137438,9008978026.154554,5897189836.096591,6449116962.521886,21355284824.773031,2090772,469017,1084073,3643862
2017-01-31,NYSE American (A),0,16712304,0,16712304,0.000000,96065480.683500,0.000000,96065480.683500,0,25486,0,25486
2017-01-31,NASDAQ BX (B),102935127,36414694,57919744,197269565,3994229172.693918,1653157439.011301,2314059237.080591,7961445848.785810,1024357,176921,571949,1773227
2017-01-31,NSX (C),732599,170951,309935,1213485,25451091.350000,13010885.738400,11096935.892000,49558912.980400,5015,1011,1832,7858
2017-01-31,NYSE (DN),117474583,49424876,71333073,238232532,4041409645.633411,1842398086.106192,2837099397.834696,8720907129.574299,292512,98734,176343,567589
2017-01-31,NASDAQ (DQ),1258564804,575242529,738991432,2572798765,43656001694.078098,26915881667.495031,25830940400.040384,96402823761.613513,4108403,1076168,2277043,7461614
2017-01-31,EDGA Equities (J),89449386,44175261,41564309,175188956,2960439404.850007,1992581856.154004,1588171520.834202,6541192781.838213,769549,202667,349116,1321332
2017-01-31,EDGX Equities (K),207453672,113895914,175390260,496739846,7223572389.532009,5158187072.468209,6050083732.646133,18431843194.646351,1413658,401318,1033131,2848107
2017-01-31,CHX (M),22200789,12397853,6500170,41098812,606699104.560400,1054135127.154400,489108247.264500,2149942478.979300,4348,4785,2188,11321
2017-01-31,NYSE (N),1115566577,0,0,1115566577,43750610700.076580,0.000000,0.000000,43750610700.076580,2996840,0,0,2996840
2017-01-31,NYSE Arca (P),257062025,349703922,159471447,766237394,10284780225.801604,18073710667.390652,6965250954.896700,35323741848.088956,1851141,864597,1066139,3781877
2017-01-31,NASDAQ (Q),410692447,137836686,532043901,1080573034,17130855183.374490,7378085802.255224,23569253296.845240,48078194282.474954,3618241,532106,2997921,7148268
2017-01-31,IEX (V),85853030,22196401,39627664,147677095,3473787312.209296,1128199623.298500,1773607927.829202,6375594863.336998,509933,82812,245742,838487
2017-01-31,NASDAQ PSX (X),25406038,21214794,20013473,66634305,868868286.002301,1103131941.079800,817380161.513299,2789380388.595400,209044,93830,158789,461663
2017-01-31,BYX Equities (Y),165832109,81258070,84224691,331314870,5177914271.470038,3246067714.999801,2805387230.333802,11229369216.803641,1510028,355890,774528,2640446
2017-01-31,BZX Equities (Z),230509879,101745222,120069954,452325055,8309268594.572637,5608838396.042484,4982606921.508199,18900713912.123320,1927778,448312,964130,3340220
2017-01-30,NYSE American (A),0,13884493,0,13884493,0.000000,77128215.436600,0.000000,77128215.436600,0,24574,0,24574
2017-01-30,NASDAQ BX (B),94847132,28546574,51149386,174543092,3597445658.810695,1348201409.016198,2085325160.065004,7030972227.891897,914580,148689,478819,1542088
2017-01-30,NSX (C),520249,239853,252150,1012252,18165557.580000,21554661.112100,9697127.734900,49417346.427000,3651,1321,1967,6939
2017-01-30,NYSE (DN),110088342,47772982,67430392,225291716,3458632368.878217,1881519762.867500,3097159209.837702,8437311341.583419,266112,100178,155675,521965
2017-01-30,NASDAQ (DQ),1175167311,485578226,654741481,2315487018,37898465944.092891,22894268603.607767,25324279464.237330,86117014011.937988,3814082,1051484,2021557,6887123
2017-01-30,EDGA Equities (J),82791974,38290714,36946244,158028932,2566736964.563100,1766217281.302901,1415551504.858599,5748505750.724600,688516,181699,302608,1172823
2017-01-30,EDGX Equities (K),193781614,98640902,152623180,445045696,6463489875.411173,4825041561.996902,5669292827.393492,16957824264.801567,1280252,378934,901328,2560514
2017-01-30,CHX (M),7019653,8734584,3548669,19302906,317559681.138500,757345558.870000,298529097.323900,1373434337.332400,4140,5079,1799,11018
2017-01-30,NYSE (N),873201793,0,0,873201793,32027673062.438141,0.000000,0.000000,32027673062.438141,2782358,0,0,2782358
2017-01-30,NYSE Arca (P),227544976,281355426,138596155,647496557,8781178736.439718,15548899556.558867,6318486970.222920,30648565263.221505,1623485,814447,945345,3383277
2017-01-30,NASDAQ (Q),364608987,121201020,441276817,927086824,15208888416.626035,7034760723.372301,21084706447.696730,43328355587.695066,3288367,523795,2783975,6596137
2017-01-30,IEX (V),80950837,17690671,36633997,135275505,3147390370.898813,996852670.440499,1763028427.306399,5907271468.645711,477385,72066,220514,769965
2017-01-30,NASDAQ PSX (X),23435740,19537050,19441955,62414745,764141613.811700,1090299638.505000,821138782.168000,2675580034.484700,190705,92910,148313,431928
2017-01-30,BYX Equities (Y),150513183,66656392,72236661,289406236,4451619225.169762,2643290249.445397,2518714874.386307,9613624349.001466,1310739,301524,639638,2251901
2017-01-30,BZX Equities (Z),210569817,92062397,107510750,410142964,7322106660.713320,5253677935.168196,4819701788.307706,17395486384.189222,1702614,434140,854788,2991542
2017-01-27,NYSE American (A),0,9660419,0,9660419,0.000000,68336182.595200,0.000000,68336182.595200,0,20908,0,20908
2017-01-27,NASDAQ BX (B),82608092,24104430,45396567,152109089,3248618356.711203,1032785038.822899,1949034774.180401,6230438169.714503,825558,122134,452207,1399899
2017-01-27,NSX (C),377129,203178,225554,805861,12635054.900000,19296793.170000,7093547.427500,39025395.497500,2830,807,1525,5162
2017-01-27,NYSE (DN),98838480,38849213,66251222,203938915,3414616347.480317,1402673694.367503,2935308146.024792,7752598187.872612,235327,79188,147293,461808
2017-01-27,NASDAQ (DQ),1024421004,416430042,626893766,2067744812,36086460949.345645,19363309024.710661,24682136516.593498,80131906490.649804,3429789,801368,1946587,6177744
2017-01-27,EDGA Equities (J),69971377,26416492,34067723,130455592,2328199306.848799,1173118511.289299,1360910440.307598,4862228258.445696,603823,127303,288538,1019664
2017-01-27,EDGX Equities (K),167718077,77252879,141193354,386164310,6077853485.201391,3288642417.054698,5697134106.792206,15063630009.048295,1147585,272924,877475,2297984
2017-01-27,CHX (M),7511175,11954154,5275250,24740579,416535495.708800,1064493051.771300,348329016.898400,1829357564.378500,3833,3144,1736,8713
2017-01-27,NYSE (N),750923991,0,0,750923991,29158452563.320059,0.000000,0.000000,29158452563.320059,2570101,0,0,2570101
2017-01-27,NYSE Arca (P),199287819,251842640,130087360,581217819,8515567110.321501,12311153931.450804,6591448872.217829,27418169913.990134,1494165,597352,931546,3023063
2017-01-27,NASDAQ (Q),332020262,92870022,404101609,828991893,14788199648.328322,4961331919.019112,20461223584.986749,40210755152.334183,3019628,375031,2665718,6060377
2017-01-27,IEX (V),69685460,13742927,34564319,117992706,2908791122.350295,619292922.498400,1699664242.737699,5227748287.586394,408671,52426,204764,665861
2017-01-27,NASDAQ PSX (X),20799286,17027988,17771161,55598435,720505801.749900,847324739.960000,763709759.387000,2331540301.096900,174919,79287,135719,389925
2017-01-27,BYX Equities (Y),130931664,51452941,65409120,247793725,4157583546.693168,1997608511.990601,2379649035.442398,8534841094.126167,1202686,236981,609217,2048884
2017-01-27,BZX Equities (Z),182330361,69110699,97959666,349400726,6798828310.801790,3577788560.302598,4682587851.709512,15059204722.813900,1538550,313503,812984,2665037
2017-01-26,NYSE American (A),0,11460190,0,11460190,0.000000,101592437.464000,0.000000,101592437.464000,0,24648,0,24648
2017-01-26,NASDAQ BX (B),92160290,31455363,51654099,175269752,3625071361.567307,1320757293.352699,2261596363.904204,7207425018.824210,910942,147805,502004,1560751
2017-01-26,NSX (C),680030,221659,206305,1107994,30635229.800000,24535910.400000,6292676.541700,61463816.741700,4414,837,1396,6647
2017-01-26,NYSE (DN),116371607,43543621,67423992,227339220,4224229497.045300,1617089226.188104,3185863031.263607,9027181754.497011,270540,87515,168400,526455
2017-01-26,NASDAQ (DQ),1194606868,526801923,679682087,2401090878,41889541051.922783,22185230300.229989,29008245757.380194,93083017109.532966,3797732,998297,2122938,6918967
2017-01-26,EDGA Equities (J),79593737,35537768,38397816,153529321,2742479190.326892,1541880139.011900,1608223454.962099,5892582784.300891,693557,167524,329911,1190992
2017-01-26,EDGX Equities (K),198170403,91864888,154855402,444890693,7222156611.626731,3979327739.852789,6457868357.210110,17659352708.689630,1353463,328687,980117,2662267
2017-01-26,CHX (M),8495421,12898972,7229068,28623461,402137298.514500,1208989700.834200,574721290.398600,2185848289.747300,4120,4216,1920,10256
2017-01-26,NYSE (N),829197120,0,0,829197120,32554529622.053397,0.000000,0.000000,32554529622.053397,2782319,0,0,2782319
2017-01-26,NYSE Arca (P),233293112,288686787,146705331,668685230,9839718947.072899,13677451832.968118,8203804534.550899,31720975314.591916,1709236,736909,1074646,3520791
2017-01-26,NASDAQ (Q),391729012,111268485,449321985,952319482,17514471687.178062,5836434971.668695,23578437271.163787,46929343930.010544,3508454,460452,2990500,6959406
2017-01-26,IEX (V),81639395,17201988,40468067,139309450,3475087944.671300,880461937.426600,2256954189.543600,6612504071.641500,468587,68742,242376,779705
2017-01-26,NASDAQ PSX (X),25030485,19203249,22147716,66381450,881262804.465001,898059726.596199,936891793.272501,2716214324.333701,205550,90287,160584,456421
2017-01-26,BYX Equities (Y),146732536,62063017,71899328,280694881,4815289474.682259,2470384305.781100,2667414240.994505,9953088021.457864,1366413,282259,680372,2329044
2017-01-26,BZX Equities (Z),213817361,86994121,107033256,407844738,8077825183.384949,4340533150.656499,5125190796.356181,17543549130.397629,1800168,385776,912258,3098202
2017-01-25,NYSE American (A),0,13296490,0,13296490,0.000000,101696391.516900,0.000000,101696391.516900,0,25864,0,25864
2017-01-25,NASDAQ BX (B),96626907,32277709,53536445,182441061,3822921805.238707,1431029893.711801,2158455089.277899,7412406788.228407,956578,150693,523652,1630923
2017-01-25,NSX (C),521791,331228,341314,1194333,16864732.240000,39586887.960000,9056209.721800,65507829.921800,3424,1158,1985,6567
2017-01-25,NYSE (DN),126528778,48028276,71607514,246164568,4287935062.093397,1866382718.233398,3234466029.236301,9388783809.563096,292009,100038,174296,566343
2017-01-25,NASDAQ (DQ),1314874471,545832558,780018491,2640725520,47323987232.727122,26374545360.165433,29219302442.481107,102917835035.373662,3997929,1076174,2214759,7288862
2017-01-25,EDGA Equities (J),86558228,37087160,41303151,164948539,2897224758.192684,1851320645.132997,1581841773.544198,6330387176.869879,739219,180604,341970,1261793
2017-01-25,EDGX Equities (K),210048245,98885690,164920822,473854757,7587805358.490724,4669196817.360611,6518881842.967111,18775884018.818446,1386505,351243,998329,2736077
2017-01-25,CHX (M),9612411,22372746,5821232,37806389,417967412.975802,1357411523.115000,447753116.237900,2223132052.328702,5535,4626,1885,12046
2017-01-25,NYSE (N),879887222,0,0,879887222,34832857831.930511,0.000000,0.000000,34832857831.930511,2907228,0,0,2907228
2017-01-25,NYSE Arca (P),228737873,286183571,137562313,652483757,9659891808.900987,15231383353.838678,6553882862.461396,31445158025.201061,1661431,700123,978318,3339872
2017-01-25,NASDAQ (Q),405729974,115066547,454738775,975535296,17836771774.969881,6723557961.071698,21854257722.948553,46414587458.990132,3619220,476504,2970665,7066389
2017-01-25,IEX (V),86688030,18882996,42167759,147738785,3743847446.499206,992956585.524900,2099326908.923503,6836130940.947609,469120,74918,236016,780054
2017-01-25,NASDAQ PSX (X),25158366,19018821,20877276,65054463,878777403.499800,1008073997.507699,831958317.199800,2718809718.207299,203923,86748,156759,447430
2017-01-25,BYX Equities (Y),151946030,65675861,76543989,294165880,5024171856.914865,2750718088.833687,2690272197.780106,10465162143.528658,1400318,300379,694737,2395434
2017-01-25,BZX Equities (Z),226426314,91678743,114602788,432707845,8393745629.367325,5159627232.308998,4983459480.337987,18536832342.014310,1869890,407738,923251,3200879
2017-01-24,NYSE American (A),0,13760963,0,13760963,0.000000,90867276.466000,0.000000,90867276.466000,0,26997,0,26997
2017-01-24,NASDAQ BX (B),96958737,29204019,52009522,178172278,3584254252.933576,1228741815.526603,1987318629.697796,6800314698.157975,917563,148601,503675,1569839
2017-01-24,NSX (C),473105,241512,203066,917683,17486272.320000,21482436.832000,4831028.931600,43799738.083600,2877,957,1300,5134
2017-01-24,NYSE (DN),121515498,48307386,67117086,236939970,4019904084.992403,1759340035.323900,2778827715.612899,8558071835.929202,274807,93118,158061,525986
2017-01-24,NASDAQ (DQ),1302727394,591673231,695911746,2590312371,44315701824.970188,30258908665.408555,24743163006.404193,99317773496.782936,4060596,1083964,2084286,7228846
2017-01-24,EDGA Equities (J),86887043,33975017,37869569,158731629,2836802295.466507,1517048657.923903,1389111531.750702,5742962485.141112,742964,183053,318694,1244711
2017-01-24,EDGX Equities (K),205081482,97456425,150505290,453043197,7095263410.219135,4298595984.802504,5395429884.390685,16789289279.412324,1323617,357342,911096,2592055
2017-01-24,CHX (M),11104903,17682828,6426343,35214074,665502414.319100,1802486667.553200,376314038.804000,2844303120.676300,4472,4542,1959,10973
2017-01-24,NYSE (N),865060236,0,0,865060236,32579909357.686185,0.000000,0.000000,32579909357.686185,2776059,0,0,2776059
2017-01-24,NYSE Arca (P),234805372,284021512,128275139,647102023,9569612764.209733,14656318123.785614,5813514164.880284,30039445052.875631,1699988,774727,935801,3410516
2017-01-24,NASDAQ (Q),397021347,112626672,430294500,939942519,16960923740.193515,6084995832.119684,19386084789.195149,42432004361.508348,3427582,476878,2765016,6669476
2017-01-24,IEX (V),88932069,16629339,41308182,146869590,3590556319.905004,808711805.537800,1983389946.579803,6382658072.022607,484279,68841,225500,778620
2017-01-24,NASDAQ PSX (X),24090109,19451333,20224119,63765561,797184251.258999,906576337.459999,780174090.702599,2483934679.421597,185599,89257,141120,415976
2017-01-24,BYX Equities (Y),156182632,62139218,74287738,292609588,4814852332.757361,2366751376.700597,2476224560.765086,9657828270.223044,1383601,305293,683066,2371960
2017-01-24,BZX Equities (Z),226116073,88825379,104135024,419076476,7993243127.047650,4544338015.130194,4314538209.090586,16852119351.268430,1782901,407151,833398,3023450
2017-01-23,NYSE American (A),0,11064282,0,11064282,0.000000,65936234.118800,0.000000,65936234.118800,0,22247,0,22247
2017-01-23,NASDAQ BX (B),81939045,31540044,46646874,160125963,3134569351.688692,1341136603.879801,1869572136.449295,6345278092.017788,818439,151568,463160,1433167
2017-01-23,NSX (C),377384,361862,181270,920516,11977129.630000,29940198.815000,6152848.402400,48070176.847400,2744,651,1312,4707
2017-01-23,NYSE (DN),101311732,42336682,63243433,206891847,3462827053.430205,1648691857.014499,2694453230.505408,7805972140.950112,239362,87493,142408,469263
2017-01-23,NASDAQ (DQ),1034890979,608126540,618282298,2261299817,36847876945.622366,32979520945.274211,23351407064.818083,93178804955.714660,3428334,983023,1923412,6334769
2017-01-23,EDGA Equities (J),74652534,39458549,34887305,148998388,2462101015.415097,1683240597.471196,1351386827.377102,5496728440.263395,650294,183915,299324,1133533
2017-01-23,EDGX Equities (K),168920070,93229679,136370028,398519777,6205064285.727199,4209309880.759201,5531450762.771274,15945824929.257674,1173444,353786,877437,2404667
2017-01-23,CHX (M),12406139,13108780,5893618,31408537,620275077.679000,1027117788.760000,364391226.022400,2011784092.461400,3957,3560,1718,9235
2017-01-23,NYSE (N),754738916,0,0,754738916,28987401351.366999,0.000000,0.000000,28987401351.366999,2408259,0,0,2408259
2017-01-23,NYSE Arca (P),189654083,296839663,123461338,609955084,8050044219.242998,14716918870.791546,5983297753.182197,28750260843.216741,1449427,769616,902127,3121170
2017-01-23,NASDAQ (Q),327574794,111666780,412266741,851508315,14362628333.993763,6154710619.800010,20188164831.437630,40705503785.231403,2927026,469693,2646813,6043532
2017-01-23,IEX (V),67608223,18552332,33282230,119442785,2759214959.766297,882714325.838799,1594789730.395002,5236719016.000098,393733,68878,189926,652537
2017-01-23,NASDAQ PSX (X),20390176,18542992,16476410,55409578,727333035.555800,963297765.300000,741523767.368600,2432154568.224400,161218,83679,118457,363354
2017-01-23,BYX Equities (Y),136828061,67412937,66371185,270612183,4348432393.835093,2623891865.564501,2373528978.974205,9345853238.373799,1283959,318426,633761,2236146
2017-01-23,BZX Equities (Z),183952493,90770963,95011250,369734706,6728967045.689575,4696413127.245099,4231920630.557019,15657300803.491693,1516358,415023,791407,2722788
2017-01-20,NYSE American (A),0,11312252,0,11312252,0.000000,69423455.128900,0.000000,69423455.128900,0,22146,0,22146
2017-01-20,NASDAQ BX (B),83320107,30581215,47558445,161459767,3233228457.584108,1488532420.741600,1946485130.325905,6668246008.651613,801874,152293,462719,1416886
2017-01-20,NSX (C),328752,227998,230418,787168,10943185.610000,17053709.490000,13593249.570000,41590144.670000,2323,823,1010,4156
2017-01-20,NYSE (DN),96599401,41449984,59944726,197994111,3635918358.407097,1694555194.031606,2558088250.057702,7888561802.496405,232449,80597,139535,452581
2017-01-20,NASDAQ (DQ),1101530008,544204861,644056353,2289791222,39699804270.745134,30908751579.878166,23935608331.194604,94544164181.817904,3502744,967537,1852923,6323204
2017-01-20,EDGA Equities (J),78729366,37423378,36052218,152204962,2639055744.993309,1708969636.569600,1424858929.851200,5772884311.414109,668828,196941,296311,1162080
2017-01-20,EDGX Equities (K),182825506,105364504,140236880,428426890,7014402034.801619,4900099069.964489,5345723755.871097,17260224860.637205,1288984,395693,865040,2549717
2017-01-20,CHX (M),12896036,19162297,8705204,40763537,688754913.409500,1899818089.035000,787447188.977900,3376020191.422400,3919,4931,1712,10562
2017-01-20,NYSE (N),980773404,0,0,980773404,40047405881.594286,0.000000,0.000000,40047405881.594286,2574833,0,0,2574833
2017-01-20,NYSE Arca (P),214752097,322980722,126472435,664205254,9096949879.365798,17765985570.230092,5798893217.906605,32661828667.502495,1561793,811264,865208,3238265
2017-01-20,NASDAQ (Q),349668185,126150189,470576002,946394376,14926058875.152036,7772124626.320093,23079993673.833152,45778177175.305281,2991543,532496,2617906,6141945
2017-01-20,IEX (V),74491831,16963228,32746951,124202010,3060898099.048789,945969248.600500,1540228408.958202,5547095756.607491,413434,69012,193979,676425
2017-01-20,NASDAQ PSX (X),21101495,18798129,15307441,55207065,739608995.002801,1143253719.424700,712678472.850799,2595541187.278300,157739,82036,109984,349759
2017-01-20,BYX Equities (Y),137036570,67611931,69048498,273696999,4437151805.515710,2657791520.568804,2426674431.824706,9521617757.909220,1246478,327231,618020,2191729
2017-01-20,BZX Equities (Z),202805862,99249336,99405252,401460450,7454362393.440724,5542788016.709499,4499960217.894404,17497110628.044627,1617502,465867,801264,2884633
2017-01-19,NYSE American (A),0,11624415,0,11624415,0.000000,91730676.513400,0.000000,91730676.513400,0,22093,0,22093
2017-01-19,NASDAQ BX (B),85942277,31537071,50960887,168440235,3243614106.024776,1368429762.496599,1949391146.008199,6561435014.529574,864029,155222,498152,1517403
2017-01-19,NSX (C),455116,315568,190776,961460,16813854.720000,26811911.475100,6206728.683600,49832494.878700,2753,1321,1580,5654
2017-01-19,NYSE (DN),96969842,42558430,67267989,206796261,3470536533.042408,1569538476.955000,2510539317.471806,7550614327.469214,227404,85498,147192,460094
2017-01-19,NASDAQ (DQ),1021087947,506037659,709633546,2236759152,35822824627.295953,24047058169.144033,23002430298.345872,82872313094.785858,3451928,961209,2005453,6418590
2017-01-19,EDGA Equities (J),79615931,40708600,40835620,161160151,2668645171.487308,1754862126.116298,1423349985.651602,5846857283.255208,697376,200624,333539,1231539
2017-01-19,EDGX Equities (K),176142610,90225682,153067692,419435984,6697948684.089530,3858304152.661111,5416321842.772699,15972574679.523340,1331311,335209,921041,2587561
2017-01-19,CHX (M),15609019,14993892,6686088,37288999,604830710.478200,1055248361.420000,469186924.367800,2129265996.266000,3928,4014,1731,9673
2017-01-19,NYSE (N),755219268,0,0,755219268,28565186659.862242,0.000000,0.000000,28565186659.862242,2499776,0,0,2499776
2017-01-19,NYSE Arca (P),194264133,273514933,137130744,604909810,8303215798.144102,14141321854.195996,5906900899.752510,28351438552.092608,1508257,756900,931775,3196932
2017-01-19,NASDAQ (Q),327277920,113644468,418767214,859689602,13931204356.098662,6171990871.834613,18796451450.837308,38899646678.770583,2947907,475102,2653487,6076496
2017-01-19,IEX (V),70570946,16801402,32066132,119438480,3039968625.664007,833410540.786499,1476970576.831599,5350349743.282105,400158,68969,186660,655787
2017-01-19,NASDAQ PSX (X),20083969,16201144,16146550,52431663,684030496.526000,903988339.880400,610374024.104400,2198392860.510800,160727,73788,113978,348493
2017-01-19,BYX Equities (Y),127994992,63851773,70074276,261921041,4022867475.651966,2528403610.741995,2314764377.735909,8866035464.129870,1178678,302916,641542,2123136
2017-01-19,BZX Equities (Z),197162872,88828867,107079918,393071657,7403911114.660761,4532879535.310291,4456716374.351578,16393507024.322630,1633800,416949,834415,2885164
2017-01-18,NYSE American (A),0,12159592,0,12159592,0.000000,75384545.521200,0.000000,75384545.521200,0,22524,0,22524
2017-01-18,NASDAQ BX (B),91111632,29918230,50858019,171887881,3398155020.771628,1285550908.772700,1952425624.651196,6636131554.195524,925359,140771,505278,1571408
2017-01-18,NSX (C),439169,221519,316020,976708,14710041.580000,17434529.710000,7558123.961900,39702695.251900,3201,1045,1997,6243
2017-01-18,NYSE (DN),99469403,43294755,58220675,200984833,3564166807.072213,1566832548.992996,2117817965.866005,7248817321.931214,238993,87032,137340,463365
2017-01-18,NASDAQ (DQ),1109879030,457457520,645684743,2213021293,39003128228.679291,20041281856.886936,21275586893.984296,80319996979.550523,3575851,940368,1944771,6460990
2017-01-18,EDGA Equities (J),78280608,34574850,37739212,150594670,2500644822.260411,1475003036.023399,1277520041.232300,5253167899.516110,676073,175931,311062,1163066
2017-01-18,EDGX Equities (K),177745776,88327155,142858252,408931183,6475833698.244327,3784583073.396095,4866508271.347609,15126925042.988031,1263597,329890,850906,2444393
2017-01-18,CHX (M),9236388,14376499,6421048,30033935,342322592.193400,901056173.877600,424094095.168000,1667472861.239000,4190,3460,1751,9401
2017-01-18,NYSE (N),771140764,0,0,771140764,29509371874.554097,0.000000,0.000000,29509371874.554097,2542510,0,0,2542510
2017-01-18,NYSE Arca (P),206525786,274894278,129690817,611110881,8473410207.672473,13313661835.359454,5439226728.104382,27226298771.136309,1545461,719288,897660,3162409
2017-01-18,NASDAQ (Q),335847752,110638393,399028993,845515138,14267604775.656718,5698069446.705317,17759431136.811395,37725105359.173430,2981091,457737,2591543,6030371
2017-01-18,IEX (V),73048614,16684875,31330043,121063532,2927213325.462487,785526080.223400,1407531895.337702,5120271301.023589,413800,62487,185892,662179
2017-01-18,NASDAQ PSX (X),21120640,17135099,15125148,53380887,726484658.560000,858468652.524799,618771798.775400,2203725109.860199,167032,74186,114310,355528
2017-01-18,BYX Equities (Y),145597608,61111845,72481950,279191403,4541258613.574258,2302745446.251898,2408004686.429301,9252008746.255457,1337625,296110,668519,2302254
2017-01-18,BZX Equities (Z),198229245,84523637,96509264,379262146,7063632467.818221,4168612739.316598,3783234437.748404,15015479644.883223,1629800,388660,785480,2803940
2017-01-17,NYSE American (A),0,16134101,0,16134101,0.000000,117759851.411800,0.000000,117759851.411800,0,28017,0,28017
2017-01-17,NASDAQ BX (B),92914833,32208571,48067328,173190732,3465468003.977192,1360711705.714800,1892942334.047998,6719122043.739990,928325,152394,493624,1574343
2017-01-17,NSX (C),627129,395469,488422,1511020,20381751.750000,30160076.980000,10710865.238100,61252693.968100,4040,1876,2486,8402
2017-01-17,NYSE (DN),103744958,49184551,62317458,215246967,3599364220.143728,1764675363.931703,2338577655.802601,7702617239.878032,262505,95746,146326,504577
2017-01-17,NASDAQ (DQ),1176262843,511734531,664697381,2352694755,41272667872.556111,23521953208.588654,23103056391.142137,87897677472.286902,3769363,1035700,1982261,6787324
2017-01-17,EDGA Equities (J),82438514,37488317,38083689,158010520,2669952910.110995,1643673672.773597,1363711408.439102,5677337991.323694,711897,187898,317690,1217485
2017-01-17,EDGX Equities (K),195417645,99794683,154338574,449550902,7231696567.741176,4363117458.380903,5556086302.141299,17150900328.263378,1411172,373440,949126,2733738
2017-01-17,CHX (M),9432367,13380409,3011830,25824606,373473790.691800,1254109931.980000,229945050.171000,1857528772.842800,4400,3996,2072,10468
2017-01-17,NYSE (N),900659958,0,0,900659958,34521964502.527715,0.000000,0.000000,34521964502.527715,2761751,0,0,2761751
2017-01-17,NYSE Arca (P),220942107,348815549,128223776,697981432,8908854568.341296,16515459617.886225,5678726630.117181,31103040816.344702,1613408,817786,916436,3347630
2017-01-17,NASDAQ (Q),347605706,124584109,438778931,910968746,14535894651.295264,6621165322.366492,19636988293.129251,40794048266.791007,3079084,517966,2679441,6276491
2017-01-17,IEX (V),72000289,17521215,32332275,121853779,2891821961.384810,871929398.287099,1505050374.329602,5268801734.001511,421489,70439,191503,683431
2017-01-17,NASDAQ PSX (X),22257924,19164967,15800412,57223303,769427568.888700,1024840999.780000,685016000.740599,2479284569.409299,180196,84869,117420,382485
2017-01-17,BYX Equities (Y),152738549,66242168,74214204,293194921,4695186713.452242,2516876353.605004,2459864128.969394,9671927196.026640,1420648,310334,715244,2446226
2017-01-17,BZX Equities (Z),209916248,93183229,99092834,402192311,7496682074.582802,4676873264.694501,4079282297.596594,16252837636.873897,1754157,432343,819219,3005719
2017-01-13,NYSE American (A),0,11610318,0,11610318,0.000000,58255751.616500,0.000000,58255751.616500,0,22467,0,22467
2017-01-13,NASDAQ BX (B),79595206,26188176,43635653,149419035,2875167165.414103,1224280892.073798,1704715900.842399,5804163958.330300,783392,120331,433094,1336817
2017-01-13,NSX (C),391968,279253,204312,875533,14610657.020000,22123022.670000,6104529.674500,42838209.364500,2839,1068,1474,5381
2017-01-13,NYSE (DN),91884391,40437128,62260416,194581935,2986345085.335301,1569516969.441899,2461335485.835303,7017197540.612503,215956,75597,133137,424690
2017-01-13,NASDAQ (DQ),1017295062,428227693,628639844,2074162599,33599485372.634373,20280893936.056179,20465470438.630491,74345849747.321043,3206189,865470,1805527,5877186
2017-01-13,EDGA Equities (J),69613826,30418696,33504431,133536953,2204578708.178406,1411361959.781799,1173741354.763500,4789682022.723705,592304,145597,260821,998722
2017-01-13,EDGX Equities (K),175722843,87901921,144533769,408158533,6224588933.553482,3874995346.442102,5081333384.926979,15180917664.922563,1225562,341480,845196,2412238
2017-01-13,CHX (M),9047889,14094198,4746442,27888529,478260014.940200,1154296860.880000,394760490.407300,2027317366.227500,3686,4576,1768,10030
2017-01-13,NYSE (N),754340809,0,0,754340809,28534890563.420775,0.000000,0.000000,28534890563.420775,2308737,0,0,2308737
2017-01-13,NYSE Arca (P),200062523,256943617,121136700,578142840,7677126772.093365,13359195388.222010,5003949217.861703,26040271378.177078,1415246,695372,814251,2924869
2017-01-13,NASDAQ (Q),295357937,103989576,377828842,777176355,11818178322.134452,5902787094.147823,17233358944.551966,34954324360.834241,2569968,440716,2311206,5321890
2017-01-13,IEX (V),68712934,12140852,28680609,109534395,2623736324.254997,664536687.670900,1202487921.806199,4490760933.732096,376618,51619,168275,596512
2017-01-13,NASDAQ PSX (X),19709235,15004583,14345865,49059683,647760176.679100,816638919.690000,574979666.306900,2039378762.676000,152429,71056,103379,326864
2017-01-13,BYX Equities (Y),124501919,52342791,61643615,238488325,3697912041.667112,2070471461.164998,2067871095.655993,7836254598.488103,1112267,242920,540894,1896081
2017-01-13,BZX Equities (Z),184445509,78373652,90101825,352920986,6287912810.766874,4063920187.566700,3778052905.580996,14129885903.914570,1492941,366263,714149,2573353
2017-01-12,NYSE American (A),0,14513718,0,14513718,0.000000,72977654.214800,0.000000,72977654.214800,0,25668,0,25668
2017-01-12,NASDAQ BX (B),89243507,35201549,49103954,173549010,3179354903.651810,1570196072.569100,1832077997.836598,6581628974.057508,860558,162815,478226,1501599
2017-01-12,NSX (C),472395,306989,315364,1094748,13031534.780000,30894315.569500,5715388.402300,49641238.751800,3326,1038,1924,6288
2017-01-12,NYSE (DN),101473420,49368027,64299980,215141427,3337937848.340408,1837423965.184202,2405015495.733810,7580377309.258420,233952,91697,133039,458688
2017-01-12,NASDAQ (DQ),1118183367,534977282,682066563,2335227212,37084057391.908791,22477308701.052767,20658181787.090100,80219547880.051658,3607520,1051429,1921575,6580524
2017-01-12,EDGA Equities (J),84907614,40443525,41984609,167335748,2605489753.163606,1823698137.009302,1296603372.535601,5725791262.708509,726196,202672,320369,1249237
2017-01-12,EDGX Equities (K),205825344,119341225,182841677,508008246,7117404476.081808,5606184597.090793,5629961275.592199,18353550348.764800,1477702,473702,1002538,2953942
2017-01-12,CHX (M),13418319,14215351,2681808,30315478,581953593.574600,1097494446.035000,226081902.401800,1905529942.011400,5027,6067,2104,13198
2017-01-12,NYSE (N),798693791,0,0,798693791,28574435850.649806,0.000000,0.000000,28574435850.649806,2742410,0,0,2742410
2017-01-12,NYSE Arca (P),224174363,315483578,143281305,682939246,8616940394.155554,16542823211.678434,5824407324.454668,30984170930.288656,1667929,912360,932560,3512849
2017-01-12,NASDAQ (Q),354618062,130647499,420073920,905339481,14077076050.987564,7443192936.504824,17430911011.527509,38951179999.019897,3108661,560575,2632267,6301503
2017-01-12,IEX (V),88818116,18560111,31207498,138585725,3469223667.788294,976713902.449300,1371072302.557701,5817009872.795295,464835,72759,185353,722947
2017-01-12,NASDAQ PSX (X),22714301,18542970,16930454,58187725,756692250.265000,1037950319.227002,681550134.154000,2476192703.646002,177074,83456,115759,376289
2017-01-12,BYX Equities (Y),144963260,69871289,69984981,284819530,4294318019.820663,2757320110.211501,2312847836.702298,9364485966.734462,1281215,323143,639888,2244246
2017-01-12,BZX Equities (Z),218716252,101127570,101073196,420917018,7442517275.352264,5525978971.793679,4023428715.657882,16991924962.803825,1748100,484637,792814,3025551
2017-01-11,NYSE American (A),0,16912958,0,16912958,0.000000,77302972.970500,0.000000,77302972.970500,0,30419,0,30419
2017-01-11,NASDAQ BX (B),90637915,36360701,51651314,178649930,3379093090.430195,1548556834.649999,1942680782.752995,6870330707.833189,875000,170335,505106,1550441
2017-01-11,NSX (C),577770,380479,349737,1307986,17384522.790000,24086360.850100,9770606.261500,51241489.901600,4212,1570,2693,8475
2017-01-11,NYSE (DN),99377993,56905953,70728927,227012873,3360318965.458713,1937075980.293904,2624984055.944910,7922379001.697527,254864,98325,161269,514458
2017-01-11,NASDAQ (DQ),1154946989,588365656,756782614,2500095259,39782715004.333261,25933433443.383376,23667467627.452869,89383616075.169506,3605193,1033532,2081723,6720448
2017-01-11,EDGA Equities (J),87734997,47526549,42649878,177911424,2748590316.367696,2030236868.672399,1451483652.333500,6230310837.373595,750022,226176,365578,1341776
2017-01-11,EDGX Equities (K),209965794,135320559,182755020,528041373,7607606744.568667,5737648277.971877,6129839945.126191,19475094967.666735,1521624,520102,1146376,3188102
2017-01-11,CHX (M),7850050,12560332,3462217,23872599,467821335.015000,956406136.180000,259318165.975400,1683545637.170400,4917,4509,1909,11335
2017-01-11,NYSE (N),891877929,0,0,891877929,32379713230.845246,0.000000,0.000000,32379713230.845246,2965177,0,0,2965177
2017-01-11,NYSE Arca (P),232206949,371767352,152004685,755978986,9319598642.880889,18155554446.562035,6450937195.735868,33926090285.178792,1755439,1052723,1066844,3875006
2017-01-11,NASDAQ (Q),379385500,155814195,459969932,995169627,15754664384.015713,8087105094.066235,20323169030.327993,44164938508.409941,3359378,647422,3079397,7086197
2017-01-11,IEX (V),74190467,18033734,35824522,128048723,2966886953.436096,992333514.034400,1387862254.855598,5347082722.326094,419856,75848,211285,706989
2017-01-11,NASDAQ PSX (X),25826684,23546923,19018328,68391935,921094959.363200,1231127239.285201,795305218.484700,2947527417.133101,203939,103506,140903,448348
2017-01-11,BYX Equities (Y),146039242,73832140,75586076,295457458,4331621731.827033,2815442980.658792,2449036450.765898,9596101163.251723,1263810,336812,734831,2335453
2017-01-11,BZX Equities (Z),224471112,116756006,110052519,451279637,7667692383.725519,6160429786.147709,4544152391.162729,18372274561.035957,1793113,556700,935398,3285211
2017-01-10,NYSE American (A),0,17993215,0,17993215,0.000000,74379902.082400,0.000000,74379902.082400,0,28220,0,28220
2017-01-10,NASDAQ BX (B),98123051,31211996,54320203,183655250,3560244796.773600,1218523998.207301,2082401360.521302,6861170155.502203,951580,156445,546475,1654500
2017-01-10,NSX (C),687808,454073,326757,1468638,22235226.980000,19607757.401700,9026390.946000,50869375.327700,4560,1494,2224,8278
2017-01-10,NYSE (DN),102060932,43851815,59044884,204957631,3272226414.213088,1428884228.753799,2228078118.533899,6929188761.500786,246061,86068,149944,482073
2017-01-10,NASDAQ (DQ),1164665309,471998156,662096318,2298759783,38829818797.597101,19697196859.850079,22520699143.253654,81047714800.700834,3711724,952142,2026541,6690407
2017-01-10,EDGA Equities (J),85731858,37952808,40658130,164342796,2750022206.336914,1494101581.265997,1445526109.876297,5689649897.479208,744501,172203,345681,1262385
2017-01-10,EDGX Equities (K),199933995,104284344,159427093,463645432,7128448220.333507,3965306212.673801,5906282941.740834,17000037374.748142,1443177,373826,1024205,2841208
2017-01-10,CHX (M),13604483,25799139,8577498,47981120,618689470.125900,2893261025.332700,574186285.319700,4086136780.778300,4761,7125,2263,14149
2017-01-10,NYSE (N),930070352,0,0,930070352,34634437218.221013,0.000000,0.000000,34634437218.221013,2734867,0,0,2734867
2017-01-10,NYSE Arca (P),228281609,295902496,129928891,654112996,9122239937.132889,13405552422.300687,5600292127.658901,28128084487.092477,1704992,739673,965349,3410014
2017-01-10,NASDAQ (Q),348977538,112755929,450314999,912048466,14252262977.443505,5616383832.753498,19968589443.548849,39837236253.745852,3069633,444792,2839930,6354355
2017-01-10,IEX (V),83916071,15132045,36068405,135116521,3145630294.903998,707562960.594800,1644445410.838197,5497638666.336995,461083,60757,217574,739414
2017-01-10,NASDAQ PSX (X),22886082,18404679,18059161,59349922,752638470.460600,854392866.940300,693258176.677399,2300289514.078299,179230,79125,130089,388444
2017-01-10,BYX Equities (Y),152063140,59866929,76264503,288194572,4633420043.907916,2176422217.702496,2552314615.565198,9362156877.175610,1374854,272947,721724,2369525
2017-01-10,BZX Equities (Z),209565624,83502421,103526758,396594803,7190887108.070668,3861863016.527312,4128289789.194002,15181039913.791982,1708637,387748,848082,2944467
2017-01-09,NYSE American (A),0,21868448,0,21868448,0.000000,78225150.359600,0.000000,78225150.359600,0,26713,0,26713
2017-01-09,NASDAQ BX (B),91917306,29434091,53591474,174942871,3399585392.340093,1118409162.929799,2038126350.687995,6556120905.957887,917176,152542,507371,1577089
2017-01-09,NSX (C),547614,348694,281042,1177350,19161003.730000,24588329.727700,7729231.363100,51478564.820800,4317,1173,2227,7717
2017-01-09,NYSE (DN),89964095,46378964,65796712,202139771,2932941882.810520,1466849649.145701,2748088521.143410,7147880053.099631,225801,79871,167934,473606
2017-01-09,NASDAQ (DQ),1029207293,523838235,733564018,2286609546,35525469779.165336,19129246398.991159,26148775411.260773,80803491589.417268,3522687,981842,2108286,6612815
2017-01-09,EDGA Equities (J),78872737,39753962,40456200,159082899,2619437010.884798,1337640306.859804,1455879830.210396,5412957147.954998,698562,179986,331085,1209633
2017-01-09,EDGX Equities (K),174679193,112085577,161899347,448664117,6267406203.639039,3731863006.456709,5757260620.327063,15756529830.422811,1263458,371373,957424,2592255
2017-01-09,CHX (M),5676203,12595673,4124622,22396498,303980450.538200,798875994.930000,266123566.948900,1368980012.417100,3681,4214,1594,9489
2017-01-09,NYSE (N),821852341,0,0,821852341,31104253864.616549,0.000000,0.000000,31104253864.616549,2543050,0,0,2543050
2017-01-09,NYSE Arca (P),194452417,273829159,144138377,612419953,7846802472.591408,12125317879.283846,6250701923.173270,26222822275.048524,1522545,741695,955805,3220045
2017-01-09,NASDAQ (Q),328417220,110056959,453839333,892313512,13373752655.953684,5220914087.863710,20664677105.588730,39259343849.406124,2961382,451810,2713456,6126648
2017-01-09,IEX (V),62258086,14132677,33465422,109856185,2470773528.664803,658740394.465399,1508239674.777400,4637753597.907602,397154,61846,205293,664293
2017-01-09,NASDAQ PSX (X),20686427,15465725,20713158,56865310,708833555.599700,719181754.433100,692697507.638300,2120712817.671100,173145,73030,126301,372476
2017-01-09,BYX Equities (Y),134973305,57868108,74163190,267004603,4212901668.351471,2033588564.882502,2478063104.580391,8724553337.814364,1244850,273848,670243,2188941
2017-01-09,BZX Equities (Z),186235132,81309996,101709860,369254988,6293288439.772241,3712607049.995905,4136122671.115186,14142018160.883332,1514524,381150,796514,2692188
2017-01-06,NYSE American (A),0,13811240,0,13811240,0.000000,71199738.247700,0.000000,71199738.247700,0,27641,0,27641
2017-01-06,NASDAQ BX (B),95630582,35698125,48890232,180218939,3578606694.247898,1343848437.829597,2021495059.573202,6943950191.650697,929015,178718,495019,1602752
2017-01-06,NSX (C),665356,258934,302150,1226440,22804192.008200,27674023.250000,6096358.382400,56574573.640600,3557,1140,1927,6624
2017-01-06,NYSE (DN),97354658,45765574,61837878,204958110,3258374338.341811,1541442521.997502,2881292046.691199,7681108907.030512,238811,89279,147091,475181
2017-01-06,NASDAQ (DQ),1137068571,520686185,664098955,2321853711,37943309791.137644,21764521629.388957,25142538399.385506,84850369819.912107,3672385,1132816,2006152,6811353
2017-01-06,EDGA Equities (J),84243106,36977521,37751368,158971995,2639961904.972805,1530041674.596598,1518132951.203698,5688136530.773101,719163,198769,324035,1241967
2017-01-06,EDGX Equities (K),179369602,106629818,147627102,433626522,6181548849.446882,4567826554.583123,5780974634.326528,16530350038.356533,1262134,412948,924145,2599227
2017-01-06,CHX (M),7392018,11905877,3606651,22904546,397050286.768400,1086941967.842800,301304363.903600,1785296618.514800,3128,3873,1117,8118
2017-01-06,NYSE (N),769438418,0,0,769438418,27984518091.261828,0.000000,0.000000,27984518091.261828,2531408,0,0,2531408
2017-01-06,NYSE Arca (P),207358540,326521390,129664149,663544079,8228213664.197585,15561931444.589166,6426679075.883602,30216824184.670353,1579764,801896,943470,3325130
2017-01-06,NASDAQ (Q),332006783,121096469,403504466,856607718,13520427643.886754,6025332868.578406,19201280725.677623,38747041238.142783,2950611,498969,2674329,6123909
2017-01-06,IEX (V),68028484,17599313,31052636,116680433,2747568922.310096,800691979.711699,1607617917.420200,5155878819.441995,401237,75773,189768,666778
2017-01-06,NASDAQ PSX (X),20864225,18467711,16560500,55892436,723571177.343598,909822565.566799,677837967.176000,2311231710.086397,172451,86254,120796,379501
2017-01-06,BYX Equities (Y),141192528,65272300,66978473,273443301,4334485037.503929,2351552687.234605,2357781571.614190,9043819296.352724,1272260,307171,630053,2209484
2017-01-06,BZX Equities (Z),201474922,91342394,99997607,392814923,6908037937.034794,4574604263.230416,4520915570.918911,16003557771.184121,1623184,425532,813993,2862709
2017-01-05,NYSE American (A),0,17155683,0,17155683,0.000000,99524050.986400,0.000000,99524050.986400,0,28718,0,28718
2017-01-05,NASDAQ BX (B),104355564,43658606,50332818,198346988,3780179610.878600,1573190352.575699,1982834126.539993,7336204089.994292,1006531,203998,509846,1720375
2017-01-05,NSX (C),456437,250272,268177,974886,14400285.080000,25338818.815600,7217401.252600,46956505.148200,3454,907,1771,6132
2017-01-05,NYSE (DN),107302887,56934139,62840119,227077145,3640178672.187308,1795992574.570198,2596779360.780604,8032950607.538110,252489,110803,150993,514285
2017-01-05,NASDAQ (DQ),1238178069,650841288,676942636,2565961993,41858725955.624760,28169686656.761774,24002954924.060705,94031367536.447239,3987293,1246555,2045548,7279396
2017-01-05,EDGA Equities (J),90717382,49617500,38703696,179038578,2836768915.106793,1924642965.510100,1481812633.314199,6243224513.931092,794509,234080,342159,1370748
2017-01-05,EDGX Equities (K),204349032,122519869,149399917,476268818,7143512157.090619,4756239036.075995,5691308759.121985,17591059952.288599,1458326,451975,978169,2888470
2017-01-05,CHX (M),10377029,14053836,4213414,28644279,494167189.458200,1004532077.390000,333652678.106600,1832351944.954800,4056,5484,1257,10797
2017-01-05,NYSE (N),926629292,0,0,926629292,33714411272.527449,0.000000,0.000000,33714411272.527449,2946810,0,0,2946810
2017-01-05,NYSE Arca (P),241438150,372732689,143030248,757201087,9622392694.605585,17589610307.165164,6360783925.912923,33572786927.683672,1850339,921062,1031772,3803173
2017-01-05,NASDAQ (Q),386876909,135783841,449612039,972272789,15666202946.198318,6590569310.190513,20353791521.642978,42610563778.031809,3431619,548317,2835221,6815157
2017-01-05,IEX (V),75097765,22239267,33052625,130389657,2976008503.045899,996678603.205500,1711328824.284499,5684015930.535898,441223,89838,199695,730756
2017-01-05,NASDAQ PSX (X),25085595,20691153,17948703,63725451,852307919.276200,971422099.642499,694632547.957100,2518362566.875799,208098,95179,134627,437904
2017-01-05,BYX Equities (Y),157378488,82899682,71418263,311696433,4756877226.180800,2873740347.508191,2439674293.900793,10070291867.589784,1446692,364786,680443,2491921
2017-01-05,BZX Equities (Z),216843429,104494409,101410648,422748486,7431507709.424324,4985938286.834315,4345810189.477109,16763256185.735748,1806005,469682,852307,3127994
2017-01-04,NYSE American (A),0,17069884,0,17069884,0.000000,104950658.112200,0.000000,104950658.112200,0,27827,0,27827
2017-01-04,NASDAQ BX (B),108209691,35814765,55522621,199547077,3927837125.700488,1598649760.129498,2160829022.654997,7687315908.484983,1081468,181375,579203,1842046
2017-01-04,NSX (C),573107,393721,345998,1312826,18301035.300000,51451778.345900,10053615.278500,79806428.924400,4374,1259,2639,8272
2017-01-04,NYSE (DN),104079896,52595514,65706189,222381599,3466472901.551815,2007107522.452197,2614202091.119600,8087782515.123612,255271,100534,163935,519740
2017-01-04,NASDAQ (DQ),1231369769,579311646,698836360,2509517775,40309128933.589959,27691091174.774347,24395178991.136220,92395399099.500526,4027183,1117376,2183086,7327645
2017-01-04,EDGA Equities (J),88120076,39197386,40884917,168202379,2762995228.233602,1718769598.675599,1419247995.890998,5901012822.800199,790022,194110,356743,1340875
2017-01-04,EDGX Equities (K),203516520,111947400,159444238,474908158,7171565978.368211,5458842544.505590,5644040896.206394,18274449419.080195,1498882,436651,1043171,2978704
2017-01-04,CHX (M),6733181,14603288,2712169,24048638,403850210.072400,1149404574.412600,201175706.545300,1754430491.030300,3829,5277,1167,10273
2017-01-04,NYSE (N),945175765,0,0,945175765,34929237488.470430,0.000000,0.000000,34929237488.470430,2948329,0,0,2948329
2017-01-04,NYSE Arca (P),228590353,301978688,139708340,670277381,9054184006.211103,15943959570.171204,5969078174.363096,30967221750.745403,1806259,836629,1054135,3697023
2017-01-04,NASDAQ (Q),384067622,133031358,484998893,1002097873,15669942051.466842,7448005346.648098,21570929069.317652,44688876467.432592,3492423,532373,3005018,7029814
2017-01-04,IEX (V),71253349,19997569,33177515,124428433,2746818179.712301,1084248090.630101,1565323449.045200,5396389719.387602,428042,80289,200022,708353
2017-01-04,NASDAQ PSX (X),24587571,20880418,18656838,64124827,839784087.211999,1079321496.051300,712354728.450400,2631460311.713699,211271,99855,143809,454935
2017-01-04,BYX Equities (Y),156346092,66688959,77628526,300663577,4808336759.913702,2639605740.388401,2614973107.940508,10062915608.242611,1490964,313016,764328,2568308
2017-01-04,BZX Equities (Z),216273729,98993805,107871782,423139316,7384618813.723960,5454623912.049911,4334560429.544319,17173803155.318190,1844329,459237,933105,3236671
2017-01-03,NYSE American (A),0,17141781,0,17141781,0.000000,104848697.401800,0.000000,104848697.401800,0,28145,0,28145
2017-01-03,NASDAQ BX (B),98612362,43877356,56649492,199139210,3590961353.396217,1867193893.516902,2131082184.308298,7589237431.221417,968081,204515,554768,1727364
2017-01-03,NSX (C),451702,422558,267302,1141562,18021597.700000,27007079.832900,7706214.821200,52734892.354100,3650,1532,1577,6759
2017-01-03,NYSE (DN),110137726,59837952,66078109,236053787,3662893382.413421,2273322917.542105,2545509009.843801,8481725309.799327,263471,120436,171630,555537
2017-01-03,NASDAQ (DQ),1154290720,698206658,689798499,2542295877,39165922832.951223,31624453285.156368,23194211101.848020,93984587219.955611,3887666,1248780,2154406,7290852
2017-01-03,EDGA Equities (J),89015175,57697501,42173396,188886072,2782856433.355405,2371666538.111699,1497439795.588001,6651962767.055105,786508,239437,360626,1386571
2017-01-03,EDGX Equities (K),212973895,130281568,160876759,504132222,7655317362.269968,5763101311.543095,6061658355.987276,19480077029.800339,1689383,487398,1128906,3305687
2017-01-03,CHX (M),14427409,14420799,3270407,32118615,474055283.870500,1178506433.330000,215354999.402200,1867916716.602700,3112,7355,899,11366
2017-01-03,NYSE (N),987308310,0,0,987308310,36420672710.786752,0.000000,0.000000,36420672710.786752,3260988,0,0,3260988
2017-01-03,NYSE Arca (P),233289934,416347320,143970039,793607293,9167387279.441078,20655183912.418378,6532665514.076192,36355236705.935648,1856053,991603,1098688,3946344
2017-01-03,NASDAQ (Q),406015076,158435297,480530814,1044981187,16137540000.140232,8981541642.858827,21708262963.521710,46827344606.520769,3602296,624923,3107081,7334300
2017-01-03,IEX (V),71233441,24809221,34153071,130195733,2736058157.110002,1173775824.696300,1463352937.888298,5373186919.694600,431796,97603,201294,730693
2017-01-03,NASDAQ PSX (X),25241987,25051799,20181297,70475083,881103471.294904,1351799605.844001,777069178.858200,3009972255.997105,217040,106603,151250,474893
2017-01-03,BYX Equities (Y),150710964,86160318,78949258,315820540,4669460629.441932,3235695272.256106,2628212379.274806,10533368280.972844,1421697,379838,743646,2545181
2017-01-03,BZX Equities (Z),219303963,120633420,110772510,450709893,7524063913.438972,6420878824.810462,4721690544.851712,18666633283.101146,1859418,534415,940813,3334646
