Day,Market Participant,Tape A Shares,Tape B Shares,Tape C Shares,Total Shares,Tape A Notional,Tape B Notional,Tape C Notional,Total Notional,Tape A Trade Count,Tape B Trade Count,Tape C Trade Count,Total Trade Count
2016-12-30,NYSE MKT (A),0,15345457,0,15345457,0.000000,104080060.410700,0.000000,104080060.410700,0,23606,0,23606
2016-12-30,NASDAQ BX (B),73586801,35365488,45415078,154367367,2581741734.262505,1635926246.588799,1633961611.861301,5851629592.712605,722416,173304,422018,1317738
2016-12-30,NSX (C),344361,266169,197563,808093,10834184.320000,14257768.725700,5529341.881800,30621294.927500,2595,1209,1457,5261
2016-12-30,NYSE (DN),65598113,53673951,53239448,172511512,1892493069.930103,1818892189.362306,1749736221.560498,5461121480.852907,172252,90126,125006,387384
2016-12-30,NASDAQ (DQ),797960709,565436866,555090022,1918487597,24274181061.668591,25353826213.623891,19386011959.741733,69014019235.034215,2653642,1077925,1565109,5296676
2016-12-30,EDGA (J),63193984,38181083,34145856,135520923,1968536186.242094,2000205356.892205,1174040993.405602,5142782536.539901,543997,184560,269553,998110
2016-12-30,EDGX (K),140607393,110150676,139849220,390607289,4614775591.854078,5179703203.904596,5217646990.268909,15012125786.027583,1006390,395353,822412,2224155
2016-12-30,CHX (M),8236031,11629107,2987973,22853111,381000554.627800,1107870443.775200,288057601.692500,1776928600.095500,2949,3806,1049,7804
2016-12-30,NYSE (N),803620106,0,0,803620106,30891290901.104357,0.000000,0.000000,30891290901.104357,2233132,0,0,2233132
2016-12-30,NYSE Arca (P),151256428,337619014,113120730,601996172,5741528801.024187,17106492875.705037,5136023509.181294,27984045185.910518,1173195,811815,780183,2765193
2016-12-30,NASDAQ (Q),250760323,126793928,420209800,797764051,9659446048.042486,7528435541.874777,19476248677.386113,36664130267.303376,2256802,486807,2199703,4943312
2016-12-30,IEX (V),37114743,18249684,20690194,76054621,1388507998.332802,1017150319.082399,864436709.519700,3270095026.934901,252732,76863,132421,462016
2016-12-30,NASDAQ PSX (X),15269268,18464875,16272374,50006517,509539668.182400,998952507.778701,599579628.439200,2108071804.400301,120706,88352,103958,313016
2016-12-30,BATS BYX (Y),115195556,71083050,62072842,248351448,3622763750.669321,2728087049.805913,2032352024.416698,8383202824.891932,1074636,318491,556766,1949893
2016-12-30,BATS BZX (Z),148809503,101655037,88407611,338872151,4804085105.660687,6141895795.226076,3812658529.997515,14758639430.884278,1238572,438308,683908,2360788
2016-12-29,NYSE MKT (A),0,12639399,0,12639399,0.000000,66453615.053900,0.000000,66453615.053900,0,25983,0,25983
2016-12-29,NASDAQ BX (B),68885830,30843450,40627600,140356880,2477520251.644595,1196507537.355798,1564483708.682198,5238511497.682591,706229,148250,405337,1259816
2016-12-29,NSX (C),391327,212052,254761,858140,9751032.850000,7695746.366000,5199689.666200,22646468.882200,2525,800,1760,5085
2016-12-29,NYSE (DN),65691127,49061683,50272341,165025151,1919459087.358911,1602726006.331397,1662375883.776499,5184560977.466807,162572,81870,109983,354425
2016-12-29,NASDAQ (DQ),736877316,546161498,469062594,1752101408,21475142003.245859,20425284746.702690,14793171929.371365,56693598679.319914,2594123,995353,1471201,5060677
2016-12-29,EDGA (J),57350446,34033737,26900353,118284536,1697773446.396200,1326752080.795206,861599837.251700,3886125364.443106,498791,164574,225552,888917
2016-12-29,EDGX (K),130797228,95702509,117082541,343582278,4276440298.833099,3523127500.051802,4013564549.552405,11813132348.437306,928455,338281,703004,1969740
2016-12-29,CHX (M),11332167,8444969,2375565,22152701,296493344.628000,665372537.372500,195230707.619500,1157096589.620000,2913,3451,808,7172
2016-12-29,NYSE (N),593220150,0,0,593220150,20937222951.041041,0.000000,0.000000,20937222951.041041,1999215,0,0,1999215
2016-12-29,NYSE Arca (P),140777486,290027384,97638419,528443289,5395590846.841382,12311868261.726980,4225229564.200404,21932688672.768766,1112466,667446,702016,2481928
2016-12-29,NASDAQ (Q),235951054,106108337,306290236,648349627,9223792288.045519,4901277508.913805,13392962659.440032,27518032456.399356,2164201,409791,1901247,4475239
2016-12-29,IEX (V),40152261,16821294,19276442,76249997,1532428915.481104,742826026.210800,763516640.473099,3038771582.165003,255373,71047,126426,452846
2016-12-29,NASDAQ PSX (X),16220765,18822935,12991720,48035420,533920581.475300,817927587.198800,488385449.670000,1840233618.344100,127023,78637,93660,299320
2016-12-29,BATS BYX (Y),103118239,65912496,52880565,221911300,3133291308.123802,2244519473.977200,1659298048.162797,7037108830.263799,960255,274748,489827,1724830
2016-12-29,BATS BZX (Z),137941126,78259183,70699392,286899701,4495618243.599116,3662573963.963394,2824294988.514593,10982487196.077103,1175070,343425,583568,2102063
2016-12-28,NYSE MKT (A),0,11553660,0,11553660,0.000000,58397912.755600,0.000000,58397912.755600,0,24255,0,24255
2016-12-28,NASDAQ BX (B),63645972,24634239,38845740,127125951,2324901834.215205,1049287600.118000,1465439514.685296,4839628949.018501,650027,122648,391583,1164258
2016-12-28,NSX (C),414274,195522,213754,823550,10187918.430000,9163768.870900,5396514.040000,24748201.340900,2743,915,1603,5261
2016-12-28,NYSE (DN),63086618,44755295,54811290,162653203,1880231575.777805,1553150329.321497,2095933405.845199,5529315310.944501,161325,78606,122403,362334
2016-12-28,NASDAQ (DQ),768289385,443038725,484124568,1695452678,22536746353.335392,18783459262.459160,16475289284.529622,57795494900.324174,2578960,882509,1563819,5025288
2016-12-28,EDGA (J),57946304,28713755,29163599,115823658,1807800121.975693,1249672779.092098,974369561.073700,4031842462.141491,511359,137974,245424,894757
2016-12-28,EDGX (K),134768192,80415671,127992938,343176801,4484311562.315087,3568163770.138892,4750104170.782384,12802579503.236363,947614,295617,769819,2013050
2016-12-28,CHX (M),10748207,9196798,6408623,26353628,483764314.180000,825592707.075000,375554803.635000,1684911824.890000,3094,3165,828,7087
2016-12-28,NYSE (N),622763546,0,0,622763546,21954813583.977817,0.000000,0.000000,21954813583.977817,2070816,0,0,2070816
2016-12-28,NYSE Arca (P),144848986,253784537,108741049,507374572,5273157696.522516,12954848735.904420,4879911784.003090,23107918216.430026,1101994,616630,751836,2470460
2016-12-28,NASDAQ (Q),245422267,89871063,312267576,647560906,9494854585.407286,5205120996.539195,14173468403.615561,28873443985.562042,2222108,365314,2030146,4617568
2016-12-28,IEX (V),40477702,14108201,20773966,75359869,1577647819.899800,767696231.094101,905566527.348201,3250910578.342102,248839,56738,135323,440900
2016-12-28,NASDAQ PSX (X),15112190,17301994,13040663,45454847,542238101.494201,835727142.863500,511189840.488400,1889155084.846101,132847,74509,95770,303126
2016-12-28,BATS BYX (Y),103446146,53361665,57518100,214325911,3168586136.070384,1960729918.179900,1906420481.539208,7035736535.789492,962529,234406,537393,1734328
2016-12-28,BATS BZX (Z),131784347,65674334,72759220,270217901,4207190808.002602,3586370594.550002,3069343910.974391,10862905313.526995,1090572,300956,598511,1990039
2016-12-27,NYSE MKT (A),0,10548275,0,10548275,0.000000,48769218.294400,0.000000,48769218.294400,0,19476,0,19476
2016-12-27,NASDAQ BX (B),52467040,18790200,32139630,103396870,1823639391.845988,830592703.000999,1188950079.098802,3843182173.945789,548638,98395,324451,971484
2016-12-27,NSX (C),368098,80671,216487,665256,9081110.550000,4976537.590000,6542631.178000,20600279.318000,2804,425,1748,4977
2016-12-27,NYSE (DN),59995548,37851995,46929889,144777432,1754952315.868806,1283220153.798200,1760476154.273696,4798648623.940702,151953,68324,110016,330293
2016-12-27,NASDAQ (DQ),676058619,393033487,476669595,1545761701,20273652446.268932,16299169750.792634,14983376255.580154,51556198452.641720,2390275,827623,1496810,4714708
2016-12-27,EDGA (J),44271165,21601309,25520410,91392884,1332104239.289899,957899425.950196,833419564.651199,3123423229.891294,404524,108982,206188,719694
2016-12-27,EDGX (K),113394139,63897677,119802051,297093867,3639050869.170107,2710038723.268499,3962150483.337114,10311240075.775720,778874,226486,665849,1671209
2016-12-27,CHX (M),4174604,5039547,2315979,11530130,254708707.326000,433514703.904800,137615147.726700,825838558.957500,2039,2712,905,5656
2016-12-27,NYSE (N),498449368,0,0,498449368,17274252552.010382,0.000000,0.000000,17274252552.010382,1683188,0,0,1683188
2016-12-27,NYSE Arca (P),115977296,213713192,91600202,421290690,4197104794.029010,9981552223.144787,3859883266.877106,18038540284.050903,859605,444298,622452,1926355
2016-12-27,NASDAQ (Q),195158604,70196951,283742932,549098487,7652149499.877620,3785998644.557402,12268438735.210145,23706586879.645167,1783735,272103,1779586,3835424
2016-12-27,IEX (V),32237592,11507889,17576530,61322011,1152192882.261102,549449222.680199,712771208.564000,2414413313.505301,208251,47472,113025,368748
2016-12-27,NASDAQ PSX (X),12316923,13048704,11345571,36711198,397446037.379000,625244151.804201,460072567.814700,1482762756.997901,102308,59812,86801,248921
2016-12-27,BATS BYX (Y),81212609,39306295,46079452,166598356,2465784093.464429,1462046824.374197,1501233289.755597,5429064207.594223,802998,177754,445304,1426056
2016-12-27,BATS BZX (Z),103652155,49855127,65120796,218628078,3356014406.815738,2707690333.126000,2595041497.092696,8658746237.034434,907695,225346,523574,1656615
2016-12-23,NYSE MKT (A),0,10464766,0,10464766,0.000000,48032084.550400,0.000000,48032084.550400,0,21004,0,21004
2016-12-23,NASDAQ BX (B),56205526,18667717,33823283,108696526,2077194699.343794,767889248.480901,1194379736.590300,4039463684.414995,570082,94345,347398,1011825
2016-12-23,NSX (C),309601,198202,221518,729321,9571021.610900,10949531.780000,6270371.619700,26790925.010600,2275,1016,1514,4805
2016-12-23,NYSE (DN),62221652,31973768,41481238,135676658,1942748476.386009,981199243.555898,1373645132.734499,4297592852.676406,155421,57213,99704,312338
2016-12-23,NASDAQ (DQ),658228850,349269101,436256148,1443754099,20073988404.837729,13770024206.878097,12803459194.057445,46647471805.773271,2244902,682558,1309736,4237196
2016-12-23,EDGA (J),48323577,20182386,25403281,93909244,1469423419.625601,830963419.173701,776481753.766099,3076868592.565401,420761,101895,206281,728937
2016-12-23,EDGX (K),111893749,62705719,111135628,285735096,3712634850.484787,2399548259.527600,3406236722.739102,9518419832.751489,785621,217791,642638,1646050
2016-12-23,CHX (M),3776954,15385241,1352755,20514950,146745577.088500,1057224150.730000,116826112.489500,1320795840.308000,2377,2710,779,5866
2016-12-23,NYSE (N),514990304,0,0,514990304,18585971183.905934,0.000000,0.000000,18585971183.905934,1717628,0,0,1717628
2016-12-23,NYSE Arca (P),118636070,183099522,82848269,384583861,4501915798.113107,8403964270.011333,3163124160.583889,16069004228.708329,903573,428604,580000,1912177
2016-12-23,NASDAQ (Q),200504347,66552893,275596069,542653309,7797861735.738800,3418094424.279805,11171804317.972832,22387760477.991437,1793913,252081,1658081,3704075
2016-12-23,IEX (V),33586145,10079736,16829888,60495769,1280592955.938296,421948482.593101,666342485.206700,2368883923.738097,215025,40881,108949,364855
2016-12-23,NASDAQ PSX (X),13591488,13508617,11147367,38247472,427317529.853499,596266176.356000,417596761.001100,1441180467.210599,112474,57046,90016,259536
2016-12-23,BATS BYX (Y),87751727,39040714,46704468,173496909,2700604741.266817,1406337162.224203,1429792131.470500,5536734034.961520,813172,176361,439503,1429036
2016-12-23,BATS BZX (Z),111214465,47465241,62103127,220782833,3613970447.469012,2286586101.973602,2191756264.160401,8092312813.603015,923994,210631,502547,1637172
2016-12-22,NYSE MKT (A),0,12471162,0,12471162,0.000000,75464783.588300,0.000000,75464783.588300,0,23452,0,23452
2016-12-22,NASDAQ BX (B),80727874,24477718,44228994,149434586,2972032083.107571,1075458498.143598,1639120176.455697,5686610757.706866,830477,121268,457913,1409658
2016-12-22,NSX (C),410840,154923,257276,823039,14745811.280000,10349408.310000,8554399.586700,33649619.176700,3308,753,1753,5814
2016-12-22,NYSE (DN),83945516,41295643,55747262,180988421,2684400140.642306,1462385302.639197,1989948576.164305,6136734019.445808,217699,81501,132786,431986
2016-12-22,NASDAQ (DQ),949093716,472127590,608049250,2029270556,31245111431.384014,20484711712.887873,18898013083.140599,70627836227.412486,3117880,882263,1771857,5772000
2016-12-22,EDGA (J),70672413,28378462,34134267,133185142,2252938869.868089,1272141879.784098,1111249620.952701,4636330370.604888,627419,141419,286302,1055140
2016-12-22,EDGX (K),157683802,81849034,145340909,384873745,5631841273.894238,3600626538.897800,4753707052.368179,13986174865.160217,1142966,309048,862765,2314779
2016-12-22,CHX (M),7734601,12645256,5305268,25685125,520686706.262200,928245565.780000,397123307.344500,1846055579.386700,3796,3846,1215,8857
2016-12-22,NYSE (N),724653908,0,0,724653908,27387318179.733838,0.000000,0.000000,27387318179.733838,2354996,0,0,2354996
2016-12-22,NYSE Arca (P),171182259,251151992,121618770,543953021,6813379832.608854,11947191059.090138,4846102730.104002,23606673621.802994,1323660,585846,842565,2752071
2016-12-22,NASDAQ (Q),286553890,91317193,380809596,758680679,11605296472.784913,5168676799.902988,16226046796.933967,33000020069.621868,2557115,356191,2314297,5227603
2016-12-22,IEX (V),51202878,15527710,26651928,93382516,2010768741.249201,714357506.911300,1062927049.345901,3788053297.506402,331950,57527,168089,557566
2016-12-22,NASDAQ PSX (X),17816204,16978822,15514090,50309116,613260451.593000,770401051.103299,635094729.294501,2018756231.990800,149695,76012,111929,337636
2016-12-22,BATS BYX (Y),121876716,57458007,62004627,241339350,3761696005.432139,2203897459.768502,1973882682.887505,7939476148.088146,1153931,257279,589936,2001146
2016-12-22,BATS BZX (Z),157119468,69735557,85813028,312668053,5319695538.996298,3629713727.113299,3300031821.657705,12249441087.767302,1330520,303945,687806,2322271
2016-12-21,NYSE MKT (A),0,10805083,0,10805083,0.000000,89339474.064000,0.000000,89339474.064000,0,24108,0,24108
2016-12-21,NASDAQ BX (B),77303429,24009912,43843788,145157129,2906536596.436486,1053099085.370400,1582960913.549697,5542596595.356583,777485,117607,439755,1334847
2016-12-21,NSX (C),239499,97431,266887,603817,8085868.920000,5660248.920000,7208185.297500,20954303.137500,1746,497,1776,4019
2016-12-21,NYSE (DN),83490054,45276733,52024484,180791271,2807332654.060122,1607032312.650403,1693357861.191004,6107722827.901529,217324,88431,128776,434531
2016-12-21,NASDAQ (DQ),953415179,490253909,579549074,2023218162,30448411337.847154,23288610209.827667,17176059088.222596,70913080635.897417,3130254,854551,1745434,5730239
2016-12-21,EDGA (J),66698445,29492200,32016429,128207074,2147573385.573997,1286343498.005201,1024385189.944798,4458302073.523996,595267,137536,268032,1000835
2016-12-21,EDGX (K),163398664,82086692,141103563,386588919,5826011548.759316,3518663446.847792,4448016959.105918,13792691954.713026,1163537,289667,805001,2258205
2016-12-21,CHX (M),6882394,28458269,8341636,43682299,317304979.751200,2531430098.072498,730869786.970000,3579604864.793698,3316,3751,1108,8175
2016-12-21,NYSE (N),698019872,0,0,698019872,26589863798.614856,0.000000,0.000000,26589863798.614856,2249355,0,0,2249355
2016-12-21,NYSE Arca (P),170192215,236067437,108093533,514353185,6950565914.257440,10823458831.828897,4149974237.285917,21923998983.372254,1316275,540009,767218,2623502
2016-12-21,NASDAQ (Q),282594564,84123015,350007982,716725561,11792713205.665220,4522691576.361189,14800522292.115320,31115927074.141729,2569588,331292,2157492,5058372
2016-12-21,IEX (V),55015598,15173663,26833338,97022599,2193415592.945198,668873752.798200,1050375196.161800,3912664541.905198,339891,53347,164203,557441
2016-12-21,NASDAQ PSX (X),18957041,17019076,14040670,50016787,614303495.415200,779862293.145300,556390351.588000,1950556140.148500,146877,75036,107907,329820
2016-12-21,BATS BYX (Y),118115201,56675376,59951221,234741798,3621237735.742070,2100442124.935398,1859617030.742302,7581296891.419770,1123382,241135,550051,1914568
2016-12-21,BATS BZX (Z),160561962,64489846,80783957,305835765,5520658759.297131,3273437271.409394,2968394272.263991,11762490302.970516,1373563,284761,654390,2312714
2016-12-20,NYSE MKT (A),0,11953514,0,11953514,0.000000,70193120.719100,0.000000,70193120.719100,0,27161,0,27161
2016-12-20,NASDAQ BX (B),83556667,27416500,47051854,158025021,3101295882.138721,1233405445.002299,1681411906.066303,6016113233.207323,856206,141832,481115,1479153
2016-12-20,NSX (C),397891,141903,320924,860718,15117147.010000,10579926.026800,9987523.020500,35684596.057300,3107,827,1999,5933
2016-12-20,NYSE (DN),97288789,47923268,63852987,209065044,3214642322.717307,1695887270.693701,2444020743.270208,7354550336.681216,248913,86538,149936,485387
2016-12-20,NASDAQ (DQ),1126953369,539503772,631411492,2297868633,35644176522.282373,27887977194.338938,20121770716.083329,83653924432.704640,3491260,981064,1931164,6403488
2016-12-20,EDGA (J),76137879,31136762,34936821,142211462,2354425776.420401,1375414706.115599,1128640807.530802,4858481290.066802,649662,157082,286493,1093237
2016-12-20,EDGX (K),194080768,93996545,158628730,446706043,6728720748.062415,4393982649.242996,5187244584.049593,16309947981.355004,1356327,354218,938597,2649142
2016-12-20,CHX (M),9318651,25470439,5098648,39887738,572234248.126000,2853227494.288799,277082309.474200,3702544051.888999,3888,4410,1053,9351
2016-12-20,NYSE (N),797111597,0,0,797111597,29627778712.821843,0.000000,0.000000,29627778712.821843,2528741,0,0,2528741
2016-12-20,NYSE Arca (P),188319796,219446665,115619758,523386219,7267613080.470377,11517615470.144704,4588737358.504879,23373965909.119960,1423462,612537,849902,2885901
2016-12-20,NASDAQ (Q),325605275,98177947,412142899,835926121,12961335996.424438,5506845434.349895,17442858221.591129,35911039652.365462,2847615,409911,2480176,5737702
2016-12-20,IEX (V),62176453,16257417,31519419,109953289,2375617346.155698,756964681.776600,1223459083.378700,4356041111.310998,359830,69350,180248,609428
2016-12-20,NASDAQ PSX (X),22591863,18361781,17156448,58110092,742145458.508201,864803331.474901,655541192.426600,2262489982.409702,170236,83506,124976,378718
2016-12-20,BATS BYX (Y),135461529,60880577,68408888,264750994,4161760776.969001,2263234309.370801,2135608518.710602,8560603605.050404,1255629,271567,631646,2158842
2016-12-20,BATS BZX (Z),187255377,76799230,93489674,357544281,6459449321.925782,4078526189.116007,3514953663.462815,14052929174.504604,1557027,345478,746035,2648540
2016-12-19,NYSE MKT (A),0,13808908,0,13808908,0.000000,75060596.670200,0.000000,75060596.670200,0,29963,0,29963
2016-12-19,NASDAQ BX (B),87612396,28765192,49410910,165788498,3189007318.856402,1341452207.550498,1813646424.083704,6344105950.490604,865385,149820,502184,1517389
2016-12-19,NSX (C),492846,187683,349535,1030064,16789463.929200,16349789.780000,11334626.691300,44473880.400500,4408,917,2564,7889
2016-12-19,NYSE (DN),96706669,43399326,56932815,197038810,3261650230.553907,1618962764.539897,2134471174.209602,7015084169.303406,240365,83772,145265,469402
2016-12-19,NASDAQ (DQ),1056575175,501344620,627078998,2184998793,34883098976.494979,26676029747.132583,20908845609.993445,82467974333.621007,3367486,925310,1890451,6183247
2016-12-19,EDGA (J),81844324,33415945,37651826,152912095,2590083614.588595,1615372857.410700,1290057006.338993,5495513478.338288,729498,169869,326913,1226280
2016-12-19,EDGX (K),185308678,99963312,162168120,447440110,6564705563.261119,4708702151.503202,5485676159.335113,16759083874.099434,1377070,394617,1007967,2779654
2016-12-19,CHX (M),9068567,15361245,5150160,29579972,394513734.822000,1043982684.797000,430413178.905000,1868909598.524000,3452,3945,975,8372
2016-12-19,NYSE (N),794679762,0,0,794679762,29540894992.719534,0.000000,0.000000,29540894992.719534,2715420,0,0,2715420
2016-12-19,NYSE Arca (P),179065079,227293693,110928010,517286782,7042311971.065658,11575084227.385693,4768892409.809394,23386288608.260745,1406468,617815,834931,2859214
2016-12-19,NASDAQ (Q),341419758,107665709,421078849,870164316,13738091261.260433,5953385187.862809,18700984715.893046,38392461165.016288,3077765,454835,2751432,6284032
2016-12-19,IEX (V),60337299,14624396,29658888,104620583,2339844790.785803,713175898.764399,1227566867.934300,4280587557.484502,376307,61546,188623,626476
2016-12-19,NASDAQ PSX (X),23214787,19476642,18821523,61512952,769944896.210801,939564433.670700,729534540.130100,2439043870.011601,189781,86833,144347,420961
2016-12-19,BATS BYX (Y),148046351,64150944,73058460,285255755,4397819178.592866,2491410655.206703,2341110576.316293,9230340410.115862,1364489,294371,698890,2357750
2016-12-19,BATS BZX (Z),188475188,82119842,96394433,366989463,6385564539.909124,4465901141.645706,3876595870.380711,14728061551.935541,1614620,386956,802047,2803623
2016-12-16,NYSE MKT (A),0,97914588,0,97914588,0.000000,316308376.901500,0.000000,316308376.901500,0,32514,0,32514
2016-12-16,NASDAQ BX (B),108113852,37741601,64201594,210057047,3937389878.140693,1731532223.286205,2411372498.703802,8080294600.130700,1045409,185784,617965,1849158
2016-12-16,NSX (C),706480,664559,625294,1996333,29641297.395000,49526197.070000,20384247.041800,99551741.506800,4295,2780,4017,11092
2016-12-16,NYSE (DN),97804201,49349344,64242610,211396155,3304128067.975203,1804833128.738601,2366313884.027905,7475275080.741709,260630,94281,163258,518169
2016-12-16,NASDAQ (DQ),1996613662,644150355,1252985652,3893749669,70250369356.993060,38237384690.081241,40587549023.777011,149075303070.851312,3806906,1042940,2218083,7067929
2016-12-16,EDGA (J),96253524,46195869,50733225,193182618,3025356998.232585,2135710698.249298,1689240682.550402,6850308379.032285,801651,220578,388856,1411085
2016-12-16,EDGX (K),213090436,115518941,181456196,510065573,7581162682.421807,5846844394.666712,6092712533.441879,19520719610.530398,1521773,457663,1114100,3093536
2016-12-16,CHX (M),14255059,20232082,8190283,42677424,627429839.985000,2252721438.552201,851206371.738700,3731357650.275901,4061,5525,1333,10919
2016-12-16,NYSE (N),2224078135,0,0,2224078135,88011274707.525833,0.000000,0.000000,88011274707.525833,3305629,0,0,3305629
2016-12-16,NYSE Arca (P),247708237,352115793,166432981,766257011,9745898947.148594,19293840058.537978,6855176250.320356,35894915256.006928,1858558,901667,1143153,3903378
2016-12-16,NASDAQ (Q),413630807,131089178,1225010007,1769729992,16793621486.646906,8141603534.892182,47985808817.221411,72921033838.760499,3509585,541500,3241504,7292589
2016-12-16,IEX (V),73209490,20209565,36574736,129993791,2832319103.313200,897993815.223701,1487148721.568203,5217461640.105104,427498,80172,223871,731541
2016-12-16,NASDAQ PSX (X),27629704,21003221,22178123,70811048,955908485.800000,1305668914.382999,832726256.592902,3094303656.775901,223792,93701,162153,479646
2016-12-16,BATS BYX (Y),182342902,87817686,90292402,360452990,5451847152.076448,3435473752.089099,2868544707.313600,11755865611.479147,1566612,381926,787153,2735691
2016-12-16,BATS BZX (Z),233551337,102908894,118559997,455020228,8018678309.533428,6072812937.084703,4650773775.904892,18742265022.523023,1888834,465556,928431,3282821
2016-12-15,NYSE MKT (A),0,16728182,0,16728182,0.000000,79013374.819900,0.000000,79013374.819900,0,36054,0,36054
2016-12-15,NASDAQ BX (B),106795565,46657119,60683113,214135797,3926013709.434574,1961348893.508399,2313631995.749707,8200994598.692680,1040355,221893,593897,1856145
2016-12-15,NSX (C),928981,729215,327431,1985627,34485826.820000,43991942.341000,14528487.697500,93006256.858500,6424,2893,2489,11806
2016-12-15,NYSE (DN),114910235,57715112,68783477,241408824,3825058925.321609,2001921320.667803,2639441359.160802,8466421605.150214,289367,103611,176118,569096
2016-12-15,NASDAQ (DQ),1356719232,735998279,761526283,2854243794,42196286749.142729,34740124841.368064,25132509106.485519,102068920696.996312,4057450,1256602,2209735,7523787
2016-12-15,EDGA (J),96076270,59658457,49016376,204751103,3011374326.966392,2511042526.767698,1579489507.948801,7101906361.682891,820411,283203,387855,1491469
2016-12-15,EDGX (K),241563951,146017270,194744096,582325317,8603983593.275246,6772933143.348812,6809656915.766160,22186573652.390218,1756587,551734,1236947,3545268
2016-12-15,CHX (M),12099891,21816049,19233111,53149051,556393352.914200,1903338006.165600,1997381435.311400,4457112794.391200,3109,7553,1075,11737
2016-12-15,NYSE (N),1005359458,0,0,1005359458,36009583048.669638,0.000000,0.000000,36009583048.669638,3288621,0,0,3288621
2016-12-15,NYSE Arca (P),268032676,429556815,172708793,870298284,10291556343.255956,21818506638.094563,7249051968.591368,39359114949.941887,2023179,1098858,1215753,4337790
2016-12-15,NASDAQ (Q),447221464,166555368,511081667,1124858499,17963316080.931843,9316013549.538682,22413016528.371904,49692346158.842429,3900002,671018,3232110,7803130
2016-12-15,IEX (V),79772110,25551520,36165163,141488793,2879777624.413883,1112855503.346801,1561721861.774198,5554354989.534882,474159,98408,231307,803874
2016-12-15,NASDAQ PSX (X),29362776,27104462,23026641,79493879,1004582520.885901,1508254039.367000,969814148.119500,3482650708.372401,234766,118248,169778,522792
2016-12-15,BATS BYX (Y),179183158,102119332,85387273,366689763,5355406971.857641,3782943331.451590,2847364028.025998,11985714331.335229,1591682,428531,792190,2812403
2016-12-15,BATS BZX (Z),235339002,126000100,118642232,479981334,8066483656.220427,6944090686.389584,4843710895.567881,19854285238.177892,1946618,558461,963967,3469046
2016-12-14,NYSE MKT (A),0,14216394,0,14216394,0.000000,77707101.800400,0.000000,77707101.800400,0,36803,0,36803
2016-12-14,NASDAQ BX (B),116114104,53581391,62147886,231843381,4226071918.790173,2201083189.758797,2338040424.623696,8765195533.172666,1108241,242580,598467,1949288
2016-12-14,NSX (C),489688,627602,349918,1467208,20618634.580000,45883173.512900,12686209.215000,79188017.307900,4130,1735,2634,8499
2016-12-14,NYSE (DN),113254207,61533128,60434305,235221640,3755945520.839313,2367539143.736510,2723302956.728903,8846787621.304726,268406,108148,154635,531189
2016-12-14,NASDAQ (DQ),1353822000,725063226,684935876,2763821102,45052959707.559868,34103693596.358099,24925507621.231773,104082160925.149740,3966558,1290968,2054263,7311789
2016-12-14,EDGA (J),99500073,60951989,44807298,205259360,2987032198.209779,2898867632.691802,1553899864.671703,7439799695.573284,817158,295176,361513,1473847
2016-12-14,EDGX (K),263273564,178448135,190376511,632098210,9161559193.221186,8849702832.289656,7107583851.071588,25118845876.582430,1845120,702199,1237968,3785287
2016-12-14,CHX (M),8871289,24531320,3256161,36658770,410328606.540000,2322017140.890200,248855176.897900,2981200924.328100,3144,9837,1246,14227
2016-12-14,NYSE (N),1064594545,0,0,1064594545,39361746844.354994,0.000000,0.000000,39361746844.354994,3585891,0,0,3585891
2016-12-14,NYSE Arca (P),303610595,517147178,166996674,987754447,11676807613.413732,26194586880.718914,7561659966.944086,45433054461.076732,2233655,1391411,1211602,4836668
2016-12-14,NASDAQ (Q),503731509,232977964,493202255,1229911728,20099677331.347696,13216386400.654523,23358081683.377769,56674145415.379988,4284068,896216,3304104,8484388
2016-12-14,IEX (V),85207617,24395115,34394880,143997612,3245501858.248200,1267395177.254999,1578132971.909995,6091030007.413194,477796,99666,216754,794216
2016-12-14,NASDAQ PSX (X),35894457,36151464,23975567,96021488,1217138952.195001,1917325496.156399,1018597826.649900,4153062275.001300,257354,161174,173712,592240
2016-12-14,BATS BYX (Y),195286419,110336550,88379803,394002772,5857123159.397307,4261287807.595707,2930968444.834599,13049379411.827613,1707161,482107,810154,2999422
2016-12-14,BATS BZX (Z),266028913,164463413,123321775,553814101,9004765755.994895,9355775771.755482,5281524560.113695,23642066087.864072,2106320,734285,990047,3830652
2016-12-13,NYSE MKT (A),0,13575733,0,13575733,0.000000,78049042.243000,0.000000,78049042.243000,0,32758,0,32758
2016-12-13,NASDAQ BX (B),103827393,33096117,60487116,197410626,3863663492.820585,1546581192.506596,2320771834.680294,7731016520.007475,1039606,167656,582166,1789428
2016-12-13,NSX (C),926642,396440,367556,1690638,46005202.270000,49721522.720000,14700287.729400,110427012.719400,5716,1377,2779,9872
2016-12-13,NYSE (DN),107638631,46378131,67636364,221653126,3714552797.769000,1936468288.083401,2872213248.303909,8523234334.156310,273544,97187,164617,535348
2016-12-13,NASDAQ (DQ),1285152789,585993198,784432314,2655578301,42780278156.228688,31600349463.767498,27817704700.295754,102198332320.291940,4045720,1048984,2234384,7329088
2016-12-13,EDGA (J),90242760,41670484,46801851,178715095,2829393555.924787,2037857295.486702,1701136908.988699,6568387760.400188,778946,198430,376469,1353845
2016-12-13,EDGX (K),216274110,110862534,196612874,523749518,7822069524.012698,5665604518.168008,7384077807.387125,20871751849.567831,1563536,440015,1182892,3186443
2016-12-13,CHX (M),7359911,16896398,7348310,31604619,353654917.406000,1485593387.237600,621454064.171700,2460702368.815300,3658,7367,1310,12335
2016-12-13,NYSE (N),913311191,0,0,913311191,34165657640.126098,0.000000,0.000000,34165657640.126098,3086294,0,0,3086294
2016-12-13,NYSE Arca (P),254871048,299519157,170682683,725072888,10170427134.087669,17241146705.455477,7669640325.544693,35081214165.087839,1954986,852278,1179090,3986354
2016-12-13,NASDAQ (Q),408252042,124039774,497425659,1029717475,17113485105.289055,7400642402.213214,23389666183.536312,47903793691.038581,3660352,513040,3084599,7257991
2016-12-13,IEX (V),76904218,17956922,37421634,132282774,2849236452.005697,893380643.674300,1666938247.965198,5409555343.645195,472385,70635,228708,771728
2016-12-13,NASDAQ PSX (X),26221603,21678700,22302527,70202830,907910574.218200,1231559421.199499,975530290.760798,3115000286.178497,210342,95266,158987,464595
2016-12-13,BATS BYX (Y),166927851,71905119,85787872,324620842,5110254576.951980,2968403488.695098,2865080495.430187,10943738561.077265,1522604,320787,766519,2609910
2016-12-13,BATS BZX (Z),217727639,96558219,117553836,431839694,7642254433.957121,5677586809.378214,5176931624.250399,18496772867.585734,1817508,444570,925069,3187147
2016-12-12,NYSE MKT (A),0,16313412,0,16313412,0.000000,80842989.582200,0.000000,80842989.582200,0,35850,0,35850
2016-12-12,NASDAQ BX (B),106802951,34280245,56268754,197351950,4063490526.378116,1521519554.602803,2025320565.269895,7610330646.250814,1060634,170029,550670,1781333
2016-12-12,NSX (C),477214,479821,360201,1317236,18185238.960000,35524494.925000,11617349.884300,65327083.769300,3355,2227,2863,8445
2016-12-12,NYSE (DN),110721324,46443101,62961666,220126091,3833104940.613216,1782657931.174198,2289682992.593798,7905445864.381212,284609,93642,154926,533177
2016-12-12,NASDAQ (DQ),1306286904,591197564,709879294,2607363762,42636873279.651947,29040421558.133559,21331727348.937441,93009022186.722947,4133852,1082853,2145521,7362226
2016-12-12,EDGA (J),96853123,40614965,42488299,179956387,3074056608.761398,1786930636.439503,1395783298.286899,6256770543.487800,843761,198013,356226,1398000
2016-12-12,EDGX (K),238293518,115136811,184950324,538380653,8654301977.688902,5429316258.387487,5863059548.083803,19946677784.160192,1711704,442724,1131059,3285487
2016-12-12,CHX (M),7949405,13991812,4053915,25995132,364776370.079600,1681732626.493201,294552125.069800,2341061121.642601,3610,6055,1144,10809
2016-12-12,NYSE (N),983204900,0,0,983204900,37183998486.599215,0.000000,0.000000,37183998486.599215,3189945,0,0,3189945
2016-12-12,NYSE Arca (P),261231093,320731112,158460459,740422664,10452199966.051395,17205275597.383530,6392295519.416393,34049771082.851318,2001596,890778,1105893,3998267
2016-12-12,NASDAQ (Q),421999687,120747034,470988369,1013735090,17424021768.282195,6975465745.412883,20413184384.281537,44812671897.976615,3764251,517017,2959612,7240880
2016-12-12,IEX (V),77392765,19710233,35934053,133037051,3043010050.739204,894748658.111000,1599086935.377301,5536845644.227505,459551,79096,217318,755965
2016-12-12,NASDAQ PSX (X),27804166,19186059,21027472,68017697,1013103668.772400,1074120674.320100,822512269.769100,2909736612.861600,217046,90354,154150,461550
2016-12-12,BATS BYX (Y),170730932,76663442,77527868,324922242,5264213648.646100,3023187898.107401,2458322193.122204,10745723739.875705,1574963,353267,723287,2651517
2016-12-12,BATS BZX (Z),229102068,96272785,106941461,432316314,8122366296.456774,5456174542.863094,4076824764.220707,17655365603.540575,1924870,437893,875202,3237965
2016-12-09,NYSE MKT (A),0,18231212,0,18231212,0.000000,85029412.792700,0.000000,85029412.792700,0,34716,0,34716
2016-12-09,NASDAQ BX (B),100762729,34742670,54510008,190015407,3588153254.248018,1570424565.644298,2045222283.811998,7203800103.704314,1000253,173596,551392,1725241
2016-12-09,NSX (C),372795,307749,283822,964366,16588992.360000,28117867.270000,7550025.408000,52256885.038000,2862,1409,1790,6061
2016-12-09,NYSE (DN),120959075,50136427,76981202,248076704,3935934766.518814,1800923696.569204,2731785928.013302,8468644391.101320,319088,97642,187498,604228
2016-12-09,NASDAQ (DQ),1309237515,631219184,790646126,2731102825,41514305298.985520,26962401854.012177,23985976070.845423,92462683223.843120,4068840,1083121,2224977,7376938
2016-12-09,EDGA (J),89704638,42633593,47200619,179538850,2722298794.380096,1936678327.796299,1504030811.937799,6163007934.114194,758065,199357,362798,1320220
2016-12-09,EDGX (K),231347934,119502533,200557155,551407622,8142191513.714882,5342494605.394891,6064184327.262207,19548870446.371980,1638308,430613,1130859,3199780
2016-12-09,CHX (M),9172535,15067003,5006685,29246223,356944827.936700,1397962513.001000,381841821.274600,2136749162.212300,3702,5430,966,10098
2016-12-09,NYSE (N),901710919,0,0,901710919,32774675235.168343,0.000000,0.000000,32774675235.168343,2924932,0,0,2924932
2016-12-09,NYSE Arca (P),249381866,319700784,160416779,729499429,9762543529.014450,16698842071.041156,6351873091.759402,32813258691.815008,1879042,849535,1076212,3804789
2016-12-09,NASDAQ (Q),384635831,122999955,459873802,967509588,15208317362.460962,6814923812.243017,20082485132.539604,42105726307.243583,3261433,501351,2845762,6608546
2016-12-09,IEX (V),79117185,17093001,38548833,134759019,2933337520.056809,863514392.536700,1655773693.619099,5452625606.212608,459720,74636,225548,759904
2016-12-09,NASDAQ PSX (X),26166350,21524557,20067181,67758088,878552089.254999,1223474914.056601,770090364.591500,2872117367.903100,202220,93311,149238,444769
2016-12-09,BATS BYX (Y),164006701,74514065,77929033,316449799,4889176404.703225,2932108192.531493,2465126042.417191,10286410639.651909,1487058,322125,722981,2532164
2016-12-09,BATS BZX (Z),219884617,95199435,110328258,425412310,7417840664.862638,5345993220.025412,4282466187.638202,17046300072.526252,1778152,423137,866707,3067996
2016-12-08,NYSE MKT (A),0,13802356,0,13802356,0.000000,71556419.789100,0.000000,71556419.789100,0,34806,0,34806
2016-12-08,NASDAQ BX (B),110159859,36862253,59316459,206338571,4163262870.693206,1778576783.781501,2291711682.337405,8233551336.812112,1082941,186108,593287,1862336
2016-12-08,NSX (C),348207,339711,314292,1002210,20385642.460000,29977282.080000,9408009.400300,59770933.940300,2122,1243,1685,5050
2016-12-08,NYSE (DN),126213889,49257435,77469209,252940533,4411734684.342300,1926717305.429416,2814512593.313595,9152964583.085311,312978,103466,189133,605577
2016-12-08,NASDAQ (DQ),1364070802,606618008,837587464,2808276274,44911405690.278618,28774604031.342079,24596601789.379694,98282611511.000391,4253632,1129112,2298659,7681403
2016-12-08,EDGA (J),97123285,46389674,53252962,196765921,3087671459.435081,2187007154.863601,1590189282.484895,6864867896.783577,815410,210093,395918,1421421
2016-12-08,EDGX (K),247083647,132354058,228905892,608343597,8837363423.607393,6195329107.881613,6937598288.144606,21970290819.633612,1718260,501600,1239875,3459735
2016-12-08,CHX (M),12561492,19758682,3082689,35402863,457717198.730600,1708776253.750000,230439675.455900,2396933127.936500,4967,8541,1143,14651
2016-12-08,NYSE (N),992621312,0,0,992621312,37318374499.329951,0.000000,0.000000,37318374499.329951,3505454,0,0,3505454
2016-12-08,NYSE Arca (P),286548899,320767996,185783080,793099975,11434585923.633310,17366337766.032104,7159705630.483405,35960629320.148819,2129776,983108,1206798,4319682
2016-12-08,NASDAQ (Q),441978856,137791557,521369162,1101139575,18337803623.455619,8296376798.642283,21777678748.597304,48411859170.695206,3834150,587127,3363102,7784379
2016-12-08,IEX (V),80181730,18648184,38711978,137541892,3122443889.833004,955799951.051399,1645013114.212598,5723256955.097001,475373,77374,236452,789199
2016-12-08,NASDAQ PSX (X),29386308,23183123,22953834,75523265,1056107634.619999,1272529278.053099,877789239.088801,3206426151.761899,231571,107299,162782,501652
2016-12-08,BATS BYX (Y),174279773,78787970,85307314,338375057,5345108592.897202,3213308546.857889,2666880693.998315,11225297833.753406,1559090,346309,778809,2684208
2016-12-08,BATS BZX (Z),240720889,109823604,122528515,473073008,8576664324.690772,6314699027.794897,4688052425.782091,19579415778.267760,1971643,497785,950690,3420118
2016-12-07,NYSE MKT (A),0,12730877,0,12730877,0.000000,73639430.217800,0.000000,73639430.217800,0,33123,0,33123
2016-12-07,NASDAQ BX (B),118201552,38942674,59901043,217045269,4408011515.128074,1832485447.894899,2339744631.586791,8580241594.609764,1122124,192922,603131,1918177
2016-12-07,NSX (C),578908,376572,233334,1188814,25170326.850000,31100616.420000,8865909.965600,65136853.235600,3676,1808,1593,7077
2016-12-07,NYSE (DN),135835207,51432377,70779473,258047057,4563634353.817207,1967302057.045999,2805199185.692502,9336135596.555708,335684,105544,184611,625839
2016-12-07,NASDAQ (DQ),1505048743,653066963,798113117,2956228823,48935338740.082441,29764071824.924697,26735163321.967034,105434573886.974172,4433554,1211500,2269196,7914250
2016-12-07,EDGA (J),99653229,48800117,48010842,196464188,3293807893.752603,2321665062.054003,1751221492.221698,7366694448.028304,852201,238015,397375,1487591
2016-12-07,EDGX (K),254909075,132321672,194408965,581639712,9100067118.109192,6404806561.761329,6900580088.153514,22405453768.024035,1781688,517782,1220236,3519706
2016-12-07,CHX (M),18775264,11875197,6167141,36817602,597489355.097500,1342988937.162801,321423081.558000,2261901373.818301,4108,7387,1345,12840
2016-12-07,NYSE (N),1051622230,0,0,1051622230,40302158594.497800,0.000000,0.000000,40302158594.497800,3255071,0,0,3255071
2016-12-07,NYSE Arca (P),288911168,347753090,170157453,806821711,11231771565.565060,19130493313.817410,7434579221.678913,37796844101.061383,2095928,1015259,1203586,4314773
2016-12-07,NASDAQ (Q),458500370,144969473,511650176,1115120019,18869311565.553646,8662399462.986006,23556136004.228326,51087847032.767978,3925233,598643,3210410,7734286
2016-12-07,IEX (V),91587584,21076356,38561900,151225840,3684274205.803504,1084178385.300997,1646515135.035700,6414967726.140201,553052,87539,247613,888204
2016-12-07,NASDAQ PSX (X),32340780,24867556,24515229,81723565,1134666764.470002,1395058168.461299,1023233099.764399,3552958032.695700,253479,113243,180139,546861
2016-12-07,BATS BYX (Y),196646798,86192008,84138385,366977191,5955125133.059701,3588866140.982302,2848357521.253996,12392348795.295999,1698142,386977,789283,2874402
2016-12-07,BATS BZX (Z),251466166,117152025,118734071,487352262,8798746285.304345,6715887275.745811,4821864139.857306,20336497700.907462,2016839,522307,961137,3500283
2016-12-06,NYSE MKT (A),0,12632019,0,12632019,0.000000,76591568.816000,0.000000,76591568.816000,0,32401,0,32401
2016-12-06,NASDAQ BX (B),113261150,29315402,59491158,202067710,4113494891.603810,1381266159.014398,2136981095.260600,7631742145.878808,1102322,153395,595624,1851341
2016-12-06,NSX (C),355656,212560,199398,767614,14130962.410000,20735935.008000,6242444.702000,41109342.120000,2448,1026,1084,4558
2016-12-06,NYSE (DN),108459468,40521364,64523824,213504656,3717918436.241091,1513161580.984002,2438495148.516605,7669575165.741698,257655,81257,159491,498403
2016-12-06,NASDAQ (DQ),1305775488,535803300,749953854,2591532642,41337398760.874955,22747752451.280949,24229585053.452594,88314736265.608498,3957507,1052044,2153571,7163122
2016-12-06,EDGA (J),88112520,38200852,45790750,172104122,2848149098.983096,1737165346.595400,1467683242.997302,6052997688.575798,774473,183629,372366,1330468
2016-12-06,EDGX (K),217500106,100841054,191618602,509959762,7736624974.227685,4519929503.865284,5975972433.467291,18232526911.560260,1593611,405156,1189224,3187991
2016-12-06,CHX (M),11518699,11707828,5516132,28742659,412691074.659000,847406705.120000,497042046.619500,1757139826.398500,3901,5647,1143,10691
2016-12-06,NYSE (N),885238484,0,0,885238484,32617436585.411608,0.000000,0.000000,32617436585.411608,2972876,0,0,2972876
2016-12-06,NYSE Arca (P),244954801,275669279,160134271,680758351,9420568415.755488,14137075709.789266,6217462912.290470,29775107037.835224,1790703,781081,1092785,3664569
2016-12-06,NASDAQ (Q),392728460,111243900,457550335,961522695,15897354055.682690,5926950046.119179,19817895553.215196,41642199655.017065,3365222,472012,2934697,6771931
2016-12-06,IEX (V),82129556,16031875,35629211,133790642,3251858670.761206,698326413.047500,1475617483.884801,5425802567.693507,495986,67094,230246,793326
2016-12-06,NASDAQ PSX (X),27963142,17190901,20873531,66027574,946193872.056000,897982813.154501,817984294.787500,2662160979.998001,213417,84465,153940,451822
2016-12-06,BATS BYX (Y),171353692,64316139,80151368,315821199,5246289159.609313,2644955027.555695,2557050903.850606,10448295091.015614,1514265,300675,710353,2525293
2016-12-06,BATS BZX (Z),207945420,88161801,106050122,402157343,7066817349.152085,4545415910.168786,3951713497.345210,15563946756.666081,1694532,394214,845329,2934075
2016-12-05,NYSE MKT (A),0,12051344,0,12051344,0.000000,78318176.521600,0.000000,78318176.521600,0,29260,0,29260
2016-12-05,NASDAQ BX (B),102930366,33609730,52776089,189316185,3915982524.628329,1524954620.372405,2045197866.947890,7486135011.948624,1007298,173130,530114,1710542
2016-12-05,NSX (C),439116,439665,210080,1088861,16255381.581600,27505498.900000,9801720.425900,53562600.907500,2815,2266,1701,6782
2016-12-05,NYSE (DN),112033534,54952890,59563709,226550133,3875033642.062903,1824593467.098596,2380483966.347495,8080111075.508994,289647,101645,154913,546205
2016-12-05,NASDAQ (DQ),1274855091,577461054,644423422,2496739567,41897081136.932682,23670311437.730386,22402670701.759697,87970063276.422765,4107887,1098312,1988661,7194860
2016-12-05,EDGA (J),94437668,42046447,43548642,180032757,3101240849.075832,1911486260.497504,1565228330.946398,6577955440.519734,832056,209950,372218,1414224
2016-12-05,EDGX (K),226979434,118269521,163349371,508598326,8250837254.457528,5379631375.246610,5886525038.202273,19516993667.906411,1646284,461847,1099687,3207818
2016-12-05,CHX (M),3462848,3150797,1883212,8496857,161526675.854000,310138544.910000,229884791.982500,701550012.746500,801,1792,253,2846
2016-12-05,NYSE (N),942296402,0,0,942296402,35695690179.228474,0.000000,0.000000,35695690179.228474,3116812,0,0,3116812
2016-12-05,NYSE Arca (P),251713960,319632950,142996899,714343809,9950468897.230125,15972840418.945966,6323107314.976624,32246416631.152715,1913017,894030,1074605,3881652
2016-12-05,NASDAQ (Q),397261401,126782684,457840618,981884703,16449634685.495225,6421051060.044917,20953303298.681726,43823989044.221868,3485567,517950,2955189,6958706
2016-12-05,IEX (V),78718720,17753890,33732807,130205417,3149906899.126092,767401252.848800,1451803975.353798,5369112127.328690,496220,72049,220397,788666
2016-12-05,NASDAQ PSX (X),25666731,18838028,20740048,65244807,914912889.377301,1051471910.298301,849801582.815599,2816186382.491201,205043,88215,148789,442047
2016-12-05,BATS BYX (Y),170939976,75452167,75890220,322282363,5167501872.733048,2989112433.285994,2466324781.895089,10622939087.914131,1516835,343543,705319,2565697
2016-12-05,BATS BZX (Z),216795808,96149387,103616217,416561412,7550157196.922126,5035377108.327397,4281271199.943995,16866805505.193518,1781013,442828,876048,3099889
2016-12-02,NYSE MKT (A),0,12610153,0,12610153,0.000000,55770767.263200,0.000000,55770767.263200,0,32078,0,32078
2016-12-02,NASDAQ BX (B),99333360,35304584,55896296,190534240,3651097742.516062,1563005466.070894,2052688042.054502,7266791250.641458,1000257,170330,552298,1722885
2016-12-02,NSX (C),333596,423699,322953,1080248,16694675.010000,29952079.590000,13815624.513100,60462379.113100,2695,1999,2376,7070
2016-12-02,NYSE (DN),105491037,47867754,59402602,212761393,3469402967.279003,1661243450.372900,2308826696.797003,7439473114.448906,255228,83877,144626,483731
2016-12-02,NASDAQ (DQ),1214610767,573450270,670042665,2458103702,38620503594.945475,23986410632.527837,23174271207.502339,85781185434.975651,3801795,984871,1950746,6737412
2016-12-02,EDGA (J),88325888,40936094,43724181,172986163,2847169111.612004,1803910986.829297,1524460669.282001,6175540767.723302,762244,199028,363113,1324385
2016-12-02,EDGX (K),219150216,119074237,170386719,508611172,7883611257.475883,5390223593.953899,6131326889.228500,19405161740.658282,1594103,473245,1110892,3178240
2016-12-02,CHX (M),10650231,10544538,8685048,29879817,520984661.603800,975173867.470000,756798722.702000,2252957251.775800,3419,7013,1471,11903
2016-12-02,NYSE (N),909916705,0,0,909916705,33966051170.046554,0.000000,0.000000,33966051170.046554,3107997,0,0,3107997
2016-12-02,NYSE Arca (P),249105350,322888483,150004735,721998568,9715704833.745688,15560680875.660815,6454741678.960428,31731127388.366931,1885250,910667,1078014,3873931
2016-12-02,NASDAQ (Q),404397090,124221291,452646778,981265159,16468277139.187779,6686021315.484760,20327143216.658464,43481441671.331003,3521382,513741,2979304,7014427
2016-12-02,IEX (V),73171729,18316637,34208419,125696785,2936919074.212384,828956737.719799,1522095663.156798,5287971475.088981,441086,72928,212371,726385
2016-12-02,NASDAQ PSX (X),27379704,20091076,21682982,69153762,926013703.050000,1023412209.483501,849629387.034300,2799055299.567801,212928,95926,157554,466408
2016-12-02,BATS BYX (Y),165207398,73060200,77502382,315769980,4800411687.367799,2818176539.977306,2413049313.823399,10031637541.168504,1422706,321641,683955,2428302
2016-12-02,BATS BZX (Z),215300656,100149954,106526326,421976936,7417956696.781362,5264983012.023998,4289490605.438203,16972430314.243563,1776483,451836,875681,3104000
2016-12-01,NYSE MKT (A),0,13836307,0,13836307,0.000000,76526044.451600,0.000000,76526044.451600,0,34304,0,34304
2016-12-01,NASDAQ BX (B),130732483,46549144,65852550,243134177,4821213160.351491,2015899459.289302,2706319809.696702,9543432429.337495,1275135,219506,663473,2158114
2016-12-01,NSX (C),334316,559420,404352,1298088,14434634.796000,47400026.192800,22378628.498600,84213289.487400,2709,1886,2473,7068
2016-12-01,NYSE (DN),153415706,67076303,76891525,297383534,5062901741.086072,2404692802.887699,3360409400.781294,10828003944.755065,362587,114469,199399,676455
2016-12-01,NASDAQ (DQ),1673354407,710386493,801746263,3185487163,53855059087.655856,30433101977.921319,31825496702.585366,116113657768.162541,4988912,1289480,2486743,8765135
2016-12-01,EDGA (J),116601973,58929344,51343063,226874380,3620755714.283284,2521277620.395899,2049616529.405702,8191649864.084885,1000236,266133,446523,1712892
2016-12-01,EDGX (K),294874138,156999803,207070326,658944267,10171769938.198801,7321844937.839301,8102077376.194889,25595692252.232991,2048804,624589,1402138,4075531
2016-12-01,CHX (M),13464000,22235909,10101332,45801241,517048369.956500,1429990364.958000,613123780.737400,2560162515.651900,4883,8391,1781,15055
2016-12-01,NYSE (N),1166379887,0,0,1166379887,41974215250.487976,0.000000,0.000000,41974215250.487976,3926348,0,0,3926348
2016-12-01,NYSE Arca (P),338057340,412627181,191729904,942414425,12912830826.797392,21324434026.184106,9023041397.185307,43260306250.166805,2489217,1155278,1418366,5062861
2016-12-01,NASDAQ (Q),522033613,167364125,556809488,1246207226,20746119585.850621,9196813286.365288,26462234229.480697,56405167101.696606,4432930,700446,3739840,8873216
2016-12-01,IEX (V),112768587,23313078,47647268,183728933,4476823322.116601,1072682099.012000,2462486977.527397,8011992398.655998,626169,96006,290339,1012514
2016-12-01,NASDAQ PSX (X),36772168,28334485,27027890,92134543,1224266367.798002,1518330047.865798,1191444355.374900,3934040771.038700,278083,128141,193709,599933
2016-12-01,BATS BYX (Y),214004473,94893229,94905549,403803251,6154885292.541521,3680587709.584594,3223779618.266490,13059252620.392605,1870608,417218,901385,3189211
2016-12-01,BATS BZX (Z),294680854,135519201,138262707,568462762,9776663192.224797,7240164268.805008,6021869940.616104,23038697401.645909,2399421,615099,1172117,4186637
2016-11-30,NYSE MKT (A),0,20803797,0,20803797,0.000000,149989898.959500,0.000000,149989898.959500,0,30653,0,30653
2016-11-30,NASDAQ BX (B),132466489,45976170,59255804,237698463,4785309130.549376,2062224876.638500,2507976688.825495,9355510696.013371,1236472,216393,582683,2035548
2016-11-30,NSX (C),622825,434242,206288,1263355,28880368.620000,37381453.501100,11441261.121000,77703083.242100,3577,1730,1477,6784
2016-11-30,NYSE (DN),143262011,60167958,61927555,265357524,4578070669.476596,2166938188.304499,2588264362.810701,9333273220.591796,358068,113228,159763,631059
2016-11-30,NASDAQ (DQ),1715709279,716559126,717104865,3149373270,53705436466.956861,33393733622.134263,26833718655.149959,113932888744.241083,4731820,1281167,2015585,8028572
2016-11-30,EDGA (J),117817001,57968249,41678591,217463841,3574037307.758011,2640326019.181397,1662085711.160299,7876449038.099707,958851,262483,349479,1570813
2016-11-30,EDGX (K),297153536,148169011,169168366,614490913,10088053263.179777,6508379491.905304,6570138742.543295,23166571497.628376,1983045,533008,1120460,3636513
2016-11-30,CHX (M),8499626,15395301,6982774,30877701,397973802.721500,1554355327.301001,472214842.597100,2424543972.619601,4424,10114,1180,15718
2016-11-30,NYSE (N),1612669757,0,0,1612669757,63475589576.798380,0.000000,0.000000,63475589576.798380,3732242,0,0,3732242
2016-11-30,NYSE Arca (P),343052204,451043303,151977267,946072774,12855897580.825836,22640373681.256754,7232054778.959378,42728326041.041968,2385347,1142253,1099847,4627447
2016-11-30,NASDAQ (Q),516112230,164571405,606473484,1287157119,20121686944.719769,9146606728.651985,30198753413.404854,59467047086.776608,4269419,650850,3075356,7995625
2016-11-30,IEX (V),92315823,22932088,31097905,146345816,3389592061.606695,1079257991.598199,1522710484.652101,5991560537.856995,539005,90828,201220,831053
2016-11-30,NASDAQ PSX (X),33320319,25097792,20264377,78682488,1119895904.622199,1316958741.331398,903400148.019600,3340254793.973197,247265,108072,149447,504784
2016-11-30,BATS BYX (Y),229507870,100431376,79367371,409306617,6390301092.292004,3923165491.020298,2830293265.735700,13143759849.048002,1833509,447521,710043,2991073
2016-11-30,BATS BZX (Z),295893538,134480165,110562486,540936189,9680610435.017437,6856534968.545685,4894363477.903813,21431508881.466935,2348723,577008,912911,3838642
2016-11-29,NYSE MKT (A),0,11200776,0,11200776,0.000000,64792621.782700,0.000000,64792621.782700,0,26380,0,26380
2016-11-29,NASDAQ BX (B),98667788,29773328,54230740,182671856,3747221345.194099,1267792023.451701,2038124269.135701,7053137637.781501,994681,151190,561020,1706891
2016-11-29,NSX (C),252172,304230,287369,843771,10705322.890000,27995642.914500,10933610.894100,49634576.698600,1889,1242,1342,4473
2016-11-29,NYSE (DN),104810236,42647447,59713134,207170817,3343222307.858826,1592775272.608599,2228494394.203303,7164491974.670728,266688,84318,149144,500150
2016-11-29,NASDAQ (DQ),1206773084,482626499,650819105,2340218688,37907077197.228554,21954714396.736016,21911309249.445440,81773100843.410010,3809509,929130,1929266,6667905
2016-11-29,EDGA (J),81889740,37506155,37293007,156688902,2487896475.980796,1580746348.951901,1318141074.791901,5386783899.724598,703056,176234,315805,1195095
2016-11-29,EDGX (K),201207688,100110189,162242237,463560114,6972295405.253156,4345295908.482402,5545866684.825686,16863457998.561244,1413606,377023,997632,2788261
2016-11-29,CHX (M),10337358,14568464,6302605,31208427,443461610.128900,1322755832.162400,399289655.598000,2165507097.889300,3804,5624,1131,10559
2016-11-29,NYSE (N),927101898,0,0,927101898,34111335668.313753,0.000000,0.000000,34111335668.313753,2879356,0,0,2879356
2016-11-29,NYSE Arca (P),231046485,253009472,139511375,623567332,8980387064.961714,12925457894.666178,5789819851.220497,27695664810.848389,1757314,780672,1022020,3560006
2016-11-29,NASDAQ (Q),371306652,104462548,456470753,932239953,15311927322.231472,5595683305.649388,19765648597.935251,40673259225.816111,3308864,436954,2757432,6503250
2016-11-29,IEX (V),71279126,15522058,32802315,119603499,2647527621.707191,694876293.610200,1447859537.291598,4790263452.608989,440852,62077,207434,710363
2016-11-29,NASDAQ PSX (X),24610403,18155656,18527687,61293746,839444025.581299,876565280.797700,706256552.178300,2422265858.557299,185402,78640,136725,400767
2016-11-29,BATS BYX (Y),169036583,62846601,73475978,305359162,4918570755.936789,2308809854.898194,2379288847.414104,9606669458.249087,1485443,280162,670896,2436501
2016-11-29,BATS BZX (Z),210877660,86867822,100089725,397835207,7070300571.664489,4469100210.662990,3963698237.793301,15503099020.120780,1745463,396331,824048,2965842
2016-11-28,NYSE MKT (A),0,10102374,0,10102374,0.000000,57745779.447000,0.000000,57745779.447000,0,24218,0,24218
2016-11-28,NASDAQ BX (B),104561904,33426738,51362301,189350943,4108397351.051090,1437410639.407006,2030805117.346100,7576613107.804196,1033214,161367,519129,1713710
2016-11-28,NSX (C),275204,355367,174440,805011,12841390.580000,28095135.910000,7569737.873800,48506264.363800,2168,1222,1135,4525
2016-11-28,NYSE (DN),99058991,44242548,57583350,200884889,3244494273.808508,1657884075.387606,2182284453.389602,7084662802.585716,261087,89299,148799,499185
2016-11-28,NASDAQ (DQ),1122060641,579082808,595489494,2296632943,36290277913.356840,25462425194.790419,20858380983.481076,82611084091.628335,3563159,1000950,1800418,6364527
2016-11-28,EDGA (J),84653236,41114941,36373609,162141786,2749206422.965702,1841647366.009602,1374601781.527598,5965455570.502902,746228,191686,315909,1253823
2016-11-28,EDGX (K),199205760,108405925,148421964,456033649,7112616644.225288,4936360687.513707,5481463949.701296,17530441281.440291,1415995,409311,948572,2773878
2016-11-28,CHX (M),7075989,10209960,6238447,23524396,398489113.562000,951054187.450000,459696039.740700,1809239340.752700,2650,6587,852,10089
2016-11-28,NYSE (N),870251508,0,0,870251508,32978139271.770977,0.000000,0.000000,32978139271.770977,2730208,0,0,2730208
2016-11-28,NYSE Arca (P),222039157,338245103,127518864,687803124,9044680654.244491,16260967727.918158,5456417798.781490,30762066180.944139,1696454,807071,954181,3457706
2016-11-28,NASDAQ (Q),348035650,113290595,406902838,868229083,14621471800.105385,6401788753.708097,19304882517.344635,40328143071.158117,3102583,472907,2549698,6125188
2016-11-28,IEX (V),58959557,15546754,25088003,99594314,2313114224.260100,706329033.669300,1156267114.460298,4175710372.389698,384978,66488,171719,623185
2016-11-28,NASDAQ PSX (X),24149069,21037641,16602119,61788829,839662368.206699,1005523928.788100,675697176.815100,2520883473.809899,183318,87748,128621,399687
2016-11-28,BATS BYX (Y),166877631,74178665,67191988,308248284,4975604683.786293,2845312801.922803,2303574695.742692,10124492181.451788,1476476,317384,640699,2434559
2016-11-28,BATS BZX (Z),207897397,98198861,91211320,397307578,7358704823.395709,5175735869.508996,3732383396.005099,16266824088.909804,1744939,428419,776418,2949776
2016-11-25,NYSE MKT (A),0,6741140,0,6741140,0.000000,31862256.928000,0.000000,31862256.928000,0,14322,0,14322
2016-11-25,NASDAQ BX (B),41819485,15454448,21200668,78474601,1549352029.981994,717861389.356401,803931519.170899,3071144938.509294,412489,75410,215491,703390
2016-11-25,NSX (C),195787,77445,83921,357153,11140009.750000,6190045.380000,6691837.628800,24021892.758800,1476,337,591,2404
2016-11-25,NYSE (DN),47735732,19665521,28052628,95453881,1389545106.299305,656756256.558299,982120180.460300,3028421543.317904,120489,38416,72277,231182
2016-11-25,NASDAQ (DQ),504723486,246853762,275242894,1026820142,15997738037.911686,10946500338.038013,8844201048.086937,35788439424.036636,1624502,475668,876663,2976833
2016-11-25,EDGA (J),32576992,17200975,16222009,65999976,979796257.921098,727262691.023800,536159793.891000,2243218742.835898,280863,86169,134938,501970
2016-11-25,EDGX (K),98585918,53570890,74899072,227055880,3313213603.899308,2479821959.367597,2504007455.101997,8297043018.368902,645137,196929,454304,1296370
2016-11-25,CHX (M),1460392,5789201,474197,7723790,69975153.811800,664954875.561200,48670932.243300,783600961.616300,1645,3729,474,5848
2016-11-25,NYSE (N),409098136,0,0,409098136,15148874720.995192,0.000000,0.000000,15148874720.995192,1335050,0,0,1335050
2016-11-25,NYSE Arca (P),101499036,142709997,56441778,300650811,3888512301.729711,7405046676.957095,2412308944.035300,13705867922.722106,752044,369936,432072,1554052
2016-11-25,NASDAQ (Q),155167910,53218752,207004687,415391349,6405465597.678499,2901286879.130205,8987777684.107541,18294530160.916245,1369899,216782,1231400,2818081
2016-11-25,IEX (V),22174348,7461555,10330749,39966652,860026722.903803,322781204.188400,453587443.414400,1636395370.506603,148290,30067,71123,249480
2016-11-25,NASDAQ PSX (X),9849830,8525119,6809755,25184704,329683991.565000,462161584.638200,254611034.148100,1046456610.351300,75010,40482,49301,164793
2016-11-25,BATS BYX (Y),69652284,32511949,28830165,130994398,1996509074.789701,1232810298.545502,948414817.039001,4177734190.374204,603807,148257,278568,1030632
2016-11-25,BATS BZX (Z),90057598,43442096,42491977,175991671,3059362160.659906,2195215489.112099,1674149398.389901,6928727048.161906,734374,191324,352436,1278134
2016-11-23,NYSE MKT (A),0,10806267,0,10806267,0.000000,59323799.125700,0.000000,59323799.125700,0,25801,0,25801
2016-11-23,NASDAQ BX (B),90561911,34226788,46899105,171687804,3371846361.027585,1421751134.136097,1804423574.867802,6598021070.031484,899564,172690,465330,1537584
2016-11-23,NSX (C),368901,170800,219618,759319,15930967.258900,14361803.340000,5917685.358000,36210455.956900,2339,803,968,4110
2016-11-23,NYSE (DN),107686946,45357888,57044408,210089242,3579845586.241486,1652177710.220696,2227643828.518198,7459667124.980380,254489,89541,145995,490025
2016-11-23,NASDAQ (DQ),1100340817,573008831,579136636,2252486284,36450805495.007927,23685845156.549582,20259169561.933824,80395820213.491333,3520522,1023159,1809922,6353603
2016-11-23,EDGA (J),76960701,41380215,37802610,156143526,2412556424.796703,1742646130.881399,1347790405.064100,5502992960.742202,662769,210552,301316,1174637
2016-11-23,EDGX (K),199875300,111567454,154323439,465766193,7243181748.486024,4954386219.438393,5455738593.256402,17653306561.180819,1382128,447105,948640,2777873
2016-11-23,CHX (M),6856162,21033904,5068126,32958192,312815784.084300,1567773975.285000,468434355.985800,2349024115.355100,2990,6126,1430,10546
2016-11-23,NYSE (N),830794524,0,0,830794524,29887317065.506469,0.000000,0.000000,29887317065.506469,2723112,0,0,2723112
2016-11-23,NYSE Arca (P),227704723,319324040,130495956,677524719,9051645845.306895,14574765743.356395,5777416400.530997,29403827989.194287,1687215,865892,946367,3499474
2016-11-23,NASDAQ (Q),342409739,115333132,404422446,862165317,14276285765.405155,6013883900.398807,18493662029.052169,38783831694.856131,2975577,500326,2589434,6065337
2016-11-23,IEX (V),62282718,16616276,27879031,106778025,2454068852.163696,779842218.247300,1237766879.288599,4471677949.699595,367099,70404,175071,612574
2016-11-23,NASDAQ PSX (X),22684109,18901696,16201423,57787228,780306818.939299,1030385552.040701,695864452.356300,2506556823.336300,181821,87473,129802,399096
2016-11-23,BATS BYX (Y),152352563,67826063,65241954,285420580,4298333762.081419,2539059287.282802,2204112039.025592,9041505088.389813,1301915,316815,608676,2227406
2016-11-23,BATS BZX (Z),198971882,98869172,92971614,390812668,6806367690.168686,4984519665.600803,3870119212.370201,15661006568.139690,1637464,461232,772868,2871564
2016-11-22,NYSE MKT (A),0,13673640,0,13673640,0.000000,69128231.961400,0.000000,69128231.961400,0,31804,0,31804
2016-11-22,NASDAQ BX (B),100450818,33475236,55251650,189177704,3775806902.163298,1468922748.855504,2179874642.659004,7424604293.677806,963275,164418,532919,1660612
2016-11-22,NSX (C),378012,268298,271724,918034,16987610.619100,25951183.020000,15009118.658200,57947912.297300,2350,1151,1665,5166
2016-11-22,NYSE (DN),127535383,49546664,72335282,249417329,4613268706.551084,1828927919.496302,2914665915.372197,9356862541.419583,319517,98517,179404,597438
2016-11-22,NASDAQ (DQ),1326967332,577028532,712667454,2616663318,45043122956.718822,24837750402.618771,25204719541.164358,95085592900.501951,4125204,1083858,2083945,7293007
2016-11-22,EDGA (J),92399535,39730905,42178754,174309194,2880177226.996297,1766297541.494604,1548696911.937101,6195171680.428002,772889,196694,352536,1322119
2016-11-22,EDGX (K),233443561,107732744,171891738,513068043,8514678127.135498,5063613022.002904,6154328911.342700,19732620060.481102,1623104,427488,1068652,3119244
2016-11-22,CHX (M),12243928,22424638,5073165,39741731,536373711.250100,1890715666.350000,420028963.378100,2847118340.978200,3707,6316,1214,11237
2016-11-22,NYSE (N),917515447,0,0,917515447,33981330853.919673,0.000000,0.000000,33981330853.919673,2994232,0,0,2994232
2016-11-22,NYSE Arca (P),252112661,281410314,142011007,675533982,9964441100.725780,14187954776.361529,6312213304.248818,30464609181.336127,1882515,797013,1035256,3714784
2016-11-22,NASDAQ (Q),390990370,114694818,452746381,958431569,16458929810.900017,5981885161.011104,20952571799.334230,43393386771.245351,3398432,469269,2925855,6793556
2016-11-22,IEX (V),76935387,15882619,34124441,126942447,3193280297.024396,771308752.272700,1566588670.476400,5531177719.773496,442919,65359,202802,711080
2016-11-22,NASDAQ PSX (X),25930561,18007791,19411654,63350006,880168983.111498,929676768.351900,796261814.790000,2606107566.253398,199481,83030,147697,430208
2016-11-22,BATS BYX (Y),173590622,67969797,75642008,317202427,4964997939.026157,2687062085.980102,2472358039.535093,10124418064.541352,1488739,311167,696084,2495990
2016-11-22,BATS BZX (Z),230032363,99584200,106811284,436427847,7978510191.392515,5097630790.962483,4222009258.000411,17298150240.355409,1850084,440206,861876,3152166
2016-11-21,NYSE MKT (A),0,11328752,0,11328752,0.000000,60370097.068200,0.000000,60370097.068200,0,26691,0,26691
2016-11-21,NASDAQ BX (B),89085466,29122514,50435400,168643380,3275759224.438497,1324961209.522494,1914016768.537793,6514737202.498784,867589,150213,493263,1511065
2016-11-21,NSX (C),414804,256791,198072,869667,19626385.569000,25767535.535600,11390195.060000,56784116.164600,2166,840,1257,4263
2016-11-21,NYSE (DN),117091080,49926348,70976971,237994399,3996849940.541646,1833320776.572601,2904126657.403500,8734297374.517747,294809,98626,166755,560190
2016-11-21,NASDAQ (DQ),1195955723,553558979,649419666,2398934368,39163307536.617834,23332787191.829667,22697386338.188848,85193481066.636349,3733588,1011102,1966301,6710991
2016-11-21,EDGA (J),81908998,39647609,38581021,160137628,2672259946.624597,1759788603.650700,1505018695.105601,5937067245.380898,724455,196441,339314,1260210
2016-11-21,EDGX (K),208070689,104425905,160290363,472786957,7380557796.694532,4717229770.058191,5795221921.842585,17893009488.595308,1433941,394545,1000625,2829111
2016-11-21,CHX (M),6024508,16650230,3372860,26047598,286745842.227000,1330955654.261499,226260531.710000,1843962028.198499,3337,5815,1171,10323
2016-11-21,NYSE (N),863865768,0,0,863865768,32312775216.763848,0.000000,0.000000,32312775216.763848,2686452,0,0,2686452
2016-11-21,NYSE Arca (P),231217477,264054943,130762832,626035252,8978973481.384921,13641697923.211849,5813479773.540596,28434151178.137366,1684507,720506,961594,3366607
2016-11-21,NASDAQ (Q),373525683,113018233,431944416,918488332,14849934647.776074,6232067460.246377,19800284606.767331,40882286714.789782,3165133,483043,2668481,6316657
2016-11-21,IEX (V),66388114,14518391,28139329,109045834,2474957593.651100,687563199.452000,1268527954.864397,4431048747.967497,392892,61526,183717,638135
2016-11-21,NASDAQ PSX (X),23910908,15989220,18245110,58145238,804606104.739400,871239525.750100,744484139.512200,2420329770.001700,182834,77377,134304,394515
2016-11-21,BATS BYX (Y),151340215,63047390,67647708,282035313,4341196020.353087,2485936487.559901,2161877813.410700,8989010321.323688,1325182,294551,619879,2239612
2016-11-21,BATS BZX (Z),202709659,87163809,98160287,388033755,7040076655.008691,4641139708.157598,3979258634.994219,15660474998.160508,1662742,400689,797110,2860541
2016-11-18,NYSE MKT (A),0,13451997,0,13451997,0.000000,90240399.798400,0.000000,90240399.798400,0,28578,0,28578
2016-11-18,NASDAQ BX (B),92141303,30207940,50701318,173050561,3418846476.956598,1421921297.173703,1907483391.663601,6748251165.793902,876997,161557,494236,1532790
2016-11-18,NSX (C),241460,279054,231829,752343,8852370.960000,26579983.235100,12730619.460000,48162973.655100,1681,926,1477,4084
2016-11-18,NYSE (DN),99456025,43953717,62834188,206243930,3403422527.795708,1640980570.727098,2613238411.646610,7657641510.169416,269412,88623,168392,526427
2016-11-18,NASDAQ (DQ),1122811296,550235108,672528242,2345574646,37848846326.541141,28038210100.514613,22932216375.397214,88819272802.452968,3629567,978119,1990198,6597884
2016-11-18,EDGA (J),80555347,39124071,39975560,159654978,2584473275.546001,1887652857.433403,1390442273.428098,5862568406.407502,691936,204974,335024,1231934
2016-11-18,EDGX (K),195194213,99430162,164568413,459192788,7132334201.207710,5039338729.227498,6013946607.147202,18185619537.582410,1410014,409273,1088919,2908206
2016-11-18,CHX (M),13611661,21766129,8965509,44343299,540244191.758900,2057746698.724999,690348762.175700,3288339652.659599,3267,5300,1077,9644
2016-11-18,NYSE (N),949444683,0,0,949444683,37383554492.913280,0.000000,0.000000,37383554492.913280,2863224,0,0,2863224
2016-11-18,NYSE Arca (P),222409119,277756377,138913640,639079136,8790215461.979015,14429025001.231480,6182355134.876670,29401595598.087165,1683565,792907,1028881,3505353
2016-11-18,NASDAQ (Q),353842344,110407408,501437677,965687429,14754047630.944188,6078853434.269509,22411467243.212619,43244368308.426316,3107808,468830,2898566,6475204
2016-11-18,IEX (V),62954509,14689779,28623860,106268148,2519838818.285697,730926273.659301,1199655048.161101,4450420140.106099,385801,63300,189991,639092
2016-11-18,NASDAQ PSX (X),24073689,18030213,19072755,61176657,809475673.634998,969754457.766800,751327752.687900,2530557884.089698,181550,85676,142887,410113
2016-11-18,BATS BYX (Y),159769967,60731637,71802636,292304240,4610884873.452660,2442682533.475211,2306126780.795711,9359694187.723582,1376592,296901,677855,2351348
2016-11-18,BATS BZX (Z),204396339,90460623,106118621,400975583,7145036305.263256,4998637935.847705,4345386762.544690,16489061003.655651,1687992,425225,873883,2987100
2016-11-17,NYSE MKT (A),0,12357502,0,12357502,0.000000,76862095.162800,0.000000,76862095.162800,0,31647,0,31647
2016-11-17,NASDAQ BX (B),99098019,38224669,58713589,196036277,3624620970.791470,1599388124.545392,2123113027.239204,7347122122.576066,984010,185470,595691,1765171
2016-11-17,NSX (C),693891,406322,259684,1359897,24718081.860000,41690871.979000,10416862.028200,76825815.867200,2842,1353,1812,6007
2016-11-17,NYSE (DN),118188599,50335903,73917293,242441795,3940542197.372500,1772998347.765404,2701430842.440300,8414971387.578204,297931,96849,192599,587379
2016-11-17,NASDAQ (DQ),1263905146,603668620,779538326,2647112092,40862611601.349752,25430785869.751994,24806574776.053050,91099972247.154796,3910535,1084186,2273903,7268624
2016-11-17,EDGA (J),84923956,45499343,46433432,176856731,2704448691.036902,2050789386.524800,1597475632.786904,6352713710.348606,737508,228837,387612,1353957
2016-11-17,EDGX (K),230326383,123363147,201923628,555613158,7949873496.416600,5705723914.908899,6617597173.045672,20273194584.371171,1551460,489456,1222247,3263163
2016-11-17,CHX (M),10444961,20208052,3903736,34556749,540565778.916200,1634233441.280001,293189765.895200,2467988986.091401,2904,6655,1210,10769
2016-11-17,NYSE (N),855626221,0,0,855626221,31059940444.753691,0.000000,0.000000,31059940444.753691,2986983,0,0,2986983
2016-11-17,NYSE Arca (P),255052255,329099604,171820289,755972148,9759591531.597885,15745385692.650269,6648184109.804390,32153161334.052544,1872831,914284,1176807,3963922
2016-11-17,NASDAQ (Q),394145573,128431788,482974646,1005552007,16004390332.973891,6644422850.022894,20023286378.180116,42672099561.176901,3404935,557734,3118448,7081117
2016-11-17,IEX (V),73091564,17543364,37032633,127667561,2856899772.089198,822130574.183200,1519780974.464300,5198811320.736698,440081,71862,229513,741456
2016-11-17,NASDAQ PSX (X),28762804,22452583,24215143,75430530,974703281.510401,1143682745.326100,899256046.304600,3017642073.141101,211448,99388,169179,480015
2016-11-17,BATS BYX (Y),169441093,75588734,78957794,323987621,4792687296.377029,2874665324.787907,2457821601.482406,10125174222.647342,1476726,339905,740873,2557504
2016-11-17,BATS BZX (Z),228033329,108099769,125025985,461159083,7848277626.764142,5627657724.257197,4651625682.454081,18127561033.475420,1870908,497107,970011,3338026
2016-11-16,NYSE MKT (A),0,12881223,0,12881223,0.000000,64663231.411800,0.000000,64663231.411800,0,30196,0,30196
2016-11-16,NASDAQ BX (B),105099393,36461329,56629457,198190179,3829563610.788703,1510474575.913207,2030060184.908701,7370098371.610611,1019578,167669,544941,1732188
2016-11-16,NSX (C),392967,285536,318629,997132,18543044.950000,29926098.620000,12168145.935000,60637289.505000,2579,1115,1549,5243
2016-11-16,NYSE (DN),113721370,47344370,74857944,235923684,3753137627.237400,1770806098.299098,2723444437.657707,8247388163.194205,291482,98975,184545,575002
2016-11-16,NASDAQ (DQ),1231423856,575931443,771558045,2578913344,40578320626.250815,25693796334.187270,24509289024.633458,90781405985.071543,3947292,999750,2244662,7191704
2016-11-16,EDGA (J),94605660,44000006,46262997,184868663,2918906730.014692,1964294084.077799,1508573548.450704,6391774362.543195,805941,211441,377131,1394513
2016-11-16,EDGX (K),227753952,113251076,193816646,534821674,7909855673.787217,5215989712.432194,6469159832.368775,19595005218.588186,1563883,462783,1172333,3198999
2016-11-16,CHX (M),8551375,20688618,23867457,53107450,338343971.080700,1535118544.389200,2480083749.243600,4353546264.713500,3050,6136,1249,10435
2016-11-16,NYSE (N),894645686,0,0,894645686,32433487919.510194,0.000000,0.000000,32433487919.510194,3115957,0,0,3115957
2016-11-16,NYSE Arca (P),255926020,295189752,164903946,716019718,9959110752.498636,14437633013.662916,6845465029.800395,31242208795.961947,1898952,865347,1154551,3918850
2016-11-16,NASDAQ (Q),406590649,123807241,481555757,1011953647,16555504653.556726,6578430666.918293,20542085695.966316,43676021016.441335,3470798,549407,3111996,7132201
2016-11-16,IEX (V),72082132,15722881,33491810,121296823,2811458977.731799,704988435.499801,1457600772.823301,4974048186.054901,429386,64239,209332,702957
2016-11-16,NASDAQ PSX (X),27263989,21057991,21415754,69737734,920573440.844999,1049173883.717500,810542597.050200,2780289921.612699,207133,95855,150487,453475
2016-11-16,BATS BYX (Y),177462827,69103829,79639073,326205729,4977736268.432465,2725915684.148698,2420971626.802491,10124623579.383654,1550747,321056,721427,2593230
2016-11-16,BATS BZX (Z),232383962,105448286,117817228,455649476,7918853022.485245,5340519011.087983,4559196561.512803,17818568595.086031,1889018,473676,929122,3291816
2016-11-15,NYSE MKT (A),0,12230316,0,12230316,0.000000,78519427.106100,0.000000,78519427.106100,0,31880,0,31880
2016-11-15,NASDAQ BX (B),120971077,42546177,65112942,228630196,4649728946.042779,1857980772.719397,2582267722.669704,9089977441.431880,1176585,198363,645596,2020544
2016-11-15,NSX (C),733887,513995,248726,1496608,33326242.800000,54509173.838600,15726396.193300,103561812.831900,4744,2010,1356,8110
2016-11-15,NYSE (DN),137449143,54792401,75843885,268085429,4853442758.930092,2112081054.201708,3144444527.256295,10109968340.388095,344468,117386,208764,670618
2016-11-15,NASDAQ (DQ),1467117060,660688781,791872120,2919677961,50459070756.698393,28938005068.580235,29063576337.611586,108460652162.890214,4568808,1245637,2372744,8187189
2016-11-15,EDGA (J),107666483,58242849,50668110,216577442,3406487754.466804,2582364977.757993,1856685072.206298,7845537804.431095,924380,268781,424979,1618140
2016-11-15,EDGX (K),259943325,138407427,199044570,597395322,9284639760.589896,6524531003.819300,7563526993.702878,23372697758.112074,1845007,557610,1302807,3705424
2016-11-15,CHX (M),7591084,17441796,5169212,30202092,424537969.415800,1807275629.851600,323811376.896300,2555624976.163700,3315,7624,1412,12351
2016-11-15,NYSE (N),1046657171,0,0,1046657171,38728512844.658298,0.000000,0.000000,38728512844.658298,3613968,0,0,3613968
2016-11-15,NYSE Arca (P),310882340,380482762,172750869,864115971,12412082481.087561,18330591650.908054,7925151567.472093,38667825699.467708,2294260,1053572,1257725,4605557
2016-11-15,NASDAQ (Q),491439627,152085160,518757499,1162282286,20429745262.338971,8438563588.444222,24408968604.572386,53277277455.355579,4255313,662859,3469744,8387916
2016-11-15,IEX (V),95222424,22143085,39147283,156512792,3710059065.591998,994356815.498300,1921380591.849202,6625796472.939500,553925,88386,244638,886949
2016-11-15,NASDAQ PSX (X),33081773,27389163,25274172,85745108,1129020338.338201,1342975579.558901,1090381172.391700,3562377090.288802,251282,120685,180214,552181
2016-11-15,BATS BYX (Y),197544676,89416920,87820176,374781772,5738129281.874182,3482965643.990305,2884131144.249404,12105226070.113891,1727639,402118,816296,2946053
2016-11-15,BATS BZX (Z),271819586,126138547,127478638,525436771,9615985395.239287,6613476734.473796,5404063561.507911,21633525691.220994,2228612,571410,1044286,3844308
2016-11-14,NYSE MKT (A),0,12791141,0,12791141,0.000000,76680897.403400,0.000000,76680897.403400,0,33342,0,33342
2016-11-14,NASDAQ BX (B),142952779,51309526,76810193,271072498,5287930848.596190,2199375556.126594,3015674536.405696,10502980941.128480,1375014,232675,740277,2347966
2016-11-14,NSX (C),974663,615294,378307,1968264,39949891.420000,55020496.740000,19133689.585900,114104077.745900,5493,2324,2570,10387
2016-11-14,NYSE (DN),176736523,68663308,83980386,329380217,6392931261.060644,2768313694.018012,4052718971.268810,13213963926.347466,418961,137827,232226,789014
2016-11-14,NASDAQ (DQ),1748286836,859787409,848813103,3456887348,59599571789.757656,37554969814.434815,34878356864.122010,132032898468.314481,5153240,1496734,2556051,9206025
2016-11-14,EDGA (J),128616678,65033568,57356119,251006365,4050083986.491604,2724580371.561097,2218594936.501196,8993259294.553897,1105036,292294,495712,1893042
2016-11-14,EDGX (K),315184837,180249318,221463852,716898007,11262966459.354375,8610808121.772949,9049649068.773772,28923423649.901096,2213356,714481,1516861,4444698
2016-11-14,CHX (M),7563641,26718499,4246868,38529008,388223661.753400,2185542931.284600,285579345.949300,2859345938.987300,3934,11577,2936,18447
2016-11-14,NYSE (N),1198606385,0,0,1198606385,43718559536.061575,0.000000,0.000000,43718559536.061575,4234957,0,0,4234957
2016-11-14,NYSE Arca (P),373063870,487584005,194055451,1054703326,15184848014.651082,23630083071.640878,9615426054.601103,48430357140.893063,2756418,1391265,1450549,5598232
2016-11-14,NASDAQ (Q),565027589,193630696,565395846,1324054131,23517793324.085466,10706591596.461606,28081201473.749773,62305586394.296845,4807648,843731,4067267,9718646
2016-11-14,IEX (V),107808362,27345802,45337401,180491565,4368463600.381600,1328361895.039101,2230751425.761603,7927576921.182304,624935,107652,278708,1011295
2016-11-14,NASDAQ PSX (X),39310029,32627609,29041491,100979129,1303178223.682904,1682544217.073799,1245122088.249102,4230844529.005805,294933,144584,219031,658548
2016-11-14,BATS BYX (Y),243362221,109134430,100438966,452935617,6856017468.927872,4160970916.187794,3361043057.273998,14378031442.389664,2109695,475077,949717,3534489
2016-11-14,BATS BZX (Z),326180869,157437516,144591357,628209742,11555446303.487471,8390167887.168563,6477171054.953115,26422785245.609149,2682921,682701,1244223,4609845
2016-11-11,NYSE MKT (A),0,15599439,0,15599439,0.000000,96577409.616800,0.000000,96577409.616800,0,37905,0,37905
2016-11-11,NASDAQ BX (B),133184216,53940172,75494198,262618586,4868040760.256664,2195683376.538397,2957817093.552184,10021541230.347245,1240284,250943,727087,2218314
2016-11-11,NSX (C),536039,901759,390777,1828575,20954362.230000,90699673.204600,22055911.161200,133709946.595800,3527,2995,2737,9259
2016-11-11,NYSE (DN),145288587,65916267,73045781,284250635,4746425152.368402,2442031479.443806,3380787348.824397,10569243980.636605,355804,137118,206950,699872
2016-11-11,NASDAQ (DQ),1515457938,794116614,762028169,3071602721,47472343998.124726,33501944280.247797,29922313403.437234,110896601681.809757,4611447,1451007,2348759,8411213
2016-11-11,EDGA (J),119758502,67475322,57795124,245028948,3590774237.520581,2962260891.454195,2181128889.956705,8734164018.931481,1005416,323857,496442,1825715
2016-11-11,EDGX (K),303974404,196461306,214319853,714755563,9932598486.445146,9595287116.372448,8351734156.957183,27879619759.774777,2061450,808399,1476612,4346461
2016-11-11,CHX (M),8529703,38530271,3887131,50947105,496161536.583400,2887887147.649002,392022067.968900,3776070752.201302,3268,14169,2337,19774
2016-11-11,NYSE (N),1173234372,0,0,1173234372,40428159941.972695,0.000000,0.000000,40428159941.972695,4175499,0,0,4175499
2016-11-11,NYSE Arca (P),356863347,556109628,189191750,1102164725,13387263365.911290,25632604738.308038,9175483140.780533,48195351244.999861,2574361,1589433,1451154,5614948
2016-11-11,NASDAQ (Q),543531822,220096599,592694434,1356322855,21261415852.458650,11871892323.620077,27577535955.666346,60710844131.745073,4674985,996443,4062879,9734307
2016-11-11,IEX (V),104363553,27280917,43365706,175010176,3804398061.058605,1290053558.739398,2084916623.165598,7179368242.963601,595474,110854,274537,980865
2016-11-11,NASDAQ PSX (X),35652752,36124288,27958829,99735869,1127251984.582599,1830065771.197800,1192634359.743000,4149952115.523399,265125,161695,211885,638705
2016-11-11,BATS BYX (Y),237395946,113498252,103366001,454260199,6423192542.156947,4269922716.839797,3348690271.809788,14041805530.806532,2019821,524942,985386,3530149
2016-11-11,BATS BZX (Z),316224206,184873508,146542466,647640180,10368522290.346144,9550349942.834310,6214806275.238582,26133678508.419036,2540672,845003,1259356,4645031
2016-11-10,NYSE MKT (A),0,16664038,0,16664038,0.000000,93532684.862900,0.000000,93532684.862900,0,37469,0,37469
2016-11-10,NASDAQ BX (B),170470194,77310867,82937838,330718899,6433843634.259296,3270281060.660592,3668674280.194703,13372798975.114591,1630333,330208,849051,2809592
2016-11-10,NSX (C),866468,1286287,517972,2670727,34137459.950000,137992203.534700,28417617.543400,200547281.028100,6177,4775,3530,14482
2016-11-10,NYSE (DN),198782452,81762063,106458867,387003382,7266852817.993644,3507826967.878092,5294448629.511891,16069128415.383627,488874,167242,274685,930801
2016-11-10,NASDAQ (DQ),1944646139,940097698,1000885385,3885629222,66072764574.832365,42075308610.886211,42927009198.314627,151075082384.033203,5887422,1825499,2976177,10689098
2016-11-10,EDGA (J),159371162,93758608,70612920,323742690,4918369466.424358,4316181045.507993,2815965690.963002,12050516202.895353,1358070,430503,621987,2410560
2016-11-10,EDGX (K),413412716,253297558,290863437,957573711,14891376653.725056,13681665510.915372,12398450125.838156,40971492290.478584,2979534,1066782,2025909,6072225
2016-11-10,CHX (M),13279062,37140304,5595489,56014855,618862410.788300,3693392943.266800,477213127.767100,4789468481.822200,4271,17019,5722,27012
2016-11-10,NYSE (N),1451344133,0,0,1451344133,52934330451.425735,0.000000,0.000000,52934330451.425735,5417828,0,0,5417828
2016-11-10,NYSE Arca (P),480147729,704511587,264439988,1449099304,18931732763.716867,37191871174.722953,14307487686.336293,70431091624.776113,3472807,2063888,1981157,7517852
2016-11-10,NASDAQ (Q),736718011,306141781,747463503,1790323295,30391383710.051891,18014097385.674485,37981677771.469519,86387158867.195895,6382128,1351069,5413701,13146898
2016-11-10,IEX (V),129844008,36297883,55722549,221864440,5031443588.490012,1806027608.402497,3050361130.942995,9887832327.835504,755852,147677,350504,1254033
2016-11-10,NASDAQ PSX (X),49282028,48636875,39971686,137890589,1583067882.280096,2657847693.351901,1859336273.150502,6100251848.782499,329706,215072,262927,807705
2016-11-10,BATS BYX (Y),286468143,144937280,118191258,549596681,8107759481.349447,6081891159.214397,4174257942.319893,18363908582.883737,2545544,659596,1210642,4415782
2016-11-10,BATS BZX (Z),423822694,251674231,203100472,878597397,15006135335.201294,14962049688.881049,9664170068.390278,39632355092.472621,3560656,1141995,1835221,6537872
2016-11-09,NYSE MKT (A),0,15532916,0,15532916,0.000000,85787369.649700,0.000000,85787369.649700,0,34732,0,34732
2016-11-09,NASDAQ BX (B),161330448,72951679,77986341,312268468,5941451623.263403,3295828713.426405,3270379570.840590,12507659907.530398,1468745,313802,798456,2581003
2016-11-09,NSX (C),1298123,1150992,646365,3095480,45696036.040000,149561863.534000,29992545.760300,225250445.334300,7490,3700,4111,15301
2016-11-09,NYSE (DN),190045353,83068403,95658711,368772467,6697957172.308702,3756856969.876485,4659724529.408196,15114538671.593383,463513,176541,257314,897368
2016-11-09,NASDAQ (DQ),1828933953,927933917,934435331,3691303201,61597227053.212303,45607625680.380856,37885251539.533787,145090104273.126946,5670670,1786672,2900423,10357765
2016-11-09,EDGA (J),152334988,94872155,67315262,314522405,4679012244.238293,4477695629.835901,2670569279.096501,11827277153.170695,1250659,422071,600505,2273235
2016-11-09,EDGX (K),400844178,259575624,271207395,931627197,14201534894.011890,15206444739.433500,11408410057.283105,40816389690.728495,2739682,1093641,1955622,5788945
2016-11-09,CHX (M),9157588,27282103,5465106,41904797,387224472.663000,3874116389.315002,539330753.945200,4800671615.923202,4000,20741,4070,28811
2016-11-09,NYSE (N),1434629470,0,0,1434629470,52605045840.205056,0.000000,0.000000,52605045840.205056,5087569,0,0,5087569
2016-11-09,NYSE Arca (P),485443446,719158478,252119987,1456721911,19017742991.586349,42109813576.264711,13911995511.964756,75039552079.815816,3401192,2140557,1926984,7468733
2016-11-09,NASDAQ (Q),728993102,321507549,731428956,1781929607,29371204384.695188,20958452839.268690,36384876550.888172,86714533774.852050,6016205,1396860,5185818,12598883
2016-11-09,IEX (V),133299232,39347880,51162812,223809924,4961132885.418467,1979163611.170499,2682430036.002799,9622726532.591765,719953,142861,330049,1192863
2016-11-09,NASDAQ PSX (X),46987360,49162954,34604971,130755285,1601270678.625002,2786447178.927401,1541240059.263500,5928957916.815903,311010,205376,249600,765986
2016-11-09,BATS BYX (Y),280785272,150561498,114991592,546338362,7923017946.934161,6420667192.731904,3983213886.983611,18326899026.649676,2336882,664117,1180843,4181842
2016-11-09,BATS BZX (Z),413510441,259751135,190548236,863809812,14441201178.603631,15616160062.259022,8937553991.330406,38994915232.193059,3285655,1140198,1755232,6181085
2016-11-08,NYSE MKT (A),0,9224503,0,9224503,0.000000,57988640.180200,0.000000,57988640.180200,0,21717,0,21717
2016-11-08,NASDAQ BX (B),108203573,36525672,53889117,198618362,3623468329.293505,1695888082.698300,1923654995.831802,7243011407.823607,995648,170239,521738,1687625
2016-11-08,NSX (C),698794,383828,321863,1404485,25307579.500000,34957391.153200,13276416.036200,73541386.689400,4721,1577,2305,8603
2016-11-08,NYSE (DN),118393109,47748339,60779194,226920642,3713655449.395860,1999182132.253908,2555071807.597001,8267909389.246769,299813,101769,164721,566303
2016-11-08,NASDAQ (DQ),1244094642,530079079,624163620,2398337341,37829438054.430946,23733726366.549956,21577367507.402342,83140531928.383244,3865237,997599,1956303,6819139
2016-11-08,EDGA (J),95684905,44394645,39734790,179814340,2708938368.874011,2155910988.307597,1461434835.740200,6326284192.921808,768031,208323,338322,1314676
2016-11-08,EDGX (K),230674830,117192751,157975585,505843166,7375893566.683921,6168261590.531003,6053478043.317500,19597633200.532424,1545826,472465,1069042,3087333
2016-11-08,CHX (M),4783173,14290373,2616908,21690454,236478601.987400,1470255611.914500,151071678.460800,1857805892.362700,3070,6314,1670,11054
2016-11-08,NYSE (N),895553198,0,0,895553198,31110499277.916039,0.000000,0.000000,31110499277.916039,3112449,0,0,3112449
2016-11-08,NYSE Arca (P),274610060,307866412,140297980,722774452,9764460388.697558,17501392284.986713,6413695635.180822,33679548308.865093,1953398,941914,1055685,3950997
2016-11-08,NASDAQ (Q),412669584,127037764,415477657,955185005,15331415568.979430,7770855371.425521,19068227245.221660,42170498185.626611,3337092,549774,2874572,6761438
2016-11-08,IEX (V),80381625,18685170,32438778,131505573,2807486180.208310,950627907.389399,1520251218.524201,5278365306.121910,455829,67161,200676,723666
2016-11-08,NASDAQ PSX (X),26762514,20659682,22080506,69502702,793950628.125000,1212833348.821001,790132711.463500,2796916688.409501,186580,92278,153861,432719
2016-11-08,BATS BYX (Y),189404893,74675339,78473584,342553816,5082320812.618726,3181248477.085005,2490332072.740687,10753901362.444418,1542894,344791,713762,2601447
2016-11-08,BATS BZX (Z),239942587,113238952,111194608,464376147,7527075140.549609,6749041107.878391,4533292767.859434,18809409016.287434,1831938,494919,910270,3237127
2016-11-07,NYSE MKT (A),0,10196663,0,10196663,0.000000,65712323.988300,0.000000,65712323.988300,0,25298,0,25298
2016-11-07,NASDAQ BX (B),109412204,35271162,58122384,202805750,3781222537.403196,1624359578.123199,2188186945.978892,7593769061.505287,1070759,168193,574176,1813128
2016-11-07,NSX (C),770699,480781,427185,1678665,26116224.540000,46963183.530000,24929417.330000,98008825.400000,5036,1725,3030,9791
2016-11-07,NYSE (DN),109376480,49433600,66948898,225758978,3458941603.689894,2021343072.584002,2816843758.467301,8297128434.741197,310600,110619,191037,612256
2016-11-07,NASDAQ (DQ),1166097726,556422946,700936220,2423456892,37868853626.397455,27509914055.498625,25685882662.741424,91064650344.637504,3973700,1125932,2201454,7301086
2016-11-07,EDGA (J),92909063,44709710,44047851,181666624,2842031611.001502,2207705400.363196,1660765115.277996,6710502126.642694,793168,223466,375880,1392514
2016-11-07,EDGX (K),211094261,109645368,159083707,479823336,7240262233.327820,5847688091.834609,6292004802.760808,19379955127.923237,1464865,444812,1072175,2981852
2016-11-07,CHX (M),8550886,12606274,3617472,24774632,400820153.198200,1309964478.724998,222890018.959800,1933674650.882998,3462,7093,2051,12606
2016-11-07,NYSE (N),913438128,0,0,913438128,33259335162.636911,0.000000,0.000000,33259335162.636911,2869303,0,0,2869303
2016-11-07,NYSE Arca (P),243438104,362565504,146017578,752021186,9267931553.905403,19925791663.583610,7067254694.333006,36260977911.822019,1820902,907063,1090207,3818172
2016-11-07,NASDAQ (Q),383817072,125605128,480418979,989841179,15315311767.025578,7611489998.009600,22827031608.654215,45753833373.689393,3242470,540603,2941292,6724365
2016-11-07,IEX (V),71959559,18374740,39468514,129802813,2667320908.177107,982536101.506099,1752802752.328699,5402659762.011905,448272,77889,238577,764738
2016-11-07,NASDAQ PSX (X),27773517,19934649,21767006,69475172,891067978.727499,1134243782.962499,833924606.809400,2859236368.499398,212312,91150,156555,460017
2016-11-07,BATS BYX (Y),178681551,75231626,82741865,336655042,4962760807.596470,3171798255.630099,2680217343.779915,10814776407.006484,1547809,342774,755061,2645644
2016-11-07,BATS BZX (Z),222403639,108896339,113024367,444324345,7521203794.918879,6207673181.567277,4594367387.431134,18323244363.917290,1805422,477242,918060,3200724
2016-11-04,NYSE MKT (A),0,10258384,0,10258384,0.000000,69035841.109100,0.000000,69035841.109100,0,27288,0,27288
2016-11-04,NASDAQ BX (B),105700838,36765396,58954316,201420550,3490188510.135116,1573669598.733001,2152439348.521201,7216297457.389318,1002579,171183,567005,1740767
2016-11-04,NSX (C),507760,449612,261072,1218444,18547246.520000,51633859.723500,16154520.020000,86335626.263500,2944,1389,1999,6332
2016-11-04,NYSE (DN),101299290,44225864,73073405,218598559,3125238843.763902,1889534291.706805,3012859097.616996,8027632233.087703,296156,94520,203453,594129
2016-11-04,NASDAQ (DQ),1198314210,526194745,723380921,2447889876,36994967352.390046,24982845166.920348,25229918045.297457,87207730564.607851,3956143,1081707,2321253,7359103
2016-11-04,EDGA (J),91296339,41112080,45811155,178219574,2589028334.176517,1781869214.772897,1621173468.478701,5992071017.428115,751820,207838,370730,1330388
2016-11-04,EDGX (K),221598790,116196660,172753492,510548942,7338740275.539870,5728111376.372500,6600420245.880078,19667271897.792448,1576893,514449,1183140,3274482
2016-11-04,CHX (M),11666995,21471829,5032754,38171578,558427657.142200,1829172142.580000,299644625.335500,2687244425.057700,3326,8284,1952,13562
2016-11-04,NYSE (N),917278316,0,0,917278316,31483659054.233756,0.000000,0.000000,31483659054.233756,3070767,0,0,3070767
2016-11-04,NYSE Arca (P),255617744,329067373,164079122,748764239,9363631635.050687,17092077927.030934,7353087392.420205,33808796954.501826,1915467,1030187,1224876,4170530
2016-11-04,NASDAQ (Q),409104077,137112048,503314762,1049530887,15810454949.118987,7875180492.300508,22506325882.006172,46191961323.425667,3440688,634072,3266801,7341561
2016-11-04,IEX (V),81440363,17953805,42304665,141698833,2871784454.875008,959399436.551100,1760765039.740002,5591948931.166110,474902,74449,252289,801640
2016-11-04,NASDAQ PSX (X),26832054,23325952,22990763,73148769,809229489.394702,1372206759.283498,831303980.881901,3012740229.560101,202829,110586,165426,478841
2016-11-04,BATS BYX (Y),183156403,75632245,83115460,341904108,4773988023.306268,2932162360.103896,2609874737.563302,10316025120.973466,1501122,350285,738589,2589996
2016-11-04,BATS BZX (Z),238105839,113332813,125058538,476497190,7559490483.418494,6008522449.511008,4958576310.163486,18526589243.092988,1881033,536617,1014211,3431861
2016-11-03,NYSE MKT (A),0,10416968,0,10416968,0.000000,67880827.502000,0.000000,67880827.502000,0,26988,0,26988
2016-11-03,NASDAQ BX (B),104202978,32731938,61670775,198605691,3552405559.939596,1439818681.773699,2257830321.013502,7250054562.726797,957221,160629,593493,1711343
2016-11-03,NSX (C),600839,382340,372719,1355898,22064390.710000,34497439.277600,10284696.083000,66846526.070600,3935,1214,2431,7580
2016-11-03,NYSE (DN),109428720,42507450,75106924,227043094,3549899671.042898,1721500817.498002,2854128835.176594,8125529323.717494,288441,91721,200655,580817
2016-11-03,NASDAQ (DQ),1216266952,486944287,777047901,2480259140,37478085353.127048,21149243046.181790,27450516842.732070,86077845242.040908,4002456,953470,2406427,7362353
2016-11-03,EDGA (J),92786767,37763263,46644127,177194157,2638430281.136999,1704162038.626102,1583106345.100304,5925698664.863405,746192,186593,379123,1311908
2016-11-03,EDGX (K),230440970,111783443,189212069,531436482,7731410509.166262,5439825264.902083,7030233177.920881,20201468951.989226,1638240,482727,1259803,3380770
2016-11-03,CHX (M),7116731,15698262,5302874,28117867,337927790.684600,1417575761.415400,359797231.387200,2115300783.487200,3372,6133,2022,11527
2016-11-03,NYSE (N),904822554,0,0,904822554,30681080819.937919,0.000000,0.000000,30681080819.937919,3038012,0,0,3038012
2016-11-03,NYSE Arca (P),263125505,324983214,177271965,765380684,9794849048.425923,16806885696.860902,7791870033.807711,34393604779.094536,1969267,929923,1254242,4153432
2016-11-03,NASDAQ (Q),416319160,123375544,492779829,1032474533,15989137231.119532,6909755070.912211,21805345121.349871,44704237423.381614,3511081,569700,3310204,7390985
2016-11-03,IEX (V),89732330,15341058,45069150,150142538,3207279623.763798,814616344.137899,1917667164.404299,5939563132.305996,502032,63581,262455,828068
2016-11-03,NASDAQ PSX (X),28396763,20962970,26403100,75762833,872101721.568898,1137002449.988001,955250195.000301,2964354366.557200,217023,101989,176330,495342
2016-11-03,BATS BYX (Y),186754063,73413484,88177259,348344806,4865481437.951576,2868034344.121103,2732920420.150403,10466436202.223082,1500196,347436,781030,2628662
2016-11-03,BATS BZX (Z),242112710,105032981,128679447,475825138,7875960087.519814,5656853134.669488,5038055497.555883,18570868719.745185,1910697,498554,1040214,3449465
2016-11-02,NYSE MKT (A),0,13548913,0,13548913,0.000000,83697403.074700,0.000000,83697403.074700,0,33261,0,33261
2016-11-02,NASDAQ BX (B),110556798,43299749,62635664,216492211,3895547056.881904,1855687783.610595,2332567286.497205,8083802126.989704,1041625,196122,578413,1816160
2016-11-02,NSX (C),546318,445227,204844,1196389,22656332.810000,37598544.740000,10068327.695800,70323205.245800,3007,1666,1562,6235
2016-11-02,NYSE (DN),118707033,53858120,70537790,243102943,3819246925.702488,2032448293.001003,2752020403.453002,8603715622.156493,328168,111234,189249,628651
2016-11-02,NASDAQ (DQ),1346844561,600242338,759130997,2706217896,41257012464.018230,25822925276.375773,25539886756.714009,92619824497.108012,4220562,1191679,2236177,7648418
2016-11-02,EDGA (J),103750575,53506332,48953047,206209954,2990218651.898193,2293469523.125802,1753778248.136502,7037466423.160497,860071,250313,386118,1496502
2016-11-02,EDGX (K),257368159,142057184,194266779,593692122,8705055848.866301,6591425287.114912,7486360691.240994,22782841827.222207,1860558,590413,1270520,3721491
2016-11-02,CHX (M),9598020,17669376,7772794,35040190,380506560.291400,1608671118.270001,580543283.147000,2569720961.708401,3881,8434,1948,14263
2016-11-02,NYSE (N),999008936,0,0,999008936,34751693322.695355,0.000000,0.000000,34751693322.695355,3562729,0,0,3562729
2016-11-02,NYSE Arca (P),295363350,390096248,190513454,875973052,11239695288.742363,19842285048.303162,8667124736.142226,39749105073.187751,2231413,1163914,1282910,4678237
2016-11-02,NASDAQ (Q),455414685,161151647,500260409,1116826741,17844651140.036885,8741987933.175116,22748747378.798112,49335386452.010113,3896905,701401,3370729,7969035
2016-11-02,IEX (V),86556905,20707693,39552886,146817484,3066572669.503507,1032665739.391500,1761669923.914401,5860908332.809408,512074,80397,235863,828334
2016-11-02,NASDAQ PSX (X),31247354,28956624,26892712,87096690,968394925.982600,1471167811.675600,938015872.413400,3377578610.071600,246278,129775,180970,557023
2016-11-02,BATS BYX (Y),204997586,91752612,92074472,388824670,5482788404.693596,3495207252.036305,2898897455.360907,11876893112.090808,1674042,433256,763323,2870621
2016-11-02,BATS BZX (Z),269160604,137544671,132196838,538902113,8917336206.992160,7025025566.140600,5243899087.533894,21186260860.666654,2151197,623969,1033130,3808296
2016-11-01,NYSE MKT (A),0,11782386,0,11782386,0.000000,83355684.403900,0.000000,83355684.403900,0,31782,0,31782
2016-11-01,NASDAQ BX (B),120347949,40148601,58669711,219166261,4325051571.678507,1813922135.066105,2488758878.608096,8627732585.352708,1110941,189313,574772,1875026
2016-11-01,NSX (C),700278,391497,239446,1331221,25032634.520000,42861764.760000,11411770.682500,79306169.962500,4120,1522,1785,7427
2016-11-01,NYSE (DN),127667726,58334376,61535972,247538074,3981757297.130622,2507853403.800805,2696094845.685796,9185705546.617223,330402,116270,172829,619501
2016-11-01,NASDAQ (DQ),1469695741,602871124,665600442,2738167307,44535326597.122071,30200691660.234922,24585940700.089251,99321958957.446244,4420975,1159297,2075588,7655860
2016-11-01,EDGA (J),108951433,50114563,45095293,204161289,3161880040.281400,2253714477.750098,1726119465.802700,7141713983.834198,880736,232531,378929,1492196
2016-11-01,EDGX (K),257318669,141527215,176555173,575401057,8741680334.033179,7137784926.358291,7081476106.514398,22960941366.905868,1853500,595370,1208525,3657395
2016-11-01,CHX (M),6744135,20340773,4863286,31948194,359358113.102300,2099869873.593201,432596553.300000,2891824539.995501,4098,8612,1875,14585
2016-11-01,NYSE (N),1080769013,0,0,1080769013,37656638833.224426,0.000000,0.000000,37656638833.224426,3453869,0,0,3453869
2016-11-01,NYSE Arca (P),298332660,389915415,153520157,841768232,11233961203.882572,21199855053.949348,7437456950.408425,39871273208.240345,2245119,1115722,1161566,4522407
2016-11-01,NASDAQ (Q),467173237,160584118,454898767,1082656122,18180145604.279324,9189317267.991358,21920565279.826465,49290028152.097147,3966140,715741,3138914,7820795
2016-11-01,IEX (V),99900597,20850179,34474176,155224952,3471542481.529012,1093171228.524700,1697477863.725997,6262191573.779709,563443,76769,227899,868111
2016-11-01,NASDAQ PSX (X),31416854,28122787,24762874,84302515,962392913.186000,1603784419.066500,918355951.103599,3484533283.356099,238663,126839,166614,532116
2016-11-01,BATS BYX (Y),208312549,90057796,81057733,379428078,5651827747.686910,3574228507.869798,2763718053.229807,11989774308.786515,1646824,407828,728274,2782926
2016-11-01,BATS BZX (Z),261860666,132814186,119655598,514330450,8679855116.219419,7625422239.783010,5318454362.328016,21623731718.330445,2095905,604036,994334,3694275
2016-10-31,NYSE MKT (A),0,10231953,0,10231953,0.000000,84498086.754600,0.000000,84498086.754600,0,22752,0,22752
2016-10-31,NASDAQ BX (B),105075671,29192639,50491093,184759403,3760725949.518078,1273994181.177300,1965041045.108103,6999761175.803481,989305,141099,497077,1627481
2016-10-31,NSX (C),719282,445322,246799,1411403,30802351.420000,31927063.940000,8866335.788000,71595751.148000,4823,2277,1731,8831
2016-10-31,NYSE (DN),107856437,34951689,54767229,197575355,3490469505.305699,1496626939.187501,2259297991.173996,7246394435.667196,313369,79287,159957,552613
2016-10-31,NASDAQ (DQ),1219432284,448488073,628203522,2296123879,40937428259.487551,20225322606.367071,22230911922.523549,83393662788.378171,3727452,853394,1813982,6394828
2016-10-31,EDGA (J),96529029,37796121,37130895,171456045,3015609413.136199,1632870834.942202,1431113563.433398,6079593811.511799,801355,169007,315729,1286091
2016-10-31,EDGX (K),206543182,91318930,142275969,440138081,7416886855.522976,4291571338.572599,5720197783.672477,17428655977.768052,1489154,379440,947728,2816322
2016-10-31,CHX (M),9419021,13467528,4365036,27251585,551443476.488900,1355624307.615000,354036386.828700,2261104170.932600,3273,5295,1046,9614
2016-10-31,NYSE (N),1052038354,0,0,1052038354,39202493687.794585,0.000000,0.000000,39202493687.794585,2830858,0,0,2830858
2016-10-31,NYSE Arca (P),243434141,288526803,124535732,656496676,9460139108.055164,14367007963.167710,5834923122.801331,29662070194.024205,1786694,745397,917874,3449965
2016-10-31,NASDAQ (Q),377696099,104947181,452728143,935371423,14889987963.315620,5555429438.226083,20797678035.871492,41243095437.413195,3076644,437319,2496428,6010391
2016-10-31,IEX (V),78416359,16203841,27622595,122242795,2914956462.010899,760640121.728700,1304435146.641401,4980031730.381000,453977,59452,179851,693280
2016-10-31,NASDAQ PSX (X),25880895,17150065,19619260,62650220,835044317.127699,855271974.666500,727406756.690200,2417723048.484399,207527,73663,137505,418695
2016-10-31,BATS BYX (Y),187548857,67526351,72854705,327929913,5241272761.837101,2617369989.382300,2391150545.728999,10249793296.948400,1514658,299540,640402,2454600
2016-10-31,BATS BZX (Z),215979250,91209554,94219397,401408201,7338161723.442577,4632519841.197798,4028042356.151896,15998723920.792271,1700095,404228,771861,2876184
2016-10-28,NYSE MKT (A),0,9700537,0,9700537,0.000000,65834696.766500,0.000000,65834696.766500,0,25197,0,25197
2016-10-28,NASDAQ BX (B),101711872,35587239,51373743,188672854,3604150063.713559,1735235695.463197,2271285773.026296,7610671532.203052,922059,158951,490390,1571400
2016-10-28,NSX (C),502058,320424,281370,1103852,16412509.780000,29756913.797200,11760584.729700,57930008.306900,3301,972,1996,6269
2016-10-28,NYSE (DN),115494401,47149192,69033304,231676897,4004736430.669053,2177552764.201907,3491042503.174205,9673331698.045165,308270,98761,180667,587698
2016-10-28,NASDAQ (DQ),1264149114,468256774,686236689,2418642577,41199435366.924673,23121990061.711184,28662985476.467962,92984410905.103819,3842109,981908,2082006,6906023
2016-10-28,EDGA (J),97082413,42847601,43692772,183622786,2935328539.315210,2003735291.941799,1787869080.963302,6726932912.220311,786996,204758,358455,1350209
2016-10-28,EDGX (K),241876808,130592179,178609876,551078863,8530443879.377173,7140797059.800115,8159083636.666598,23830324575.843886,1681453,569703,1166277,3417433
2016-10-28,CHX (M),10278705,18763580,3534199,32576484,499293935.001300,2084122578.049998,377502166.016800,2960918679.068098,3038,8183,1563,12784
2016-10-28,NYSE (N),967763928,0,0,967763928,34712713956.918653,0.000000,0.000000,34712713956.918653,3335705,0,0,3335705
2016-10-28,NYSE Arca (P),275155977,376625366,166017832,817799175,10897584726.589002,21893916730.578689,9282502928.813481,42074004385.981172,2055625,1196516,1190861,4443002
2016-10-28,NASDAQ (Q),417164853,150623979,459647627,1027436459,17092776914.518920,9431056474.972316,24518734042.882638,51042567432.373874,3484334,690187,3082208,7256729
2016-10-28,IEX (V),90192198,17421526,35624214,143237938,3523089268.617799,1037794976.156200,1999635800.962499,6560520045.736498,529293,73492,226414,829199
2016-10-28,NASDAQ PSX (X),28793579,24719928,23706811,77220318,903837673.351500,1633528146.374701,981304577.653000,3518670397.379201,208511,110213,155665,474389
2016-10-28,BATS BYX (Y),179331420,72278622,75177970,326788012,4966438622.268122,3072331533.357308,2784440765.173197,10823210920.798627,1415910,344927,650255,2411092
2016-10-28,BATS BZX (Z),238781799,123947621,118879165,481608585,8215247602.441448,7437952326.341490,6010323042.122521,21663522970.905459,1847304,584786,952616,3384706
2016-10-27,NYSE MKT (A),0,8244596,0,8244596,0.000000,73591949.408700,0.000000,73591949.408700,0,27067,0,27067
2016-10-27,NASDAQ BX (B),107814747,29239361,54134294,191188402,3865931266.423708,1357310968.179002,2436159486.057199,7659401720.659909,991062,132525,509798,1633385
2016-10-27,NSX (C),408567,240256,202526,851349,14232194.640000,17868349.660000,7332374.990000,39432919.290000,2942,876,1265,5083
2016-10-27,NYSE (DN),121723497,39043490,69430749,230197736,3823442854.190081,1793430245.687700,3024151033.487490,8641024133.365271,324494,79248,185194,588936
2016-10-27,NASDAQ (DQ),1368804157,393947145,707554723,2470306025,41209882682.325848,18870244744.685861,27714033540.078428,87794160967.090137,4020490,809488,2113231,6943209
2016-10-27,EDGA (J),104081680,33144090,44487351,181713121,3045054552.606109,1579668907.497401,1646187291.537101,6270910751.640611,829123,159784,345079,1333986
2016-10-27,EDGX (K),239592166,92359721,171161713,503113600,7757463985.156721,4778860092.381591,7314733231.764981,19851057309.303293,1587091,396365,1104257,3087713
2016-10-27,CHX (M),12515158,12760143,4599596,29874897,585409388.481900,1230496006.145000,535761319.729600,2351666714.356500,3175,5710,1435,10320
2016-10-27,NYSE (N),984221726,0,0,984221726,34091504018.909778,0.000000,0.000000,34091504018.909778,3112814,0,0,3112814
2016-10-27,NYSE Arca (P),290409372,275599727,169563381,735572480,10424967732.374463,14914932966.428480,9216803270.980668,34556703969.783611,2005910,821540,1173536,4000986
2016-10-27,NASDAQ (Q),427939494,101899820,452868552,982707866,16756471595.181979,5992710058.614099,23180897810.701566,45930079464.497644,3399123,449930,2930073,6779126
2016-10-27,IEX (V),91306447,13511073,38642603,143460123,3234421456.045101,790121262.916300,1971807764.339799,5996350483.301200,482872,54893,216358,754123
2016-10-27,NASDAQ PSX (X),26552511,16418804,22655913,65627228,792491975.434499,986179535.527999,856296883.883000,2634968394.845498,193678,71850,145411,410939
2016-10-27,BATS BYX (Y),187622776,61645017,78458373,327726166,5135023171.853040,2518344858.387306,2721442798.504098,10374810828.744444,1470498,279309,653515,2403322
2016-10-27,BATS BZX (Z),246413871,84290363,113061279,443765513,8238275358.901247,4640019986.083108,4976220761.975308,17854516106.959663,1868359,397519,893308,3159186
2016-10-26,NYSE MKT (A),0,8575052,0,8575052,0.000000,81827860.260700,0.000000,81827860.260700,0,26800,0,26800
2016-10-26,NASDAQ BX (B),95326871,29514555,48161316,173002742,3425296023.163323,1307689674.623401,2025323180.616011,6758308878.402735,885214,137811,469619,1492644
2016-10-26,NSX (C),402413,277501,158325,838239,12717654.760000,37241716.740000,6427598.260000,56386969.760000,2706,876,1144,4726
2016-10-26,NYSE (DN),110775039,34990485,61255987,207021511,3604701079.564606,1471275892.380500,2746653762.986299,7822630734.931405,281683,80103,163322,525108
2016-10-26,NASDAQ (DQ),1253673253,433255749,655127518,2342056520,40237176737.624951,18653688525.361545,24280932315.242899,83171797578.229395,3881277,842004,1922429,6645710
2016-10-26,EDGA (J),91243677,34149118,39862956,165255751,2698926402.608695,1463594319.179601,1474705333.089698,5637226054.877994,755461,166258,332934,1254653
2016-10-26,EDGX (K),211650117,94179021,158080310,463909448,7368023324.009600,4652748415.980981,6444867464.147203,18465639204.137784,1460560,389497,1015581,2865638
2016-10-26,CHX (M),10989372,10395557,5060411,26445340,439506577.261600,1191902597.270000,431732173.540500,2063141348.072100,2711,6498,1273,10482
2016-10-26,NYSE (N),885983675,0,0,885983675,31121809489.856247,0.000000,0.000000,31121809489.856247,2874898,0,0,2874898
2016-10-26,NYSE Arca (P),250720977,276426727,144122062,671269766,9975648406.749386,14548695560.982594,7191627119.926800,31715971087.658780,1864996,796306,1046714,3708016
2016-10-26,NASDAQ (Q),375178472,102540498,394075485,871794455,15577082837.645326,5795278688.483191,19314119559.932439,40686481086.060956,3086743,448554,2591196,6126493
2016-10-26,IEX (V),82676458,14443216,32375348,129495022,3072913050.315004,697393143.047400,1614727303.626098,5385033496.988502,461756,59630,202130,723516
2016-10-26,NASDAQ PSX (X),24993855,18546755,19498175,63038785,755370519.144899,1012020908.543600,787926375.542200,2555317803.230699,179613,77295,130998,387906
2016-10-26,BATS BYX (Y),169186078,57811767,71272957,298270802,4629836201.044507,2302936925.311903,2470997529.049503,9403770655.405913,1359658,267163,611634,2238455
2016-10-26,BATS BZX (Z),215323510,85064053,103251392,403638955,7361893687.303217,4661330025.664907,4428464435.644407,16451688148.612531,1677292,394097,821974,2893363
2016-10-25,NYSE MKT (A),0,10026939,0,10026939,0.000000,80895686.876700,0.000000,80895686.876700,0,30642,0,30642
2016-10-25,NASDAQ BX (B),91673986,26403644,45992799,164070429,3358781623.331609,1181113548.485699,1883722296.357904,6423617468.175212,857157,125790,448308,1431255
2016-10-25,NSX (C),351872,223925,103556,679353,15859350.270000,27325740.550000,4687693.900000,47872784.720000,2082,787,820,3689
2016-10-25,NYSE (DN),110296164,34110178,54072748,198479090,3566913541.217298,1350397327.487800,2240011518.725902,7157322387.431000,271082,77789,153300,502171
2016-10-25,NASDAQ (DQ),1316701505,396206583,598580397,2311488485,41380936710.174895,17040699123.889755,20762441823.510455,79184077657.575105,3787167,813229,1801534,6401930
2016-10-25,EDGA (J),92259593,31554127,37242775,161056495,2738002383.304402,1503889766.311799,1381646729.324298,5623538878.940499,737478,154334,304723,1196535
2016-10-25,EDGX (K),214410527,82806502,139885204,437102233,7323882283.187588,3880656949.876806,5552210810.771485,16756750043.835879,1401479,340485,891352,2633316
2016-10-25,CHX (M),9954686,10667185,6328200,26950071,402696783.787700,1097809987.762500,456001930.464800,1956508702.015000,2818,4984,1283,9085
2016-10-25,NYSE (N),838976497,0,0,838976497,30015362653.800609,0.000000,0.000000,30015362653.800609,2682187,0,0,2682187
2016-10-25,NYSE Arca (P),245179017,235153358,130915127,611247502,9603034387.373628,12036882936.197068,6244850069.978921,27884767393.549617,1757152,665018,908741,3330911
2016-10-25,NASDAQ (Q),354258402,85117706,363683953,803060061,14514531848.438557,4855438632.289895,16952809856.860497,36322780337.588949,2865828,379263,2333044,5578135
2016-10-25,IEX (V),80127209,13474898,27746039,121348146,2966442537.712903,698595423.148000,1358214363.354600,5023252324.215503,429056,54509,168046,651611
2016-10-25,NASDAQ PSX (X),22718718,14598055,17672476,54989249,706201894.837601,790488113.963200,669030694.849400,2165720703.650201,172586,62634,126456,361676
2016-10-25,BATS BYX (Y),166627926,53938546,67571093,288137565,4564580205.804123,2110757670.908500,2396489661.864902,9071827538.577525,1309625,254573,581705,2145903
2016-10-25,BATS BZX (Z),212670286,73594913,91040745,377305944,7219881082.008273,3895653694.202596,3792387614.156574,14907922390.367443,1627838,342655,717763,2688256
2016-10-24,NYSE MKT (A),0,9515069,0,9515069,0.000000,73195103.706400,0.000000,73195103.706400,0,24642,0,24642
2016-10-24,NASDAQ BX (B),86804375,23307009,42975345,153086729,3147461035.733603,961775042.452899,1815302219.184499,5924538297.371001,804055,110234,419096,1333385
2016-10-24,NSX (C),592644,102348,222426,917418,20326841.990000,13133255.090000,7863520.090000,41323617.170000,3808,495,1451,5754
2016-10-24,NYSE (DN),103474580,31654149,56761159,191889888,3178437443.361506,1170353126.353601,2279268243.586004,6628058813.301111,267385,72674,156445,496504
2016-10-24,NASDAQ (DQ),1116498029,364443158,578531828,2059473015,35138446835.584415,15727116515.472022,20807671279.447925,71673234630.504362,3404029,749474,1664211,5817714
2016-10-24,EDGA (J),82580739,26200019,36777100,145557858,2651911361.090712,1188392234.009000,1409291476.211200,5249595071.310912,680714,133992,305338,1120044
2016-10-24,EDGX (K),187646834,73730990,140302526,401680350,6299382335.974931,3449579030.319099,5481959740.880577,15230921107.174607,1215494,312446,872396,2400336
2016-10-24,CHX (M),13096354,6279976,4258630,23634960,587135553.166400,696129860.014800,340881829.214000,1624147242.395200,3407,3853,1538,8798
2016-10-24,NYSE (N),797750730,0,0,797750730,28633328094.408241,0.000000,0.000000,28633328094.408241,2363050,0,0,2363050
2016-10-24,NYSE Arca (P),220795453,211704005,117997207,550496665,8675046201.142205,11019949599.372886,5587757493.591191,25282753294.106282,1555932,590044,844276,2990252
2016-10-24,NASDAQ (Q),319048053,76157633,363856560,759062246,12956666012.082593,4208272536.437801,17556503528.363677,34721442076.884071,2578461,339951,2194546,5112958
2016-10-24,IEX (V),67569843,12353456,26659772,106583071,2485575366.301805,561710830.386800,1264507480.196698,4311793676.885303,376337,46079,166972,589388
2016-10-24,NASDAQ PSX (X),21446791,12518994,16812155,50777940,663614689.130000,668480413.481000,667741336.637000,1999836439.248000,154324,53567,113713,321604
2016-10-24,BATS BYX (Y),150417894,45097073,60304869,255819836,4310600164.679654,1740309037.696796,2152661557.492203,8203570759.868653,1202340,216108,530145,1948593
2016-10-24,BATS BZX (Z),192232705,63770782,87915654,343919141,6501610800.429700,3309320884.219899,3695740191.295684,13506671875.945283,1470530,306696,687565,2464791
2016-10-21,NYSE MKT (A),0,7851419,1712672,9564091,0.000000,86756744.773500,48252170.403000,135008915.176500,0,23161,7069,30230
2016-10-21,NASDAQ BX (B),85418174,20889993,44478932,150787099,3211095263.476306,988062069.594999,1850689826.743995,6049847159.815300,799154,106600,423149,1328903
2016-10-21,NSX (C),418770,114704,202199,735673,17800311.500000,9650937.260000,8477524.310000,35928773.070000,2440,510,1318,4268
2016-10-21,NYSE (DN),100747374,28640521,59609357,188997252,3428439909.680094,1262097432.785901,2375901937.190703,7066439279.656698,253985,63952,152544,470481
2016-10-21,NASDAQ (DQ),1153497649,384304257,616923275,2154725181,38541335296.891786,21393865983.393116,22841821783.397939,82777023063.682841,3369918,700031,1804561,5874510
2016-10-21,EDGA (J),82852294,23871015,36975327,143698636,2588515008.300599,1237726699.571700,1344217289.067398,5170458996.939697,661836,126065,298597,1086498
2016-10-21,EDGX (K),182421499,71296401,138540304,392258204,6461260864.707671,3682247672.381704,5406019009.878319,15549527546.967694,1208662,306030,886596,2401288
2016-10-21,CHX (M),7945211,11707746,4065834,23718791,435324418.284000,1104238740.480001,303605998.200200,1843169156.964201,2859,4872,1434,9165
2016-10-21,NYSE (N),883019929,0,0,883019929,33387037028.744236,0.000000,0.000000,33387037028.744236,2453188,0,0,2453188
2016-10-21,NYSE Arca (P),218589341,196758669,130217082,545565092,8899245448.381091,11654065157.999100,6072757147.480089,26626067753.860280,1527174,600647,913548,3041369
2016-10-21,NASDAQ (Q),311852174,78865271,412223270,802940715,12828662534.349932,4977948393.906392,19972240903.500201,37778851831.756525,2472328,356868,2336100,5165296
2016-10-21,IEX (V),67402514,10165481,30407831,107975826,2807327188.775796,592821174.265800,1386725151.629098,4786873514.670694,375609,42635,175860,594104
2016-10-21,NASDAQ PSX (X),20432645,13631220,17212438,51276303,662862487.702800,831937451.565101,683384578.454900,2178184517.722801,149845,57765,126125,333735
2016-10-21,BATS BYX (Y),149015781,43209964,63216941,255442686,4288406536.027116,1831398433.650403,2251269519.790602,8371074489.468121,1180627,211893,543664,1936184
2016-10-21,BATS BZX (Z),192778925,67879131,95704768,356362824,6718979838.955827,3784579531.221100,4044950542.650799,14548509912.827726,1436553,316347,735510,2488410
2016-10-20,NYSE MKT (A),0,8951688,2050181,11001869,0.000000,56802024.302000,46405236.672000,103207260.974000,0,24311,8131,32442
2016-10-20,NASDAQ BX (B),92658563,27975295,50439935,171073793,3374486204.989201,1252847380.259799,2055191705.694809,6682525290.943809,873190,131674,481661,1486525
2016-10-20,NSX (C),280872,196226,212721,689819,10461858.530000,15752040.400000,6511816.310000,32725715.240000,2016,704,1432,4152
2016-10-20,NYSE (DN),86205034,33150790,55546242,174902066,2733172113.067603,1407793601.077999,2098747462.568705,6239713176.714307,206001,70403,141316,417720
2016-10-20,NASDAQ (DQ),1064548939,398857077,639223614,2102629630,33611943135.571786,16640030943.459808,21488437527.909542,71740411606.941136,3314817,792874,1857778,5965469
2016-10-20,EDGA (J),85477004,31480394,41348438,158305836,2645229967.389717,1395341982.510500,1461208990.329701,5501780940.229918,697887,157868,336788,1192543
2016-10-20,EDGX (K),194709512,93703498,159706748,448119758,6669107443.523832,4456606874.229103,5736259045.064885,16861973362.817820,1312832,373419,978470,2664721
2016-10-20,CHX (M),8347920,11281478,3734527,23363925,410450316.830400,1271155232.288701,215411922.324400,1897017471.443501,2772,4801,1483,9056
2016-10-20,NYSE (N),792883868,0,0,792883868,28901151892.175376,0.000000,0.000000,28901151892.175376,2558844,0,0,2558844
2016-10-20,NYSE Arca (P),230250073,239765971,151020029,621036073,8873263148.368787,12708048041.386002,6435250221.484659,28016561411.239448,1645043,741588,1019550,3406181
2016-10-20,NASDAQ (Q),333123347,97223837,406553173,836900357,13529383949.793969,5466938937.772800,18483158292.919708,37479481180.486477,2742876,430325,2564349,5737550
2016-10-20,IEX (V),70357338,13099954,34592325,118049617,2676126595.881412,651792165.723000,1467959053.096899,4795877814.701311,408691,53316,212304,674311
2016-10-20,NASDAQ PSX (X),22737697,18127538,21216337,62081572,673093646.520000,1036623384.156800,775923092.516700,2485640123.193500,152294,71551,139889,363734
2016-10-20,BATS BYX (Y),161034109,57214941,72253260,290502310,4509612846.941683,2206243984.928609,2546714185.807507,9262571017.677799,1283019,263684,628691,2175394
2016-10-20,BATS BZX (Z),196714888,85674341,107374438,389763667,6684867902.518634,4570686930.602206,4354430376.990380,15609985210.111220,1519111,383376,839189,2741676
2016-10-19,NYSE MKT (A),0,8884051,1936329,10820380,0.000000,59247197.278500,58803404.743000,118050602.021500,0,24099,8767,32866
2016-10-19,NASDAQ BX (B),83574672,26028293,42257439,151860404,3103616193.268726,1041571316.102604,1695241967.437006,5840429476.808336,818390,123471,420016,1361877
2016-10-19,NSX (C),656980,233318,339684,1229982,23318000.580000,20062506.040000,12892257.573500,56272764.193500,3622,925,2289,6836
2016-10-19,NYSE (DN),89331729,38357264,52872775,180561768,2822486159.928097,1419994152.490499,1986589732.598401,6229070045.016997,233179,75881,138622,447682
2016-10-19,NASDAQ (DQ),1141164976,419709091,583890378,2144764445,35546013969.575962,17156443687.827725,19821622287.560936,72524079944.964623,3466439,833004,1760493,6059936
2016-10-19,EDGA (J),85932333,30267904,36991844,153192081,2595220737.988697,1268305203.862901,1230340014.542101,5093865956.393699,711488,154201,306455,1172144
2016-10-19,EDGX (K),189852069,87276060,140685920,417814049,6428770454.760904,4012105105.451296,5186455468.844714,15627331029.056914,1269571,345702,866628,2481901
2016-10-19,CHX (M),13266446,15541358,3133850,31941654,518732331.204000,1409716483.545000,209091912.418200,2137540727.167200,3026,4411,1278,8715
2016-10-19,NYSE (N),797622331,0,0,797622331,29029096037.780664,0.000000,0.000000,29029096037.780664,2490167,0,0,2490167
2016-10-19,NYSE Arca (P),214577982,254721216,123973779,593272977,8207357996.279228,13255222157.832463,5518321059.771919,26980901213.883610,1552977,673781,858025,3084783
2016-10-19,NASDAQ (Q),310906592,91115284,359325417,761347293,12506936708.179839,4897368230.135997,16421912405.299330,33826217343.615166,2579686,385391,2266610,5231687
2016-10-19,IEX (V),65216608,12249483,29963860,107429951,2485246237.766795,547591733.590400,1249434381.557798,4282272352.914993,368809,48868,181020,598697
2016-10-19,NASDAQ PSX (X),22698254,16241862,18260205,57200321,664217241.586399,822632525.810001,668912433.115900,2155762200.512300,156672,65526,124910,347108
2016-10-19,BATS BYX (Y),156868357,50989387,62009422,269867166,4413983099.113301,1903413604.052201,2137660313.000594,8455057016.166096,1270192,242851,560134,2073177
2016-10-19,BATS BZX (Z),193327694,80686891,93270443,367285028,6484784976.306790,4046118075.828004,3850726836.983702,14381629889.118496,1483767,371555,741752,2597074
2016-10-18,NYSE MKT (A),0,8556674,2393293,10949967,0.000000,57506908.220700,49289818.425000,106796726.645700,0,20941,8794,29735
2016-10-18,NASDAQ BX (B),81421644,26164178,40554742,148140564,2964789063.328296,1116515296.957199,1725815675.886300,5807120036.171795,769418,120313,403498,1293229
2016-10-18,NSX (C),382199,195826,228246,806271,14650569.910000,24730341.490000,12513707.257600,51894618.657600,2329,906,1640,4875
2016-10-18,NYSE (DN),88496178,34680038,52953503,176129719,2941805954.995010,1712112327.012299,2131701156.612608,6785619438.619917,233590,75676,146572,455838
2016-10-18,NASDAQ (DQ),1088464608,390496296,560488403,2039449307,33900473105.791226,17198413027.484733,20692731791.283501,71791617924.559460,3285809,786024,1685690,5757523
2016-10-18,EDGA (J),80181369,29398007,35799149,145378525,2508982132.209088,1280843831.478099,1325743297.774099,5115569261.461286,669214,148803,299937,1117954
2016-10-18,EDGX (K),174466108,82325577,127023396,383815081,5955399146.730738,3927971645.022398,5113754112.281603,14997124904.034739,1158564,327319,809116,2294999
2016-10-18,CHX (M),7523249,7313333,4010222,18846804,381274404.567500,889675437.330000,387069572.940000,1658019414.837500,3201,4417,1166,8784
2016-10-18,NYSE (N),742363156,0,0,742363156,26223138564.317223,0.000000,0.000000,26223138564.317223,2420849,0,0,2420849
2016-10-18,NYSE Arca (P),209291794,240100087,118942056,568333937,8048753348.845661,12704383223.286943,5827666654.451307,26580803226.583911,1491407,622551,837117,2951075
2016-10-18,NASDAQ (Q),289633120,85604369,341723410,716960899,11594449395.734002,4762678529.608206,16450980614.443628,32808108539.785836,2343283,370597,2181255,4895135
2016-10-18,IEX (V),70799159,11047193,29804904,111651256,2710385397.478693,526341802.351700,1451680772.394800,4688407972.225193,424668,50211,188877,663756
2016-10-18,NASDAQ PSX (X),20480388,14863521,18575305,53919214,625885155.419201,823855938.325600,662427683.158000,2112168776.902801,142088,62395,120945,325428
2016-10-18,BATS BYX (Y),140384696,50575393,56931633,247891722,3955879455.343521,2007820469.818106,2027292623.058594,7990992548.220221,1129176,236020,502898,1868094
2016-10-18,BATS BZX (Z),179056941,79885078,87544092,346486111,6077503222.540407,4171717484.474586,3647538517.166685,13896759224.181678,1378054,357821,692162,2428037
2016-10-17,NYSE MKT (A),0,7887463,1617355,9504818,0.000000,44358822.316300,33899918.768000,78258741.084300,0,20144,5529,25673
2016-10-17,NASDAQ BX (B),82228652,24152205,40687918,147068775,3002246424.223215,1075917706.778897,1636677103.759896,5714841234.762008,804792,113855,401271,1319918
2016-10-17,NSX (C),164437,129654,180501,474592,7274805.570000,15219479.410000,6254918.117700,28749203.097700,1438,477,1042,2957
2016-10-17,NYSE (DN),74315839,30763823,49248439,154328101,2398337262.338406,1224262283.957201,1713128891.754005,5335728438.049612,214654,67161,129099,410914
2016-10-17,NASDAQ (DQ),880992365,321994958,508760031,1711747354,28681666278.572716,13197647895.345402,16772571500.611625,58651885674.529743,2941901,728579,1562743,5233223
2016-10-17,EDGA (J),73738100,26858984,35681172,136278256,2309677407.695903,1271298671.067498,1175133136.725800,4756109215.489201,640212,136834,292568,1069614
2016-10-17,EDGX (K),162712842,74258945,136158972,373130759,5688832732.960369,3781497651.201711,4862756146.751595,14333086530.913675,1155673,334981,825812,2316466
2016-10-17,CHX (M),6328578,10680374,2591371,19600323,333155929.787600,893395247.064400,212448589.923000,1438999766.775000,2426,3160,930,6516
2016-10-17,NYSE (N),707147222,0,0,707147222,25855228519.826968,0.000000,0.000000,25855228519.826968,2289110,0,0,2289110
2016-10-17,NYSE Arca (P),186126446,213390051,114953785,514470282,7206615075.468701,11801470271.065694,5191253542.946824,24199338889.481219,1412072,643021,821732,2876825
2016-10-17,NASDAQ (Q),271267635,79412788,345263794,695944217,11059429958.975230,4772135084.936803,15523867321.505364,31355432365.417397,2320296,378478,2203083,4901857
2016-10-17,IEX (V),58640769,10937473,26064295,95642537,2306488049.885005,569628780.550200,1128841333.339102,4004958163.774307,363968,46263,169322,579553
2016-10-17,NASDAQ PSX (X),18021452,12653307,16897717,47572476,548326174.940500,695002278.687400,561189845.936400,1804518299.564300,130690,58879,114189,303758
2016-10-17,BATS BYX (Y),136777847,48909543,56299615,241987005,3833315299.857596,1941277422.529795,1900263935.570899,7674856657.958290,1132517,233970,495498,1861985
2016-10-17,BATS BZX (Z),173982675,73576845,92663597,340223117,5994192141.675542,4012666191.480595,3569732985.996101,13576591319.152238,1392687,361328,716123,2470138
2016-10-14,NYSE MKT (A),0,9192011,1916753,11108764,0.000000,51503562.556600,47469450.561000,98973013.117600,0,25903,7893,33796
2016-10-14,NASDAQ BX (B),88699697,31324449,44854285,164878431,3125343944.736303,1423634745.426300,1757234269.312194,6306212959.474797,843164,147724,434652,1425540
2016-10-14,NSX (C),294374,189374,242888,726636,11775578.140000,17331397.290000,7971440.653300,37078416.083300,2274,764,1355,4393
2016-10-14,NYSE (DN),84336758,36802590,55297569,176436917,2709110141.998506,1637610340.580004,1874662953.933200,6221383436.511710,224036,75417,135133,434586
2016-10-14,NASDAQ (DQ),985050299,455880243,574456943,2015387485,31900035297.412137,20073687636.493418,18903835058.403424,70877557992.308979,3117150,853076,1640781,5611007
2016-10-14,EDGA (J),82317458,37501638,38415135,158234231,2509002520.823491,1676057623.424697,1273413469.653999,5458473613.902187,685373,179021,319979,1184373
2016-10-14,EDGX (K),179852448,103447519,149283478,432583445,6089989803.323672,5184474412.373189,5218993390.556426,16493457606.253287,1246823,435428,913939,2596190
2016-10-14,CHX (M),8888943,13858898,3686728,26434569,391448552.697600,1422714198.220001,345496245.747100,2159658996.664701,2644,5188,1054,8886
2016-10-14,NYSE (N),808353148,0,0,808353148,29114804610.058205,0.000000,0.000000,29114804610.058205,2574737,0,0,2574737
2016-10-14,NYSE Arca (P),219141660,280756980,129885524,629784164,8319304218.760410,15461046503.605840,5554563865.610521,29334914587.976771,1592383,851804,913180,3357367
2016-10-14,NASDAQ (Q),309364639,112496722,382779930,804641291,12321733082.644459,6400046899.162918,16988260150.447523,35710040132.254900,2590038,510188,2397606,5497832
2016-10-14,IEX (V),64841395,11891562,28892142,105625099,2664360774.523604,657637843.095000,1316196930.607901,4638195548.226505,398039,54593,185388,638020
2016-10-14,NASDAQ PSX (X),22462957,18385984,20534099,61383040,646156711.420000,1062220296.667201,673518697.829100,2381895705.916301,146535,76544,130831,353910
2016-10-14,BATS BYX (Y),146044798,61697913,62241254,269983965,4047828040.531268,2521869253.810101,2068573518.939684,8638270813.281053,1199162,301101,547741,2048004
2016-10-14,BATS BZX (Z),188269655,99295003,101127014,388691672,6290807285.702375,5506039223.891508,4071359668.674586,15868206178.268469,1501628,471499,805944,2779071
2016-10-13,NYSE MKT (A),0,10953836,2032747,12986583,0.000000,62128760.446400,55755791.056000,117884551.502400,0,26783,8543,35326
2016-10-13,NASDAQ BX (B),91881664,37740573,48167358,177789595,3323165423.034598,1626573054.052903,1892551043.279996,6842289520.367497,892112,165069,494451,1551632
2016-10-13,NSX (C),334895,272726,349417,957038,15077462.020000,31529787.520000,9682446.175600,56289695.715600,2511,987,1754,5252
2016-10-13,NYSE (DN),92786784,50064310,63158957,206010051,2919072793.180705,2109432782.262906,2280503061.697305,7309008637.140916,249034,101969,155850,506853
2016-10-13,NASDAQ (DQ),1107901479,539024729,624533867,2271460075,35456055836.677044,21933575294.529211,20733736719.790375,78123367850.996630,3417785,1061400,1830434,6309619
2016-10-13,EDGA (J),89158154,45824576,43205810,178188540,2752977498.498001,2014977094.215101,1487250147.888901,6255204740.602003,751486,209783,375101,1336370
2016-10-13,EDGX (K),200567853,120300188,160068339,480936380,6974625624.403145,6022055009.145408,5791934808.868511,18788615442.417064,1419309,497518,1012961,2929788
2016-10-13,CHX (M),6365967,15608775,3774369,25749111,221923181.478800,1647957081.932000,247065447.393800,2116945710.804600,2783,6828,1150,10761
2016-10-13,NYSE (N),878557871,0,0,878557871,31176640934.458926,0.000000,0.000000,31176640934.458926,2886008,0,0,2886008
2016-10-13,NYSE Arca (P),243823635,329075589,146736117,719635341,9411153022.471625,17374176425.842393,6407354757.776227,33192684206.090245,1800830,978425,1050466,3829721
2016-10-13,NASDAQ (Q),346229697,130969331,409454282,886653310,13868775314.821831,7614774034.018482,18214399451.443182,39697948800.283495,2936291,593832,2768764,6298887
2016-10-13,IEX (V),69480242,17123749,31857966,118461957,2650958540.867907,856940792.981800,1383621881.402101,4891521215.251808,405486,69701,194839,670026
2016-10-13,NASDAQ PSX (X),22686434,22988671,21226266,66901371,692681590.429301,1275900802.038800,779376754.858600,2747959147.326701,167324,93797,146268,407389
2016-10-13,BATS BYX (Y),165693358,72341954,68858852,306894164,4561925876.777115,2906867689.652802,2258670073.797207,9727463640.227124,1356366,332412,634868,2323646
2016-10-13,BATS BZX (Z),222565831,122657879,114297227,459520937,7582625079.732928,6680444104.386112,4582431178.349621,18845500362.468661,1823220,573282,943131,3339633
2016-10-12,NYSE MKT (A),0,10363873,1772330,12136203,0.000000,51937993.860800,42407917.815000,94345911.675800,0,28862,6203,35065
2016-10-12,NASDAQ BX (B),81766334,28975725,44477329,155219388,3097727487.086996,1235701332.337701,1767661212.331301,6101090031.755998,809025,132862,422332,1364219
2016-10-12,NSX (C),228409,184002,144702,557113,7494990.266400,14728149.712500,5322432.209700,27545572.188600,1736,645,893,3274
2016-10-12,NYSE (DN),75423161,35804717,51218677,162446555,2474483362.885405,1502833370.833195,1933188663.192402,5910505396.911002,209662,78229,134353,422244
2016-10-12,NASDAQ (DQ),956926869,397220255,580140514,1934287638,30552252231.800409,15746876689.882366,18225469087.101537,64524598008.784312,3028857,846733,1679797,5555387
2016-10-12,EDGA (J),76797646,33747479,37839782,148384907,2425911265.013705,1440498222.424901,1294424090.876301,5160833578.314907,653824,166450,319883,1140157
2016-10-12,EDGX (K),166684057,94339572,142240095,403263724,6121682602.442212,4502420221.643214,5132498211.780789,15756601035.866215,1202885,396266,889933,2489084
2016-10-12,CHX (M),5247443,9983443,2805265,18036151,235628862.626000,1255884066.800000,186819686.186600,1678332615.612600,2336,5119,751,8206
2016-10-12,NYSE (N),696556373,0,0,696556373,25524430644.544892,0.000000,0.000000,25524430644.544892,2391532,0,0,2391532
2016-10-12,NYSE Arca (P),197549083,256050661,127511924,581111668,8277356755.779586,13319955001.888965,5484042116.573589,27081353874.242140,1529994,772595,897987,3200576
2016-10-12,NASDAQ (Q),296115545,99199149,367942156,763256850,12636866426.307423,5640893446.720714,16140676192.517771,34418436065.545908,2548582,455438,2419610,5423630
2016-10-12,IEX (V),60187928,12540163,27492014,100220105,2480273909.889297,628407507.051100,1153445343.511100,4262126760.451497,353787,53426,168850,576063
2016-10-12,NASDAQ PSX (X),19907059,15883308,19713833,55504200,655559816.580000,867703400.364898,711905748.233501,2235168965.178399,144851,69209,140268,354328
2016-10-12,BATS BYX (Y),138204285,58113283,61945785,258263353,4100918955.734600,2276322616.372596,2107972718.001001,8485214290.108197,1160965,269257,549895,1980117
2016-10-12,BATS BZX (Z),187918696,87845994,102691685,378456375,6746455344.083227,4642785478.242505,4029097115.240292,15418337937.566024,1547606,421711,824072,2793389
2016-10-11,NYSE MKT (A),0,10665481,2458029,13123510,0.000000,63102131.419000,62515474.883000,125617606.302000,0,26743,8827,35570
2016-10-11,NASDAQ BX (B),84385546,35727267,45727043,165839856,3162702581.191209,1638850215.242601,1940716892.854001,6742269689.287811,813191,155396,445558,1414145
2016-10-11,NSX (C),166395,272061,160222,598678,5769191.990000,37198805.210000,8570049.809700,51538047.009700,1207,934,1109,3250
2016-10-11,NYSE (DN),90429885,45653169,61757137,197840191,3002084086.659203,2070675740.615992,2542058492.770002,7614818320.045197,239449,96985,160655,497089
2016-10-11,NASDAQ (DQ),1068319457,533621557,649398508,2251339522,35327829804.940964,25393801244.212945,23983744503.976189,84705375553.130098,3311056,1033090,1918528,6262674
2016-10-11,EDGA (J),91854334,46275237,44914185,183043756,2900362946.384403,2211588977.892898,1751418272.137898,6863370196.415199,772221,221742,387274,1381237
2016-10-11,EDGX (K),197751943,117897487,173136093,488785523,7088671818.259810,6294017602.211283,6566330896.169497,19949020316.640590,1384329,479069,1048477,2911875
2016-10-11,CHX (M),2569879,23376900,4483546,30430325,130051526.358000,2045960186.632399,318507944.612500,2494519657.602899,2633,6765,1029,10427
2016-10-11,NYSE (N),834218942,0,0,834218942,30251824625.909211,0.000000,0.000000,30251824625.909211,2793963,0,0,2793963
2016-10-11,NYSE Arca (P),230579640,338280799,153381968,722242407,9144994142.715444,19398998447.773399,7439410822.962502,35983403413.451345,1716971,957938,1072483,3747392
2016-10-11,NASDAQ (Q),332899430,128790305,444819951,906509686,13848643731.295907,8073384775.954205,21020777818.343765,42942806325.593877,2841027,567351,2900591,6308969
2016-10-11,IEX (V),63005545,17300378,31650207,111956130,2410736449.935988,866320670.208000,1412057478.209099,4689114598.353087,365356,69130,190438,624924
2016-10-11,NASDAQ PSX (X),22492572,22157110,23423643,68073325,714771635.798899,1329169422.124999,917009561.231299,2960950619.155197,161138,87663,164823,413624
2016-10-11,BATS BYX (Y),160567940,79551348,69841146,309960434,4715948955.051710,3316890646.298399,2489384746.301895,10522224347.652004,1323112,350768,620629,2294509
2016-10-11,BATS BZX (Z),213824758,123301317,117829563,454955638,7487867937.698336,7267596559.376227,5203583818.870193,19959048315.944756,1719007,547998,952175,3219180
2016-10-10,NYSE MKT (A),0,7435455,1318584,8754039,0.000000,47295348.842800,35066528.174000,82361877.016800,0,21306,5347,26653
2016-10-10,NASDAQ BX (B),85779521,22030335,38245656,146055512,3320978927.708204,994384615.658599,1576974868.046595,5892338411.413398,863599,103932,395219,1362750
2016-10-10,NSX (C),201821,111893,132837,446551,7470275.880000,11744996.930000,7384617.699000,26599890.509000,1241,481,865,2587
2016-10-10,NYSE (DN),75726972,28534602,40302987,144564561,2562849497.083605,1122995982.572699,1550517593.309799,5236363072.966103,201284,60453,107113,368850
2016-10-10,NASDAQ (DQ),929919195,346937244,496952279,1773808718,30249538176.734707,14402288538.940618,17305620371.416214,61957447087.091539,3023385,724816,1510381,5258582
2016-10-10,EDGA (J),72953458,28412250,33632634,134998342,2419438479.499399,1246607257.660900,1227277114.653700,4893322851.813999,639874,137675,289681,1067230
2016-10-10,EDGX (K),168265500,74715402,131445528,374426430,5953930854.482176,3478820831.961401,4696433922.121498,14129185608.565075,1134595,289354,782065,2206014
2016-10-10,CHX (M),8430561,8252694,3081764,19765019,405710773.526500,744295290.405000,270608315.985000,1420614379.916500,1752,3755,586,6093
2016-10-10,NYSE (N),684947480,0,0,684947480,25424559513.700944,0.000000,0.000000,25424559513.700944,2236548,0,0,2236548
2016-10-10,NYSE Arca (P),193648803,203009598,110312585,506970986,7522617319.956045,10676035202.903488,4851917412.785928,23050569935.645461,1397307,539831,748389,2685527
2016-10-10,NASDAQ (Q),282836628,80211989,334222605,697271222,11467035283.427404,4473008830.683300,15224749930.389079,31164794044.499783,2289807,347577,2102845,4740229
2016-10-10,IEX (V),56635958,10464052,22647801,89747811,2170645741.903500,465945296.567800,1031954909.708699,3668545948.179999,324262,40969,144490,509721
2016-10-10,NASDAQ PSX (X),20995804,12857526,17361724,51215054,809413992.520001,698936571.685300,673259166.670700,2181609730.876001,159853,57030,124177,341060
2016-10-10,BATS BYX (Y),126450877,42368280,50000197,218819354,3729810234.447702,1635070610.507604,1777488737.771802,7142369582.727108,1057587,185235,451182,1694004
2016-10-10,BATS BZX (Z),175179270,70760815,85949975,331890060,6193694849.281319,3634201783.363098,3484809415.105399,13312706047.749816,1417557,314426,695855,2427838
2016-10-07,NYSE MKT (A),0,12241148,1973560,14214708,0.000000,82710234.323000,47615389.475000,130325623.798000,0,26776,7956,34732
2016-10-07,NASDAQ BX (B),95013225,33060791,42995711,171069727,3631609041.568306,1450905462.840800,1703393131.837502,6785907636.246608,906225,147978,411977,1466180
2016-10-07,NSX (C),497120,169057,151350,817527,16528433.454900,17371244.860000,5207620.914800,39107299.229700,2188,648,975,3811
2016-10-07,NYSE (DN),89764193,43682489,52512850,185959532,2875963699.481004,1958592801.170405,1850023761.710398,6684580262.361807,234351,80375,130790,445516
2016-10-07,NASDAQ (DQ),1078071374,474626984,580594853,2133293211,34662863117.250483,19015914894.492172,17810550159.827749,71489328171.570404,3328090,873306,1635598,5836994
2016-10-07,EDGA (J),93720413,46168723,38722208,178611344,2809008133.342694,1941938066.017201,1266910165.427401,6017856364.787296,764234,213830,317256,1295320
2016-10-07,EDGX (K),198663947,120403597,153007580,472075124,6776522837.233094,5788928848.559519,5083452442.574608,17648904128.367221,1353094,468152,884551,2705797
2016-10-07,CHX (M),6972799,13406980,2266564,22646343,339949069.963200,1443917596.566000,149029264.362000,1932895930.891200,2105,5680,982,8767
2016-10-07,NYSE (N),952072755,0,0,952072755,34218918881.522906,0.000000,0.000000,34218918881.522906,2822812,0,0,2822812
2016-10-07,NYSE Arca (P),237924585,332572754,132218394,702715733,9192845325.798507,18096226342.340982,5494272095.434399,32783343763.573888,1732246,941371,912159,3585776
2016-10-07,NASDAQ (Q),348742741,128760631,427371774,904875146,14012292159.385659,7524956948.987675,18238435215.063710,39775684323.437044,2822074,547445,2464588,5834107
2016-10-07,IEX (V),68182689,15135959,29032006,112350654,2656992226.560295,741247301.989100,1207065753.965900,4605305282.515295,415018,60593,176954,652565
2016-10-07,NASDAQ PSX (X),23834518,20675934,19569527,64079979,783672636.989001,1211018924.916700,697292797.682400,2691984359.588101,167244,81356,130889,379489
2016-10-07,BATS BYX (Y),165765093,68826377,64213106,298804576,4832181872.392743,2658362677.985701,2089934837.774595,9580479388.153039,1352931,312245,542155,2207331
2016-10-07,BATS BZX (Z),219552135,118617045,102708979,440878159,7478010672.325042,6627576680.381201,4157143741.845819,18262731094.552062,1744965,545292,833829,3124086
2016-10-06,NYSE MKT (A),0,13449220,1885818,15335038,0.000000,68304470.496800,44705314.278000,113009784.774800,0,30058,6926,36984
2016-10-06,NASDAQ BX (B),90271124,31849559,41017826,163138509,3380566191.678284,1272219674.561401,1652617699.227695,6305403565.467380,870353,138865,400919,1410137
2016-10-06,NSX (C),460645,175461,243824,879930,15038703.950000,12956500.230000,5320188.143800,33315392.323800,2822,927,1182,4931
2016-10-06,NYSE (DN),90715533,41145254,58343590,190204377,2873192200.824407,1596488438.380900,1903014552.620804,6372695191.826111,228843,80085,136656,445584
2016-10-06,NASDAQ (DQ),1106877187,452579964,594866276,2154323427,36194301030.802749,16617792546.085910,18853917730.046526,71666011306.935185,3487979,923049,1801242,6212270
2016-10-06,ADF (D),0,0,1000,1000,0.000000,0.000000,68560.000000,68560.000000,0,0,1,1
2016-10-06,EDGA (J),84742423,41084618,38176439,164003480,2625275950.288706,1633537877.340101,1292977890.339398,5551791717.968205,738085,186918,326516,1251519
2016-10-06,EDGX (K),197967248,106465615,150279753,454712616,6785497747.899092,4584573379.050384,5187403025.753892,16557474152.703368,1359924,408948,909069,2677941
2016-10-06,CHX (M),25263356,12882753,3320250,41466359,1830914394.015000,999998417.600000,221088149.029000,3052000960.644000,2724,4234,869,7827
2016-10-06,NYSE (N),818334750,0,0,818334750,29032117907.236906,0.000000,0.000000,29032117907.236906,2753190,0,0,2753190
2016-10-06,NYSE Arca (P),226510109,302749201,130146535,659405845,8585916342.378964,15308537923.730779,5718250418.953184,29612704685.062927,1668127,803582,946580,3418289
2016-10-06,NASDAQ (Q),337944367,104939225,423299741,866183333,13800070587.481208,5401199941.785990,17249313871.112058,36450584400.379256,2849679,439213,2524935,5813827
2016-10-06,IEX (V),68789782,15996313,29734548,114520643,2731607522.082797,728340914.926100,1426230813.237501,4886179250.246398,427035,65362,187332,679729
2016-10-06,NASDAQ PSX (X),23250916,18688626,20235231,62174773,741769718.513299,896873315.142701,710982339.929400,2349625373.585400,166362,76480,138619,381461
2016-10-06,BATS BYX (Y),151871375,60800001,60054846,272726222,4386656243.007338,2209215663.635201,2005905899.410486,8601777806.053025,1290686,266214,554567,2111467
2016-10-06,BATS BZX (Z),215050410,98783544,103881491,417715445,7545151871.876661,4819097477.474395,4218891105.220603,16583140454.571659,1805998,444083,889430,3139511
2016-10-05,NYSE MKT (A),0,12333408,2045955,14379363,0.000000,75903951.081100,38947336.504000,114851287.585100,0,36207,6604,42811
2016-10-05,NASDAQ BX (B),100638259,34637442,45852486,181128187,3913931907.592026,1484621474.619995,1847170690.426600,7245724072.638621,994151,159189,460724,1614064
2016-10-05,NSX (C),442450,192763,239145,874358,14182635.370000,16710691.420000,12827391.074500,43720717.864500,2689,792,1521,5002
2016-10-05,NYSE (DN),104455303,45447618,65085523,214988444,3433982952.847403,1818567276.332303,2101368030.296802,7353918259.476508,268022,92997,148155,509174
2016-10-05,NASDAQ (DQ),1279312472,522071618,647634617,2449018707,41985399678.512682,22772028345.020918,19369118893.422289,84126546916.955889,3776769,998833,1812868,6588470
2016-10-05,EDGA (J),93765284,42909078,40330070,177004432,3003596661.749891,1851932799.526702,1313406989.195701,6168936450.472294,823927,212820,346775,1383522
2016-10-05,EDGX (K),211267211,111883474,154685827,477836512,7434938743.480354,5144701903.688806,5083625228.862005,17663265876.031165,1456464,423800,890000,2770264
2016-10-05,CHX (M),20803086,10012768,5053825,35869679,1543858230.688400,708377215.572100,449212849.459300,2701448295.719800,2662,4846,911,8419
2016-10-05,NYSE (N),985956362,0,0,985956362,35068601351.021034,0.000000,0.000000,35068601351.021034,2912207,0,0,2912207
2016-10-05,NYSE Arca (P),247302121,331877040,138501264,717680425,9724170958.661506,16415916886.108991,5452205905.208393,31592293749.978890,1792684,862466,943280,3598430
2016-10-05,NASDAQ (Q),346214619,115996856,437087740,899299215,14175560849.902222,6335311732.250398,17205456641.918214,37716329224.070834,2899898,477993,2423109,5801000
2016-10-05,IEX (V),76861474,16257668,29433859,122553001,3140215211.514000,774605692.528899,1296677607.645699,5211498511.688598,446625,65258,175304,687187
2016-10-05,NASDAQ PSX (X),24242223,19489960,20331908,64064091,801471185.166998,950436361.084899,694233714.477000,2446141260.728897,180276,79577,135376,395229
2016-10-05,BATS BYX (Y),161599648,65381360,63032696,290013704,4728810095.743605,2462835560.932597,2066289758.658900,9257935415.335102,1406779,291704,583712,2282195
2016-10-05,BATS BZX (Z),230856994,107637856,106327924,444822774,7968784160.355015,5704385879.866820,4103445867.145003,17776615907.366838,1923367,479830,879182,3282379
2016-10-04,NYSE MKT (A),0,13686853,2258943,15945796,0.000000,67133072.327000,46958096.999000,114091169.326000,0,31206,8070,39276
2016-10-04,NASDAQ BX (B),109365373,46042143,46698143,202105659,4119023473.596478,1875565741.790601,1861538064.336199,7856127279.723278,1045719,195816,455363,1696898
2016-10-04,NSX (C),382967,295226,162490,840683,11741832.280000,27187734.347500,5714453.446400,44644020.073900,2946,1019,1121,5086
2016-10-04,NYSE (DN),98003604,52341274,61994091,212338969,2931934470.906288,2155288820.062398,2208597327.950999,7295820618.919685,236269,109071,142463,487803
2016-10-04,NASDAQ (DQ),1107556980,674586689,613359855,2395503524,34162570116.518562,30406391386.159977,19601065613.686788,84170027116.365327,3682724,1194964,1839418,6717106
2016-10-04,EDGA (J),95256939,57638083,39278994,192174016,2833658248.639295,2367016213.773597,1345562695.674302,6546237158.087194,815280,273925,335906,1425111
2016-10-04,EDGX (K),220094301,148564481,161913503,530572285,7338193491.233019,6873389247.290570,5624319903.299587,19835902641.823176,1540036,577336,965760,3083132
2016-10-04,CHX (M),10580208,13998786,2461241,27040235,518406718.503600,1185331736.557201,150147434.316500,1853885889.377301,2208,7549,1141,10898
2016-10-04,NYSE (N),902449845,0,0,902449845,31618543877.669549,0.000000,0.000000,31618543877.669549,3158285,0,0,3158285
2016-10-04,NYSE Arca (P),256616785,458796948,137567994,852981727,9499936825.178235,22426979056.716206,6039998131.302202,37966914013.196643,1928936,1232984,996899,4158819
2016-10-04,NASDAQ (Q),399297299,167048221,416637602,982983122,15819708381.709295,9179922274.628123,17500648698.524650,42500279354.862068,3319534,719993,2656084,6695611
2016-10-04,IEX (V),78442741,23390817,30559184,132392742,2881941497.087204,1096284132.251002,1404840013.253602,5383065642.591808,442958,82496,187882,713336
2016-10-04,NASDAQ PSX (X),26985219,24816241,22998496,74799956,845693994.943000,1259583910.959099,804674196.118500,2909952102.020599,196059,97756,147154,440969
2016-10-04,BATS BYX (Y),171467842,88486474,64036490,323990806,4805474516.627123,3423204973.323097,2182250308.959101,10410929798.909321,1429349,384615,584876,2398840
2016-10-04,BATS BZX (Z),239601463,147222815,111890043,498714321,8017236309.376406,8154793251.641175,4584160037.957311,20756189598.974892,1999077,667596,961933,3628606
2016-10-03,NYSE MKT (A),0,9577962,1660905,11238867,0.000000,59225439.920300,38396666.183000,97622106.103300,0,25420,6297,31717
2016-10-03,NASDAQ BX (B),93276501,32494416,43896707,169667624,3468938034.517414,1513559264.478898,1834032087.771799,6816529386.768111,918606,151927,438887,1509420
2016-10-03,NSX (C),403808,163128,232019,798955,12035358.211000,15301702.080000,11222658.467800,38559718.758800,2924,697,1675,5296
2016-10-03,NYSE (DN),78499361,38573605,57361153,174434119,2442236426.682003,1782570535.007900,1968282376.552598,6193089338.242501,219938,91467,146126,457531
2016-10-03,NASDAQ (DQ),921840378,501476982,588468217,2011785577,29393914472.694284,26272483856.419226,19878447677.004069,75544846006.117579,3325318,935658,1818253,6079229
2016-10-03,EDGA (J),83538355,40836978,39617691,163993024,2668521005.063602,1950504376.738097,1412684263.252902,6031709645.054601,772450,195990,358621,1327061
2016-10-03,EDGX (K),172257407,99690961,147597261,419545629,6199014161.707141,4992145578.723784,5252000370.833814,16443160111.264739,1307345,415647,915695,2638687
2016-10-03,CHX (M),15047849,10269966,1792725,27110540,1117738175.893400,1091611570.384000,153864845.760900,2363214592.038300,2586,5464,997,9047
2016-10-03,NYSE (N),822851778,0,0,822851778,29509674221.771097,0.000000,0.000000,29509674221.771097,2803697,0,0,2803697
2016-10-03,NYSE Arca (P),200776141,280977416,123515170,605268727,7993752662.890337,15849180693.386625,5485337178.108797,29328270534.385759,1667978,807179,954711,3429868
2016-10-03,NASDAQ (Q),311640563,102983060,392492189,807115812,12956573603.142105,6142609645.219077,17250098647.942376,36349281896.303558,2760405,472341,2566271,5799017
2016-10-03,IEX (V),59395698,14960560,28446706,102802964,2416008867.695999,756741771.360000,1366067009.210499,4538817648.266498,387945,60998,188372,637315
2016-10-03,NASDAQ PSX (X),19927939,16721651,18064841,54714431,649298205.377400,873697863.100600,661002272.996000,2183998341.474000,165032,71850,134529,371411
2016-10-03,BATS BYX (Y),146059728,60173903,62947156,269180787,4221967769.505082,2526162981.383503,2189504811.889305,8937635562.777890,1324717,273656,588509,2186882
2016-10-03,BATS BZX (Z),188335769,89800238,100374321,378510328,6735032845.670400,5094738083.767806,4111137497.854681,15940908427.292887,1696399,432156,884304,3012859
2016-09-30,NYSE MKT (A),0,15151827,1689122,16840949,0.000000,118432061.686400,33605434.679000,152037496.365400,0,30773,6195,36968
2016-09-30,NASDAQ BX (B),112264155,39920431,56591301,208775887,4219117218.353038,1708234902.131401,2454452988.701900,8381805109.186339,1072554,159782,554354,1786690
2016-09-30,NSX (C),505294,194283,249617,949194,19502456.030000,26800767.523100,12256003.987800,58559227.540900,3208,712,1468,5388
2016-09-30,NYSE (DN),102201034,40671304,71991089,214863427,3259585774.880291,1659607302.582700,2755440806.456501,7674633883.919492,260586,87469,175389,523444
2016-09-30,NASDAQ (DQ),1263733593,477769592,714725158,2456228343,42193062423.411957,24464440556.850414,25297989647.347011,91955492627.609382,3710037,889248,2105018,6704303
2016-09-30,EDGA (J),98963773,44563531,47009481,190536785,3105225395.199996,2056455676.805902,1707030787.681900,6868711859.687798,848472,207812,399065,1455349
2016-09-30,EDGX (K),206726272,117601290,171652404,495979966,7943719372.632416,6177925206.855697,6277496001.426273,20399140580.914386,1428338,450392,1056028,2934758
2016-09-30,CHX (M),75707262,14545841,4214510,94467613,6374967669.598201,1091972772.308700,287672866.636800,7754613308.543701,3428,4946,1001,9375
2016-09-30,NYSE (N),1180281600,0,0,1180281600,45403262432.267836,0.000000,0.000000,45403262432.267836,3139932,0,0,3139932
2016-09-30,NYSE Arca (P),245545144,344800356,154133313,744478813,9459078987.870957,20146560650.064699,7029882760.683458,36635522398.619114,1830063,903903,1109476,3843442
2016-09-30,NASDAQ (Q),366752709,118403606,586782755,1071939070,14484188834.963564,7282319290.518274,26392937099.066229,48159445224.548067,2919999,520651,2942619,6383269
2016-09-30,IEX (V),71781105,17020030,35782575,124583710,2872429185.018507,820829082.619400,1776405277.541199,5469663545.179106,433950,60050,218305,712305
2016-09-30,NASDAQ PSX (X),23743110,21495371,20789097,66027578,779178344.810000,1146027231.622699,819150613.027600,2744356189.460299,176269,81140,152781,410190
2016-09-30,BATS BYX (Y),176937605,70054590,71955680,318947875,5189582731.182202,2814561519.430897,2576047026.387505,10580191277.000604,1473648,298894,643727,2416269
2016-09-30,BATS BZX (Z),233663230,109079422,125695828,468438480,8228455482.111108,6557885475.139723,5526642906.052003,20312983863.302834,1926608,479427,1065853,3471888
2016-09-29,NYSE MKT (A),0,11272732,2328007,13600739,0.000000,63306178.109200,39582690.277000,102888868.386200,0,31689,8094,39783
2016-09-29,NASDAQ BX (B),104310235,38176037,47131756,189618028,3542899327.791904,1698766184.829800,1940231606.870002,7181897119.491706,942307,177374,445857,1565538
2016-09-29,NSX (C),433089,209369,132478,774936,19452878.540000,25154790.020000,12073918.976000,56681587.536000,2728,1087,884,4699
2016-09-29,NYSE (DN),119440725,53287950,73588413,246317088,3663832049.485018,2316340375.028298,2726082029.187397,8706254453.700713,268504,106208,162783,537495
2016-09-29,NASDAQ (DQ),1293186102,496309205,687250456,2476745763,39984505042.573996,22045675660.618355,23589070434.909064,85619251138.101415,3866892,1020737,1988590,6876219
2016-09-29,EDGA (J),108416856,53258071,48901613,210576540,3004909598.655801,2368798137.475696,1691418953.966395,7065126690.097892,887160,259105,405506,1551771
2016-09-29,EDGX (K),257208111,142062788,183873894,583144793,8938779187.084819,7484890356.791504,6580748093.662682,23004417637.539005,1752276,592136,1124128,3468540
2016-09-29,CHX (M),38196189,14942603,4776587,57915379,2981389399.392801,1094212553.639300,353971048.345600,4429573001.377701,2653,6192,989,9834
2016-09-29,NYSE (N),1000754023,0,0,1000754023,34458310898.943864,0.000000,0.000000,34458310898.943864,3515989,0,0,3515989
2016-09-29,NYSE Arca (P),284842539,383804472,167417571,836064582,10660451964.313121,21717065152.808485,7373397672.065363,39750914789.186969,2137267,1236701,1172953,4546921
2016-09-29,NASDAQ (Q),447866150,148671404,469773389,1066310943,16754203929.247423,8942950175.557959,20550219551.854423,46247373656.659805,3445951,694655,3055910,7196516
2016-09-29,IEX (V),80907339,17187414,34418510,132513263,3127098850.075808,923628504.884800,1768696290.891002,5819423645.851610,452482,72063,210628,735173
2016-09-29,NASDAQ PSX (X),29499360,23410656,23656418,76566434,878883845.620002,1543895677.291200,899021747.189001,3321801270.100203,203064,99397,162841,465302
2016-09-29,BATS BYX (Y),177413110,75973708,69688189,323075007,4666147029.453926,3115009494.807602,2408872925.603500,10190029449.865028,1418013,362819,609290,2390122
2016-09-29,BATS BZX (Z),273153579,139794612,133214976,546163167,8923635361.548160,8402348101.433885,5651500970.927582,22977484433.909627,2168954,670100,1111946,3951000
2016-09-28,NYSE MKT (A),0,12368768,2261846,14630614,0.000000,74370006.594400,33747299.564000,108117306.158400,0,31516,7125,38641
2016-09-28,NASDAQ BX (B),93292291,34994788,41932981,170220060,3242855932.033329,1444164800.686601,1645939800.577095,6332960533.297025,847973,151719,405633,1405325
2016-09-28,NSX (C),377026,91772,165837,634635,11690339.110000,4799959.950000,12727793.557200,29218092.617200,2373,542,1135,4050
2016-09-28,NYSE (DN),108284254,49595703,73092404,230972361,3343072053.568783,1909606820.762105,2368103677.686501,7620782552.017389,253170,94229,158878,506277
2016-09-28,NASDAQ (DQ),1228920875,520711483,679886390,2429518748,39050654236.237256,22700093451.706194,20292878970.711967,82043626658.655417,3694489,944064,1923984,6562537
2016-09-28,EDGA (J),94373841,46796451,40912157,182082449,2805753983.435189,1961059248.775297,1283968054.915496,6050781287.125982,794009,211156,343589,1348754
2016-09-28,EDGX (K),219961013,125503973,161464901,506929887,7523054054.333941,5695280543.306703,5185643532.395729,18403978130.036373,1487879,478021,928376,2894276
2016-09-28,CHX (M),43534670,16914263,3570639,64019572,3388239816.152099,803070280.034900,278059634.996400,4469369731.183399,2667,4478,733,7878
2016-09-28,NYSE (N),929678179,0,0,929678179,33363672391.468962,0.000000,0.000000,33363672391.468962,3065725,0,0,3065725
2016-09-28,NYSE Arca (P),249202895,336056728,143384070,728643693,9311023318.329391,16991829399.895970,5779140123.363093,32081992841.588454,1844032,957185,994350,3795567
2016-09-28,NASDAQ (Q),381196191,124362997,415200702,920759890,14636304361.938964,6725529028.922880,16923350962.738167,38285184353.600011,3018041,530749,2568775,6117565
2016-09-28,IEX (V),73501535,16767370,30201070,120469975,2683848465.819904,723199585.733301,1269201099.632100,4676249151.185305,421945,61952,182272,666169
2016-09-28,NASDAQ PSX (X),27116105,20497037,20164897,67778039,824404845.450000,1099544239.862600,725301506.684400,2649250591.997000,195136,84654,138630,418420
2016-09-28,BATS BYX (Y),169309445,66488419,64431738,300229602,4625899513.339811,2518691257.664906,2049494519.610697,9194085290.615414,1383914,288033,561066,2233013
2016-09-28,BATS BZX (Z),241648914,116885874,111575204,470109992,7777117320.683397,6036734361.547114,4261220810.632614,18075072492.863125,1880276,519165,909729,3309170
2016-09-27,NYSE MKT (A),0,11496266,1950612,13446878,0.000000,58702593.600800,41584677.458000,100287271.058800,0,27419,8123,35542
2016-09-27,NASDAQ BX (B),85805694,30289331,42141110,158236135,3108362112.524198,1324790332.292201,1681456936.183404,6114609380.999803,836297,134798,426982,1398077
2016-09-27,NSX (C),299525,87758,221754,609037,10320869.020000,9009207.410000,11986300.370000,31316376.800000,2064,527,1392,3983
2016-09-27,NYSE (DN),91930274,40159479,65907673,197997426,2860558902.590702,1584811538.758397,2253575032.622701,6698945473.971800,209599,76052,150683,436334
2016-09-27,NASDAQ (DQ),1073784753,420616663,667317155,2161718571,34544558210.236675,18868551706.223419,21218043669.661409,74631153586.121503,3373968,831727,1885162,6090857
2016-09-27,EDGA (J),83618954,40619884,41292724,165531562,2554265396.976701,1801822335.369198,1438551277.170699,5794639009.516598,732977,194235,358777,1285989
2016-09-27,EDGX (K),192188296,102989798,157680369,452858463,6870217849.066279,4916363977.720002,5315100055.456199,17101681882.242480,1354116,410814,932579,2697509
2016-09-27,CHX (M),40219196,9272692,3811148,53303036,3068942456.278001,692186453.231100,233600938.021000,3994729847.530101,1830,2524,539,4893
2016-09-27,NYSE (N),849931329,0,0,849931329,30948742673.338966,0.000000,0.000000,30948742673.338966,2749444,0,0,2749444
2016-09-27,NYSE Arca (P),222004786,276649664,137181665,635836115,8499790054.398910,14249019079.874178,5723821660.667895,28472630794.940983,1653240,818198,973917,3445355
2016-09-27,NASDAQ (Q),328477246,98720933,410839014,838037193,13111583198.766110,5558930067.816114,18231520354.826611,36902033621.408835,2650345,441353,2558058,5649756
2016-09-27,IEX (V),63491756,15193513,31795761,110481030,2387819872.787102,652412873.634200,1414778344.657597,4455011091.078899,373522,52042,187113,612677
2016-09-27,NASDAQ PSX (X),22379885,16150566,19552474,58082925,703371669.108001,909207251.563401,717917618.503101,2330496539.174503,166845,69719,137152,373716
2016-09-27,BATS BYX (Y),150165082,60470424,64706342,275341848,4266926270.092674,2405096228.647898,2178928438.569006,8850950937.309578,1269163,262221,589326,2120710
2016-09-27,BATS BZX (Z),209802058,93285358,110304910,413392326,7215425109.900808,5052920658.204507,4362744596.148785,16631090364.254100,1704952,428228,933262,3066442
2016-09-26,NYSE MKT (A),0,11373267,2798390,14171657,0.000000,58175065.628300,43495588.845000,101670654.473300,0,25243,7307,32550
2016-09-26,NASDAQ BX (B),85697010,28335893,40482337,154515240,3116204563.272506,1258314338.355201,1617118722.439602,5991637624.067309,805940,126270,382935,1315145
2016-09-26,NSX (C),215974,113992,177016,506982,9664816.920000,15103697.100000,10005317.895000,34773831.915000,1490,584,1094,3168
2016-09-26,NYSE (DN),92528261,39375165,67405342,199308768,2972383051.072817,1692229334.210393,2063471848.764110,6728084234.047320,227613,79013,156116,462742
2016-09-26,NASDAQ (DQ),993661654,374284023,614740435,1982686112,33321370942.298222,17622993393.246628,17815608301.787436,68759972637.332286,3201136,821437,1794380,5816953
2016-09-26,EDGA (J),82205709,34855683,41372975,158434367,2572956697.041100,1633433162.235700,1389795105.226906,5596184964.503706,717452,171100,347866,1236418
2016-09-26,EDGX (K),188075038,93735015,160207010,442017063,6757999967.054313,4747334296.097302,5142061169.812090,16647395432.963705,1355335,379102,935286,2669723
2016-09-26,CHX (M),27095382,7324274,3014146,37433802,2185192458.989500,498806567.676300,149710288.759300,2833709315.425100,1809,2634,318,4761
2016-09-26,NYSE (N),797138759,0,0,797138759,30144157465.255917,0.000000,0.000000,30144157465.255917,2659040,0,0,2659040
2016-09-26,NYSE Arca (P),201521539,256160390,131746079,589428008,7871364621.717550,15863926060.916539,5394275971.692733,29129566654.326822,1547663,784011,932333,3264007
2016-09-26,NASDAQ (Q),311709247,87956661,394909874,794575782,12742987944.885789,5294998589.622210,16956498874.209540,34994485408.717539,2563867,403457,2425056,5392380
2016-09-26,IEX (V),58527903,13151841,29773094,101452838,2343934038.217703,652455074.181399,1202361716.959101,4198750829.358203,357927,51767,178725,588419
2016-09-26,NASDAQ PSX (X),20884953,13500750,20109700,54495403,702706560.740000,794726351.356700,699173022.473200,2196605934.569900,161165,59107,134296,354568
2016-09-26,BATS BYX (Y),143982022,55325704,62908901,262216627,4131837926.779878,2248071441.488897,2054213599.507900,8434122967.776675,1197192,244382,534582,1976156
2016-09-26,BATS BZX (Z),196667799,83551357,102545544,382764700,6995139227.818260,4920146998.632397,3967483294.910320,15882769521.360977,1594285,394596,823961,2812842
2016-09-23,NYSE MKT (A),0,11952076,2698770,14650846,0.000000,60054275.603500,50603357.393000,110657632.996500,0,28906,8328,37234
2016-09-23,NASDAQ BX (B),90343574,30327274,46281621,166952469,3463319226.971496,1368145163.935397,1894128623.417199,6725593014.324092,882664,134989,443358,1461011
2016-09-23,NSX (C),262467,115584,192259,570310,10497399.250000,7147069.400000,11975361.334000,29619829.984000,1561,549,1198,3308
2016-09-23,NYSE (DN),88246305,42505653,68356475,199108433,2774167030.072000,1616469414.916695,2298834417.076107,6689470862.064802,225628,84911,150123,460662
2016-09-23,NASDAQ (DQ),1001822756,485579010,636389702,2123791468,32812343937.289703,22175856605.345255,20865020987.312043,75853221529.947001,3364565,846986,1834729,6046280
2016-09-23,EDGA (J),85150519,39979081,42111793,167241393,2693429464.456302,1833750043.078599,1431852485.393099,5959031992.928000,750716,182450,349771,1282937
2016-09-23,EDGX (K),198254264,99313846,160746862,458314972,7029233959.701790,4597042856.805686,5663002072.338064,17289278888.845540,1410706,378316,954768,2743790
2016-09-23,CHX (M),24186838,12263857,3148404,39599099,1807276557.104900,1035294235.490000,234371277.827000,3076942070.421900,1620,2866,474,4960
2016-09-23,NYSE (N),826478961,0,0,826478961,30977570155.878097,0.000000,0.000000,30977570155.878097,2724698,0,0,2724698
2016-09-23,NYSE Arca (P),216305888,284130619,144352140,644788647,8227112739.591244,14619963643.433878,6577867805.064110,29424944188.089232,1617795,759839,987602,3365236
2016-09-23,NASDAQ (Q),334571197,99687795,428516771,862775763,13675741680.366971,5475937845.500099,18671281003.889610,37822960529.756680,2777640,427741,2587996,5793377
2016-09-23,IEX (V),58132469,16899612,30002755,105034836,2333849611.089801,762519409.628800,1357758047.395904,4454127068.114505,356376,55306,174918,586600
2016-09-23,NASDAQ PSX (X),20706588,16705841,20911529,58323958,689902195.974998,893601630.670400,774366331.050500,2357870157.695898,162554,66135,143543,372232
2016-09-23,BATS BYX (Y),144424269,63831568,65585829,273841666,4049404737.120486,2467378013.608395,2141201949.771393,8657984700.500274,1215914,266067,555613,2037594
2016-09-23,BATS BZX (Z),200978166,90920997,113407388,405306551,6933227306.906560,4900249108.158608,4772989396.732889,16606465811.798057,1662417,405982,902689,2971088
2016-09-22,NYSE MKT (A),0,16283366,2749981,19033347,0.000000,63077112.479700,41543216.995000,104620329.474700,0,29806,8832,38638
2016-09-22,NASDAQ BX (B),88397799,33105711,45879326,167382836,3203144390.951005,1511810455.641599,1859986872.835099,6574941719.427703,824827,153438,426057,1404322
2016-09-22,NSX (C),302187,185490,137360,625037,13505732.370000,24639308.120000,9774397.103200,47919437.593200,1380,864,925,3169
2016-09-22,NYSE (DN),107153011,50999141,75210862,233363014,3264258784.866830,1922934748.101701,2497484311.561200,7684677844.529731,254397,97452,175118,526967
2016-09-22,NASDAQ (DQ),1126790376,521983238,725858474,2374632088,38322604666.788056,22679250827.062584,23035164688.294190,84037020182.144830,3603262,1001410,2039406,6644078
2016-09-22,EDGA (J),87088930,44484896,46599278,178173104,2724937852.934101,1988092687.842900,1525652710.355801,6238683251.132802,757350,215067,374215,1346632
2016-09-22,EDGX (K),196512513,117198845,174575827,488287185,6775480448.203919,5541002382.583087,5898632898.188767,18215115728.975773,1357397,430767,996169,2784333
2016-09-22,CHX (M),31584418,8973754,5213129,45771301,2235268969.482400,564786102.551000,491878882.594800,3291933954.628200,1362,2558,566,4486
2016-09-22,NYSE (N),855527280,0,0,855527280,31885039687.137247,0.000000,0.000000,31885039687.137247,2728253,0,0,2728253
2016-09-22,NYSE Arca (P),223913979,314263958,151489602,689667539,8887816850.240703,17054635470.311916,6378032983.526806,32320485304.079425,1677018,869984,1024718,3571720
2016-09-22,NASDAQ (Q),344728923,122561458,437268763,904559144,14107889982.988029,6884427301.370487,19612211846.851689,40604529131.210205,2818316,501342,2622360,5942018
2016-09-22,IEX (V),67169029,16645454,35735089,119549572,2717725430.535190,849626794.015600,1546995454.978501,5114347679.529291,395412,62869,200759,659040
2016-09-22,NASDAQ PSX (X),22589311,19060966,22939218,64589495,724951684.489002,1057842637.943600,765556312.110399,2548350634.543001,161871,75288,140762,377921
2016-09-22,BATS BYX (Y),151402454,65609125,68531961,285543540,4335252285.830399,2629172493.163702,2260144254.318007,9224569033.312108,1263569,287236,582023,2132828
2016-09-22,BATS BZX (Z),220706613,108773627,122361311,451841551,7633701087.853724,5930451021.932611,4794703578.700386,18358855688.486721,1767363,481291,966525,3215179
2016-09-21,NYSE MKT (A),0,26787577,3149015,29936592,0.000000,76616863.717501,57815442.199000,134432305.916501,0,44712,12019,56731
2016-09-21,NASDAQ BX (B),89707238,44711963,47526305,181945506,3209853324.770179,1942926126.614198,1874187373.688794,7026966825.073171,830107,194435,434053,1458595
2016-09-21,NSX (C),334870,241238,210331,786439,17053806.510000,25586376.590900,13860229.053400,56500412.154300,2046,893,1359,4298
2016-09-21,NYSE (DN),114050640,63401600,85541764,262994004,3193260803.186601,2282797389.791900,2540759421.727195,8016817614.705696,242520,113682,173980,530182
2016-09-21,NASDAQ (DQ),1110072550,626947461,719524025,2456544036,36407443875.516881,25265424641.914887,22826748742.922976,84499617260.354744,3425111,1129005,1959983,6514099
2016-09-21,EDGA (J),93952170,63194420,47287925,204434515,2755944225.666404,2626016392.796298,1568549147.184302,6950509765.647004,801806,281473,385178,1468457
2016-09-21,EDGX (K),228344095,171000908,189228893,588573896,7645136248.904916,7512600581.872955,6532330231.813376,21690067062.591247,1588611,602214,1088649,3279474
2016-09-21,CHX (M),27732927,8065341,3857086,39655354,1776610982.362600,675753665.478000,350647255.906000,2803011903.746600,1754,5176,1087,8017
2016-09-21,NYSE (N),898341581,0,0,898341581,32142793209.955667,0.000000,0.000000,32142793209.955667,3051714,0,0,3051714
2016-09-21,NYSE Arca (P),254536353,466317118,166777143,887630614,9762538496.769380,24188449598.927838,7099629097.920415,41050617193.617633,1860592,1215837,1131289,4207718
2016-09-21,NASDAQ (Q),381820125,185520348,478286880,1045627353,15141993445.245370,9764797432.458944,21039421097.920787,45946211975.625101,3090001,747697,2948644,6786342
2016-09-21,IEX (V),62640098,21306255,31007431,114953784,2475760148.795696,999804263.977600,1392757912.762599,4868322325.535895,367346,76307,187032,630685
2016-09-21,NASDAQ PSX (X),25849467,28627334,24807362,79284163,843233280.757499,1724784482.972500,928928499.985200,3496946263.715199,182872,112951,156472,452295
2016-09-21,BATS BYX (Y),160202778,89557951,72641555,322402284,4464567354.112606,3405574855.136703,2396653029.650294,10266795238.899603,1329377,371252,607451,2308080
2016-09-21,BATS BZX (Z),237874007,156215117,132052370,526141494,7836194539.966712,8211910645.702878,5255248050.409716,21303353236.079306,1897009,679531,1036405,3612945
2016-09-20,NYSE MKT (A),0,9090826,2821573,11912399,0.000000,47409015.680800,45867842.254000,93276857.934800,0,26843,9026,35869
2016-09-20,NASDAQ BX (B),80393775,27720316,41383278,149497369,2860300341.503697,1187089636.710700,1547966924.342100,5595356902.556497,746168,125310,380500,1251978
2016-09-20,NSX (C),336123,145622,304779,786524,11253407.990000,9537816.700400,11216120.059800,32007344.750200,2067,581,1516,4164
2016-09-20,NYSE (DN),106804005,41337260,66561534,214702799,2856032835.318400,1457427373.662099,2014183020.854304,6327643229.834803,225813,77453,155840,459106
2016-09-20,NASDAQ (DQ),953175488,389004572,637065957,1979246017,30776877611.345381,17772126132.260983,20043829854.352381,68592833597.958745,3122865,835192,1825026,5783083
2016-09-20,EDGA (J),76599579,32665533,39249152,148514264,2371001225.832493,1454782378.425203,1285208758.379398,5110992362.637094,655711,158080,324492,1138283
2016-09-20,EDGX (K),185979956,91007551,158367081,435354588,6204785195.873468,4049707403.313501,5206236551.419702,15460729150.606671,1254808,353472,920863,2529143
2016-09-20,CHX (M),31877363,13205439,8558262,53641064,2109593850.482800,1024948560.150000,594341114.934300,3728883525.567100,1638,3297,579,5514
2016-09-20,NYSE (N),760098379,0,0,760098379,26887561555.025851,0.000000,0.000000,26887561555.025851,2394572,0,0,2394572
2016-09-20,NYSE Arca (P),209998659,244323598,134289860,588612117,7737211450.612587,12773780799.869625,5435525628.443896,25946517878.926108,1528085,717660,944938,3190683
2016-09-20,NASDAQ (Q),299454023,86813709,394141747,780409479,12104721581.820601,4754623801.233406,16341440704.087150,33200786087.141157,2440408,384538,2403591,5228537
2016-09-20,IEX (V),55188161,15079145,25242460,95509766,2098154412.293499,637701029.692500,1119122203.817699,3854977645.803698,297046,46101,153376,496523
2016-09-20,NASDAQ PSX (X),21350762,13751910,19273169,54375841,640076616.308001,785558144.654301,644678124.223400,2070312885.185702,144978,61044,125404,331426
2016-09-20,BATS BYX (Y),138168376,55584524,62500392,256253292,3763533275.159200,2146240599.452808,1967563320.501403,7877337195.113411,1104759,236182,515608,1856549
2016-09-20,BATS BZX (Z),197959538,80844490,107776160,386580188,6581295402.497149,4238228532.908199,4077362210.866215,14896886146.271563,1560369,379568,862089,2802026
2016-09-19,NYSE MKT (A),0,10911682,3429648,14341330,0.000000,70242378.807700,43771902.085000,114014280.892700,0,26448,8938,35386
2016-09-19,NASDAQ BX (B),82075430,29966759,42979795,155021984,2909436021.242786,1347562262.825900,1644283342.702898,5901281626.771584,754071,137082,399803,1290956
2016-09-19,NSX (C),483452,212496,366241,1062189,18225677.690000,20054675.770000,12750638.350500,51030991.810500,3477,864,1742,6083
2016-09-19,NYSE (DN),102999145,40286075,75774461,219059681,2863755414.710915,1768586364.813299,2353075306.334307,6985417085.858521,237207,83565,165443,486215
2016-09-19,NASDAQ (DQ),965602297,419308131,659453550,2044363978,30191379400.617665,19082358462.229712,20530189608.924558,69803927471.771935,3104309,820214,1889482,5814005
2016-09-19,EDGA (J),79205536,35145174,44392028,158742738,2455011650.132999,1555921213.220103,1416808578.151500,5427741441.504602,696332,170605,358234,1225171
2016-09-19,EDGX (K),181578780,93569655,171297788,446446223,6210572282.989641,4562455479.586210,5802423045.165192,16575450807.741043,1265518,398348,995642,2659508
2016-09-19,CHX (M),30832833,8249048,5840373,44922254,1573423974.863000,696850948.447300,482304295.293300,2752579218.603600,1814,3964,548,6326
2016-09-19,NYSE (N),780154803,0,0,780154803,27582814455.878614,0.000000,0.000000,27582814455.878614,2495633,0,0,2495633
2016-09-19,NYSE Arca (P),204144578,274991414,142329730,621465722,7614022270.862159,14951586367.329053,5913407906.035500,28479016544.226712,1520383,816347,1020332,3357062
2016-09-19,NASDAQ (Q),306738178,100371881,418662013,825772072,12281501059.302388,5858825034.878509,17647320206.443472,35787646300.624369,2550125,471272,2596091,5617488
2016-09-19,IEX (V),50229271,11205339,25869950,87304560,1953819098.152701,563482240.832300,1139654899.557000,3656956238.542001,286398,46912,158163,491473
2016-09-19,NASDAQ PSX (X),21273893,14932618,19941551,56148062,660356245.230800,851272327.991599,694684344.425900,2206312917.648299,149186,70588,131478,351252
2016-09-19,BATS BYX (Y),142503001,60144011,66887376,269534388,3980574445.650486,2365093601.021096,2115555093.896195,8461223140.567777,1173316,263014,555947,1992277
2016-09-19,BATS BZX (Z),194008796,87246200,115426118,396681114,6594618535.140479,4779005285.439011,4422765409.898197,15796389230.477687,1561333,426648,925698,2913679
2016-09-16,NYSE MKT (A),0,121945046,2973847,124918893,0.000000,617136514.844700,61213403.722000,678349918.566700,0,34034,11804,45838
2016-09-16,NASDAQ BX (B),101818818,40035854,56565278,198419950,3712744015.128505,1770379154.792397,2048935320.298694,7532058490.219596,961244,169306,488939,1619489
2016-09-16,NSX (C),486076,348286,296006,1130368,17011553.080000,47412945.696000,15956068.810000,80380567.586000,3274,1029,1912,6215
2016-09-16,NYSE (DN),98621881,44097274,89318404,232037559,2804391588.445511,1886051568.117302,2431448576.275803,7121891732.838616,256070,95611,182769,534450
2016-09-16,NASDAQ (DQ),1242225245,550644512,961902210,2754771967,40409312675.392497,31098067165.729169,29567110149.413345,101074489990.535011,3464186,955645,2081060,6500891
2016-09-16,EDGA (J),91978328,49286120,55037263,196301711,2790086075.891592,2182406709.897002,1575780546.596900,6548273332.385494,776814,228541,395826,1401181
2016-09-16,EDGX (K),188977208,120061804,206550801,515589813,6719163282.044193,6275217977.066310,6180656682.089494,19175037941.199997,1389908,482851,1060395,2933154
2016-09-16,CHX (M),20424970,24799187,8570879,53795036,1075411583.897000,2192797531.761700,465180759.583100,3733389875.241800,1904,3981,593,6478
2016-09-16,NYSE (N),2162818551,0,0,2162818551,80417441197.913708,0.000000,0.000000,80417441197.913708,2994831,0,0,2994831
2016-09-16,NYSE Arca (P),234562036,339414179,196971817,770948032,9151851219.855314,20100876227.149956,7070872949.994291,36323600396.999561,1772605,1010950,1159402,3942957
2016-09-16,NASDAQ (Q),352843701,134205557,1141008868,1628058126,14419901167.665500,8292014341.952880,45556726839.929137,68268642349.547517,2866665,573926,2927794,6368385
2016-09-16,IEX (V),56303880,15565679,35362598,107232157,2264589928.929800,804026216.769100,1394725605.614301,4463341751.313201,342538,59918,190522,592978
2016-09-16,NASDAQ PSX (X),22312587,21286262,27483954,71082803,778110586.233200,1349070178.892300,878480898.703200,3005661663.828700,171494,92832,158820,423146
2016-09-16,BATS BYX (Y),175605725,89440880,88458373,353504978,4952616210.468828,3597008728.439399,2586883404.531904,11136508343.440131,1413353,364235,672392,2449980
2016-09-16,BATS BZX (Z),229899970,127048106,147039961,503988037,8084374293.221321,7384102056.760787,5478806021.645487,20947282371.627595,1929877,562935,1088336,3581148
2016-09-15,NYSE MKT (A),0,11817837,4084088,15901925,0.000000,54444123.358900,86390914.808000,140835038.166900,0,28130,11910,40040
2016-09-15,NASDAQ BX (B),89167050,37482629,48940544,175590223,3274506089.401798,1830003271.130400,2028814656.495799,7133324017.027997,875140,170266,455727,1501133
2016-09-15,NSX (C),386721,503095,330358,1220174,10913844.830000,72769971.969300,25011006.600500,108694823.399800,2281,1458,1675,5414
2016-09-15,NYSE (DN),102922546,49353290,79692671,231968507,2826852091.721891,1808403357.143201,2629557720.961304,7264813169.826396,239823,97408,173417,510648
2016-09-15,NASDAQ (DQ),1004525904,523618098,694406059,2222550061,32774419613.137411,29149109035.780280,24794617220.842572,86718145869.760263,3386661,957974,2000497,6345132
2016-09-15,EDGA (J),90752426,47308572,49019422,187080420,2843998545.034613,2352876229.022894,1726802927.476002,6923677701.533509,800940,230972,399808,1431720
2016-09-15,EDGX (K),197090657,129753308,195308646,522152611,6923263644.094492,7199888815.069788,7126301619.622945,21249454078.787225,1409942,529070,1110521,3049533
2016-09-15,CHX (M),18384708,11323815,5686838,35395361,790308968.324000,1013509472.031200,446721423.423000,2250539863.778200,1601,5361,973,7935
2016-09-15,NYSE (N),842470878,0,0,842470878,30560030170.888209,0.000000,0.000000,30560030170.888209,2833576,0,0,2833576
2016-09-15,NYSE Arca (P),218421585,350785156,162415282,731622023,8495334966.899743,19997051887.822312,7385015228.921729,35877402083.643784,1692025,1047438,1118166,3857629
2016-09-15,NASDAQ (Q),335149537,134035432,463441177,932626146,13635382063.519126,8375977425.673594,20520796453.934238,42532155943.126958,2772455,603314,2763539,6139308
2016-09-15,IEX (V),55637201,15754283,28170618,99562102,2324402038.872397,845036889.174100,1342207035.409999,4511645963.456496,350358,61815,172607,584780
2016-09-15,NASDAQ PSX (X),21193896,21461537,22724359,65379792,665806004.977000,1443244441.351199,931937527.349000,3040987973.677199,152285,92100,148957,393342
2016-09-15,BATS BYX (Y),160682662,75395177,76416845,312494684,4533047192.248236,3267876942.877905,2629763375.925095,10430687511.051236,1331070,330232,641502,2302804
2016-09-15,BATS BZX (Z),214132352,125158583,130728470,470019405,7305998695.600761,7592981289.971081,5730306661.881181,20629286647.453023,1729945,562917,1039491,3332353
2016-09-14,NYSE MKT (A),0,11247412,3091934,14339346,0.000000,56444038.746800,71120487.706000,127564526.452800,0,31461,12359,43820
2016-09-14,NASDAQ BX (B),96847794,39633082,48090696,184571572,3479020991.714386,1796793463.218002,1919943236.879503,7195757691.811891,915203,181589,444956,1541748
2016-09-14,NSX (C),908373,687833,464773,2060979,17597124.410000,94639335.568800,11710916.934600,123947376.913400,4055,2130,2120,8305
2016-09-14,NYSE (DN),110139088,52377061,74771070,237287219,2968870271.338215,2120439277.605301,2585563073.364209,7674872622.307725,250659,97746,176040,524445
2016-09-14,NASDAQ (DQ),1081272169,495856943,670621983,2247751095,33996258732.695102,24349771370.612281,23641772508.393242,81987802611.700625,3419138,955616,1941172,6315926
2016-09-14,EDGA (J),93507793,50436421,47232327,191176541,2736599435.718999,2309471907.495597,1654743674.659996,6700815017.874592,788633,254629,394547,1437809
2016-09-14,EDGX (K),221740438,143023461,186322077,551085976,7973643424.911389,7829089056.946183,6947463242.252103,22750195724.109675,1634153,586010,1129624,3349787
2016-09-14,CHX (M),18451652,18030498,8921975,45404125,1224140304.170200,1250341686.565900,490318584.339200,2964800575.075300,1679,7146,1399,10224
2016-09-14,NYSE (N),904617839,0,0,904617839,32301496310.964414,0.000000,0.000000,32301496310.964414,3219558,0,0,3219558
2016-09-14,NYSE Arca (P),247079785,374289803,163501861,784871449,9711218525.888854,20864104205.118228,7331905061.238174,37907227792.245256,1896795,1206110,1128615,4231520
2016-09-14,NASDAQ (Q),370224914,158615995,445916117,974757026,15125698435.459890,9585593111.467605,19827038196.483103,44538329743.410598,3121491,713719,2950775,6785985
2016-09-14,IEX (V),56844441,15368984,28844529,101057954,2229153336.324200,778818035.776700,1383352901.973201,4391324274.074101,338032,61658,165970,565660
2016-09-14,NASDAQ PSX (X),22955891,23236253,24979491,71171635,736353084.438999,1469793208.943199,928137989.633400,3134284283.015598,169408,102860,154252,426520
2016-09-14,BATS BYX (Y),169728558,84963163,73678602,328370323,4587497292.126197,3383085890.020593,2487777885.265912,10458361067.412702,1352647,360577,623206,2336430
2016-09-14,BATS BZX (Z),242059784,137993123,130632533,510685440,8319593052.539303,8215161887.619994,5555600002.167414,22090354942.326711,2014869,655406,1074700,3744975
2016-09-13,NYSE MKT (A),0,11837404,4001632,15839036,0.000000,63590191.287000,77669982.635000,141260173.922000,0,29440,13410,42850
2016-09-13,NASDAQ BX (B),146747663,55817238,69371431,271936332,5508548237.327971,2586719840.862002,2812260010.645202,10907528088.835175,1369816,249715,642274,2261805
2016-09-13,NSX (C),336229,961218,181853,1479300,13157496.800000,116758519.650000,9583016.464700,139499032.914700,2089,2690,1064,5843
2016-09-13,NYSE (DN),97315550,52412972,64421418,214149940,2652428126.445603,2368993488.187100,2106210549.914400,7127632164.547103,248889,117246,155487,521622
2016-09-13,NASDAQ (DQ),1164251316,647826111,689311276,2501388703,35617958344.201221,34942039506.468236,23579802780.595991,94139800631.265448,3740613,1329275,1934896,7004784
2016-09-13,EDGA (J),120270621,71759726,56256933,248287280,3541554764.666298,3510346273.777695,1951000891.708401,9002901930.152394,993152,361123,449939,1804214
2016-09-13,EDGX (K),219373078,172586151,198174271,590133500,6658899225.940183,9904051488.965117,6498142869.413708,23061093584.319008,1464921,708030,1101420,3274371
2016-09-13,CHX (M),19944101,15582133,3228672,38754906,1298824037.193000,1527039741.015000,316477919.831600,3142341698.039600,1332,8914,1584,11830
2016-09-13,NYSE (N),1034316921,0,0,1034316921,35009949243.681790,0.000000,0.000000,35009949243.681790,3517679,0,0,3517679
2016-09-13,NYSE Arca (P),283714700,536329801,192616514,1012661015,10695767672.526463,30048744027.460108,8370769772.030996,49115281472.017567,2136818,1631118,1273210,5041146
2016-09-13,NASDAQ (Q),429714257,204223765,492559243,1126497265,16900180597.300624,12894931979.927008,21320007368.603995,51115119945.831627,3638952,915971,3141116,7696039
2016-09-13,IEX (V),66131614,21247203,30459582,117838399,2646067630.216196,1196797572.246099,1492981019.773900,5335846222.236195,383308,81510,173443,638261
2016-09-13,NASDAQ PSX (X),26049432,28373023,27018117,81440572,818151818.325999,2003801260.081501,928280556.126700,3750233634.534200,189499,126868,160310,476677
2016-09-13,BATS BYX (Y),235283522,117160336,101945636,454389494,7214365470.362026,5123990921.419004,3747940729.502604,16086297121.283634,1988769,512795,896886,3398450
2016-09-13,BATS BZX (Z),262728380,175128242,143489830,581346452,8656620924.031084,10931735734.255184,6092134349.388912,25680491007.675180,2163320,822529,1147211,4133060
2016-09-12,NYSE MKT (A),0,13476896,4184847,17661743,0.000000,69507727.701900,105893529.537000,175401257.238900,0,34267,19191,53458
2016-09-12,NASDAQ BX (B),140275336,49359127,69604742,259239205,5208601560.052993,2360805668.811899,2812128734.435906,10381535963.300798,1320624,220684,656782,2198090
2016-09-12,NSX (C),979667,661473,488912,2130052,22336562.280000,71247106.479700,15965260.468800,109548929.228500,5373,2262,2791,10426
2016-09-12,NYSE (DN),94056630,43861958,62686652,200605240,2858699561.090807,1923485020.972406,2053172420.248396,6835357002.311609,236547,110721,157085,504353
2016-09-12,NASDAQ (DQ),1136767766,584644304,660103020,2381515090,37071625947.724579,29085149844.166499,22173466123.724767,88330241915.615845,3805677,1243864,2078295,7127836
2016-09-12,EDGA (J),115981548,63470903,54213484,233665935,3441402429.306899,3061152458.013200,1844605535.645900,8347160422.965999,966123,320457,452657,1739237
2016-09-12,EDGX (K),201845100,148721766,178241159,528808025,6482407728.513513,8645238990.660070,6249156196.614981,21376802915.788564,1383934,607973,1102515,3094422
2016-09-12,CHX (M),10052172,9088217,5476521,24616910,609117600.320300,736807254.216000,516190427.365600,1862115281.901900,1671,6845,1885,10401
2016-09-12,NYSE (N),1021386396,0,0,1021386396,36262386401.736468,0.000000,0.000000,36262386401.736468,3559455,0,0,3559455
2016-09-12,NYSE Arca (P),275119366,475651606,177469832,928240804,10425919014.306851,28148687561.675629,7552458715.273103,46127065291.255583,2109337,1451042,1228730,4789109
2016-09-12,NASDAQ (Q),406734707,179814740,497106824,1083656271,16409528941.416717,11619158155.656499,21578894099.848622,49607581196.921838,3459828,813699,3158339,7431866
2016-09-12,IEX (V),62056337,18385262,32420062,112861661,2438206189.169890,1032925911.049500,1394867823.414100,4865999923.633490,373988,70986,187104,632078
2016-09-12,NASDAQ PSX (X),26584853,28152200,26994371,81731424,834807416.624399,1917647721.471201,948777605.548601,3701232743.644201,193850,122590,159692,476132
2016-09-12,BATS BYX (Y),226362488,106558563,100980509,433901560,7036816032.014845,4564953038.356296,3582222076.375193,15183991146.746334,1908309,461175,881386,3250870
2016-09-12,BATS BZX (Z),263614880,159885420,139855174,563355474,8931648771.701080,10139379439.666283,5632885847.967885,24703914059.335248,2146380,727284,1139794,4013458
2016-09-09,NYSE MKT (A),0,13950224,3103937,17054161,0.000000,66814488.719900,55683610.570000,122498099.289900,0,34493,9970,44463
2016-09-09,NASDAQ BX (B),112839812,50130384,60191946,223162142,4179583391.357308,2479947463.454002,2384489852.322204,9044020707.133514,1050810,223923,536136,1810869
2016-09-09,NSX (C),378007,875841,193939,1447787,15554280.822500,106325412.845300,7079939.650800,128959633.318600,2517,2608,922,6047
2016-09-09,NYSE (DN),117823457,60245410,75982991,254051858,3487636561.390223,2514140270.788802,2659331426.908810,8661108259.087835,317213,142871,194501,654585
2016-09-09,NASDAQ (DQ),1262731299,664639756,753812206,2681183261,40915764412.887470,36610956323.071569,26706294660.388121,104233015396.347160,4147029,1394548,2289452,7831029
2016-09-09,EDGA (J),113318946,70006675,55844238,239169859,3533142936.341011,3505997000.897199,1890528712.723402,8929668649.961612,966182,359367,451144,1776693
2016-09-09,EDGX (K),239687815,165810356,202164131,607662302,7988588648.573163,9822381916.036562,7216363587.628888,25027334152.238613,1628160,659160,1193978,3481298
2016-09-09,CHX (M),17988992,23096326,5904887,46990205,1129145441.809000,3058020844.042400,403689182.358300,4590855468.209700,2040,8146,1597,11783
2016-09-09,NYSE (N),1083570411,0,0,1083570411,39576293799.111574,0.000000,0.000000,39576293799.111574,3484210,0,0,3484210
2016-09-09,NYSE Arca (P),279078785,513795690,196732904,989607379,10990830398.615485,31670717568.127692,8352611556.687402,51014159523.430579,2117366,1400763,1295171,4813300
2016-09-09,NASDAQ (Q),412943166,190299557,542625793,1145868516,16799935072.397978,13178193340.330100,24409463348.574579,54387591761.302657,3446208,823127,3254772,7524107
2016-09-09,IEX (V),65634724,21823592,35246594,122704910,2601563583.777809,1361038206.876800,1516111063.707800,5478712854.362409,396946,86458,202971,686375
2016-09-09,NASDAQ PSX (X),25859188,26892034,28307202,81058424,827137388.473601,1960673217.628201,980097572.852500,3767908178.954302,185072,115150,177027,477249
2016-09-09,BATS BYX (Y),203674147,111026831,96828604,411529582,6169267615.789054,4983876089.901394,3431756964.584813,14584900670.275261,1708237,486937,816141,3011315
2016-09-09,BATS BZX (Z),273319061,169818749,153040938,596178748,9416929087.849932,11693123608.572227,6562176657.530511,27672229353.952670,2208584,762091,1214818,4185493
2016-09-08,NYSE MKT (A),0,12779035,2082700,14861735,0.000000,63836323.687400,40241738.893000,104078062.580400,0,30352,7453,37805
2016-09-08,NASDAQ BX (B),96306932,31735996,46026688,174069616,3452209225.452609,1396663328.254002,1759892574.509298,6608765128.215909,905179,141493,420022,1466694
2016-09-08,NSX (C),439212,284021,449710,1172943,16970292.100000,24591384.840000,9549791.242200,51111468.182200,2836,822,1813,5471
2016-09-08,NYSE (DN),103737444,39545868,65234310,208517622,2770326876.385694,1452946145.624502,1957171415.362802,6180444437.372998,258455,91684,154666,504805
2016-09-08,NASDAQ (DQ),1263887981,474024802,682750509,2420663292,39587815468.864923,19743308170.058619,22502803140.521692,81833926779.445234,3622764,903503,1949838,6476105
2016-09-08,EDGA (J),95167761,40326174,45217673,180711608,2778603569.897100,1720645716.283898,1436541298.758501,5935790584.939499,795302,190444,361761,1347507
2016-09-08,EDGX (K),219618217,104361318,173053216,497032751,7001461847.573200,4682831342.728683,5606271555.644997,17290564745.946880,1435246,389239,959680,2784165
2016-09-08,CHX (M),16919718,13851755,6825131,37596604,1210964955.612100,1168119140.529500,481754098.517200,2860838194.658800,2058,4013,609,6680
2016-09-08,NYSE (N),839312504,0,0,839312504,28771519061.715377,0.000000,0.000000,28771519061.715377,2652694,0,0,2652694
2016-09-08,NYSE Arca (P),238713947,299253506,147233544,685200997,8364687622.769881,15418772113.883516,6022820886.716712,29806280623.370109,1672289,806698,991567,3470554
2016-09-08,NASDAQ (Q),348308540,112479036,432255033,893042609,13197108517.151506,6200882870.839913,17939599658.827410,37337591046.818829,2734482,465647,2572474,5772603
2016-09-08,IEX (V),64149226,12839862,27374007,104363095,2346817063.848408,608661232.424001,1244495670.179101,4199973966.451510,346245,48790,154229,549264
2016-09-08,NASDAQ PSX (X),24144817,17763987,22059046,63967850,712805579.986900,946067277.374000,758725118.848200,2417597976.209100,167962,78304,139822,386088
2016-09-08,BATS BYX (Y),163297898,67046868,70583219,300927985,4614781269.247929,2648714581.916103,2332711202.741707,9596207053.905739,1338982,288571,586151,2213704
2016-09-08,BATS BZX (Z),233057693,99028319,120670121,452756133,7571253709.255726,5346423470.149696,4702361403.683108,17620038583.088530,1775971,421426,917537,3114934
2016-09-07,NYSE MKT (A),0,14345093,3851109,18196202,0.000000,68999062.435400,60915373.845000,129914436.280400,0,32910,11890,44800
2016-09-07,NASDAQ BX (B),94818208,28265088,50432740,173516036,3648934188.291607,1294768932.558801,2116517846.501304,7060220967.351712,926676,133956,496433,1557065
2016-09-07,NSX (C),384018,238895,462530,1085443,15100107.370000,23915431.100200,10363471.964400,49379010.434600,2568,783,1973,5324
2016-09-07,NYSE (DN),89880809,38034824,65879937,193795570,2692924674.081901,1292950467.250302,2146097660.805009,6131972802.137212,247782,87708,174869,510359
2016-09-07,NASDAQ (DQ),1013830051,440536543,671426752,2125793346,33912843897.026902,21325951446.691898,24768310059.015059,80007105402.733859,3560069,934504,2062564,6557137
2016-09-07,EDGA (J),87564757,38308812,45558114,171431683,2674260168.049092,1703220273.733600,1585574961.944096,5963055403.726788,755946,194846,382636,1333428
2016-09-07,EDGX (K),197203483,97842760,181268414,476314657,7114376670.591654,4259296595.429503,5998021785.887526,17371695051.908683,1431006,342951,1022074,2796031
2016-09-07,CHX (M),15876485,16448796,8789179,41114460,968531567.725400,2003187972.940099,490160109.563000,3461879650.228499,1922,2888,784,5594
2016-09-07,NYSE (N),823424839,0,0,823424839,29842699015.364536,0.000000,0.000000,29842699015.364536,2574065,0,0,2574065
2016-09-07,NYSE Arca (P),216436675,250180590,147630389,614247654,8602305262.710152,13023628236.301700,6439265591.989601,28065199091.001453,1686370,688756,1067058,3442184
2016-09-07,NASDAQ (Q),322656106,95967272,472844743,891468121,13274302041.540703,5255246725.218700,23916525295.711760,42446074062.471163,2711127,402332,2709901,5823360
2016-09-07,IEX (V),55849232,10697340,29180445,95727017,2117613954.682301,553056306.909200,1277389709.208500,3948059970.800001,314752,44995,164286,524033
2016-09-07,NASDAQ PSX (X),21564815,15200900,21312229,58077944,688756032.998802,822383325.008400,749123295.715900,2260262653.723102,163376,63461,142563,369400
2016-09-07,BATS BYX (Y),149513110,61555446,67075289,278143845,4354286182.040275,2460127076.523401,2333959213.711306,9148372472.274982,1264573,264015,589033,2117621
2016-09-07,BATS BZX (Z),211225238,88745957,114333303,414304498,7433534725.260935,4609833012.059700,4663805183.404305,16707172920.724940,1725571,386602,940664,3052837
2016-09-06,NYSE MKT (A),0,14891383,2826494,17717877,0.000000,72166132.920400,56883493.979000,129049626.899400,0,32133,11335,43468
2016-09-06,NASDAQ BX (B),95046148,35329965,46824803,177200916,3628454928.390206,1513171622.933197,2050729646.405403,7192356197.728806,930944,151786,467705,1550435
2016-09-06,NSX (C),245147,385970,290101,921218,9013910.470000,25150588.706100,12693155.177800,46857654.353900,1781,1043,2036,4860
2016-09-06,NYSE (DN),92831545,43514428,66856761,203202734,2634233417.156604,1421523091.139300,2127888847.814198,6183645356.110102,250467,95928,166462,512857
2016-09-06,NASDAQ (DQ),1075521191,492485351,637174993,2205181535,35622246353.666165,20698872672.030331,21791877988.624558,78112997014.321054,3611120,970027,1993502,6574649
2016-09-06,EDGA (J),90378747,48512320,44497816,183388883,2789724265.885598,2088595372.698299,1580504784.364500,6458824422.948397,796416,226488,371446,1394350
2016-09-06,EDGX (K),207752943,110966628,166585325,485304896,7568742043.849562,4716052523.387020,5692406028.144979,17977200595.381561,1413520,388909,959888,2762317
2016-09-06,CHX (M),13599691,9845960,7165618,30611269,873368513.328300,804604444.394600,553251169.485300,2231224127.208200,2286,3389,580,6255
2016-09-06,NYSE (N),857605315,0,0,857605315,31730567428.783644,0.000000,0.000000,31730567428.783644,2695374,0,0,2695374
2016-09-06,NYSE Arca (P),220245874,340549928,142260118,703055920,8798984232.388921,16598507246.111637,6623711687.857008,32021203166.357566,1688048,791814,1026392,3506254
2016-09-06,NASDAQ (Q),324085336,116378445,439640349,880104130,13440640771.423713,5967811854.030715,19943634397.530884,39352087022.985312,2776959,458505,2657269,5892733
2016-09-06,IEX (V),63406067,15708449,30359808,109474324,2427552514.376702,692964696.706200,1458054408.405499,4578571619.488401,340957,57047,174820,572824
2016-09-06,NASDAQ PSX (X),21396010,17504421,21526009,60426440,719837237.683100,921859752.450899,748137711.216800,2389834701.350799,166309,73251,140228,379788
2016-09-06,BATS BYX (Y),152411769,75462873,64796177,292670819,4453232861.604261,3002131135.899399,2307177277.443679,9762541274.947339,1310585,301928,597537,2210050
2016-09-06,BATS BZX (Z),207642135,106605948,109038306,423286389,7381597067.544917,5457916870.073895,4608816947.465299,17448330885.084111,1760283,432161,924457,3116901
2016-09-02,NYSE MKT (A),0,11110616,2318576,13429192,0.000000,58332784.149300,57029007.396000,115361791.545300,0,25975,10816,36791
2016-09-02,NASDAQ BX (B),79126137,35124267,38108989,152359393,2902276571.220097,1542900483.455199,1709908997.953094,6155086052.628390,744634,143382,373173,1261189
2016-09-02,NSX (C),155705,239280,100783,495768,3123318.118600,28397138.250800,5234009.528400,36754465.897800,786,698,554,2038
2016-09-02,NYSE (DN),89504116,42423792,56022165,187950073,2412326810.140402,1611336771.786998,1683252913.369899,5706916495.297299,230639,92583,133911,457133
2016-09-02,NASDAQ (DQ),933297344,422502049,516655411,1872454804,29536634829.043492,17983918487.105768,17824159103.483767,65344712419.633027,3098760,860399,1673529,5632688
2016-09-02,EDGA (J),77303557,43331449,36392392,157027398,2276816968.208094,2002817192.255899,1258937049.411198,5538571209.875191,655991,203023,307449,1166463
2016-09-02,EDGX (K),192245294,107276999,142585105,442107398,6306897261.898277,5215980833.188402,5004466105.408800,16527344200.495479,1271047,386928,860833,2518808
2016-09-02,CHX (M),11594251,10516963,3915957,26027171,672546637.965300,857203410.509500,315648504.766400,1845398553.241200,2057,4152,716,6925
2016-09-02,NYSE (N),803232309,0,0,803232309,29322010860.419159,0.000000,0.000000,29322010860.419159,2522445,0,0,2522445
2016-09-02,NYSE Arca (P),204129536,341273411,120088850,665491797,7681896898.671561,18311331686.825530,5631339229.635213,31624567815.132304,1522962,834666,889902,3247530
2016-09-02,NASDAQ (Q),297643791,113499561,370531295,781674647,11684326098.492329,6550318232.866407,16841304230.644359,35075948562.003095,2456623,465324,2314018,5235965
2016-09-02,IEX (V),45375710,12648205,20986448,79010363,1767725988.729999,619492573.777000,1110561007.430000,3497779569.936999,267657,45476,130528,443661
2016-09-02,NASDAQ PSX (X),19176401,17693930,17211940,54082271,602584129.189999,1059947205.232400,613274877.878300,2275806212.300699,150328,69637,118330,338295
2016-09-02,BATS BYX (Y),136215960,68912822,54303544,259432326,3821578400.196821,2795748359.305498,2031644957.010792,8648971716.513111,1125810,288255,485171,1899236
2016-09-02,BATS BZX (Z),200082485,103171753,97274624,400528862,6744503826.757772,5875344475.100400,4278492231.249713,16898340533.107885,1615575,434106,829453,2879134
2016-09-01,NYSE MKT (A),0,12423230,2647268,15070498,0.000000,60427417.845200,60021624.223000,120449042.068200,0,27802,11022,38824
2016-09-01,NASDAQ BX (B),89903258,36142989,41720188,167766435,3269821901.250220,1631314363.652101,1876644988.089102,6777781252.991423,854960,154017,423989,1432966
2016-09-01,NSX (C),636263,375016,424705,1435984,25995923.740000,45058303.080300,18781925.149200,89836151.969500,4402,1050,2254,7706
2016-09-01,NYSE (DN),143769606,51157894,81300638,276228138,4568358819.336294,2073535628.323702,2791936410.826696,9433830858.486692,498851,123486,262137,884474
2016-09-01,NASDAQ (DQ),1017508031,518840924,541317471,2077666426,31545783517.034604,24374566028.664228,18534767514.433667,74455117060.132499,3426300,947552,1763510,6137362
2016-09-01,EDGA (J),90908092,47734949,39851934,178494975,2676058345.081612,2143476450.888301,1454727746.433498,6274262542.403411,776449,216366,342716,1335531
2016-09-01,EDGX (K),208497185,112240193,151439642,472177020,7025510550.599822,5525711096.196608,5390834667.166116,17942056313.962546,1450844,417301,942220,2810365
2016-09-01,CHX (M),24285733,16512685,5851723,46650141,1700846850.846400,1503445780.086000,501828478.505000,3706121109.437400,1842,3965,597,6404
2016-09-01,NYSE (N),828278889,0,0,828278889,28784671912.845590,0.000000,0.000000,28784671912.845590,2846558,0,0,2846558
2016-09-01,NYSE Arca (P),231193589,345352501,139542414,716088504,8507063892.743514,18285753830.676653,6355346565.301100,33148164288.721267,1752296,900773,1013336,3666405
2016-09-01,NASDAQ (Q),341670693,124447461,394419633,860537787,13362950711.085670,7355510116.133672,17583033388.049070,38301494215.268412,2863375,520576,2623540,6007491
2016-09-01,IEX (V),4308463,2457077,1541646,8307186,161580175.590000,126633244.750900,60584847.585000,348798267.925900,27764,10455,10062,48281
2016-09-01,NASDAQ PSX (X),20713712,18672742,20174248,59560702,641578068.874599,1169164994.145300,712348960.454700,2523092023.474599,157560,77164,129543,364267
2016-09-01,BATS BYX (Y),162145193,76701768,64002489,302849450,4477826353.148426,3093645608.584804,2332214375.283807,9903686337.017037,1325695,304461,579585,2209741
2016-09-01,BATS BZX (Z),225824084,109398771,109434071,444656926,7490883751.264184,6379870524.029018,4746798364.425716,18617552639.718918,1892612,474788,957858,3325258
2016-08-31,NYSE MKT (A),0,20164926,2464922,22629848,0.000000,86609558.260900,65306364.210000,151915922.470900,0,28613,10216,38829
2016-08-31,NASDAQ BX (B),88790022,33373689,40430366,162594077,3213158527.735500,1463171914.175203,1624353818.161899,6300684260.072602,824969,137263,392248,1354480
2016-08-31,NSX (C),240057,290867,165098,696022,8017758.035600,41473145.229000,7254429.828000,56745333.092600,1429,751,758,2938
2016-08-31,NYSE (DN),143168664,51446352,83656477,278271493,4649893141.908892,1914097729.372105,2446898742.047801,9010889613.328798,509250,122316,260253,891819
2016-08-31,NASDAQ (DQ),1133155455,453633593,602967174,2189756222,34467369484.624694,21033792688.981581,18215773978.647799,73716936152.254074,3500084,919548,1724090,6143722
2016-08-31,EDGA (J),91521009,43610685,43358417,178490111,2664639169.016994,1847866836.588802,1353259150.155997,5865765155.761793,762022,196873,348531,1307426
2016-08-31,EDGX (K),209087976,107266265,154944657,471298898,6997411037.218120,4967236776.506906,4601897468.069708,16566545281.794734,1400674,401495,891081,2693250
2016-08-31,CHX (M),10134751,9440991,2539159,22114901,526301188.464500,828081453.772300,194810812.681400,1549193454.918200,1929,3614,611,6154
2016-08-31,NYSE (N),1103023726,0,0,1103023726,39892601326.378735,0.000000,0.000000,39892601326.378735,2742792,0,0,2742792
2016-08-31,NYSE Arca (P),225554484,309441433,129552097,664548014,8447215581.011787,16457314988.240773,5127324834.661602,30031855403.914162,1671628,858208,909494,3439330
2016-08-31,NASDAQ (Q),331635066,114715037,502761743,949111846,12960770164.409395,6432597284.007096,19634570724.309805,39027938172.726296,2681726,478497,2463437,5623660
2016-08-31,IEX (V),4923428,1846118,1443286,8212832,171342165.190000,89045181.679100,54249110.165600,314636457.034700,27440,7654,9210,44304
2016-08-31,NASDAQ PSX (X),20890313,16655197,18981303,56526813,640669191.130001,977526311.921800,622129902.973900,2240325406.025701,154595,70586,123794,348975
2016-08-31,BATS BYX (Y),162902329,74020639,61899129,298822097,4468421411.311182,2942910498.851094,2102283578.667504,9513615488.829780,1292419,300649,548798,2141866
2016-08-31,BATS BZX (Z),233156164,105863810,109505411,448525385,7702828056.153343,5889387367.623201,4155741097.644799,17747956521.421343,1847804,466867,918352,3233023
2016-08-30,NYSE MKT (A),0,9413565,1720433,11133998,0.000000,49189775.823000,36570289.850000,85760065.673000,0,23453,7331,30784
2016-08-30,NASDAQ BX (B),75758099,27693566,37077681,140529346,2823247379.983802,1218362283.823199,1477410988.153999,5519020651.961000,711535,124989,352208,1188732
2016-08-30,NSX (C),156802,151291,218163,526256,5371747.190000,11573131.030000,3696427.386400,20641305.606400,1014,612,616,2242
2016-08-30,NYSE (DN),127341329,46835568,85318517,259495414,4168628691.080998,1760555556.962704,2331099006.480999,8260283254.524701,432917,111613,240550,785080
2016-08-30,NASDAQ (DQ),948744535,412120825,551638084,1912503444,29320490579.548857,18137337745.998929,15945680356.015155,63403508681.562941,3101869,813470,1622385,5537724
2016-08-30,EDGA (J),77637679,34874180,39754369,152266228,2336300894.707293,1516867009.248805,1266932205.662802,5120100109.618900,648166,168159,307997,1124322
2016-08-30,EDGX (K),188572339,87265491,152968416,428806246,6550879435.260890,3949437883.486213,4617495350.693206,15117812669.440309,1258095,359465,838991,2456551
2016-08-30,CHX (M),6281517,10797702,2851137,19930356,361328130.099000,879715938.935100,167076711.078000,1408120780.112100,3535,2665,881,7081
2016-08-30,NYSE (N),754526231,0,0,754526231,26633663034.023861,0.000000,0.000000,26633663034.023861,2386893,0,0,2386893
2016-08-30,NYSE Arca (P),195519634,251799573,129085456,576404663,7498941643.852922,12543818332.708266,5063721344.235631,25106481320.796819,1454548,710912,870021,3035481
2016-08-30,NASDAQ (Q),289935997,87265449,389579707,766781153,11411355115.608880,4758575011.021900,15362670233.131383,31532600359.762163,2361184,395734,2246108,5003026
2016-08-30,IEX (V),207861,11265,296860,515986,11694531.820000,780915.000000,6331096.610000,18806543.430000,1655,50,2008,3713
2016-08-30,NASDAQ PSX (X),18538727,13392758,16713885,48645370,578787519.600400,755187452.314900,593275311.924700,1927250283.840000,137087,57535,113792,308414
2016-08-30,BATS BYX (Y),131601994,59440066,54841561,245883621,3815810982.558114,2325631273.139799,1907224245.663307,8048666501.361220,1075285,245443,473552,1794280
2016-08-30,BATS BZX (Z),192031654,81615547,100412375,374059576,6403784834.520114,4228626541.903283,3861583939.585731,14493995316.009128,1544745,390763,818735,2754243
2016-08-29,NYSE MKT (A),0,8272854,2329810,10602664,0.000000,45737967.287800,47770053.448000,93508020.735800,0,21538,8275,29813
2016-08-29,NASDAQ BX (B),70339782,24893793,37186129,132419704,2645120814.948194,1096916662.255302,1483341843.840600,5225379321.044096,679931,108771,356991,1145693
2016-08-29,NSX (C),131139,102358,319895,553392,4706422.400000,7964937.190000,6396410.881600,19067770.471600,998,380,1159,2537
2016-08-29,NYSE (DN),111941504,35097349,75793906,222832759,3631517493.543805,1342872042.581304,2394643973.477802,7369033509.602911,385032,95308,230363,710703
2016-08-29,NASDAQ (DQ),831913542,329498053,512121816,1673533411,26606895304.335975,16153943651.919785,15691716521.404525,58452555477.660285,2881567,695114,1639922,5216603
2016-08-29,EDGA (J),73536348,28758557,36233088,138527993,2350184968.989097,1307184897.394198,1243262474.986300,4900632341.369595,650815,140987,310188,1101990
2016-08-29,EDGX (K),161165192,71103614,136963801,369232607,5575254763.026259,3630250366.088699,4488386624.413520,13693891753.528478,1106362,285096,795971,2187429
2016-08-29,CHX (M),9146230,7703173,1567061,18416464,568230861.385400,861476613.553900,153602247.517200,1583309722.456500,1489,2248,400,4137
2016-08-29,NYSE (N),659871407,0,0,659871407,23839578593.371506,0.000000,0.000000,23839578593.371506,2187853,0,0,2187853
2016-08-29,NYSE Arca (P),171464832,227480316,115736377,514681525,6653934838.854032,11957212828.905589,4810910353.375596,23422058021.135217,1300071,573710,816288,2690069
2016-08-29,NASDAQ (Q),249734209,74427937,337858868,662021014,10030735456.257698,4249689921.003089,14280223996.378655,28560649373.639442,2076559,329141,2059292,4464992
2016-08-29,IEX (V),333855,3988,372951,710794,11658359.550000,121032.880000,5778222.995000,17557615.425000,1719,35,1904,3658
2016-08-29,NASDAQ PSX (X),15406903,12074898,17972803,45454604,501380711.967000,708721999.522000,575973140.030600,1786075851.519600,117770,52638,111662,282070
2016-08-29,BATS BYX (Y),124076049,48849503,52476233,225401785,3688547454.750224,1976013040.372097,1824985547.153005,7489546042.275326,1058480,202783,476125,1737388
2016-08-29,BATS BZX (Z),174244351,69734585,91013217,334992153,6075597327.943636,4061236309.134899,3569560996.536409,13706394633.614944,1443411,329020,761815,2534246
2016-08-26,NYSE MKT (A),0,11644705,2513205,14157910,0.000000,67944839.174100,55733509.490000,123678348.664100,0,27869,10592,38461
2016-08-26,NASDAQ BX (B),83569514,44066048,41174664,168810226,3041056334.808718,1961452105.441499,1723056251.687595,6725564691.937812,778069,180104,386147,1344320
2016-08-26,NSX (C),191499,327358,169148,688005,5876651.920000,23397981.050000,4953031.965700,34227664.935700,1106,1078,794,2978
2016-08-26,NYSE (DN),131706686,60240489,73760890,265708065,4268576591.080906,2682043270.786606,2753174946.216009,9703794808.083521,453140,156869,240643,850652
2016-08-26,NASDAQ (DQ),940225998,492069095,532611652,1964906745,29834375164.877334,22690330374.548626,17465982464.869438,69990688004.295398,3141215,1038167,1663306,5842688
2016-08-26,EDGA (J),90330666,58760333,41910051,191001050,2639492292.413811,2654711895.013202,1474988803.426703,6769192990.853716,756927,278871,352469,1388267
2016-08-26,EDGX (K),225854138,149248670,162794988,537897796,7328798936.047351,7701624976.686477,5811929328.593168,20842353241.326996,1489165,589598,985935,3064698
2016-08-26,CHX (M),7761257,10752017,1610711,20123985,487308085.887200,1085285198.351600,127299951.991200,1699893236.230000,1539,4086,741,6366
2016-08-26,NYSE (N),821906932,0,0,821906932,28109072878.644120,0.000000,0.000000,28109072878.644120,2982986,0,0,2982986
2016-08-26,NYSE Arca (P),236729863,429562108,142627304,808919275,8708157305.046390,23680142779.425451,6544242635.360016,38932542719.831857,1771100,1322199,1028849,4122148
2016-08-26,NASDAQ (Q),361157025,171156980,385942763,918256768,13949252360.470153,9772725240.621792,17329424003.678180,41051401604.770125,2949893,708330,2638580,6296803
2016-08-26,IEX (V),104138,3156,40325,147619,707885.830000,43546.920000,267985.290000,1019418.040000,445,19,265,729
2016-08-26,NASDAQ PSX (X),23130204,25605761,21116539,69852504,704912408.030700,1641399929.738899,777118140.018100,3123430477.787699,160050,98528,131342,389920
2016-08-26,BATS BYX (Y),159360825,89798758,65936493,315096076,4450578894.626114,3610351744.894307,2312079907.813204,10373010547.333625,1285119,369558,567799,2222476
2016-08-26,BATS BZX (Z),256161185,156466741,119757886,532385812,8426748919.350226,9178784239.800294,5147581152.575966,22753114311.726486,2011962,688797,994118,3694877
2016-08-25,NYSE MKT (A),0,13499799,2537881,16037680,0.000000,50545579.168800,45635506.451000,96181085.619800,0,25616,8607,34223
2016-08-25,NASDAQ BX (B),80962131,25721574,40193975,146877680,3133977224.760388,1157697736.303500,1650846631.447498,5942521592.511386,784214,116167,406067,1306448
2016-08-25,NSX (C),354472,119472,218743,692687,17386148.420000,9980551.580000,6762669.746000,34129369.746000,2340,432,1385,4157
2016-08-25,NYSE (DN),129686473,40646278,80239596,250572347,4702293880.618272,1593338839.864200,2616433023.043595,8912065743.526067,475643,99102,248447,823192
2016-08-25,NASDAQ (DQ),930076674,353721729,529026009,1812824412,32136019682.674435,16704624719.013418,17546439295.575840,66387083697.263693,3177180,764935,1659565,5601680
2016-08-25,EDGA (J),78679448,32003770,38528865,149212083,2501093320.310215,1476827965.667599,1303784900.018705,5281706185.996519,678295,161694,327568,1167557
2016-08-25,EDGX (K),182472402,90858943,153028499,426359844,6766706768.708925,4134825090.815305,5072376108.604179,15973907968.128409,1290069,354294,920762,2565125
2016-08-25,CHX (M),9726194,7540581,2279016,19545791,518496014.029000,614205031.034100,236783825.871500,1369484870.934600,1615,3047,658,5320
2016-08-25,NYSE (N),717744922,0,0,717744922,26198883314.644084,0.000000,0.000000,26198883314.644084,2537924,0,0,2537924
2016-08-25,NYSE Arca (P),199302868,246108337,130023568,575434773,8173957135.847935,13291023252.348590,5546121614.195412,27011102002.391937,1564895,701309,946655,3212859
2016-08-25,NASDAQ (Q),288768214,89360904,353200758,731329876,12390292659.589738,4931136343.093287,14933973777.676576,32255402780.359601,2499470,385710,2393195,5278375
2016-08-25,IEX (V),111928,4444,50640,167012,595201.525000,16657.270000,345690.725000,957549.520000,288,43,341,672
2016-08-25,NASDAQ PSX (X),18085905,13255161,20266947,51608013,603042540.263601,762870040.600300,638584709.025800,2004497289.889701,136152,58362,119314,313828
2016-08-25,BATS BYX (Y),133972913,53094937,60245718,247313568,3938956647.228487,2159878357.856608,2067532749.711000,8166367754.796095,1103728,233900,533109,1870737
2016-08-25,BATS BZX (Z),194480475,81279333,103650502,379410310,7066847008.388580,4504366051.567311,4208004111.413200,15779217171.369091,1606285,378296,859367,2843948
2016-08-24,NYSE MKT (A),0,12707483,1856831,14564314,0.000000,79153679.286000,34052071.810000,113205751.096000,0,27730,6526,34256
2016-08-24,NASDAQ BX (B),79939398,35075706,39658338,154673442,2891925149.561302,1368473197.122301,1611867497.175700,5872265843.859303,740283,145872,381578,1267733
2016-08-24,NSX (C),224111,137151,132613,493875,10936532.890000,10397012.480000,11408367.448000,32741912.818000,1472,518,948,2938
2016-08-24,NYSE (DN),137785725,54589518,90775241,283150484,4410318317.696079,2019589050.264797,2792267220.295897,9222174588.256773,465055,122817,266793,854665
2016-08-24,NASDAQ (DQ),1019303604,473213241,636707515,2129224360,32126630307.006711,20890422572.084392,18768590005.587999,71785642884.679102,3290982,912296,1813614,6016892
2016-08-24,EDGA (J),80251704,42953655,41425780,164631139,2394450576.042095,1813119645.952399,1351909547.344700,5559479769.339194,671999,200394,343398,1215791
2016-08-24,EDGX (K),204040683,98917669,169088412,472046764,7116392912.654040,4493681542.220105,5023264121.328689,16633338576.202834,1363590,379828,963521,2706939
2016-08-24,CHX (M),9425063,8323921,3715094,21464078,361736226.822000,523503264.885000,253517835.099000,1138757326.806000,2068,3535,545,6148
2016-08-24,NYSE (N),756275169,0,0,756275169,27326530730.696589,0.000000,0.000000,27326530730.696589,2482110,0,0,2482110
2016-08-24,NYSE Arca (P),207718624,305564062,142736613,656019299,7916214854.170612,15729921368.386890,5429790986.443996,29075927209.001498,1538364,759241,973636,3271241
2016-08-24,NASDAQ (Q),300294791,104163555,396277891,800736237,11870437645.708334,5655694047.769582,16281625030.960477,33807756724.438393,2427216,431273,2483007,5341496
2016-08-24,IEX (V),93318,1635,38038,132991,530206.110000,9154.750000,270198.760000,809559.620000,390,15,246,651
2016-08-24,NASDAQ PSX (X),19136616,15874566,19629809,54640991,577665365.163000,826147450.694599,675998188.505501,2079811004.363100,138928,70721,128079,337728
2016-08-24,BATS BYX (Y),137287282,68098394,63034096,268419772,3865797837.745504,2568742769.781904,2139308419.970923,8573849027.498331,1114042,274873,552227,1941142
2016-08-24,BATS BZX (Z),205681679,97031773,113507350,416220802,6885080771.089259,4985483571.026403,4183945523.255915,16054509865.371577,1606270,416340,900951,2923561
2016-08-23,NYSE MKT (A),0,11082703,2241356,13324059,0.000000,56191140.931700,41397300.576000,97588441.507700,0,23048,7666,30714
2016-08-23,NASDAQ BX (B),78346927,26896078,39010914,144253919,2905462078.908796,1203872820.866099,1556984179.203998,5666319078.978893,746492,113815,367966,1228273
2016-08-23,NSX (C),203158,256271,150932,610361,10789716.580000,8358540.189400,5344573.111600,24492829.881000,1231,795,907,2933
2016-08-23,NYSE (DN),131856779,41301667,78337306,251495752,4371432701.480603,1556625403.051600,2488046998.408004,8416105102.940207,455130,101147,241283,797560
2016-08-23,NASDAQ (DQ),1002387399,372593978,565637815,1940619192,32370265340.748367,16364673018.960862,17246003019.842260,65980941379.551489,3244459,741589,1717935,5703983
2016-08-23,EDGA (J),78050903,33178535,38263402,149492840,2381067482.155698,1502286538.061601,1259718716.661799,5143072736.879098,661567,156599,309406,1127572
2016-08-23,EDGX (K),183581229,81439582,151179167,416199978,6181095096.242401,4040818266.895098,4485396017.783900,14707309380.921399,1196683,311507,844724,2352914
2016-08-23,CHX (M),7863025,9429662,2444494,19737181,773390860.454100,875936574.727600,155717656.452800,1805045091.634500,1524,3160,429,5113
2016-08-23,NYSE (N),734388994,0,0,734388994,26184406383.279444,0.000000,0.000000,26184406383.279444,2313978,0,0,2313978
2016-08-23,NYSE Arca (P),198853836,234628780,128387075,561869691,7655950025.655604,12378479086.221417,4770502857.292324,24804931969.169345,1461905,618500,864552,2944957
2016-08-23,NASDAQ (Q),284436359,79438902,364652749,728528010,11327545798.593179,4583467783.820707,14837014101.479728,30748027683.893614,2307933,341630,2128945,4778508
2016-08-23,IEX (V),37361,0,11244,48605,227903.990000,0.000000,93539.485000,321443.475000,200,0,90,290
2016-08-23,NASDAQ PSX (X),19451258,13180293,19140888,51772439,588038942.524999,667279560.793000,595392778.035400,1850711281.353399,141091,56387,123156,320634
2016-08-23,BATS BYX (Y),133088848,56242566,58842244,248173658,3827211664.786616,2279103247.911206,1936038986.685093,8042353899.382915,1101450,231160,501303,1833913
2016-08-23,BATS BZX (Z),191844147,76111556,100210734,368166437,6507152843.455718,4212635545.014796,3609972186.861906,14329760575.332420,1503404,332499,762079,2597982
2016-08-22,NYSE MKT (A),0,12668429,2223319,14891748,0.000000,48173122.097400,42081859.432000,90254981.529400,0,25093,7129,32222
2016-08-22,NASDAQ BX (B),69810843,25512034,37729109,133051986,2492945371.364800,1108497224.972799,1524394330.147805,5125836926.485404,671217,112440,352089,1135746
2016-08-22,NSX (C),181835,111792,147201,440828,7564695.111200,9070890.306900,7316120.797000,23951706.215100,1338,422,886,2646
2016-08-22,NYSE (DN),114385433,39927833,81675553,235988819,3707603357.106201,1599528282.122800,2545233271.607911,7852364910.836912,411510,100143,254396,766049
2016-08-22,NASDAQ (DQ),885664821,353764137,568975255,1808404213,28185210369.504710,15419140319.224588,17624935114.909220,61229285803.638518,3016026,737350,1694791,5448167
2016-08-22,EDGA (J),70829332,31679876,38827151,141336359,2192397734.807799,1472179410.178599,1272285603.818601,4936862748.804999,630069,156402,309887,1096358
2016-08-22,EDGX (K),164146514,78057931,151517389,393721834,5726887851.213046,3845705359.551802,4640635286.413609,14213228497.178457,1142838,312427,856841,2312106
2016-08-22,CHX (M),6853009,9023701,2354364,18231074,258826461.554200,684081766.637800,147641974.927700,1090550203.119700,1516,2910,500,4926
2016-08-22,NYSE (N),703413385,0,0,703413385,25797778950.608460,0.000000,0.000000,25797778950.608460,2294328,0,0,2294328
2016-08-22,NYSE Arca (P),183823941,241515206,137302224,562641371,7142537037.977323,12715969155.286224,5542009129.499406,25400515322.762953,1422113,655342,917530,2994985
2016-08-22,NASDAQ (Q),265962232,80307077,362251974,708521283,10706275138.848837,4604357346.060008,15066498456.547571,30377130941.456416,2255117,358204,2197719,4811040
2016-08-22,IEX (V),32767,0,26497,59264,203647.055000,0.000000,218823.900000,422470.955000,279,0,97,376
2016-08-22,NASDAQ PSX (X),17519030,12159460,20085503,49763993,569772834.070000,694541714.561400,679353018.129900,1943667566.761300,138365,57694,125772,321831
2016-08-22,BATS BYX (Y),122313161,52308904,58511507,233133572,3521518322.021206,2046639064.744200,1933119688.793002,7501277075.558408,1048946,224665,496512,1770123
2016-08-22,BATS BZX (Z),174980461,74222625,100999547,350202633,5985490310.778692,4074551302.564016,3799734630.159674,13859776243.502382,1447199,340957,795098,2583254
2016-08-19,NYSE MKT (A),0,15372966,3608653,18981619,0.000000,93303886.061200,116224075.508000,209527961.569200,0,23602,10935,34537
2016-08-19,NASDAQ BX (B),78639933,25658887,38400024,142698844,2963085930.376001,1154933287.850600,1511568191.841801,5629587410.068402,785872,113194,375269,1274335
2016-08-19,NSX (C),223041,76935,553192,853168,10578484.770000,6808273.320000,6756801.283300,24143559.373300,958,270,1401,2629
2016-08-19,NYSE (DN),117085129,40821093,74031420,231937642,4070058162.007706,1556676266.125699,2345384784.360508,7972119212.493913,433950,95705,232190,761845
2016-08-19,NASDAQ (DQ),977992999,351154931,593209463,1922357393,32373132484.429362,17161178065.692251,17283988987.418663,66818299537.540276,3208045,714596,1680380,5603021
2016-08-19,EDGA (J),75941700,29910859,38727669,144580228,2381346668.163602,1409343297.203198,1221998637.753704,5012688603.120504,660552,150764,310712,1122028
2016-08-19,EDGX (K),177663207,76317522,150303176,404283905,6404949651.541297,3926761813.171119,4507281972.561327,14838993437.273743,1238751,297976,822752,2359479
2016-08-19,CHX (M),7617194,14006642,3557102,25180938,370355015.242000,1784794461.571500,218311384.393000,2373460861.206500,2645,2757,688,6090
2016-08-19,NYSE (N),844422021,0,0,844422021,32411629847.050609,0.000000,0.000000,32411629847.050609,2406412,0,0,2406412
2016-08-19,NYSE Arca (P),199543923,230917446,129203829,559665198,7990001718.824661,12952847256.557050,4871750198.423028,25814599173.804739,1512799,626412,861307,3000518
2016-08-19,NASDAQ (Q),280559460,81048951,421910348,783518759,11234091308.555262,4794130161.929291,17195024067.490894,33223245537.975447,2290121,345432,2205247,4840800
2016-08-19,IEX (V),74807,0,15523,90330,471855.415000,0.000000,128168.605000,600024.020000,318,0,122,440
2016-08-19,NASDAQ PSX (X),18758100,12454143,18125965,49338208,588157191.754999,696556446.726600,624414911.071098,1909128549.552697,137656,54487,114522,306665
2016-08-19,BATS BYX (Y),129048519,52705187,59221688,240975394,3761604715.104088,2115782315.535595,1879854207.091402,7757241237.731085,1087334,224601,501477,1813412
2016-08-19,BATS BZX (Z),188956180,75685490,104977327,369618997,6680063492.936024,4343329069.574090,3987801517.540061,15011194080.050175,1527592,344430,805091,2677113
2016-08-18,NYSE MKT (A),0,8994915,3400083,12394998,0.000000,52446817.480800,113640918.267000,166087735.747800,0,22773,11564,34337
2016-08-18,NASDAQ BX (B),82826746,24422715,39357162,146606623,3104624203.356504,1063086543.777801,1548009223.635714,5715719970.770019,798545,106534,371295,1276374
2016-08-18,NSX (C),244121,206491,133338,583950,9936401.360000,16741476.500000,5888369.550000,32566247.410000,1639,844,750,3233
2016-08-18,NYSE (DN),144903256,40603785,80521303,266028344,4775187570.751430,1549987362.510902,2518541429.724715,8843716362.987047,507891,104832,261013,873736
2016-08-18,NASDAQ (DQ),1123477211,385929356,635889980,2145296547,35985844641.927437,16727937397.425424,18254584749.794022,70968366789.146883,3473587,748785,1738173,5960545
2016-08-18,EDGA (J),85566262,30673820,38840855,155080937,2689397285.194607,1357280556.899299,1258743879.444209,5305421721.538115,730399,151503,320885,1202787
2016-08-18,EDGX (K),205162331,81428513,150319242,436910086,6992372785.042601,4052192289.073293,4356628511.583214,15401193585.699108,1362145,305500,841528,2509173
2016-08-18,CHX (M),7284730,9986130,2314398,19585258,336488505.152200,721315461.375000,168763764.612500,1226567731.139700,2626,2810,528,5964
2016-08-18,NYSE (N),756355938,0,0,756355938,27234134337.104296,0.000000,0.000000,27234134337.104296,2517010,0,0,2517010
2016-08-18,NYSE Arca (P),211915108,213910820,131579889,557405817,8060667356.432156,11718736608.795909,4766991635.006706,24546395600.234771,1588278,584819,891603,3064700
2016-08-18,NASDAQ (Q),320965725,83778613,389642819,794387157,12616238562.650477,4820053639.405808,14644235577.126551,32080527779.182836,2600547,368342,2242115,5211004
2016-08-18,NASDAQ PSX (X),21868680,13625209,19529344,55023233,646592123.445199,726634285.230600,558727903.301598,1931954311.977397,156339,57598,118774,332711
2016-08-18,BATS BYX (Y),139251133,52014354,62228447,253493934,3970529788.731233,2072650970.539603,1935124659.449793,7978305418.720629,1168435,215992,512289,1896716
2016-08-18,BATS BZX (Z),205528867,77477682,107009717,390016266,6973925353.586222,4234380990.748701,3833096534.778284,15041402879.113207,1631283,352239,810238,2793760
2016-08-17,NYSE MKT (A),0,11234610,3527399,14762009,0.000000,64072299.722500,106914670.597000,170986970.319500,0,26395,11821,38216
2016-08-17,NASDAQ BX (B),82243674,33603348,41085976,156932998,3048214614.655394,1450881012.218400,1558681126.809412,6057776753.683206,782896,144348,376776,1304020
2016-08-17,NSX (C),332715,179911,171847,684473,12243551.170000,12572098.971800,4576471.604900,29392121.746700,2114,765,792,3671
2016-08-17,NYSE (DN),143269068,51001320,88576328,282846716,4963292663.942482,2060356983.140699,2831523622.648711,9855173269.731892,525784,130972,302579,959335
2016-08-17,NASDAQ (DQ),1056126352,434999699,645008252,2136134303,34462027921.104973,20157875464.157032,18494744280.766533,73114647666.028538,3568659,879021,1891115,6338795
2016-08-17,EDGA (J),92530924,44378624,44869507,181779055,2818819990.513620,2033433096.902303,1369570907.918407,6221823995.334330,800498,222665,357334,1380497
2016-08-17,EDGX (K),218839928,106678092,169219325,494737345,7857114234.931053,5453832840.484702,5154250236.662283,18465197312.078038,1561445,398912,974025,2934382
2016-08-17,CHX (M),4114525,23021311,7338675,34474511,376114359.869400,1228304460.110000,370516787.905000,1974935607.884400,2794,3723,718,7235
2016-08-17,NYSE (N),789457886,0,0,789457886,28243800766.425204,0.000000,0.000000,28243800766.425204,2857728,0,0,2857728
2016-08-17,NYSE Arca (P),251711882,308556294,158301536,718569712,9800517094.626808,17046661627.889906,5960140455.908942,32807319178.425656,1897580,878037,1088276,3863893
2016-08-17,NASDAQ (Q),326098039,112776470,378664960,817539469,13003128715.521877,6249485447.812801,15238739522.574487,34491353685.909165,2657408,487212,2467857,5612477
2016-08-17,NASDAQ PSX (X),20997625,18652308,20920035,60569968,632015944.540499,970941520.877000,641093509.292801,2244050974.710300,150146,74972,131920,357038
2016-08-17,BATS BYX (Y),159958295,70643841,68311349,298913485,4580077854.023034,2878696490.358790,2200830371.956600,9659604716.338424,1336636,301488,574200,2212324
2016-08-17,BATS BZX (Z),245287445,109377780,123733114,478398339,8446117114.153587,5996164411.016396,4574755082.549687,19017036607.719670,1985190,472453,960198,3417841
2016-08-16,NYSE MKT (A),0,10755109,3792521,14547630,0.000000,59065392.541400,120588968.053000,179654360.594400,0,25381,10390,35771
2016-08-16,NASDAQ BX (B),80306688,26431540,40606074,147344302,2992471336.227412,1153808508.131201,1598863026.148117,5745142870.506730,788355,116180,378857,1283392
2016-08-16,NSX (C),287914,91585,393529,773028,10206069.563200,7928402.310400,11922396.502100,30056868.375700,1949,412,1807,4168
2016-08-16,NYSE (DN),133228457,45131585,83617290,261977332,4701063405.842734,1805831663.370101,2675593148.631928,9182488217.844763,484265,120499,276377,881141
2016-08-16,NASDAQ (DQ),1062611067,383189587,645374280,2091174934,34898437248.047894,16140374957.600197,18812951989.378449,69851764195.026540,3456740,793163,1902077,6151980
2016-08-16,EDGA (J),80727554,34789019,39762025,155278598,2525385715.560195,1650891316.770398,1272351531.112595,5448628563.443188,688398,175217,315067,1178682
2016-08-16,EDGX (K),191225847,79764481,154850294,425840622,6822827091.545899,3881034775.457308,4587872129.627015,15291733996.630222,1293160,307297,879206,2479663
2016-08-16,CHX (M),14969129,7964592,6326889,29260610,729956559.926800,710766230.317600,520825140.930000,1961547931.174400,2908,2825,664,6397
2016-08-16,NYSE (N),749466213,0,0,749466213,26949352058.960078,0.000000,0.000000,26949352058.960078,2474155,0,0,2474155
2016-08-16,NYSE Arca (P),219031674,231584364,142824710,593440748,8688835883.249262,12742912039.897226,5427891512.592199,26859639435.738687,1626564,654732,967541,3248837
2016-08-16,NASDAQ (Q),307089311,83703767,400084295,790877373,12574745313.785632,4980690310.740101,15853721222.249327,33409156846.775060,2492116,366455,2319093,5177664
2016-08-16,NASDAQ PSX (X),19868729,12437584,19187938,51494251,627739346.919999,656028040.748700,620557087.668500,1904324475.337199,146003,55093,122525,323621
2016-08-16,BATS BYX (Y),139811578,57093805,61484044,258389427,4055365157.257808,2319362398.750996,2040842862.863930,8415570418.872734,1164310,245154,524826,1934290
2016-08-16,BATS BZX (Z),202153852,79836989,105169760,387160601,6974359157.908060,4340234464.598609,3933670116.208434,15248263738.715103,1593050,360210,820484,2773744
2016-08-15,NYSE MKT (A),0,11297253,3010213,14307466,0.000000,63273680.176700,107976239.913000,171249920.089700,0,24740,9314,34054
2016-08-15,NASDAQ BX (B),75172548,24580357,35905740,135658645,2734401673.202203,1037410020.714402,1415127508.794696,5186939202.711301,710479,107269,349716,1167464
2016-08-15,NSX (C),417606,80709,187116,685431,14125378.240000,4435010.500000,6926688.168000,25487076.908000,2931,384,954,4269
2016-08-15,NYSE (DN),137611758,41838440,81483418,260933616,4671105506.747409,1583672320.081396,2728939704.988408,8983717531.817213,493337,104037,265602,862976
2016-08-15,NASDAQ (DQ),1022307502,341970531,567552062,1931830095,32559454711.920619,14409149314.764515,17893251498.616977,64861855525.302111,3381074,748019,1803554,5932647
2016-08-15,EDGA (J),78628766,27497926,36352132,142478824,2421481985.127487,1274250547.493000,1182940048.540898,4878672581.161385,686812,143359,306022,1136193
2016-08-15,EDGX (K),191933434,68297160,145283836,405514430,6525029308.148297,3244957416.242390,4649224605.541687,14419211329.932374,1248603,267152,867947,2383702
2016-08-15,CHX (M),8984094,6638907,4011288,19634289,1102089816.133800,602972693.695000,236797629.277500,1941860139.106300,2889,2941,522,6352
2016-08-15,NYSE (N),741165845,0,0,741165845,26771619587.684463,0.000000,0.000000,26771619587.684463,2355847,0,0,2355847
2016-08-15,NYSE Arca (P),200236116,212275955,130223437,542735508,7528038118.734033,11608377284.252925,5055877351.843830,24192292754.830788,1468223,570427,897388,2936038
2016-08-15,NASDAQ (Q),286781104,71704813,363727358,722213275,11237952807.222278,4168691297.651304,14910115440.731585,30316759545.605167,2302446,318782,2258999,4880227
2016-08-15,NASDAQ PSX (X),18105247,11212532,16102182,45419961,579686022.172499,559136350.023100,544090339.831600,1682912712.027199,140845,49097,112477,302419
2016-08-15,BATS BYX (Y),133332197,48198825,56460472,237991494,3783772102.949913,1878163236.487897,1858349892.431996,7520285231.869806,1120574,203614,491654,1815842
2016-08-15,BATS BZX (Z),186045169,67483178,95996815,349525162,6135094575.625758,3587375609.908401,3543445200.297075,13265915385.831234,1457209,306380,761997,2525586
2016-08-12,NYSE MKT (A),0,12300546,1863956,14164502,0.000000,66765644.525400,45578036.153000,112343680.678400,0,27038,9412,36450
2016-08-12,NASDAQ BX (B),76641110,27702926,37087259,141431295,2844388893.802810,1108371065.343001,1426442850.134491,5379202809.280302,744564,121440,359708,1225712
2016-08-12,NSX (C),285733,148860,241386,675979,10469376.420000,7467231.897000,4330728.317300,22267336.634300,2241,345,1435,4021
2016-08-12,NYSE (DN),129468517,42798488,69937691,242204696,4328170248.435892,1689769069.741399,2402459366.637986,8420398684.815277,465029,102421,244387,811837
2016-08-12,NASDAQ (DQ),977346505,407710890,559088121,1944145516,31351367761.688595,17678870262.473096,17067778911.469025,66098016935.630716,3155333,742122,1666180,5563635
2016-08-12,EDGA (J),78692166,30994434,36480558,146167158,2330994281.756404,1390471540.695499,1219033293.791506,4940499116.243409,660858,155518,311444,1127820
2016-08-12,EDGX (K),186287234,83012931,135652849,404953014,6749158101.288571,3591051418.284517,4316463299.013557,14656672818.586645,1259621,304807,850568,2414996
2016-08-12,CHX (M),12441447,8167809,2456275,23065531,1793308380.208102,730166139.817000,168856898.698700,2692331418.723802,3115,2329,574,6018
2016-08-12,NYSE (N),712123363,0,0,712123363,25964274698.949016,0.000000,0.000000,25964274698.949016,2388856,0,0,2388856
2016-08-12,NYSE Arca (P),198598731,232264269,131466146,562329146,7657585020.647374,12503343281.104747,4985260584.494527,25146188886.246648,1498899,677176,918599,3094674
2016-08-12,NASDAQ (Q),285195557,81375120,354771975,721342652,11420425730.342434,4488560936.590403,14409171950.329380,30318158617.262217,2337997,358212,2178643,4874852
2016-08-12,NASDAQ PSX (X),18780581,12666163,16587964,48034708,591117179.758300,630911173.158100,541985378.981799,1764013731.898199,144399,56411,113746,314556
2016-08-12,BATS BYX (Y),133992185,53304896,59369037,246666118,3778730763.085885,2000046049.708103,1995138988.907511,7773915801.701499,1107400,220357,515853,1843610
2016-08-12,BATS BZX (Z),193178506,77485801,97701731,368366038,6476152923.057072,3968171096.171499,3618488872.026962,14062812891.255533,1538406,340755,789002,2668163
2016-08-11,NYSE MKT (A),0,13925600,1852929,15778529,0.000000,82333199.648900,51618464.563000,133951664.211900,0,29603,9846,39449
2016-08-11,NASDAQ BX (B),80391728,29581769,35956164,145929661,2848546947.660905,1304977179.650205,1386016324.744398,5539540452.055508,739248,128190,340192,1207630
2016-08-11,NSX (C),563252,173067,344065,1080384,29618939.590000,12151514.555800,8649322.472400,50419776.618200,4344,783,1438,6565
2016-08-11,NYSE (DN),145442182,43036428,65483812,253962422,4907395294.503513,1867430479.082602,2461644807.995694,9236470581.581809,521428,113167,254057,888652
2016-08-11,NASDAQ (DQ),1165984254,412906009,572646978,2151537241,37443112945.248976,19587551791.893390,18635988212.632784,75666652949.775150,3496615,810552,1736546,6043713
2016-08-11,EDGA (J),86919963,34828687,36517383,158266033,2598421305.266980,1584035769.631799,1243672917.298803,5426129992.197582,727240,174498,315417,1217155
2016-08-11,EDGX (K),207304045,87449427,134493802,429247274,7049304558.294386,4113084637.946694,4374530190.874401,15536919387.115481,1361513,325440,854357,2541310
2016-08-11,CHX (M),13707404,10893401,2907831,27508636,1522764788.932500,801348606.920000,168700897.832000,2492814293.684500,3396,2907,424,6727
2016-08-11,NYSE (N),781608805,0,0,781608805,28499255767.825343,0.000000,0.000000,28499255767.825343,2639356,0,0,2639356
2016-08-11,NYSE Arca (P),245112949,251388391,133959036,630460376,9132309787.342014,14057547673.432233,5176602683.310675,28366460144.084922,1723926,710316,951423,3385665
2016-08-11,NASDAQ (Q),328212020,88595782,363241195,780048997,13040528868.814717,4919229940.049391,15231056138.982584,33190814947.846692,2648679,386800,2346713,5382192
2016-08-11,NASDAQ PSX (X),22485405,13276951,15809200,51571556,655321010.574901,700756852.099700,525894844.681401,1881972707.356002,158459,58761,112188,329408
2016-08-11,BATS BYX (Y),140250040,58893450,57057238,256200728,3909923052.264502,2383895276.361102,1890726714.163597,8184545042.789201,1148686,243914,510512,1903112
2016-08-11,BATS BZX (Z),211307840,85773774,96715477,393797091,6947988972.440030,4420245860.794609,3636548466.732547,15004783299.967186,1644062,368185,805999,2818246
2016-08-10,NYSE MKT (A),0,11181755,2645211,13826966,0.000000,55608868.001800,47308849.228000,102917717.229800,0,25885,11481,37366
2016-08-10,NASDAQ BX (B),79444637,27939294,39546323,146930254,2789480443.426893,1207094152.422200,1459246436.429281,5455821032.278374,754943,125465,375220,1255628
2016-08-10,NSX (C),327488,150207,340451,818146,12965990.740000,17012100.906000,4493323.699500,34471415.345500,2477,424,1024,3925
2016-08-10,NYSE (DN),144550928,43219769,75706196,263476893,4855290133.336422,1849955992.690601,2697669340.356113,9402915466.383136,505207,111263,280988,897458
2016-08-10,NASDAQ (DQ),1066955084,380949462,615473640,2063378186,32850042615.479002,16559365335.006757,18328529873.657787,67737937824.143546,3414228,789016,1897541,6100785
2016-08-10,EDGA (J),86201403,35109979,40226020,161537402,2540219317.041702,1571772453.851600,1273109265.012905,5385101035.906207,732500,174276,345586,1252362
2016-08-10,EDGX (K),201349957,79591057,150011218,430952232,6695548190.350104,3860484837.480497,4636880629.332528,15192913657.163129,1379739,321433,958523,2659695
2016-08-10,CHX (M),11880403,9969129,3280194,25129726,1339509159.953400,738515048.962000,215438021.444700,2293462230.360100,2451,2724,576,5751
2016-08-10,NYSE (N),764637637,0,0,764637637,26655276934.093988,0.000000,0.000000,26655276934.093988,2625910,0,0,2625910
2016-08-10,NYSE Arca (P),226798925,247929322,147575354,622303601,8467091632.425136,13473769357.045957,5396140384.350585,27337001373.821678,1657655,740211,1034289,3432155
2016-08-10,NASDAQ (Q),318640273,88206567,398187209,805034049,12497998770.121391,5136575238.161404,15348070186.607744,32982644194.890539,2614951,411463,2560014,5586428
2016-08-10,NASDAQ PSX (X),19763445,14135505,16801308,50700258,602010271.855199,747351270.645800,560403652.199101,1909765194.700100,148750,64381,120105,333236
2016-08-10,BATS BYX (Y),143891689,55452715,60466757,259811161,3973663912.448590,2171567249.313103,1924423719.424985,8069654881.186678,1172105,231506,535903,1939514
2016-08-10,BATS BZX (Z),199788014,82738682,104469846,386996542,6441726851.500886,4311414876.572995,3791099420.182691,14544241148.256572,1574705,373523,850393,2798621
2016-08-09,NYSE MKT (A),0,10867315,2209085,13076400,0.000000,53383390.665100,46167213.227000,99550603.892100,0,25637,9102,34739
2016-08-09,NASDAQ BX (B),92511887,26992364,42722801,162227052,3244475225.193179,1211639201.933599,1693563209.627098,6149677636.753876,866277,125301,421366,1412944
2016-08-09,NSX (C),261120,249452,551327,1061899,9410775.227800,17302881.516500,5831968.759800,32545625.504100,1616,771,1788,4175
2016-08-09,NYSE (DN),149706655,44346768,81036364,275089787,4885697558.793774,1751426335.662797,3121334045.488185,9758457939.944756,538854,117384,291084,947322
2016-08-09,NASDAQ (DQ),1100916834,394112499,624065521,2119094854,33109687736.246287,16864300949.411554,19731590130.630716,69705578816.288557,3552764,779380,1901068,6233212
2016-08-09,EDGA (J),111020435,33621856,40759806,185402097,3654824234.151306,1506236829.126204,1299284358.721198,6460345421.998708,985781,165755,349730,1501266
2016-08-09,EDGX (K),191913948,77159554,154545565,423619067,5850708619.504568,3611601119.391099,4982108890.767666,14444418629.663333,1246684,298678,963953,2509315
2016-08-09,CHX (M),11825638,8203508,4317820,24346966,1438683999.323001,560159214.700000,252536622.660400,2251379836.683401,2276,2635,549,5460
2016-08-09,NYSE (N),750947666,0,0,750947666,26284465927.235974,0.000000,0.000000,26284465927.235974,2587923,0,0,2587923
2016-08-09,NYSE Arca (P),238136525,246358228,147895604,632390357,8250019911.662587,13216713526.217394,5817503209.743763,27284236647.623744,1653889,685005,1045872,3384766
2016-08-09,NASDAQ (Q),308280636,85123420,376853485,770257541,11752880344.700210,4609726978.891500,15618959798.766056,31981567122.357766,2552267,387126,2556915,5496308
2016-08-09,NASDAQ PSX (X),20703691,12785339,16950199,50439229,590927818.270700,662911627.242500,587427909.316901,1841267354.830101,148411,58542,118020,324973
2016-08-09,BATS BYX (Y),154851205,56275451,64009013,275135669,4265091828.581572,2250651492.152511,2063034124.148811,8578777444.882894,1305452,239579,574561,2119592
2016-08-09,BATS BZX (Z),211167851,77403596,111060145,399631592,6803717449.073707,4145891887.872495,4260554736.707093,15210164073.653295,1660989,340329,915276,2916594
2016-08-08,NYSE MKT (A),0,11432546,3116247,14548793,0.000000,68275514.520100,57039570.799400,125315085.319500,0,25039,9711,34750
2016-08-08,NASDAQ BX (B),91886235,25128589,39385665,156400489,3225117729.447512,1032996250.378800,1542692480.327188,5800806460.153500,838983,111613,378353,1328949
2016-08-08,NSX (C),238203,187843,327091,753137,9090000.480000,23783809.880000,5513199.077600,38387009.437600,1571,685,1278,3534
2016-08-08,NYSE (DN),130905267,31337037,65755770,227998074,4472269979.421897,1178869450.778201,2296930209.787990,7948069639.988088,474589,87855,246366,808810
2016-08-08,NASDAQ (DQ),1121325408,389787608,632788575,2143901591,35699784695.625229,15613453645.245332,19337846582.513895,70651084923.384456,3445066,778952,1812008,6036026
2016-08-08,EDGA (J),112510451,31445641,38539191,182495283,3732468035.400308,1345403866.549401,1246218239.606303,6324090141.556012,989057,151845,325922,1466824
2016-08-08,EDGX (K),179232050,71632145,144983290,395847485,5707977341.527608,3177758884.538309,4441796588.954802,13327532815.020719,1198694,265388,890360,2354442
2016-08-08,CHX (M),14068416,6482125,4254557,24805098,1612604390.462000,526625365.604800,163600083.131900,2302829839.198700,2952,2669,570,6191
2016-08-08,NYSE (N),793714813,0,0,793714813,28632101409.477006,0.000000,0.000000,28632101409.477006,2511689,0,0,2511689
2016-08-08,NYSE Arca (P),215946829,215313308,134684654,565944791,8052857537.723680,10698913263.692347,5169862603.390097,23921633404.806124,1600912,561987,940753,3103652
2016-08-08,NASDAQ (Q),303419072,73380138,389004508,765803718,11870685937.457765,3949122593.397515,16429338377.229967,32249146908.085247,2478681,320648,2397280,5196609
2016-08-08,NASDAQ PSX (X),20768584,12320852,17093266,50182702,624336215.046700,580961242.803000,535493470.724600,1740790928.574300,156339,51335,120040,327714
2016-08-08,BATS BYX (Y),147359331,50754074,57163229,255276634,4074041498.022649,1882373378.357403,1868226810.291489,7824641686.671541,1217002,206342,491869,1915213
2016-08-08,BATS BZX (Z),199441947,70372788,103240646,373055381,6438613279.997624,3646698057.385309,3740521805.316318,13825833142.699251,1575791,303125,816915,2695831
2016-08-05,NYSE MKT (A),0,12349294,2355022,14704316,0.000000,56458015.249200,58383936.621000,114841951.870200,0,27394,9463,36857
2016-08-05,NASDAQ BX (B),98705574,30033315,44243607,172982496,3462638317.417605,1356343685.928399,1789039999.321111,6608022002.667115,888807,123566,413216,1425589
2016-08-05,NSX (C),232080,193872,302970,728922,8801555.890000,14901178.790000,3230671.067900,26933405.747900,1583,793,1256,3632
2016-08-05,NYSE (DN),155276888,52049365,102141411,309467664,5224724510.456933,2093086411.971403,3623039884.389065,10940850806.817401,573457,134726,324218,1032401
2016-08-05,NASDAQ (DQ),1197808069,452441601,785099579,2435349249,38689199328.788026,20725761427.551534,24011273738.224771,83426234494.564331,3867065,873432,2129415,6869912
2016-08-05,EDGA (J),126850422,40254287,47095951,214200660,4254330627.055688,1813980825.711898,1542190388.690897,7610501841.458483,1109711,189453,391576,1690740
2016-08-05,EDGX (K),202454105,93385748,184428836,480268689,6413128614.016528,4339711754.361687,5820216378.672793,16573056747.051008,1316200,339044,1054878,2710122
2016-08-05,CHX (M),12944779,9015046,6798254,28758079,772260135.162500,780169555.123400,490528337.104000,2042958027.389900,3097,3842,1041,7980
2016-08-05,NYSE (N),865601687,0,0,865601687,30999159202.873661,0.000000,0.000000,30999159202.873661,2730533,0,0,2730533
2016-08-05,NYSE Arca (P),252660284,282339200,166589844,701589328,9342186067.069649,14874250867.839067,6508014924.960122,30724451859.868838,1729726,705679,1122603,3558008
2016-08-05,NASDAQ (Q),341036671,96746786,464678290,902461747,13750870205.769276,5676504732.234104,19882713241.384258,39310088179.387638,2767334,399418,2818238,5984990
2016-08-05,NASDAQ PSX (X),23850750,14900853,22928294,61679897,704330134.142398,857806093.400800,633317523.868201,2195453751.411399,173187,64767,140260,378214
2016-08-05,BATS BYX (Y),163672006,60606145,66417226,290695377,4649222853.189098,2272728344.077005,2173984658.923085,9095935856.189188,1358185,239084,572727,2169996
2016-08-05,BATS BZX (Z),230441943,94034020,129478018,453953981,7678288879.935230,5088549425.829600,4970332454.215062,17737170759.979892,1812252,389138,991115,3192505
2016-08-04,NYSE MKT (A),0,9874264,2370629,12244893,0.000000,52060360.434400,48418602.468000,100478962.902400,0,25010,9504,34514
2016-08-04,NASDAQ BX (B),98231420,28996138,45700663,172928221,3343953817.662086,1188841635.871200,1862178450.681410,6394973904.214696,893108,113865,422579,1429552
2016-08-04,NSX (C),181824,176011,313129,670964,5435618.560000,11957378.310000,3267060.682300,20660057.552300,1099,646,1305,3050
2016-08-04,NYSE (DN),149792731,39764654,91364988,280922373,4818151236.458188,1481712087.585498,3130842454.511779,9430705778.555465,551365,102058,300483,953906
2016-08-04,NASDAQ (DQ),1171535133,380918435,729469764,2281923332,34888349227.629986,14443070570.904757,21776168953.623732,71107588752.158475,3722709,795356,2016581,6534646
2016-08-04,EDGA (J),122605281,39028663,43739548,205373492,3886992620.007510,1571356477.107101,1400005492.467590,6858354589.582201,1050447,168748,354886,1574081
2016-08-04,EDGX (K),192367353,80232600,169213755,441813708,5669960405.265924,3549149902.729001,5532626337.460212,14751736645.455137,1289685,306747,1012163,2608595
2016-08-04,CHX (M),9491547,8416006,3282081,21189634,694550264.528400,723031231.304200,222845828.153900,1640427323.986500,2302,3373,670,6345
2016-08-04,NYSE (N),817843025,0,0,817843025,28171435150.282511,0.000000,0.000000,28171435150.282511,2861616,0,0,2861616
2016-08-04,NYSE Arca (P),228910858,241652705,159014156,629577719,8306052765.342928,11811282819.404094,6345459554.484117,26462795139.231139,1704985,640090,1093533,3438608
2016-08-04,NASDAQ (Q),338270521,85580162,420537052,844387735,13012316629.640860,4663156576.713017,17838054490.742788,35513527697.096665,2764900,367989,2752544,5885433
2016-08-04,NASDAQ PSX (X),22039589,13764514,20445917,56250020,645950356.056700,695613523.715003,640317488.588502,1981881368.360205,163139,58897,132169,354205
2016-08-04,BATS BYX (Y),162728636,57992423,68209468,288930527,4362901000.113952,2043339430.034900,2098504742.438095,8504745172.586947,1305637,228281,568499,2102417
2016-08-04,BATS BZX (Z),216960272,85706112,121271972,423938356,6807571443.437491,4255140189.814206,4474301315.321927,15537012948.573624,1700127,356786,936226,2993139
2016-08-03,NYSE MKT (A),0,10940740,3221291,14162031,0.000000,59534670.098600,52127162.984000,111661833.082600,0,26655,10280,36935
2016-08-03,NASDAQ BX (B),104827242,30989773,45174088,180991103,3682102504.462711,1292627328.457203,1866627084.353310,6841356917.273224,955046,131657,429225,1515928
2016-08-03,NSX (C),471029,161946,448363,1081338,14992209.800000,10409983.540000,7441174.394500,32843367.734500,3387,575,1646,5608
2016-08-03,NYSE (DN),155737161,45646233,92438397,293821791,4995364889.644462,1834239576.521596,3155531299.599605,9985135765.765663,554743,116979,295642,967364
2016-08-03,NASDAQ (DQ),1253639968,395590832,742533847,2391764647,38176826315.281959,17028223062.433982,21908916856.075481,77113966233.791422,3835217,853613,2028045,6716875
2016-08-03,EDGA (J),125067332,36858919,42400820,204327071,4158397256.685380,1580113494.008600,1363455147.636469,7101965898.330449,1107614,173529,355155,1636298
2016-08-03,EDGX (K),207534382,89229143,171271622,468035147,6197285551.635329,4097273610.759099,5395554201.232109,15690113363.626537,1392317,340699,994395,2727411
2016-08-03,CHX (M),9578570,11249410,3385815,24213795,626189095.846000,837730511.513200,214364381.770000,1678283989.129200,2626,4019,833,7478
2016-08-03,NYSE (N),897814058,0,0,897814058,31073020810.223353,0.000000,0.000000,31073020810.223353,3021969,0,0,3021969
2016-08-03,NYSE Arca (P),245129201,258004155,164614107,667747463,8856588139.553908,13053132380.834084,6616798086.020124,28526518606.408116,1832186,717628,1136906,3686720
2016-08-03,NASDAQ (Q),361593300,99622457,434594790,895810547,13840534523.499227,5360408981.251731,18853307627.318318,38054251132.069276,2985747,420475,2752824,6159046
2016-08-03,NASDAQ PSX (X),23324195,15683445,19838778,58846418,661547796.467999,772100898.600300,591828380.077101,2025477075.145400,173447,67719,126912,368078
2016-08-03,BATS BYX (Y),173852163,65936535,68761429,308550127,4834660964.569412,2402248384.807096,2193013503.771000,9429922853.147508,1427732,269782,585088,2282602
2016-08-03,BATS BZX (Z),231287894,95234502,122907777,449430173,7313880258.548570,4758828670.745402,4652878859.000339,16725587788.294311,1841114,401927,949374,3192415
2016-08-02,NYSE MKT (A),0,13482876,2842367,16325243,0.000000,69406198.550600,54433067.436000,123839265.986600,0,30408,10258,40666
2016-08-02,NASDAQ BX (B),107889216,37871542,51665270,197426028,3733663479.658317,1710780136.387104,2194217787.210508,7638661403.255929,952589,163661,466787,1583037
2016-08-02,NSX (C),277014,270999,227792,775805,10573745.330000,16659601.200200,9219090.394500,36452436.924700,2088,879,1257,4224
2016-08-02,NYSE (DN),153155093,59818327,110936579,323909999,5237767600.243732,2424053153.947794,4016531627.837427,11678352382.028953,568126,156975,330765,1055866
2016-08-02,NASDAQ (DQ),1206941809,546840574,791950641,2545733024,37159423335.408703,24673307589.853422,24149196255.703159,85981927180.965284,3965393,1031685,2182049,7179127
2016-08-02,EDGA (J),132982205,48149128,51801592,232932925,4511386662.755411,2192531046.159301,1651403705.200379,8355321414.115091,1165061,222583,409984,1797628
2016-08-02,EDGX (K),210596385,115406996,189783148,515786529,6590315932.897827,5886922378.627910,6444248982.593867,18921487294.119604,1489615,435402,1157771,3082788
2016-08-02,CHX (M),9561897,9799952,4404451,23766300,826347587.675000,941837296.179400,337979200.260000,2106164084.114400,3470,5248,1318,10036
2016-08-02,NYSE (N),942716443,0,0,942716443,33653261920.830609,0.000000,0.000000,33653261920.830609,3281401,0,0,3281401
2016-08-02,NYSE Arca (P),250626521,333514958,189498802,773640281,9370707025.530312,17590882675.010180,7765501367.851159,34727091068.391651,1880546,935621,1272442,4088609
2016-08-02,NASDAQ (Q),383179446,132507373,498301777,1013988596,15263088391.944930,7595762603.443601,21734182577.721896,44593033573.110427,3201507,560451,3171082,6933040
2016-08-02,NASDAQ PSX (X),24444342,21261092,24506299,70211733,704545037.678101,1176864110.235401,797455972.174102,2678865120.087604,179870,87008,148391,415269
2016-08-02,BATS BYX (Y),190300365,78800647,82862782,351963794,5372896001.160040,3116688493.390894,2610744834.962803,11100329329.513737,1550548,319059,691817,2561424
2016-08-02,BATS BZX (Z),239477047,125579585,146909854,511966486,7803213531.453128,7009328576.266394,5730183362.360572,20542725470.080094,1922627,518463,1122524,3563614
2016-08-01,NYSE MKT (A),0,12026487,3747352,15773839,0.000000,75172906.305800,84606392.391000,159779298.696800,0,27090,14061,41151
2016-08-01,NASDAQ BX (B),100439571,34480123,48363005,183282699,3703652396.130091,1542488452.486298,2162426164.736194,7408567013.352583,927729,146219,450477,1524425
2016-08-01,NSX (C),297930,209986,140078,647994,14011967.300000,9116981.809600,3660122.806500,26789071.916100,2083,828,690,3601
2016-08-01,NYSE (DN),146885867,52162101,92762046,291810014,5137951455.441908,2163936824.420999,3772884754.752829,11074773034.615736,563834,138186,323290,1025310
2016-08-01,NASDAQ (DQ),1088463367,500146519,671592429,2260202315,35283268937.298956,22595971029.502063,23241490609.211265,81120730576.012284,3704981,916704,2024634,6646319
2016-08-01,EDGA (J),106952919,40789397,46125275,193867591,3600448296.318189,1826787188.835302,1630909609.165007,7058145094.318498,955879,191579,386766,1534224
2016-08-01,EDGX (K),197508899,99072147,172980973,469562019,6251786858.245416,4924534034.374701,6183661746.048232,17359982638.668349,1377993,390292,1056227,2824512
2016-08-01,CHX (M),7307070,10291763,4028143,21626976,459844566.225600,767364494.100000,215873350.598500,1443082410.924100,1517,4517,745,6779
2016-08-01,NYSE (N),854579422,0,0,854579422,31105475915.568010,0.000000,0.000000,31105475915.568010,2957745,0,0,2957745
2016-08-01,NYSE Arca (P),237435447,302352767,167268452,707056666,9109762899.502232,16436322418.878364,7392166360.363750,32938251678.744346,1817657,828220,1195560,3841437
2016-08-01,NASDAQ (Q),355730939,103357389,444125586,903213914,14398979609.114352,6064708799.887693,19974186408.671190,40437874817.673235,3012017,457856,2914606,6384479
2016-08-01,NASDAQ PSX (X),22146844,16289875,18964996,57401715,661856668.654201,910588021.650400,647104545.234300,2219549235.538901,166291,71810,124125,362226
2016-08-01,BATS BYX (Y),166127045,73617356,74267257,314011658,4840387394.934385,2859673763.223193,2511599916.423737,10211661074.581315,1433076,305533,645735,2384344
2016-08-01,BATS BZX (Z),224736662,95426736,124571123,444734521,7740645413.940836,5475239865.074193,5031737790.770412,18247623069.785441,1843067,416744,1002667,3262478
2016-07-29,NYSE MKT (A),0,13773959,2473296,16247255,0.000000,85197791.791900,82558308.885000,167756100.676900,0,28014,10345,38359
2016-07-29,NASDAQ BX (B),100646211,38559268,48195444,187400923,3592740973.285300,1670307887.686904,2163271949.607013,7426320810.579217,906806,155527,426957,1489290
2016-07-29,NSX (C),132747,98700,131540,362987,5011735.050000,9895488.880000,3941153.343200,18848377.273200,525,234,506,1265
2016-07-29,NYSE (DN),150656021,52590222,91042569,294288812,5155289425.014677,2065744957.491905,4144524630.318057,11365559012.824639,548215,133052,322250,1003517
2016-07-29,NASDAQ (DQ),1239935444,460102297,737025509,2437063250,38231621327.713385,20240817813.025908,25928705397.213049,84401144537.952342,3756910,912560,2068518,6737988
2016-07-29,EDGA (J),93599337,44629751,43302344,181531432,2753225456.716202,1958333297.250001,1588387822.301199,6299946576.267402,758203,199575,351663,1309441
2016-07-29,EDGX (K),186737738,98104089,159753816,444595643,5636796116.260535,4790824216.050797,6289848615.291489,16717468947.602821,1214229,359341,970009,2543579
2016-07-29,CHX (M),7646931,11676494,3038689,22362114,333728797.714500,1219591375.562600,275218935.197100,1828539108.474200,421,2732,611,3764
2016-07-29,NYSE (N),1197377901,0,0,1197377901,43137762253.400724,0.000000,0.000000,43137762253.400724,3125480,0,0,3125480
2016-07-29,NYSE Arca (P),252824275,318653982,172112407,743590664,9709917845.990392,17495200897.182278,8367498729.438541,35572617472.611211,1853027,814895,1221377,3889299
2016-07-29,NASDAQ (Q),375588270,109432773,596499072,1081520115,15173984897.750852,6446895823.482214,26084255715.403898,47705136436.636964,2973339,447419,2884338,6305096
2016-07-29,NASDAQ PSX (X),21819724,15814894,18076645,55711263,647797753.340000,873469104.250900,648685267.661900,2169952125.252800,160127,67519,120500,348146
2016-07-29,BATS BYX (Y),174101681,71378265,73137327,318617273,4901090954.389303,2724324694.096203,2592817560.039600,10218233208.525106,1380269,291161,604553,2275983
2016-07-29,BATS BZX (Z),242396760,107351832,129478524,479227116,8076976263.391369,5984172508.493306,5733658525.074680,19794807296.959355,1909913,437623,1041283,3388819
2016-07-28,NYSE MKT (A),0,9398921,2644137,12043058,0.000000,51219476.944800,67630295.452000,118849772.396800,0,22308,11641,33949
2016-07-28,NASDAQ BX (B),97781772,29313459,46723066,173818297,3679976469.640095,1183535622.265702,2066904545.000307,6930416636.906104,884910,120977,419806,1425693
2016-07-28,NSX (C),194400,42921,95032,332353,10827532.600000,3930922.480000,3776106.310400,18534561.390400,1440,123,599,2162
2016-07-28,NYSE (DN),154973436,42329731,102772829,300075996,5405777859.320608,1712451245.599600,4536016024.427057,11654245129.347265,550864,105261,317833,973958
2016-07-28,NASDAQ (DQ),1194784733,383195833,725412811,2303393377,38112140270.022969,16032156329.630096,27029266111.459419,81173562711.112484,3773701,783754,2154488,6711943
2016-07-28,EDGA (J),95034236,35176914,46776941,176988091,2904823949.513306,1465692576.545498,1628828648.963008,5999345175.021812,784890,163875,375947,1324712
2016-07-28,EDGX (K),193672045,80095497,173808185,447575727,5863894672.566019,3639185013.995889,7008114897.931711,16511194584.493619,1244401,303757,1017597,2565755
2016-07-28,CHX (M),14780815,9765045,4668318,29214178,702297247.829000,723306665.180000,587656722.336100,2013260635.345100,354,2696,651,3701
2016-07-28,NYSE (N),875503835,0,0,875503835,30814819650.616855,0.000000,0.000000,30814819650.616855,2928391,0,0,2928391
2016-07-28,NYSE Arca (P),248693731,246212817,185995760,680902308,9780506545.722058,13102365929.105890,9762092264.047789,32644964738.875737,1815146,691464,1316748,3823358
2016-07-28,NASDAQ (Q),374064108,90595706,446294607,910954421,15435910367.226500,4923916453.509199,21528386177.730698,41888212998.466397,2997325,373588,2849020,6219933
2016-07-28,NASDAQ PSX (X),22128335,13065498,18745369,53939202,668494702.546000,686456663.917700,671924962.066203,2026876328.529903,162567,56843,122131,341541
2016-07-28,BATS BYX (Y),166785262,57762430,71797319,296345011,4868689027.687832,2073176738.246701,2508394762.041304,9450260527.975837,1355857,236902,601886,2194645
2016-07-28,BATS BZX (Z),234139445,85105080,130281552,449526077,7925284693.443818,4477141581.162884,5388924639.038924,17791350913.645626,1825628,374596,1015653,3215877
2016-07-27,NYSE MKT (A),0,10583802,4443328,15027130,0.000000,77536493.235700,109947333.240000,187483826.475700,0,23721,19052,42773
2016-07-27,NASDAQ BX (B),104493791,35700828,50575583,190770202,3917603277.501882,1565759711.792705,2243458018.698612,7726821007.993199,949076,145916,452919,1547911
2016-07-27,NSX (C),102722,101187,119622,323531,4342093.110000,8468493.990100,3429800.075600,16240387.175700,644,327,512,1483
2016-07-27,NYSE (DN),157841411,44936804,98620403,301398618,5718687865.677648,1903942501.082300,3908168237.773894,11530798604.533842,563362,118919,329334,1011615
2016-07-27,NASDAQ (DQ),1240530817,493801162,770277817,2504609796,38928930542.781423,22982205889.967439,26414311420.782873,88325447853.531735,3830760,910899,2181391,6923050
2016-07-27,EDGA (J),100997640,45445097,52018681,198461418,3040745220.518307,2045140858.265499,1875797252.486294,6961683331.270100,836841,216466,398134,1451441
2016-07-27,EDGX (K),221296509,105706115,187932190,514934814,6532242884.914989,5060837565.925604,7261985796.897199,18855066247.737792,1412304,399063,1096015,2907382
2016-07-27,CHX (M),8497987,8580660,6513846,23592493,569672951.410000,544915481.180000,603956125.631500,1718544558.221500,1508,3473,896,5877
2016-07-27,NYSE (N),986934658,0,0,986934658,35268800677.581551,0.000000,0.000000,35268800677.581551,3348752,0,0,3348752
2016-07-27,NYSE Arca (P),277906020,326950331,215945183,820801534,10725176318.114667,17335363545.558951,10106155218.439861,38166695082.113479,2024348,913331,1428178,4365857
2016-07-27,NASDAQ (Q),430941915,126846069,497433311,1055221295,17364487787.996755,7070267281.991286,23436798831.808197,47871553901.796238,3449673,531484,3182516,7163673
2016-07-27,NASDAQ PSX (X),27258502,18318685,21409464,66986651,795327542.325199,999688220.181700,800717291.198401,2595733053.705300,186189,75234,136879,398302
2016-07-27,BATS BYX (Y),171984110,71850078,76293903,320128091,4916011070.067048,2733879021.076593,2598315198.872110,10248205290.015751,1386012,296388,611926,2294326
2016-07-27,BATS BZX (Z),262126062,113435086,146468262,522029410,8748112220.521456,6337237603.160811,6033087737.840061,21118437561.522328,2075365,490243,1107278,3672886
2016-07-26,NYSE MKT (A),0,11081730,3117377,14199107,0.000000,62408065.914000,82567445.068000,144975510.982000,0,22233,13325,35558
2016-07-26,NASDAQ BX (B),88838803,32910478,48259437,170008718,3227788463.978099,1437926425.908703,1953061275.144911,6618776165.031713,816473,130664,424500,1371637
2016-07-26,NSX (C),139768,80250,103841,323859,5021672.190000,7085649.737700,4186649.870000,16293971.797700,622,187,643,1452
2016-07-26,NYSE (DN),140876447,36785062,89966878,267628387,5125267808.049931,1596328577.548500,3397026277.333309,10118622662.931740,527004,102722,320114,949840
2016-07-26,NASDAQ (DQ),1116726474,413263823,771513462,2301503759,35818595203.431656,18673063110.429838,23925169841.153332,78416828155.014826,3614709,829021,2101917,6545647
2016-07-26,EDGA (J),85263848,39168670,47643752,172076270,2602016782.128401,1725238051.066398,1653136713.911308,5980391547.106107,730807,175272,379810,1285889
2016-07-26,EDGX (K),193389239,84651017,187466731,465506987,5852566056.220300,4053421604.554201,6129448539.238080,16035436200.012581,1219138,325159,1008679,2552976
2016-07-26,CHX (M),11558027,7257740,6021008,24836775,596515000.456100,573773996.030000,320591341.573400,1490880338.059500,531,2244,737,3512
2016-07-26,NYSE (N),823685288,0,0,823685288,29147342738.519839,0.000000,0.000000,29147342738.519839,2802665,0,0,2802665
2016-07-26,NYSE Arca (P),246117021,265451898,206764412,718333331,9620356523.275966,14632570476.177757,8679675805.128382,32932602804.582105,1764081,739854,1322908,3826843
2016-07-26,NASDAQ (Q),352632692,94645558,449010665,896288915,14191133476.679249,5299708638.481694,19126103503.553699,38616945618.714642,2836961,401080,2787355,6025396
2016-07-26,NASDAQ PSX (X),22265330,15901127,27071972,65238429,667525148.996899,955495985.481399,812867281.900298,2435888416.378596,160290,73773,148114,382177
2016-07-26,BATS BYX (Y),148440762,64038606,74678260,287157628,4281513856.038121,2503844754.482102,2471453798.775630,9256812409.295853,1222816,258175,592759,2073750
2016-07-26,BATS BZX (Z),224504304,88771311,134701139,447976754,7546450712.343703,4945926163.736422,5083996211.495181,17576373087.575306,1781186,388697,1012593,3182476
2016-07-25,NYSE MKT (A),0,12701295,2332961,15034256,0.000000,75560279.641700,47923610.572000,123483890.213700,0,28693,8917,37610
2016-07-25,NASDAQ BX (B),80371720,27474424,39198958,147045102,2824241935.361190,1154539211.015899,1478670167.973196,5457451314.350285,719479,126895,333049,1179423
2016-07-25,NSX (C),181261,69197,127882,378340,9515216.440000,5487808.897000,4812440.592000,19815465.929000,1049,224,892,2165
2016-07-25,NYSE (DN),113480997,35335573,75363712,224180282,4093724256.334411,1443327041.767901,2788112760.976480,8325164059.078792,446028,107965,260231,814224
2016-07-25,NASDAQ (DQ),995221514,376281418,693289620,2064792552,30589266806.782264,15512578511.022758,20207710254.719688,66309555572.524710,3196171,818433,1830906,5845510
2016-07-25,EDGA (J),76694947,32605999,41102223,150403169,2296824486.660199,1403839088.846898,1331875155.503496,5032538731.010593,648810,167659,323536,1140005
2016-07-25,EDGX (K),169356487,76618880,159601690,405577057,5054412904.130716,3473362702.223495,4996092547.860601,13523868154.214812,1058256,296496,857858,2212610
2016-07-25,CHX (M),5185562,7222838,4896601,17305001,294174108.480400,620607291.810000,398254739.407200,1313036139.697600,632,1983,570,3185
2016-07-25,NYSE (N),774716379,0,0,774716379,28075332838.866217,0.000000,0.000000,28075332838.866217,2468262,0,0,2468262
2016-07-25,NYSE Arca (P),204406064,259987108,163218405,627611577,7878365891.726100,12908526541.191377,6069432023.207607,26856324456.125084,1497089,683620,1071050,3251759
2016-07-25,NASDAQ (Q),290631345,80101512,390377862,761110719,11742609251.061470,4207931877.143798,16319429357.179021,32269970485.384289,2376458,354095,2320103,5050656
2016-07-25,NASDAQ PSX (X),18668182,12201571,20378742,51248495,570825337.400001,614418264.307700,570994373.948099,1756237975.655800,140078,54852,110111,305041
2016-07-25,BATS BYX (Y),134638343,52383880,66261585,253283808,3934092969.589395,1913124655.623800,2068176868.794916,7915394494.008111,1122587,227412,540260,1890259
2016-07-25,BATS BZX (Z),195592391,73796812,117530357,386919560,6402086184.720684,3808115358.657998,4084913616.082613,14295115159.461295,1541283,342818,852263,2736364
2016-07-22,NYSE MKT (A),0,10114616,3077682,13192298,0.000000,66230978.149800,85182833.199000,151413811.348800,0,25620,14309,39929
2016-07-22,NASDAQ BX (B),78434878,25103381,38771076,142309335,2907576399.625706,1136387073.357801,1479003172.205585,5522966645.189092,731342,105909,346726,1183977
2016-07-22,NSX (C),103291,63772,159173,326236,3811998.030800,5643270.413200,7366771.090400,16822039.534400,651,219,848,1718
2016-07-22,NYSE (DN),114797293,36364704,71336420,222498417,4433654959.703885,1343162541.581402,2655020055.369987,8431837556.655274,456280,97483,243964,797727
2016-07-22,NASDAQ (DQ),985632651,361594033,617492634,1964719318,32547040281.450108,16091773595.476664,19029673167.422819,67668487044.349591,3281541,730121,1721822,5733484
2016-07-22,EDGA (J),76824161,29433304,38897277,145154742,2417745701.114099,1357421651.721199,1271507812.254696,5046675165.089994,665539,142826,310793,1119158
2016-07-22,EDGX (K),163111995,73020619,145465782,381598396,5262586737.959968,3242309195.588905,4703726886.990670,13208622820.539543,1062497,272689,809805,2144991
2016-07-22,CHX (M),8017418,8959709,4958629,21935756,551436043.608000,603545413.790000,249252064.834900,1404233522.232900,995,2435,694,4124
2016-07-22,NYSE (N),750792696,0,0,750792696,28192400196.584647,0.000000,0.000000,28192400196.584647,2403788,0,0,2403788
2016-07-22,NYSE Arca (P),201246163,209139146,148053779,558439088,8155897182.994787,11637468049.610057,5854853019.061353,25648218251.666197,1502661,590969,989368,3082998
2016-07-22,NASDAQ (Q),300351926,77432101,376893944,754677971,12631995060.129924,4608378318.473603,16241657651.295392,33482031029.898919,2471199,319036,2174681,4964916
2016-07-22,NASDAQ PSX (X),18435179,12126725,17576689,48138593,607410502.115001,727721858.621500,568221755.374900,1903354116.111401,144909,53324,110431,308664
2016-07-22,BATS BYX (Y),133479532,50793968,61590007,245863507,3926556755.031216,1975098225.058194,1973038450.641594,7874693430.731004,1132569,218139,503422,1854130
2016-07-22,BATS BZX (Z),193324055,75020211,115332971,383677237,6801217322.853407,4053020978.278492,4242708841.433821,15096947142.565720,1574163,328215,843430,2745808
2016-07-21,NYSE MKT (A),0,9708078,2977491,12685569,0.000000,54127294.927000,72235464.733000,126362759.660000,0,24199,12662,36861
2016-07-21,NASDAQ BX (B),89136026,29917885,44602918,163656829,3279563010.495903,1257594242.150399,1787269598.110009,6324426850.756311,812588,128278,388454,1329320
2016-07-21,NSX (C),193066,79384,224720,497170,5883666.620000,7879253.420000,8242518.300200,22005438.340200,732,205,1070,2007
2016-07-21,NYSE (DN),135921819,44523385,87386995,267832199,5226788196.795116,1719680875.590996,3103401889.345110,10049870961.731222,517045,112834,305709,935588
2016-07-21,NASDAQ (DQ),1137095752,468461914,708128566,2313686232,37204467605.490149,20890168809.511572,22685538532.023802,80780174947.025523,3602341,838824,1992636,6433801
2016-07-21,EDGA (J),84086324,37362456,44655015,166103795,2613133991.443196,1582127516.913802,1541109458.475413,5736370966.832411,717328,177796,352742,1247866
2016-07-21,EDGX (K),182193855,90673723,169527586,442395164,5713375984.384899,3961394192.347502,5682696670.081074,15357466846.813475,1197707,330714,950496,2478917
2016-07-21,CHX (M),10846384,7565945,5525022,23937351,690571349.929800,660715716.528800,445868760.352000,1797155826.810600,451,2597,641,3689
2016-07-21,NYSE (N),822049813,0,0,822049813,29541542996.333290,0.000000,0.000000,29541542996.333290,2676318,0,0,2676318
2016-07-21,NYSE Arca (P),244092701,275379506,182556763,702028970,9655299896.048562,13609238990.334960,7551330173.190723,30815869059.574245,1743373,725491,1196227,3665091
2016-07-21,NASDAQ (Q),331664387,93390339,409230520,834285246,13849060261.654142,4947671179.358299,17199200534.381932,35995931975.394373,2689401,377746,2518275,5585422
2016-07-21,NASDAQ PSX (X),22005200,15183497,21437796,58626493,674305553.397601,759950972.105000,712419292.831599,2146675818.334200,160655,63287,133040,356982
2016-07-21,BATS BYX (Y),150161393,62665300,73337021,286163714,4400686264.708901,2261074316.955108,2465745437.082212,9127506018.746221,1247557,260121,593200,2100878
2016-07-21,BATS BZX (Z),232194117,91381476,133977899,457553492,7820119717.424519,4493948213.999693,5071333592.673043,17385401524.097255,1826121,388515,1027297,3241933
2016-07-20,NYSE MKT (A),0,10778910,3110492,13889402,0.000000,55774445.735200,75970315.348000,131744761.083200,0,25175,14333,39508
2016-07-20,NASDAQ BX (B),83531707,29852385,45282534,158666626,3162112027.863507,1207461704.242100,1865088446.821591,6234662178.927198,775173,126091,404711,1305975
2016-07-20,NSX (C),226645,117640,276397,620682,7581174.423200,9980843.407300,7908665.994500,25470683.825000,993,402,1430,2825
2016-07-20,NYSE (DN),130420589,44899288,94328517,269648394,4837326942.758090,1684123793.204898,3504400069.703921,10025850805.666909,496904,125022,302801,924727
2016-07-20,NASDAQ (DQ),1119884240,446865975,730530250,2297280465,35498610350.912975,18679567681.291615,23744005572.754793,77922183604.959383,3442560,883625,1983505,6309690
2016-07-20,EDGA (J),77194335,36620515,42812788,156627638,2379465877.517888,1443586826.795500,1478413177.776187,5301465882.089575,659410,170249,351270,1180929
2016-07-20,EDGX (K),169858006,85252827,163006173,418117006,5246109750.982814,3538813654.227394,5490592914.003301,14275516319.213509,1065577,308677,919973,2294227
2016-07-20,CHX (M),8645749,13254300,9744219,31644268,589273919.355000,1153370245.447200,568451943.449000,2311096108.251200,374,3123,764,4261
2016-07-20,NYSE (N),749733780,0,0,749733780,26150312110.264908,0.000000,0.000000,26150312110.264908,2392862,0,0,2392862
2016-07-20,NYSE Arca (P),212327597,283654405,173825882,669807884,8183484070.555034,13572761259.042063,7076988476.702021,28833233806.299118,1508892,661684,1141049,3311625
2016-07-20,NASDAQ (Q),301666985,87135363,398198195,787000543,12260426382.189648,4448551090.412703,17011902167.411813,33720879640.014164,2410232,353041,2394493,5157766
2016-07-20,NASDAQ PSX (X),20617946,14509695,20605803,55733444,636567484.255000,735456429.732401,696113105.591802,2068137019.579203,150769,59880,132964,343613
2016-07-20,BATS BYX (Y),133026800,59111888,66931813,259070501,3797521051.850965,2024867971.418400,2203880449.450803,8026269472.720168,1088425,232954,544981,1866360
2016-07-20,BATS BZX (Z),208570692,86019874,133988589,428579155,6979866187.491314,4104528959.432893,4808523132.625353,15892918279.549560,1639777,363551,977040,2980368
2016-07-19,NYSE MKT (A),0,8977097,4389728,13366825,0.000000,61724850.108200,71411529.964000,133136380.072200,0,20576,15204,35780
2016-07-19,NASDAQ BX (B),76097443,27216944,38682936,141997323,2796168323.290501,1147686388.875500,1510521658.823093,5454376370.989094,727155,105539,341205,1173899
2016-07-19,NSX (C),117233,92022,280320,489575,5057979.615000,6451726.008700,4823416.526400,16333122.150100,698,288,1390,2376
2016-07-19,NYSE (DN),114814118,35084164,72841893,222740175,4310748731.537294,1354998772.590501,2641728446.589697,8307475950.717492,427809,101369,249453,778631
2016-07-19,NASDAQ (DQ),978669619,360216991,648784630,1987671240,31775606768.125347,16256355421.517437,21359853590.078451,69391815779.721235,3199018,716586,1782396,5698000
2016-07-19,EDGA (J),68583611,31485161,37914073,137982845,2133897182.416201,1344932953.367101,1277101515.358197,4755931651.141499,595703,147110,299851,1042664
2016-07-19,EDGX (K),156867105,76547525,151279629,384694259,5181111839.101481,3352112622.970297,4997978775.275456,13531203237.347234,1025361,273814,841529,2140704
2016-07-19,CHX (M),11726235,10660032,11625036,34011303,877475426.993800,953100928.600000,518854020.274500,2349430375.868300,351,2011,792,3154
2016-07-19,NYSE (N),754946105,0,0,754946105,28048518468.080909,0.000000,0.000000,28048518468.080909,2428432,0,0,2428432
2016-07-19,NYSE Arca (P),192237055,216187274,155824566,564248895,7778598186.016485,11359736723.429899,6546839982.705833,25685174892.152217,1404594,591375,1043367,3039336
2016-07-19,NASDAQ (Q),283820580,74606002,382354507,740781089,12425561330.949804,3937938346.852297,16514561576.681208,32878061254.483309,2385796,310812,2226714,4923322
2016-07-19,NASDAQ PSX (X),19578401,12758720,19117902,51455023,620959818.480000,681717257.645000,612727912.573798,1915404988.698798,143862,51576,115272,310710
2016-07-19,BATS BYX (Y),127662766,54707168,61496378,243866312,3733543849.722911,1974008100.252601,2023891863.347908,7731443813.323420,1085495,219781,505679,1810955
2016-07-19,BATS BZX (Z),185354033,75008025,113379088,373741146,6439134767.305181,3776826292.310904,4160974116.182998,14376935175.799083,1545053,321496,857580,2724129
2016-07-18,NYSE MKT (A),0,10031182,2795812,12826994,0.000000,62903787.115300,64971191.296000,127874978.411300,0,21767,12188,33955
2016-07-18,NASDAQ BX (B),73570132,27633069,36862417,138065618,2653276518.933502,1160004906.759501,1470855532.990198,5284136958.683201,677147,104215,330366,1111728
2016-07-18,NSX (C),119681,120551,245881,486113,5235532.623400,3358321.128600,7814940.046800,16408793.798800,800,344,1228,2372
2016-07-18,NYSE (DN),121189226,37206084,74107357,232502667,4079201904.729416,1378133069.817600,2696716550.165996,8154051524.713012,438545,105222,244815,788582
2016-07-18,NASDAQ (DQ),1001236405,393604742,595643975,1990485122,30818265206.507889,18291905584.492208,19836774624.206253,68946945415.206350,3233065,783318,1708394,5724777
2016-07-18,EDGA (J),70198487,34033203,37076328,141308018,2126582336.508314,1456289255.896900,1207826113.200901,4790697705.606115,616852,154605,309849,1081306
2016-07-18,EDGX (K),168571412,77663706,141151210,387386328,5121129897.953621,3416647265.901608,5007436900.074462,13545214063.929691,1022003,282306,809537,2113846
2016-07-18,CHX (M),12983313,9285931,8196133,30465377,706131821.156000,677080826.019400,511644503.822900,1894857150.998300,325,2338,660,3323
2016-07-18,NYSE (N),740765889,0,0,740765889,26207510713.661905,0.000000,0.000000,26207510713.661905,2365716,0,0,2365716
2016-07-18,NYSE Arca (P),193642750,244182540,150436965,588262255,7193178194.852026,12163667393.977698,6658018662.767193,26014864251.596917,1362441,593447,1028523,2984411
2016-07-18,NASDAQ (Q),285817961,76685916,350126979,712630856,11573972625.085923,4122307489.292201,15176607007.381115,30872887121.759239,2331151,310607,2220586,4862344
2016-07-18,NASDAQ PSX (X),19794088,12651362,17808472,50253922,629790219.687300,686236499.228000,570865842.179500,1886892561.094800,146722,51339,113332,311393
2016-07-18,BATS BYX (Y),133317537,58508705,61351389,253177631,3830849885.758466,2093340032.551706,1983493336.379533,7907683254.689705,1162365,221967,539950,1924282
2016-07-18,BATS BZX (Z),190267446,76664057,113207866,380139369,6334033977.345572,3822146993.534899,4078944571.923266,14235125542.803737,1537535,311879,859698,2709112
2016-07-15,NYSE MKT (A),0,9649050,3010116,12659166,0.000000,56944796.312600,69190666.620000,126135462.932600,0,21275,11575,32850
2016-07-15,NASDAQ BX (B),77061439,32823042,35894315,145778796,2879071722.453080,1446936350.721600,1478503508.846406,5804511582.021086,715758,121647,324190,1161595
2016-07-15,NSX (C),126034,76271,163563,365868,5367032.790000,7413772.180000,2522141.799600,15302946.769600,514,165,693,1372
2016-07-15,NYSE (DN),113038921,47222135,72834001,233095057,4246555301.899200,1764946806.668904,2326588177.498797,8338090286.066901,463565,124780,245086,833431
2016-07-15,NASDAQ (DQ),961891752,536136138,571812208,2069840098,31643699447.977577,26768330233.705889,17195145888.578986,75607175570.262452,3327599,844973,1689441,5862013
2016-07-15,EDGA (J),73484623,39534786,36076984,149096393,2442417076.498202,1787844196.791903,1229051324.240800,5459312597.530905,658584,174227,299849,1132660
2016-07-15,EDGX (K),159210478,100370094,131777855,391358427,5365379951.615793,4721454309.778320,4245065357.541656,14331899618.935769,1057901,353043,758481,2169425
2016-07-15,CHX (M),10315531,21638552,5720970,37675053,912080041.412500,2053795007.918800,459362375.623500,3425237424.954800,303,2681,522,3506
2016-07-15,NYSE (N),874178555,0,0,874178555,35611654761.293031,0.000000,0.000000,35611654761.293031,2567649,0,0,2567649
2016-07-15,NYSE Arca (P),207735597,301184876,144152945,653073418,8303286702.631861,16216041553.815125,5917844806.488901,30437173062.935887,1496851,754239,1005998,3257088
2016-07-15,NASDAQ (Q),297050030,103473771,419349742,819873543,12671684963.480878,6162524631.618106,19170071226.968984,38004280822.067968,2512732,400785,2290633,5204150
2016-07-15,NASDAQ PSX (X),20076645,16668699,18386821,55132165,636574687.294400,1015199460.201500,641543788.329598,2293317935.825498,142896,63625,121110,327631
2016-07-15,BATS BYX (Y),136782404,67028690,62436344,266247438,4143437353.084828,2568710071.702397,2036408837.646210,8748556262.433435,1178443,264744,521730,1964917
2016-07-15,BATS BZX (Z),195197799,105421591,114274120,414893510,6907867741.599063,5659689182.685585,4048603048.146880,16616159972.431528,1628123,402697,863231,2894051
2016-07-14,NYSE MKT (A),0,11567553,5018961,16586514,0.000000,57505171.920400,105193413.073000,162698584.993400,0,26109,16277,42386
2016-07-14,NASDAQ BX (B),82573571,36976945,37461112,157011628,2993034288.596507,1587671745.468101,1546800619.277793,6127506653.342401,755716,135336,349232,1240284
2016-07-14,NSX (C),200156,133406,240895,574457,11007466.618800,8411126.556300,6196768.419400,25615361.594500,1068,338,1550,2956
2016-07-14,NYSE (DN),139894066,50697067,82957071,273548204,5124297535.841016,2025610012.551908,2728320302.615587,9878227851.008511,535644,131293,272562,939499
2016-07-14,NASDAQ (DQ),1182349544,501334210,606037067,2289720821,37432009147.179743,22786616159.344199,19251786879.683604,79470412186.207546,3713004,937800,1787967,6438771
2016-07-14,EDGA (J),80951144,45061331,37313680,163326155,2591420126.020885,1898159830.776797,1210802617.581501,5700382574.379183,716516,194867,308645,1220028
2016-07-14,EDGX (K),180900879,104278105,138309412,423488396,5738619246.588998,5086196697.389799,4620211394.345611,15445027338.324408,1153047,372756,821842,2347645
2016-07-14,CHX (M),10773030,8306038,4809337,23888405,785044492.033200,618753998.846000,304924023.532600,1708722514.411800,335,3422,589,4346
2016-07-14,NYSE (N),838099832,0,0,838099832,30650432322.479992,0.000000,0.000000,30650432322.479992,2802066,0,0,2802066
2016-07-14,NYSE Arca (P),231739635,325898777,154871617,712510029,9008576949.184120,17521784277.598253,6221266725.821905,32751627952.604278,1662655,820375,1074461,3557491
2016-07-14,NASDAQ (Q),326385798,109066363,371292930,806745091,13266421296.109326,6688660302.937120,15572841266.179477,35527922865.225923,2686780,432032,2391341,5510153
2016-07-14,NASDAQ PSX (X),22076631,18233845,19897097,60207573,721145917.527501,1045442801.551600,681694568.153199,2448283287.232300,162988,69932,133836,366756
2016-07-14,BATS BYX (Y),153777119,72709743,63598544,290085406,4559521571.701354,2648413489.197395,2091851567.889638,9299786628.788387,1306711,284499,557805,2149015
2016-07-14,BATS BZX (Z),218395709,108449506,121562962,448408177,7503893489.259328,5948508803.477374,4289523792.468707,17741926085.205409,1791693,427478,927274,3146445
2016-07-13,NYSE MKT (A),0,12037108,5323474,17360582,0.000000,64377909.536100,97214433.265000,161592342.801100,0,29459,17784,47243
2016-07-13,NASDAQ BX (B),84440116,34412393,38254097,157106606,3005936234.909596,1484699368.525500,1549414620.041297,6040050223.476393,759322,137851,342178,1239351
2016-07-13,NSX (C),163923,140385,194612,498920,9583037.786400,8077541.930000,5572817.011600,23233396.728000,810,527,997,2334
2016-07-13,NYSE (DN),135136854,50361899,84236168,269734921,4628453794.265085,1822210121.788799,2717314819.433991,9167978735.487875,517314,120465,261624,899403
2016-07-13,NASDAQ (DQ),1161442062,499875637,580383598,2241701297,34304152400.731004,23166715632.791507,18141447820.597054,75612315854.119565,3601352,937249,1784399,6323000
2016-07-13,EDGA (J),84799231,41259319,39435799,165494349,2536632227.576497,1807948665.894294,1276002264.328315,5620583157.799106,729618,196916,323724,1250258
2016-07-13,EDGX (K),195167300,106288832,138031603,439487735,5929425824.147916,5080493476.367305,4594715806.040492,15604635106.555713,1244444,381908,826348,2452700
2016-07-13,CHX (M),13389388,16127630,3665747,33182765,900101576.951500,1154088372.845000,199047134.172000,2253237083.968500,470,3155,564,4189
2016-07-13,NYSE (N),836857685,0,0,836857685,29554610767.183986,0.000000,0.000000,29554610767.183986,2817516,0,0,2817516
2016-07-13,NYSE Arca (P),241400103,312667276,153370176,707437555,8744860759.131671,15650350432.608052,6182073639.283097,30577284831.022820,1713741,838286,1092360,3644387
2016-07-13,NASDAQ (Q),346730823,108407679,395936311,851074813,13465001347.353902,6427297156.651581,16834202232.924629,36726500736.930112,2819514,437109,2502463,5759086
2016-07-13,NASDAQ PSX (X),24014521,18220536,20436822,62671879,733425115.284000,1020727523.020601,691462327.581801,2445614965.886402,172799,72935,133922,379656
2016-07-13,BATS BYX (Y),155368662,70491399,67457438,293317499,4409480832.665196,2618033854.419600,2158108978.075485,9185623665.160281,1288562,292693,573126,2154381
2016-07-13,BATS BZX (Z),229681599,111299522,127929812,468910933,7414941839.679630,6058111644.084706,4366403645.992281,17839457129.756617,1834229,449902,949649,3233780
2016-07-12,NYSE MKT (A),0,13760361,4890031,18650392,0.000000,72706512.387100,84865261.139000,157571773.526100,0,29167,14870,44037
2016-07-12,NASDAQ BX (B),96993211,43457130,43371302,183821643,3400790023.398307,1862154681.627397,1757846360.352290,7020791065.377994,900730,173227,399001,1472958
2016-07-12,NSX (C),206144,191743,259329,657216,9776687.550000,12697315.170000,7785978.247300,30259980.967300,1029,413,1476,2918
2016-07-12,NYSE (DN),153344340,56317963,89027902,298690205,5266218176.220990,2354441680.432907,3136164017.300396,10756823873.954293,592150,150741,293210,1036101
2016-07-12,NASDAQ (DQ),1364982990,653483735,682146191,2700612916,39762516010.020592,32587231711.606074,21827145976.178858,94176893697.805524,3993033,1138472,1979335,7110840
2016-07-12,EDGA (J),101701183,53969526,45875535,201546244,3091031038.779674,2416977264.343999,1513840542.481602,7021848845.605275,900455,248765,381082,1530302
2016-07-12,EDGX (K),231245987,123322876,158379563,512948426,6674095692.530564,6050678098.214504,5352318578.280582,18077092369.025650,1437883,441158,946041,2825082
2016-07-12,CHX (M),13712863,13606629,3931157,31250649,881516375.783000,1116973361.727200,340485209.397500,2338974946.907700,319,3524,685,4528
2016-07-12,NYSE (N),980458542,0,0,980458542,34693176329.745013,0.000000,0.000000,34693176329.745013,3297065,0,0,3297065
2016-07-12,NYSE Arca (P),272084107,368995933,171493777,812573817,9797159044.521758,18983742818.378296,6993557987.926583,35774459850.826637,1946285,942531,1232566,4121382
2016-07-12,NASDAQ (Q),408825310,123943722,440906938,973675970,15827053705.067121,7337631182.353886,18917247125.168522,42081932012.589529,3313554,494180,2832273,6640007
2016-07-12,NASDAQ PSX (X),27867718,21812078,23150218,72830014,813353520.326002,1182628147.572500,775190892.869498,2771172560.768000,201571,82712,150514,434797
2016-07-12,BATS BYX (Y),183432157,86913444,74579406,344925007,5133730165.350927,3448543682.317312,2514824618.415036,11097098466.083275,1551510,354055,644193,2549758
2016-07-12,BATS BZX (Z),272611078,126412831,131329946,530353855,8880814805.409210,7283715541.652105,4898526349.705114,21063056696.766429,2200209,507817,1061632,3769658
2016-07-11,NYSE MKT (A),0,14799426,4946741,19746167,0.000000,74369663.783800,86289198.356000,160658862.139800,0,27720,13718,41438
2016-07-11,NASDAQ BX (B),79492631,33338982,40564962,153396575,2778199312.839702,1409294753.205497,1552956180.907608,5740450246.952807,712562,130637,358737,1201936
2016-07-11,NSX (C),200260,132835,285509,618604,9640189.155900,10777903.650000,3763570.620300,24181663.426200,1012,349,1019,2380
2016-07-11,NYSE (DN),124434237,47686354,76428645,248549236,4429943425.225312,1842047995.451602,2660508199.828873,8932499620.505787,491250,114187,256025,861462
2016-07-11,NASDAQ (DQ),1068243521,479620638,633638925,2181503084,32930531900.743754,21299674519.147038,19769494211.021748,73999700630.912540,3425493,946131,1837787,6209411
2016-07-11,EDGA (J),80128968,41360676,41896467,163386111,2463733111.542413,1809044566.891006,1337798306.591104,5610575985.024523,708283,192728,340289,1241300
2016-07-11,EDGX (K),177889579,97488944,146403470,421781993,5372546310.733615,4575773538.851092,4792824941.125026,14741144790.709733,1132008,349916,836810,2318734
2016-07-11,CHX (M),12137120,11199997,4892238,28229355,1268848140.575000,769314181.390000,256175831.694000,2294338153.659000,504,2620,1005,4129
2016-07-11,NYSE (N),810899876,0,0,810899876,29314915338.462678,0.000000,0.000000,29314915338.462678,2728437,0,0,2728437
2016-07-11,NYSE Arca (P),211035363,297575275,159977273,668587911,7948637585.521309,15132367709.586785,6190174180.261289,29271179475.369383,1559141,756611,1076154,3391906
2016-07-11,NASDAQ (Q),320695069,107634267,409454172,837783508,12918067040.443723,6236117115.525299,17261018131.946675,36415202287.915697,2661148,418468,2526680,5606296
2016-07-11,NASDAQ PSX (X),21997372,18482640,21475752,61955764,680300458.855099,1018926573.845201,714181616.582300,2413408649.282600,160105,69299,135411,364815
2016-07-11,BATS BYX (Y),146420488,69563565,68720323,284704376,4185039206.083374,2572552195.533101,2194378236.778596,8951969638.395071,1258143,272943,580199,2111285
2016-07-11,BATS BZX (Z),208081401,98912929,114103889,421098219,6935792869.479902,5450280894.497205,4171707940.452663,16557781704.429770,1696363,399688,904845,3000896
2016-07-08,NYSE MKT (A),0,13323715,3465539,16789254,0.000000,68954566.998500,87381719.851000,156336286.849500,0,30102,13663,43765
2016-07-08,NASDAQ BX (B),88046656,38675828,43962987,170685471,3133296846.785885,1746317335.207602,1649258691.177488,6528872873.170975,795053,154986,372047,1322086
2016-07-08,NSX (C),401504,149972,459806,1011282,19580036.500000,13788374.195600,4511810.208600,37880220.904200,1772,274,1045,3091
2016-07-08,NYSE (DN),137117194,57990294,80707458,275814946,5046063606.428693,2357792677.878703,2903402038.084066,10307258322.391462,544430,157546,293888,995864
2016-07-08,NASDAQ (DQ),1138507257,584503205,722957275,2445967737,35248679558.043258,28533595402.262966,21749752468.572968,85532027428.879192,3613509,1064820,1983313,6661642
2016-07-08,EDGA (J),87989094,50028091,46298806,184315991,2704218981.411583,2265073001.432500,1454794654.065191,6424086636.909274,766053,228324,362783,1357160
2016-07-08,EDGX (K),195164614,122322159,160575772,478062545,5981216209.052818,6162925171.731519,5274942758.324481,17419084139.108818,1272015,446873,914154,2633042
2016-07-08,CHX (M),5319884,9958840,5765198,21043922,296070068.705600,919607640.407600,306448834.658000,1522126543.771200,643,4423,1016,6082
2016-07-08,NYSE (N),931580410,0,0,931580410,33193171953.535180,0.000000,0.000000,33193171953.535180,3074668,0,0,3074668
2016-07-08,NYSE Arca (P),231621647,365441012,187855404,784918063,8757478931.193592,19444323433.576410,6913116476.706954,35114918841.476956,1736359,944297,1171753,3852409
2016-07-08,NASDAQ (Q),372880330,131924188,460559379,965363897,14874278369.529884,8497516332.455023,19030649858.438768,42402444560.423675,3078336,525389,2741717,6345442
2016-07-08,NASDAQ PSX (X),23384390,21052949,27243804,71681143,734709507.130001,1370669392.770200,842034649.566099,2947413549.466300,176497,84458,149378,410333
2016-07-08,BATS BYX (Y),161108696,80404425,74932286,316445407,4699935139.869121,3167411952.739694,2356331590.072915,10223678682.681730,1363403,327688,613363,2304454
2016-07-08,BATS BZX (Z),235523321,121883283,133535018,490941622,8004321680.180833,7212911912.478787,4860682541.862821,20077916134.522441,1928312,506433,992761,3427506
2016-07-07,NYSE MKT (A),0,13460425,3743511,17203936,0.000000,63672552.571600,80365019.135000,144037571.706600,0,29735,14185,43920
2016-07-07,NASDAQ BX (B),82739427,39568895,39282362,161590684,2831844742.265781,1525080442.140200,1391782352.146308,5748707536.552289,756849,156040,344688,1257577
2016-07-07,NSX (C),251767,135064,279170,666001,11943009.250000,12918187.590000,6272258.823800,31133455.663800,1954,367,1252,3573
2016-07-07,NYSE (DN),133564136,45152186,78240638,256956960,4891661558.687121,1824646286.523897,2475212612.746014,9191520457.957032,511225,122393,242588,876206
2016-07-07,NASDAQ (DQ),1146555880,522678720,612161094,2281395694,34532764331.651467,21780575373.013760,18070852690.903034,74384192395.568261,3512522,1053600,1695364,6261486
2016-07-07,EDGA (J),83806538,52512754,40812651,177131943,2538097413.706997,2009754486.168898,1202203436.529806,5750055336.405701,729007,229772,318200,1276979
2016-07-07,EDGX (K),196409655,114167299,144505045,455081999,5769766576.047043,5041903804.150996,4391506390.050488,15203176770.248527,1285692,432999,828463,2547154
2016-07-07,CHX (M),8347272,11295977,2563950,22207199,304846578.445700,656643041.210000,193410267.040100,1154899886.695800,476,4218,743,5437
2016-07-07,NYSE (N),878409561,0,0,878409561,30661394359.071765,0.000000,0.000000,30661394359.071765,3157068,0,0,3157068
2016-07-07,NYSE Arca (P),302308967,354842082,179643665,836794714,11434987103.016371,16523901189.481554,6821673464.250039,34780561756.747964,2252586,999207,1300492,4552285
2016-07-07,NASDAQ (Q),379934440,126330575,380881953,887146968,15018051534.512724,6988903927.440992,15920449261.505569,37927404723.459285,3222621,529264,2586997,6338882
2016-07-07,NASDAQ PSX (X),24152954,21330293,21921285,67404532,694011795.045002,1114347824.844999,649747311.284601,2458106931.174602,172127,82303,128519,382949
2016-07-07,BATS BYX (Y),153054950,78094406,63254814,294404170,4251551198.319483,2710195739.151888,1871821744.451801,8833568681.923172,1286284,325749,532763,2144796
2016-07-07,BATS BZX (Z),224403430,117296471,110521627,452221528,7269800967.959398,6141862095.863575,4018378064.012746,17430041127.835719,1832911,504066,882680,3219657
2016-07-06,NYSE MKT (A),0,15922214,3658417,19580631,0.000000,76752067.062500,69989664.610000,146741731.672500,0,35992,13939,49931
2016-07-06,NASDAQ BX (B),102115498,45402425,49046623,196564546,3691037320.590002,1908347215.961004,1919291154.894807,7518675691.445813,948249,190993,434108,1573350
2016-07-06,NSX (C),257317,176921,240509,674747,13280952.302500,16910127.470700,5100822.613400,35291902.386600,2027,462,1185,3674
2016-07-06,NYSE (DN),141548724,57158564,88169836,286877124,5344229302.853195,2186313891.320097,2968599642.333305,10499142836.506597,593090,170927,300578,1064595
2016-07-06,NASDAQ (DQ),1224430947,584172712,661760174,2470363833,37968411785.293673,23569147517.271173,20377990238.913664,81915549541.478510,3754773,1110063,1873368,6738204
2016-07-06,EDGA (J),95150788,52658032,47121035,194929855,2882891883.639194,2275840599.739902,1534733766.584203,6693466249.963299,820391,253116,376116,1449623
2016-07-06,EDGX (K),201701054,133342931,152818880,487862865,5993354009.176306,6315628931.893776,5150401970.676636,17459384911.746718,1339912,512993,927470,2780375
2016-07-06,CHX (M),7344149,7772493,8000441,23117083,312076717.319200,682858585.610000,453777743.863800,1448713046.793000,1122,4230,1220,6572
2016-07-06,NYSE (N),1050899148,0,0,1050899148,36781465818.019983,0.000000,0.000000,36781465818.019983,3325188,0,0,3325188
2016-07-06,NYSE Arca (P),255291384,406587215,169749591,831628190,9570914573.280555,20138149887.547285,7113265538.414541,36822329999.242381,1953081,1117275,1251634,4321990
2016-07-06,NASDAQ (Q),395798817,141331474,467611484,1004741775,16159323852.725415,8344234327.475131,19854063310.273422,44357621490.473968,3418673,602873,2897222,6918768
2016-07-06,NASDAQ PSX (X),24502767,22798695,24133320,71434782,787103800.801000,1231699007.806199,838848992.916898,2857651801.524097,186685,93928,159011,439624
2016-07-06,BATS BYX (Y),172459836,86007489,74879078,333346403,4848392195.721747,3193643066.008898,2373698954.657203,10415734216.387848,1447255,379021,623515,2449791
2016-07-06,BATS BZX (Z),241161889,135141531,130138075,506441495,7985575216.604666,7182282897.682880,4905463740.261075,20073321854.548621,1977982,588813,1017655,3584450
2016-07-05,NYSE MKT (A),0,15482002,3521965,19003967,0.000000,82132704.911100,71769002.916000,153901707.827100,0,33271,13237,46508
2016-07-05,NASDAQ BX (B),91231172,40825988,42847069,174904229,3302801825.898802,1757438512.267701,1671726821.562016,6731967159.728519,849543,169315,383089,1401947
2016-07-05,NSX (C),166052,230818,228924,625794,9187279.740000,18980150.422500,3580091.163700,31747521.326200,1144,616,1061,2821
2016-07-05,NYSE (DN),131384765,60409343,69522774,261316882,4610783199.008900,2283823247.420001,2420841523.999205,9315447970.428106,551489,156614,253962,962065
2016-07-05,NASDAQ (DQ),1118499372,545341971,590963960,2254805303,32729747376.147783,25618047811.456993,17988364155.974962,76336159343.579738,3711757,1104816,1807557,6624130
2016-07-05,EDGA (J),94452875,51162461,43183588,188798924,2816643631.033198,2223803757.638299,1372676173.089395,6413123561.760892,804945,250463,349883,1405291
2016-07-05,EDGX (K),207596200,121715944,143077180,472389324,6097587323.756958,5666444003.697820,4689219611.075014,16453250938.529792,1357332,471352,884748,2713432
2016-07-05,CHX (M),4912137,9494688,2351057,16757882,186418645.008000,725841562.960800,167838251.127800,1080098459.096600,418,5635,978,7031
2016-07-05,NYSE (N),982272889,0,0,982272889,35583459030.772353,0.000000,0.000000,35583459030.772353,3201831,0,0,3201831
2016-07-05,NYSE Arca (P),240074490,375329078,155413562,770817130,8704663223.267339,19137627212.633495,5929484908.004541,33771775343.905375,1785972,1010490,1131873,3928335
2016-07-05,NASDAQ (Q),379855503,129231457,435184194,944271154,15233246719.869234,7878224829.456686,18218412054.833367,41329883604.159287,3280118,547794,2737551,6565463
2016-07-05,NASDAQ PSX (X),23913001,21462881,22084916,67460798,744680041.183199,1190855510.725100,763841732.096800,2699377284.005099,184619,85700,147371,417690
2016-07-05,BATS BYX (Y),163264987,78177706,69249056,310691749,4593262278.300104,2976675571.187198,2212920680.348082,9782858529.835384,1381202,346959,585478,2313639
2016-07-05,BATS BZX (Z),226991472,122587202,115408663,464987337,7294588706.772450,6662126953.337292,4126857724.181201,18083573384.290943,1862709,541178,930319,3334206
2016-07-01,NYSE MKT (A),0,13921534,2732684,16654218,0.000000,83669004.397500,57200510.471000,140869514.868500,0,29868,11023,40891
2016-07-01,NASDAQ BX (B),92061569,43998465,44162437,180222471,3463266390.315591,1873447110.040198,1657192892.256307,6993906392.612096,856495,167150,389937,1413582
2016-07-01,NSX (C),319693,184114,345245,849052,15351062.639600,15175120.967000,7325378.627000,37851562.233600,2133,633,1526,4292
2016-07-01,NYSE (DN),129779031,50932453,76773867,257485351,4752309745.939517,2057295105.751103,2482399867.395009,9292004719.085629,530792,138440,259483,928715
2016-07-01,NASDAQ (DQ),1099352237,588220376,645210434,2332783047,33322518199.411638,26334649907.745172,18665848318.649515,78323016425.806325,3604670,1075305,1824704,6504679
2016-07-01,EDGA (J),84969245,48827200,43500954,177297399,2709111164.164002,2151662676.389403,1377013810.284298,6237787650.837703,756883,228569,350905,1336357
2016-07-01,EDGX (K),199068573,120176983,150964094,470209650,5845704896.910891,5898444508.564291,4799232650.231811,16543382055.706993,1299925,455170,873607,2628702
2016-07-01,CHX (M),3620879,10445319,4169751,18235949,188439336.304000,819746536.100000,302936217.613500,1311122090.017500,250,3197,756,4203
2016-07-01,NYSE (N),856522850,0,0,856522850,30612459344.146702,0.000000,0.000000,30612459344.146702,3028055,0,0,3028055
2016-07-01,NYSE Arca (P),233166577,360912137,153811963,747890677,8677781142.270108,18003140371.346618,6128395930.681271,32809317444.297997,1761436,955085,1084112,3800633
2016-07-01,NASDAQ (Q),364924886,127544662,416992835,909462383,14622101806.952087,7737635289.615116,17082340302.192942,39442077398.760145,3133732,524846,2659139,6317717
2016-07-01,NASDAQ PSX (X),23650317,22082187,22581492,68313996,721728398.538400,1318727502.464900,750248277.507300,2790704178.510600,175129,88391,149677,413197
2016-07-01,BATS BYX (Y),159844304,80192764,68914954,308952022,4624594124.511710,2968492485.451797,2106112114.162018,9699198724.125525,1380978,339418,583571,2303967
2016-07-01,BATS BZX (Z),212551029,119765436,116547812,448864277,7081967003.871226,6664103130.977888,4490807006.998659,18236877141.847773,1773016,505008,917005,3195029
2016-06-30,NYSE MKT (A),0,16240101,3397233,19637334,0.000000,91642995.561000,73203481.919000,164846477.480000,0,30620,14362,44982
2016-06-30,NASDAQ BX (B),122884152,54989765,54283598,232157515,4644044774.777191,2339806807.797893,2137135257.687785,9120986840.262869,1129474,207459,485325,1822258
2016-06-30,NSX (C),291443,176685,196223,664351,16168303.170000,17920130.100000,3052734.445600,37141167.715600,1875,384,850,3109
2016-06-30,NYSE (DN),165906809,66594466,93671143,326172418,6201738373.884795,2905257029.949808,3572132389.549893,12679127793.384496,685159,164191,340759,1190109
2016-06-30,NASDAQ (DQ),1348109539,719590481,733232444,2800932464,44150400865.100115,34084093932.701705,22756904931.334522,100991399729.136342,4266104,1120418,2083307,7469829
2016-06-30,EDGA (J),109215362,65359560,51375410,225950332,3444365931.788793,2861224544.243102,1677130655.504802,7982721131.536697,941755,284353,417516,1643624
2016-06-30,EDGX (K),229484150,146160614,172162947,547807711,7076997107.111071,7594943084.962307,5482912411.611734,20154852603.685112,1537438,539216,1053306,3129960
2016-06-30,CHX (M),10188258,21124151,4054583,35366992,413176193.645000,1525479637.070000,279157289.519000,2217813120.234000,2493,4915,1467,8875
2016-06-30,NYSE (N),1371753281,0,0,1371753281,51453823864.578573,0.000000,0.000000,51453823864.578573,3828627,0,0,3828627
2016-06-30,NYSE Arca (P),305422343,456167721,201340922,962930986,11660440037.288127,24895110072.307529,7863207388.850344,44418757498.446000,2316041,1196259,1439967,4952267
2016-06-30,NASDAQ (Q),459277559,159912928,609392965,1228583452,19177986927.103008,10263060328.369769,25336376876.689320,54777424132.162097,3947168,632660,3269690,7849518
2016-06-30,NASDAQ PSX (X),29735273,26246714,28328764,84310751,942791091.122202,1559250436.582499,1049271082.790501,3551312610.495202,221689,103482,187718,512889
2016-06-30,BATS BYX (Y),207821421,109981258,83303723,401106402,6156608529.227392,4080853743.929490,2688869392.512920,12926331665.669802,1740764,433726,705686,2880176
2016-06-30,BATS BZX (Z),268762182,158956689,140272604,567991475,9101866935.657058,9120473398.563578,5432882645.383158,23655222979.603794,2210115,648165,1133801,3992081
2016-06-29,NYSE MKT (A),0,13708195,3249618,16957813,0.000000,83431956.571600,70327173.180000,153759129.751600,0,35409,12602,48011
2016-06-29,NASDAQ BX (B),108258866,47980985,50958746,207198597,3726021300.021722,2111846878.578199,1874835084.772096,7712703263.372017,974376,194114,441824,1610314
2016-06-29,NSX (C),337780,58651,320983,717414,16268938.990000,4680909.770000,4302789.556100,25252638.316100,2841,134,938,3913
2016-06-29,NYSE (DN),164741601,57380275,97532772,319654648,5809060136.594870,2582347611.509505,3329103485.400720,11720511233.505095,639899,159558,322729,1122186
2016-06-29,NASDAQ (DQ),1345750365,594230119,777134105,2717114589,39897513817.975024,27952129013.011617,23377168125.724231,91226810956.710872,4258608,1179406,2196244,7634258
2016-06-29,EDGA (J),104434203,54833937,52031749,211299889,3095978531.784402,2399385962.681999,1549578990.769701,7044943485.236102,901284,257335,402397,1561016
2016-06-29,EDGX (K),235118126,136050146,186243001,557411273,7046330691.817242,7015196088.060617,5685842141.292275,19747368921.170134,1534516,521845,1058528,3114889
2016-06-29,CHX (M),7644800,11817082,4056162,23518044,290147906.851400,901828755.180000,313493044.563200,1505469706.594600,660,4975,1377,7012
2016-06-29,NYSE (N),1055426190,0,0,1055426190,36248861924.407413,0.000000,0.000000,36248861924.407413,3566624,0,0,3566624
2016-06-29,NYSE Arca (P),286372689,404443351,200024769,890840809,10314798113.516736,21339702771.154335,7802448159.221285,39456949043.892356,2077691,1082107,1378237,4538035
2016-06-29,NASDAQ (Q),444452717,142982118,499645131,1087079966,17815009387.547621,9250605386.872773,20233571522.265002,47299186296.685396,3734762,588964,3152822,7476548
2016-06-29,NASDAQ PSX (X),29130013,23036904,25931340,78098257,888321734.258001,1553595551.051500,906733320.674400,3348650605.983901,214597,93019,168526,476142
2016-06-29,BATS BYX (Y),193840452,94848758,77779197,366468407,5377813444.327833,3689654407.381726,2432966267.772010,11500434119.481569,1626372,391306,657071,2674749
2016-06-29,BATS BZX (Z),269897847,138807047,144146065,552850959,8624993069.331776,8231747405.764595,5471783654.192457,22328524129.288828,2174316,602415,1134296,3911027
2016-06-28,NYSE MKT (A),0,11954389,3891940,15846329,0.000000,72430058.987000,74586697.725000,147016756.712000,0,26416,15254,41670
2016-06-28,NASDAQ BX (B),124884595,55738762,63717192,244340549,4164730263.971294,2379575496.543294,2202881305.290793,8747187065.805381,1116314,224892,532405,1873611
2016-06-28,NSX (C),284766,144727,179637,609130,12866598.769200,15143952.435000,5456652.336600,33467203.540800,2534,341,969,3844
2016-06-28,NYSE (DN),165716434,56050720,84737722,306504876,5664428161.402828,2582537533.369002,3128769329.386742,11375735024.158572,671058,153271,320752,1145081
2016-06-28,NASDAQ (DQ),1409265668,683495883,734886540,2827648091,41832293993.580571,33271146196.867720,23211340798.072846,98314780988.521137,4487168,1224314,2184431,7895913
2016-06-28,EDGA (J),110941099,65850982,52874962,229667043,3291747345.527387,2845343798.648904,1654591034.029498,7791682178.205789,969678,303107,433444,1706229
2016-06-28,EDGX (K),234028585,147843074,179756438,561628097,7131479774.768290,7383580887.588681,5712850184.876751,20227910847.233722,1629359,565038,1118981,3313378
2016-06-28,CHX (M),12132654,15763518,4721904,32618076,578176613.331000,1436801936.360000,298725582.148500,2313704131.839500,462,5276,1317,7055
2016-06-28,NYSE (N),1084048363,0,0,1084048363,37656133418.017074,0.000000,0.000000,37656133418.017074,3858051,0,0,3858051
2016-06-28,NYSE Arca (P),294749994,438102440,196438553,929290987,10699145367.888527,22496280873.458261,7760438697.711778,40955864939.058566,2212507,1239956,1436244,4888707
2016-06-28,NASDAQ (Q),454328201,165099175,506869743,1126297119,18212050462.903579,10299470045.934195,20903239472.798916,49414759981.636690,3954813,672720,3390151,8017684
2016-06-28,NASDAQ PSX (X),28280978,25996668,26525708,80803354,881515593.417800,1669405067.045400,865699177.605602,3416619838.068802,218190,107613,176353,502156
2016-06-28,BATS BYX (Y),202408974,100643902,85237280,388290156,5513363934.854744,3846642586.294902,2509720302.781994,11869726823.931640,1696431,425471,726397,2848299
2016-06-28,BATS BZX (Z),272110235,156778001,139012366,567900602,8858872286.749319,9060312071.577899,5187563308.104462,23106747666.431680,2282311,656613,1156688,4095612
2016-06-27,NYSE MKT (A),0,13891562,4498786,18390348,0.000000,73295267.857300,94447229.045000,167742496.902300,0,33336,16639,49975
2016-06-27,NASDAQ BX (B),142036045,67506281,70939003,280481329,4899039243.359987,2891372619.625402,2570414243.476172,10360826106.461561,1289532,282783,617524,2189839
2016-06-27,NSX (C),251268,373994,482219,1107481,12495526.340000,38652860.210400,8199718.666600,59348105.217000,1953,831,2129,4913
2016-06-27,NYSE (DN),227297215,75626487,113951596,416875298,7646341845.524947,3683302648.325401,4267613146.495899,15597257640.346247,900038,218034,434306,1552378
2016-06-27,NASDAQ (DQ),1715028211,854303598,898482808,3467814617,48486668205.600159,44157052126.063558,28780856242.895077,121424576574.558794,5554501,1761360,2758156,10074017
2016-06-27,EDGA (J),143058408,86310809,68917748,298286965,4146808590.583728,3783582652.060687,2129010612.254889,10059401854.899304,1237077,404368,556369,2197814
2016-06-27,EDGX (K),302624470,212886472,238675891,754186833,8953286508.089891,11420685464.292853,7699966867.323675,28073938839.706419,2099045,873360,1482907,4455312
2016-06-27,CHX (M),18491455,18055703,5425065,41972223,705366680.401000,1524590005.739001,389187919.900500,2619144606.040501,588,8638,1891,11117
2016-06-27,NYSE (N),1312113434,0,0,1312113434,44843752921.221661,0.000000,0.000000,44843752921.221661,4719978,0,0,4719978
2016-06-27,NYSE Arca (P),389230498,611173954,258543200,1258947652,13777489530.057569,33095677384.619461,10620044275.553043,57493211190.230073,2921156,1849012,1902269,6672437
2016-06-27,NASDAQ (Q),581627038,236042064,669567621,1487236723,22838050661.493110,15338701462.125433,27352361003.392387,65529113127.010930,5066135,1040660,4446457,10553252
2016-06-27,NASDAQ PSX (X),34375850,35723921,36443589,106543360,1078743525.862601,2522768221.817701,1185782066.241193,4787293813.921495,271708,150343,229507,651558
2016-06-27,BATS BYX (Y),245538646,128443609,108875567,482857822,6529306498.070667,4834775559.079479,3189260459.811361,14553342516.961507,2094851,575410,908085,3578346
2016-06-27,BATS BZX (Z),341642323,222706002,192017912,756366237,10856544804.729522,13076433377.535276,7088783478.614798,31021761660.879596,2869111,977578,1536517,5383206
2016-06-24,NYSE MKT (A),0,111888545,3720568,115609113,0.000000,412235176.369700,86347446.078000,498582622.447700,0,37881,15305,53186
2016-06-24,NASDAQ BX (B),156359476,79503370,77571840,313434686,5370652541.313737,3522070145.201002,2881662214.972485,11774384901.487224,1362845,332817,670915,2366577
2016-06-24,NSX (C),321201,367485,560201,1248887,12694436.721300,35877176.499300,9246452.596200,57818065.816800,1336,714,2564,4614
2016-06-24,NYSE (DN),236313766,88430960,128429203,453173929,8542008907.274523,4492060319.851706,5463532026.769402,18497601253.895631,938359,254837,495368,1688564
2016-06-24,NASDAQ (DQ),2394079047,983563934,1628744138,5006387119,73883792471.507793,51571258210.471303,51761211425.096943,177216262107.076039,5459254,1936322,2886229,10281805
2016-06-24,EDGA (J),144693495,108488833,70930192,324112520,4200471177.961186,4687527916.639596,2244073081.632783,11132072176.233565,1172344,525327,561442,2259113
2016-06-24,EDGX (K),331376774,271700533,252536703,855614010,9848322279.157325,16034000052.844490,8979686532.240625,34862008864.242440,2126382,1134967,1529491,4790840
2016-06-24,CHX (M),8733839,19842540,5972260,34548639,349552869.823400,1815880550.210001,616654349.426200,2782087769.459601,1118,14761,3031,18910
2016-06-24,NYSE (N),2510098576,0,0,2510098576,81056318252.385657,0.000000,0.000000,81056318252.385657,5282488,0,0,5282488
2016-06-24,NYSE Arca (P),456384570,820248862,293467463,1570100895,16389495681.929377,46130362060.703405,12861406736.160720,75381264478.793502,3137620,2316184,2078505,7532309
2016-06-24,NASDAQ (Q),648447825,312030090,1589291289,2549769204,25131137767.869956,21996842385.180036,49816044253.424843,96944024406.474835,5254470,1327729,4764093,11346292
2016-06-24,NASDAQ PSX (X),40875931,41292142,37489747,119657820,1297519856.147702,3021150736.978700,1409258368.642301,5727928961.768703,280727,182720,247046,710493
2016-06-24,BATS BYX (Y),280961322,160581891,121747896,563291109,8024768101.949864,6373275130.562903,3805692949.308799,18203736181.821566,2324777,716726,992879,4034382
2016-06-24,BATS BZX (Z),397011280,276471378,204388608,877871266,12981009469.805471,18046535556.899909,8525928957.821513,39553473984.526893,3176013,1216770,1631828,6024611
2016-06-23,NYSE MKT (A),0,10379915,2751645,13131560,0.000000,94346623.255200,55974373.105000,150320996.360200,0,24930,9917,34847
2016-06-23,NASDAQ BX (B),90089257,42945048,47283276,180317581,3079718049.399581,1724880425.268301,1698964154.470213,6503562629.138095,814925,166369,402550,1383844
2016-06-23,NSX (C),144120,118440,173432,435992,6397897.520000,10604979.646900,4707940.950600,21710818.117500,884,306,1012,2202
2016-06-23,NYSE (DN),128601124,45102561,76945105,250648790,4590728493.877194,1846934928.535397,2881496691.439284,9319160113.851875,509540,127046,288697,925283
2016-06-23,NASDAQ (DQ),1053234086,463243415,622433181,2138910682,32295875240.530306,20079469799.512132,19123390312.788284,71498735352.830722,3338325,883015,1851169,6072509
2016-06-23,EDGA (J),81304351,50290161,44595625,176190137,2418662218.882385,2074615695.154100,1325273783.636408,5818551697.672893,705573,223655,352959,1282187
2016-06-23,EDGX (K),176157950,110669765,151371204,438198919,5283847248.133145,5106464760.938813,4700051328.838069,15090363337.910027,1132706,397598,867114,2397418
2016-06-23,CHX (M),8156509,14139856,4635779,26932144,280308075.710200,1567068073.126000,362063715.172500,2209439864.008700,367,3345,822,4534
2016-06-23,NYSE (N),851895665,0,0,851895665,30297694905.552373,0.000000,0.000000,30297694905.552373,2726597,0,0,2726597
2016-06-23,NYSE Arca (P),217729124,345761129,166562598,730052851,8063135047.505504,17005247591.070412,6458491087.750247,31526873726.326163,1592825,912343,1143888,3649056
2016-06-23,NASDAQ (Q),336655505,119594140,424810177,881059822,13410313793.230167,7083231602.747880,17953871116.165165,38447416512.143212,2845080,488837,2647050,5980967
2016-06-23,NASDAQ PSX (X),21955742,18649276,22132979,62737997,694253380.655600,1084445592.635199,735794114.744700,2514493088.035499,164428,77316,146355,388099
2016-06-23,BATS BYX (Y),147249446,79529080,71112019,297890545,4250611711.825683,2938477459.959405,2217164324.111994,9406253495.897082,1251027,325089,581630,2157746
2016-06-23,BATS BZX (Z),191752121,110199957,112206533,414158611,6247214068.341960,5727130495.462107,4200549645.838639,16174894209.642706,1570312,449019,873503,2892834
2016-06-22,NYSE MKT (A),0,10586473,3637416,14223889,0.000000,104373155.156500,74039052.003000,178412207.159500,0,25113,13812,38925
2016-06-22,NASDAQ BX (B),83938301,43224065,44800156,171962522,2819805746.695793,1879361466.777600,1769158073.545206,6468325287.018599,761821,171000,396260,1329081
2016-06-22,NSX (C),228681,140001,247375,616057,8238452.191200,9978294.216100,6791005.452000,25007751.859300,1230,241,1255,2726
2016-06-22,NYSE (DN),116757927,49748902,72464990,238971819,4070701194.181686,2147144043.692500,2852008862.531793,9069854100.405979,485274,129429,268894,883597
2016-06-22,NASDAQ (DQ),973840197,544994339,608628502,2127463038,29852813531.751264,24653933132.949082,19354019030.589027,73860765695.289373,3153010,914400,1776940,5844350
2016-06-22,EDGA (J),74544097,48105685,40024418,162674200,2155901585.236500,2033426651.529101,1240403555.745107,5429731792.510708,650051,223987,328096,1202134
2016-06-22,EDGX (K),180045387,112312607,145217705,437575699,5164125649.773364,5252036925.926699,4852331456.912275,15268494032.612338,1169250,446214,903969,2519433
2016-06-22,CHX (M),8786932,11884878,9608033,30279843,310688395.716200,1127712824.351200,611976917.163600,2050378137.231000,309,2995,838,4142
2016-06-22,NYSE (N),827249840,0,0,827249840,28632444664.568723,0.000000,0.000000,28632444664.568723,2846574,0,0,2846574
2016-06-22,NYSE Arca (P),210956641,341099515,164937593,716993749,7630245361.414382,16423692257.011541,6996892107.570898,31050829725.996821,1590988,984844,1197719,3773551
2016-06-22,NASDAQ (Q),341828266,123441357,398549962,863819585,13781718073.349448,6665290996.109683,17097804547.810402,37544813617.269533,2933877,526877,2723978,6184732
2016-06-22,NASDAQ PSX (X),20934744,20604878,22789104,64328726,601966040.769299,1225965466.015500,769442728.677101,2597374235.461900,151722,91995,143811,387528
2016-06-22,BATS BYX (Y),143578754,77731885,65613816,286924455,4022210516.742392,2916800250.511796,2184730634.674702,9123741401.928890,1205825,327246,564599,2097670
2016-06-22,BATS BZX (Z),190152438,117155769,108413226,415721433,6075639922.953618,6048685253.118121,4239018108.025424,16363343284.097163,1565573,512234,903269,2981076
2016-06-21,NYSE MKT (A),0,11922568,3420864,15343432,0.000000,118870177.169300,79151005.918000,198021183.087300,0,26382,13744,40126
2016-06-21,NASDAQ BX (B),79159836,39799587,43886552,162845975,2720622875.022507,1636946485.597601,1698320919.209197,6055890279.829305,709434,162624,382924,1254982
2016-06-21,NSX (C),216728,110330,149053,476111,10137895.700000,8989472.430000,6572821.136800,25700189.266800,1609,202,1019,2830
2016-06-21,NYSE (DN),121293512,43152445,80844279,245290236,4309822326.293307,1807459738.132001,2841808816.435610,8959090880.860918,499891,120617,285410,905918
2016-06-21,NASDAQ (DQ),987062748,440542100,604461017,2032065865,29962394861.110757,18645458962.473513,18207005824.749926,66814859648.334196,3242408,908546,1774353,5925307
2016-06-21,EDGA (J),80360257,45644186,41829490,167833933,2463815804.988190,1839530266.167698,1318472601.965393,5621818673.121281,708992,217183,339612,1265787
2016-06-21,EDGX (K),180969027,99013929,151343103,431326059,5238122167.791299,4568781211.713121,4897556292.305869,14704459671.810289,1186816,387554,899917,2474287
2016-06-21,CHX (M),8297719,16365175,2371538,27034432,299658787.542300,1218974815.985000,173856352.574000,1692489956.101300,286,3037,597,3920
2016-06-21,NYSE (N),854555746,0,0,854555746,29307830486.848904,0.000000,0.000000,29307830486.848904,2844561,0,0,2844561
2016-06-21,NYSE Arca (P),221039932,309219162,161342901,691601995,7953204389.908157,14811251613.321882,6224244465.451464,28988700468.681503,1659196,897580,1130158,3686934
2016-06-21,NASDAQ (Q),338010780,108829776,412751862,859592418,13361687407.754801,5787104275.427310,16459822466.347366,35608614149.529477,2884135,470243,2678440,6032818
2016-06-21,NASDAQ PSX (X),21250982,17605179,20886816,59742977,620313568.790400,969373883.567201,692019244.431597,2281706696.789198,155538,77314,136361,369213
2016-06-21,BATS BYX (Y),149210652,73034960,68509295,290754907,4323891527.711691,2690726389.323799,2197092712.684119,9211710629.719609,1275468,313399,575764,2164631
2016-06-21,BATS BZX (Z),198609698,103544036,111561616,413715350,6330166666.383379,5280590111.692211,4201527422.790950,15812284200.866540,1592346,444383,896535,2933264
2016-06-20,NYSE MKT (A),0,12655330,3507911,16163241,0.000000,102801260.565700,90105703.214000,192906963.779700,0,27231,14629,41860
2016-06-20,NASDAQ BX (B),87177556,43546093,47044554,177768203,3070105897.125988,1882393683.037101,1752012660.585092,6704512240.748181,803433,181518,405655,1390606
2016-06-20,NSX (C),165519,125423,293633,584575,8436828.800600,10039837.590000,4589303.678700,23065970.069300,1424,369,1349,3142
2016-06-20,NYSE (DN),137985055,52353017,80750816,271088888,5142302826.674479,2148318931.684000,2887139658.716290,10177761417.074769,585661,141799,300416,1027876
2016-06-20,NASDAQ (DQ),1012125841,474991360,615417510,2102534711,30840876863.679971,20526692463.168695,18707130018.665383,70074699345.514049,3569073,971921,1915350,6456344
2016-06-20,EDGA (J),89348456,50727528,46397651,186473635,2778595612.098101,2064160134.608997,1467453784.506085,6310209531.213183,793699,239208,376460,1409367
2016-06-20,EDGX (K),196881524,115639001,155008654,467529179,5844542515.038009,5336612829.904115,4913328556.611075,16094483901.553199,1335926,446420,948709,2731055
2016-06-20,CHX (M),7390018,8122707,3347410,18860135,305814796.293500,468779841.930000,203726242.027400,978320880.250900,377,3268,840,4485
2016-06-20,NYSE (N),908637979,0,0,908637979,32382125841.158934,0.000000,0.000000,32382125841.158934,2998385,0,0,2998385
2016-06-20,NYSE Arca (P),240369935,339287209,176046119,755703263,9003458117.367126,16181557373.391682,6916119249.155429,32101134739.914237,1800589,939051,1215558,3955198
2016-06-20,NASDAQ (Q),382716750,123130659,440073138,945920547,15519044935.543507,6488315495.191418,18608590485.031567,40615950915.766492,3250230,500272,2754908,6505410
2016-06-20,NASDAQ PSX (X),24290819,18936704,22871803,66099326,729645533.851601,1069606048.471000,746508141.687798,2545759724.010399,168015,78144,143826,389985
2016-06-20,BATS BYX (Y),164870581,82001805,75819986,322692372,4802447826.324017,3095629554.179012,2348909651.049021,10246987031.552050,1414826,362881,628714,2406421
2016-06-20,BATS BZX (Z),217440706,115542147,115212144,448194997,6896903362.262440,5928396378.746487,4266204798.914271,17091504539.923198,1775165,490331,927995,3193491
2016-06-17,NYSE MKT (A),0,67728352,3787206,71515558,0.000000,334140088.582800,71749145.325000,405889233.907800,0,29715,13567,43282
2016-06-17,NASDAQ BX (B),98494493,43133056,47240780,188868329,3341528292.529512,1859091811.102200,1799376643.126902,6999996746.758614,897143,179886,407056,1484085
2016-06-17,NSX (C),310363,98124,474352,882839,11960075.767100,9953058.140000,5907685.913900,27820819.821000,1439,182,1445,3066
2016-06-17,NYSE (DN),127100848,47021477,83571702,257694027,4117522445.883102,2061152063.203698,2977230040.932600,9155904550.019400,553660,137713,312441,1003814
2016-06-17,NASDAQ (DQ),1304977163,559399742,833339178,2697716083,35742267050.258300,25708696470.728859,25961479102.437041,87412442623.424200,3506059,972153,1890006,6368218
2016-06-17,EDGA (J),93849082,52896026,46969720,193714828,2722129285.852403,2198679658.340297,1428090843.979306,6348899788.172006,795824,246453,370916,1413193
2016-06-17,EDGX (K),200981062,119097505,162990367,483068934,5752810958.492690,5740921199.962896,5131459299.785162,16625191458.240748,1332989,487529,956062,2776580
2016-06-17,CHX (M),7525403,20548251,6396712,34470366,255612810.815500,1337209115.180000,530598791.958600,2123420717.954100,479,3953,1262,5694
2016-06-17,NYSE (N),2124284057,0,0,2124284057,73014789985.126699,0.000000,0.000000,73014789985.126699,3393219,0,0,3393219
2016-06-17,NYSE Arca (P),258082049,357637966,190613973,806333988,8977445519.240585,18095930219.508927,7333797483.781379,34407173222.530891,1903179,1071378,1273162,4247719
2016-06-17,NASDAQ (Q),386057029,132124997,1039447643,1557629669,14595585761.951671,7763474658.187211,38781899818.689783,61140960238.828665,3192295,564223,3090051,6846569
2016-06-17,NASDAQ PSX (X),28479608,24431935,28401572,81313115,806275847.125801,1400264581.817000,930838844.611000,3137379273.553801,198115,102334,167944,468393
2016-06-17,BATS BYX (Y),182201202,84985074,77805079,344991355,4996918158.251688,3145049916.404701,2442520552.093583,10584488626.749972,1504446,371402,648447,2524295
2016-06-17,BATS BZX (Z),230836465,125104551,129081444,485022460,7061807047.848510,6544664952.593807,5033819360.784594,18640291361.226911,1805598,544983,1018780,3369361
2016-06-16,NYSE MKT (A),0,16849071,3798410,20647481,0.000000,71669337.773800,72445649.107000,144114986.880800,0,35008,13800,48808
2016-06-16,NASDAQ BX (B),87918577,52092317,47013824,187024718,2995173392.191602,2137665370.394201,1723326409.463095,6856165172.048898,793403,214547,397876,1405826
2016-06-16,NSX (C),163919,166116,528566,858601,7853090.400300,17237118.648700,3617926.049600,28708135.098600,1198,331,1662,3191
2016-06-16,NYSE (DN),140771461,65900926,89722362,296394749,4844953994.671608,2762691800.572312,3179888483.592725,10787534278.836645,569915,166699,316126,1052740
2016-06-16,NASDAQ (DQ),1113972045,667235740,666292814,2447500599,32429091649.026041,31107918872.881449,19160980623.152587,82697991145.060077,3609518,1225853,1876948,6712319
2016-06-16,EDGA (J),90553255,66687327,47520539,204761121,2679066206.654105,2728898907.734697,1431691012.107404,6839656126.496206,800124,320447,384727,1505298
2016-06-16,EDGX (K),207747467,150787257,164253005,522787729,5939430250.406085,7018748624.002006,5062214629.424802,18020393503.832893,1377946,590050,948448,2916444
2016-06-16,CHX (M),9481601,21150929,4557346,35189876,378936153.263700,1645122972.903500,294538750.290600,2318597876.457800,414,6839,1627,8880
2016-06-16,NYSE (N),893668762,0,0,893668762,29655275918.800675,0.000000,0.000000,29655275918.800675,3288755,0,0,3288755
2016-06-16,NYSE Arca (P),260170734,456052656,182270314,898493704,9465245580.674513,22499040941.122790,7060337267.328574,39024623789.125877,1968892,1346473,1283958,4599323
2016-06-16,NASDAQ (Q),400634671,162099370,422709178,985443219,15648683334.285300,9039348013.619822,16991283655.823807,41679315003.728929,3458895,688074,2930998,7077967
2016-06-16,NASDAQ PSX (X),27956566,28497478,27256968,83711012,805812169.162301,1749240215.302702,926169465.402504,3481221849.867507,199257,124434,163954,487645
2016-06-16,BATS BYX (Y),166036934,97996844,76122209,340155987,4491390417.850457,3629974831.306296,2266627027.325102,10387992276.481855,1404114,431186,601575,2436875
2016-06-16,BATS BZX (Z),235501755,154054110,122643113,512198978,7406776121.975276,8092047606.872076,4655062797.092121,20153886525.939473,1927444,668386,991097,3586927
2016-06-15,NYSE MKT (A),0,13082616,4038684,17121300,0.000000,73846423.398400,88145284.329000,161991707.727400,0,30209,12972,43181
2016-06-15,NASDAQ BX (B),92463628,41050281,45805499,179319408,3163464412.728415,1691272805.257299,1689372745.090387,6544109963.076101,828791,173466,389795,1392052
2016-06-15,NSX (C),263613,189499,401778,854890,10819675.490000,14187335.772500,2720435.203900,27727446.466400,939,468,913,2320
2016-06-15,NYSE (DN),131665496,53832809,80867539,266365844,4347761836.916094,2240915536.765502,2437338490.589010,9026015864.270606,519764,144599,270206,934569
2016-06-15,NASDAQ (DQ),1026623048,496282066,635039443,2157944557,30313017774.327614,22693406538.836427,17744672654.979626,70751096968.143667,3421482,986950,1787826,6196258
2016-06-15,EDGA (J),92919865,52076091,44621273,189617229,2777612763.813891,2067251408.269700,1340996222.165908,6185860394.249499,807716,248265,364798,1420779
2016-06-15,EDGX (K),209158858,126906883,160129450,496195191,5921361048.761490,5954899454.267674,4636528417.896955,16512788920.926119,1379603,500572,916537,2796712
2016-06-15,CHX (M),7638051,10666432,4500909,22805392,327214079.477500,1046623987.770000,262591015.628500,1636429082.876000,420,5326,1044,6790
2016-06-15,NYSE (N),903134599,0,0,903134599,30400183633.621897,0.000000,0.000000,30400183633.621897,3134662,0,0,3134662
2016-06-15,NYSE Arca (P),255182687,362987219,176036479,794206385,9193335707.979961,17712137860.394861,6436443760.753034,33341917329.127856,1941915,1080538,1243433,4265886
2016-06-15,NASDAQ (Q),399649160,148312015,432011799,979972974,15365979278.540360,7811604891.704376,17067757915.074589,40245342085.319325,3328493,624977,2755333,6708803
2016-06-15,NASDAQ PSX (X),29849071,28857488,28102278,86808837,833000045.219599,1559063963.817401,875154663.513000,3267218672.550000,200100,121667,166006,487773
2016-06-15,BATS BYX (Y),167596064,82000294,72898784,322495142,4648131856.058851,3029779908.071199,2202371537.314863,9880283301.444913,1392650,351953,569764,2314367
2016-06-15,BATS BZX (Z),230869486,130651715,119333622,480854823,7130505130.063804,6535607311.188328,4273709767.008917,17939822208.261049,1842835,563741,948555,3355131
2016-06-14,NYSE MKT (A),0,9751789,3909305,13661094,0.000000,54815758.873300,87542999.302000,142358758.175300,0,26373,14983,41356
2016-06-14,NASDAQ BX (B),94493351,47631729,50636674,192761754,3274341864.248501,1972942735.924397,1742262491.290393,6989547091.463291,843157,196388,403672,1443217
2016-06-14,NSX (C),198985,112304,272069,583358,14727233.760000,11596663.950000,5372477.224600,31696374.934600,906,225,988,2119
2016-06-14,NYSE (DN),145996331,56025837,90145805,292167973,5295046443.917797,2439324156.117104,2980924950.928500,10715295550.963401,604131,153984,308474,1066589
2016-06-14,NASDAQ (DQ),1137978031,572424713,684760316,2395163060,35326340569.938985,25518698273.462442,19443236897.713394,80288275741.114821,3843036,1142177,1943468,6928681
2016-06-14,EDGA (J),100502991,60353724,51150771,212007486,3160752070.879390,2455204910.757311,1505103430.118705,7121060411.755406,880067,282756,397077,1559900
2016-06-14,EDGX (K),217506159,139708537,168878009,526092705,6649111210.715798,6611567177.392405,5097260595.603893,18357938983.712096,1468389,573133,983840,3025362
2016-06-14,CHX (M),10313233,13775855,5857970,29947058,319729170.446000,1148292339.248700,484303308.430000,1952324818.124700,272,4747,1681,6700
2016-06-14,NYSE (N),907722489,0,0,907722489,30977117959.249695,0.000000,0.000000,30977117959.249695,3244913,0,0,3244913
2016-06-14,NYSE Arca (P),273023617,413450167,192915597,879389381,10420907230.924979,19891669605.846013,7210907560.207644,37523484396.978636,2074235,1270929,1329465,4674629
2016-06-14,NASDAQ (Q),428686538,162801622,438995428,1030483588,17236242229.794178,8665587390.312303,16940547423.697795,42842377043.804276,3636557,691959,2947927,7276443
2016-06-14,NASDAQ PSX (X),30213789,26642427,28154992,85011208,899473855.470800,1586230384.475801,952547555.842501,3438251795.789102,212889,121323,173961,508173
2016-06-14,BATS BYX (Y),175334895,91604742,76579367,343519004,4946098941.839690,3398907900.005603,2302863719.290301,10647870561.135594,1421333,398790,602267,2422390
2016-06-14,BATS BZX (Z),241569969,145826285,130484473,517880727,7808190368.337961,7515108083.542216,4631471888.966420,19954770340.846597,1949650,642372,1006190,3598212
2016-06-13,NYSE MKT (A),0,12028193,4712266,16740459,0.000000,51865698.110400,109147202.716000,161012900.826400,0,28130,17161,45291
2016-06-13,NASDAQ BX (B),87283241,38794028,45976388,172053657,3053278921.111903,1648304279.947601,1701370584.082704,6402953785.142208,793201,166430,394357,1353988
2016-06-13,NSX (C),192720,179662,282171,654553,9508717.100000,27448210.070000,7821777.404500,44778704.574500,1572,385,1415,3372
2016-06-13,NYSE (DN),130216583,45701266,84425834,260343683,4969406250.763718,1940833357.219301,3157985610.089634,10068225218.072653,554596,128466,302261,985323
2016-06-13,NASDAQ (DQ),986451647,464033923,653434012,2103919582,30923221307.657243,23688738296.963908,19711153591.100591,74323113195.721742,3548137,974223,2002823,6525183
2016-06-13,EDGA (J),91149379,52407227,50871855,194428461,2908979458.712501,2088114149.235399,1535832649.700805,6532926257.648705,817670,253427,404292,1475389
2016-06-13,EDGX (K),194556431,116809231,169063782,480429444,6024109609.095608,5539478408.548702,5287322585.628896,16850910603.273206,1344770,469511,1010317,2824598
2016-06-13,CHX (M),7625353,8681009,7627434,23933796,287992987.541300,917801381.890000,553100450.706800,1758894820.138100,506,3897,1363,5766
2016-06-13,NYSE (N),870618519,0,0,870618519,31098560997.292039,0.000000,0.000000,31098560997.292039,3182557,0,0,3182557
2016-06-13,NYSE Arca (P),238853557,355310751,190942046,785106354,9514101500.674972,17956648347.151834,7509849110.019788,34980598957.846594,1905645,1073919,1359349,4338913
2016-06-13,NASDAQ (Q),381416836,125985898,453845796,961248530,15853769345.848235,7014401356.197202,18696450503.725022,41564621205.770459,3396668,549307,3073798,7019773
2016-06-13,NASDAQ PSX (X),25085324,22370520,25202841,72658685,814676719.534999,1283468906.196701,864096099.992900,2962241725.724600,193896,100492,166233,460621
2016-06-13,BATS BYX (Y),157627422,78747399,74318506,310693327,4459819355.299914,3039543570.663406,2272398370.736619,9771761296.699939,1310512,350892,594615,2256019
2016-06-13,BATS BZX (Z),227620240,121513763,132068571,481202574,7537556768.748026,6480553004.999914,5050879659.978257,19068989433.726197,1890703,544604,1078180,3513487
2016-06-10,NYSE MKT (A),0,13276255,3253643,16529898,0.000000,57304691.371000,63883815.956000,121188507.327000,0,27496,11153,38649
2016-06-10,NASDAQ BX (B),84160503,38450195,42909862,165520560,2861006385.904196,1597311150.156400,1642784361.101501,6101101897.162097,756815,162285,367731,1286831
2016-06-10,NSX (C),526270,669664,358487,1554421,16133796.894400,125744067.938400,9638746.706800,151516611.539600,1567,1348,1365,4280
2016-06-10,NYSE (DN),131389399,51552499,73099139,256041037,4555200924.149507,2178163517.102201,2796242460.008784,9529606901.260492,544980,138100,283471,966551
2016-06-10,NASDAQ (DQ),1091543738,499411529,658654137,2249609404,32488666858.623915,22216739567.435521,20288993161.194620,74994399587.254056,3697080,1045541,1939458,6682079
2016-06-10,EDGA (J),87003096,49013789,44955046,180971931,2733964003.722312,1996730521.166798,1424949963.363006,6155644488.252116,772408,227681,366660,1366749
2016-06-10,EDGX (K),206579760,120621002,167249325,494450087,6071577788.356315,5406071364.709519,5285037187.885887,16762686340.951721,1354330,455656,965349,2775335
2016-06-10,CHX (M),6685707,12988948,6707207,26381862,220690365.103800,1805027691.345000,444810121.037100,2470528177.485900,258,5666,2015,7939
2016-06-10,NYSE (N),877839321,0,0,877839321,30543622875.911049,0.000000,0.000000,30543622875.911049,3016220,0,0,3016220
2016-06-10,NYSE Arca (P),242745097,365605260,179148863,787499220,8743055907.357947,18993126654.064157,6938419672.278093,34674602233.700197,1788132,997419,1250962,4036513
2016-06-10,NASDAQ (Q),378696795,122003165,428779029,929478989,15087295095.283377,6893172444.760585,17952335974.934057,39932803514.978019,3253906,504806,2841165,6599877
2016-06-10,NASDAQ PSX (X),26098029,23180419,26185432,75463880,783900181.621400,1352761042.204801,939800577.086600,3076461800.912801,188473,98624,162679,449776
2016-06-10,BATS BYX (Y),154198056,76198746,68710440,299107242,4375530221.025497,2844665947.889589,2164688171.843117,9384884340.758203,1293938,317876,558695,2170509
2016-06-10,BATS BZX (Z),229075001,118243784,123309271,470628056,7281397364.286813,6360434828.640694,4705415054.494556,18347247247.422063,1856206,504313,981974,3342493
2016-06-09,NYSE MKT (A),0,12000325,2633375,14633700,0.000000,59503922.064100,61679165.537000,121183087.601100,0,24365,11349,35714
2016-06-09,NASDAQ BX (B),80033019,28740098,36141705,144914822,2710143439.174420,1199350233.963602,1409038098.955097,5318531772.093119,715560,129010,319706,1164276
2016-06-09,NSX (C),60569,348067,293792,702428,3807701.030000,58762091.358900,3965583.192900,66535375.581800,319,832,937,2088
2016-06-09,NYSE (DN),121738859,37710050,67512614,226961523,4164224529.520201,1511646775.695096,2466424829.534511,8142296134.749808,503172,103320,264795,871287
2016-06-09,NASDAQ (DQ),1054471269,422282932,608325039,2085079240,31553147910.515919,18473740296.422218,18091418601.630413,68118306808.568550,3421709,866398,1753398,6041505
2016-06-09,EDGA (J),85493952,37648290,39397867,162540109,2608928965.742083,1497655618.390998,1233045182.050594,5339629766.183675,749459,185399,327901,1262759
2016-06-09,EDGX (K),195788210,96735735,150933815,443457760,5749181082.549134,4147198613.555305,4565943621.323210,14462323317.427649,1271279,366317,869500,2507096
2016-06-09,CHX (M),8503062,15933167,5833585,30269814,320177252.312000,1451119628.780000,349038325.072800,2120335206.164800,859,3036,934,4829
2016-06-09,NYSE (N),812497137,0,0,812497137,27149916285.492553,0.000000,0.000000,27149916285.492553,2772770,0,0,2772770
2016-06-09,NYSE Arca (P),219880511,266729268,155611266,642221045,7773681201.031152,13073860105.510128,5963605021.378571,26811146327.919851,1654163,812456,1101401,3568020
2016-06-09,NASDAQ (Q),337433706,95404399,383089701,815927806,12935151642.450216,5065736417.308315,15126341624.329053,33127229684.087584,2845710,407586,2506583,5759879
2016-06-09,NASDAQ PSX (X),24458857,19698375,22237997,66395229,708987412.561500,1032884703.917200,804018542.267801,2545890658.746501,175047,88640,140262,403949
2016-06-09,BATS BYX (Y),144947144,58095079,57608237,260650460,4105059525.277593,2143164370.720995,1905352095.974303,8153575991.972891,1208753,258824,500547,1968124
2016-06-09,BATS BZX (Z),207473512,91311586,107543361,406328459,6503861102.826095,4653763071.899502,4082765961.145304,15240390135.870901,1669372,399435,882018,2950825
2016-06-08,NYSE MKT (A),0,13182586,2802839,15985425,0.000000,62118981.402700,63594957.434000,125713938.836700,0,28745,11384,40129
2016-06-08,NASDAQ BX (B),81368955,30766391,38714807,150850153,2598557110.047402,1241972147.021403,1516176575.610003,5356705832.678808,704738,135332,320200,1160270
2016-06-08,NSX (C),161775,153750,59915,375440,8273915.730000,23915268.730000,2182837.170000,34372021.630000,768,488,549,1805
2016-06-08,NYSE (DN),142338041,44093243,75347287,261778571,4932942049.533498,1771941277.681101,2759527575.085424,9464410902.300023,562488,122758,280919,966165
2016-06-08,NASDAQ (DQ),1166776408,454333212,630070544,2251180164,34048426072.894645,18975581311.269018,18607775872.132980,71631783256.296643,3673299,911612,1903492,6488403
2016-06-08,EDGA (J),87475682,38500505,44052391,170028578,2555608404.252309,1527752411.347703,1268098383.900199,5351459199.500211,741294,189986,335492,1266772
2016-06-08,EDGX (K),214375739,99772925,159802548,473951212,5938767330.119002,4194548778.689498,4699820683.921617,14833136792.730117,1333802,382959,875106,2591867
2016-06-08,CHX (M),10574096,14165458,4200483,28940037,352719653.290000,818349316.090000,298347871.236000,1469416840.616000,342,3072,756,4170
2016-06-08,NYSE (N),885283723,0,0,885283723,29867688054.522060,0.000000,0.000000,29867688054.522060,2893851,0,0,2893851
2016-06-08,NYSE Arca (P),241076297,290224043,166371755,697672095,8323313645.698234,13342263653.614866,6010915277.781127,27676492577.094227,1764851,855127,1122247,3742225
2016-06-08,NASDAQ (Q),356799793,96075888,385191270,838066951,13521903530.493290,4978516026.110784,15634520887.927805,34134940444.531879,2943145,406162,2508809,5858116
2016-06-08,NASDAQ PSX (X),24229671,18643279,20141531,63014481,698589816.127299,979422705.494800,716140908.126798,2394153429.748897,169131,82365,130885,382381
2016-06-08,BATS BYX (Y),141347521,59920249,59878258,261146028,3795602702.505561,2277520972.455997,1933316181.782503,8006439856.744061,1142445,261314,486447,1890206
2016-06-08,BATS BZX (Z),219203183,93396655,107619916,420219754,6579471020.009480,4740085245.498917,3910861200.443469,15230417465.951866,1695576,405978,839882,2941436
2016-06-07,NYSE MKT (A),0,11056891,2621438,13678329,0.000000,48081475.000600,67582051.133000,115663526.133600,0,23906,12720,36626
2016-06-07,NASDAQ BX (B),77515067,31181521,38152530,146849118,2621320401.868994,1248527714.079401,1516051421.136896,5385899537.085291,692579,138234,335064,1165877
2016-06-07,NSX (C),150904,143210,98317,392431,7890859.660000,20087825.470000,3246419.382200,31225104.512200,918,486,632,2036
2016-06-07,NYSE (DN),131027070,36508879,76676014,244211963,4790444361.519578,1524376328.618503,2835069682.648093,9149890372.786174,519268,113162,286280,918710
2016-06-07,NASDAQ (DQ),1181990632,394703927,641956766,2218651325,36028720510.624626,17306992604.526019,20340450292.039928,73676163407.190573,3632845,867399,1957042,6457286
2016-06-07,EDGA (J),83813633,37953028,42873254,164639915,2579469575.933218,1563082080.498697,1292517358.520296,5435069014.952211,734765,186430,336950,1258145
2016-06-07,EDGX (K),211535155,87900619,164385361,463821135,6259559800.205396,3825273657.220802,5178556363.086008,15263389820.512206,1327219,336520,926658,2590397
2016-06-07,CHX (M),9916899,17275129,7211291,34403319,358303044.899000,993248434.850000,398950197.553500,1750501677.302500,391,2491,846,3728
2016-06-07,NYSE (N),865721003,0,0,865721003,30290588553.716320,0.000000,0.000000,30290588553.716320,2775120,0,0,2775120
2016-06-07,NYSE Arca (P),242075609,255501430,177608408,675185447,8495520360.848688,11952300710.928032,6731904541.087085,27179725612.863805,1738062,741361,1168505,3647928
2016-06-07,NASDAQ (Q),352424852,85226421,409614392,847265665,13840019085.143556,4471983147.597506,17399696500.378398,35711698733.119460,2975543,361197,2646754,5983494
2016-06-07,NASDAQ PSX (X),24909156,18198674,21676018,64783848,729972279.668199,954823425.193000,698993992.514600,2383789697.375799,182932,78675,139325,400932
2016-06-07,BATS BYX (Y),139392771,61712864,60774458,261880093,3903237895.663785,2323168512.374500,1968089824.181698,8194496232.219983,1145705,263691,500649,1910045
2016-06-07,BATS BZX (Z),216494801,87535540,108374889,412405230,6812780736.776781,4363574608.006002,4155975739.303074,15332331084.085857,1722678,379953,880711,2983342
2016-06-06,NYSE MKT (A),0,13548569,3057673,16606242,0.000000,55484988.396400,72350759.879000,127835748.275400,0,26514,12961,39475
2016-06-06,NASDAQ BX (B),83047532,37945741,38171718,159164991,2751325777.297700,1538505966.514101,1548264693.132496,5838096436.944297,730740,153037,337254,1221031
2016-06-06,NSX (C),173212,169010,163638,505860,8494821.550000,25175535.090000,2545213.894900,36215570.534900,1128,490,731,2349
2016-06-06,NYSE (DN),126536868,45891590,69950311,242378769,4322079853.068695,1867128077.403302,2493243246.647506,8682451177.119503,511183,132130,272573,915886
2016-06-06,NASDAQ (DQ),1047013676,465334474,603792951,2116141101,31142832610.180587,19696688125.607146,17197218678.024776,68036739413.812509,3580903,983348,1914419,6478670
2016-06-06,EDGA (J),89626069,49031536,41625681,180283286,2702094540.763588,1907989473.550898,1314064166.561905,5924148180.876391,798302,225674,349584,1373560
2016-06-06,EDGX (K),213011016,102542432,152628716,468182164,6194314748.748911,4399694623.708993,4701584431.053595,15295593803.511499,1350330,385325,908317,2643972
2016-06-06,CHX (M),9031696,10671170,5527865,25230731,346669124.372000,519231529.367600,452331509.879500,1318232163.619100,1025,2440,916,4381
2016-06-06,NYSE (N),880569550,0,0,880569550,30171319030.751756,0.000000,0.000000,30171319030.751756,2943570,0,0,2943570
2016-06-06,NYSE Arca (P),236718876,318820295,159348005,714887176,8335553984.970867,14965794671.549079,5849603885.289346,29150952541.809292,1766254,884181,1159824,3810259
2016-06-06,NASDAQ (Q),362166960,111244412,404763322,878174694,13874991287.808036,5711932597.744900,16337067615.822844,35923991501.375780,3045007,464003,2647083,6156093
2016-06-06,NASDAQ PSX (X),26164608,20678987,20938604,67782199,776678600.541698,1062690270.090200,708326347.192099,2547695217.823997,183288,94974,138999,417261
2016-06-06,BATS BYX (Y),148793569,73023179,60631971,282448719,4029493792.017523,2757773024.109099,1966998659.275104,8754265475.401726,1233241,305909,510487,2049637
2016-06-06,BATS BZX (Z),222086408,112171028,106907942,441165378,6948721506.362577,5497212121.312019,3906450799.159957,16352384426.834553,1815427,453055,895851,3164333
2016-06-03,NYSE MKT (A),0,19867411,2912661,22780072,0.000000,57515814.400400,64569155.769000,122084970.169400,0,34226,12011,46237
2016-06-03,NASDAQ BX (B),86484622,47699382,39182838,173366842,2842824542.244812,1909067595.993002,1587771248.454989,6339663386.692803,746552,195271,350151,1291974
2016-06-03,NSX (C),157880,495024,103228,756132,6867735.850000,93679443.880000,2010627.389200,102557807.119200,1122,892,520,2534
2016-06-03,NYSE (DN),134338471,56614634,67585550,258538655,4386774050.899500,2363755898.217903,2513280996.293999,9263810945.411402,511654,153739,254217,919610
2016-06-03,NASDAQ (DQ),1117640468,600021365,605232328,2322894161,33209321412.693672,24009937274.080137,18270197565.807311,75489456252.581120,3596169,1091788,1872224,6560181
2016-06-03,EDGA (J),91164676,56634910,44771388,192570974,2704384529.760690,2239768012.686998,1395064843.078406,6339217385.526094,778221,255444,366420,1400085
2016-06-03,EDGX (K),215478904,131700557,157225525,504404986,6316080460.960897,5649609745.081404,4875510244.669827,16841200450.712128,1377638,501433,922364,2801435
2016-06-03,CHX (M),9790275,13664970,4898517,28353762,425729246.292000,941875700.970000,359858419.432000,1727463366.694000,314,5292,1279,6885
2016-06-03,NYSE (N),913299430,0,0,913299430,31098409505.610460,0.000000,0.000000,31098409505.610460,3074154,0,0,3074154
2016-06-03,NYSE Arca (P),254243567,436351979,170649336,861244882,9020593974.204034,20616420524.886790,6779651877.238290,36416666376.329114,1872446,1114408,1236952,4223806
2016-06-03,NASDAQ (Q),385024010,148058306,406637106,939719422,15013044739.107555,7508384793.125673,16819690297.460718,39341119829.693946,3244684,597032,2738608,6580324
2016-06-03,NASDAQ PSX (X),28369789,30293822,24631510,83295121,831512727.911101,1607787234.738602,861691849.364601,3300991812.014304,197565,132537,153471,483573
2016-06-03,BATS BYX (Y),156526796,83790891,62072994,302390681,4206793829.799797,3164725492.074402,2023670562.466591,9395189884.340790,1243180,350832,531436,2125448
2016-06-03,BATS BZX (Z),237892428,132552920,114184216,484629564,7514842554.115737,6605314028.119899,4491913654.073817,18612070236.309453,1902638,560007,948940,3411585
2016-06-02,NYSE MKT (A),0,10048847,3010810,13059657,0.000000,46157221.522300,75651427.861000,121808649.383300,0,23152,13250,36402
2016-06-02,NASDAQ BX (B),86862831,29357799,43787284,160007914,3131746828.879184,1279324294.262500,1763747087.512593,6174818210.654277,794258,129722,396212,1320192
2016-06-02,NSX (C),160527,166498,70083,397108,10606901.463600,27700290.310000,5216479.110000,43523670.883600,1389,269,472,2130
2016-06-02,NYSE (DN),130392888,36329602,72357827,239080317,4810054336.592811,1644690094.349999,2842241039.660114,9296985470.602924,528704,104511,279568,912783
2016-06-02,NASDAQ (DQ),1154039490,411379889,633788588,2199207967,38052434984.827555,18987544061.299444,19958657948.785711,76998636994.912710,3615201,833859,1995439,6444499
2016-06-02,EDGA (J),85519865,36629318,44321734,166470917,2692824204.575799,1540920423.441306,1456686470.365396,5690431098.382501,756563,180646,374664,1311873
2016-06-02,EDGX (K),197492073,88367172,154487453,440346698,6187036097.839502,4072191169.273384,4841640753.788062,15100868020.900948,1292053,364741,917973,2574767
2016-06-02,CHX (M),10633431,9882738,9419251,29935420,446164356.111700,782065103.712600,306760996.008400,1534990455.832700,259,3337,833,4429
2016-06-02,NYSE (N),973802086,0,0,973802086,35926436922.691849,0.000000,0.000000,35926436922.691849,2757108,0,0,2757108
2016-06-02,NYSE Arca (P),250234631,246597784,165545546,662377961,9125797725.278239,11756760927.118875,6696025582.677451,27578584235.074565,1802906,749698,1211515,3764119
2016-06-02,NASDAQ (Q),365095698,95293428,407279062,867668188,14823649414.642755,5019525207.723716,16895321981.521766,36738496603.888237,3051869,409268,2657422,6118559
2016-06-02,NASDAQ PSX (X),25881715,21344240,22573770,69799725,776661845.256300,1038266092.229300,815014360.745297,2629942298.230897,177320,95868,146436,419624
2016-06-02,BATS BYX (Y),147042299,56807651,65256698,269106648,4192135727.872405,2216822662.057798,2181456442.423387,8590414832.353590,1237312,268387,561536,2067235
2016-06-02,BATS BZX (Z),206895228,86247169,109092187,402234584,6763948672.982823,4500945202.884311,4115935819.885710,15380829695.752844,1667767,391912,892441,2952120
2016-06-01,NYSE MKT (A),0,9105674,3175128,12280802,0.000000,55408551.466400,75933614.538000,131342166.004400,0,23790,13196,36986
2016-06-01,NASDAQ BX (B),85840163,34302403,44873464,165016030,2963837458.185089,1511109884.460600,1718282122.615291,6193229465.260980,818214,146409,406202,1370825
2016-06-01,NSX (C),284700,71469,123610,479779,19257225.570000,7508344.040000,2266958.440000,29032528.050000,1462,159,676,2297
2016-06-01,NYSE (DN),133360190,36068774,79003639,248432603,4880300942.800674,1622370699.763802,2893812611.159809,9396484253.724285,559799,107482,296725,964006
2016-06-01,NASDAQ (DQ),1036177003,407357411,637762644,2081297058,32953868264.838559,18774578885.190607,19575678002.210994,71304125152.240160,3693195,879136,1996594,6568925
2016-06-01,EDGA (J),89308409,41091183,45408689,175808281,2846183143.760706,1714967984.390298,1404414744.271698,5965565872.422702,815885,203706,385594,1405185
2016-06-01,EDGX (K),212808079,99531948,159795851,472135878,6700632438.188833,4663746471.582704,5204609543.480421,16568988453.251958,1470032,419106,1008095,2897233
2016-06-01,CHX (M),6286478,8850568,3674841,18811887,240291054.475500,722528927.335700,324339469.354200,1287159451.165400,312,3565,1280,5157
2016-06-01,NYSE (N),907308144,0,0,907308144,32022625399.311529,0.000000,0.000000,32022625399.311529,3198535,0,0,3198535
2016-06-01,NYSE Arca (P),260830173,292227667,170409691,723467531,10063609071.393822,14536960958.718568,6599239031.373614,31199809061.486004,2014792,905726,1266098,4186616
2016-06-01,NASDAQ (Q),393987965,109248463,446275070,949511498,15520410994.135707,5743373018.178495,17642972268.944145,38906756281.258347,3428858,484008,2920154,6833020
2016-06-01,NASDAQ PSX (X),29549770,24030715,25696179,79276664,885720375.929000,1167507492.963700,803505304.408099,2856733173.300799,215865,105472,167497,488834
2016-06-01,BATS BYX (Y),153605966,63409597,68018690,285034253,4228794102.547580,2416500680.135101,2045891043.215199,8691185825.897880,1308366,290636,584464,2183466
2016-06-01,BATS BZX (Z),219736961,94497855,116277291,430512107,7307756765.498097,4849485615.258511,4305455568.391126,16462697949.147734,1880249,431656,968691,3280596
2016-05-31,NYSE MKT (A),0,21659139,3064699,24723838,0.000000,111626285.773200,78303121.091000,189929406.864200,0,23657,12791,36448
2016-05-31,NASDAQ BX (B),95104458,43714950,48658281,187477689,3251149217.065318,1877991176.623997,1993800681.343208,7122941075.032523,832385,180349,415465,1428199
2016-05-31,NSX (C),136176,150470,103356,390002,6502653.850000,9203390.360000,4241258.456000,19947302.666000,930,122,702,1754
2016-05-31,NYSE (DN),136128395,43819716,80175133,260123244,4830966744.975981,1928171081.081698,3037662991.244814,9796800817.302493,545621,124697,305682,976000
2016-05-31,NASDAQ (DQ),1388566606,508364734,806254514,2703185854,47506096146.170704,25753138617.355673,30085947205.289448,103345181968.815825,3699218,961637,2009821,6670676
2016-05-31,EDGA (J),101926245,49647831,49856491,201430567,3192196335.741915,2084297002.367398,1701602087.794981,6978095425.904294,873576,221659,416422,1511657
2016-05-31,EDGX (K),217441883,110802815,161249748,489494446,6547601528.584368,5456056146.625105,5409865175.830993,17413522851.040466,1408847,445467,981446,2835760
2016-05-31,CHX (M),5475785,8546867,3496343,17518995,248513269.025000,760975183.936800,274082951.305600,1283571404.267400,419,4234,862,5515
2016-05-31,NYSE (N),1466640433,0,0,1466640433,56513847364.755398,0.000000,0.000000,56513847364.755398,3272748,0,0,3272748
2016-05-31,NYSE Arca (P),259290328,345284696,176958172,781533196,9643885466.259470,17194127127.467591,7300990380.762868,34139002974.489929,1944624,968360,1269219,4182203
2016-05-31,NASDAQ (Q),408880439,129293965,735234635,1273409039,16593315128.004316,7164790038.940047,32577768293.071653,56335873460.016016,3464823,527505,3012175,7004503
2016-05-31,NASDAQ PSX (X),28472724,22953447,25396523,76822694,872814262.295900,1183936059.661199,907158313.360699,2963908635.317798,207702,105981,159798,473481
2016-05-31,BATS BYX (Y),174723081,82987231,73172845,330883157,4865690304.264534,3195160371.163095,2445764664.894009,10506615340.321638,1388605,355066,592902,2336573
2016-05-31,BATS BZX (Z),235862219,112999949,123351736,472213904,7630896569.710787,5934532796.795090,4830979054.291923,18396408420.797800,1904692,482537,987398,3374627
2016-05-27,NYSE MKT (A),0,9778068,3397460,13175528,0.000000,57028148.569200,72176202.963000,129204351.532200,0,20859,13174,34033
2016-05-27,NASDAQ BX (B),69941655,27311045,34821328,132074028,2413065793.202894,1133528873.178700,1434342506.552279,4980937172.933873,650921,118631,310237,1079789
2016-05-27,NSX (C),123707,55090,117571,296368,9498784.570000,4965436.060000,5875298.370000,20339519.000000,1021,152,918,2091
2016-05-27,NYSE (DN),107564567,32699134,64835242,205098943,3491496791.716409,1366198872.320102,2592850975.473491,7450546639.510002,422723,95407,236381,754511
2016-05-27,NASDAQ (DQ),949014995,351045903,533126046,1833186944,28044001654.073546,15745671955.523425,17768664890.385859,61558338499.982830,3020870,750358,1672865,5444093
2016-05-27,EDGA (J),75749194,32799000,38117084,146665278,2363467979.313798,1356284239.673001,1271291370.237505,4991043589.224304,677617,161729,322189,1161535
2016-05-27,EDGX (K),175136993,81446163,129294001,385877157,5064122065.488007,3729318346.908804,4424879179.067991,13218319591.464802,1137508,335076,793561,2266145
2016-05-27,CHX (M),5575108,5861984,5204545,16641637,224330920.501500,559754453.330000,378696604.896000,1162781978.727500,316,2406,808,3530
2016-05-27,NYSE (N),835846935,0,0,835846935,28625396948.134724,0.000000,0.000000,28625396948.134724,2566017,0,0,2566017
2016-05-27,NYSE Arca (P),202748373,242821904,143565024,589135301,7281914611.473147,11482232659.893307,6192765775.136646,24956913046.503100,1561752,743370,1076083,3381205
2016-05-27,NASDAQ (Q),321643209,89594186,381082635,792320030,12408996851.627189,4627023959.955709,16391848788.216485,33427869599.799383,2762574,396389,2425131,5584094
2016-05-27,NASDAQ PSX (X),23223524,14824319,20117214,58165057,685757249.955600,773062395.119400,663023622.529301,2121843267.604301,166598,62497,128317,357412
2016-05-27,BATS BYX (Y),130859425,55795577,56023147,242678149,3540816752.284912,2080038096.597896,1872906211.868812,7493761060.751620,1064270,254916,463599,1782785
2016-05-27,BATS BZX (Z),186295288,80610119,96098021,363003428,5693741336.827078,4278455826.861694,3767177272.774284,13739374436.463056,1496750,376634,780416,2653800
2016-05-26,NYSE MKT (A),0,10149108,2893876,13042984,0.000000,42394211.856900,66393902.341000,108788114.197900,0,21965,12182,34147
2016-05-26,NASDAQ BX (B),75488749,27144104,36223808,138856661,2474095020.779997,1102367958.559000,1502027572.577682,5078490551.916679,660517,121186,324208,1105911
2016-05-26,NSX (C),131731,38456,59553,229740,6172351.470000,3937386.000000,2262524.560000,12372262.030000,1011,82,458,1551
2016-05-26,NYSE (DN),124488826,34226045,68717887,227432758,4309759840.558101,1391844824.809700,2808564070.989216,8510168736.357017,476489,97969,260822,835280
2016-05-26,NASDAQ (DQ),1027915819,334073746,575382017,1937371582,30344164529.222147,14615160544.049584,19689632442.883436,64648957516.155167,3354759,756506,1796898,5908163
2016-05-26,EDGA (J),80063070,33055705,41662208,154780983,2396830433.946210,1378672295.050200,1397988936.583595,5173491665.580005,688275,163018,340207,1191500
2016-05-26,EDGX (K),187149583,82772740,139956078,409878401,5310152241.213826,3629313919.572800,4812984893.273254,13752451054.059880,1192291,340192,839259,2371742
2016-05-26,CHX (M),11856890,9185315,21563884,42606089,514812501.146800,563110426.467600,2031683989.908800,3109606917.523200,341,2739,848,3928
2016-05-26,NYSE (N),792583622,0,0,792583622,26308522612.871201,0.000000,0.000000,26308522612.871201,2791410,0,0,2791410
2016-05-26,NYSE Arca (P),221714358,235125807,156691603,613531768,7915507241.709212,10966579449.334304,6425658537.602836,25307745228.646352,1707903,748793,1143986,3600682
2016-05-26,NASDAQ (Q),353947429,90214951,380244424,824406804,13489533397.128748,4557427021.280592,15994583490.561452,34041543908.970792,2993911,396820,2540888,5931619
2016-05-26,NASDAQ PSX (X),25800463,16573512,22427042,64801017,759617072.723901,838639713.909700,802046716.121000,2400303502.754601,183109,70945,138298,392352
2016-05-26,BATS BYX (Y),134132283,52871193,58851156,245854632,3601314378.209984,1964487552.436804,2008987981.363396,7574789912.010184,1108158,244698,480371,1833227
2016-05-26,BATS BZX (Z),199736863,79629251,103389844,382755958,6153645237.478856,3924825652.869693,3952883781.561028,14031354671.909577,1597735,373692,818830,2790257
2016-05-25,NYSE MKT (A),0,10902800,3501619,14404419,0.000000,49652502.965700,81903683.474000,131556186.439700,0,24311,15443,39754
2016-05-25,NASDAQ BX (B),87507351,36206694,38586839,162300884,2935686041.918398,1515355834.727500,1597008126.607698,6048050003.253596,761521,162016,354855,1278392
2016-05-25,NSX (C),150201,110457,162384,423042,7845839.877900,12404965.959000,4553824.593200,24804630.430100,1128,236,860,2224
2016-05-25,NYSE (DN),143570294,39289665,67449433,250309392,5201265659.726897,1698275907.182303,2752376934.121787,9651918501.030987,550710,122083,271333,944126
2016-05-25,NASDAQ (DQ),1254250351,457888050,662203960,2374342361,37123064781.517256,21151209602.077795,22445487547.810927,80719761931.405978,3922793,959373,1979543,6861709
2016-05-25,EDGA (J),98108878,44324570,47070430,189503878,2886530468.993494,1762935012.104701,1479092200.733286,6128557681.831481,832349,206033,388947,1427329
2016-05-25,EDGX (K),225784873,99973079,156429712,482187664,6422342365.500423,4638375219.308697,5206659988.554948,16267377573.364068,1398652,404653,932906,2736211
2016-05-25,CHX (M),16377955,12433290,6453902,35265147,607300936.792000,746500676.500000,492750203.069800,1846551816.361800,331,3463,1251,5045
2016-05-25,NYSE (N),913103130,0,0,913103130,30190425810.059256,0.000000,0.000000,30190425810.059256,3042524,0,0,3042524
2016-05-25,NYSE Arca (P),268860436,310759090,173897496,753517022,9436652676.590836,15174902863.952882,6985438018.483720,31596993559.027438,1957136,908291,1241826,4107253
2016-05-25,NASDAQ (Q),416905109,113054124,418360939,948320172,16076126407.860713,5991443593.494202,17854967950.064173,39922537951.419088,3438771,489325,2860164,6788260
2016-05-25,NASDAQ PSX (X),32795021,19825601,26912537,79533159,932289942.287298,1091861848.468999,923610865.358800,2947762656.115097,229724,86237,174724,490685
2016-05-25,BATS BYX (Y),163809616,67151029,68005939,298966584,4304221245.688780,2523314976.603100,2197474157.371335,9025010379.663215,1274433,286763,557336,2118532
2016-05-25,BATS BZX (Z),241193312,100687085,117958452,459838849,7337202686.778094,5118997948.744395,4508212849.829999,16964413485.352488,1896394,440119,968506,3305019
2016-05-24,NYSE MKT (A),0,11079645,2810170,13889815,0.000000,53037679.783200,68706767.066000,121744446.849200,0,25709,13210,38919
2016-05-24,NASDAQ BX (B),81985807,33506942,41460865,156953614,2760497165.382883,1487697393.416902,1605834575.076993,5854029133.876778,724063,155557,356918,1236538
2016-05-24,NSX (C),196988,100936,136965,434889,6565358.800000,9410942.220000,3925755.386700,19902056.406700,1290,156,900,2346
2016-05-24,NYSE (DN),138797302,45938206,78123024,262858532,4925379734.932407,1874520693.889900,2853754969.458181,9653655398.280488,517871,130838,278119,926828
2016-05-24,NASDAQ (DQ),1147818824,504365735,712288720,2364473279,35069212263.699901,23562354364.517650,21793464276.011511,80425030904.229062,3694266,960742,2018196,6673204
2016-05-24,EDGA (J),92551686,42734538,52511691,187797915,2803320465.581797,1824459425.104900,1566192981.783193,6193972872.469890,812362,212885,406043,1431290
2016-05-24,EDGX (K),212201212,105157333,184935750,502294295,6288993805.839488,4935986931.260215,5531534804.431255,16756515541.530958,1347362,426853,995036,2769251
2016-05-24,CHX (M),11470214,9643607,7657454,28771275,413643075.510200,655752227.302500,463852938.351700,1533248241.164400,613,4192,1241,6046
2016-05-24,NYSE (N),889011949,0,0,889011949,29789111689.924749,0.000000,0.000000,29789111689.924749,2989088,0,0,2989088
2016-05-24,NYSE Arca (P),255500985,338541465,188467426,782509876,9261976312.239017,16788385479.796044,7008431344.140977,33058793136.176038,1910378,902095,1281071,4093544
2016-05-24,NASDAQ (Q),395151831,117244051,458134276,970530158,15487136012.900353,6302469997.283099,18613259547.954949,40402865558.138401,3361895,507988,2946951,6816834
2016-05-24,NASDAQ PSX (X),30699814,21754685,26848204,79302703,876227016.538001,1199614783.764001,892163180.710098,2968004981.012100,217947,92016,169296,479259
2016-05-24,BATS BYX (Y),150552542,68513743,69213312,288279597,4057893150.219871,2647161024.771901,2166958146.544410,8872012321.536182,1246823,314940,563249,2125012
2016-05-24,BATS BZX (Z),224130952,103340653,121388439,448860044,6957885360.866081,5434815564.434100,4524308860.584859,16917009785.885040,1800759,459898,981077,3241734
2016-05-23,NYSE MKT (A),0,9558748,3005832,12564580,0.000000,52263500.890200,74370926.401000,126634427.291200,0,22057,13813,35870
2016-05-23,NASDAQ BX (B),71549676,25412450,38887976,135850102,2343166011.591094,1025182774.608601,1456836383.672401,4825185169.872096,633449,108975,315112,1057536
2016-05-23,NSX (C),197195,9829,94417,301441,7372563.540000,641808.630000,3475043.330000,11489415.500000,1002,38,692,1732
2016-05-23,NYSE (DN),101651163,34009348,73840161,209500672,3630999518.625623,1429715436.394899,2373594817.351889,7434309772.372411,409687,97084,261720,768491
2016-05-23,NASDAQ (DQ),932372180,347211790,693306611,1972890581,28066170263.757346,15444878143.108829,18439747380.304654,61950795787.170829,3082601,759347,1820255,5662203
2016-05-23,EDGA (J),75778815,32157532,51336906,159273253,2321934299.600808,1312224087.618999,1359071779.119408,4993230166.339215,676953,157338,355709,1190000
2016-05-23,EDGX (K),176813164,82271555,178265262,437349981,5080906060.816696,3641722799.346688,4572633044.052264,13295261904.215648,1161388,343674,882416,2387478
2016-05-23,CHX (M),6358618,9802283,2819865,18980766,244536927.981000,581393519.498100,192142030.567800,1018072478.046900,385,2400,675,3460
2016-05-23,NYSE (N),819367361,0,0,819367361,27295971951.407510,0.000000,0.000000,27295971951.407510,2640058,0,0,2640058
2016-05-23,NYSE Arca (P),207979602,244553988,188372300,640905890,7377912032.974245,11609600441.619981,6112322783.177275,25099835257.771501,1585827,730053,1180940,3496820
2016-05-23,NASDAQ (Q),326727255,88327893,431572492,846627640,12527428775.784529,4421700806.729300,16073830355.859045,33022959938.372874,2784937,402436,2569126,5756499
2016-05-23,NASDAQ PSX (X),25467936,14585308,27977379,68030623,739434891.539300,765063265.183199,767667609.177700,2272165765.900199,183955,64103,145809,393867
2016-05-23,BATS BYX (Y),127331399,53085087,63979774,244396260,3392094908.576617,1960980317.961397,1861920359.279489,7214995585.817503,1037821,236607,488473,1762901
2016-05-23,BATS BZX (Z),186397121,80302928,114285971,380986020,5725377453.951276,4055133453.918192,3721943786.096370,13502454693.965838,1524460,370470,878091,2773021
2016-05-20,NYSE MKT (A),0,14266733,3320500,17587233,0.000000,67884288.285300,103104675.586000,170988963.871300,0,20007,16530,36537
2016-05-20,NASDAQ BX (B),84201183,28922998,41282795,154406976,2945302729.746297,1236445138.242799,1577351695.057500,5759099563.046596,759295,126696,363348,1249339
2016-05-20,NSX (C),206779,24457,77028,308264,7151762.830000,645396.470000,2578043.965800,10375203.265800,870,52,412,1334
2016-05-20,NYSE (DN),117896857,38025824,73277439,229200120,4133496638.857711,1730212832.789803,2730792681.932103,8594502153.579617,471532,109458,268185,849175
2016-05-20,NASDAQ (DQ),1080960869,414812326,710022321,2205795516,32465944226.529076,21538519524.844473,21265587587.731247,75270051339.104796,3270922,788720,1895096,5954738
2016-05-20,EDGA (J),86165683,37260466,50483174,173909323,2662697646.518093,1575765949.297500,1479750162.272003,5718213758.087596,767030,182641,379602,1329273
2016-05-20,EDGX (K),186285171,95845785,167299029,449429985,5477969713.366885,4692531262.610597,4986084564.440792,15156585540.418274,1237656,414061,944596,2596313
2016-05-20,CHX (M),10089993,15875522,5083688,31049203,403670848.646400,1608478258.030000,386083664.095000,2398232770.771400,266,3429,1459,5154
2016-05-20,NYSE (N),976349439,0,0,976349439,36129702593.191058,0.000000,0.000000,36129702593.191058,2959817,0,0,2959817
2016-05-20,NYSE Arca (P),232142671,288815929,189836253,710794853,8758943016.621526,15321450896.664464,7218258228.639080,31298652141.925070,1781507,850592,1292652,3924751
2016-05-20,NASDAQ (Q),361664772,102532273,513462305,977659350,14611814713.880417,5734187071.236818,20784954830.328592,41130956615.445827,3153385,461095,2837132,6451612
2016-05-20,NASDAQ PSX (X),27046840,18452869,24699018,70198727,810648696.806800,1148153359.582200,828728402.187897,2787530458.576897,197013,77848,157245,432106
2016-05-20,BATS BYX (Y),144347106,62208850,68608028,275163984,4046671315.624818,2374925312.651205,2118438769.425597,8540035397.701620,1222688,278258,562039,2062985
2016-05-20,BATS BZX (Z),213152783,98697430,125312389,437162602,6789157432.250328,5379247146.771901,4705322626.858528,16873727205.880757,1745166,465838,985136,3196140
2016-05-19,NYSE MKT (A),0,11179977,2835962,14015939,0.000000,55254699.158100,66754041.461000,122008740.619100,0,25477,13971,39448
2016-05-19,NASDAQ BX (B),87401777,38208337,40764828,166374942,2974529261.444608,1594828617.228697,1476510385.421298,6045868264.094603,789120,182852,350084,1322056
2016-05-19,NSX (C),219158,35433,171765,426356,8233496.367000,744952.670000,2603574.462700,11582023.499700,1054,72,618,1744
2016-05-19,NYSE (DN),142363628,52412506,69092572,263868706,4972836074.819892,2219472972.871602,2530706305.029990,9723015352.721484,555623,137017,268863,961503
2016-05-19,NASDAQ (DQ),1150622187,519320141,632059270,2302001598,33902859861.526980,23517920701.681294,19365906798.573840,76786687361.782114,3853931,1106999,1853959,6814889
2016-05-19,EDGA (J),94730486,50237695,47333341,192301522,2755129821.471407,2123656842.928501,1359628952.687300,6238415617.087208,819926,244978,363926,1428830
2016-05-19,EDGX (K),233987145,139914115,166984109,540885369,6674012472.389492,6667458495.068783,5057712177.224929,18399183144.683204,1521123,598491,987729,3107343
2016-05-19,CHX (M),17684740,15356078,6661881,39702699,752665730.583600,872333939.960000,491951265.207000,2116950935.750600,454,5585,1517,7556
2016-05-19,NYSE (N),949884522,0,0,949884522,30880238061.120602,0.000000,0.000000,30880238061.120602,3470789,0,0,3470789
2016-05-19,NYSE Arca (P),288393888,397688754,189545950,875628592,10345232901.712388,19481973074.962240,7191062371.801651,37018268348.476279,2176751,1225135,1362344,4764230
2016-05-19,NASDAQ (Q),434198807,154689957,435570679,1024459443,16591836661.473885,8224640173.422511,16799759983.892314,41616236818.788710,3700085,693864,2994660,7388609
2016-05-19,NASDAQ PSX (X),32526686,27489025,26570860,86586571,943802979.961399,1564442890.377201,850786185.047300,3359032055.385900,226512,112508,164996,504016
2016-05-19,BATS BYX (Y),162943626,82393740,68305701,313643067,4335894580.614905,3018137878.588591,2084474754.828089,9438507214.031585,1355693,373612,564157,2293462
2016-05-19,BATS BZX (Z),254846529,137864961,122296990,515008480,7801929517.460387,7455993767.843078,4364489894.388467,19622413179.691932,2034613,646068,997003,3677684
2016-05-18,NYSE MKT (A),0,14348396,3502683,17851079,0.000000,81781161.428800,81560868.228000,163342029.656800,0,27405,15591,42996
2016-05-18,NASDAQ BX (B),91866233,47242604,43231219,182340056,3044201587.006697,1933688222.751200,1553126148.719700,6531015958.477597,822143,197150,366040,1385333
2016-05-18,NSX (C),108069,20978,144274,273321,4703722.630000,840795.460000,2533586.245300,8078104.335300,699,124,625,1448
2016-05-18,NYSE (DN),146336132,60435757,69580913,276352802,4989211568.048368,2545873177.094004,2825155383.736289,10360240128.878661,577848,163327,273206,1014381
2016-05-18,NASDAQ (DQ),1218065856,671569846,665482056,2555117758,36570914392.397810,27669240276.471222,20951817366.064079,85191972034.933111,3853450,1189264,1956054,6998768
2016-05-18,EDGA (J),107516458,67949733,47892025,223358216,3200999760.724013,2724246895.396895,1412916298.646900,7338162954.767808,926186,301668,379053,1606907
2016-05-18,EDGX (K),286779706,172243184,178615182,637638072,8075026408.665931,7605618131.063406,5681081540.762072,21361726080.491409,1857719,698001,1058295,3614015
2016-05-18,CHX (M),39373758,13665403,3840608,56879769,1522391967.021000,1105806115.880000,246993891.987500,2875191974.888500,587,5522,1447,7556
2016-05-18,NYSE (N),779802688,0,0,779802688,26489423585.911420,0.000000,0.000000,26489423585.911420,2631457,0,0,2631457
2016-05-18,NYSE Arca (P),346835649,492314449,208655812,1047805910,12504431492.616740,23046949383.766563,8377651649.848553,43929032526.231856,2639461,1363658,1456189,5459308
2016-05-18,NASDAQ (Q),557307868,190502267,475758430,1223568565,21545910496.200576,9889928831.927233,19637059738.288833,51072899066.416642,4724263,829736,3281821,8835820
2016-05-18,NASDAQ PSX (X),37003059,31293670,29463592,97760321,1091910599.965202,1803245475.400698,928951590.025602,3824107665.391502,244949,123498,171089,539536
2016-05-18,BATS BYX (Y),173556897,100294515,71923460,345774872,4716162286.598183,3560052782.767895,2200141439.583713,10476356508.949791,1448538,426683,590080,2465301
2016-05-18,BATS BZX (Z),320087992,167160374,137787212,625035578,9978792338.155631,8538933230.366242,5125633933.021705,23643359501.543578,2588467,745650,1105996,4440113
2016-05-17,NYSE MKT (A),0,14118307,3521862,17640169,0.000000,84061657.025500,88924678.871000,172986335.896500,0,29848,17544,47392
2016-05-17,NASDAQ BX (B),92969154,36568969,42714028,172252151,3303989422.846708,1519687992.783800,1667354444.523215,6491031860.153723,831568,153081,380641,1365290
2016-05-17,NSX (C),147774,69504,300083,517361,7267658.400000,527891.130000,5960278.862800,13755828.392800,1008,85,1133,2226
2016-05-17,NYSE (DN),139149795,53719499,69968078,262837372,5031870063.892890,1965415006.662205,2861629790.223694,9858914860.778789,568674,135342,276173,980189
2016-05-17,NASDAQ (DQ),1234316237,547826576,667133003,2449275816,40099370007.304725,22040096357.221205,22114720478.418484,84254186842.944414,3954139,1039648,2018532,7012319
2016-05-17,EDGA (J),100399772,48352377,47031748,195783897,3093351769.965214,2067315547.555198,1468068169.959797,6628735487.480209,882443,230120,385697,1498260
2016-05-17,EDGX (K),242807936,139195364,176798541,558801841,7151522472.682480,6197594578.660412,5808118503.695179,19157235555.038071,1607111,528710,1093873,3229694
2016-05-17,CHX (M),28261144,8036685,4465682,40763511,1154023883.071800,640117894.203800,680537362.775700,2474679140.051300,904,3842,1059,5805
2016-05-17,NYSE (N),1057479369,0,0,1057479369,41239786690.157065,0.000000,0.000000,41239786690.157065,3501566,0,0,3501566
2016-05-17,NYSE Arca (P),295978615,349659160,189869264,835507039,11182919746.457965,18682237492.652434,7892835591.575868,37757992830.686267,2214285,1022229,1420983,4657497
2016-05-17,NASDAQ (Q),451227050,137787735,495174002,1084188787,17900097220.591379,7387624841.656678,21446936073.636037,46734658135.884094,3859687,609193,3214791,7683671
2016-05-17,NASDAQ PSX (X),34791157,24969693,28646403,88407253,1083260320.848900,1448922527.092300,958684781.866600,3490867629.807800,250885,98746,191109,540740
2016-05-17,BATS BYX (Y),168592351,77513625,70790532,316896508,4751347678.875685,2918258895.436997,2289349961.026751,9958956535.339433,1448290,350802,607295,2406387
2016-05-17,BATS BZX (Z),264350815,125456708,130046083,519853606,8190845983.306270,6930745736.379897,4956404881.323557,20077996601.009724,2160298,564957,1113907,3839162
2016-05-16,NYSE MKT (A),0,15185789,3641622,18827411,0.000000,62258077.633400,85968378.113000,148226455.746400,0,32079,14362,46441
2016-05-16,NASDAQ BX (B),75046563,31860597,37290182,144197342,2634774019.826099,1204218181.112200,1492736427.018399,5331728627.956698,676181,132580,335830,1144591
2016-05-16,NSX (C),72871,68566,133022,274459,3407617.580000,1002889.890000,5517587.430000,9928094.900000,503,112,785,1400
2016-05-16,NYSE (DN),121693666,47510525,68611410,237815601,4312032244.050615,1576183733.334803,2932904971.584469,8821120948.969887,500680,119515,277085,897280
2016-05-16,NASDAQ (DQ),1120479123,479734799,622537648,2222751570,33469440416.816182,17447390172.741381,21794239935.986943,72711070525.544506,3736982,954632,1993936,6685550
2016-05-16,EDGA (J),82400389,40169520,40761264,163331173,2557068259.303495,1552146614.963702,1354330022.459902,5463544896.727099,734076,190385,332094,1256555
2016-05-16,EDGX (K),207250590,108671731,152782858,468705179,5877035527.057943,4345814856.433806,5420432850.325119,15643283233.816868,1370824,407067,953801,2731692
2016-05-16,CHX (M),22313300,7953924,4638670,34905894,1038514576.230000,632207231.946000,497394726.130000,2168116534.306000,261,3368,814,4443
2016-05-16,NYSE (N),883615249,0,0,883615249,29576293632.666531,0.000000,0.000000,29576293632.666531,3016096,0,0,3016096
2016-05-16,NYSE Arca (P),241458153,303672003,178575723,723705879,8778489685.032554,14851506250.495090,7775380642.563962,31405376578.091606,1851438,851447,1287324,3990209
2016-05-16,NASDAQ (Q),365871569,108998755,437323630,912193954,14266650207.347709,5440129736.135416,18541780201.122421,38248560144.605546,3152653,475599,2885453,6513705
2016-05-16,NASDAQ PSX (X),29604105,19946855,22712478,72263438,848839517.612599,982472238.082200,775269282.192200,2606581037.886999,207451,78204,149823,435478
2016-05-16,BATS BYX (Y),136238366,63249210,61827063,261314639,3866438063.650968,2225836583.815190,2023151361.900809,8115426009.366967,1208965,280768,537866,2027599
2016-05-16,BATS BZX (Z),220410276,98529121,112788839,431728236,6778480924.357578,4992497367.712296,4449223058.949409,16220201351.019283,1852338,458162,971035,3281535
2016-05-13,NYSE MKT (A),0,12423559,3237431,15660990,0.000000,51626735.363400,78934695.860000,130561431.223400,0,25551,15219,40770
2016-05-13,NASDAQ BX (B),90295372,37439155,41396908,169131435,3100352289.663618,1487634322.052199,1548840889.413395,6136827501.129212,828695,156391,365471,1350557
2016-05-13,NSX (C),109504,16532,301051,427087,4173707.147000,989624.125800,3268464.067800,8431795.340600,684,117,1078,1879
2016-05-13,NYSE (DN),128661273,48299879,62991650,239952802,4403124591.068519,1834563165.880000,2487972523.813810,8725660280.762329,512872,116658,246508,876038
2016-05-13,NASDAQ (DQ),1084601840,465674304,595960333,2146236477,33752476416.332836,19070873904.021103,20135506856.606327,72958857176.960266,3637348,920721,1804482,6362551
2016-05-13,EDGA (J),86577188,42993443,41891548,171462179,2537497977.780481,1754528297.461597,1272680690.068005,5564706965.310083,747765,190428,335577,1273770
2016-05-13,EDGX (K),211418353,111319029,148523577,471260959,6109252304.657994,5073429496.800702,4889155500.719416,16071837302.178112,1394842,443175,930539,2768556
2016-05-13,CHX (M),20154930,8855380,4394628,33404938,924668734.886600,681136603.988000,337556065.552300,1943361404.426900,542,3323,995,4860
2016-05-13,NYSE (N),879314518,0,0,879314518,29568882316.824795,0.000000,0.000000,29568882316.824795,3119857,0,0,3119857
2016-05-13,NYSE Arca (P),262140191,319994343,164339108,746473642,9452600789.188652,16566171727.341123,6566995151.341366,32585767667.871141,1974331,964387,1236827,4175545
2016-05-13,NASDAQ (Q),400272027,125480612,432851351,958603990,15348759661.453372,6510989647.050208,17117752200.457036,38977501508.960616,3381916,542251,2872755,6796922
2016-05-13,NASDAQ PSX (X),30754185,24191977,24655510,79601672,860783523.367099,1340243753.281798,794250712.837902,2995277989.486799,211801,92702,152420,456923
2016-05-13,BATS BYX (Y),152513582,72073128,62917983,287504693,4195240902.570493,2599211805.410191,1955863539.220110,8750316247.200794,1266422,318311,537881,2122614
2016-05-13,BATS BZX (Z),239785309,111903541,118444242,470133092,7441818670.270085,5792773343.516208,4437972357.040116,17672564370.826409,1936283,515753,984672,3436708
2016-05-12,NYSE MKT (A),0,14695912,3359660,18055572,0.000000,60718832.516100,64121696.327000,124840528.843100,0,29648,13366,43014
2016-05-12,NASDAQ BX (B),84964432,34045529,42684710,161694671,2897331874.919484,1429165161.484100,1618833521.388713,5945330557.792297,756290,145477,370258,1272025
2016-05-12,NSX (C),135340,70003,123980,329323,5637502.042300,984128.760000,4123275.820000,10744906.622300,1017,97,906,2020
2016-05-12,NYSE (DN),133583290,49248022,77556037,260387349,4691304212.867092,1773931727.083803,3097623115.485386,9562859055.436281,520888,114924,291454,927266
2016-05-12,NASDAQ (DQ),1147250272,503101263,687765737,2338117272,38032148869.079976,18185463992.514065,24174336665.844618,80391949527.438659,3780728,904447,2077169,6762344
2016-05-12,EDGA (J),92009735,42740345,47040915,181790995,2638369788.487993,1681134144.537199,1364929601.897900,5684433534.923092,769661,191146,353931,1314738
2016-05-12,EDGX (K),232915909,123672722,180460638,537049269,6703330484.507826,5178085581.412416,6040848876.894218,17922264942.814460,1522588,467887,1073912,3064387
2016-05-12,CHX (M),16158832,11857971,4067468,32084271,664312626.464400,1184866860.625000,270680505.834500,2119859992.923900,367,3552,1295,5214
2016-05-12,NYSE (N),948762083,0,0,948762083,31445731663.802506,0.000000,0.000000,31445731663.802506,3238847,0,0,3238847
2016-05-12,NYSE Arca (P),285562702,343269109,198414195,827246006,10317749009.326185,16352732646.667869,7850293779.003444,34520775434.997498,2124968,988487,1413616,4527071
2016-05-12,NASDAQ (Q),421178747,131104074,470616961,1022899782,16207182886.612371,6710569394.306505,18632252933.966256,41550005214.885132,3535130,563271,3081696,7180097
2016-05-12,NASDAQ PSX (X),32847036,22945994,25751991,81545021,919378285.378101,1337188911.073900,911901579.243601,3168468775.695602,230548,89349,169262,489159
2016-05-12,BATS BYX (Y),159937285,68242455,69729520,297909260,4298766836.519719,2477920286.785201,2128713156.642020,8905400279.946940,1310216,297506,566466,2174188
2016-05-12,BATS BZX (Z),245604055,116689438,130093579,492387072,7373981858.378943,5911039768.180110,4838706813.052598,18123728439.611651,1947487,531071,1036628,3515186
2016-05-11,NYSE MKT (A),0,11324807,3403036,14727843,0.000000,57454424.279000,84109192.654000,141563616.933000,0,23497,15170,38667
2016-05-11,NASDAQ BX (B),82582057,33116276,39273372,154971705,2743106306.699797,1246738184.852798,1550003356.056394,5539847847.608989,718689,137251,340906,1196846
2016-05-11,NSX (C),210023,162406,227514,599943,7470642.971000,827229.541700,9520611.801700,17818484.314400,1344,456,1038,2838
2016-05-11,NYSE (DN),141332366,49168996,76503049,267004411,5027113226.731031,1746447072.250004,2971350044.668908,9744910343.649943,538905,115426,292433,946764
2016-05-11,NASDAQ (DQ),1206347338,544093263,686074719,2436515320,34772513587.617332,21242278205.594209,22108061895.714857,78122853688.926398,3911485,929464,2005568,6846517
2016-05-11,EDGA (J),89573016,42067713,42217213,173857942,2603554268.912006,1643829123.632700,1254836251.018903,5502219643.563609,771459,187967,330200,1289626
2016-05-11,EDGX (K),227257950,112939881,161299449,501497280,6445539229.571849,4943040949.037110,5386373646.175693,16774953824.784652,1460051,414277,954621,2828949
2016-05-11,CHX (M),27087051,16936245,6993843,51017139,1086477093.723800,1245263338.940000,233124045.641000,2564864478.304800,375,3344,797,4516
2016-05-11,NYSE (N),946129512,0,0,946129512,31726421228.923448,0.000000,0.000000,31726421228.923448,3149773,0,0,3149773
2016-05-11,NYSE Arca (P),269246054,306371668,196871969,772489691,9526682022.261720,14410486471.603085,6952032392.807986,30889200886.672791,1952870,851174,1280272,4084316
2016-05-11,NASDAQ (Q),405804999,112575674,436676296,955056969,15462086405.578646,5847165975.005090,17721523285.987301,39030775666.571037,3378401,470674,2823477,6672552
2016-05-11,NASDAQ PSX (X),31469514,19366099,25196410,76032023,855790481.881900,1051982632.486701,806578041.482198,2714351155.850799,216110,78854,150740,445704
2016-05-11,BATS BYX (Y),150351853,65977199,66102398,282431450,4093206247.480315,2251278216.799009,2023279283.761765,8367763748.041089,1253288,277931,542995,2074214
2016-05-11,BATS BZX (Z),246330704,106825019,120489219,473644942,7354198332.122498,5252398609.695805,4432229780.711507,17038826722.529810,1960119,469509,958350,3387978
2016-05-10,NYSE MKT (A),0,9544098,2419945,11964043,0.000000,45347130.822200,69943522.436000,115290653.258200,0,20311,12441,32752
2016-05-10,NASDAQ BX (B),83258249,33258433,38661129,155177811,2731847618.590301,1365583381.296500,1510243808.984093,5607674808.870894,729039,137442,348511,1214992
2016-05-10,NSX (C),147138,190786,270765,608689,5040036.090000,1462184.074100,3452475.242400,9954695.406500,883,585,702,2170
2016-05-10,NYSE (DN),146204050,44386885,76418655,267009590,4919188660.080385,1559574902.883792,3105714771.213991,9584478334.178168,569997,110608,300517,981122
2016-05-10,NASDAQ (DQ),1163027804,488865925,645614070,2297507799,33731443200.978771,18704650752.315051,21640954485.554569,74077048438.848391,3897103,865924,2016455,6779482
2016-05-10,EDGA (J),89731629,40031024,40205575,169968228,2678557799.567696,1619467727.413698,1318000464.553307,5616025991.534701,780470,172253,339900,1292623
2016-05-10,EDGX (K),210055695,102746854,158511446,471313995,6394483562.498203,4479341351.485795,5515843563.996861,16389668477.980859,1402527,385517,997390,2785434
2016-05-10,CHX (M),13568108,14914625,4019075,32501808,561394712.855700,1070237471.416000,366259018.084000,1997891202.355700,332,2687,905,3924
2016-05-10,NYSE (N),854913549,0,0,854913549,28972393203.762530,0.000000,0.000000,28972393203.762530,3037690,0,0,3037690
2016-05-10,NYSE Arca (P),264558877,309008684,175020710,748588271,9802501608.505384,14960144396.362274,6870039356.522739,31632685361.390397,1934301,820578,1283983,4038862
2016-05-10,NASDAQ (Q),377909659,103007030,418154805,899071494,14975988644.673410,5389592321.533811,17081865782.499475,37447446748.706696,3205585,430900,2946959,6583444
2016-05-10,NASDAQ PSX (X),28257231,19317623,23579691,71154545,809131736.302299,1016914697.293901,780893466.370598,2606939899.966798,204510,74630,153338,432478
2016-05-10,BATS BYX (Y),145091340,61959303,62655721,269706364,3983922865.164858,2248136138.616095,2022831429.017309,8254890432.798262,1257361,256918,545394,2059673
2016-05-10,BATS BZX (Z),229282144,99738629,116477717,445498490,7226487328.306262,5036142902.569694,4310719306.076586,16573349536.952542,1912406,442480,967665,3322551
2016-05-09,NYSE MKT (A),0,10433536,2512848,12946384,0.000000,52483116.342700,63421804.021000,115904920.363700,0,21873,12164,34037
2016-05-09,NASDAQ BX (B),88914014,39755455,37475976,166145445,2895624618.546200,1438639230.429500,1471283137.614103,5805546986.589803,775158,158444,354135,1287737
2016-05-09,NSX (C),150664,31377,196042,378083,8114743.429800,567907.795000,4808654.660700,13491305.885500,1125,86,1091,2302
2016-05-09,NYSE (DN),146400264,47738751,61842830,255981845,4583804317.710721,1577286824.148996,2620881865.008894,8781973006.868611,550696,118917,256779,926392
2016-05-09,NASDAQ (DQ),1188048948,505479021,559578875,2253106844,32904052833.553847,19345714133.143790,18647176224.738085,70896943191.435722,3818369,958931,1856440,6633740
2016-05-09,EDGA (J),92389020,45732910,38265275,176387205,2658890257.612498,1694711837.153102,1232595487.010200,5586197581.775800,801466,196671,328659,1326796
2016-05-09,EDGX (K),222876357,112372057,152856514,488104928,6265289574.540617,4474155275.170110,5002516454.564300,15741961304.275027,1459610,433588,978150,2871348
2016-05-09,CHX (M),15648574,11040335,4726454,31415363,629146823.026000,613486550.842000,159329801.243000,1401963175.111000,664,2845,707,4216
2016-05-09,NYSE (N),966279882,0,0,966279882,31397480095.931001,0.000000,0.000000,31397480095.931001,3158997,0,0,3158997
2016-05-09,NYSE Arca (P),270346812,348107308,167409372,785863492,8742429486.519213,15462515251.825364,6471662665.594430,30676607403.939007,1896584,897155,1260148,4053887
2016-05-09,NASDAQ (Q),387290174,113808453,415488335,916586962,13995521457.894463,5421226869.489715,16912968940.363552,36329717267.747730,3216517,484645,2826484,6527646
2016-05-09,NASDAQ PSX (X),29758040,20900522,20841216,71499778,809819451.728898,1014048433.306900,686243598.351700,2510111483.387498,214546,80740,145243,440529
2016-05-09,BATS BYX (Y),152294999,71417862,57887695,281600556,3977818201.487429,2359531627.363596,1824610787.324508,8161960616.175533,1306122,297839,514241,2118202
2016-05-09,BATS BZX (Z),231617696,106840479,108465001,446923176,6812298171.293126,4891762889.001589,3935421612.819774,15639482673.114489,1918630,475792,940434,3334856
2016-05-06,NYSE MKT (A),0,11535141,3828462,15363603,0.000000,60712189.046600,130473671.220000,191185860.266600,0,22861,14169,37030
2016-05-06,NASDAQ BX (B),84250890,38936509,41760606,164948005,2808874750.528928,1469695429.951404,1632343653.550096,5910913834.030428,735561,155570,379671,1270802
2016-05-06,NSX (C),113249,15180,98146,226575,5893646.220000,324673.028800,2970609.747200,9188928.996000,937,111,609,1657
2016-05-06,NYSE (DN),149109090,54255868,78978020,282342978,5470048041.965387,1939470874.415500,3372124975.796300,10781643892.177187,563732,126477,311776,1001985
2016-05-06,NASDAQ (DQ),1137421954,522964968,657669690,2318056612,34544617190.572906,19559868680.976671,22712196432.395080,76816682303.944657,3952415,933396,2165471,7051282
2016-05-06,EDGA (J),92883622,44919625,43537342,181340589,2702359064.641503,1757044738.222299,1410586478.906003,5869990281.769805,804535,191769,363614,1359918
2016-05-06,EDGX (K),229478008,121016362,168848099,519342469,6642021095.167524,5279072430.855014,5664546435.303843,17585639961.326381,1504370,460954,1073183,3038507
2016-05-06,CHX (M),22382184,9119923,4533393,36035500,1022162286.355700,907207776.559000,307774396.794500,2237144459.709200,576,4056,1121,5753
2016-05-06,NYSE (N),970497932,0,0,970497932,31494136934.486860,0.000000,0.000000,31494136934.486860,3343281,0,0,3343281
2016-05-06,NYSE Arca (P),277619901,348608967,187531101,813759969,9776795412.923493,16509955943.950101,7483128122.048400,33769879478.921994,2080734,952559,1406611,4439904
2016-05-06,NASDAQ (Q),406654256,125460516,463878137,995992909,15524028736.860480,6716331822.046714,18687274948.695043,40927635507.602237,3434967,536915,3161299,7133181
2016-05-06,NASDAQ PSX (X),29472062,20894491,22834400,73200953,811428064.483301,1188308004.627901,773752469.832698,2773488538.943900,215099,83276,150911,449286
2016-05-06,BATS BYX (Y),154154256,73034470,65188081,292376807,4091377514.728711,2501053615.231303,2054261813.572422,8646692943.532436,1293472,308148,561563,2163183
2016-05-06,BATS BZX (Z),243880384,114868845,122972396,481721625,7342643354.696776,5696413508.834893,4701274555.252787,17740331418.784456,1990874,504308,1039738,3534920
2016-05-05,NYSE MKT (A),0,17482634,4187997,21670631,0.000000,99867034.528600,144388603.512000,244255638.040600,0,24220,16488,40708
2016-05-05,NASDAQ BX (B),93564927,37296807,42552604,173414338,3206346385.869200,1353476516.706101,1699543619.659394,6259366522.234695,831079,157085,389694,1377858
2016-05-05,NSX (C),118229,75590,67726,261545,4640844.460000,2325889.220000,2118849.505000,9085583.185000,741,245,449,1435
2016-05-05,NYSE (DN),159631808,53121376,77130545,289883729,5412972440.012089,1814114996.565494,3323001150.721389,10550088587.298972,593448,130382,307638,1031468
2016-05-05,NASDAQ (DQ),1244273375,527840704,670053469,2442167548,36305124802.593247,19997849836.228828,22100786633.415584,78403761272.237659,4004994,970569,2127279,7102842
2016-05-05,EDGA (J),97298441,44176056,45277354,186751851,2921488781.934504,1681750262.672000,1364690137.804607,5967929182.411111,842344,195257,364417,1402018
2016-05-05,EDGX (K),244593895,118361939,175519085,538474919,6976537971.009135,4972677706.319710,5757654720.407356,17706870397.736201,1613345,460230,1085765,3159340
2016-05-05,CHX (M),20744144,11023151,4951314,36718609,853937853.039000,672320981.747500,384099305.170400,1910358139.956900,710,3025,812,4547
2016-05-05,NYSE (N),976412662,0,0,976412662,31925881640.954435,0.000000,0.000000,31925881640.954435,3467173,0,0,3467173
2016-05-05,NYSE Arca (P),301568499,342446827,193933581,837948907,10425285123.378765,14964396020.528259,7268523215.105376,32658204359.012400,2217420,934931,1406977,4559328
2016-05-05,NASDAQ (Q),433755404,126147924,466895226,1026798554,16646799965.161781,6214488604.286614,19093610682.745701,41954899252.194096,3677965,531016,3216465,7425446
2016-05-05,NASDAQ PSX (X),33526511,23169984,24664638,81361133,921999295.776099,1184432588.493601,798980596.664200,2905412480.933900,235782,90771,161933,488486
2016-05-05,BATS BYX (Y),160112862,71530229,65629780,297272871,4439294158.335208,2442161331.038993,2138140089.019299,9019595578.393500,1346707,300607,566507,2213821
2016-05-05,BATS BZX (Z),246036492,112009219,120785496,478831207,7486588184.359231,5145196425.141991,4549676871.758369,17181461481.259591,2021167,491071,1021570,3533808
2016-05-04,NYSE MKT (A),0,13075208,4355520,17430728,0.000000,69228172.705100,140750646.705000,209978819.410100,0,25485,18796,44281
2016-05-04,NASDAQ BX (B),97559758,45357780,46409271,189326809,3365365829.542503,1681511188.447502,1859249906.536603,6906126924.526608,884574,187915,426908,1499397
2016-05-04,NSX (C),241755,24664,137040,403459,11877434.190000,629156.050000,4338951.168900,16845541.408900,1852,116,982,2950
2016-05-04,NYSE (DN),146180280,56199902,75253235,277633417,4966791043.687190,2057727669.341896,3156657811.712285,10181176524.741371,601126,153091,307367,1061584
2016-05-04,NASDAQ (DQ),1245345940,615003270,687127356,2547476566,37479976869.948372,23877996355.781695,23246166427.605795,84604139653.335862,4277743,1112361,2205547,7595651
2016-05-04,EDGA (J),103440882,55359295,48151031,206951208,3142296101.587392,2183164832.478698,1493290251.796306,6818751185.862396,921127,242618,395365,1559110
2016-05-04,EDGX (K),244406006,135745302,176196775,556348083,7184692015.064615,5796933862.018495,6028498389.885846,19010124266.968956,1651605,506490,1116702,3274797
2016-05-04,CHX (M),15712061,10229227,6446459,32387747,634930580.119300,774438429.994400,318752287.234000,1728121297.347700,534,3773,1269,5576
2016-05-04,NYSE (N),1019138350,0,0,1019138350,33663871160.792389,0.000000,0.000000,33663871160.792389,3543581,0,0,3543581
2016-05-04,NYSE Arca (P),296996532,404841782,194336282,896174596,10466253943.633011,18276057858.584596,8007743850.836657,36750055653.054264,2235742,1025613,1446230,4707585
2016-05-04,NASDAQ (Q),451943511,139730474,490328836,1082002821,17436973487.109420,7228695931.571499,20932582317.785391,45598251736.466310,3904316,585632,3333379,7823327
2016-05-04,NASDAQ PSX (X),33751293,26652371,26243551,86647215,927160921.750998,1398358547.662898,822812370.140799,3148331839.554695,238877,105193,167765,511835
2016-05-04,BATS BYX (Y),162346285,79961181,72334374,314641840,4505776577.708685,2795397111.657003,2305625275.426106,9606798964.791794,1401790,336522,609946,2348258
2016-05-04,BATS BZX (Z),244204583,128064227,126345767,498614577,7435798851.803345,6200297835.127288,4809830426.605952,18445927113.536585,2025678,535548,1054790,3616016
2016-05-03,NYSE MKT (A),0,9771478,3788380,13559858,0.000000,45923521.817400,131784784.385000,177708306.202400,0,23424,15363,38787
2016-05-03,NASDAQ BX (B),93208366,42219715,45213648,180641729,3110441536.936106,1658280354.631498,1777588245.252089,6546310136.819693,812718,174348,394552,1381618
2016-05-03,NSX (C),166946,23324,138636,328906,7630419.780000,657013.360000,4025523.358900,12312956.498900,1276,116,863,2255
2016-05-03,NYSE (DN),160377524,54914082,72885444,288177050,5466040882.625511,2091944383.596400,3079260502.237294,10637245768.459205,628937,151409,299187,1079533
2016-05-03,NASDAQ (DQ),1318146993,611592037,715571646,2645310676,38409371155.754743,26598089858.135455,24000945206.829254,89008406220.719452,4364349,1088807,2175512,7628668
2016-05-03,EDGA (J),105441920,52961891,50679760,209083571,3104073241.233802,2194351124.929499,1540511710.960405,6838936077.123706,907063,232504,391974,1531541
2016-05-03,EDGX (K),254812498,138501071,194267233,587580802,7507935812.615678,6197097676.346105,6523632111.459318,20228665600.421101,1676653,503363,1164523,3344539
2016-05-03,CHX (M),25201949,12925501,4273530,42400980,935229504.440800,980888128.180000,214236042.598700,2130353675.219500,455,4219,858,5532
2016-05-03,NYSE (N),1004487056,0,0,1004487056,33214326634.404150,0.000000,0.000000,33214326634.404150,3612213,0,0,3612213
2016-05-03,NYSE Arca (P),305403927,375332245,204381763,885117935,10877854326.632077,17833673147.089621,8121138308.805188,36832665782.526886,2301483,1013437,1471935,4786855
2016-05-03,NASDAQ (Q),454775833,135413611,470524240,1060713684,17657476132.493868,7168986822.783623,20031285194.233278,44857748149.510769,3854934,562770,3317044,7734748
2016-05-03,NASDAQ PSX (X),35159851,26210296,27131481,88501628,998326058.716100,1420783050.151301,934180941.285502,3353290050.152903,248982,103525,177390,529897
2016-05-03,BATS BYX (Y),165191076,82803580,72713461,320708117,4435572800.944734,2939901044.049001,2310976626.898096,9686450471.891831,1355153,348809,606003,2309965
2016-05-03,BATS BZX (Z),254827015,125614204,124763339,505204558,7882445043.667719,6351775797.404690,4848668957.796482,19082889798.868891,2068254,536297,1049163,3653714
2016-05-02,NYSE MKT (A),0,12581362,3732299,16313661,0.000000,64345959.211700,119466155.150000,183812114.361700,0,27056,15911,42967
2016-05-02,NASDAQ BX (B),88270947,34183425,44065939,166520311,3111909829.200150,1332018104.662800,1847950758.542304,6291878692.405254,822568,150771,403503,1376842
2016-05-02,NSX (C),117805,15199,238713,371717,4438899.160000,736094.830000,4274880.479800,9449874.469800,875,57,1120,2052
2016-05-02,NYSE (DN),143183436,47050587,77239543,267473566,5174726117.244703,1642506660.572699,3402021518.458996,10219254296.276398,598808,127751,329033,1055592
2016-05-02,NASDAQ (DQ),1156739545,495662675,667265546,2319667766,36598525794.248712,18176806281.832885,22899108203.025100,77674440279.106697,4279351,957502,2159982,7396835
2016-05-02,EDGA (J),97854799,42285048,46908700,187048547,3056691978.516590,1667779168.644102,1564685449.640204,6289156596.800896,892760,199994,393541,1486295
2016-05-02,EDGX (K),240819274,118010548,177351833,536181655,6982590863.805906,4928468426.973492,6223889351.507236,18134948642.286634,1645127,465370,1134591,3245088
2016-05-02,CHX (M),11373416,7526881,6327493,25227790,492608976.423700,603684790.670000,385397381.317600,1481691148.411300,2488,3174,939,6601
2016-05-02,NYSE (N),987850225,0,0,987850225,32980790855.083163,0.000000,0.000000,32980790855.083163,3402517,0,0,3402517
2016-05-02,NYSE Arca (P),277155231,331870023,189949433,798974687,9896528429.869699,15402792965.699006,7885713145.257933,33185034540.826638,2183495,939269,1432197,4554961
2016-05-02,NASDAQ (Q),416882611,112117272,458103784,987103667,16361219118.312234,5618911481.939279,19695213782.636692,41675344382.888205,3594015,493666,3128385,7216066
2016-05-02,NASDAQ PSX (X),32508273,20021426,24710489,77240188,891420308.576803,1072503233.728901,821260654.052702,2785184196.358406,230619,81934,163903,476456
2016-05-02,BATS BYX (Y),152772898,68791466,68464832,290029196,4349377449.538316,2353518211.702705,2264324687.350511,8967220348.591532,1372935,296812,585687,2255434
2016-05-02,BATS BZX (Z),238741324,103752517,118801050,461294891,7360774982.963563,5018822813.771294,4654919615.703461,17034517412.438318,1996442,470384,1011953,3478779
2016-04-29,NYSE MKT (A),0,12784167,2680172,15464339,0.000000,73070177.514600,71477465.731000,144547643.245600,0,24540,14287,38827
2016-04-29,NASDAQ BX (B),103829691,47238974,51492532,202561197,3616362384.406004,1912797935.935599,2168204749.857089,7697365070.198692,912235,194825,453723,1560783
2016-04-29,NSX (C),498162,42554,201565,742281,9386464.321600,1325354.700000,5026036.497700,15737855.519300,2041,208,911,3160
2016-04-29,NYSE (DN),165162482,61970688,91307804,318440974,5323633064.945608,2410530380.398402,4376261986.085194,12110425431.429204,627286,148696,359358,1135340
2016-04-29,NASDAQ (DQ),1395873651,690106984,816709667,2902690302,39357294315.841773,29553701716.614531,31651458693.510988,100562454725.967292,4391564,1174144,2541386,8107094
2016-04-29,EDGA (J),113356680,62716502,54859521,230932703,3304204408.946491,2641518349.354497,1950036562.248602,7895759320.549590,957579,265928,445195,1668702
2016-04-29,EDGX (K),273918018,167943113,217558481,659419612,7439051408.045578,7556559865.436413,8199007039.289998,23194618312.771989,1728101,629782,1362670,3720553
2016-04-29,CHX (M),9088958,15304514,4204518,28597990,369420867.365300,1188525254.355000,352136716.249600,1910082837.969900,440,5220,1231,6891
2016-04-29,NYSE (N),1292038534,0,0,1292038534,44451270661.029077,0.000000,0.000000,44451270661.029077,3973546,0,0,3973546
2016-04-29,NYSE Arca (P),345379868,468493120,232854906,1046727894,11401624290.676101,23288723511.934480,10567562486.222161,45257910288.832742,2428610,1255342,1693547,5377499
2016-04-29,NASDAQ (Q),508047039,171091361,635603621,1314742021,19048332765.774186,9498239624.809830,29523398194.175079,58069970584.759095,4168726,712547,3890213,8771486
2016-04-29,NASDAQ PSX (X),41576331,28498518,30859930,100934779,1057948374.616201,1440754588.171599,1129216037.669401,3627919000.457201,263659,109003,197071,569733
2016-04-29,BATS BYX (Y),182463012,95193830,81833687,359490529,5031879204.204059,3437518853.276097,2804876083.935662,11274274141.415818,1518576,378844,674933,2572353
2016-04-29,BATS BZX (Z),276582989,152482290,158182219,587247498,8242733740.519067,8179565420.354923,6887941423.320787,23310240584.194777,2188769,661725,1268330,4118824
2016-04-28,NYSE MKT (A),0,10099938,3228736,13328674,0.000000,54346178.047400,93983809.485000,148329987.532400,0,22547,14792,37339
2016-04-28,NASDAQ BX (B),95407199,42283068,45649026,183339293,3305785793.949211,1657981214.765199,2070122078.458580,7033889087.172990,828810,173611,405222,1407643
2016-04-28,NSX (C),225253,22026,239553,486832,6220723.178900,935979.520000,4935652.903900,12092355.602800,1030,72,1001,2103
2016-04-28,NYSE (DN),173164882,52707787,91817156,317689825,5864418045.210185,2000828669.649501,4610604244.715506,12475850959.575192,650747,143661,360562,1154970
2016-04-28,NASDAQ (DQ),1405560555,586090511,792272238,2783923304,40271547965.537290,23999265968.952791,31796650065.766067,96067464000.256148,4347572,1021148,2440482,7809202
2016-04-28,EDGA (J),102546927,51735834,50904512,205187273,3086457461.498382,2103228248.933600,1995798160.345186,7185483870.777168,885756,219556,424234,1529546
2016-04-28,EDGX (K),265475038,137266970,208395323,611137331,7449453043.625334,5940401261.021016,8356724301.248236,21746578605.894586,1653132,485757,1258354,3397243
2016-04-28,CHX (M),19050901,8423185,7655863,35129949,793749574.799000,723762059.160000,444176685.110600,1961688319.069600,480,3910,1260,5650
2016-04-28,NYSE (N),1029369135,0,0,1029369135,33958665529.200459,0.000000,0.000000,33958665529.200459,3561035,0,0,3561035
2016-04-28,NYSE Arca (P),316188743,375837358,218618524,910644625,11431630882.345060,18189522805.196640,10793324572.827406,40414478260.369106,2312136,987426,1557832,4857394
2016-04-28,NASDAQ (Q),454565354,134100229,508038364,1096703947,17796817852.602067,7145207192.053794,24264425009.551002,49206450054.206863,3775356,549457,3462296,7787109
2016-04-28,NASDAQ PSX (X),36306933,26158071,28869881,91334885,989493704.152798,1348265090.560299,1088623942.029101,3426382736.742198,243724,91704,177821,513249
2016-04-28,BATS BYX (Y),160863934,82536601,70301046,313701581,4589914818.354696,2919671786.521401,2600721214.064776,10110307818.940873,1364349,332884,604463,2301696
2016-04-28,BATS BZX (Z),253668187,119142850,138147207,510958244,7852413336.448754,6119033986.535395,5891320214.955941,19862767537.940090,2032462,491006,1118111,3641579
2016-04-27,NYSE MKT (A),0,8881587,3196170,12077757,0.000000,62006935.128100,94794549.709000,156801484.837100,0,23642,15200,38842
2016-04-27,NASDAQ BX (B),91044236,33414031,41413472,165871739,3316648902.911607,1313875152.088400,1878930027.341315,6509454082.341322,816132,136876,380320,1333328
2016-04-27,NSX (C),109455,19105,406812,535372,3707545.459100,988804.250000,7944245.165600,12640594.874700,627,114,1600,2341
2016-04-27,NYSE (DN),157509877,43453842,83827995,284791714,5388779459.436735,1642806694.360798,4013383247.925201,11044969401.722734,590989,112008,323496,1026493
2016-04-27,NASDAQ (DQ),1290984520,446481519,673278707,2410744746,37684798321.087225,17200362570.466411,26114724786.671433,80999885678.225069,4059463,905225,2245188,7209876
2016-04-27,EDGA (J),107528545,44949356,45927673,198405574,3147732866.330420,1927315565.673507,1773957008.548991,6849005440.552918,901585,200149,392765,1494499
2016-04-27,EDGX (K),254973047,124345253,187064450,566382750,7232350447.372986,5359694266.542995,7501992675.808382,20094037389.724363,1602138,458187,1177661,3237986
2016-04-27,CHX (M),12218026,12090076,8537227,32845329,505090969.402000,869904974.025000,561724965.949000,1936720909.376000,458,3956,1641,6055
2016-04-27,NYSE (N),997429533,0,0,997429533,33377780140.909512,0.000000,0.000000,33377780140.909512,3473525,0,0,3473525
2016-04-27,NYSE Arca (P),296149944,309408128,203624332,809182404,10628257389.865489,14751620831.434735,9857529966.554663,35237408187.854887,2183482,899050,1455693,4538225
2016-04-27,NASDAQ (Q),448876160,128695225,472355386,1049926771,17539396070.908561,6691271090.645728,22703940376.683052,46934607538.237341,3679191,540675,3254860,7474726
2016-04-27,NASDAQ PSX (X),37646605,24282608,28213866,90143079,1021355911.250699,1148672321.625001,1138903265.475699,3308931498.351399,249880,89074,183932,522886
2016-04-27,BATS BYX (Y),158842787,66797881,67427332,293068000,4453674359.580433,2406950823.409991,2451210405.245302,9311835588.235726,1307770,283577,584077,2175424
2016-04-27,BATS BZX (Z),249197319,110318221,127124868,486640408,7642086699.431361,5495901959.937310,5443053860.553904,18581042519.922575,1978249,473685,1052086,3504020
2016-04-26,NYSE MKT (A),0,8512602,3490185,12002787,0.000000,52383323.756400,92137062.646000,144520386.402400,0,21072,15782,36854
2016-04-26,NASDAQ BX (B),83865023,25233568,40428857,149527448,2945610967.213888,1028835781.887098,1642746121.251690,5617192870.352676,752331,116560,362534,1231425
2016-04-26,NSX (C),226891,3317,379012,609220,4592758.824400,329146.780000,4078565.015800,9000470.620200,713,44,1410,2167
2016-04-26,NYSE (DN),131165254,35517875,77584835,244267964,4710229189.020692,1411361166.761999,3284397993.803423,9405988349.586114,524266,97096,285221,906583
2016-04-26,NASDAQ (DQ),1091509303,386319274,658176402,2136004979,34228472295.922884,18215571306.052544,21555272005.953434,73999315607.928862,3674253,792352,2017202,6483807
2016-04-26,EDGA (J),93133679,37096001,43471382,173701062,2892763590.990490,1514275610.611598,1466052099.889403,5873091301.491491,813596,160377,361760,1335733
2016-04-26,EDGX (K),217116945,95101740,183171440,495390125,6418604541.805856,4227814613.827505,6279516619.001781,16925935774.635142,1402081,372729,1078808,2853618
2016-04-26,CHX (M),14854956,15962378,10008988,40826322,664320869.150100,1621559280.340400,558957704.379500,2844837853.870000,688,3526,751,4965
2016-04-26,NYSE (N),920074020,0,0,920074020,31305677494.898802,0.000000,0.000000,31305677494.898802,3039288,0,0,3039288
2016-04-26,NYSE Arca (P),247279419,259512826,185278653,692070898,9198978480.853058,12724618610.333850,7523676232.512450,29447273323.699358,1854500,753237,1314090,3921827
2016-04-26,NASDAQ (Q),376357217,91669324,434103542,902130083,15239861134.454544,4816403866.603802,18467416494.051389,38523681495.109735,3197415,413909,2878206,6489530
2016-04-26,NASDAQ PSX (X),27449384,15941691,23271670,66662745,793268136.557600,790149724.422801,786467520.350200,2369885381.330601,196492,62777,145704,404973
2016-04-26,BATS BYX (Y),140893258,53299141,60178375,254370774,3970458791.114688,1932604351.503496,2010050121.332805,7913113263.950989,1185402,231324,521032,1937758
2016-04-26,BATS BZX (Z),217696285,82271130,110454149,410421564,6750564236.915502,4320340903.390600,4158318368.175937,15229223508.482039,1750639,373375,914147,3038161
2016-04-25,NYSE MKT (A),0,8220261,3064506,11284767,0.000000,43029441.146800,88807742.174000,131837183.320800,0,18790,13694,32484
2016-04-25,NASDAQ BX (B),77763900,25272094,34256360,137292354,2687905977.141201,1026427599.527000,1396983355.021406,5111316931.689607,714240,113361,325501,1153102
2016-04-25,NSX (C),392616,32304,196160,621080,6919657.226500,1155585.940000,3200319.988900,11275563.155400,1082,89,770,1941
2016-04-25,NYSE (DN),119357661,34400926,59738634,213497221,4226319795.241597,1315254153.224102,2413015600.825999,7954589549.291698,501987,98667,249587,850241
2016-04-25,NASDAQ (DQ),987456062,368848030,577977032,1934281124,30757460296.571541,15650707788.717249,17788084416.040586,64196252501.329376,3407861,767320,1813129,5988310
2016-04-25,EDGA (J),84759235,35563021,36933863,157256119,2592137332.222998,1452532323.124101,1212214661.523797,5256884316.870896,751098,165245,306021,1222364
2016-04-25,EDGX (K),208151268,99567329,152862682,460581279,6167960645.897084,4361867116.242119,5058355609.603535,15588183371.742738,1369915,382952,923955,2676822
2016-04-25,CHX (M),19129720,10408228,5643398,35181346,771104663.492500,821669721.885600,211252098.552300,1804026483.930400,1189,3082,693,4964
2016-04-25,NYSE (N),883345386,0,0,883345386,29937245607.167899,0.000000,0.000000,29937245607.167899,2932594,0,0,2932594
2016-04-25,NYSE Arca (P),230828500,255721350,152903118,639452968,8631685969.617798,12511401689.104177,5847124229.825561,26990211888.547536,1775683,754317,1128613,3658613
2016-04-25,NASDAQ (Q),355864749,95657879,386002003,837524631,14381349858.253635,5030299176.751494,16627289813.734989,36038938848.740118,3116202,430118,2548382,6094702
2016-04-25,NASDAQ PSX (X),26211517,16963686,21283948,64459151,782183382.382399,830297038.256700,717783520.554202,2330263941.193301,195405,66424,131263,393092
2016-04-25,BATS BYX (Y),132099663,51725551,56598866,240424080,3736501522.651414,1833402470.652700,1863533264.569205,7433437257.873319,1144897,237912,480016,1862825
2016-04-25,BATS BZX (Z),199532379,84924267,96326713,380783359,6248295952.533409,4398765236.357997,3633453979.751217,14280515168.642623,1653090,384966,816137,2854193
2016-04-22,NYSE MKT (A),0,9886071,3537107,13423178,0.000000,75853990.292100,96922902.898000,172776893.190100,0,22163,17988,40151
2016-04-22,NASDAQ BX (B),83271414,32366700,43187225,158825339,2997138126.564287,1345495298.413301,1866516644.572791,6209150069.550379,760229,139325,381640,1281194
2016-04-22,NSX (C),154408,22692,133094,310194,7308590.670000,772553.270000,3525045.131000,11606189.071000,1132,126,685,1943
2016-04-22,NYSE (DN),132324685,46637720,75731974,254694379,4800418038.265605,1723440150.253397,3655311967.642469,10179170156.161471,520448,121146,291084,932678
2016-04-22,NASDAQ (DQ),1162004645,501884119,725805673,2389694437,37293560852.875589,23316064531.008010,26579052464.940113,87188677848.823712,3836530,923921,2178403,6938854
2016-04-22,EDGA (J),93236771,40235859,48656491,182129121,2925330871.091006,1787017861.446603,1786053812.914493,6498402545.452102,825855,186427,380829,1393111
2016-04-22,EDGX (K),225633931,125657407,190233832,541525170,6920328147.871091,5535847206.443509,7311465532.538427,19767640886.853027,1482296,461134,1119386,3062816
2016-04-22,CHX (M),24415889,11986122,4297109,40699120,1089634739.856900,1074010576.670000,295462260.770600,2459107577.297500,306,3247,1350,4903
2016-04-22,NYSE (N),1031927841,0,0,1031927841,36761485136.075714,0.000000,0.000000,36761485136.075714,3242637,0,0,3242637
2016-04-22,NYSE Arca (P),253535780,314191572,191999263,759726615,9439046265.411252,15173804492.315965,8441523335.922891,33054374093.650108,1904384,889267,1338515,4132166
2016-04-22,NASDAQ (Q),391796128,124009511,513652951,1029458590,15667226994.733294,6330674268.379585,24484827379.788361,46482728642.901240,3318542,521635,3053880,6894057
2016-04-22,NASDAQ PSX (X),29603176,21436632,27725406,78765214,910932798.445100,1138532585.310199,1077667772.865702,3127133156.621001,213161,80361,163522,457044
2016-04-22,BATS BYX (Y),146324422,63673350,70830482,280828254,4172702313.856114,2349531439.468998,2368082680.633283,8890316433.958395,1220762,272422,555983,2049167
2016-04-22,BATS BZX (Z),218496892,103702324,124209042,446408258,6917554899.669111,5512611007.936796,5123946971.309167,17554112878.915074,1749101,460083,958482,3167666
2016-04-21,NYSE MKT (A),0,10959508,3574761,14534269,0.000000,59793284.325200,84157056.420000,143950340.745200,0,24814,16908,41722
2016-04-21,NASDAQ BX (B),92804763,35793362,37424416,166022541,3220126489.995084,1419844180.927000,1497004410.560804,6136975081.482888,821862,153768,353803,1329433
2016-04-21,NSX (C),139556,33460,140100,313116,6245170.380000,802561.765700,2946384.228600,9994116.374300,884,119,622,1625
2016-04-21,NYSE (DN),162552915,47277032,71098382,280928329,5888742497.305665,1717210808.822996,3083924005.911679,10689877312.040340,615705,126795,281901,1024401
2016-04-21,NASDAQ (DQ),1345554246,524996279,669943543,2540494068,43864819564.471822,21910744766.111955,22456756773.213018,88232321103.796795,4336260,981953,2016534,7334747
2016-04-21,EDGA (J),101115681,48169903,38114657,187400241,3069231481.032704,2010428375.287696,1335409390.930515,6415069247.250915,856438,221148,323138,1400724
2016-04-21,EDGX (K),258963115,130123333,165445200,554531648,7795299029.511951,5563800583.611091,6452487328.170919,19811586941.293961,1652209,496872,1053208,3202289
2016-04-21,CHX (M),11818259,9462482,5102740,26383481,590194360.862200,725550150.427600,363114711.849500,1678859223.139300,377,3782,762,4921
2016-04-21,NYSE (N),1014293740,0,0,1014293740,34470941579.465565,0.000000,0.000000,34470941579.465565,3519639,0,0,3519639
2016-04-21,NYSE Arca (P),292716679,349792637,169420630,811929946,10704663928.176064,15967656804.399849,7628343362.955665,34300664095.531578,2137566,1004221,1270727,4412514
2016-04-21,NASDAQ (Q),446956016,131787892,403231240,981975148,17879674901.989369,6739169665.124698,18441406579.892753,43060251147.006820,3768427,567583,2882219,7218229
2016-04-21,NASDAQ PSX (X),36364789,22502606,24577890,83445285,1080420945.590999,1125000011.590700,824270623.478401,3029691580.660100,248148,86332,153252,487732
2016-04-21,BATS BYX (Y),163204121,76065109,64160669,303429899,4769636535.301507,2646372413.321988,2119470136.172215,9535479084.795710,1407252,325991,560549,2293792
2016-04-21,BATS BZX (Z),250624793,112064872,109653916,472343581,8007972655.305640,5731749197.511800,4285202551.481581,18024924404.299021,2015591,498644,924323,3438558
2016-04-20,NYSE MKT (A),0,9869548,3998953,13868501,0.000000,50466362.056100,79524378.668000,129990740.724100,0,23057,13573,36630
2016-04-20,NASDAQ BX (B),87072624,35542506,38365297,160980427,2992914769.970800,1318836388.554900,1586550428.146206,5898301586.671906,769178,149355,348474,1267007
2016-04-20,NSX (C),714438,29850,217141,961429,6345307.244100,748536.670000,5252721.091000,12346565.005100,1526,83,1145,2754
2016-04-20,NYSE (DN),156168108,51446576,74444271,282058955,5423587227.766516,1762883219.725699,3093143129.800285,10279613577.292500,581401,127477,286136,995014
2016-04-20,NASDAQ (DQ),1356873250,580275115,658249958,2595398323,39772064141.466290,22999582787.023532,21791852666.046564,84563499594.536386,4090904,1060514,1999183,7150601
2016-04-20,EDGA (J),107949013,50684552,42529999,201163564,3254195370.416806,1976272495.098298,1525714492.992795,6756182358.507899,917008,214512,365946,1497466
2016-04-20,EDGX (K),273609113,132828095,174375468,580812676,7805290378.514000,5326373579.741110,6173936772.049610,19305600730.304720,1666004,476450,1068930,3211384
2016-04-20,CHX (M),16391966,13673930,6628237,36694133,683075096.652500,1030034900.105200,342993447.933100,2056103444.690800,352,4234,728,5314
2016-04-20,NYSE (N),986387708,0,0,986387708,32237846087.446386,0.000000,0.000000,32237846087.446386,3230589,0,0,3230589
2016-04-20,NYSE Arca (P),292664469,343488779,172304967,808458215,9977954988.609355,15169771190.338711,6640785498.245905,31788511677.193971,2018904,934134,1232965,4186003
2016-04-20,NASDAQ (Q),452947057,131606889,412699215,997253161,16917121939.692241,6204229724.983307,17761476108.902892,40882827773.578440,3588015,547173,2812239,6947427
2016-04-20,NASDAQ PSX (X),35267017,21790191,23542097,80599305,1026217840.749301,1000769120.679700,809672889.790504,2836659851.219505,240580,81484,154365,476429
2016-04-20,BATS BYX (Y),168072005,74800170,65344692,308216867,4708154710.963022,2487565455.157095,2224193112.277279,9419913278.397396,1416958,303646,576431,2297035
2016-04-20,BATS BZX (Z),255840880,114333467,112002486,482176833,7789042699.371930,5408835201.948689,4256135892.962615,17454013794.283234,1984717,473895,932576,3391188
2016-04-19,NYSE MKT (A),0,10724654,2808733,13533387,0.000000,59729907.673700,88131314.517000,147861222.190700,0,25030,15184,40214
2016-04-19,NASDAQ BX (B),82641761,33947518,37647837,154237116,2886271921.641217,1281979658.353597,1654948407.497383,5823199987.492197,729693,141713,343881,1215287
2016-04-19,NSX (C),761591,21156,171731,954478,8530874.325200,1672199.334500,5268688.248900,15471761.908600,1931,114,1168,3213
2016-04-19,NYSE (DN),150456160,52674756,76372170,279503086,5128576378.121428,1795792128.940701,3577098676.665983,10501467183.728112,563317,138511,285472,987300
2016-04-19,NASDAQ (DQ),1316394879,509001943,675597257,2500994079,37982965653.265626,20513503795.661407,24738208524.396637,83234677973.323670,4292673,1042902,2056903,7392478
2016-04-19,EDGA (J),101191718,48179845,41961989,191333552,3008631086.666118,1869188709.666998,1520031731.866107,6397851528.199223,852250,209571,351709,1413530
2016-04-19,EDGX (K),244661259,123247280,174408341,542316880,7026801973.704204,5425330341.978212,6767062011.935722,19219194327.618138,1508721,452356,1082569,3043646
2016-04-19,CHX (M),13254584,20872326,4723185,38850095,420737322.018200,1455115702.545000,219974611.120500,2095827635.683700,519,3753,450,4722
2016-04-19,NYSE (N),902733090,0,0,902733090,30613258116.684337,0.000000,0.000000,30613258116.684337,3090972,0,0,3090972
2016-04-19,NYSE Arca (P),256032891,341893397,176930997,774857285,9053635334.540987,16311322885.120637,7800269105.616936,33165227325.278560,1868522,901000,1275698,4045220
2016-04-19,NASDAQ (Q),417491720,124803416,435670129,977965265,15871567850.383794,6591447898.008790,19717012066.766936,42180027815.159520,3435911,547013,2913140,6896064
2016-04-19,NASDAQ PSX (X),32882305,20016225,25802721,78701251,981104994.436298,1057776036.960100,895794221.509299,2934675252.905697,237478,82789,165879,486146
2016-04-19,BATS BYX (Y),153830671,70246598,64112819,288190088,4368183462.940134,2366468931.493700,2199445996.944519,8934098391.378353,1315801,288306,556310,2160417
2016-04-19,BATS BZX (Z),228114928,105986207,110317574,444418709,6969588004.767728,5715902203.770418,4666658780.076811,17352148988.614957,1817493,452584,924685,3194762
2016-04-18,NYSE MKT (A),0,10527471,2823957,13351428,0.000000,54880651.278700,84669933.276000,139550584.554700,0,24275,15530,39805
2016-04-18,NASDAQ BX (B),71909511,28018223,34462388,134390122,2406990722.043306,1105074579.027495,1368186020.897114,4880251321.967915,638368,124471,308844,1071683
2016-04-18,NSX (C),381765,29304,250938,662007,4826633.963000,917829.171000,5502062.538700,11246525.672700,1201,100,1157,2458
2016-04-18,NYSE (DN),125027882,39558430,72139667,236725979,4159145672.940108,1478023694.669898,2948565728.781991,8585735096.391997,492425,111706,273280,877411
2016-04-18,NASDAQ (DQ),1051328301,429968357,622525244,2103821902,31001086425.618915,18650799733.806054,20777250843.791686,70429137003.216655,3468431,909898,1914076,6292405
2016-04-18,EDGA (J),83680012,39333964,37510170,160524146,2415059945.165598,1627687739.681398,1233342430.508891,5276090115.355887,718755,179235,314145,1212135
2016-04-18,EDGX (K),202954371,103534581,158621395,465110347,5658912591.310285,4582191973.010198,5523480372.395323,15764584936.715806,1273796,402470,952592,2628858
2016-04-18,CHX (M),13596415,7948840,14730038,36275293,440192111.413800,756720952.970000,1430369946.799700,2627283011.183500,452,3826,1271,5549
2016-04-18,NYSE (N),852553919,0,0,852553919,28162438742.015318,0.000000,0.000000,28162438742.015318,2806966,0,0,2806966
2016-04-18,NYSE Arca (P),226412040,283777010,164868338,675057388,7810382673.813719,14238176595.648019,6944841676.085881,28993400945.547619,1640922,798880,1184431,3624233
2016-04-18,NASDAQ (Q),347080178,104343782,392891496,844315456,13248921184.302478,5567743577.885997,16878710799.463869,35695375561.652344,2959167,479294,2631615,6070076
2016-04-18,NASDAQ PSX (X),26851876,17496260,21180340,65528476,790304208.672302,916912157.221600,721645065.437799,2428861431.331701,196079,70508,137235,403822
2016-04-18,BATS BYX (Y),132476119,57710137,58766565,248952821,3768579873.807473,2032138554.800593,1985068591.963619,7785787020.571685,1146689,249766,506474,1902929
2016-04-18,BATS BZX (Z),187350013,92854588,95177105,375381706,5693750253.733853,4957461687.379197,3657671331.503844,14308883272.616894,1541800,420561,815071,2777432
2016-04-15,NYSE MKT (A),0,8602393,3070181,11672574,0.000000,73155207.225600,94484112.576000,167639319.801600,0,19960,16058,36018
2016-04-15,NASDAQ BX (B),74546393,31324697,33232105,139103195,2408964045.750114,1139550511.995400,1281824710.137096,4830339267.882610,657220,128575,301406,1087201
2016-04-15,NSX (C),956517,6661,243932,1207110,5926650.953900,395901.460000,6942428.173500,13264980.587400,1657,42,1116,2815
2016-04-15,NYSE (DN),129061005,39092240,61690941,229844186,4177524809.822907,1469365223.731699,2533008007.451005,8179898041.005611,506924,110833,250468,868225
2016-04-15,NASDAQ (DQ),1194444545,450984283,607180840,2252609668,33136987640.166736,19388388001.726732,20139276028.710399,72664651670.603867,3574773,914583,1805175,6294531
2016-04-15,EDGA (J),88963480,38789252,37852057,165604789,2585574825.226088,1600400096.929697,1222393172.627184,5408368094.782969,755413,178293,308213,1241919
2016-04-15,EDGX (K),202551870,96798878,153808922,453159670,5364134296.859853,4089273182.527205,4877933714.607538,14331341193.994596,1193868,355275,872495,2421638
2016-04-15,CHX (M),15493784,14072770,10128472,39695026,513718776.274200,1146179848.810000,666806198.733800,2326704823.818000,326,2751,849,3926
2016-04-15,NYSE (N),1036005523,0,0,1036005523,36963374495.144405,0.000000,0.000000,36963374495.144405,2714611,0,0,2714611
2016-04-15,NYSE Arca (P),242209066,287936337,157149886,687295289,7926026205.249007,13846216000.041822,6055940625.715252,27828182831.006081,1629319,745791,1101494,3476604
2016-04-15,NASDAQ (Q),363313538,102126242,448583406,914023186,13332746806.375587,5138880205.683907,20161307476.907597,38632934488.967091,2908546,435069,2498595,5842210
2016-04-15,NASDAQ PSX (X),28184348,18488527,20883231,67556106,784211709.286199,824289231.299600,728156197.803600,2336657138.389399,200620,71600,140230,412450
2016-04-15,BATS BYX (Y),144674909,56559624,58130505,259365038,4060649044.730222,1965053000.072199,1984219794.916488,8009921839.718909,1259905,248709,529929,2038543
2016-04-15,BATS BZX (Z),187886647,93695077,94758963,376340687,5673715382.982121,4643989792.773801,3708240206.377520,14025945382.133442,1482125,390527,785626,2658278
2016-04-14,NYSE MKT (A),0,8063848,2557385,10621233,0.000000,48792520.410700,78197403.411000,126989923.821700,0,20805,14271,35076
2016-04-14,NASDAQ BX (B),71921626,29578655,30258292,131758573,2346643648.294015,1095391132.384598,1203588021.733905,4645622802.412518,624897,127654,280988,1033539
2016-04-14,NSX (C),1084736,25876,208093,1318705,9252746.825800,1037544.960000,3899609.957300,14189901.743100,2808,128,974,3910
2016-04-14,NYSE (DN),135283847,41895067,63402915,240581829,4388448440.117641,1518330629.130802,2441675057.078205,8348454126.326648,517747,109672,248947,876366
2016-04-14,NASDAQ (DQ),1295523734,470221026,630398653,2396143413,35073046529.695085,17882038680.128550,19958785396.034048,72913870605.857683,3889857,911557,1862535,6663949
2016-04-14,EDGA (J),96702810,42006125,38420196,177129131,2652080303.224802,1620065879.470001,1201917818.751098,5474064001.445901,762365,196297,304494,1263156
2016-04-14,EDGX (K),230129189,102582324,159313754,492025267,6019366671.765801,4630894314.590510,5063350604.025750,15713611590.382061,1315025,382654,907464,2605143
2016-04-14,CHX (M),7711494,13090270,4405770,25207534,326526910.077300,875810204.128500,644565017.403600,1846902131.609400,941,2521,791,4253
2016-04-14,NYSE (N),904845192,0,0,904845192,28721216758.954758,0.000000,0.000000,28721216758.954758,2876775,0,0,2876775
2016-04-14,NYSE Arca (P),261723084,296546397,166923165,725192646,8699316514.969882,13534663733.830286,6188898507.678226,28422878756.478394,1786747,777952,1146695,3711394
2016-04-14,NASDAQ (Q),380257700,106532709,387812963,874603372,14177954915.580617,5574127508.485096,15472470760.916452,35224553184.982165,3105513,467948,2509574,6083035
2016-04-14,NASDAQ PSX (X),28959721,18087064,19718149,66764934,770363738.177301,864794005.881701,630506281.675503,2265664025.734505,189155,70597,125007,384759
2016-04-14,BATS BYX (Y),146587660,61684415,56872555,265144630,3999562486.455770,2099678871.620298,1892710401.733790,7991951759.809858,1213237,270442,500269,1983948
2016-04-14,BATS BZX (Z),209078337,93945658,96247948,399271943,6073666145.349869,4894997630.803596,3537810219.347031,14506473995.500496,1599769,415911,798045,2813725
2016-04-13,NYSE MKT (A),0,8864662,3657458,12522120,0.000000,53038251.321400,116210079.616000,169248330.937400,0,22669,19254,41923
2016-04-13,NASDAQ BX (B),86075189,35191307,38801482,160067978,2842695984.041994,1370535132.903801,1616906026.422601,5830137143.368396,766715,149908,350253,1266876
2016-04-13,NSX (C),185853,12608,614686,813147,1886594.290300,1288315.720000,2416516.373400,5591426.383700,559,52,1535,2146
2016-04-13,NYSE (DN),160218618,51028045,75878998,287125661,5393071203.280294,1798442556.198895,3154864222.384578,10346377981.863767,599112,126915,281082,1007109
2016-04-13,NASDAQ (DQ),1386067397,515919594,728297147,2630284138,38953245536.088227,21606371193.446400,25232625828.027874,85792242557.562501,4265123,1053904,2095647,7414674
2016-04-13,EDGA (J),105011895,50921139,46471379,202404413,2980634949.806861,2051147979.878100,1535766814.950198,6567549744.635159,896935,225101,364873,1486909
2016-04-13,EDGX (K),263407562,134356309,191468336,589232207,7071239803.463468,6279428251.661886,6649087188.316465,19999755243.441819,1567572,497949,1070330,3135851
2016-04-13,CHX (M),11121066,18234809,4663512,34019387,441592260.337400,1181366666.431000,299967282.293900,1922926209.062300,399,4033,1098,5530
2016-04-13,NYSE (N),1009793667,0,0,1009793667,32110329671.511716,0.000000,0.000000,32110329671.511716,3313062,0,0,3313062
2016-04-13,NYSE Arca (P),291645005,380424056,188768388,860837449,9805267993.354281,18220324045.726350,7635225870.743145,35660817909.823776,2041512,974721,1282271,4298504
2016-04-13,NASDAQ (Q),440806593,139309232,453023370,1033139195,16565083319.026839,7729847938.058301,19581029143.141659,43875960400.226799,3628679,594390,2988421,7211490
2016-04-13,NASDAQ PSX (X),33185943,24849867,26473904,84509714,933276205.374003,1250981975.004099,914289890.164098,3098548070.542200,230861,93721,161273,485855
2016-04-13,BATS BYX (Y),164975300,72076041,66316823,303368164,4612426075.322886,2565221655.692696,2294986951.713014,9472634682.728596,1428485,308395,592027,2328907
2016-04-13,BATS BZX (Z),245819363,122547933,115995489,484362785,7208888114.387960,6703154438.333520,4568574278.248114,18480616830.969594,1922890,527541,945452,3395883
2016-04-12,NYSE MKT (A),0,9809640,3780182,13589822,0.000000,63178097.100600,123625766.780000,186803863.880600,0,25083,20923,46006
2016-04-12,NASDAQ BX (B),82341433,37874748,36180222,156396403,2536071774.082392,1401295468.743299,1333877746.846991,5271244989.672682,716861,152513,326419,1195793
2016-04-12,NSX (C),398556,10959,1013086,1422601,2611191.722500,736703.150000,1737037.891100,5084932.763600,763,58,1863,2684
2016-04-12,NYSE (DN),170300679,55840809,71517300,297658788,5049251280.336601,1865119237.846000,2559354426.413593,9473724944.596194,605889,133089,265288,1004266
2016-04-12,NASDAQ (DQ),1415600895,558576489,643294062,2617471446,34395024721.773271,23682434515.872963,19177002283.561077,77254461521.207311,4185068,1042460,1898986,7126514
2016-04-12,EDGA (J),105296763,51855626,44539444,201691833,2791840125.850088,2024330383.508098,1358682869.098399,6174853378.456585,866386,233340,355217,1454943
2016-04-12,EDGX (K),282222036,132746184,174076152,589044372,6837580459.214583,5985101466.982905,5616290185.021271,18438972111.218759,1593949,516761,1017229,3127939
2016-04-12,CHX (M),7175617,12303905,4519054,23998576,318247855.147000,1009517537.586600,178987412.410500,1506752805.144100,984,4586,1328,6898
2016-04-12,NYSE (N),975915032,0,0,975915032,28787814143.815535,0.000000,0.000000,28787814143.815535,3223532,0,0,3223532
2016-04-12,NYSE Arca (P),306810193,368085035,176207727,851102955,9263801412.907375,18625094994.549981,6722170292.199462,34611066699.656818,2020598,1043668,1225836,4290102
2016-04-12,NASDAQ (Q),448050755,132180076,406719407,986950238,15389892756.614619,7155466978.571203,16482133028.824446,39027492764.010268,3491154,585531,2780264,6856949
2016-04-12,NASDAQ PSX (X),35837088,24101296,25050862,84989246,913582801.159698,1238660107.370500,829788624.073697,2982031532.603895,238448,104604,156820,499872
2016-04-12,BATS BYX (Y),161278417,72805861,66114210,300198488,4323813825.898822,2472547168.271514,2133184237.740710,8929545231.911046,1379477,306449,584735,2270661
2016-04-12,BATS BZX (Z),253274417,121197161,112031242,486502820,6892275654.092860,6609831088.828719,4105405335.116603,17607512078.038182,1929164,543681,931083,3403928
2016-04-11,NYSE MKT (A),0,14368906,2640903,17009809,0.000000,89200314.873500,83529442.201000,172729757.074500,0,27717,14786,42503
2016-04-11,NASDAQ BX (B),72987012,33569038,32557589,139113639,2353947902.766405,1206373357.720905,1287884829.248304,4848206089.735614,646665,145305,294662,1086632
2016-04-11,NSX (C),352736,13028,108216,473980,3391588.599700,467968.267000,2429463.235200,6289020.101900,870,91,581,1542
2016-04-11,NYSE (DN),137980668,51044612,63690289,252715569,4278669833.675995,1687132324.478799,2518098457.943591,8483900616.098385,542267,125071,255507,922845
2016-04-11,NASDAQ (DQ),1125137672,474853049,540678900,2140669621,31473316458.922362,17347313635.568742,18699128475.148297,67519758569.639401,3546523,970874,1695329,6212726
2016-04-11,EDGA (J),90554448,44280608,37276022,172111078,2543265044.861887,1729027392.164399,1244412988.958597,5516705425.984883,759929,203061,307889,1270879
2016-04-11,EDGX (K),222797794,119579750,152745456,495123000,5995175630.729720,5217116946.682403,5484709465.663416,16697002043.075539,1353721,443127,944380,2741228
2016-04-11,CHX (M),5396752,8893769,2966460,17256981,230749599.940100,683404192.200500,205242537.618000,1119396329.758600,353,3667,1321,5341
2016-04-11,NYSE (N),911953475,0,0,911953475,29141555976.387315,0.000000,0.000000,29141555976.387315,2901631,0,0,2901631
2016-04-11,NYSE Arca (P),249299853,351856885,154474997,755631735,8367969691.276978,16634291008.751021,6235162089.951636,31237422789.979635,1774405,959008,1149001,3882414
2016-04-11,NASDAQ (Q),369410690,117010066,380751934,867172690,13658823641.280285,5977657258.361998,16122360767.781686,35758841667.423969,3082847,537989,2595619,6216455
2016-04-11,NASDAQ PSX (X),28504403,20097259,25035213,73636875,797550806.049800,1006669141.565000,756919190.427399,2561139138.042199,207005,85624,144522,437151
2016-04-11,BATS BYX (Y),145997020,65396541,57826918,269220479,4040881159.406432,2205169846.002396,1960791550.383413,8206842555.792241,1238312,290593,513793,2042698
2016-04-11,BATS BZX (Z),210226594,105847734,96906754,412981082,6002243599.413436,5609669217.291599,3706585259.767799,15318498076.472834,1634067,468525,836119,2938711
2016-04-08,NYSE MKT (A),0,8823832,2684504,11508336,0.000000,57590536.201700,79449908.134000,137040444.335700,0,21924,13171,35095
2016-04-08,NASDAQ BX (B),70285251,33863620,33514586,137663457,2301653292.519205,1192582439.383499,1302447124.724805,4796682856.627509,629210,141677,302087,1072974
2016-04-08,NSX (C),466795,8435,73426,548656,8339664.160400,622198.990000,2166161.114400,11128024.264800,2026,41,560,2627
2016-04-08,NYSE (DN),123471962,49736185,61527177,234735324,4081082399.187193,1538785476.383601,2582237586.941906,8202105462.512700,475635,115784,240133,831552
2016-04-08,NASDAQ (DQ),1052798721,479454184,578521083,2110773988,29287273026.399311,18580475404.593549,19701459947.962192,67569208378.955052,3465013,971866,1756620,6193499
2016-04-08,EDGA (J),80954691,43800659,37712481,162467831,2278091599.649905,1621919683.792100,1289214986.187987,5189226269.629992,673575,200415,307326,1181316
2016-04-08,EDGX (K),212858432,124002572,151500076,488361080,5938556519.521388,5438119070.618016,5545996526.794730,16922672116.934134,1324233,451138,931624,2706995
2016-04-08,CHX (M),9200054,7387307,2912421,19499782,300303238.776600,583099008.810000,248157062.274000,1131559309.860600,303,3488,1026,4817
2016-04-08,NYSE (N),841742121,0,0,841742121,26988798721.645682,0.000000,0.000000,26988798721.645682,2850617,0,0,2850617
2016-04-08,NYSE Arca (P),236013045,347778325,158740514,742531884,8139780070.904330,16827932166.035372,6490035988.725041,31457748225.664743,1714204,927237,1145028,3786469
2016-04-08,NASDAQ (Q),363527422,117519655,387486295,868533372,13720685997.247060,6318115686.460206,16744020228.789826,36782821912.497092,3064065,519499,2661045,6244609
2016-04-08,NASDAQ PSX (X),28602071,20650734,21213281,70466086,846140633.204603,1069369756.625998,757245333.813201,2672755723.643802,214650,92774,134268,441692
2016-04-08,BATS BYX (Y),136919757,64159675,57914630,258994062,3821298911.101521,2120563155.632300,1911545268.402306,7853407335.136127,1182258,282855,510560,1975673
2016-04-08,BATS BZX (Z),206105991,107540586,95795657,409442234,6004145066.276462,5684062135.216805,3839681065.185039,15527888266.678306,1618287,468172,827232,2913691
2016-04-07,NYSE MKT (A),0,10157318,3118395,13275713,0.000000,66724533.613400,77051794.291000,143776327.904400,0,24522,14914,39436
2016-04-07,NASDAQ BX (B),76700210,37788421,40214070,154702701,2593383559.101587,1370530540.892200,1550260584.603904,5514174684.597691,691741,153236,358435,1203412
2016-04-07,NSX (C),399248,7650,246752,653650,6232386.457400,460623.900000,6229233.219200,12922243.576600,1390,47,1378,2815
2016-04-07,NYSE (DN),135388896,47796195,80477601,263662692,4605198601.082525,1650871541.836998,3051753815.316101,9307823958.235624,529542,114522,295927,939991
2016-04-07,NASDAQ (DQ),1248726257,536703917,696010640,2481440814,37455899364.334451,22763054734.701135,23146001203.663370,83364955302.698956,3811921,1042493,2022251,6876665
2016-04-07,EDGA (J),89900377,52898819,43500918,186300114,2545204486.985805,2003038546.122697,1401621682.098206,5949864715.206708,730676,212237,348878,1291791
2016-04-07,EDGX (K),231043408,135106875,175147500,541297783,6645988181.236797,6297171969.287628,6222446474.485578,19165606625.010003,1473279,479905,1071625,3024809
2016-04-07,CHX (M),6188535,9346835,3848203,19383573,291011359.444900,966005075.230000,257358704.096000,1514375138.770900,420,4021,1820,6261
2016-04-07,NYSE (N),938413160,0,0,938413160,30744603927.681457,0.000000,0.000000,30744603927.681457,3011718,0,0,3011718
2016-04-07,NYSE Arca (P),265051995,375622908,184233118,824908021,9450871985.393068,18463710113.518025,7508955793.965118,35423537892.876211,1967276,999781,1340088,4307145
2016-04-07,NASDAQ (Q),409218265,139951109,478140138,1027309512,16084001093.062498,7707019610.074507,19523515787.189432,43314536490.326437,3515669,571347,3076653,7163669
2016-04-07,NASDAQ PSX (X),32879601,23747480,24924997,81552078,1034208237.233101,1284994446.430601,921429456.740098,3240632140.403800,253960,92575,162220,508755
2016-04-07,BATS BYX (Y),159060900,75338688,68595869,302995457,4547053172.686425,2575502124.306894,2219177020.841075,9341732317.834394,1358611,316494,613020,2288125
2016-04-07,BATS BZX (Z),210271733,122379169,111910526,444561428,6498055926.229477,6706936609.244611,4311135765.235445,17516128300.709533,1723497,503782,946648,3173927
2016-04-06,NYSE MKT (A),0,8501426,3043547,11544973,0.000000,61705929.110800,87515990.061000,149221919.171800,0,23860,18791,42651
2016-04-06,NASDAQ BX (B),74059995,31456666,36658892,142175553,2632744136.976785,1300917736.265700,1493966084.943116,5427627958.185601,688752,138459,343872,1171083
2016-04-06,NSX (C),414320,14843,202615,631778,5536722.767000,945580.110000,4514057.690800,10996360.567800,1338,79,1056,2473
2016-04-06,NYSE (DN),145782069,44422754,75289092,265493915,5802085761.745832,1719739414.198999,3178322293.042306,10700147468.987137,568168,118436,290218,976822
2016-04-06,NASDAQ (DQ),1248156574,471693983,641965443,2361816000,38919162891.307524,20559894994.682545,21756488782.837998,81235546668.828067,3898345,959198,1989139,6846682
2016-04-06,EDGA (J),88156783,44238167,42668422,175063372,2599651029.010602,1882882072.769702,1451472218.665116,5934005320.445420,731338,197571,354009,1282918
2016-04-06,EDGX (K),232609569,124364841,168779599,525754009,6927795921.667340,5774086534.163159,5971698179.563911,18673580635.394410,1482051,465100,1010123,2957274
2016-04-06,CHX (M),10160989,7890129,5360234,23411352,555651782.636000,691279103.140000,423966299.868100,1670897185.644100,305,3675,1359,5339
2016-04-06,NYSE (N),869019798,0,0,869019798,29207426867.719006,0.000000,0.000000,29207426867.719006,3034640,0,0,3034640
2016-04-06,NYSE Arca (P),270384156,316218641,169615115,756217912,9943864301.601578,16272687002.535856,7058048747.431638,33274600051.569072,1978024,950251,1241654,4169929
2016-04-06,NASDAQ (Q),414475783,124266767,423029195,961771745,16639537679.187127,6864462909.401446,18052367368.652030,41556367957.240603,3537151,552085,2900075,6989311
2016-04-06,NASDAQ PSX (X),30637813,20618331,20807485,72063629,1002159384.761501,1154770901.938899,744503925.657998,2901434212.358398,235555,89083,138378,463016
2016-04-06,BATS BYX (Y),153318853,72281220,66989657,292589730,4524882388.647100,2540138179.509222,2278166057.747911,9343186625.904233,1338772,340196,610762,2289730
2016-04-06,BATS BZX (Z),217855319,111179688,109401897,438436904,6913301286.850978,6283667323.139652,4212439912.340384,17409408522.331014,1818115,520289,932801,3271205
2016-04-05,NYSE MKT (A),0,7617605,3778494,11396099,0.000000,53877343.069800,94818021.535000,148695364.604800,0,19962,20873,40835
2016-04-05,NASDAQ BX (B),83823807,32747243,37763823,154334873,2756597300.973213,1343351846.634901,1425281603.651592,5525230751.259706,722796,144299,344501,1211596
2016-04-05,NSX (C),1080926,47772,191756,1320454,6712121.828700,2190790.215600,4833907.752900,13736819.797200,2341,331,991,3663
2016-04-05,NYSE (DN),154074771,48159263,73402438,275636472,5904846733.940060,1810425211.099299,2853275427.348862,10568547372.388221,642845,126894,293290,1063029
2016-04-05,NASDAQ (DQ),1353303175,496608288,599115030,2449026493,39301496305.716333,24739278942.010045,19743484827.898750,83784260075.625128,3911032,984872,1842506,6738410
2016-04-05,EDGA (J),97895003,44737203,41913719,184545925,2737916042.065901,1879578322.197900,1367039888.527092,5984534252.790893,771435,205620,346225,1323280
2016-04-05,EDGX (K),240230915,121703113,160978762,522912790,7088759847.793429,5469314258.711709,5554482356.356154,18112556462.861292,1527059,465591,998197,2990847
2016-04-05,CHX (M),12597989,10125235,3178694,25901918,543809503.245700,870465406.750000,181139180.914400,1595414090.910100,614,4297,1427,6338
2016-04-05,NYSE (N),1073536103,0,0,1073536103,34967930234.207979,0.000000,0.000000,34967930234.207979,3073443,0,0,3073443
2016-04-05,NYSE Arca (P),303856335,343188214,164600371,811644920,11315825200.591393,16660263560.889098,6306879751.837625,34282968513.318116,1966881,953745,1204695,4125321
2016-04-05,NASDAQ (Q),425251685,120958865,450004440,996214990,17501948647.844060,6575232785.618100,18034141004.310016,42111322437.772176,3605230,536900,2780472,6922602
2016-04-05,NASDAQ PSX (X),32680340,21442587,22030667,76153594,1055477446.910297,1157859931.117300,753837847.470596,2967175225.498193,238864,89961,139952,468777
2016-04-05,BATS BYX (Y),161615145,81022981,67325500,309963626,4702757160.440108,2636149370.351113,2284267627.926018,9623174158.717239,1405940,376856,609158,2391954
2016-04-05,BATS BZX (Z),219769776,116608372,103691864,440070012,6921992779.684647,6410579497.903910,3778508878.888505,17111081156.477062,1803150,515482,889126,3207758
2016-04-04,NYSE MKT (A),0,8104897,2538754,10643651,0.000000,45725166.610300,81544733.758000,127269900.368300,0,21793,13302,35095
2016-04-04,NASDAQ BX (B),79457489,26015509,36996676,142469674,2561299953.774103,1058566034.781902,1396758644.830691,5016624633.386696,704630,117488,334966,1157084
2016-04-04,NSX (C),259124,13062,219477,491663,3814135.911200,539694.100000,3098036.870100,7451866.881300,1026,46,902,1974
2016-04-04,NYSE (DN),136902745,38122768,74449562,249475075,4778838400.206108,1487890745.826602,3158188607.506792,9424917753.539502,572127,116232,307578,995937
2016-04-04,NASDAQ (DQ),1112407908,428488835,626848751,2167745494,31294358981.531960,17934931461.148552,21367025392.641434,70596315835.321946,3795895,878839,2042256,6716990
2016-04-04,EDGA (J),86644414,34270501,41069018,161983933,2489094273.919301,1376569039.547599,1401891232.979804,5267554546.446704,735364,162567,340151,1238082
2016-04-04,EDGX (K),220037886,101499146,163789087,485326119,6320112374.969908,4341350316.522094,6025266618.466767,16686729309.958769,1401794,380880,1029570,2812244
2016-04-04,CHX (M),6567344,7218300,3269139,17054783,314220015.470000,669752958.458000,235366933.937600,1219339907.865600,431,3095,992,4518
2016-04-04,NYSE (N),823326604,0,0,823326604,27366583894.141648,0.000000,0.000000,27366583894.141648,2856882,0,0,2856882
2016-04-04,NYSE Arca (P),261488910,285275174,167508344,714272428,9007755437.065461,14102595581.849188,6943151425.517676,30053502444.432325,1856147,788936,1251405,3896488
2016-04-04,NASDAQ (Q),395577019,94659003,402406716,892642738,15433071445.410729,4872846847.540292,17092185757.503901,37398104050.454922,3469934,420399,2792937,6683270
2016-04-04,NASDAQ PSX (X),25626178,16512389,19419447,61558014,748129782.924203,808825917.379900,717864618.664303,2274820318.968406,194137,71854,134342,400333
2016-04-04,BATS BYX (Y),146035522,62250532,64391096,272677150,4091387520.819233,2059056367.895694,2126613197.342503,8277057086.057430,1275607,298775,565583,2139965
2016-04-04,BATS BZX (Z),208756343,91698725,104834210,405289278,6263766830.522275,4502021819.681383,3839273660.514701,14605062310.718359,1724676,409146,890402,3024224
2016-04-01,NYSE MKT (A),0,8965269,3084710,12049979,0.000000,51160601.891900,73576281.647000,124736883.538900,0,23092,14038,37130
2016-04-01,NASDAQ BX (B),82635830,35628533,40078508,158342871,2791388401.438396,1522176459.039301,1618183681.350800,5931748541.828497,765786,146587,369419,1281792
2016-04-01,NSX (C),334975,10326,140729,486030,6217780.078700,534146.512500,4872001.986700,11623928.577900,1184,65,979,2228
2016-04-01,NYSE (DN),139402484,47114130,75881616,262398230,5286233672.446806,2035734733.694300,3548516254.411004,10870484660.552110,589404,131393,322222,1043019
2016-04-01,NASDAQ (DQ),1160665816,558748181,635820528,2355234525,36016418829.796083,26265991773.906278,22285505462.356566,84567916066.058927,4059505,1038298,2028337,7126140
2016-04-01,EDGA (J),89975796,47270968,42115785,179362549,2728206085.283698,2113442199.611601,1448821531.240001,6290469816.135300,792413,204256,349601,1346270
2016-04-01,EDGX (K),227220590,125695192,168169365,521085147,6616056952.551169,5811094167.229608,6205829009.516161,18632980129.296938,1499746,471195,1044931,3015872
2016-04-01,CHX (M),8947747,10019578,3756896,22724221,511265514.200200,867996023.600000,348141128.890000,1727402666.690200,425,4829,1573,6827
2016-04-01,NYSE (N),983919165,0,0,983919165,34280673388.692430,0.000000,0.000000,34280673388.692430,3125564,0,0,3125564
2016-04-01,NYSE Arca (P),254326974,337768068,167715840,759810882,9017888488.343349,18761902332.138533,6671410260.018329,34451201080.500211,1903630,935439,1213505,4052574
2016-04-01,NASDAQ (Q),405686147,122563309,465941634,994191090,16150187278.926722,6982931216.014334,20506835853.035750,43639954347.976806,3664970,528504,2929473,7122947
2016-04-01,NASDAQ PSX (X),26860415,23769900,23745497,74375812,776838500.279901,1278237487.820000,798614669.335603,2853690657.435504,202010,91573,146327,439910
2016-04-01,BATS BYX (Y),158356321,81009918,71158104,310524343,4591672871.601110,2844192013.840515,2420914757.994130,9856779643.435755,1456995,349564,633873,2440432
2016-04-01,BATS BZX (Z),220869234,123261865,116232515,460363614,6806218267.156531,6618404898.009819,4608389353.343284,18033012518.509634,1880315,522308,960745,3363368
2016-03-31,NYSE MKT (A),0,11544063,3198938,14743001,0.000000,76324820.063200,108319290.179000,184644110.242200,0,23744,16226,39970
2016-03-31,NASDAQ BX (B),79022192,31657424,37842627,148522243,2658797629.901071,1362957131.235399,1441297418.847900,5463052179.984370,711515,132841,349175,1193531
2016-03-31,NSX (C),347176,53879,143365,544420,8680770.496600,2285168.420000,2434016.736000,13399955.652600,1703,286,832,2821
2016-03-31,NYSE (DN),134071232,44803936,68012480,246887648,4739967059.120203,1793679151.359097,2719726022.589403,9253372233.068703,588815,119683,295722,1004220
2016-03-31,NASDAQ (DQ),1182267521,472470698,641052181,2295790400,36790229166.211611,23920310301.004472,21970186550.719641,82680726017.935724,3752703,879123,1878089,6509915
2016-03-31,EDGA (J),88521675,41622537,41643128,171787340,2632421504.426901,1852370507.916895,1306511453.958305,5791303466.302101,768136,183789,340860,1292785
2016-03-31,EDGX (K),207580389,110970286,155519162,474069837,6100629122.866821,5067536861.060090,5170199146.744134,16338365130.671045,1356555,419714,953915,2730184
2016-03-31,CHX (M),12877938,12428260,5285991,30592189,560905080.621600,940376316.753600,311987497.103900,1813268894.479100,486,3756,950,5192
2016-03-31,NYSE (N),996784524,0,0,996784524,34406921511.662571,0.000000,0.000000,34406921511.662571,2825971,0,0,2825971
2016-03-31,NYSE Arca (P),239127673,319662159,155942664,714732496,8515022704.770503,16536570457.803882,5959909022.194877,31011502184.769262,1758886,854182,1117272,3730340
2016-03-31,NASDAQ (Q),379654883,109085709,473601223,962341815,15105646782.796254,5760016302.000097,19124635763.547877,39990298848.344228,3302657,451245,2704463,6458365
2016-03-31,NASDAQ PSX (X),25922592,19103915,20053348,65079855,772203053.802300,1005353422.625000,704174572.793001,2481731049.220301,192606,80503,136048,409157
2016-03-31,BATS BYX (Y),154835519,82300756,67379480,304515755,4509664006.161799,2800831955.041991,2214963879.060333,9525459840.264123,1376329,367581,614624,2358534
2016-03-31,BATS BZX (Z),219917203,111589251,106594245,438100699,6671988533.168126,6017322748.337076,3920333204.312995,16609644485.818197,1768009,483186,903288,3154483
2016-03-30,NYSE MKT (A),0,8199408,2838201,11037609,0.000000,47102219.054100,82483622.829000,129585841.883100,0,21750,13278,35028
2016-03-30,NASDAQ BX (B),72921461,31794899,35769778,140486138,2385262246.856595,1344467601.305002,1396246410.618202,5125976258.779799,658686,149299,320230,1128215
2016-03-30,NSX (C),594504,61917,113651,770072,4980000.424200,375660.040500,2204070.905000,7559731.369700,1674,69,692,2435
2016-03-30,NYSE (DN),146487088,50576032,74993641,272056761,4896762030.845789,1764170110.094900,3095252177.831195,9756184318.771884,584897,123825,303551,1012273
2016-03-30,NASDAQ (DQ),1151951469,464543898,624528778,2241024145,32913578813.449493,20294240956.816583,21771868519.493180,74979688289.759256,3793158,966974,1910052,6670184
2016-03-30,EDGA (J),94740035,42134782,43690925,180565742,2539797334.971588,1737573829.066399,1418009581.408300,5695380745.446287,764415,194432,351171,1310018
2016-03-30,EDGX (K),229750279,114365800,166482504,510598583,6140810164.182536,5091850591.674497,6029616345.104648,17262277100.961681,1414644,429124,996533,2840301
2016-03-30,CHX (M),15220640,13220827,4829135,33270602,627202746.695400,842768675.115000,413146465.587600,1883117887.398000,626,4005,1757,6388
2016-03-30,NYSE (N),823903839,0,0,823903839,25925644537.585518,0.000000,0.000000,25925644537.585518,2922629,0,0,2922629
2016-03-30,NYSE Arca (P),248534012,293749263,161823171,704106446,8257727590.550191,14593077137.553078,6684403822.325442,29535208550.428711,1822125,867260,1161034,3850419
2016-03-30,NASDAQ (Q),404677196,114716139,409628870,929022205,14765971231.653627,6272965343.741788,16880353357.901593,37919289933.297008,3381348,500279,2797451,6679078
2016-03-30,NASDAQ PSX (X),28108303,19297614,21509473,68915390,771025930.076501,1028638175.192100,739296470.744099,2538960576.012700,205525,80459,141486,427470
2016-03-30,BATS BYX (Y),154135897,78445648,65671275,298252820,4279025696.430069,2591040534.202582,2251841879.036003,9121908109.668654,1342349,361779,581342,2285470
2016-03-30,BATS BZX (Z),223507653,111154705,109868541,444530899,6368734948.625402,6050342258.123697,4332140172.355882,16751217379.104981,1792727,487762,925235,3205724
2016-03-29,NYSE MKT (A),0,8957289,3067812,12025101,0.000000,55620622.069000,92649998.310000,148270620.379000,0,22683,16966,39649
2016-03-29,NASDAQ BX (B),76304240,35912951,36537635,148754826,2507821206.904402,1490550011.209398,1406701967.268392,5405073185.382192,698794,154130,337979,1190903
2016-03-29,NSX (C),742022,20800,121115,883937,4649673.910600,30595.020000,2294381.419100,6974650.349700,2085,14,597,2696
2016-03-29,NYSE (DN),145954687,52271625,71712372,269938684,5008008356.104627,1945950346.192696,2908390338.556812,9862349040.854135,586103,132050,305969,1024122
2016-03-29,NASDAQ (DQ),1221972996,467338063,640494515,2329805574,34356959537.400125,20830206921.976568,21716625785.268547,76903792244.645240,3846248,986897,1937352,6770497
2016-03-29,EDGA (J),95566733,46797110,45035321,187399164,2678232546.818700,1988371379.352502,1455469542.245194,6122073468.416396,804304,203716,357173,1365193
2016-03-29,EDGX (K),237471107,123136834,167815316,528423257,6159887553.980564,5548708681.515203,5841268719.407805,17549864954.903572,1437768,469202,1030615,2937585
2016-03-29,CHX (M),17560845,8276484,3398603,29235932,567016595.374100,802396324.988500,227048529.290000,1596461449.652600,325,4147,1395,5867
2016-03-29,NYSE (N),968837451,0,0,968837451,30683279753.638464,0.000000,0.000000,30683279753.638464,3017766,0,0,3017766
2016-03-29,NYSE Arca (P),260522872,352884318,170756995,784164185,8625872316.127175,17644466980.637812,6612098030.482179,32882437327.247166,1839418,934074,1201270,3974762
2016-03-29,NASDAQ (Q),409111383,132291953,475238804,1016642140,14874800569.361224,6960881357.684694,18932030522.001435,40767712449.047353,3446422,542780,2896310,6885512
2016-03-29,NASDAQ PSX (X),27215243,22542652,22255010,72012905,770789905.505600,1222174928.869899,805681641.658099,2798646476.033598,202777,92983,146393,442153
2016-03-29,BATS BYX (Y),151409058,82727858,68487003,302623919,4275753118.280727,2830821311.188507,2242260206.270202,9348834635.739436,1347710,367365,608480,2323555
2016-03-29,BATS BZX (Z),223773172,121420687,114396065,459589924,6499542337.387444,6611340164.823578,4142403758.959744,17253286261.170766,1829634,534952,950044,3314630
2016-03-28,NYSE MKT (A),0,6313251,2920263,9233514,0.000000,35349382.934600,95595407.193000,130944790.127600,0,17425,16103,33528
2016-03-28,NASDAQ BX (B),59369160,22281290,28824396,110474846,2007129561.651900,905484350.685900,1073978451.765695,3986592364.103495,549885,104314,266833,921032
2016-03-28,NSX (C),71317,3794,363594,438705,3569915.290000,2394.219400,1254155.893400,4826465.402800,620,7,879,1506
2016-03-28,NYSE (DN),109234168,34320958,54940774,198495900,3644589401.756407,1348977503.647303,2147779143.738394,7141346049.142104,466714,89273,247705,803692
2016-03-28,NASDAQ (DQ),881495289,368300384,477996524,1727792197,25079843157.599072,15427725850.186871,14744128278.593011,55251697286.378954,3182186,695243,1590345,5467774
2016-03-28,EDGA (J),73114983,27968655,35908895,136992533,2073302125.978984,1212704574.432801,1136171664.862299,4422178365.274084,643895,134522,291221,1069638
2016-03-28,EDGX (K),170478263,81847783,140580085,392906131,4828130785.678397,3701374052.579296,4453581694.330761,12983086532.588454,1134649,334031,845762,2314442
2016-03-28,CHX (M),5581485,6572119,3072854,15226458,247788155.935000,461971860.588600,123851245.602700,833611262.126300,280,2357,1061,3698
2016-03-28,NYSE (N),706546580,0,0,706546580,23512247435.644938,0.000000,0.000000,23512247435.644938,2464153,0,0,2464153
2016-03-28,NYSE Arca (P),189161561,241857711,134348589,565367861,6561598172.221173,12098885234.173188,5025265234.054805,23685748640.449166,1421728,663835,969458,3055021
2016-03-28,NASDAQ (Q),314242889,80835843,352149914,747228646,11833455541.213086,4454293430.730592,13984644479.580420,30272393451.524098,2747553,374391,2328421,5450365
2016-03-28,NASDAQ PSX (X),21176907,15886747,16123441,53187095,609618463.707901,886171567.648501,558636242.039698,2054426273.396100,160232,66869,113064,340165
2016-03-28,BATS BYX (Y),116823314,53740361,49166415,219730090,3393138797.989480,1756957256.407098,1618851981.497411,6768948035.893989,1080129,263131,462948,1806208
2016-03-28,BATS BZX (Z),167593610,78280604,88345042,334219256,5049494848.466258,4293703139.165293,3150360616.434562,12493558604.066113,1459441,376258,775684,2611383
2016-03-24,NYSE MKT (A),0,7556535,2831353,10387888,0.000000,56851754.907300,86423478.821000,143275233.728300,0,18636,14609,33245
2016-03-24,NASDAQ BX (B),70665730,28053224,29990485,128709439,2274717973.551606,1070351626.951801,1190273261.207404,4535342861.710811,615906,123797,279517,1019220
2016-03-24,NSX (C),49543,63334,100626,213503,2041795.880000,2566479.540000,5334073.044000,9942348.464000,398,490,520,1408
2016-03-24,NYSE (DN),124507084,38330964,60877548,223715596,3940005095.489019,1538471165.412297,2404878338.371702,7883354599.273018,529337,108611,262585,900533
2016-03-24,NASDAQ (DQ),1066371245,423771675,567521565,2057664485,29159430098.760318,18313345383.134479,17883023938.978630,65355799420.873427,3456168,880444,1670734,6007346
2016-03-24,EDGA (J),87528089,39715007,40492632,167735728,2402437238.927897,1717121741.960206,1200979111.889089,5320538092.777192,720081,178767,312181,1211029
2016-03-24,EDGX (K),199751237,107320760,154293308,461365305,5649459299.789589,4838060843.622376,4785350919.170485,15272871062.582450,1278459,406163,890771,2575393
2016-03-24,CHX (M),13284818,11696416,7971148,32952382,464291022.118200,887441644.070000,571035004.095000,1922767670.283200,305,4330,1046,5681
2016-03-24,NYSE (N),887314765,0,0,887314765,29609283533.087439,0.000000,0.000000,29609283533.087439,2760598,0,0,2760598
2016-03-24,NYSE Arca (P),230538570,301170468,147863042,679572080,8080025220.252053,14694450045.240882,5536766997.717259,28311242263.210194,1702518,828791,1042620,3573929
2016-03-24,NASDAQ (Q),364874276,109346312,400823849,875044437,13681959481.053077,6061495967.442621,16381280819.003785,36124736267.499483,3105808,460815,2515047,6081670
2016-03-24,NASDAQ PSX (X),23914600,20701427,17879966,62495993,707983662.664800,1096384746.757200,650060394.218000,2454428803.640000,180045,87204,122909,390158
2016-03-24,BATS BYX (Y),145465345,74585552,60141790,280192687,4037495799.746121,2408837076.700101,1998157078.900824,8444489955.347046,1256750,354593,554427,2165770
2016-03-24,BATS BZX (Z),199431863,101572616,102517787,403522266,6020631493.277915,5356102861.902085,3743836056.613418,15120570411.793418,1653756,453983,857743,2965482
2016-03-23,NYSE MKT (A),0,8635275,2885214,11520489,0.000000,49394630.517400,86106820.929800,135501451.447200,0,21778,14633,36411
2016-03-23,NASDAQ BX (B),75980331,35122168,33714485,144816984,2528906496.190824,1280924567.966303,1300689081.311392,5110520145.468519,686643,149348,308149,1144140
2016-03-23,NSX (C),82517,24500,205775,312792,3678460.030000,914505.210000,4884317.867200,9477283.107200,665,182,763,1610
2016-03-23,NYSE (DN),140920462,53495620,65055239,259471321,4635290535.212310,1910757774.843902,2540268415.297808,9086316725.354020,563069,133889,265229,962187
2016-03-23,NASDAQ (DQ),1170679752,524657795,616941980,2312279527,33361033470.435143,21864717006.350984,18158861359.279139,73384611836.065266,3715616,1007442,1803805,6526863
2016-03-23,EDGA (J),94212896,48011401,45144717,187369014,2663906316.935799,1903436148.975499,1282180823.238510,5849523289.149808,787991,211859,338518,1338368
2016-03-23,EDGX (K),226779018,128632280,183204395,538615693,6157621261.877753,5293956725.820085,5334290009.601120,16785867997.298958,1367316,458317,980474,2806107
2016-03-23,CHX (M),11855067,11484863,3882101,27222031,540811699.777600,888189014.520000,236422177.020000,1665422891.317600,396,4717,1198,6311
2016-03-23,NYSE (N),862473794,0,0,862473794,27930595262.665004,0.000000,0.000000,27930595262.665004,2959169,0,0,2959169
2016-03-23,NYSE Arca (P),257202070,371354700,164938736,793495506,8570302010.120622,16035454264.621695,6041940525.734402,30647696800.476719,1813394,921620,1112439,3847453
2016-03-23,NASDAQ (Q),402653187,130116725,421317416,954087328,14996145829.060195,6410106801.187488,16485225621.145555,37891478251.393238,3375558,523049,2737041,6635648
2016-03-23,NASDAQ PSX (X),27680229,21911753,19513274,69105256,772597433.559900,989396587.869901,726340396.595099,2488334418.024900,200130,89923,135070,425123
2016-03-23,BATS BYX (Y),158321626,84232387,68572373,311126386,4499387415.119115,2694583427.138816,2177586516.475679,9371557358.733610,1408061,386230,621969,2416260
2016-03-23,BATS BZX (Z),216780216,118661413,108589925,444031554,6415496397.394781,6310625127.391802,3926776539.382339,16652898064.168922,1765871,526747,903435,3196053
2016-03-22,NYSE MKT (A),0,7653068,2591426,10244494,0.000000,50246636.151800,79822192.817000,130068828.968800,0,19083,12924,32007
2016-03-22,NASDAQ BX (B),66781460,24744349,30311604,121837413,2208570428.162816,1003926883.384198,1139344993.155897,4351842304.702911,602601,115077,278211,995889
2016-03-22,NSX (C),66054,7000,167010,240064,3141052.405000,144545.000000,5696478.600900,8982076.005900,485,59,1194,1738
2016-03-22,NYSE (DN),135223218,43279292,72687883,251190393,4501979582.494194,1572901905.378895,2895023879.710706,8969905367.583795,540031,97019,268742,905792
2016-03-22,NASDAQ (DQ),1098999953,404188923,567396486,2070585362,33107482827.804605,19556821835.020111,18975636808.197079,71639941471.021795,3519466,820719,1732051,6072236
2016-03-22,EDGA (J),82445299,36609524,39299993,158354816,2401731119.909396,1670187615.855104,1283061841.293104,5354980577.057604,702823,168530,310729,1182082
2016-03-22,EDGX (K),219834884,104217031,159506817,483558732,6293965964.228135,4819498588.034695,5314719297.818475,16428183850.081305,1377699,397535,946767,2722001
2016-03-22,CHX (M),10982271,13115597,9729462,33827330,458046351.238200,735599671.607000,358732631.746400,1552378654.591600,480,3688,1033,5201
2016-03-22,NYSE (N),840669491,0,0,840669491,28577696489.005509,0.000000,0.000000,28577696489.005509,2695710,0,0,2695710
2016-03-22,NYSE Arca (P),235415705,277356119,147229975,660001799,8475520291.139892,14438614984.121029,6004364763.270456,28918500038.531377,1720579,782689,1043056,3546324
2016-03-22,NASDAQ (Q),367581072,100935717,391276336,859793125,14120339349.987016,5659393502.956782,16496143281.871484,36275876134.815282,3166312,445009,2507251,6118572
2016-03-22,NASDAQ PSX (X),24064928,18347066,18453956,60865950,697736246.873397,972498393.140900,686989452.241900,2357224092.256197,173521,78481,119995,371997
2016-03-22,BATS BYX (Y),139305409,65620458,61445915,266371782,4026632406.826111,2350121317.596997,2087245473.991163,8463999198.414271,1256866,313515,556975,2127356
2016-03-22,BATS BZX (Z),202121079,98621149,97666935,398409163,6185567214.163945,5622078350.729811,3730488269.874082,15538133834.767838,1697108,454244,833512,2984864
2016-03-21,NYSE MKT (A),0,7136169,2521704,9657873,0.000000,42146594.648400,68178768.085800,110325362.734200,0,20265,13368,33633
2016-03-21,NASDAQ BX (B),62824995,27382781,29825129,120032905,2241541445.395236,1090926830.188401,1196796274.593201,4529264550.176838,616875,128340,288680,1033895
2016-03-21,NSX (C),63703,1300,83309,148312,2721261.310000,73789.990000,2870914.848200,5665966.148200,575,14,513,1102
2016-03-21,NYSE (DN),127631629,45784183,65440121,238855933,4504152489.989419,1614435939.039197,2554406049.315387,8672994478.344003,547659,115191,266214,929064
2016-03-21,NASDAQ (DQ),1068879543,420060304,584687491,2073627338,32689092991.802131,19226030201.950924,19312475462.976442,71227598656.729497,3603986,833551,1811208,6248745
2016-03-21,EDGA (J),83173851,35419216,37865873,156458940,2515659559.868950,1492246977.499705,1266208178.451400,5274114715.820055,737092,166349,323356,1226797
2016-03-21,EDGX (K),225549961,104585284,160263734,490398979,6592439172.217757,4565324468.510701,5509952181.382344,16667715822.110802,1481275,408798,1014837,2904910
2016-03-21,CHX (M),13658214,10972255,4917727,29548196,459612557.626000,741255645.685000,307708588.325700,1508576791.636700,485,3640,946,5071
2016-03-21,NYSE (N),836184581,0,0,836184581,28401010950.725951,0.000000,0.000000,28401010950.725951,2922545,0,0,2922545
2016-03-21,NYSE Arca (P),225633550,260725946,148326103,634685599,8340423766.040618,12718933806.906147,5978581514.877945,27037939087.824710,1724877,820678,1085728,3631283
2016-03-21,NASDAQ (Q),374040473,102085193,395612541,871738207,14721152793.604352,5284651930.259905,16644997105.087267,36650801828.951524,3278892,451759,2681556,6412207
2016-03-21,NASDAQ PSX (X),27311635,18037105,20734396,66083136,812940616.124501,854108237.059100,764690200.330600,2431739053.514201,211983,79346,139902,431231
2016-03-21,BATS BYX (Y),137707557,65868296,61556163,265132016,4093094786.170883,2235762049.038514,2073783287.584937,8402640122.794334,1267793,321362,558697,2147852
2016-03-21,BATS BZX (Z),203249401,99510197,100418097,403177695,6384497459.881744,5094171050.541811,3775097849.379784,15253766359.803339,1753016,451402,872089,3076507
2016-03-18,NYSE MKT (A),0,54995158,2794896,57790054,0.000000,371234172.030100,79201172.940400,450435344.970500,0,25960,15669,41629
2016-03-18,NASDAQ BX (B),93017446,40410045,41288512,174716003,3127549506.348067,1697054948.615500,1698544915.578380,6523149370.541947,827113,172930,380016,1380059
2016-03-18,NSX (C),313129,9390,238381,560900,12331912.505400,87938.920000,5922860.548200,18342711.973600,1609,32,1414,3055
2016-03-18,NYSE (DN),181195233,48736965,72751250,302683448,6351007581.441534,1920979643.502599,3160314092.494798,11432301317.438931,733889,133838,311397,1179124
2016-03-18,NASDAQ (DQ),1843260085,581918750,872835682,3298014517,54632166877.561068,27991227821.513503,30388912326.094555,113012307025.169126,4531976,1060734,2046009,7638719
2016-03-18,EDGA (J),121992044,53810645,52284528,228087217,3543234582.290994,2422298193.558800,1816174495.323795,7781707271.173589,990784,241608,415362,1647754
2016-03-18,EDGX (K),309600751,140883687,195557667,646042105,8516196445.067216,6526435454.619003,6777819762.590843,21820451662.277062,1919208,548190,1202664,3670062
2016-03-18,CHX (M),15099280,18880798,8641149,42621227,613732697.515800,1187720327.800000,460463614.378600,2261916639.694400,3199,4430,1561,9190
2016-03-18,NYSE (N),2589508874,0,0,2589508874,91134010661.693768,0.000000,0.000000,91134010661.693768,3804473,0,0,3804473
2016-03-18,NYSE Arca (P),322419260,396454390,178285185,897158835,11403017287.827836,20537134458.468953,7358235209.590395,39298386955.887184,2293878,1080983,1272089,4646950
2016-03-18,NASDAQ (Q),512603862,145023106,1172357795,1829984763,19056292011.656295,8571065214.505686,43774277380.224480,71401634606.386461,4149139,621848,3361989,8132976
2016-03-18,NASDAQ PSX (X),35182029,22941234,24101340,82224603,1002744783.842999,1248549003.510997,870185733.062800,3121479520.416796,256981,98300,168432,523713
2016-03-18,BATS BYX (Y),199407242,88518436,82097259,370022937,5756939080.486327,3115184548.328807,2816710082.022681,11688833710.837815,1669012,382022,716179,2767213
2016-03-18,BATS BZX (Z),285906636,134997247,129715186,550619069,8567883108.877458,7547614354.594602,5203364245.704826,21318861709.176886,2294589,588806,1094331,3977726
2016-03-17,NYSE MKT (A),0,9814921,3107716,12922637,0.000000,51539601.364900,86264695.767000,137804297.131900,0,24010,15734,39744
2016-03-17,NASDAQ BX (B),90883427,40591659,38422662,169897748,3024400512.835347,1555447966.798004,1593430655.164075,6173279134.797426,825421,182468,368833,1376722
2016-03-17,NSX (C),175438,4836,501103,681377,6307024.152500,66425.600000,7566087.158400,13939536.910900,1247,48,2271,3566
2016-03-17,NYSE (DN),182130444,65536164,81781094,329447702,6441477881.320696,2318021665.685201,3520113245.554584,12279612792.560481,742375,179543,344149,1266067
2016-03-17,NASDAQ (DQ),1470000888,646772261,683612380,2800385529,43864486584.098644,29453281666.419103,23345272589.868914,96663040840.386661,4594617,1163782,2115908,7874307
2016-03-17,EDGA (J),111507767,57633521,46350202,215491490,3100012399.976928,2389472958.554702,1576491565.713088,7065976924.244718,956237,259225,389406,1604868
2016-03-17,EDGX (K),306362442,154849292,188625304,649837038,8671484432.995666,6735390633.137092,6657526261.888513,22064401328.021271,1950853,577674,1213963,3742490
2016-03-17,CHX (M),16830689,14262053,5056617,36149359,532139891.887100,1306223261.800000,332986453.207000,2171349606.894100,651,5594,1594,7839
2016-03-17,NYSE (N),1040040791,0,0,1040040791,34149193210.974075,0.000000,0.000000,34149193210.974075,3460628,0,0,3460628
2016-03-17,NYSE Arca (P),320766138,435077544,186246625,942090307,11151698296.403698,21416326171.095355,7691206533.569989,40259231001.069042,2268400,1165455,1356379,4790234
2016-03-17,NASDAQ (Q),500799065,151966678,455697186,1108462929,18874713366.477874,8084496353.088017,19071268320.437100,46030478040.002991,4179684,634638,3114705,7929027
2016-03-17,NASDAQ PSX (X),35824377,22772021,23251345,81847743,1054290856.871999,1158765293.308099,848554944.700599,3061611094.880697,270612,101889,163102,535603
2016-03-17,BATS BYX (Y),182877991,93735239,74485058,351098288,5213257794.265164,3285105020.445606,2607043744.192612,11105406558.903382,1655231,406889,689705,2751825
2016-03-17,BATS BZX (Z),277053475,147854465,121599936,546507876,8132069981.945031,7459577375.698374,4577006147.803153,20168653505.446558,2211749,636877,1027986,3876612
2016-03-16,NYSE MKT (A),0,8072885,2850440,10923325,0.000000,57057269.963300,71901349.833000,128958619.796300,0,22123,14710,36833
2016-03-16,NASDAQ BX (B),83387852,40830063,39534530,163752445,2782441717.872176,1560409657.923898,1594243152.888614,5937094528.684688,772631,178242,370781,1321654
2016-03-16,NSX (C),104880,8609,255012,368501,4412944.532200,667952.500000,3526594.962300,8607491.994500,949,45,1073,2067
2016-03-16,NYSE (DN),164619777,63513100,73685345,301818222,5566708076.246005,2646994242.193690,3168803691.236213,11382506009.675908,664145,161659,306890,1132694
2016-03-16,NASDAQ (DQ),1233593077,578564274,617431460,2429588811,34365813595.100407,25380660790.260116,20121736281.376680,79868210666.737203,4019344,1077353,1888728,6985425
2016-03-16,EDGA (J),103367225,56101089,46341689,205810003,2830896725.317111,2365462260.513293,1556494919.783522,6752853905.613926,873196,256231,385486,1514913
2016-03-16,EDGX (K),284043462,155846200,182522470,622412132,7954355209.191400,6889583405.501509,6132337618.636244,20976276233.329153,1860077,603396,1146588,3610061
2016-03-16,CHX (M),13102251,10329824,6087806,29519881,655615822.657900,1221863728.919999,433742388.648000,2311221940.225899,481,7165,2921,10567
2016-03-16,NYSE (N),941673152,0,0,941673152,29689660096.278614,0.000000,0.000000,29689660096.278614,3462391,0,0,3462391
2016-03-16,NYSE Arca (P),292773541,445228116,175455689,913457346,10062297435.567377,21451494490.020321,6972185407.046232,38485977332.633930,2182916,1192354,1289123,4664393
2016-03-16,NASDAQ (Q),476454935,167685175,425445625,1069585735,17472371277.972753,9075465327.377934,17589221320.003054,44137057925.353741,4111673,721634,3059750,7893057
2016-03-16,NASDAQ PSX (X),34743749,25959967,21123092,81826808,975961452.374005,1299222207.024300,818774212.057600,3093957871.455905,245204,107844,152298,505346
2016-03-16,BATS BYX (Y),168581314,90747717,71183039,330512070,4843676834.476432,3120271189.913193,2559164691.145519,10523112715.535144,1560221,407190,693286,2660697
2016-03-16,BATS BZX (Z),263330264,156643853,122654557,542628674,7650899001.242928,8311676869.441185,4763666129.385712,20726242000.069825,2187687,697113,1054265,3939065
2016-03-15,NYSE MKT (A),0,7994610,2988775,10983385,0.000000,60459844.517200,88017820.914700,148477665.431900,0,20688,15127,35815
2016-03-15,NASDAQ BX (B),75864814,32274525,34531683,142671022,2482255460.309914,1220572554.015603,1340467155.423703,5043295169.749220,684062,150045,318104,1152211
2016-03-15,NSX (C),232102,51300,967061,1250463,7035884.490200,1893773.510000,4899647.962900,13829305.963100,1339,276,2224,3839
2016-03-15,NYSE (DN),144919108,49682754,70281245,264883107,5002537313.495908,1912749448.642499,2729225279.256816,9644512041.395223,586434,115435,278189,980058
2016-03-15,NASDAQ (DQ),1086861595,440495425,589702692,2117059712,30989363559.013585,20535771049.401016,18414975001.716794,69940109610.131395,3723225,863641,1806791,6393657
2016-03-15,EDGA (J),94085962,43544880,42410801,180041643,2698171280.845065,1824179265.733502,1349436156.862891,5871786703.441458,810581,203224,347504,1361309
2016-03-15,EDGX (K),242342349,110469749,175949113,528761211,6919551687.125205,4702110234.263497,5574596814.148687,17196258735.537389,1556008,416602,1037237,3009847
2016-03-15,CHX (M),9202729,21888707,4825573,35917009,221057119.106400,1302021269.805000,390444759.496000,1913523148.407400,470,5592,1920,7982
2016-03-15,NYSE (N),830982488,0,0,830982488,26784639424.998117,0.000000,0.000000,26784639424.998117,2878389,0,0,2878389
2016-03-15,NYSE Arca (P),263974887,312923493,165398754,742297134,9220912151.474915,15651411447.833852,6351842467.101635,31224166066.410402,1928967,892354,1182609,4003930
2016-03-15,NASDAQ (Q),415916961,112274247,413194264,941385472,15646057076.607350,5543137181.672390,16703842915.443971,37893037173.723711,3547901,485901,2728675,6762477
2016-03-15,NASDAQ PSX (X),28194583,19867867,19221847,67284297,818254314.983896,905442597.012100,681416972.731200,2405113884.727196,216323,86206,135281,437810
2016-03-15,BATS BYX (Y),152325852,75834864,68376646,296537362,4368367010.481856,2505699071.769694,2337550107.036483,9211616189.288033,1369728,343480,642356,2355564
2016-03-15,BATS BZX (Z),221430310,104134933,107401325,432966568,6629267975.795020,5149195398.401387,3926903277.709932,15705366651.906339,1851407,469284,917003,3237694
2016-03-14,NYSE MKT (A),0,8436487,2671070,11107557,0.000000,51603643.378100,74085278.761100,125688922.139200,0,22568,14623,37191
2016-03-14,NASDAQ BX (B),72502525,31229598,33316884,137049007,2289064650.606833,1209683776.433300,1269605708.310303,4768354135.350436,656067,141721,306504,1104292
2016-03-14,NSX (C),100491,15825,424338,540654,5279024.313900,40710.730000,2621165.611100,7940900.655000,844,66,1009,1919
2016-03-14,NYSE (DN),136035981,44413998,64315420,244765399,4495118162.873516,1578563411.854500,2601468566.779408,8675150141.507424,586832,120674,275641,983147
2016-03-14,NASDAQ (DQ),1043929233,406356558,565202284,2015488075,29148201062.929501,16876231214.921557,18083691518.944829,64108123796.795887,3545765,847786,1797515,6191066
2016-03-14,EDGA (J),90193318,39110411,41013165,170316894,2472372595.923717,1617398118.338300,1341747082.261190,5431517796.523207,777313,189466,334709,1301488
2016-03-14,EDGX (K),234436187,110281590,160524134,505241911,6248600942.926788,4507346012.001216,5278899072.502599,16034846027.430603,1531774,403207,985001,2919982
2016-03-14,CHX (M),9949773,11036688,3951579,24938040,474585780.548100,888575495.036400,212687350.664000,1575848626.248500,416,4878,1204,6498
2016-03-14,NYSE (N),858246849,0,0,858246849,28150972439.703956,0.000000,0.000000,28150972439.703956,2968917,0,0,2968917
2016-03-14,NYSE Arca (P),246619821,321427595,156013752,724061168,8329947883.677558,14668887750.337859,6134285407.166934,29133121041.182351,1904514,886296,1163983,3954793
2016-03-14,NASDAQ (Q),400240234,108410916,399631735,908282885,14470824001.116938,5305125609.512277,16130420563.010497,35906370173.639712,3506896,477947,2727530,6712373
2016-03-14,NASDAQ PSX (X),28264660,16898941,18994065,64157666,775105264.716805,768216583.183900,661142750.294100,2204464598.194805,216880,75222,126056,418158
2016-03-14,BATS BYX (Y),153152861,71281469,67449561,291883891,4219553465.748035,2384785183.751881,2263353103.662207,8867691753.162123,1391884,338111,614011,2344006
2016-03-14,BATS BZX (Z),216590998,105564686,104623369,426779053,6184809938.379152,5102286375.440793,3769302023.877404,15056398337.697349,1865277,478918,914044,3258239
2016-03-11,NYSE MKT (A),0,8688546,3616787,12305333,0.000000,62567431.266800,97811364.991900,160378796.258700,0,22361,18910,41271
2016-03-11,NASDAQ BX (B),80498877,39958572,35921783,156379232,2557633417.439092,1439540550.349103,1407262258.671994,5404436226.460189,698940,169162,328971,1197073
2016-03-11,NSX (C),166883,15000,133145,315028,8468016.340000,535713.300000,3685672.060000,12689401.700000,1165,124,760,2049
2016-03-11,NYSE (DN),173274756,52466170,76990537,302731463,5555518136.991456,1809201432.952797,3038946331.803271,10403665901.747524,646979,124987,282327,1054293
2016-03-11,NASDAQ (DQ),1281893685,602983933,627396013,2512273631,36316752418.704502,26813522572.284296,19656846516.292931,82787121507.281729,4057564,982017,1887820,6927401
2016-03-11,EDGA (J),101304209,49158733,46831705,197294647,2810821199.296394,1941134378.760202,1539363066.186198,6291318644.242794,830013,215496,365464,1410973
2016-03-11,EDGX (K),266852537,143127893,182742450,592722880,7480509134.590638,5595961486.736812,6133435116.071824,19209905737.399274,1668902,474204,1074182,3217288
2016-03-11,CHX (M),9847190,16733265,4710139,31290594,244778408.674000,1391798961.790001,315899159.405000,1952476529.869001,457,7311,1752,9520
2016-03-11,NYSE (N),997398062,0,0,997398062,32465629489.076254,0.000000,0.000000,32465629489.076254,3193609,0,0,3193609
2016-03-11,NYSE Arca (P),279200412,402237987,172672056,854110455,9555497662.006898,19517004278.856612,6788629536.274741,35861131477.138251,2004606,1010850,1198191,4213647
2016-03-11,NASDAQ (Q),445292689,135622795,439947554,1020863038,16174153860.648159,7116506980.288666,18388084920.239576,41678745761.176401,3583981,552995,2760313,6897289
2016-03-11,NASDAQ PSX (X),30304937,24631817,21807213,76743967,843374544.257801,1175237230.595200,791788886.637899,2810400661.490900,219035,93137,131384,443556
2016-03-11,BATS BYX (Y),163690148,89403212,69192746,322286106,4527026177.443734,2864388615.158672,2284098409.696982,9675513202.299388,1373757,367698,582117,2323572
2016-03-11,BATS BZX (Z),252908041,129666540,121041156,503615737,7531668254.159125,6843097103.591103,4726304410.906286,19101069768.656514,2018222,558636,981106,3557964
2016-03-10,NYSE MKT (A),0,10312634,4019926,14332560,0.000000,55248374.804600,104408460.052000,159656834.856600,0,23085,20662,43747
2016-03-10,NASDAQ BX (B),82921538,47534531,36879322,167335391,2475181072.819178,1704716115.938800,1489154235.941803,5669051424.699781,702594,189378,335449,1227421
2016-03-10,NSX (C),115370,3700,58523,177593,6501436.440000,159108.000000,1906474.740000,8567019.180000,891,35,494,1420
2016-03-10,NYSE (DN),171071937,62866095,76530239,310468271,5286930565.678169,2257161814.201897,3157250414.669703,10701342794.549769,670465,150396,308738,1129599
2016-03-10,NASDAQ (DQ),1321876816,701339464,655367976,2678584256,35315199602.951884,26197476504.565424,21485541039.018601,82998217146.535909,3946449,1095695,1938427,6980571
2016-03-10,EDGA (J),104760442,66954290,47507834,219222566,2689678182.789409,2693056266.901604,1574758251.680804,6957492701.371817,836057,284710,367740,1488507
2016-03-10,EDGX (K),303472116,189088396,205608265,698168777,7965077378.118334,7748679882.653430,6927075923.506783,22640833184.278547,1909558,629804,1254392,3793754
2016-03-10,CHX (M),8437061,19337800,4855243,32630104,236262992.661200,1704852927.808800,368618075.854500,2309733996.324500,575,9354,3041,12970
2016-03-10,NYSE (N),1050276147,0,0,1050276147,31292417682.001605,0.000000,0.000000,31292417682.001605,3814272,0,0,3814272
2016-03-10,NYSE Arca (P),317241550,510098111,200102578,1027442239,10054233999.064382,24113254023.456872,8077213528.273956,42244701550.795210,2284978,1418999,1421126,5125103
2016-03-10,NASDAQ (Q),523906425,207364145,467757317,1199027887,17724760485.512261,11144302605.057635,19049087398.491113,47918150489.061009,4316272,841868,3276840,8434980
2016-03-10,NASDAQ PSX (X),37169445,31341999,25515994,94027438,985752732.198295,1666674657.580801,954067515.972898,3606494905.751994,253891,126444,157814,538149
2016-03-10,BATS BYX (Y),171643165,117719245,72888833,362251243,4762721211.630844,3701115135.459533,2538723069.322830,11002559416.413207,1463420,515921,648504,2627845
2016-03-10,BATS BZX (Z),285596686,185034942,140938286,611569914,7898576925.661905,9668087236.436019,5401104356.153693,22967768518.251617,2289451,792103,1172256,4253810
2016-03-09,NYSE MKT (A),0,10128973,4687070,14816043,0.000000,62045154.303500,129793141.081800,191838295.385300,0,24269,25512,49781
2016-03-09,NASDAQ BX (B),80727664,39309443,34945670,154982777,2320215923.589252,1244042327.104099,1256368742.483695,4820626993.177046,691043,144785,320110,1155938
2016-03-09,NSX (C),91727,1000,46100,138827,5014580.770000,35961.130000,2041462.990000,7092004.890000,695,5,433,1133
2016-03-09,NYSE (DN),164220946,60146069,70544724,294911739,5014607964.456996,1604216164.802296,2711839223.355425,9330663352.614717,654862,130001,281045,1065908
2016-03-09,NASDAQ (DQ),1298735773,600310297,631215906,2530261976,35012270486.304370,18868216153.156530,18597132784.383979,72477619423.844879,4036300,917376,1874508,6828184
2016-03-09,EDGA (J),103104758,53262073,47412670,203779501,2637199553.606607,1914860778.256401,1391373454.995406,5943433786.858414,826773,222595,367329,1416697
2016-03-09,EDGX (K),259416223,151312297,180232816,590961336,7100364123.804334,5113852954.229492,5760410541.847180,17974627619.881006,1654586,457885,1089663,3202134
2016-03-09,CHX (M),8540963,9410291,5854141,23805395,331349916.910000,849928610.529999,462792020.645700,1644070548.085699,397,4890,1613,6900
2016-03-09,NYSE (N),958023710,0,0,958023710,30357291672.262357,0.000000,0.000000,30357291672.262357,3303825,0,0,3303825
2016-03-09,NYSE Arca (P),283264849,366219470,174509893,823994212,9535902440.294655,15909870652.894470,6770235679.736956,32216008772.926081,2063638,1035797,1235839,4335274
2016-03-09,NASDAQ (Q),451022377,138699955,429708868,1019431200,16391756906.366253,6742465831.675908,17244466220.278395,40378688958.320556,3819724,566356,2928094,7314174
2016-03-09,NASDAQ PSX (X),32926047,22765620,21469288,77160955,927671561.244901,1056868672.704099,720459295.746802,2704999529.695802,246242,92881,145197,484320
2016-03-09,BATS BYX (Y),171262583,91636686,74002509,336901778,4752560873.122421,2696691496.134910,2444301890.499038,9893554259.756369,1459502,370910,672347,2502759
2016-03-09,BATS BZX (Z),241822523,125934261,117048844,484805628,7185457610.455731,5875551866.690901,4324274762.956292,17385284240.102924,1992402,548075,994319,3534796
2016-03-08,NYSE MKT (A),0,12192431,4356867,16549298,0.000000,69991541.920000,112316768.355100,182308310.275100,0,27945,20274,48219
2016-03-08,NASDAQ BX (B),86623521,45345849,38297366,170266736,2380374405.088120,1533519015.210104,1346188539.006399,5260081959.304623,737131,180927,345618,1263676
2016-03-08,NSX (C),117496,64974,70048,252518,4684120.100000,1642514.600000,2766227.870000,9092862.570000,950,286,540,1776
2016-03-08,NYSE (DN),189343439,71479017,78455855,339278311,5334700710.247779,2114877058.735694,2954387455.063000,10403965224.046473,705405,153731,300173,1159309
2016-03-08,NASDAQ (DQ),1473471939,696761403,685164812,2855398154,37102592469.421926,24633142022.390316,20094395352.357015,81830129844.169257,4416437,1131652,1994253,7542342
2016-03-08,EDGA (J),110996156,58666555,49434993,219097704,2700994391.243203,2321660829.065398,1450941788.280004,6473597008.588605,875563,255166,374221,1504950
2016-03-08,EDGX (K),303199044,169866014,208378170,681443228,7425160072.001282,6066384539.679713,6331434800.966918,19822979412.647913,1833570,544461,1187010,3565041
2016-03-08,CHX (M),8911867,11227181,5078531,25217579,349627762.827500,858096053.040000,230502931.244000,1438226747.111500,538,4990,2240,7768
2016-03-08,NYSE (N),1117518546,0,0,1117518546,34203205503.851073,0.000000,0.000000,34203205503.851073,3672261,0,0,3672261
2016-03-08,NYSE Arca (P),332018633,435100743,200828880,967948256,10158896611.495766,20049829493.899340,7630366984.014090,37839093089.409196,2290291,1167471,1390497,4848259
2016-03-08,NASDAQ (Q),522626274,155425608,489556977,1167608859,18067198124.124939,7897656295.052026,19421059063.404910,45385913482.581875,4361522,635103,3270559,8267184
2016-03-08,NASDAQ PSX (X),36632179,25809625,24303359,86745163,948892224.808398,1356143106.328099,878804888.139803,3183840219.276300,260179,105476,158920,524575
2016-03-08,BATS BYX (Y),193253218,106451182,80367822,380072222,5267328738.242593,3286993364.084300,2745098675.826625,11299420778.153518,1654976,448992,754674,2858642
2016-03-08,BATS BZX (Z),282718724,147481506,130959812,561160042,7761327591.887479,7461359119.765197,4824772067.837075,20047458779.489751,2253445,644089,1109916,4007450
2016-03-07,NYSE MKT (A),0,11621318,4516037,16137355,0.000000,71641871.927100,125002278.550100,196644150.477200,0,29795,21632,51427
2016-03-07,NASDAQ BX (B),86676861,46249207,36117281,169043349,2352031892.835213,1443442731.231303,1352906109.786003,5148380733.852519,722650,169465,326563,1218678
2016-03-07,NSX (C),123220,31085,58281,212586,5106158.390000,2934473.730000,2345324.220000,10385956.340000,985,164,520,1669
2016-03-07,NYSE (DN),215635603,71348790,88840101,375824494,6160663722.556974,1995184933.269000,3248311388.714095,11404160044.540069,734167,153250,332309,1219726
2016-03-07,NASDAQ (DQ),1612577915,713857234,726767486,3053202635,40040232810.640727,24945041954.382697,21856083305.286623,86841358070.310047,4718692,1105102,2166226,7990020
2016-03-07,EDGA (J),118048904,59688284,50603821,228341009,2845706968.276808,2179217093.348000,1521985446.622109,6546909508.246917,949933,258101,392695,1600729
2016-03-07,EDGX (K),347247861,175169995,229683555,752101411,8448634314.669594,5741543307.723697,6919974941.959352,21110152564.352643,2051155,530161,1274771,3856087
2016-03-07,CHX (M),6133058,12225999,3259376,21618433,299296457.202600,973287948.590000,236587841.998000,1509172247.790600,539,4700,2196,7435
2016-03-07,NYSE (N),1133230127,0,0,1133230127,33252436290.168643,0.000000,0.000000,33252436290.168643,3686678,0,0,3686678
2016-03-07,NYSE Arca (P),361643184,425165164,203608523,990416871,10944185429.581413,17289672884.165472,7433097988.485747,35666956302.232632,2507760,1117297,1415672,5040729
2016-03-07,NASDAQ (Q),546364280,163723209,505615553,1215703042,18187228509.947725,7211417449.202211,19927494232.551065,45326140191.701001,4449330,632348,3275682,8357360
2016-03-07,NASDAQ PSX (X),40229316,27030559,24460980,91720855,1010427554.909005,1282444118.479202,851562079.541500,3144433752.929707,279923,111127,159250,550300
2016-03-07,BATS BYX (Y),209273581,109837917,83849057,402960555,5574085232.763846,3194888980.070214,2819085637.508614,11588059850.342674,1801366,467902,755587,3024855
2016-03-07,BATS BZX (Z),294588017,141707445,130136744,566432206,7816889854.518091,6570817400.439993,4754742114.401042,19142449369.359126,2268557,591095,1098274,3957926
2016-03-04,NYSE MKT (A),0,11835825,3595908,15431733,0.000000,66361311.358000,93507215.128300,159868526.486300,0,31639,18193,49832
2016-03-04,NASDAQ BX (B),98692554,48714809,37113249,184520612,2542842613.298592,1659748666.684698,1369317491.385708,5571908771.368998,801067,187140,345609,1333816
2016-03-04,NSX (C),194914,100,73022,268036,7821369.170000,1775.000000,4032522.110000,11855666.280000,1518,1,665,2184
2016-03-04,NYSE (DN),260135591,76022596,87984887,424143074,6810781527.889153,2439291137.732501,3385592588.113083,12635665253.734737,858146,181366,335890,1375402
2016-03-04,NASDAQ (DQ),1978023230,783213212,763603062,3524839504,43337791982.263286,27126156234.646550,23355294576.138538,93819242793.048374,5324891,1288292,2231991,8845174
2016-03-04,EDGA (J),136337443,69315715,49725639,255378797,3001690099.780689,2595733006.868796,1500333424.798801,7097756531.448286,1017936,306282,373482,1697700
2016-03-04,EDGX (K),417607246,206471560,236953387,861032193,8983784047.629807,7040403519.553097,7206729000.836346,23230916568.019250,2252576,635163,1322499,4210238
2016-03-04,CHX (M),9046042,19577846,4252220,32876108,246884464.354000,1644759193.796200,282769325.723200,2174412983.873400,465,5945,2271,8681
2016-03-04,NYSE (N),1382232215,0,0,1382232215,38572226350.435629,0.000000,0.000000,38572226350.435629,4125694,0,0,4125694
2016-03-04,NYSE Arca (P),438192353,489571318,202915447,1130679118,11995757706.439226,21420697641.393057,7768863504.107372,41185318851.939655,2788618,1350182,1469797,5608597
2016-03-04,NASDAQ (Q),682371392,187125249,533596894,1403093535,20951191605.599707,8983580631.039191,20810780295.351282,50745552531.990180,5066514,736620,3439841,9242975
2016-03-04,NASDAQ PSX (X),46104765,33419237,26411080,105935082,1091373244.729201,1665552104.246300,953622530.830996,3710547879.806497,302169,133580,171971,607720
2016-03-04,BATS BYX (Y),243229504,115711305,88348101,447288910,6170626563.325613,3594312168.607500,2945989554.055410,12710928285.988523,2002937,495492,797666,3296095
2016-03-04,BATS BZX (Z),360651520,164023707,138310509,662985736,8905378764.931085,7849972062.604826,5144871776.040203,21900222603.576114,2598204,674645,1139356,4412205
2016-03-03,NYSE MKT (A),0,10831715,3449004,14280719,0.000000,66000132.274300,88619171.538500,154619303.812800,0,25315,17843,43158
2016-03-03,NASDAQ BX (B),87613388,39839860,34533014,161986262,2334744043.327017,1363887151.292502,1259434052.055006,4958065246.674525,716814,156603,317849,1191266
2016-03-03,NSX (C),101891,1210,92574,195675,4634174.321800,73382.600000,2516024.320000,7223581.241800,814,14,745,1573
2016-03-03,NYSE (DN),208560935,57548499,81776443,347885877,5557136990.623393,1836771221.435399,3086047058.442903,10479955270.501695,732887,137914,312466,1183267
2016-03-03,NASDAQ (DQ),1708501574,661413901,684913792,3054829267,40558152471.558981,22698415227.416753,20860827162.074463,84117394861.050197,4765118,1057706,2062089,7884913
2016-03-03,EDGA (J),116122330,55263675,44397055,215783060,2677740673.132318,2047793244.824004,1323697764.652301,6049231682.608623,864083,235556,347371,1447010
2016-03-03,EDGX (K),322656896,162289166,202176499,687122561,7311549839.008441,5533202553.876027,6160796226.560316,19005548619.444784,1776567,518739,1180961,3476267
2016-03-03,CHX (M),12102654,15666317,5345449,33114420,307512640.637500,1258809820.150000,396803946.895000,1963126407.682500,423,4375,1926,6724
2016-03-03,NYSE (N),1155721384,0,0,1155721384,33845716831.793219,0.000000,0.000000,33845716831.793219,3613512,0,0,3613512
2016-03-03,NYSE Arca (P),376874094,397120976,186640708,960635778,11245504771.711472,17044576287.507184,7221624004.949819,35511705064.168475,2518859,1041289,1415949,4976097
2016-03-03,NASDAQ (Q),552088812,142308306,466420758,1160817876,18104067928.058946,6702602910.817784,17804142872.833527,42610813711.710257,4222903,576847,3079826,7879576
2016-03-03,NASDAQ PSX (X),38631214,25886564,23984554,88502332,937500475.899501,1217779181.902899,874148100.324903,3029427758.127303,260990,102052,161112,524154
2016-03-03,BATS BYX (Y),215070465,92604796,77913485,385588746,5608151304.791860,2969836747.860591,2689757776.025096,11267745828.677547,1767114,413311,699344,2879769
2016-03-03,BATS BZX (Z),292434704,130215112,126202714,548852530,7887550136.686760,6274881122.065275,4441810473.925313,18604241732.677348,2267724,534654,1052505,3854883
2016-03-02,NYSE MKT (A),0,7672728,4218096,11890824,0.000000,58056214.703100,103639486.509400,161695701.212500,0,20700,19131,39831
2016-03-02,NASDAQ BX (B),75849368,39397060,34380833,149627261,2143054330.916212,1354884454.509602,1297506153.706801,4795444939.132615,652401,150913,324609,1127923
2016-03-02,NSX (C),89671,16756,133596,240023,4740825.084300,1036733.550000,7105822.070000,12883380.704300,806,101,1106,2013
2016-03-02,NYSE (DN),173036369,56578249,79291635,308906253,5003437102.328590,1913777818.629401,3040783374.143397,9957998295.101388,669758,134438,316013,1120209
2016-03-02,NASDAQ (DQ),1485193130,614066488,658821921,2758081539,37743416567.840193,22895117110.265808,22330323425.056431,82968857103.162432,4376734,1031916,2117569,7526219
2016-03-02,EDGA (J),105427734,56379733,45774091,207581558,2568759206.094399,2189803035.172602,1492081654.816305,6250643896.083306,841786,238167,378923,1458876
2016-03-02,EDGX (K),301124214,161992348,194445463,657562025,7319304147.564295,5584324477.916798,6836962774.138568,19740591399.619661,1739266,513759,1261932,3514957
2016-03-02,CHX (M),15740520,12575556,4032975,32349051,511637287.308400,1137432867.773000,278724799.532000,1927794954.613400,390,3708,1670,5768
2016-03-02,NYSE (N),1093732711,0,0,1093732711,32725033260.904252,0.000000,0.000000,32725033260.904252,3677278,0,0,3677278
2016-03-02,NYSE Arca (P),384096109,378349398,185008889,947454396,11029098571.113193,16152377738.754588,7509261856.333882,34690738166.201663,2393645,988084,1422333,4804062
2016-03-02,NASDAQ (Q),519762184,146802621,472391255,1138956060,17501006930.818878,7192949682.983767,19266391160.877853,43960347774.680498,4052971,612699,3280115,7945785
2016-03-02,NASDAQ PSX (X),42072522,26524124,27043318,95639964,970361982.185400,1342861719.438801,1050081507.396399,3363305209.020600,258853,113633,179673,552159
2016-03-02,BATS BYX (Y),199259423,99245628,81399246,379904297,5239868626.861326,3111249337.147705,2736695421.156502,11087813385.165533,1704924,411301,746233,2862458
2016-03-02,BATS BZX (Z),278736524,129235398,126911751,534883673,7724046400.347971,6359286465.776605,4711538790.044909,18794871656.169485,2229392,545896,1116191,3891479
2016-03-01,NYSE MKT (A),0,9216835,3784375,13001210,0.000000,71702164.861200,101583302.592000,173285467.453200,0,23934,19275,43209
2016-03-01,NASDAQ BX (B),84009304,45190073,40256613,169455990,2403697042.936969,1798650918.652604,1605164303.730502,5807512265.320075,711792,177993,358454,1248239
2016-03-01,NSX (C),114422,3300,103105,220827,6100715.638000,306894.000000,5850882.990000,12258492.628000,904,21,844,1769
2016-03-01,NYSE (DN),213876754,72851988,94948553,381677295,6692319116.307164,2485357617.985405,3823363522.072018,13001040256.364587,813956,172306,391990,1378252
2016-03-01,NASDAQ (DQ),1533776340,729504931,695015973,2958297244,39719773109.172041,30245364430.160683,24643009035.124709,94608146574.457433,5052170,1139156,2387403,8578729
2016-03-01,EDGA (J),109424207,59495367,50988437,219908011,2842489650.193404,2395403524.608406,1786474002.647503,7024367177.449313,870064,254076,412160,1536300
2016-03-01,EDGX (K),288524907,166846430,204283665,659655002,7747066526.851090,6512057600.634270,7665393022.233210,21924517149.718570,1740200,551832,1311799,3603831
2016-03-01,CHX (M),13011294,15512614,4540468,33064376,429410480.355000,1525666231.493599,339940860.589500,2295017572.438099,609,5811,2206,8626
2016-03-01,NYSE (N),1128754314,0,0,1128754314,34572106709.175557,0.000000,0.000000,34572106709.175557,3738782,0,0,3738782
2016-03-01,NYSE Arca (P),377661231,439246448,203865744,1020773423,12092425175.057917,21888947617.373853,8575962690.108527,42557335482.540297,2526166,1029676,1542805,5098647
2016-03-01,NASDAQ (Q),540765498,164681554,533690296,1239137348,19461032094.412116,8813749085.134575,21957168139.318207,50231949318.864898,4393637,675898,3493936,8563471
2016-03-01,NASDAQ PSX (X),44398889,28445800,27191784,100036473,1109304198.535696,1456745259.074901,1065007691.338399,3631057148.948996,271699,115011,181818,568528
2016-03-01,BATS BYX (Y),216167385,95882638,87600124,399650147,5888325420.780236,3274614899.973100,3137373492.804830,12300313813.558166,1838572,417818,795919,3052309
2016-03-01,BATS BZX (Z),280185365,150071912,135767570,566024847,8246802103.345846,8065902934.561398,5487733874.809448,21800438912.716692,2307986,614489,1184602,4107077
2016-02-29,NYSE MKT (A),0,12987749,4636089,17623838,0.000000,101146137.971600,92141254.667000,193287392.638600,0,20623,22359,42982
2016-02-29,NASDAQ BX (B),75880671,40278632,37616243,153775546,2200767656.844560,1575611437.071001,1407550322.774082,5183929416.689643,658479,169974,344092,1172545
2016-02-29,NSX (C),105243,12884,77466,195593,5975709.190000,1260459.160000,2932369.580000,10168537.930000,653,94,659,1406
2016-02-29,NYSE (DN),156045915,60309431,74265847,290621193,4778224828.614383,1883010224.892400,2911954826.619610,9573189880.126393,653759,123111,302891,1079761
2016-02-29,NASDAQ (DQ),1427443622,585202127,716755419,2729401168,41036129505.607652,24979652364.764988,24663192988.679887,90678974859.052527,4337032,928188,2046660,7311880
2016-02-29,EDGA (J),98333917,50154658,44932705,193421280,2574858084.252282,1937046188.437201,1448847928.164807,5960752200.854290,788864,201494,365572,1355930
2016-02-29,EDGX (K),242374495,151729551,180269843,574373889,6539742969.721295,5736550801.737377,5926091032.047633,18202384803.506305,1551986,477882,1164471,3194339
2016-02-29,CHX (M),9400921,9114227,5022549,23537697,317340342.819600,897295813.740000,285255470.925000,1499891627.484600,490,4208,1545,6243
2016-02-29,NYSE (N),1295853950,0,0,1295853950,42130911892.836501,0.000000,0.000000,42130911892.836501,3571764,0,0,3571764
2016-02-29,NYSE Arca (P),303073382,387533315,178516530,869123227,9926097788.126733,17747104370.847079,6787570480.961105,34460772639.934917,2216439,978394,1365085,4559918
2016-02-29,NASDAQ (Q),491911307,157503975,589619587,1239034869,17541098299.117033,8107187507.980518,23325329173.700035,48973614980.797586,4080412,605486,3246054,7931952
2016-02-29,NASDAQ PSX (X),32858730,24144754,25074895,82078379,910014662.295502,1367585006.169000,878517018.695200,3156116687.159702,247127,98320,164068,509515
2016-02-29,BATS BYX (Y),204709461,87951688,83348392,376009541,5696590629.453528,2917496939.455105,2751272856.616418,11365360425.525051,1765817,376774,758160,2900751
2016-02-29,BATS BZX (Z),245437073,126878501,120351465,492667039,7312951404.765514,6792835423.241795,4471778019.538346,18577564847.545655,2102121,539924,1058893,3700938
2016-02-26,NYSE MKT (A),0,8339917,3878672,12218589,0.000000,52653547.117400,103104495.164000,155758042.281400,0,21474,19447,40921
2016-02-26,NASDAQ BX (B),70244949,42008848,32878252,145132049,2033200972.483027,1406459254.398898,1257106077.211791,4696766304.093716,612618,157005,294865,1064488
2016-02-26,NSX (C),95785,400,60862,157047,5112139.400000,18037.000000,3882080.690000,9012257.090000,821,4,555,1380
2016-02-26,NYSE (DN),182823913,65063061,79824033,327711007,5727377933.205800,1983768023.732199,3484551366.318996,11195697323.256995,700535,135015,307280,1142830
2016-02-26,NASDAQ (DQ),1356631117,650825621,604785231,2612241969,35483306438.848056,23889480568.203531,21465925183.261724,80838712190.313311,4377311,980974,2056505,7414790
2016-02-26,EDGA (J),99983013,53820080,41971833,195774926,2501832973.302614,2000828265.037295,1395260974.185205,5897922212.525114,795704,222309,343970,1361983
2016-02-26,EDGX (K),263814848,161702215,181203043,606720106,6920462734.635530,6206637075.720010,6512077491.616185,19639177301.971725,1614654,525339,1144704,3284697
2016-02-26,CHX (M),7895229,18098586,3216871,29210686,230812900.959900,1483580164.030000,233629471.954800,1948022536.944700,683,5418,2100,8201
2016-02-26,NYSE (N),1032354679,0,0,1032354679,32207801080.593095,0.000000,0.000000,32207801080.593095,3618257,0,0,3618257
2016-02-26,NYSE Arca (P),323983436,380089045,180432454,884504935,10459410270.513346,16974666706.612646,7639863686.889209,35073940664.015201,2316017,988264,1369359,4673640
2016-02-26,NASDAQ (Q),516214661,166023956,461389391,1143628008,18181349067.625888,8609062556.935918,18768845409.695470,45559257034.257276,4156685,670289,3166932,7993906
2016-02-26,NASDAQ PSX (X),33930930,27074766,22635484,83641180,927588109.069598,1487810084.672399,808567738.618301,3223965932.360298,247514,103653,144556,495723
2016-02-26,BATS BYX (Y),195563246,95263390,78821025,369647661,5398296219.240014,2957358227.919503,2672940907.622810,11028595354.782327,1693317,405537,703206,2802060
2016-02-26,BATS BZX (Z),271424619,139178375,124878058,535481052,7900990177.689953,7024235070.167246,4893786573.638551,19819011821.495750,2241540,588346,1075087,3904973
2016-02-25,NYSE MKT (A),0,8529976,3529924,12059900,0.000000,50206898.168100,88968082.313000,139174980.481100,0,20497,16183,36680
2016-02-25,NASDAQ BX (B),68047555,33566541,30286656,131900752,2001820872.266424,1205020632.391799,1180170784.391403,4387012289.049626,593035,130841,278387,1002263
2016-02-25,NSX (C),119045,2200,58434,179679,4624972.040000,41236.000000,2182086.810000,6848294.850000,852,10,374,1236
2016-02-25,NYSE (DN),184852432,58668329,75481738,319002499,5492894874.844306,1789317669.817200,3060050989.638161,10342263534.299667,691521,131699,314611,1137831
2016-02-25,NASDAQ (DQ),1293847279,573984362,560500646,2428332287,34145171133.633968,20424406766.274587,19400892157.515378,73970470057.423933,4323391,909506,1933247,7166144
2016-02-25,EDGA (J),92560624,45964032,38983710,177508366,2420027345.130311,1755627812.569597,1287520209.026199,5463175366.726107,749218,199191,318370,1266779
2016-02-25,EDGX (K),244993517,140948890,167718658,553661065,6650591377.111692,5189108479.572653,6160979257.541659,18000679114.226004,1560889,458822,1086439,3106150
2016-02-25,CHX (M),12492194,12298860,4853307,29644361,500701356.220600,893243313.695000,358406892.315000,1752351562.230600,475,3811,2116,6402
2016-02-25,NYSE (N),951910859,0,0,951910859,29397305146.273849,0.000000,0.000000,29397305146.273849,3439715,0,0,3439715
2016-02-25,NYSE Arca (P),320051575,322841361,165251948,808144884,10316938261.090205,15571785183.873257,7158451006.558213,33047174451.521675,2253433,882138,1299904,4435475
2016-02-25,NASDAQ (Q),480313736,131198388,414262573,1025774697,17168308012.440371,7041148613.895496,17154311502.646142,41363768128.982009,3977141,568583,2987908,7533632
2016-02-25,NASDAQ PSX (X),33703052,19952870,22043966,75699888,894520099.154501,1129488121.907099,842075883.026399,2866084104.087999,231704,83066,143381,458151
2016-02-25,BATS BYX (Y),186618162,82384741,73035897,342038800,5157407197.555012,2495872132.026396,2448001376.076503,10101280705.657911,1625319,347501,662732,2635552
2016-02-25,BATS BZX (Z),257503529,115964546,114357881,487825956,7481741936.229462,5939355287.283980,4348287274.670135,17769384498.183577,2108798,500753,1006571,3616122
2016-02-24,NYSE MKT (A),0,10606934,4097168,14704102,0.000000,84037996.333100,101442379.482000,185480375.815100,0,25304,21184,46488
2016-02-24,NASDAQ BX (B),73259311,42200344,37197650,152657305,2017156739.419540,1513670647.874499,1336860252.567987,4867687639.862026,639656,172420,336124,1148200
2016-02-24,NSX (C),169986,36100,364772,570858,4403791.636500,857350.250000,2454548.173800,7715690.060300,998,58,1223,2279
2016-02-24,NYSE (DN),188079140,75920058,88904718,352903916,5639346044.675305,2332959202.182497,3450987178.431097,11423292425.288899,698946,156187,352660,1207793
2016-02-24,NASDAQ (DQ),1328210450,668809112,662637797,2659657359,35056483536.983065,24853187506.785513,21804035130.650617,81713706174.419195,4259822,1114185,2118165,7492172
2016-02-24,EDGA (J),100288542,58926542,45625450,204840534,2525678276.641303,2229452810.388294,1431861989.105106,6186993076.134703,807406,255994,374499,1437899
2016-02-24,EDGX (K),252982766,171467557,202532839,626983162,6856465799.228888,6992165949.662288,6943252128.787428,20791883877.678604,1630088,625071,1275247,3530406
2016-02-24,CHX (M),9507815,17331881,4812649,31652345,290185651.939000,1570495535.280500,270926420.745000,2131607607.964500,473,6624,2378,9475
2016-02-24,NYSE (N),1041952916,0,0,1041952916,30830167850.410351,0.000000,0.000000,30830167850.410351,3740938,0,0,3740938
2016-02-24,NYSE Arca (P),327517280,424204024,202424278,954145582,10760005790.432665,20835214666.881991,8217398066.521617,39812618523.836273,2404158,1184226,1567032,5155416
2016-02-24,NASDAQ (Q),499339435,174072390,482234729,1155646554,17625240982.830107,9624119205.946723,18958982524.251582,46208342713.028412,4195537,761411,3477780,8434728
2016-02-24,NASDAQ PSX (X),35552134,26326684,28108826,89987644,963534772.003301,1522631222.563601,1035950076.379012,3522116070.945914,248752,112270,180303,541325
2016-02-24,BATS BYX (Y),192972860,95003108,84896898,372872866,5284590288.777437,2939329840.697907,2827661727.767450,11051581857.242794,1676868,409188,783698,2869754
2016-02-24,BATS BZX (Z),272122302,140836074,135805019,548763395,7863925909.320184,7523274890.600492,5067097779.397672,20454298579.318348,2233771,637611,1168026,4039408
2016-02-23,NYSE MKT (A),0,9283009,4500166,13783175,0.000000,46657167.426800,94897909.076000,141555076.502800,0,22188,20229,42417
2016-02-23,NASDAQ BX (B),60210593,29630181,30477436,120318210,1749073181.223011,1124068818.706000,1112476177.626594,3985618177.555605,540958,118235,272208,931401
2016-02-23,NSX (C),77171,30657,77019,184847,3033848.088500,41425.257700,2679460.770000,5754734.116200,508,166,563,1237
2016-02-23,NYSE (DN),160283262,61615871,77401193,299300326,4937777733.588802,1909173038.265799,2952218625.605203,9799169397.459804,635998,133235,317372,1086605
2016-02-23,NASDAQ (DQ),1230653690,560407220,596403179,2387464089,33956750487.013440,20645209918.620791,19810390204.235233,74412350609.869464,4097323,925848,1976001,6999172
2016-02-23,EDGA (J),92726153,43318960,43406251,179451364,2505745775.347501,1691733972.349998,1501448299.054004,5698928046.751503,780878,191721,366345,1338944
2016-02-23,EDGX (K),245042490,136037323,193595837,574675650,6903598070.059262,5242301233.983017,6560703524.267904,18706602828.310183,1580769,454998,1259878,3295645
2016-02-23,CHX (M),12678018,14015963,4399901,31093882,427897838.303200,1301452196.139000,250452925.838500,1979802960.280700,354,5194,2284,7832
2016-02-23,NYSE (N),942364885,0,0,942364885,30594077269.655686,0.000000,0.000000,30594077269.655686,3508825,0,0,3508825
2016-02-23,NYSE Arca (P),300763628,327522905,192149079,820435612,10210353359.988978,14690120856.634759,7775810410.356020,32676284626.979757,2217355,868037,1499030,4584422
2016-02-23,NASDAQ (Q),394122633,127388169,407650662,929161464,13936394673.284337,6933139416.058815,16181332753.809787,37050866843.152939,3281496,537518,2725998,6545012
2016-02-23,NASDAQ PSX (X),29649646,19482490,21577997,70710133,824482620.192098,1109775012.930100,804071776.570299,2738329409.692497,213074,82546,140253,435873
2016-02-23,BATS BYX (Y),179790545,73132889,82540590,335464024,5006580056.990223,2366473873.757488,2731576072.663477,10104630003.411188,1616987,321743,763232,2701962
2016-02-23,BATS BZX (Z),250025478,109432243,125909110,485366831,7550228568.589473,5725459641.635896,4686162118.443175,17961850328.668544,2120708,482515,1117826,3721049
2016-02-22,NYSE MKT (A),0,8966453,3967688,12934141,0.000000,45289131.560200,101135610.263000,146424741.823200,0,19884,19093,38977
2016-02-22,NASDAQ BX (B),67126418,28262709,31534157,126923284,1989454664.637115,1062086256.213999,1171633616.742103,4223174537.593217,590438,119739,290688,1000865
2016-02-22,NSX (C),94112,700,55974,150786,5658243.860000,117239.000000,3342872.510000,9118355.370000,741,7,521,1269
2016-02-22,NYSE (DN),178446680,61573723,80454322,320474725,5707678001.262701,1775990746.368099,3217625503.593468,10701294251.224268,686121,130549,325949,1142619
2016-02-22,NASDAQ (DQ),1274315262,523570376,612848168,2410733806,35951212268.850718,19692124997.826952,20745069126.174618,76388406392.852288,4196384,902486,2033308,7132178
2016-02-22,EDGA (J),93740555,43890252,41566778,179197585,2551326708.913492,1707162539.338299,1484054817.162702,5742544065.414493,760074,199811,352154,1312039
2016-02-22,EDGX (K),244002167,124964811,180634302,549601280,6800631794.706961,4849719502.830888,6427026286.286406,18077377583.824255,1502554,433842,1159525,3095921
2016-02-22,CHX (M),8493668,11008463,6833715,26335846,410598207.399400,985012658.925000,413259733.419800,1808870599.744200,432,5027,1749,7208
2016-02-22,NYSE (N),1000964983,0,0,1000964983,32595649162.713960,0.000000,0.000000,32595649162.713960,3337848,0,0,3337848
2016-02-22,NYSE Arca (P),300935383,304842750,175667080,781445213,10260083650.105182,15036430444.188732,7174408205.947235,32470922300.241149,2150591,829639,1322742,4302972
2016-02-22,NASDAQ (Q),439037105,115517949,448541669,1003096723,16255880822.024853,6199108059.152108,18371808618.127695,40826797499.304656,3661932,507717,2945552,7115201
2016-02-22,NASDAQ PSX (X),31129813,19399336,22847663,73376812,919866412.375200,989938492.496301,822723937.159903,2732528842.031404,228213,79726,146458,454397
2016-02-22,BATS BYX (Y),182980426,73402007,75866275,332248708,5198349395.841685,2363075779.302798,2583224078.087995,10144649253.232478,1596930,315001,687513,2599444
2016-02-22,BATS BZX (Z),242357855,105518864,116683835,464560554,7320770014.963080,5376199396.960312,4416933033.805952,17113902445.729344,2037770,471110,1036112,3544992
2016-02-19,NYSE MKT (A),0,13174899,4103268,17278167,0.000000,63442622.585900,109892756.416000,173335379.001900,0,21168,21703,42871
2016-02-19,NASDAQ BX (B),71025108,35350879,33828590,140204577,2144698917.732113,1340300495.213000,1188089210.992094,4673088623.937207,647479,143987,311363,1102829
2016-02-19,NSX (C),73869,600,47280,121749,3897426.370000,3944.000000,2519857.000000,6421227.370000,526,4,416,946
2016-02-19,NYSE (DN),164121599,52476793,77819631,294418023,5126746619.238118,1745310992.954597,3055606705.605485,9927664317.798200,675429,132347,318707,1126483
2016-02-19,NASDAQ (DQ),1189997435,554103393,613263712,2357364540,32661829289.077785,21862040424.685809,19875571363.584855,74399441077.348449,4307110,913789,1993750,7214649
2016-02-19,EDGA (J),90988632,45425569,42378936,178793137,2438602987.082823,1850650746.338505,1400944127.212306,5690197860.633634,752204,205155,344930,1302289
2016-02-19,EDGX (K),230861641,134521813,186336525,551719979,6475201963.520621,5302779921.608300,6311526436.068213,18089508321.197134,1529870,498269,1175657,3203796
2016-02-19,CHX (M),10281443,17378302,20071186,47730931,474182597.767800,1545780784.563399,1084691504.337900,3104654886.669099,453,5537,1890,7880
2016-02-19,NYSE (N),1161058463,0,0,1161058463,40345786521.759221,0.000000,0.000000,40345786521.759221,3578349,0,0,3578349
2016-02-19,NYSE Arca (P),299811924,349745611,189856227,839413762,10089771705.013747,15517157028.427445,7408320762.734159,33015249496.175351,2203764,942062,1394603,4540429
2016-02-19,NASDAQ (Q),461565050,130814797,510557478,1102937325,16505458563.475885,7062921286.239527,20494074528.820017,44062454378.535429,3905399,584949,3157335,7647683
2016-02-19,NASDAQ PSX (X),31988834,20831999,25572506,78393339,911962382.771400,1140890556.791900,885452921.371501,2938305860.934801,236859,80085,158161,475105
2016-02-19,BATS BYX (Y),184726269,80492718,78288430,343507417,5448592923.538529,2641023825.759896,2529011239.947084,10618627989.245509,1712403,355593,723197,2791193
2016-02-19,BATS BZX (Z),249606974,112306742,123147360,485061076,7299352702.001369,5973033129.963709,4808869342.671238,18081255174.636316,2102909,520941,1060240,3684090
2016-02-18,NYSE MKT (A),0,7758576,5267094,13025670,0.000000,45436640.360200,144976075.951000,190412716.311200,0,19736,28339,48075
2016-02-18,NASDAQ BX (B),79321143,41505444,36754899,157581486,2351167249.746002,1525535111.440602,1339871818.291319,5216574179.477923,718337,170666,349074,1238077
2016-02-18,NSX (C),77632,400,40435,118467,2951104.780000,20944.000000,1392586.840000,4364635.620000,587,1,351,939
2016-02-18,NYSE (DN),188991862,64742078,84594014,338327954,5770713152.514103,1983466495.306603,3374345965.299009,11128525613.119715,742842,159544,352058,1254444
2016-02-18,NASDAQ (DQ),1335853492,656016733,649547121,2641417346,36524059894.983112,20673252956.742119,21903116107.546533,79100428959.271764,4500475,1036274,2109914,7646663
2016-02-18,EDGA (J),102464091,56025569,45544408,204034068,2676411816.729870,2119993793.512801,1513399828.625994,6309805438.868665,829549,252636,376078,1458263
2016-02-18,EDGX (K),249396193,164136165,195320243,608852601,7030136117.553797,5929705881.786597,6767296001.718773,19727138001.059167,1682223,575424,1278191,3535838
2016-02-18,CHX (M),12368631,16283429,8284793,36936853,386813018.083600,1309190939.389999,654791085.172600,2350795042.646199,587,6123,2709,9419
2016-02-18,NYSE (N),1084682623,0,0,1084682623,33338538786.573389,0.000000,0.000000,33338538786.573389,3912400,0,0,3912400
2016-02-18,NYSE Arca (P),343526234,386626861,195791279,925944374,11243504480.790874,16958033146.988404,7886806283.234433,36088343911.013711,2471283,1064659,1512135,5048077
2016-02-18,NASDAQ (Q),532708516,151925455,498166562,1182800533,19096409790.357838,7660878414.648598,20116788610.042283,46874076815.048719,4507443,671813,3560279,8739535
2016-02-18,NASDAQ PSX (X),39176642,27158758,25787175,92122575,1056763402.285707,1257501129.284400,869457488.348905,3183722019.919012,281555,102205,170180,553940
2016-02-18,BATS BYX (Y),197198690,95650803,82084988,374934481,5520878710.052870,2998167433.595590,2675015182.025325,11194061325.673785,1737477,404419,776132,2918028
2016-02-18,BATS BZX (Z),279432252,136575822,130396356,546404430,8216611372.972939,6710878547.998199,5037478962.351580,19964968883.322718,2323624,612985,1144953,4081562
2016-02-17,NYSE MKT (A),0,9461569,4099813,13561382,0.000000,69508298.046200,112992520.242000,182500818.288200,0,22119,22876,44995
2016-02-17,NASDAQ BX (B),82518510,41518904,41385972,165423386,2332056336.656217,1501414724.036198,1547381480.477216,5380852541.169631,702165,158112,367035,1227312
2016-02-17,NSX (C),83625,11927,45987,141539,4404842.050000,763956.600000,2107510.050000,7276308.700000,655,89,388,1132
2016-02-17,NYSE (DN),217028450,71521180,104755108,393304738,6481238559.604304,2276322498.911889,4162658399.295904,12920219457.812097,812704,154363,393600,1360667
2016-02-17,NASDAQ (DQ),1576716874,688435999,755315737,3020468610,42000748738.832570,24941294344.782307,26405041627.297620,93347084710.912497,5091212,1143577,2518787,8753576
2016-02-17,EDGA (J),117183548,56880519,55827345,229891412,3100259738.549878,2248465377.500098,2040804923.711896,7389530039.761872,949669,256592,457253,1663514
2016-02-17,EDGX (K),290762465,175211579,233299146,699273190,7954638590.859840,6614354848.416485,8257322300.865039,22826315740.141364,1862734,579908,1438238,3880880
2016-02-17,CHX (M),8879274,19878743,6007066,34765083,276775835.325100,1941417259.019999,383407526.218100,2601600620.563199,442,7387,3215,11044
2016-02-17,NYSE (N),1217147104,0,0,1217147104,37022474992.657796,0.000000,0.000000,37022474992.657796,4177786,0,0,4177786
2016-02-17,NYSE Arca (P),375429503,393367478,221115527,989912508,12140983944.588304,18565621893.274717,9169286507.078089,39875892344.941110,2681809,1083435,1639631,5404875
2016-02-17,NASDAQ (Q),571648083,162507811,604180394,1338336288,20140708296.676462,8799423040.971453,24552337972.883400,53492469310.531315,4651445,686727,3764557,9102729
2016-02-17,NASDAQ PSX (X),42263959,25678778,29414044,97356781,1127205837.935701,1455986145.381301,1010205286.366500,3593397269.683502,298131,108111,189015,595257
2016-02-17,BATS BYX (Y),216453507,89469810,93992917,399916234,5751108049.747992,2901053144.113081,3130075908.548164,11782237102.409237,1827300,376195,845943,3049438
2016-02-17,BATS BZX (Z),304452962,135438295,148891534,588782791,8688448010.575422,7098181605.737612,5792004620.905222,21578634237.218256,2445297,592436,1226834,4264567
2016-02-16,NYSE MKT (A),0,9856596,3752303,13608899,0.000000,58369842.475600,101997792.724000,160367635.199600,0,22495,18688,41183
2016-02-16,NASDAQ BX (B),73990822,43365430,38279457,155635709,2198486502.529217,1482052072.648603,1450249225.423904,5130787800.601724,637957,170495,345766,1154218
2016-02-16,NSX (C),97903,6400,124945,229248,5047770.120000,214101.000000,5012480.840000,10274351.960000,896,49,954,1899
2016-02-16,NYSE (DN),190894369,69195791,95063151,355153311,5708056093.364108,2346486354.696692,3681306326.041945,11735848774.102745,753306,171772,383688,1308766
2016-02-16,NASDAQ (DQ),1378558707,753035866,675845710,2807440283,38177509079.262268,24901463014.490544,23428024220.378050,86506996314.130862,4588602,1140809,2288623,8018034
2016-02-16,EDGA (J),101982848,57384260,50578144,209945252,2765483390.969504,2066018431.410301,1721128147.099996,6552629969.479801,830563,249226,413158,1492947
2016-02-16,EDGX (K),248971977,168712536,215058388,632742901,6992154765.672973,6639530378.982397,7557727545.945235,21189412690.600605,1693434,633416,1360293,3687143
2016-02-16,CHX (M),5549647,16327890,4538308,26415845,245860544.551000,1585337363.008600,242947892.637000,2074145800.196600,480,7166,2645,10291
2016-02-16,NYSE (N),1236948128,0,0,1236948128,39240803455.226223,0.000000,0.000000,39240803455.226223,4004353,0,0,4004353
2016-02-16,NYSE Arca (P),329950710,433197932,206127031,969275673,10684237257.634017,18569235019.608598,8237099810.412573,37490572087.655188,2423383,1078305,1560804,5062492
2016-02-16,NASDAQ (Q),510066784,156875901,582354079,1249296764,18153578740.074266,7889861945.445683,23376177819.130642,49419618504.650591,4269341,696706,3571419,8537466
2016-02-16,NASDAQ PSX (X),37502423,23910213,29144626,90557262,1057793106.047202,1233136188.842701,937480970.316599,3228410265.206502,277484,99264,184341,561089
2016-02-16,BATS BYX (Y),196145921,97860173,83888727,377894821,5278179641.075541,2798081827.698718,2718005661.739457,10794267130.513716,1622752,401906,731742,2756400
2016-02-16,BATS BZX (Z),273897624,143688442,139379248,556965314,7969290476.561401,7108876088.522301,5316415848.844741,20394582413.928443,2286187,624843,1183308,4094338
2016-02-12,NYSE MKT (A),0,9262873,3885761,13148634,0.000000,54060723.271500,119534928.426000,173595651.697500,0,21116,21928,43044
2016-02-12,NASDAQ BX (B),87591799,54947138,42276491,184815428,2482801293.087329,1707160397.898301,1496897264.847900,5686858955.833530,761840,193867,394364,1350071
2016-02-12,NSX (C),71255,100,43396,114751,3238840.000000,2702.000000,2245387.370000,5486929.370000,576,1,317,894
2016-02-12,NYSE (DN),196358762,76064763,86056949,358480474,5559742348.347204,2526425147.141692,3529726732.725099,11615894228.213995,733804,170375,352582,1256761
2016-02-12,NASDAQ (DQ),1449842950,766029365,625411095,2841283410,35797540603.857214,24267831684.454767,22267228427.221236,82332600715.533217,4678717,1143671,2224981,8047369
2016-02-12,EDGA (J),103534801,66877483,45074450,215486734,2599556785.874007,2317694225.024796,1496664130.994297,6413915141.893100,825622,261435,380394,1467451
2016-02-12,EDGX (K),281708436,201781709,200838412,684328557,7732386530.123789,7075320402.784993,7323670957.003426,22131377889.912208,1814122,656807,1348935,3819864
2016-02-12,CHX (M),10711791,16634535,7470041,34816367,294781470.451200,1622613207.689999,468266282.843000,2385660960.984199,431,9014,2830,12275
2016-02-12,NYSE (N),1159474750,0,0,1159474750,35850187768.455789,0.000000,0.000000,35850187768.455789,4032018,0,0,4032018
2016-02-12,NYSE Arca (P),339559680,434832946,192536579,966929205,10739482813.524894,19071113360.620678,8046649128.140386,37857245302.285958,2448757,1159925,1490367,5099049
2016-02-12,NASDAQ (Q),557906176,192998889,534413569,1285318634,19177206628.578520,9451768170.074491,21147728138.303358,49776702936.956369,4539122,769590,3510741,8819453
2016-02-12,NASDAQ PSX (X),42303634,29155604,29055529,100514767,1139572801.200399,1372209895.501800,979655161.746701,3491437858.448900,295205,109029,188997,593231
2016-02-12,BATS BYX (Y),179196377,125568632,76625120,381390129,4708080451.519940,3236058191.950209,2466960198.114336,10411098841.584485,1542708,461147,710912,2714767
2016-02-12,BATS BZX (Z),291885904,161483289,140603573,593972766,8368638605.597367,7705694411.468919,5507794957.517426,21582127974.583712,2386217,657988,1194887,4239092
2016-02-11,NYSE MKT (A),0,11801569,4525884,16327453,0.000000,53639310.206500,154909624.658000,208548934.864500,0,25522,26481,52003
2016-02-11,NASDAQ BX (B),99391991,72743661,50122417,222258069,2886936259.127450,2614223306.342906,1925125292.953210,7426284858.423566,844209,291226,484844,1620279
2016-02-11,NSX (C),139561,2300,54703,196564,5726871.990000,33503.000000,3036150.000000,8796524.990000,883,2,423,1308
2016-02-11,NYSE (DN),249014877,102022510,109379576,460416963,7299739067.034326,3546597345.887000,4726933751.136108,15573270164.057434,917520,247128,448268,1612916
2016-02-11,NASDAQ (DQ),1570564625,966284313,937308243,3474157181,42046853513.725191,35823098277.912783,26662516860.271055,104532468651.909029,5424674,1681593,2528554,9634821
2016-02-11,EDGA (J),119596720,101180557,56539949,277317226,3027745352.970610,3801712588.403102,1952379669.008493,8781837610.382205,946764,439753,475979,1862496
2016-02-11,EDGX (K),349072335,280513462,319309995,948895792,9309855096.356375,12027345418.625734,8989542840.169070,30326743355.151179,2287327,1021883,1652113,4961323
2016-02-11,CHX (M),9081943,26935395,11134248,47151586,335559239.780000,2845499096.900601,669517680.362400,3850576017.043001,884,16319,5315,22518
2016-02-11,NYSE (N),1357885080,0,0,1357885080,40967033049.563104,0.000000,0.000000,40967033049.563104,5071801,0,0,5071801
2016-02-11,NYSE Arca (P),422421963,626398253,273563036,1322383252,13497966444.606976,28832691850.559116,10900866686.526308,53231524981.692400,3052977,1872081,1897662,6822720
2016-02-11,NASDAQ (Q),684548975,291266133,738332071,1714147179,23487165984.062301,15255625038.892124,25618280043.547096,64361071066.501521,5636862,1307549,4433575,11377986
2016-02-11,NASDAQ PSX (X),52579829,50308351,37406809,140294989,1478241123.450100,2524270571.039701,1399563062.175393,5402074756.665194,353262,191214,226713,771189
2016-02-11,BATS BYX (Y),219702230,161769234,89301588,470773052,5753783933.195567,4676248165.438779,3035600688.424288,13465632787.058634,1803820,683686,840006,3327512
2016-02-11,BATS BZX (Z),374567224,249548037,187434180,811549441,10648302991.569952,13011266422.400720,7417609333.829781,31077178747.800453,3036983,1124009,1618570,5779562
2016-02-10,NYSE MKT (A),0,9793204,4356825,14150029,0.000000,44862754.722500,146474234.046000,191336988.768500,0,23976,24772,48748
2016-02-10,NASDAQ BX (B),83289728,51550211,43777495,178617434,2444268254.914785,1889346603.531302,1690980226.076094,6024595084.522181,716304,206085,406777,1329166
2016-02-10,NSX (C),89312,2700,46351,138363,3973612.710000,146063.000000,1469046.240000,5588721.950000,748,21,347,1116
2016-02-10,NYSE (DN),181990641,73872637,97647661,353510939,5821548251.888322,2643193627.772899,4158894807.518133,12623636687.179354,732588,168681,370862,1272131
2016-02-10,NASDAQ (DQ),1286529943,725083333,782803664,2794416940,36219659935.373109,22650111188.183280,24316951395.624172,83186722519.180561,4345628,1133695,2279644,7758967
2016-02-10,EDGA (J),100723366,72300624,54793877,227817867,2651402824.123389,2756834230.026492,1726029948.288094,7134267002.437975,827865,321659,429166,1578690
2016-02-10,EDGX (K),272759693,204963713,296517817,774241223,7884684313.327002,8409832046.891088,8150350015.764885,24444866375.982975,1917801,729623,1497869,4145293
2016-02-10,CHX (M),9201942,20791124,6717609,36710675,291746575.497700,1984207274.871399,477511164.578500,2753465014.947599,621,11233,4012,15866
2016-02-10,NYSE (N),1082243097,0,0,1082243097,33412656365.068479,0.000000,0.000000,33412656365.068479,4213534,0,0,4213534
2016-02-10,NYSE Arca (P),334391009,450426877,290864453,1075682339,11284036796.740455,20531293918.879373,9980431214.009398,41795761929.629226,2509124,1365498,1824851,5699473
2016-02-10,NASDAQ (Q),604893042,211517713,594958895,1411369650,21545930899.269451,10456875952.560789,21939356833.210020,53942163685.040260,5123467,920542,3934423,9978432
2016-02-10,NASDAQ PSX (X),40521995,32501339,31743318,104766652,1140153987.155903,1853348125.276198,1183969205.837300,4177471318.269401,283949,125298,201213,610460
2016-02-10,BATS BYX (Y),172536734,122877151,82240064,377653949,4837701084.615214,3698145785.534422,2751266310.987135,11287113181.136771,1511947,530783,747569,2790299
2016-02-10,BATS BZX (Z),306447815,182090673,165079974,653618462,9104180303.099976,9024973913.275183,6499982783.171302,24629136999.546461,2567570,802030,1419217,4788817
2016-02-09,NYSE MKT (A),0,10257929,5321901,15579830,0.000000,61122766.681000,146525569.792100,207648336.473100,0,26351,29551,55902
2016-02-09,NASDAQ BX (B),95682516,60822859,48985149,205490524,2876342585.056466,2213968243.327096,1885122365.209808,6975433193.593370,839906,238584,453028,1531518
2016-02-09,NSX (C),70768,24788,45683,141239,3193943.021900,2939661.020000,2947132.280000,9080736.321900,470,162,374,1006
2016-02-09,NYSE (DN),226690359,83675610,108350398,418716367,7101219682.041392,2960869191.104695,4885053441.296271,14947142314.442358,901325,201636,425078,1528039
2016-02-09,NASDAQ (DQ),1587878228,838474445,790092826,3216445499,44362582486.683708,28405200806.217070,27870702753.555140,100638486046.455918,5118147,1342744,2423662,8884553
2016-02-09,EDGA (J),119196025,82877126,59026396,261099547,3204578732.773786,3334581676.053400,2292224577.966214,8831384986.793400,968305,377607,490561,1836473
2016-02-09,EDGX (K),306611753,236136251,259032676,801780680,8991688971.105048,9977368212.815148,8976158115.412744,27945215299.332940,2178004,845292,1635475,4658771
2016-02-09,CHX (M),12988964,22436655,8389455,43815074,375162988.391600,2437416853.409999,611165180.823600,3423745022.625199,2120,12711,5331,20162
2016-02-09,NYSE (N),1166083217,0,0,1166083217,36579080927.796013,0.000000,0.000000,36579080927.796013,4755485,0,0,4755485
2016-02-09,NYSE Arca (P),369136599,522899396,280067307,1172103302,12649821596.634220,23527117439.286728,11178554582.339454,47355493618.260402,2799923,1545689,2019044,6364656
2016-02-09,NASDAQ (Q),699502360,240691826,620960825,1561155011,25480848439.990193,12937231727.180010,24757630801.693992,63175710968.864195,6011467,1052599,4412780,11476846
2016-02-09,NASDAQ PSX (X),50523156,38548282,36180137,125251575,1433895613.993995,2307848055.111100,1434568589.874397,5176312258.979492,340628,157724,231247,729599
2016-02-09,BATS BYX (Y),210545146,129002975,91063824,430611945,5764639842.170778,3912509740.077200,3150016465.257731,12827166047.505709,1793523,530501,832348,3156372
2016-02-09,BATS BZX (Z),350900201,206462360,182583166,739945727,10734014405.371654,11723393263.401772,7200740123.043714,29658147791.817140,2938930,920207,1568241,5427378
2016-02-08,NYSE MKT (A),0,10967841,5969182,16937023,0.000000,69834685.760700,217113335.697800,286948021.458500,0,25709,26525,52234
2016-02-08,NASDAQ BX (B),100756335,53533750,52169104,206459189,3013195053.525290,2175740671.864894,2102664954.337486,7291600679.727670,870204,240168,482416,1592788
2016-02-08,NSX (C),81031,2000,74762,157793,4238277.340000,30618.400000,5025893.650000,9294789.390000,586,12,586,1184
2016-02-08,NYSE (DN),259304117,84467152,125600349,469371618,8563979404.326773,3206430242.965295,5747220202.972398,17517629850.264466,980170,209383,495844,1685397
2016-02-08,NASDAQ (DQ),1659282503,727241477,827523764,3214047744,46643636384.777778,29559432229.507864,31757758856.624243,107960827470.909885,5653991,1494730,2935015,10083736
2016-02-08,EDGA (J),129468434,78986859,63738331,272193624,3470984216.227777,3342841543.690201,2356569136.100097,9170394896.018075,1061269,367607,544329,1973205
2016-02-08,EDGX (K),332871245,219330015,267508818,819710078,9721032347.614065,10540852201.363381,9883920424.438457,30145804973.415903,2331165,869407,1789875,4990447
2016-02-08,CHX (M),16594169,23151292,9181457,48926918,547271060.568400,2763673001.701998,784835776.323200,4095779838.593598,600,12469,7162,20231
2016-02-08,NYSE (N),1354051803,0,0,1354051803,43246263295.788029,0.000000,0.000000,43246263295.788029,5022488,0,0,5022488
2016-02-08,NYSE Arca (P),400142907,517022610,299147995,1216313512,13719955683.881550,25739475741.953047,13068966304.714757,52528397730.549354,3036682,1565099,2249133,6850914
2016-02-08,NASDAQ (Q),748163716,234705896,717625822,1700495434,27038761840.707523,12946457239.021861,30009042352.315464,69994261432.044848,6251533,1064110,4892373,12208016
2016-02-08,NASDAQ PSX (X),52716602,33451147,39759152,125926901,1513013785.674298,1845683791.013700,1568480591.439498,4927178168.127496,378813,142539,253123,774475
2016-02-08,BATS BYX (Y),224008165,119705054,100997507,444710726,6072340724.027712,4123303082.775735,3449923585.680853,13645567392.484300,1892837,555454,889718,3338009
2016-02-08,BATS BZX (Z),370877407,200718970,197049633,768646010,11187422870.196471,11561941674.775323,7947332822.047159,30696697367.018953,3048818,912626,1665585,5627029
2016-02-05,NYSE MKT (A),0,10051199,5490907,15542106,0.000000,63623364.867400,213713038.278000,277336403.145400,0,22825,28077,50902
2016-02-05,NASDAQ BX (B),101162419,47900462,51125537,200188418,3175053770.648986,1838005787.139501,2062416555.057687,7075476112.846174,863741,205950,451967,1521658
2016-02-05,NSX (C),65845,7003,118931,191779,3690633.960000,206222.960000,5563640.790000,9460497.710000,485,49,792,1326
2016-02-05,NYSE (DN),217736026,65993816,111248502,394978344,7784757978.224452,2643263937.319602,5751621990.583681,16179643906.127735,870505,161169,447758,1479432
2016-02-05,NASDAQ (DQ),1425007118,665409395,763774926,2854191439,44592303126.017952,28538613137.983203,31149634316.726076,104280550580.727231,5053897,1164308,2650502,8868707
2016-02-05,EDGA (J),117384520,70241774,59918104,247544398,3317908239.624103,2937373926.922996,2158300328.211185,8413582494.758284,976532,321031,493127,1790690
2016-02-05,EDGX (K),288458187,192548268,241229544,722235999,9443184967.995765,9434592068.462750,9749147957.750182,28626924994.208697,2141424,747727,1651422,4540573
2016-02-05,CHX (M),7934269,20881714,20125414,48941397,282272104.887200,2171289822.102800,1057429170.946199,3510991097.936199,512,11807,4705,17024
2016-02-05,NYSE (N),1153272540,0,0,1153272540,37917879058.985886,0.000000,0.000000,37917879058.985886,4427854,0,0,4427854
2016-02-05,NYSE Arca (P),371243611,445168727,275491451,1091903789,13750828850.270505,22742005250.190314,12407264877.357150,48900098977.817969,2891162,1329836,2106623,6327621
2016-02-05,NASDAQ (Q),689753694,200090721,672061256,1561905671,27191087134.309293,11057500828.178590,29169199695.213375,67417787657.701258,5943041,920647,4448321,11312009
2016-02-05,NASDAQ PSX (X),43597926,29253393,34636155,107487474,1334481186.590795,1662932648.295299,1345374325.869201,4342788160.755295,333383,114921,227553,675857
2016-02-05,BATS BYX (Y),204933605,105347508,90630343,400911456,5847710335.127016,3523732543.690992,3352955221.895016,12724398100.713024,1769544,476856,820408,3066808
2016-02-05,BATS BZX (Z),314108514,158162709,167775666,640046889,10226776507.469306,9074671616.811322,7255022822.297415,26556470946.578043,2729279,737188,1466925,4933392
2016-02-04,NYSE MKT (A),0,8895343,4621613,13516956,0.000000,52728781.230700,148928191.811000,201656973.041700,0,25938,28708,54646
2016-02-04,NASDAQ BX (B),97511533,55939392,43666417,197117342,2962352548.495601,2045202237.002100,1852153873.934099,6859708659.431800,833991,235049,397949,1466989
2016-02-04,NSX (C),72191,3000,93573,168764,3850015.760000,90724.000000,3323832.910000,7264572.670000,517,17,671,1205
2016-02-04,NYSE (DN),218913161,76163701,97364935,392441797,7316080912.696382,2619540378.647204,4557611765.186743,14493233056.530329,885555,182704,413989,1482248
2016-02-04,NASDAQ (DQ),1464426675,661730847,670661419,2796818941,42848106226.887368,23762325955.288797,26220024143.067927,92830456325.244092,5035100,1236722,2352995,8624817
2016-02-04,EDGA (J),121797810,76370014,51912909,250080733,3119570316.208002,2940362096.472296,1887309084.486209,7947241497.166507,975385,338663,434753,1748801
2016-02-04,EDGX (K),326023055,209630056,231684108,767337219,9850064816.098531,9301393606.681820,8670914276.948675,27822372699.729026,2360467,799063,1593307,4752837
2016-02-04,CHX (M),11627228,15788076,11695814,39111118,484298142.177700,1724170769.990000,988794172.787800,3197263084.955500,685,10147,3554,14386
2016-02-04,NYSE (N),1208543525,0,0,1208543525,38744161562.908423,0.000000,0.000000,38744161562.908423,4770084,0,0,4770084
2016-02-04,NYSE Arca (P),398894319,473108026,249894914,1121897259,13543470729.499094,21944486722.640443,10914771175.791489,46402728627.931026,2985101,1457180,1987813,6430094
2016-02-04,NASDAQ (Q),742425440,218788592,574095223,1535309255,27564715264.059159,11312451501.781592,25269577877.681837,64146744643.522588,6287743,998857,4207829,11494429
2016-02-04,NASDAQ PSX (X),48140086,29838179,29136358,107114623,1387404732.784400,1419377397.726699,1048254667.656101,3855036798.167200,340431,120181,197282,657894
2016-02-04,BATS BYX (Y),207045115,116611005,78098404,401754524,5676437112.686180,3684468293.310703,2851382743.655197,12212288149.652080,1799167,497345,745392,3041904
2016-02-04,BATS BZX (Z),352334332,178637342,159789496,690761170,10838380033.093938,9638625029.355219,6653772583.047148,27130777645.496305,2954131,822724,1417170,5194025
2016-02-03,NYSE MKT (A),0,7791462,5187034,12978496,0.000000,49050231.136900,176843950.872000,225894182.008900,0,23116,27906,51022
2016-02-03,NASDAQ BX (B),97032967,69562088,47808441,214403496,2960077967.259612,2613831898.460405,1934436309.091006,7508346174.811023,847447,267246,442016,1556709
2016-02-03,NSX (C),142570,5234,91811,239615,6459108.550000,156213.980000,4541474.130000,11156796.660000,953,23,728,1704
2016-02-03,NYSE (DN),217902031,88321671,108574242,414797944,7177095029.221840,3253850972.295287,5424771485.902426,15855717487.419553,845819,207659,433251,1486729
2016-02-03,NASDAQ (DQ),1467993565,779891509,766161969,3014047043,43193687465.974570,30638869703.282722,31085761379.508318,104918318548.765610,5009092,1405517,2592371,9006980
2016-02-03,EDGA (J),123916815,98566828,59807680,282291323,3253931477.265508,3926271890.257084,2060788196.474484,9240991563.997076,985531,427600,505445,1918576
2016-02-03,EDGX (K),322688033,236131749,249684725,808504507,10087701912.954913,11508776903.875580,9969567623.728507,31566046440.559000,2331555,889149,1704396,4925100
2016-02-03,CHX (M),8792465,29530283,8742143,47064891,281594119.601800,2979712119.980001,672482858.577299,3933789098.159100,689,14131,4883,19703
2016-02-03,NYSE (N),1195070841,0,0,1195070841,39394232523.493234,0.000000,0.000000,39394232523.493234,4805906,0,0,4805906
2016-02-03,NYSE Arca (P),386897468,577996130,290222477,1255116075,13476119231.198163,27465894726.042148,12674341471.181337,53616355428.421648,2922717,1672395,2219049,6814161
2016-02-03,NASDAQ (Q),746215362,267058109,619931620,1633205091,28019797629.700869,15121163280.884400,28173750255.950304,71314711166.535573,6482384,1212018,4575166,12269568
2016-02-03,NASDAQ PSX (X),44934202,36927642,32971974,114833818,1453385757.942206,1934650673.609601,1251125816.596394,4639162248.148201,341538,139094,216716,697348
2016-02-03,BATS BYX (Y),207144895,142527265,92029457,441701617,5740028520.513516,4887887066.021396,3334947365.682381,13962862952.217293,1777415,599238,874473,3251126
2016-02-03,BATS BZX (Z),356595627,219394290,188725976,764715893,11360351881.097910,12359907814.893288,7871658681.230800,31591918377.221998,3060135,974942,1658284,5693361
2016-02-02,NYSE MKT (A),0,6423544,3862512,10286056,0.000000,42341158.050300,138324432.397600,180665590.447900,0,18944,22438,41382
2016-02-02,NASDAQ BX (B),78853036,46604143,39078325,164535504,2364695176.145198,1777886392.091903,1568723017.059399,5711304585.296500,671126,179099,354516,1204741
2016-02-02,NSX (C),72587,400,61003,133990,4546982.430000,5181.090000,3087204.770000,7639368.290000,536,2,435,973
2016-02-02,NYSE (DN),193164622,66852006,97342876,357359504,6727437488.650352,2755211630.435994,4915036542.310602,14397685661.396948,759983,154614,368786,1283383
2016-02-02,NASDAQ (DQ),1310355410,674717886,709009312,2694082608,40546780916.557112,30866196255.410425,27869140736.627940,99282117908.595477,4621582,1091236,2346060,8058878
2016-02-02,EDGA (J),105283717,64442295,54468552,224194564,2957953059.347206,2669303577.685801,1963416793.885200,7590673430.918207,884693,281916,451497,1618106
2016-02-02,EDGX (K),260457950,172896127,228146707,661500784,8379330307.454115,7834284312.018426,9050187068.437563,25263801687.910104,1888196,615400,1448025,3951621
2016-02-02,CHX (M),7589569,22266937,5077860,34934366,232447179.525300,2482708519.180001,464984883.079500,3180140581.784801,556,9362,2529,12447
2016-02-02,NYSE (N),1068109301,0,0,1068109301,35946171833.281155,0.000000,0.000000,35946171833.281155,3949807,0,0,3949807
2016-02-02,NYSE Arca (P),324762446,413026436,247088088,984876970,11739773593.158463,20738315017.316934,10807257591.424587,43285346201.899984,2443874,1139126,1820505,5403505
2016-02-02,NASDAQ (Q),607968396,172663646,539143958,1319776000,23899888463.512107,9423193167.952789,23961769286.956251,57284850918.421147,5181298,766118,3707444,9654860
2016-02-02,NASDAQ PSX (X),35682961,21526989,27424436,84634386,1079645717.728402,1003215594.343900,1004288895.522902,3087150207.595204,268362,87873,181682,537917
2016-02-02,BATS BYX (Y),200626547,107762297,89971440,398360284,5708017452.314622,3570453395.586787,3056635975.547798,12335106823.449207,1739590,467478,805195,3012263
2016-02-02,BATS BZX (Z),278648324,141968291,147902170,568518785,9125286677.072549,7934276322.592675,6077765263.981825,23137328263.647049,2394964,627888,1258052,4280904
2016-02-01,NYSE MKT (A),0,7544085,3638048,11182133,0.000000,46122137.757100,113516070.562000,159638208.319100,0,21724,23874,45598
2016-02-01,NASDAQ BX (B),81688082,39832291,36687160,158207533,2486290077.243697,1659947089.340301,1510369248.729789,5656606415.313787,696844,170812,338212,1205868
2016-02-01,NSX (C),55320,200,76563,132083,2499221.470000,250.000000,3344959.980000,5844431.450000,362,1,518,881
2016-02-01,NYSE (DN),184738914,61501948,84891517,331132379,6341021530.399051,2140700263.894290,4033928341.148526,12515650135.441867,741470,152226,344108,1237804
2016-02-01,NASDAQ (DQ),1279013795,600461363,653051592,2532526750,38909403179.461041,27099247814.220946,25168293211.761011,91176944205.442998,4419500,1096355,2165465,7681320
2016-02-01,EDGA (J),104195207,61510091,48282780,213988078,3032628764.172216,2546244134.777109,1691645092.153098,7270517991.102423,872150,282841,404069,1559060
2016-02-01,EDGX (K),248543274,156025503,200326420,604895197,7854179680.634729,7172756108.586607,7848764754.838014,22875700544.059350,1833472,594786,1319484,3747742
2016-02-01,CHX (M),9032314,25202708,4379863,38614885,274267302.296200,2252030905.453998,315803191.358800,2842101399.108998,621,8205,2148,10974
2016-02-01,NYSE (N),1020832455,0,0,1020832455,33873859061.572539,0.000000,0.000000,33873859061.572539,3864327,0,0,3864327
2016-02-01,NYSE Arca (P),322136845,365264698,221572543,908974086,11289581837.410303,19097979944.016577,9925547850.898806,40313109632.325686,2441778,1091954,1728990,5262722
2016-02-01,NASDAQ (Q),586350537,162571041,501443413,1250364991,22542920129.962371,8966907110.532480,22731435254.915955,54241262495.410806,5034039,747660,3517019,9298718
2016-02-01,NASDAQ PSX (X),35027705,19901774,23205068,78134547,1058541043.582500,1023307078.187099,801846799.228701,2883694920.998300,266368,89463,160925,516756
2016-02-01,BATS BYX (Y),196746741,101021111,81002807,378770659,5475020746.074654,3415389976.867313,2736915372.644293,11627326095.586260,1701647,457993,732163,2891803
2016-02-01,BATS BZX (Z),265245914,131234873,129249090,525729877,8609213423.611059,7575395930.041403,5161643448.061199,21346252801.713661,2295604,605209,1150014,4050827
2016-01-29,NYSE MKT (A),0,11989152,4656586,16645738,0.000000,98242614.660300,145542223.514000,243784838.174300,0,25648,31469,57117
2016-01-29,NASDAQ BX (B),106832936,52723910,51728178,211285024,3370202774.064824,2310987492.734101,2117256484.311101,7798446751.110026,898246,233021,455050,1586317
2016-01-29,NSX (C),123860,11362,59943,195165,7347571.590000,1389714.110000,3188026.000000,11925311.700000,738,80,373,1191
2016-01-29,NYSE (DN),196747122,66895596,103515264,367157982,7128774917.686274,2563779211.223093,5172695918.426957,14865250047.336324,788143,171337,398353,1357833
2016-01-29,NASDAQ (DQ),1591659129,670653669,844747529,3107060327,49673336752.062288,32460147464.284073,34420017438.771518,116553501655.117879,4886147,1195669,2629298,8711114
2016-01-29,EDGA (J),118323558,69084778,57425064,244833400,3485949822.266186,3088932625.797597,2220007329.966086,8794889778.029869,1001976,311741,479630,1793347
2016-01-29,EDGX (K),274613621,177442080,228572658,680628359,8607060268.131188,8573066371.502460,9644848525.835042,26824975165.468690,1978082,682363,1510691,4171136
2016-01-29,CHX (M),6112691,22476301,6413357,35002349,259619535.584900,2651744344.204497,607073790.220900,3518437670.010297,968,9106,3135,13209
2016-01-29,NYSE (N),1633689109,0,0,1633689109,59108289161.507648,0.000000,0.000000,59108289161.507648,4244741,0,0,4244741
2016-01-29,NYSE Arca (P),359073225,455996967,251793626,1066863818,12896373244.705621,26537973621.420670,12077895306.763951,51512242172.890242,2646388,1248183,1960476,5855047
2016-01-29,NASDAQ (Q),661275209,196819562,786461990,1644556761,25594586722.202916,11336402893.876297,36849997021.557508,73780986637.636721,5561307,843853,4049015,10454175
2016-01-29,NASDAQ PSX (X),37975386,24981751,28995444,91952581,1176608904.971396,1256487632.307600,1097298490.522003,3530395027.800999,296467,100596,198756,595819
2016-01-29,BATS BYX (Y),207960837,116834594,90764298,415559729,6148378435.085251,4194426730.667386,3344333861.071207,13687139026.823844,1850508,507024,839524,3197056
2016-01-29,BATS BZX (Z),298033303,160787687,158169595,616990585,9790235999.589378,9563576838.712365,6821680369.058125,26175493207.359868,2533896,725522,1336631,4596049
2016-01-28,NYSE MKT (A),0,8018305,4851676,12869981,0.000000,67841991.491100,173113843.593100,240955835.084200,0,22370,29146,51516
2016-01-28,NASDAQ BX (B),91357458,50277321,48484155,190118934,2868287521.016692,1907945643.040602,2102737248.038408,6878970412.095702,776221,203669,424950,1404840
2016-01-28,NSX (C),73585,1200,44708,119493,3812400.280000,1627.000000,1937182.090000,5751209.370000,517,6,350,873
2016-01-28,NYSE (DN),196213131,64223600,102598953,363035684,7058619321.180933,2419867286.429293,5111526968.296357,14590013575.906583,751003,152170,401419,1304592
2016-01-28,NASDAQ (DQ),1328120902,545409071,745428999,2618958972,39904621175.048546,21227898188.038282,30193169783.081415,91325689146.168243,4593918,1087974,2485741,8167633
2016-01-28,EDGA (J),105472307,69073476,58388892,232934675,2976085356.728198,2700082937.534803,2388284747.514705,8064453041.777706,880490,316944,482934,1680368
2016-01-28,EDGX (K),285272665,180933018,240651862,706857545,8604363210.123527,8236046752.066018,10516166043.884387,27356576006.073932,2061787,709618,1607035,4378440
2016-01-28,CHX (M),13116759,16525407,5965622,35607788,470729440.414000,1783777914.885001,477587525.210100,2732094880.509101,1066,9698,2978,13742
2016-01-28,NYSE (N),1097074711,0,0,1097074711,35509922792.049837,0.000000,0.000000,35509922792.049837,4274119,0,0,4274119
2016-01-28,NYSE Arca (P),364610793,414664333,269384761,1048659887,12381739758.478956,20403056201.073476,13408160632.912439,46192956592.464871,2645993,1361808,2038677,6046478
2016-01-28,NASDAQ (Q),684927430,214970573,578657165,1478555168,25401129844.951031,11779749577.109269,27035428170.456104,64216307592.516404,5678164,1005156,4104646,10787966
2016-01-28,NASDAQ PSX (X),43403866,28344768,32376933,104125567,1227560461.456301,1447082540.100500,1210352308.582803,3884995310.139604,312838,113562,204620,631020
2016-01-28,BATS BYX (Y),184798880,116420142,82252638,383471660,5208494411.027906,3655129284.390967,3031026101.058689,11894649796.477562,1568883,522014,743032,2833929
2016-01-28,BATS BZX (Z),301030942,164301240,157014457,622346639,9397321050.063263,8898539307.540821,6725105441.327163,25020965798.931247,2495779,773247,1337300,4606326
2016-01-27,NYSE MKT (A),0,8266086,5030257,13296343,0.000000,54055645.179900,171600708.133000,225656353.312900,0,24020,28250,52270
2016-01-27,NASDAQ BX (B),88338217,54748933,41616845,184703995,2752639555.934696,2070259222.626399,1660098357.674575,6482997136.235670,754442,227479,388555,1370476
2016-01-27,NSX (C),122845,2600,35898,161343,5911815.660000,103880.000000,1570340.440000,7586036.100000,859,15,298,1172
2016-01-27,NYSE (DN),195273089,70420476,84635780,350329345,6454042268.391479,2648147789.433395,4100382220.325504,13202572278.150378,775457,156868,350453,1282778
2016-01-27,NASDAQ (DQ),1374109127,582689928,647902900,2604701955,38196879197.853295,24259373112.431258,26115837620.516655,88572089930.801208,4515656,1119539,2205918,7841113
2016-01-27,EDGA (J),102142493,70838796,49380782,222362071,2709104136.183100,2879520195.517994,1637171827.346998,7225796159.048092,823569,312423,405234,1541226
2016-01-27,EDGX (K),298126003,195596726,229976298,723699027,8720539015.202462,9210895968.058289,9369801201.348856,27301236184.609607,2127180,762056,1505880,4395116
2016-01-27,CHX (M),7883393,22966938,7380045,38230376,267272273.921000,2850515869.059999,517341678.599600,3635129821.580599,739,14837,4150,19726
2016-01-27,NYSE (N),1125804129,0,0,1125804129,35920393435.386679,0.000000,0.000000,35920393435.386679,4335254,0,0,4335254
2016-01-27,NYSE Arca (P),360929914,437913132,250304861,1049147907,11626585242.852356,22671758620.584692,11164394458.215314,45462738321.652362,2644738,1447617,1891382,5983737
2016-01-27,NASDAQ (Q),683079227,231065660,550807366,1464952253,24702895770.525017,12764334479.702324,24341174940.963757,61808405191.191098,5733608,1039578,3837345,10610531
2016-01-27,NASDAQ PSX (X),43091361,29461116,30181335,102733812,1228730065.446503,1470337251.094999,1099506685.103198,3798574001.644700,314677,128652,195140,638469
2016-01-27,BATS BYX (Y),181143482,119924558,78391158,379459198,5055114246.354486,3844338104.004007,2754057205.019478,11653509555.377971,1547566,537211,722936,2807713
2016-01-27,BATS BZX (Z),298936507,172168741,146920519,618025767,8984726709.617737,9255847978.515286,6009621547.936389,24250196236.069412,2457942,772811,1264149,4494902
2016-01-26,NYSE MKT (A),0,7220734,3235979,10456713,0.000000,40430892.479000,91775335.230000,132206227.709000,0,21123,18079,39202
2016-01-26,NASDAQ BX (B),85183560,39437359,41020766,165641685,2429026811.867201,1613355938.893599,1455313248.597101,5497695999.357901,700720,179747,353833,1234300
2016-01-26,NSX (C),105588,2907,28653,137148,4130041.860000,127718.530000,1738334.070000,5996094.460000,688,15,198,901
2016-01-26,NYSE (DN),184152198,62052659,85541973,331746830,5618987845.252962,2312054608.207397,3375272478.459209,11306314931.919568,717794,148985,337873,1204652
2016-01-26,NASDAQ (DQ),1338529144,541729485,655724360,2535982989,36928925722.109990,22217275850.174759,22121840050.492672,81268041622.777421,4347475,1045021,2108204,7500700
2016-01-26,EDGA (J),94767688,55893458,50462365,201123511,2500907907.403498,2200742643.952596,1508182722.409485,6209833273.765579,781217,249338,385147,1415702
2016-01-26,EDGX (K),255003341,150848319,199182341,605034001,7287755573.553584,6823074240.407802,7006670255.793281,21117500069.754667,1788338,583118,1309173,3680629
2016-01-26,CHX (M),11562581,18024625,7126740,36713946,279537574.373000,1520453174.070001,472030761.777000,2272021510.220001,688,7707,2517,10912
2016-01-26,NYSE (N),1044490662,0,0,1044490662,32813453298.878782,0.000000,0.000000,32813453298.878782,3675078,0,0,3675078
2016-01-26,NYSE Arca (P),321384085,347709238,220125795,889219118,10154164513.156334,17429567893.555131,8703708674.134250,36287441080.845715,2290672,1081438,1653563,5025673
2016-01-26,NASDAQ (Q),549305771,164295316,487923025,1201524112,19844365828.921271,9246536677.176317,19652453858.063179,48743356364.160767,4648533,750925,3278999,8678457
2016-01-26,NASDAQ PSX (X),35186626,19521096,26313413,81021135,982724790.212601,982276241.841899,877819264.392298,2842820296.446798,265847,88296,172659,526802
2016-01-26,BATS BYX (Y),175146881,101190150,77862500,354199531,4709263652.397022,3212067158.758395,2414820227.472174,10336151038.627591,1509626,475183,674515,2659324
2016-01-26,BATS BZX (Z),259513576,123691578,132218910,515424064,7736169017.221404,6892477943.213779,4770655460.811899,19399302421.247082,2142832,551447,1100908,3795187
2016-01-25,NYSE MKT (A),0,7441842,4953127,12394969,0.000000,53163335.459100,165092249.440000,218255584.899100,0,21697,27398,49095
2016-01-25,NASDAQ BX (B),88432564,42153739,41077908,171664211,2573791321.322793,1706443345.118698,1501151056.180501,5781385722.621992,743895,199126,364054,1307075
2016-01-25,NSX (C),49237,2700,41426,93363,2530167.780000,153864.000000,1634119.030000,4318150.810000,303,26,330,659
2016-01-25,NYSE (DN),160191778,59081726,75259670,294533174,4867586435.641799,2272957539.591397,3141070543.554388,10281614518.787584,654602,147293,304619,1106514
2016-01-25,NASDAQ (DQ),1370100302,633832007,698399311,2702331620,37438544730.036099,26992214904.937243,22297765333.442867,86728524968.416209,4380746,1067012,2009650,7457408
2016-01-25,EDGA (J),97766403,62410461,48993043,209169907,2569893663.957474,2389060162.633897,1483168027.021798,6442121853.613169,812432,274061,381874,1468367
2016-01-25,EDGX (K),252205733,154131102,202139892,608476727,7174394354.229177,6978803989.935725,7024511779.532421,21177710123.697323,1793107,601343,1300191,3694641
2016-01-25,CHX (M),12683857,14791539,4525708,32001104,467654027.970500,1426888865.449998,284178532.602400,2178721426.022898,755,7789,2184,10728
2016-01-25,NYSE (N),1056084813,0,0,1056084813,33332355335.707663,0.000000,0.000000,33332355335.707663,3838056,0,0,3838056
2016-01-25,NYSE Arca (P),302681416,369393122,218331775,890406313,9855109346.611850,17642831386.976737,8274535680.140691,35772476413.729278,2258113,1099137,1626260,4983510
2016-01-25,NASDAQ (Q),571782210,168087961,511406144,1251276315,20841959703.495899,8782383051.316274,20395376275.077092,50019719029.889265,4929776,761809,3314489,9006074
2016-01-25,NASDAQ PSX (X),34901854,20728020,25312216,80942090,970656240.837401,928075575.961099,842632346.436099,2741364163.234599,257560,88416,166065,512041
2016-01-25,BATS BYX (Y),178015069,101931917,75838951,355785937,4844549756.696282,3439118372.648587,2493706140.845543,10777374270.190412,1545467,489514,677534,2712515
2016-01-25,BATS BZX (Z),254449253,131472676,124542360,510464289,7603084815.758020,6999604907.923710,4535578121.256047,19138267844.937777,2128957,580975,1055019,3764951
2016-01-22,NYSE MKT (A),0,11078070,3250123,14328193,0.000000,66208159.974900,87601498.325000,153809658.299900,0,26852,18495,45347
2016-01-22,NASDAQ BX (B),98439588,54671126,48010495,201121209,2768623975.415412,2167621051.655199,1770786002.287406,6707031029.358017,826893,231444,420593,1478930
2016-01-22,NSX (C),68155,14538,46929,129622,2631473.820000,216484.920000,3298112.980000,6146071.720000,443,34,336,813
2016-01-22,NYSE (DN),200411431,73908910,86964214,361284555,6056774416.827051,2738448826.246289,3684424663.695909,12479647906.769249,749462,175584,326848,1251894
2016-01-22,NASDAQ (DQ),1436003452,747992613,701770067,2885766132,38878915259.116044,29161122582.787938,24113496359.537560,92153534201.441542,4734334,1222453,2228710,8185497
2016-01-22,EDGA (J),109952998,74887622,53251757,238092377,2764763228.077489,2921700837.622499,1676756479.840198,7363220545.540186,878693,330046,415587,1624326
2016-01-22,EDGX (K),294499225,175153147,211631498,681283870,8057123024.759556,8040199732.931493,7382611024.556379,23479933782.247428,2071074,680803,1374100,4125977
2016-01-22,CHX (M),10160845,25291272,4116288,39568405,241369002.196000,2456246128.919998,297874935.047200,2995490066.163198,735,10711,2741,14187
2016-01-22,NYSE (N),1194605526,0,0,1194605526,36309755975.768015,0.000000,0.000000,36309755975.768015,4246800,0,0,4246800
2016-01-22,NYSE Arca (P),370710145,437777683,235026219,1043514047,11390680115.252438,21919112509.809992,9122558278.285958,42432350903.348388,2659714,1313474,1730299,5703487
2016-01-22,NASDAQ (Q),637885102,206816845,555059565,1399761512,21958764611.318501,11426618576.647168,21942224243.011151,55327607430.976820,5302342,918760,3522322,9743424
2016-01-22,NASDAQ PSX (X),40841284,25427358,25255317,91523959,1070725019.371498,1193290546.172200,835041140.940102,3099056706.483800,295370,106162,168944,570476
2016-01-22,BATS BYX (Y),206829200,111245856,88120485,406195541,5359335009.793701,3847752249.680200,2858842477.161732,12065929736.635633,1801271,493871,774636,3069778
2016-01-22,BATS BZX (Z),304338581,155233427,143201050,602773058,8656628369.903636,8652928044.340180,5472948602.502306,22782505016.746122,2477971,702824,1184800,4365595
2016-01-21,NYSE MKT (A),0,8846729,4093264,12939993,0.000000,49818645.443500,105333496.261400,155152141.704900,0,25290,26863,52153
2016-01-21,NASDAQ BX (B),105644538,65542265,56795759,227982562,3123696867.678016,2694426913.619695,1960515609.497904,7778639390.795615,919912,294823,497363,1712098
2016-01-21,NSX (C),84501,2000,42668,129169,3678936.890000,26696.000000,2020402.580000,5726035.470000,632,5,363,1000
2016-01-21,NYSE (DN),207021261,85737179,98872790,391631230,6071500117.832075,3323566178.818902,3859521610.228517,13254587906.879494,791536,196692,372097,1360325
2016-01-21,NASDAQ (DQ),1460728780,758672785,779221879,2998623444,38942739619.250789,33119310889.212883,25966599887.280296,98028650395.743968,4892376,1415011,2438096,8745483
2016-01-21,EDGA (J),115278835,89871984,61982890,267133709,2919915137.123621,3823631713.417395,1881549229.534600,8625096080.075616,939040,430499,493091,1862630
2016-01-21,EDGX (K),314402785,221568171,248976595,784947551,8996024428.451840,10946088528.577386,8516107124.164175,28458220081.193401,2293745,907967,1652154,4853866
2016-01-21,CHX (M),16529479,28440880,9355518,54325877,316033395.486000,3017619286.726002,631850516.145000,3965503198.357002,745,17860,4049,22654
2016-01-21,NYSE (N),1206097634,0,0,1206097634,37024244667.577693,0.000000,0.000000,37024244667.577693,4750783,0,0,4750783
2016-01-21,NYSE Arca (P),383899867,487774088,277066549,1148740504,12233900975.078432,24251179867.034573,10758858617.010293,47243939459.123298,2866662,1647427,2086183,6600272
2016-01-21,NASDAQ (Q),690468485,264794957,612819962,1568083404,24383895486.624157,14417988754.193772,23505138388.397810,62307022629.215739,5903460,1194718,4252294,11350472
2016-01-21,NASDAQ PSX (X),43984012,32762393,31762528,108508933,1225661361.106000,1663477700.367101,1054132102.253098,3943271163.726199,321400,140571,204749,666720
2016-01-21,BATS BYX (Y),203521217,135204653,92779046,431504916,5365266103.047685,4634134459.814701,2807143012.481183,12806543575.343569,1735439,591341,817300,3144080
2016-01-21,BATS BZX (Z),334663591,208624448,176529032,719817071,9932797607.174003,11240903366.402126,6398102515.728340,27571803489.304469,2774755,952451,1477777,5204983
2016-01-20,NYSE MKT (A),0,11080816,3226328,14307144,0.000000,64754785.268000,77272484.610000,142027269.878000,0,29679,19616,49295
2016-01-20,NASDAQ BX (B),128704308,73903250,73340863,275948421,3915678604.008901,3238152326.637894,2702874330.090481,9856705260.737276,1132947,350655,667665,2151267
2016-01-20,NSX (C),107208,8507,22747,138462,3345567.290000,272994.080000,1950917.500000,5569478.870000,800,74,207,1081
2016-01-20,NYSE (DN),285390663,102671166,152130461,540192290,8325738821.163811,4741159600.007404,6099577124.855214,19166475546.026429,1015058,251270,531888,1798216
2016-01-20,NASDAQ (DQ),1920155101,932714418,1037127791,3889997310,50970828207.644112,43624330941.368714,36244191808.326463,130839350957.339289,6441711,1871316,3284658,11597685
2016-01-20,EDGA (J),143332498,105859555,78723956,327916009,3543272077.395976,4581327268.393800,2394547701.367097,10519147047.156873,1147169,517559,618997,2283725
2016-01-20,EDGX (K),399072757,272414564,334538262,1006025583,11176524264.101828,14319605642.765256,11625431251.800036,37121561158.667120,2776256,1120315,2159720,6056291
2016-01-20,CHX (M),15785210,37861454,10675811,64322475,470445906.901400,4343274455.355202,755638977.014000,5569359339.270602,944,22303,7548,30795
2016-01-20,NYSE (N),1474413170,0,0,1474413170,45108486560.133331,0.000000,0.000000,45108486560.133331,5730715,0,0,5730715
2016-01-20,NYSE Arca (P),467259167,615984443,351417010,1434660620,14910984277.302234,33282515630.291666,14023104656.255964,62216604563.849864,3408250,2014090,2588195,8010535
2016-01-20,NASDAQ (Q),869856271,330807942,772983434,1973647647,31298045314.837434,20064490406.824350,31121125908.690570,82483661630.352354,7424680,1508626,5421548,14354854
2016-01-20,NASDAQ PSX (X),51979889,36385224,42167512,130532625,1483338952.231100,2165147811.500802,1499748692.023303,5148235455.755205,378826,163358,259856,802040
2016-01-20,BATS BYX (Y),246151972,154484417,119578956,520215345,6278280170.929668,5418599688.354014,3834015294.676750,15530895153.960432,2089192,692706,1055290,3837188
2016-01-20,BATS BZX (Z),416570386,251841036,229431495,897842917,12198852574.374337,15291550186.610711,8657847963.212713,36148250724.197761,3415914,1163240,1911125,6490279
2016-01-19,NYSE MKT (A),0,10380243,3664635,14044878,0.000000,80387899.840000,98298792.472700,178686692.312700,0,25886,21068,46954
2016-01-19,NASDAQ BX (B),102360701,57083127,56696562,216140390,3214801473.711606,2512905342.376197,2031490745.299299,7759197561.387102,899990,263410,503174,1666574
2016-01-19,NSX (C),85543,900,47927,134370,3408202.090000,152303.000000,2220273.870000,5780778.960000,687,9,411,1107
2016-01-19,NYSE (DN),209086152,75312950,103045641,387444743,6646003052.631993,3233691683.519593,4231055975.037857,14110750711.189443,817979,181555,401096,1400630
2016-01-19,NASDAQ (DQ),1494918669,728482771,781537058,3004938498,41442967819.879021,33410746895.885437,26935083205.133261,101788797920.897719,5122645,1353339,2540558,9016542
2016-01-19,EDGA (J),110161152,74042348,59118044,243321544,3027263487.223597,3289964897.763994,1848343538.594311,8165571923.581902,910732,343998,479185,1733915
2016-01-19,EDGX (K),286511303,188990200,239015853,714517356,8431210600.766842,9431602339.065248,8280256190.796805,26143069130.628895,2044813,757678,1567454,4369945
2016-01-19,CHX (M),7131091,25217329,7430709,39779129,302307763.005300,2520379148.299500,506975073.061000,3329661984.365800,847,11884,4615,17346
2016-01-19,NYSE (N),1206378056,0,0,1206378056,39321691934.655928,0.000000,0.000000,39321691934.655928,4424712,0,0,4424712
2016-01-19,NYSE Arca (P),349523221,470660638,249182770,1069366629,11579089686.387864,25025630542.824139,9974483061.417747,46579203290.629750,2584488,1433782,1880552,5898822
2016-01-19,NASDAQ (Q),636447662,221548918,611978125,1469974705,23978218468.272981,12683350546.827488,24019590451.475511,60681159466.575980,5474264,1012892,4034946,10522102
2016-01-19,NASDAQ PSX (X),37789039,26355138,29004885,93149062,1103853685.808700,1432740836.106599,988971952.991497,3525566474.906796,273232,115707,189587,578526
2016-01-19,BATS BYX (Y),197917437,113171220,93500830,404589487,5390452352.453026,4070718426.879094,2915150960.707994,12376321740.040114,1704990,511536,807066,3023592
2016-01-19,BATS BZX (Z),296797655,170405737,164002070,631205462,9117386046.035481,10271398996.430099,5980188349.619165,25368973392.084745,2472099,760995,1351878,4584972
2016-01-15,NYSE MKT (A),0,11267723,4107499,15375222,0.000000,68849300.831600,128916295.604600,197765596.436200,0,23033,21824,44857
2016-01-15,NASDAQ BX (B),113310021,66580585,62454632,242345238,3627386917.409896,3285505770.031502,2482455893.441702,9395348580.883100,991970,306925,571956,1870851
2016-01-15,NSX (C),46973,1300,35497,83770,2876746.160000,66017.000000,1812209.620000,4754972.780000,420,10,315,745
2016-01-15,NYSE (DN),229645828,86573414,116136675,432355917,7358026384.582476,3947013831.458008,5061274204.564806,16366314420.605290,890734,219951,445252,1555937
2016-01-15,NASDAQ (DQ),1516877131,830853913,865642390,3213373434,44166363055.916450,44936105133.148137,31783030256.717810,120885498445.782397,5138067,1522653,2716875,9377595
2016-01-15,EDGA (J),128307442,90733410,67568216,286609068,3563015832.630602,4246368168.741102,2371091529.265200,10180475530.636904,1067036,405822,562016,2034874
2016-01-15,EDGX (K),310308168,234325439,263422710,808056317,9735460882.867833,12505284751.444093,10006516303.909611,32247261938.221537,2266275,940161,1783830,4990266
2016-01-15,CHX (M),13930172,33020352,19067823,66018347,422507249.332000,3927604880.503000,1308037592.531599,5658149722.366599,888,21182,4500,26570
2016-01-15,NYSE (N),1475949003,0,0,1475949003,51789657479.106441,0.000000,0.000000,51789657479.106441,4805988,0,0,4805988
2016-01-15,NYSE Arca (P),394728891,584194209,298211055,1277134155,13386989291.072969,32810589877.062794,12928584515.114673,59126163683.250436,2967032,1772574,2251417,6991023
2016-01-15,NASDAQ (Q),704391382,289628988,791215656,1785236026,26821462347.250602,18341896280.144151,34051806740.528923,79215165367.923676,6106290,1263259,4738830,12108379
2016-01-15,NASDAQ PSX (X),42119539,33670972,34420385,110210896,1287891560.436803,1936468075.324699,1312190750.874695,4536550386.636197,311822,141341,223238,676401
2016-01-15,BATS BYX (Y),220358471,136955051,105365585,462679107,5997702996.982410,5372809479.863083,3547928621.198443,14918441098.043936,1874186,596152,950272,3420610
2016-01-15,BATS BZX (Z),333231622,227661718,198110133,759003473,10404254448.080299,15555168122.670129,7995199744.768140,33954622315.518568,2733620,1011299,1646446,5391365
2016-01-14,NYSE MKT (A),0,9571322,3212581,12783903,0.000000,55459074.519400,93259442.695100,148718517.214500,0,26736,20910,47646
2016-01-14,NASDAQ BX (B),107912827,57348563,58805118,224066508,3451255815.132593,2619380110.786597,2381938200.170599,8452574126.089789,933732,261979,514059,1709770
2016-01-14,NSX (C),139493,4952,57088,201533,7074550.640000,116725.720000,3588249.940000,10779526.300000,1037,28,500,1565
2016-01-14,NYSE (DN),211282591,79865085,109268142,400415818,6505150345.008258,3583302703.907788,4944437242.648521,15032890291.564567,800652,184020,414682,1399354
2016-01-14,NASDAQ (DQ),1599486985,715256851,849339321,3164083157,44425147003.167468,36901254081.249933,30940968650.033003,112267369734.450404,5247558,1355187,2676734,9279479
2016-01-14,EDGA (J),126477083,79804663,64076956,270358702,3461369739.483519,3634894633.317284,2233886792.541480,9330151165.342283,1051816,373819,517450,1943085
2016-01-14,EDGX (K),308638056,203303264,257563649,769504969,9201510818.190328,10783192773.670833,9348399098.178919,29333102690.040080,2194832,849587,1638437,4682856
2016-01-14,CHX (M),11853610,25593295,12455482,49902387,366681971.616000,2916378062.910999,640894099.396200,3923954133.923199,718,13679,3832,18229
2016-01-14,NYSE (N),1253308394,0,0,1253308394,42254317474.096892,0.000000,0.000000,42254317474.096892,4543361,0,0,4543361
2016-01-14,NYSE Arca (P),367981776,474250538,269747353,1111979667,12358349839.665284,26525240079.808722,11422083653.640661,50305673573.114667,2711533,1516013,2005463,6233009
2016-01-14,NASDAQ (Q),668477781,233142379,636806559,1538426719,24742442634.895534,14658368305.459331,27433227424.223719,66834038364.578584,5674300,1073371,4247056,10994727
2016-01-14,NASDAQ PSX (X),43518398,30245489,31859543,105623430,1236792383.699300,1743136870.854999,1284331627.349298,4264260881.903597,310872,133585,204257,648714
2016-01-14,BATS BYX (Y),217121213,112824742,98477775,428423730,6067246636.989526,4260829611.066402,3396120156.926829,13724196404.982757,1850338,504748,852289,3207375
2016-01-14,BATS BZX (Z),328763504,188764747,176874563,694402814,9867914107.364922,12025118333.278114,6981620887.921477,28874653328.564513,2655857,839795,1430833,4926485
2016-01-13,NYSE MKT (A),0,9373784,3656097,13029881,0.000000,55672889.428100,112182818.382000,167855707.810100,0,26870,21172,48042
2016-01-13,NASDAQ BX (B),110918188,63802233,57779595,232500016,3393157380.164603,2778892621.859100,2285292844.903304,8457342846.927007,948010,278598,512025,1738633
2016-01-13,NSX (C),88039,1900,19320,109259,2584533.518700,71963.000000,1106229.380000,3762725.898700,544,17,193,754
2016-01-13,NYSE (DN),218053597,72905509,105981793,396940899,6768304760.734577,3333695087.795802,4894357859.554557,14996357708.084936,851969,181622,417111,1450702
2016-01-13,NASDAQ (DQ),1526629183,660496442,864817869,3051943494,41403119243.443589,32043919029.837669,30700945492.043745,104147983765.325003,5127794,1351773,2591507,9071074
2016-01-13,EDGA (J),126525606,83507194,59302603,269335403,3235134871.152211,3784077683.159301,1886978420.321169,8906190974.632681,1013599,381160,475384,1870143
2016-01-13,EDGX (K),310188668,209468373,246412328,766069369,9210886476.743889,11354692791.409003,9075444297.022662,29641023565.175554,2199305,849309,1616994,4665608
2016-01-13,CHX (M),11881857,25926964,7196965,45005786,385722325.432100,3082679636.209999,493872393.529500,3962274355.171599,786,13910,4156,18852
2016-01-13,NYSE (N),1185605807,0,0,1185605807,38047088543.631954,0.000000,0.000000,38047088543.631954,4339580,0,0,4339580
2016-01-13,NYSE Arca (P),373710467,487312606,274612299,1135635372,12198939078.366392,26233222110.025263,11603889600.977309,50036050789.368964,2764851,1566409,2028357,6359617
2016-01-13,NASDAQ (Q),658426185,259617845,612902943,1530946973,24089345903.516047,15437166899.824084,25732917584.363710,65259430387.703841,5592184,1159215,4052344,10803743
2016-01-13,NASDAQ PSX (X),40520829,31086084,30764881,102371794,1194233154.852899,1867743919.349699,1144145480.007100,4206122554.209698,295028,131837,199441,626306
2016-01-13,BATS BYX (Y),204130315,129317419,97118471,430566205,5548792472.336408,4795922069.757882,3296413583.796867,13641128125.891157,1720806,555727,844338,3120871
2016-01-13,BATS BZX (Z),326187750,199427234,178782560,704397544,9897628331.621008,12280470433.614633,7259128002.522299,29437226767.757940,2700553,893355,1470748,5064656
2016-01-12,NYSE MKT (A),0,10387067,3631470,14018537,0.000000,73850935.279500,94291576.375000,168142511.654500,0,24928,22243,47171
2016-01-12,NASDAQ BX (B),100711448,52219468,49566468,202497384,2947650224.320994,2101702007.856398,1900496306.009888,6949848538.187280,851162,223140,443946,1518248
2016-01-12,NSX (C),99300,8755,42756,150811,4562038.900000,386409.850000,2789170.840000,7737619.590000,723,74,393,1190
2016-01-12,NYSE (DN),213982191,67956196,88548262,370486649,6096481151.463707,2680644850.165996,3740146467.399295,12517272469.028998,787050,164581,350306,1301937
2016-01-12,NASDAQ (DQ),1540454488,647942861,727868467,2916265816,38426336789.458895,27665416042.031298,24561139895.182670,90652892726.672863,4965070,1208424,2300285,8473779
2016-01-12,EDGA (J),119302434,73164258,52200364,244667056,3011437424.835580,2826002845.464992,1756408775.950496,7593849046.251068,957209,318350,437627,1713186
2016-01-12,EDGX (K),287820351,187851136,215783584,691455071,7984803503.555112,9116481491.005132,7768801554.164043,24870086548.724287,1951588,724088,1398566,4074242
2016-01-12,CHX (M),16460374,22778115,5479692,44718181,550911272.306000,2204969176.270000,329712939.156000,3085593387.732000,752,9589,3049,13390
2016-01-12,NYSE (N),1134361622,0,0,1134361622,34912568462.827952,0.000000,0.000000,34912568462.827952,3987526,0,0,3987526
2016-01-12,NYSE Arca (P),344336843,428001722,218150194,990488759,10727640680.068712,21754025799.346367,9142501853.885832,41624168333.300911,2471417,1338352,1674420,5484189
2016-01-12,NASDAQ (Q),593509224,218532197,531805882,1343847303,20896124886.255181,12269461859.467537,21501841952.500610,54667428698.223328,4962798,959859,3512126,9434783
2016-01-12,NASDAQ PSX (X),35043977,24201708,24485825,83731510,975715384.914602,1324631436.020000,873170062.002499,3173516882.937101,258647,97738,167668,524053
2016-01-12,BATS BYX (Y),203803717,112212029,86282091,402297837,5367930298.371059,3815558058.486200,2920213848.326923,12103702205.184182,1710855,476876,793984,2981715
2016-01-12,BATS BZX (Z),302537028,167784876,146952028,617273932,8765766175.568658,10340484408.625831,5733594050.432408,24839844634.626897,2444240,732634,1268158,4445032
2016-01-11,NYSE MKT (A),0,11272558,3498742,14771300,0.000000,46902626.535500,95203763.055000,142106389.590500,0,25982,20564,46546
2016-01-11,NASDAQ BX (B),101948086,57545183,56492817,215986086,3036499188.963110,2362323070.259099,2038190406.676188,7437012665.898397,862051,256939,486688,1605678
2016-01-11,NSX (C),57043,2204,38677,97924,2034395.010000,295391.190000,2231698.300000,4561484.500000,398,18,338,754
2016-01-11,NYSE (DN),189477232,72088209,105960824,367526265,6296451247.954094,3074653618.548804,4316497493.967029,13687602360.469927,723656,180891,396050,1300597
2016-01-11,NASDAQ (DQ),1380937152,657865417,790697675,2829500244,39665799767.069477,28375390312.494438,25814244136.846701,93855434216.410616,4871092,1319234,2547697,8738023
2016-01-11,EDGA (J),114213323,78029883,61760636,254003842,3139582439.715801,3343038910.326906,1956373042.271201,8438994392.313908,958219,353156,488176,1799551
2016-01-11,EDGX (K),278186702,199189619,245944367,723320688,8531065144.933516,10148451923.888186,8177884672.486161,26857401741.307863,1974226,791464,1506509,4272199
2016-01-11,CHX (M),11163286,18128589,4790287,34082162,381187123.127400,1828106656.114499,293244703.816500,2502538483.058399,832,10255,2538,13625
2016-01-11,NYSE (N),1078704216,0,0,1078704216,35439744454.682202,0.000000,0.000000,35439744454.682202,3930112,0,0,3930112
2016-01-11,NYSE Arca (P),349615468,441401061,265318758,1056335287,12036741203.782703,25255778469.937453,10142790633.292879,47435310307.013035,2622817,1398193,1911516,5932526
2016-01-11,NASDAQ (Q),587115222,224454990,566681390,1378251602,22657804945.279814,13176725209.442273,21986128264.164454,57820658418.886541,5104245,1014549,3726748,9845542
2016-01-11,NASDAQ PSX (X),34448872,24280826,30862348,89592046,1063608868.340402,1309387581.815500,1013377174.926803,3386373625.082705,266638,111785,193201,571624
2016-01-11,BATS BYX (Y),195081804,110025641,94263042,399370487,5324739787.530602,4176060827.845294,3041100108.672843,12541900724.048739,1653829,512443,831137,2997409
2016-01-11,BATS BZX (Z),291695506,178202657,168583668,638481831,9216973250.836525,11244350973.809165,6224376482.585886,26685700707.231576,2424675,807907,1378415,4610997
2016-01-08,NYSE MKT (A),0,8774620,4833590,13608210,0.000000,46972472.298600,106218476.847000,153190949.145600,0,21413,18685,40098
2016-01-08,NASDAQ BX (B),110776847,55584063,59154385,225515295,3530941755.382014,2424117858.672596,2188046714.990915,8143106329.045525,948544,247071,514109,1709724
2016-01-08,NSX (C),100,100,50,250,9386.000000,1306.000000,33.985000,10725.985000,1,1,1,3
2016-01-08,NYSE (DN),197341778,66707011,95727910,359776699,6199014624.942810,2898758248.634504,4178406060.085140,13276178933.662454,741556,170987,376686,1289229
2016-01-08,NASDAQ (DQ),1451482314,658875520,760923322,2871281156,40788754420.796357,33656853632.019220,27811262524.805239,102256870577.620816,4797982,1264698,2477804,8540484
2016-01-08,EDGA (J),114240864,69486086,56435039,240161989,3184459309.057412,3121323214.065607,1846607728.933309,8152390252.056328,947004,315443,456428,1718875
2016-01-08,EDGX (K),270925104,180845331,223307031,675077466,8185940369.288290,9925053768.072070,8569801936.681305,26680796074.041665,1874201,730464,1447122,4051787
2016-01-08,CHX (M),16256612,23531944,9915462,49704018,563519957.696000,2455144672.175000,736547245.228000,3755211875.099000,1487,10084,3366,14937
2016-01-08,NYSE (N),1116783365,0,0,1116783365,36662237360.305414,0.000000,0.000000,36662237360.305414,3692822,0,0,3692822
2016-01-08,NYSE Arca (P),336974890,417650866,234163139,988788895,11283566551.359549,23661902832.676255,10024655744.612962,44970125128.648766,2449936,1308578,1749439,5507953
2016-01-08,NASDAQ (Q),562391754,219447787,575350420,1357189961,21519358116.862373,14036755935.083449,23806708152.564493,59362822204.510315,4795609,953558,3581206,9330373
2016-01-08,NASDAQ PSX (X),33785373,24057183,26162062,84004618,1031343698.277103,1384890236.647999,1000577944.052402,3416811878.977504,260934,103728,183230,547892
2016-01-08,BATS BYX (Y),184110491,103574549,88794874,376479914,4995620854.339425,3960780884.913390,2927016590.322620,11883418329.575435,1524944,456318,784527,2765789
2016-01-08,BATS BZX (Z),279570098,166706933,157044014,603321045,8912924726.247454,10474334488.284664,6398027414.661296,25785286629.193414,2307777,730658,1305736,4344171
2016-01-07,NYSE MKT (A),0,11659893,4046375,15706268,0.000000,60324655.573800,127601100.626000,187925756.199800,0,25206,17911,43117
2016-01-07,NASDAQ BX (B),117275851,60263206,62902367,240441424,3879071122.461113,2441780229.107704,2547169864.821389,8868021216.390206,999823,262529,554353,1816705
2016-01-07,NSX (C),33050,1900,500,35450,631807.077500,24893.000000,586.000000,657286.077500,16,5,5,26
2016-01-07,NYSE (DN),227354462,78697817,112353364,418405643,7780497323.189959,3368412857.606109,5228012367.947628,16376922548.743696,836543,200396,423756,1460695
2016-01-07,NASDAQ (DQ),1579102537,759983335,852792946,3191878818,46334943413.419638,35095363609.138876,31941790796.725115,113372097819.283629,5309604,1487179,2840339,9637122
2016-01-07,EDGA (J),124815311,78796450,60388419,264000180,3590029303.733899,3469897427.625917,2139377061.330563,9199303792.690379,1032406,354756,492649,1879811
2016-01-07,EDGX (K),314082623,207246779,258077340,779406742,9673477964.126278,10634147669.813790,9743856312.810683,30051481946.750751,2101620,828845,1626814,4557279
2016-01-07,CHX (M),13422058,22035892,6689798,42147748,421134584.582300,2104515241.920498,472486259.361600,2998136085.864398,747,10422,3518,14687
2016-01-07,NYSE (N),1171996946,0,0,1171996946,39481980119.236646,0.000000,0.000000,39481980119.236646,3949133,0,0,3949133
2016-01-07,NYSE Arca (P),363581857,495993021,274157284,1133732162,12489706208.036857,26831722275.261438,11786951343.423843,51108379826.722138,2623466,1476272,1991982,6091720
2016-01-07,NASDAQ (Q),626070103,234306568,628529291,1488905962,24991988411.116773,14216185438.606079,27144349327.441669,66352523177.164521,5351437,1024747,3989935,10366119
2016-01-07,NASDAQ PSX (X),36417130,27885726,30063330,94366186,1156239616.041000,1459916737.403899,1147745688.216700,3763902041.661599,277667,111460,205332,594459
2016-01-07,BATS BYX (Y),199708057,117755463,96579854,414043374,5699425054.400476,4283360564.636600,3329754962.531164,13312540581.568240,1672179,512604,845595,3030378
2016-01-07,BATS BZX (Z),309688520,185768644,172350087,667807251,10169444836.368958,11917692595.528479,6950879249.772150,29038016681.669587,2541789,806455,1435301,4783545
2016-01-06,NYSE MKT (A),0,9648882,2874778,12523660,0.000000,56075794.772900,79351881.821300,135427676.594200,0,22765,13346,36111
2016-01-06,NASDAQ BX (B),98812589,44706219,54006277,197525085,3405815026.340417,1871230617.528799,2189994892.681988,7467040536.551204,877324,195019,478334,1550677
2016-01-06,NSX (C),25,500,200,725,20.270000,6569.000000,566.000000,7155.270000,1,6,2,9
2016-01-06,NYSE (DN),180235205,56542089,91281594,328058888,6459840733.063830,2325229933.314801,4130961996.460110,12916032662.838741,714143,149281,351094,1214518
2016-01-06,NASDAQ (DQ),1356921619,592233663,744391491,2693546773,42890341579.286205,25333498985.232434,27089908866.765783,95313749431.284422,4464842,1118843,2330528,7914213
2016-01-06,EDGA (J),108383102,61812587,52267655,222463344,3229889326.579499,2653257638.261600,1734705612.178297,7617852577.019396,908186,273992,423406,1605584
2016-01-06,EDGX (K),257647278,165212614,219050282,641910174,8150578355.616011,7863990623.362199,7998507459.023503,24013076438.001713,1780799,629953,1367600,3778352
2016-01-06,CHX (M),14601692,21022245,7118236,42742173,467483375.962100,1955149833.668001,402430813.203000,2825064022.833101,786,8816,2464,12066
2016-01-06,NYSE (N),1053991775,0,0,1053991775,36784261679.276685,0.000000,0.000000,36784261679.276685,3404282,0,0,3404282
2016-01-06,NYSE Arca (P),305755629,375913652,220943365,902612646,11223239019.445162,20123570205.340724,9471181984.680638,40817991209.466524,2320615,1113512,1653950,5088077
2016-01-06,NASDAQ (Q),494800020,168969546,528972881,1192742447,19948605696.495456,9677206553.484699,22386641266.025021,52012453516.005176,4315015,721222,3142870,8179107
2016-01-06,NASDAQ PSX (X),30845221,20652561,23797101,75294883,992190457.320700,1070678605.728900,904527876.101198,2967396939.150798,232726,82566,165038,480330
2016-01-06,BATS BYX (Y),176076627,86418157,85905986,348400770,5288670166.919727,3156110956.022702,2974075446.062174,11418856569.004603,1550678,377055,774948,2702681
2016-01-06,BATS BZX (Z),263703702,141125242,141997107,546826051,8908469983.646958,9037922410.272819,5787755201.003800,23734147594.923577,2243674,618072,1200538,4062284
2016-01-05,NYSE MKT (A),0,7221558,2880820,10102378,0.000000,61126796.025800,78954580.592700,140081376.618500,0,19893,15667,35560
2016-01-05,NASDAQ BX (B),95799515,35267981,50795066,181862562,3218573145.993976,1566315010.966800,2090707141.614097,6875595298.574873,855482,171847,449859,1477188
2016-01-05,NSX (C),0,2600,508,3108,0.000000,34523.000000,22895.440000,57418.440000,0,11,4,15
2016-01-05,NYSE (DN),137664470,43583037,81681810,262929317,4811457606.222388,1852345804.769097,3531088835.297007,10194892246.288492,570012,116741,306109,992862
2016-01-05,NASDAQ (DQ),1132229614,473552961,672702963,2278485538,35652190843.681307,21489333262.091281,23780439564.634163,80921963670.406751,4080618,902797,2103946,7087361
2016-01-05,EDGA (J),92469819,48855578,48358568,189683965,2836720357.416897,2124692530.923300,1675654261.547907,6637067149.888104,791200,224623,383512,1399335
2016-01-05,EDGX (K),230728032,125665892,196323257,552717181,7216091647.318998,6209531150.071223,6912460468.651369,20338083266.041590,1620425,513263,1222177,3355865
2016-01-05,CHX (M),9310759,13787085,9020863,32118707,430738536.768200,1279690594.299999,437599191.757000,2148028322.825199,747,6421,1822,8990
2016-01-05,NYSE (N),864177441,0,0,864177441,30561097320.960375,0.000000,0.000000,30561097320.960375,3194970,0,0,3194970
2016-01-05,NYSE Arca (P),268123549,295105568,198783969,762013086,9602515557.949785,16288170834.293797,8636217517.406001,34526903909.649583,2062354,919033,1478751,4460138
2016-01-05,NASDAQ (Q),485454438,143740795,452274701,1081469934,19340160298.462919,8466481913.810514,19519830859.999399,47326473072.272832,4237665,655167,2916799,7809631
2016-01-05,NASDAQ PSX (X),28736714,16821473,21708930,67267117,934129898.957799,915285351.275500,817788537.013899,2667203787.247198,229373,71738,152249,453360
2016-01-05,BATS BYX (Y),145036567,73553731,76806452,295396750,4310947922.850909,2851820098.693598,2646219374.985730,9808987396.530237,1280038,333544,680334,2293916
2016-01-05,BATS BZX (Z),224193523,109494371,120526475,454214369,7545157627.340746,6861993441.416606,4963731203.092073,19370882271.849425,1947592,500682,1027542,3475816
2016-01-04,NYSE MKT (A),0,9340644,3740576,13081220,0.000000,62343346.565300,107152244.955000,169495591.520300,0,25148,18452,43600
2016-01-04,NASDAQ BX (B),114658667,51195705,59634376,225488748,4032011182.462009,2300553224.784202,2618270628.762900,8950835036.009111,1032139,231637,540830,1804606
2016-01-04,NSX (C),39292,5004,2496,46792,12190.246000,65806.600000,12318.670500,90315.516500,41,16,4,61
2016-01-04,NYSE (DN),154221496,59677874,83208230,297107600,5383644980.968832,2918105051.619208,4063351795.023173,12365101827.611213,625017,176393,346641,1148051
2016-01-04,NASDAQ (DQ),1218209541,679452720,694592536,2592254797,39356896315.329411,41580887258.265408,28150131733.408535,109087915307.003354,4558188,1358579,2432060,8348827
2016-01-04,EDGA (J),105158524,66113413,56035430,227307367,3301168160.568405,3037836760.903209,2263893643.418100,8602898564.889714,920450,313097,483163,1716710
2016-01-04,EDGX (K),260394561,173430666,223480979,657306206,8303772183.804492,9079394924.868113,8840770021.243245,26223937129.915850,1842072,717757,1430563,3990392
2016-01-04,CHX (M),11597580,23700360,16554066,51852006,442994906.252100,3367382432.099994,1516437034.714601,5326814373.066695,808,12370,5948,19126
2016-01-04,NYSE (N),1113944254,0,0,1113944254,39956076520.215363,0.000000,0.000000,39956076520.215363,3823322,0,0,3823322
2016-01-04,NYSE Arca (P),306408530,440782166,229268520,976459216,11135659183.823215,26024239852.779840,10654556369.478633,47814455406.081688,2379294,1277644,1781843,5438781
2016-01-04,NASDAQ (Q),574337575,200428581,604031244,1378797400,22990863616.570458,12250708774.334909,28502154531.830002,63743726922.735369,5139660,902428,3773507,9815595
2016-01-04,NASDAQ PSX (X),32645074,23986495,26172861,82804430,1118496833.041200,1286878545.747001,1005803027.085301,3411178405.873502,266688,104180,186962,557830
2016-01-04,BATS BYX (Y),168077075,97094488,87427558,352599121,4999098587.626098,3896814651.991995,3287945591.533772,12183858831.151865,1495201,432928,829088,2757217
2016-01-04,BATS BZX (Z),256154254,157028891,139760041,552943186,8920148082.416250,10915149043.841215,6051645413.214608,25886942539.472073,2238940,695404,1206370,4140714
