Day,Market Participant,Tape A Shares,Tape B Shares,Tape C Shares,Total Shares,Tape A Notional,Tape B Notional,Tape C Notional,Total Notional,Tape A Trade Count,Tape B Trade Count,Tape C Trade Count,Total Trade Count
2012-12-31,NYSE MKT (A),0,11306985,4606958,15913943,0.000000,80179155.263100,58568822.183100,138747977.446200,0,24654,18988,43642
2012-12-31,NASDAQ BX (B),83942493,40680702,44171312,168794507,2162055745.864997,2324885281.795001,1343379924.161801,5830320951.821799,528961,145300,277731,951992
2012-12-31,NSX (C),9905653,5249149,5865345,21020147,219881456.916800,195289679.312300,126751327.964700,541922464.193800,26319,8790,16616,51725
2012-12-31,NYSE (DN),77974385,21045998,40316439,139336822,2288006691.519582,1269640346.202602,1390736381.421495,4948383419.143679,532981,101739,260230,894950
2012-12-31,NASDAQ (DQ),915479261,414130009,493499167,1823108437,23776502616.042792,22434671705.665893,15384197039.487559,61595371361.196244,2657530,692219,1285002,4634751
2012-12-31,EDGA (J),65183720,46577616,31997982,143759318,1579048116.885699,2659800300.268101,818728339.563499,5057576756.717299,378806,165872,180421,725099
2012-12-31,EDGX (K),228369396,107019628,150184271,485573295,6138065709.601709,5641531855.015998,5215620910.185037,16995218474.802744,968455,295023,578634,1842112
2012-12-31,CHX (M),4144048,9596705,3505091,17245844,124022120.985400,950772458.745900,124729737.439200,1199524317.170500,340,1501,1350,3191
2012-12-31,NYSE (N),731742108,0,0,731742108,23368039590.454715,0.000000,0.000000,23368039590.454715,1923125,0,0,1923125
2012-12-31,NYSE Arca (P),355380470,260782966,170359756,786523192,10764471676.047131,16697921639.885634,6204624974.223187,33667018290.155952,1965428,636341,855500,3457269
2012-12-31,NASDAQ (Q),354963742,204011763,392735739,951711244,11645172076.927525,14440405248.086210,12720779378.936499,38806356703.950234,2234735,619578,1668236,4522549
2012-12-31,CBSX (W),10610696,6037080,5647730,22295506,269105853.780000,319941066.740000,113423104.390000,702470024.910000,76693,11083,38691,126467
2012-12-31,NASDAQ PSX (X),17693360,18702181,15102742,51498283,408152477.270000,1252944195.600000,391780874.505000,2052877547.375000,77959,42721,47169,167849
2012-12-31,BATS BYX (Y),107130639,34908407,48927666,190966712,2781213626.758602,1922982922.200400,1295800705.394100,5999997254.353102,735214,135793,326125,1197132
2012-12-31,BATS BZX (Z),242594993,168981136,152466200,564042329,7287265404.623582,11585171801.854471,4777741285.527309,23650178492.005362,1501242,537661,838209,2877112
2012-12-28,NYSE MKT (A),0,9198589,4439830,13638419,0.000000,60870750.000600,59128053.183000,119998803.183600,0,20260,18830,39090
2012-12-28,NASDAQ BX (B),68811727,28318279,33557150,130687156,1728330441.429999,1568410370.974999,945680417.111800,4242421229.516798,433662,98042,219609,751313
2012-12-28,NSX (C),6685484,3157177,4315991,14158652,147805868.305600,108656658.626900,79937673.316000,336400200.248500,20262,6077,14621,40960
2012-12-28,NYSE (DN),67958726,14955528,30663909,113578163,1978190505.124088,770793445.027602,939640859.345096,3688624809.496786,439993,74625,199798,714416
2012-12-28,NASDAQ (DQ),709102598,276293923,369282954,1354679475,18144216035.442129,14579267870.713631,9693345286.207623,42416829192.363383,2170412,478857,1026129,3675398
2012-12-28,EDGA (J),54698265,31993409,26069827,112761501,1291190361.721899,1668755280.249800,647063480.645600,3607009122.617299,315099,116033,153512,584644
2012-12-28,EDGX (K),167756344,69511603,111990174,349258121,4608702579.465407,3404194730.387197,3236252581.375319,11249149891.227923,768276,194131,434819,1397226
2012-12-28,CHX (M),15330393,5394032,8093366,28817791,388321107.422200,356432464.773000,375502703.537200,1120256275.732400,361,1818,906,3085
2012-12-28,NYSE (N),535491713,0,0,535491713,16433469231.642570,0.000000,0.000000,16433469231.642570,1494221,0,0,1494221
2012-12-28,NYSE Arca (P),257967443,186821289,125607199,570395931,7685536960.583376,11644768564.083392,4383721284.301815,23714026808.968583,1417094,441300,645362,2503756
2012-12-28,NASDAQ (Q),251415142,122215716,269977247,643608105,8140373500.124559,8457433558.962702,8199858723.442808,24797665782.530069,1563183,381397,1207192,3151772
2012-12-28,CBSX (W),10285768,3898863,6955683,21140314,272677873.280000,223647731.400000,126798177.630000,623123782.310000,71378,10132,40380,121890
2012-12-28,NASDAQ PSX (X),12692364,12002176,12012434,36706974,259356672.340000,713684479.840000,276658217.820000,1249699370.000000,53542,25096,35413,114051
2012-12-28,BATS BYX (Y),85967256,23145510,37436084,146548850,2149156664.329999,1228966516.225700,940467825.034500,4318591005.590199,572899,93927,250059,916885
2012-12-28,BATS BZX (Z),183432864,118130751,110551276,412114891,5185932841.036702,7841888270.645924,3303028632.083302,16330849743.765928,1098448,367944,619100,2085492
2012-12-27,NYSE MKT (A),0,9380086,5404040,14784126,0.000000,56153831.244500,80178806.929000,136332638.173500,0,22103,21911,44014
2012-12-27,NASDAQ BX (B),82335839,35081019,41429694,158846552,2038478823.825001,1851315573.275499,1274659543.668603,5164453940.769103,523496,114810,272420,910726
2012-12-27,NSX (C),8340975,3876335,4768430,16985740,179776518.256900,169249817.396300,101971042.898500,450997378.551700,23927,7534,16303,47764
2012-12-27,NYSE (DN),79393392,17573445,37499445,134466282,2284025433.153781,892630983.386501,1291587252.879994,4468243669.420276,523517,81978,237587,843082
2012-12-27,NASDAQ (DQ),828683484,304697493,431478055,1564859032,21660180701.323888,15542350046.203079,12745075823.365652,49947606570.892619,2533058,536561,1226076,4295695
2012-12-27,EDGA (J),64063743,36577356,29847587,130488686,1474531866.883099,1797215237.563600,764005598.273900,4035752702.720599,367198,119031,178550,664779
2012-12-27,EDGX (K),209155239,78296848,129997493,417449580,5607092376.128489,3821873703.537999,4246572888.566895,13675538968.233383,931531,226222,537976,1695729
2012-12-27,CHX (M),6002836,4117708,3779802,13900346,199946507.816000,308533939.387300,115764631.119500,624245078.322800,287,1250,1205,2742
2012-12-27,NYSE (N),566725390,0,0,566725390,17514486594.108446,0.000000,0.000000,17514486594.108446,1744745,0,0,1744745
2012-12-27,NYSE Arca (P),316483483,195270414,157403589,669157486,9307932206.814113,12037788208.194176,5456706963.383131,26802427378.391420,1696253,487783,806355,2990391
2012-12-27,NASDAQ (Q),308361263,142980974,298170993,749513230,9758864178.864004,9823562632.275801,9427698123.594474,29010124934.734279,1901824,467675,1439331,3808830
2012-12-27,CBSX (W),11625744,6227543,6657437,24510724,292066099.950000,282240742.790000,136850144.910000,711156987.650000,79538,13199,42823,135560
2012-12-27,NASDAQ PSX (X),14536259,14792922,13403015,42732196,305770782.440000,925965322.925000,339662502.563000,1571398607.928000,64342,31107,41988,137437
2012-12-27,BATS BYX (Y),101273374,27735098,46607266,175615738,2520969934.773999,1412358756.699999,1202008087.206200,5135336778.680198,674822,108642,312080,1095544
2012-12-27,BATS BZX (Z),236206492,138956112,144357487,519520091,6678615147.536998,9094862991.344513,4310104161.870612,20083582300.752123,1379138,437447,790055,2606640
2012-12-26,NYSE MKT (A),0,7436379,4006605,11442984,0.000000,45733547.922400,54322362.537000,100055910.459400,0,17905,20418,38323
2012-12-26,NASDAQ BX (B),59977945,19735819,29915949,109629713,1487192619.802601,1066981304.975001,903391079.040200,3457565003.817802,373979,67526,196681,638186
2012-12-26,NSX (C),7310264,2612032,3928130,13850426,147072489.815800,95815099.946200,89385260.667400,332272850.429400,19942,4862,12537,37341
2012-12-26,NYSE (DN),60808711,10657541,28520265,99986517,1737258013.988799,591138545.974800,889401750.789201,3217798310.752800,407210,51389,186194,644793
2012-12-26,NASDAQ (DQ),715949848,232145826,353784695,1301880369,18193695967.849754,12699684787.104945,9613560750.447731,40506941505.402430,2139464,372458,1025878,3537800
2012-12-26,EDGA (J),52384969,22487210,25424783,100296962,1173002972.431398,1105045128.642000,594547028.828401,2872595129.901799,285893,74666,142695,503254
2012-12-26,EDGX (K),159874664,50664041,104868270,315406975,4337550323.339199,2356822714.289397,3328122734.136397,10022495771.764993,721356,133654,420026,1275036
2012-12-26,CHX (M),14634884,5951137,1459473,22045494,614009136.155000,334050355.263000,93844651.835000,1041904143.253000,253,804,974,2031
2012-12-26,NYSE (N),475592048,0,0,475592048,14644750462.914760,0.000000,0.000000,14644750462.914760,1385058,0,0,1385058
2012-12-26,NYSE Arca (P),236907054,144427096,113107630,494441780,6919369304.039787,8708787554.162025,3671563574.348605,19299720432.550417,1257388,306242,584136,2147766
2012-12-26,NASDAQ (Q),228779214,78447431,235116781,542343426,7181795426.420886,5092697152.207096,7344004120.082839,19618496698.710821,1375073,247545,1085272,2707890
2012-12-26,CBSX (W),9953961,3071321,7584387,20609669,246072879.790000,131158879.790000,112819753.090000,490051512.670000,67316,10151,39918,117385
2012-12-26,NASDAQ PSX (X),10753780,7279187,9327580,27360547,239335605.105000,430713887.720000,217040816.940000,887090309.765000,47202,17419,29748,94369
2012-12-26,BATS BYX (Y),75183800,16534574,33835622,125553996,1892418034.549997,830927673.239999,821097060.550801,3544442768.340797,503136,65714,231789,800639
2012-12-26,BATS BZX (Z),177612415,80866648,110289093,368768156,5045774557.311387,4988318454.423499,3078969613.428002,13113062625.162888,1070501,249181,618705,1938387
2012-12-24,NYSE MKT (A),0,6681606,2798402,9480008,0.000000,36641124.122700,37764080.215000,74405204.337700,0,13473,13110,26583
2012-12-24,NASDAQ BX (B),34674098,11113126,16207432,61994656,849047087.035300,554715528.851900,481911595.889400,1885674211.776600,218921,39019,107766,365706
2012-12-24,NSX (C),3862610,1330891,2087681,7281182,78274358.187800,44345753.980400,46838180.122100,169458292.290300,11691,2605,6782,21078
2012-12-24,NYSE (DN),35395813,6503584,15862661,57762058,1000254206.951201,321415866.420300,482909843.332198,1804579916.703699,231559,31845,100956,364360
2012-12-24,NASDAQ (DQ),396380809,145718954,207810466,749910229,10379753152.409718,7291488623.850072,5628155178.062733,23299396954.322523,1212389,231889,591770,2036048
2012-12-24,EDGA (J),27487463,12179223,12305051,51971737,584232115.133400,575955262.319500,278200684.230200,1438388061.683100,141334,37321,71520,250175
2012-12-24,EDGX (K),87976465,31379170,63578853,182934488,2422750429.048694,1386989898.109900,1852818395.468090,5662558722.626684,398856,81743,235214,715813
2012-12-24,CHX (M),2665031,1291937,677963,4634931,87466399.319000,107240282.400000,31280146.413700,225986828.132700,127,603,512,1242
2012-12-24,NYSE (N),286482559,0,0,286482559,8948102631.084120,0.000000,0.000000,8948102631.084120,789453,0,0,789453
2012-12-24,NYSE Arca (P),125183397,85945419,60284694,271413510,3749758881.889408,5037468814.325908,2084323296.113802,10871550992.329118,691552,186677,324694,1202923
2012-12-24,NASDAQ (Q),113260177,42320539,152138631,307719347,3587947435.074405,2653325295.662401,4533549317.040513,10774822047.777319,702401,139508,637123,1479032
2012-12-24,CBSX (W),5526640,2148267,3172141,10847048,144534009.060000,105147497.660000,64232456.680000,313913963.400000,41498,5551,20942,67991
2012-12-24,NASDAQ PSX (X),5364017,4137101,5052719,14553837,115705849.390000,242450891.910000,111606062.815000,469762804.115000,25108,9970,17425,52503
2012-12-24,BATS BYX (Y),39020744,9336132,17363272,65720148,949800192.203800,465353119.503300,403478950.612500,1818632262.319600,255823,37466,117162,410451
2012-12-24,BATS BZX (Z),85852510,42113573,57902621,185868704,2496117567.797601,2500598152.107099,1581794654.694498,6578510374.599198,539184,133481,339331,1011996
2012-12-21,NYSE MKT (A),0,41291362,5990132,47281494,0.000000,264242917.586300,80619075.648000,344861993.234300,0,26775,21407,48182
2012-12-21,NASDAQ BX (B),100523434,35932487,53435059,189890980,2527390259.220003,2010160437.803001,1507767840.521103,6045318537.544107,626855,118511,327749,1073115
2012-12-21,NSX (C),9043746,4372281,5854204,19270231,215663071.257700,139658699.506100,124788982.315100,480110753.078900,30120,8014,18291,56425
2012-12-21,NYSE (DN),107446588,20897147,51658011,180001746,3305667614.589690,1149636883.004802,1560688237.649008,6015992735.243500,692875,92736,331161,1116772
2012-12-21,NASDAQ (DQ),1542932893,393174351,952110343,2888217587,44634590140.269710,21845483843.075417,25188125725.132477,91668199708.477604,3427364,585961,1690269,5703594
2012-12-21,EDGA (J),84523639,41384823,42325598,168234060,2010101109.077700,2131700622.901499,1061921409.060800,5203723141.039999,471497,134119,238169,843785
2012-12-21,EDGX (K),268548897,85672940,179967941,534189778,7946547045.449465,4255548767.641200,5120806569.026297,17322902382.116962,1251822,244015,701812,2197649
2012-12-21,CHX (M),10506948,13268098,5058304,28833350,386215307.435000,1081039607.686000,120905068.851600,1588159983.972600,254,1199,1604,3057
2012-12-21,NYSE (N),1883790810,0,0,1883790810,62522866421.200924,0.000000,0.000000,62522866421.200924,2151567,0,0,2151567
2012-12-21,NYSE Arca (P),392572440,299298444,191759678,883630562,12031821213.077086,20777276125.283163,6942240876.453268,39751338214.813517,2041178,559440,931189,3531807
2012-12-21,NASDAQ (Q),394571088,164741614,1108186703,1667499405,12817924663.324320,11771738874.743307,32662847288.921003,57252510826.988630,2275091,497465,1891465,4664021
2012-12-21,CBSX (W),16044750,4478055,8180384,28703189,447523892.440000,215009271.690000,198621226.200000,861154390.330000,106045,13389,50222,169656
2012-12-21,NASDAQ PSX (X),17959511,17710631,16975482,52645624,419251733.030000,1276357392.410000,419743878.935000,2115353004.375000,83333,34059,52298,169690
2012-12-21,BATS BYX (Y),120877777,30480656,60685313,212043746,3139386193.717995,1705637230.472400,1451611827.789301,6296635251.979696,805037,118010,384535,1307582
2012-12-21,BATS BZX (Z),291812506,146377522,186130420,624320448,8518757101.857517,9877251234.055107,5364490493.907019,23760498829.819643,1725066,455686,997048,3177800
2012-12-20,NYSE MKT (A),0,11474276,5511315,16985591,0.000000,75368649.822300,80134019.025000,155502668.847300,0,24052,21807,45859
2012-12-20,NASDAQ BX (B),93583803,29562632,47834417,170980852,2458956707.820000,1495405131.109800,1415369200.435898,5369731039.365698,586958,93551,302040,982549
2012-12-20,NSX (C),8775383,5049495,4572746,18397624,211672861.959200,100248480.066600,135318432.756000,447239774.781800,29934,8284,17135,55353
2012-12-20,NYSE (DN),116166058,21608017,55984263,193758338,3626548225.328489,1136581428.494999,1697697867.194994,6460827521.018482,739405,92636,341655,1173696
2012-12-20,NASDAQ (DQ),1230533147,397022785,560944828,2188500760,33095439100.158742,22823104263.250716,15686354553.517481,71604897916.926939,3258091,540070,1522740,5320901
2012-12-20,EDGA (J),81097065,36084986,39320890,156502941,2038745457.233999,1805327624.296199,1023330933.613001,4867404015.143199,472589,112241,225217,810047
2012-12-20,EDGX (K),271865357,82179271,169198624,523243252,8084487769.123804,3525419376.467410,5034566651.062198,16644473796.653412,1241017,208145,674399,2123561
2012-12-20,CHX (M),14273198,10796791,8300034,33370023,416587638.883300,843830169.220000,665522549.154200,1925940357.257500,451,2238,1377,4066
2012-12-20,NYSE (N),682601628,0,0,682601628,22289318998.725797,0.000000,0.000000,22289318998.725797,1953333,0,0,1953333
2012-12-20,NYSE Arca (P),373124550,217175718,188602200,778902468,11740740333.657595,13438836839.452999,6262968754.064531,31442545927.175125,1976742,452852,929348,3358942
2012-12-20,NASDAQ (Q),390998242,134174159,384693557,909865958,12919225823.852298,8398596485.632093,11948107205.586116,33265929515.070507,2265633,397100,1715271,4378004
2012-12-20,CBSX (W),13884056,4353455,7382023,25619534,393518507.730000,219039620.350000,168778705.800000,781336833.880000,97691,11889,50070,159650
2012-12-20,NASDAQ PSX (X),19233283,15299711,16728715,51261709,443658831.360000,774667953.625000,378961446.860000,1597288231.845000,86212,28104,50168,164484
2012-12-20,BATS BYX (Y),120369452,27327723,58515675,206212850,3260063962.316004,1395254894.720199,1482856727.030901,6138175584.067104,814391,103970,386900,1305261
2012-12-20,BATS BZX (Z),278388401,123487137,172112202,573987740,8198340887.321128,7835014681.326512,4880217639.311083,20913573207.958723,1658913,369589,956172,2984674
2012-12-19,NYSE MKT (A),0,10712406,8226521,18938927,0.000000,64928439.504500,98389403.962000,163317843.466500,0,22610,25235,47845
2012-12-19,NASDAQ BX (B),104250859,35365003,49814331,189430193,2618184707.958401,1648747884.012001,1485887141.252302,5752819733.222704,622499,103394,306429,1032322
2012-12-19,NSX (C),8641572,3941977,4878784,17462333,206019761.034800,108628364.799700,117538967.121100,432187092.955600,28938,6911,16139,51988
2012-12-19,NYSE (DN),121521317,22876814,59670139,204068270,3767440990.544686,1183841626.990909,1788960056.658392,6740242674.193987,712906,98861,335033,1146800
2012-12-19,NASDAQ (DQ),1276995545,377701500,704709680,2359406725,34711115176.831291,19502015654.126899,17888656672.829118,72101787503.787308,3436882,531884,1661023,5629789
2012-12-19,EDGA (J),80403673,41891390,42401386,164696449,1989014165.770303,1948898298.990801,1080749781.316600,5018662246.077704,455705,124237,230400,810342
2012-12-19,EDGX (K),263850123,76921874,187968780,528740777,7682425235.137300,3413118675.493295,5436842555.211197,16532386465.841792,1174243,196423,693140,2063806
2012-12-19,CHX (M),27685015,10440049,6472420,44597484,666700311.732400,838154125.285500,200742720.097500,1705597157.115400,330,1283,1471,3084
2012-12-19,NYSE (N),750951005,0,0,750951005,24040083876.473852,0.000000,0.000000,24040083876.473852,1907985,0,0,1907985
2012-12-19,NYSE Arca (P),383348020,219344096,194431097,797123213,11442967314.214363,12483630812.622281,6584765885.049791,30511364011.886435,1955692,446750,920778,3323220
2012-12-19,NASDAQ (Q),406843313,130548612,423547606,960939531,13107616692.737059,8290136151.508303,13396846298.372758,34794599142.618120,2296964,391708,1765431,4454103
2012-12-19,CBSX (W),18143029,5710991,9005910,32859930,514724970.140000,236274662.370000,206427109.820000,957426742.330000,120693,15262,57809,193764
2012-12-19,NASDAQ PSX (X),20709899,14503181,18684359,53897439,462217375.200000,748658511.610000,440727991.820000,1651603878.630000,88945,27862,54176,170983
2012-12-19,BATS BYX (Y),127404909,32295663,63385985,223086557,3294287583.005006,1558935912.931999,1505441292.714999,6358664788.652004,821806,110181,384238,1316225
2012-12-19,BATS BZX (Z),280713724,127601278,182691304,591006306,8090766932.199889,7947613469.555985,5193002822.480710,21231383224.236584,1619862,357863,968426,2946151
2012-12-18,NYSE MKT (A),0,13749436,7295053,21044489,0.000000,75356449.913700,95777120.611000,171133570.524700,0,26314,27488,53802
2012-12-18,NASDAQ BX (B),110068901,37342166,55579019,202990086,2803193879.815003,1940100794.666002,1656768633.100500,6400063307.581505,645188,115380,318111,1078679
2012-12-18,NSX (C),11611851,4986282,6061819,22659952,283090780.057000,152001810.301900,155390976.933100,590483567.292000,36150,9072,19776,64998
2012-12-18,NYSE (DN),125346714,27335538,60090002,212772254,3920310038.050426,1394029898.546206,1983738418.078505,7298078354.675137,758066,114810,333776,1206652
2012-12-18,NASDAQ (DQ),1504632303,430749295,712202389,2647583987,42773374619.305466,22321023343.974533,19688026440.745452,84782424404.025451,3675711,616760,1734193,6026664
2012-12-18,EDGA (J),87893171,44904350,46952670,179750191,2128278328.092700,2225780930.090804,1172764985.738903,5526824243.922407,476850,128183,239725,844758
2012-12-18,EDGX (K),291249485,93156461,204654882,589060828,8495311240.416181,4093150331.568101,6448977614.410487,19037439186.394769,1294987,235273,767125,2297385
2012-12-18,CHX (M),9482656,10450465,4963612,24896733,294690876.961900,904001120.300800,272262149.098900,1470954146.361600,373,2914,1470,4757
2012-12-18,NYSE (N),820577243,0,0,820577243,26297422453.242793,0.000000,0.000000,26297422453.242793,2035462,0,0,2035462
2012-12-18,NYSE Arca (P),417454523,253017051,205482123,875953697,12604480034.777493,15360221491.725215,7426375644.303665,35391077170.806373,2121792,519652,985532,3626976
2012-12-18,NASDAQ (Q),439260864,162783317,443251229,1045295410,14412365710.567542,11513526182.155914,14118773093.831575,40044664986.555031,2500051,499187,1874073,4873311
2012-12-18,CBSX (W),17167868,6481872,9168948,32818688,467081709.150000,287084117.530000,203561059.246900,957726885.926900,113861,15103,54494,183458
2012-12-18,NASDAQ PSX (X),26345724,16425612,23891757,66663093,597300488.045000,941527183.780000,512372547.060000,2051200218.885000,108174,34473,67198,209845
2012-12-18,BATS BYX (Y),135262270,32991235,66781066,235034571,3524491102.438999,1649337502.204200,1687480300.477401,6861308905.120600,858231,118382,398484,1375097
2012-12-18,BATS BZX (Z),309940084,150224906,197576950,657741940,9002963898.415834,9873124331.026583,5694081108.570399,24570169338.012816,1765851,431856,1006681,3204388
2012-12-17,NYSE MKT (A),0,10115568,6495140,16610708,0.000000,69871753.566900,80533629.004000,150405382.570900,0,24012,26105,50117
2012-12-17,NASDAQ BX (B),91288128,28411401,51772924,171472453,2349771513.730000,1479418570.320102,1488459725.481802,5317649809.531904,555948,89810,288602,934360
2012-12-17,NSX (C),9951647,3217584,6621704,19790935,219975213.879900,90263476.742500,151362021.610500,461600712.232900,30590,6665,20345,57600
2012-12-17,NYSE (DN),105439379,20506759,63678895,189625033,3208507525.160784,995905215.629804,1984666877.243603,6189079618.034191,637495,93797,306883,1038175
2012-12-17,NASDAQ (DQ),1094300580,316331647,654881997,2065514224,29793496589.440374,16229018842.854851,18595108277.101909,64617623709.397134,3200565,501879,1629482,5331926
2012-12-17,EDGA (J),72665458,35175062,44375531,152216051,1739698246.672599,1668949713.755299,1057058693.389499,4465706653.817397,402802,107106,211602,721510
2012-12-17,EDGX (K),240530897,69360420,180583113,490474430,6955633210.630103,3091814868.932597,5814209297.623318,15861657377.186018,1091236,173782,660018,1925036
2012-12-17,CHX (M),14462867,13006450,5644800,33114117,499124105.980400,757253976.016200,308714564.268700,1565092646.265300,267,1977,2835,5079
2012-12-17,NYSE (N),701923363,0,0,701923363,23283375660.574814,0.000000,0.000000,23283375660.574814,1780482,0,0,1780482
2012-12-17,NYSE Arca (P),344688987,193690222,196349864,734729073,10253385154.759088,11772716222.442778,6806957504.411600,28833058881.613466,1793213,389892,877069,3060174
2012-12-17,NASDAQ (Q),368192416,120100534,428172218,916465168,12091541676.562792,8482585164.336308,13760554526.031282,34334681366.930382,2145624,367688,1729407,4242719
2012-12-17,CBSX (W),15277076,4082700,8472501,27832277,413816237.770000,176017643.490000,175619644.056000,765453525.316000,102337,12034,49728,164099
2012-12-17,NASDAQ PSX (X),21745950,12713607,26225849,60685406,498075337.130000,693181219.660000,456225072.205000,1647481628.995000,92399,27899,63452,183750
2012-12-17,BATS BYX (Y),119329760,25294971,61524294,206149025,3065944365.865998,1250749543.919802,1446495094.076299,5763189003.862099,774706,95520,358292,1228518
2012-12-17,BATS BZX (Z),256832725,107940829,181824168,546597722,7280250685.099199,6718577663.284701,5001160347.360400,18999988695.744300,1492311,331252,905083,2728646
2012-12-14,NYSE MKT (A),0,8196051,5831115,14027166,0.000000,51155368.824700,84266428.785000,135421797.609700,0,20263,22679,42942
2012-12-14,NASDAQ BX (B),82163119,21781602,43872060,147816781,2006520441.775999,1128878670.331499,1462600730.369499,4597999842.476997,499564,75694,257941,833199
2012-12-14,NSX (C),7964692,2565538,6162039,16692269,181198760.045400,79054088.809100,146477739.561500,406730588.416000,27204,5676,18257,51137
2012-12-14,NYSE (DN),102010349,16149906,50467347,168627602,3033806795.833105,794433588.931200,1925904028.280500,5754144413.044805,612991,74094,265287,952372
2012-12-14,NASDAQ (DQ),1028423900,270933311,620922744,1920279955,27692112066.801366,14703219172.182959,19713550017.487720,62108881256.472045,2882608,411443,1544063,4838114
2012-12-14,EDGA (J),67752632,30945567,40212756,138910955,1721170611.585101,1397286406.218098,1153437601.554602,4271894619.357801,404103,99133,210094,713330
2012-12-14,EDGX (K),212528657,56799189,186266549,455594395,6249971051.077101,2598239212.546897,6045111156.420599,14893321420.044597,1029099,152882,668654,1850635
2012-12-14,CHX (M),16618859,8285969,14465141,39369969,360878418.144500,679973834.138800,576452308.597700,1617304560.881000,231,1923,405,2559
2012-12-14,NYSE (N),673920837,0,0,673920837,21140704801.038546,0.000000,0.000000,21140704801.038546,1709199,0,0,1709199
2012-12-14,NYSE Arca (P),313113735,150727122,193966796,657807653,9568698223.656401,9208675549.308999,7760849877.681871,26538223650.647271,1694224,341515,899455,2935194
2012-12-14,NASDAQ (Q),336779343,106168127,392460470,835407940,11020920404.775401,7765773616.780777,13829849037.840587,32616543059.396765,1983120,327665,1622515,3933300
2012-12-14,CBSX (W),13671005,3406216,7688692,24765913,375215898.420000,154589756.130000,194928998.624000,724734653.174000,96797,9048,50727,156572
2012-12-14,NASDAQ PSX (X),20535121,11180468,21973617,53689206,466965594.890000,650184454.930000,469498429.535000,1586648479.355000,87750,24999,59341,172090
2012-12-14,BATS BYX (Y),103932802,20065386,53714132,177712320,2638994937.585002,1042685680.214600,1442660480.321002,5124341098.120604,685934,79907,333388,1099229
2012-12-14,BATS BZX (Z),242640697,100913563,186086733,529640993,6918642210.339995,6226576434.027094,5771318669.142804,18916537313.509893,1436091,304963,941807,2682861
2012-12-13,NYSE MKT (A),0,9310430,5378514,14688944,0.000000,55393116.772100,67782814.258300,123175931.030400,0,20214,17735,37949
2012-12-13,NASDAQ BX (B),84595040,28181276,46023476,158799792,2106802584.291801,1429995977.780101,1367075062.607803,4903873624.679705,536898,97190,282113,916201
2012-12-13,NSX (C),8762289,3741284,7297110,19800683,193683624.237900,97582189.226700,148883428.127600,440149241.592200,27061,8199,17895,53155
2012-12-13,NYSE (DN),106041476,19482372,51213551,176737399,3192873004.575788,979951776.989200,1734648556.680696,5907473338.245684,649946,88549,285096,1023591
2012-12-13,NASDAQ (DQ),1063339329,324920217,633773435,2022032981,28929905707.164258,15495867581.194384,17853544083.628961,62279317371.987603,3042041,482576,1501417,5026034
2012-12-13,EDGA (J),70725803,39152304,39406739,149284846,1748494858.136798,1684658246.801403,1007039259.090699,4440192364.028900,424714,124695,211049,760458
2012-12-13,EDGX (K),238929286,72641325,192054908,503625519,6864571525.689804,2946359406.875600,5718840799.317598,15529771731.883002,1129152,184554,682355,1996061
2012-12-13,CHX (M),23634413,9919993,4265457,37819863,643320995.800900,674806719.645100,384473026.554900,1702600742.000900,399,2105,3026,5530
2012-12-13,NYSE (N),663192532,0,0,663192532,21079903841.184366,0.000000,0.000000,21079903841.184366,1761506,0,0,1761506
2012-12-13,NYSE Arca (P),333373294,186596968,199319491,719289753,10039883008.498560,11286301602.273116,6692789752.538405,28018974363.310081,1768977,413709,874564,3057250
2012-12-13,NASDAQ (Q),376930910,130537411,398192808,905661129,12016962523.252797,8932791285.599105,12976910572.988259,33926664381.840161,2165566,403979,1647898,4217443
2012-12-13,CBSX (W),14954881,4794944,8360637,28110462,399799659.530000,209058940.050000,259525981.560400,868384581.140400,97381,10603,48607,156591
2012-12-13,NASDAQ PSX (X),23590211,14836822,26066989,64494022,524657182.785000,946689388.730000,536933454.037900,2008280025.552900,95935,31027,67195,194157
2012-12-13,BATS BYX (Y),116687679,23855934,55722991,196266604,2951987669.554998,1195943332.910499,1362869219.967998,5510800222.433495,764204,98117,345465,1207786
2012-12-13,BATS BZX (Z),243690419,102670349,175587185,521947953,6865841310.267711,6402777738.553402,4789224555.426316,18057843604.247429,1432597,334100,870953,2637650
2012-12-12,NYSE MKT (A),0,14078043,5257295,19335338,0.000000,70419912.476900,75404869.558000,145824782.034900,0,21833,20534,42367
2012-12-12,NASDAQ BX (B),92273818,35598497,44533960,172406275,2382308991.905000,1531076019.940799,1385578151.461099,5298963163.306898,587919,103337,285396,976652
2012-12-12,NSX (C),9648943,3934825,6877501,20461269,224901877.464800,117163451.878900,139415006.206300,481480335.550000,30495,8317,19877,58689
2012-12-12,NYSE (DN),111643160,26107402,53665265,191415827,3533783947.598204,1048186387.178703,1839943917.701088,6421914252.477995,695796,105023,310431,1111250
2012-12-12,NASDAQ (DQ),1190329305,394009282,618540461,2202879048,33873117082.796608,18652473071.859743,17187148125.610621,69712738280.266972,3346320,512384,1506755,5365459
2012-12-12,EDGA (J),70934356,39564294,33817238,144315888,1697720858.536800,1681773423.977200,854793200.269899,4234287482.783899,405151,105867,190699,701717
2012-12-12,EDGX (K),277175429,85061383,184871656,547108468,8323527313.525073,3438466534.622287,5641211981.458708,17403205829.606068,1280245,197454,675173,2152872
2012-12-12,CHX (M),12828637,8750102,3850547,25429286,514363520.026300,696013581.644300,154975801.981700,1365352903.652300,349,2535,877,3761
2012-12-12,NYSE (N),694720520,0,0,694720520,22820599916.658885,0.000000,0.000000,22820599916.658885,1890189,0,0,1890189
2012-12-12,NYSE Arca (P),366996914,206323976,171512232,744833122,11509609418.793668,11523187748.857764,5982896622.900328,29015693790.551760,1948147,438304,835996,3222447
2012-12-12,NASDAQ (Q),431505767,156703541,379687136,967896444,14567829748.454621,9874131278.928614,11879982089.233976,36321943116.617211,2547807,469906,1683853,4701566
2012-12-12,CBSX (W),14938855,3878688,7797171,26614714,425353970.240000,176452920.790000,188866495.190000,790673386.220000,103032,11458,50292,164782
2012-12-12,NASDAQ PSX (X),25288006,18958186,19760880,64007072,557023044.280000,800802679.000000,423117237.550000,1780942960.830000,101260,31174,56749,189183
2012-12-12,BATS BYX (Y),126086970,33737260,54267292,214091522,3243265357.200798,1352467954.052999,1351197987.053002,5946931298.306799,824404,114781,346473,1285658
2012-12-12,BATS BZX (Z),286229670,137784294,179049560,603063524,8558433623.281184,7871586013.733477,5052691615.986818,21482711253.001479,1741087,404051,935979,3081117
2012-12-11,NYSE MKT (A),0,10055211,4899568,14954779,0.000000,63098983.263800,72302283.699100,135401266.962900,0,19575,18724,38299
2012-12-11,NASDAQ BX (B),91924364,27680786,45185300,164790450,2313379714.507398,1456958345.143301,1503101796.583202,5273439856.233901,556037,91554,283098,930689
2012-12-11,NSX (C),8683554,3614386,6605374,18903314,204066476.808700,107255480.725400,149965963.305200,461287920.839300,27859,7590,19301,54750
2012-12-11,NYSE (DN),125620708,19173548,57331592,202125848,3919945228.275464,945890525.080398,2023297640.521383,6889133393.877245,736748,78448,322994,1138190
2012-12-11,NASDAQ (DQ),1182464941,298444357,708131769,2189041067,33451807356.853999,17286548829.094723,21382261094.753057,72120617280.701779,3312570,460424,1600562,5373556
2012-12-11,EDGA (J),73628159,33043252,37456627,144128038,1816090119.376798,1565089689.368800,942259291.222198,4323439099.967796,406050,93692,194279,694021
2012-12-11,EDGX (K),252743671,70368014,186329984,509441669,7581073364.800520,3049571251.886505,5955704641.594273,16586349258.281298,1143931,170019,682820,1996770
2012-12-11,CHX (M),9591318,8926349,3312705,21830372,284557936.066600,582554879.852400,140439547.833900,1007552363.752900,310,1670,1107,3087
2012-12-11,NYSE (N),692869474,0,0,692869474,22552510792.180556,0.000000,0.000000,22552510792.180556,1779046,0,0,1779046
2012-12-11,NYSE Arca (P),367417730,172257855,169991520,709667105,11408549498.269022,10217559044.970488,6114340305.244078,27740448848.483588,1836403,371958,849013,3057374
2012-12-11,NASDAQ (Q),397483816,122252769,439882710,959619295,13129634157.938111,8381720320.414902,13977807397.927424,35489161876.280437,2265106,364654,1771472,4401232
2012-12-11,CBSX (W),16509767,3540274,8133648,28183689,459761155.200000,200934765.830000,195798549.306600,856494470.336600,106531,11616,52968,171115
2012-12-11,NASDAQ PSX (X),24792665,13776395,24263336,62832396,561273513.390000,849100487.410000,526114740.210000,1936488741.010000,103144,28208,62989,194341
2012-12-11,BATS BYX (Y),127977342,23642456,58834472,210454270,3353123611.305004,1212362353.465000,1477558667.804497,6043044632.574501,827368,90485,374488,1292341
2012-12-11,BATS BZX (Z),279273847,108993173,184474732,572741752,8171888082.731800,6972333887.312996,5345385418.137294,20489607388.182090,1628421,330792,977292,2936505
2012-12-10,NYSE MKT (A),0,9144727,3991575,13136302,0.000000,55394127.097600,53766996.276000,109161123.373600,0,18801,18100,36901
2012-12-10,NASDAQ BX (B),75763658,23880550,40270860,139915068,1852457978.393100,1201584318.986302,1184017229.879397,4238059527.258799,467380,78227,246670,792277
2012-12-10,NSX (C),8325098,3112297,6188817,17626212,193891864.395200,85399738.191200,135819952.009600,415111554.596000,26540,6765,17949,51254
2012-12-10,NYSE (DN),91439619,15532613,43746776,150719008,2680923787.315799,739597606.055699,1510826426.599500,4931347819.970998,555746,64955,266813,887514
2012-12-10,NASDAQ (DQ),959463325,275361465,532000125,1766824915,25798297996.785102,13748060946.176639,16529966054.584108,56076324997.545849,2776601,381329,1415923,4573853
2012-12-10,EDGA (J),59209101,29208381,31069361,119486843,1419354221.592798,1354193656.359201,786075215.219900,3559623093.171899,337364,85690,173591,596645
2012-12-10,EDGX (K),202184630,56128991,157445701,415759322,5841533956.225785,2433093264.183302,4772361060.994003,13046988281.403090,932877,130575,575653,1639105
2012-12-10,CHX (M),6744403,7106351,7110651,20961405,201880286.224000,574179951.781000,329615782.643000,1105676020.648000,186,885,704,1775
2012-12-10,NYSE (N),592775011,0,0,592775011,19086354772.701545,0.000000,0.000000,19086354772.701545,1587572,0,0,1587572
2012-12-10,NYSE Arca (P),308846560,163569632,142259854,614676046,8923702399.853247,8908382266.479083,5390146191.886480,23222230858.218810,1548536,321478,737154,2607168
2012-12-10,NASDAQ (Q),318440350,99740202,342252520,760433072,10299687172.865324,6601130080.938405,11476612524.008685,28377429777.812414,1864913,295325,1438219,3598457
2012-12-10,CBSX (W),16148431,4542099,9136375,29826905,422596013.720000,185700039.556500,185230799.270400,793526852.546900,110018,9984,51508,171510
2012-12-10,NASDAQ PSX (X),23487795,11345178,19930358,54763331,478729690.930000,683396699.590000,407059810.735000,1569186201.255000,80256,22282,50594,153132
2012-12-10,BATS BYX (Y),101106275,19366406,49198683,169671364,2562658973.570002,959378602.280000,1198562605.899501,4720600181.749503,677019,76235,314861,1068115
2012-12-10,BATS BZX (Z),238177583,93343982,153893043,485414608,6729652964.200190,5626139380.192502,4522019050.261819,16877811394.654511,1404277,273373,837810,2515460
2012-12-07,NYSE MKT (A),0,8454644,6941556,15396200,0.000000,56351528.582800,69482124.407000,125833652.989800,0,18836,23233,42069
2012-12-07,NASDAQ BX (B),82600607,23735179,40138013,146473799,2033209932.672000,1139807804.350300,1250203520.896000,4423221257.918300,500610,84589,251586,836785
2012-12-07,NSX (C),10032700,3042768,5741497,18816965,211211047.350900,95696024.382400,150794281.607600,457701353.340900,30571,7084,18111,55766
2012-12-07,NYSE (DN),93161001,16070446,46519027,155750474,2777363017.360892,750074594.999100,1637589594.418397,5165027206.778389,568491,60276,266400,895167
2012-12-07,NASDAQ (DQ),948661151,231293656,557799737,1737754544,24882795233.555215,11945748484.542585,17687354372.874213,54515898090.972013,2683757,391904,1375274,4450935
2012-12-07,EDGA (J),60550982,27007076,31342847,118900905,1437778738.919899,1265923552.685000,843796061.292699,3547498352.897598,344934,93790,175551,614275
2012-12-07,EDGX (K),231101636,63241717,163591696,457935049,6319507539.075483,2683340066.788399,5173375366.440923,14176222972.304805,982300,155072,590398,1727770
2012-12-07,CHX (M),12134331,7074245,4302211,23510787,312939987.121400,550180921.697400,237305570.685000,1100426479.503800,271,1952,607,2830
2012-12-07,NYSE (N),606321227,0,0,606321227,19199731294.941624,0.000000,0.000000,19199731294.941624,1706784,0,0,1706784
2012-12-07,NYSE Arca (P),324999352,151562342,167611374,644173068,9529766217.390215,9075834660.801614,6730718436.778424,25336319314.970253,1686875,375268,832561,2894704
2012-12-07,NASDAQ (Q),365474146,110276185,348896466,824646797,11539058193.737387,7254172306.898072,11698756973.938940,30491987474.574399,2079080,354369,1532620,3966069
2012-12-07,CBSX (W),15097230,3067276,7047322,25211828,393766221.280000,183951745.553500,151291806.600000,729009773.433500,96541,9292,47032,152865
2012-12-07,NASDAQ PSX (X),21217315,10782292,18739268,50738875,445033829.735000,654340380.690000,362683420.415000,1462057630.840000,82516,24694,50652,157862
2012-12-07,BATS BYX (Y),110794166,19897062,52062574,182753802,2786575074.816501,987968751.521500,1222544817.073001,4997088643.411002,716811,84142,325311,1126264
2012-12-07,BATS BZX (Z),255215259,108158455,165810753,529184467,7024092755.753808,6532658713.344400,5112061541.888887,18668813010.987095,1471209,341285,887273,2699767
2012-12-06,NYSE MKT (A),0,10028807,6039094,16067901,0.000000,69070506.200600,76500414.152600,145570920.353200,0,20871,20898,41769
2012-12-06,NASDAQ BX (B),76304997,19015990,41545178,136866165,1956024032.079999,943685325.559600,1464330212.774200,4364039570.413799,502199,73508,264865,840572
2012-12-06,NSX (C),10230037,2650405,6342538,19222980,228686367.679600,83294664.756400,176051758.563801,488032790.999801,33808,5955,19735,59498
2012-12-06,NYSE (DN),97721830,13186034,49889381,160797245,2766120967.398973,670031484.057000,2042457640.793701,5478610092.249674,605869,66887,287369,960125
2012-12-06,NASDAQ (DQ),993155530,265580915,584334875,1843071320,26354937637.911401,13640887982.182737,21198817998.794411,61194643618.888549,2823107,397721,1441489,4662317
2012-12-06,EDGA (J),63275740,28890591,32695248,124861579,1495968821.450599,1202728651.435801,1043061927.278399,3741759400.164799,374573,91392,179610,645575
2012-12-06,EDGX (K),228776831,58886544,171732904,459396279,6112237620.186601,2514373579.765300,6427069669.567222,15053680869.519123,1013902,152421,631149,1797472
2012-12-06,CHX (M),11927735,7957248,3968764,23853747,303965552.207300,511515008.980100,238216386.019400,1053696947.206800,316,1452,440,2208
2012-12-06,NYSE (N),617153079,0,0,617153079,19491044788.243277,0.000000,0.000000,19491044788.243277,1744900,0,0,1744900
2012-12-06,NYSE Arca (P),344212430,153126881,193296436,690635747,9956629811.856389,8746837130.607211,8544560880.038045,27248027822.501645,1800622,379793,914657,3095072
2012-12-06,NASDAQ (Q),380159180,102997114,376623058,859779352,11465000017.472409,6354385658.357600,14328838021.467079,32148223697.297088,2131115,337341,1622326,4090782
2012-12-06,CBSX (W),16967341,2849115,8030724,27847180,456967400.090000,176039235.070000,185715332.760000,818721967.920000,114079,12342,53597,180018
2012-12-06,NASDAQ PSX (X),22112313,9724125,21777607,53614045,445601569.875000,526861398.840000,407861493.990000,1380324462.705000,84181,21645,56052,161878
2012-12-06,BATS BYX (Y),113023745,20229770,52723240,185976755,2858116797.045700,927487608.109100,1383484056.889598,5169088462.044398,763255,87141,343239,1193635
2012-12-06,BATS BZX (Z),256927669,102038757,175979103,534945529,7033244792.133321,6062615569.242284,5989493801.939009,19085354163.314614,1492839,337872,896951,2727662
2012-12-05,NYSE MKT (A),0,9855230,5294109,15149339,0.000000,69759779.079100,67494271.708000,137254050.787100,0,22065,20797,42862
2012-12-05,NASDAQ BX (B),103783380,26419872,42722115,172925367,2355345455.866598,1381046691.053801,1557253750.605001,5293645897.525400,564224,96381,265764,926369
2012-12-05,NSX (C),12646645,3534519,6530119,22711283,281725004.951000,117101057.843400,235416806.641899,634242869.436299,40005,7805,22548,70358
2012-12-05,NYSE (DN),123505147,19381020,49284905,192171072,3404312932.179002,971004896.684799,2031324525.039483,6406642353.903284,713583,85075,285336,1083994
2012-12-05,NASDAQ (DQ),1348330344,308574625,611383793,2268288762,33709160129.225876,15732676010.847170,21193895179.549874,70635731319.622920,3420378,498308,1530147,5448833
2012-12-05,EDGA (J),81815247,35498614,33661925,150975786,1820261681.215102,1704046337.378500,955546945.986198,4479854964.579800,424555,121547,190587,736689
2012-12-05,EDGX (K),317246822,78379659,181117934,576744415,8340585698.094003,3483364276.710797,6606526590.786206,18430476565.591006,1268542,195756,660783,2125081
2012-12-05,CHX (M),11869274,8128980,8220286,28218540,385701150.710000,663633573.200600,764576514.256500,1813911238.167100,297,2396,593,3286
2012-12-05,NYSE (N),759331035,0,0,759331035,23322359612.173284,0.000000,0.000000,23322359612.173284,2073241,0,0,2073241
2012-12-05,NYSE Arca (P),474029277,212215468,194954016,881198761,13427364602.723140,12242383628.356415,8764881051.112316,34434629282.191871,2222051,504608,987443,3714102
2012-12-05,NASDAQ (Q),505280319,158543200,417822679,1081646198,15472528570.926890,10331224125.305698,15350215736.207274,41153968432.439862,2730693,479097,1819900,5029690
2012-12-05,CBSX (W),18307188,4387302,7706929,30401419,479307906.040000,184331569.600000,177388561.820000,841028037.460000,109524,11915,51779,173218
2012-12-05,NASDAQ PSX (X),30705369,18227492,23001888,71934749,594592475.760000,1002640908.575000,482511162.695000,2079744547.030000,105231,34655,59178,199064
2012-12-05,BATS BYX (Y),145262686,28866502,58574913,232704101,3551570910.009499,1406520219.345001,1468320350.519502,6426411479.874002,902986,119302,379140,1401428
2012-12-05,BATS BZX (Z),322925832,135843250,185228651,643997733,8518631756.629514,8536602061.358799,5953837959.021402,23009071777.009715,1745848,445865,953874,3145587
2012-12-04,NYSE MKT (A),0,10285303,4674131,14959434,0.000000,68671953.047000,67378497.127000,136050450.174000,0,22421,18696,41117
2012-12-04,NASDAQ BX (B),77107241,24448960,41791334,143347535,1975654195.739997,1230237494.538702,1333608742.680201,4539500432.958900,494776,85612,260343,840731
2012-12-04,NSX (C),9930868,5152225,5778772,20861865,250416989.458300,115161383.033400,169737348.203600,535315720.695300,36416,9480,19759,65655
2012-12-04,NYSE (DN),106000005,13696519,54586856,174283380,3087265777.350092,746393398.796001,1782452580.150903,5616111756.296996,661017,61930,307374,1030321
2012-12-04,NASDAQ (DQ),940809057,280404325,599943330,1821156712,24930122507.617754,13573498264.320071,17859332161.257383,56362952933.195208,2810379,449078,1417348,4676805
2012-12-04,EDGA (J),59792564,32107136,33119663,125019363,1395203735.839701,1572730946.261801,817443219.352302,3785377901.453804,355405,109484,183844,648733
2012-12-04,EDGX (K),230269012,73016364,182544200,485829576,6175952061.289204,2989172487.943106,5507835880.499921,14672960429.732231,1056416,187324,654193,1897933
2012-12-04,CHX (M),9394874,11463999,7329665,28188538,302554544.288700,707362543.464000,1535492746.820900,2545409834.573600,435,2103,453,2991
2012-12-04,NYSE (N),674590164,0,0,674590164,21189408066.299722,0.000000,0.000000,21189408066.299722,1873995,0,0,1873995
2012-12-04,NYSE Arca (P),341342453,186045241,186575828,713963522,9933096050.920105,10684423500.845609,6814360098.870410,27431879650.636124,1876796,447723,946452,3270971
2012-12-04,NASDAQ (Q),392992184,131033353,409921509,933947046,12238673579.242115,8879288210.321396,12693475487.727343,33811437277.290854,2310243,404756,1708998,4423997
2012-12-04,CBSX (W),13825085,4505254,7994909,26325248,364104811.060000,196806992.870000,184242383.240000,745154187.170000,94443,11140,51629,157212
2012-12-04,NASDAQ PSX (X),25796713,14104062,23307208,63207983,499326362.220000,834852212.180000,467601243.910000,1801779818.310000,89242,28056,57561,174859
2012-12-04,BATS BYX (Y),115306772,23614404,58442344,197363520,2868767513.651999,1129531971.829999,1398054074.876499,5396353560.358497,775061,97503,369140,1241704
2012-12-04,BATS BZX (Z),251973105,115290496,174058840,541322441,6828466929.514506,7073131606.300318,4886066980.785083,18787665516.599907,1485711,375670,894310,2755691
2012-12-03,NYSE MKT (A),0,8736811,4694007,13430818,0.000000,62857321.843200,65747081.740000,128604403.583200,0,20447,20461,40908
2012-12-03,NASDAQ BX (B),75187187,25594448,41019691,141801326,1891909438.294999,1284820909.637201,1201201509.465001,4377931857.397201,494578,89258,265764,849600
2012-12-03,NSX (C),9209716,3171670,6499299,18880685,232772105.167500,109510239.692600,159827705.861200,502110050.721300,34421,7362,20884,62667
2012-12-03,NYSE (DN),93960501,16215557,47644505,157820563,2785096504.668787,863709440.870699,1463330555.283995,5112136500.823481,588206,73889,287077,949172
2012-12-03,NASDAQ (DQ),897301134,310576476,564196299,1772073909,24049709209.652490,15272549645.079284,15280967875.846506,54603226730.578280,2874102,460204,1493456,4827762
2012-12-03,EDGA (J),54257765,31291135,31502733,117051633,1250045735.359401,1507057538.490901,752688637.124699,3509791910.975001,325013,104984,178658,608655
2012-12-03,EDGX (K),224275067,72140472,163379986,459795525,6498766663.922495,3305467271.822400,5087621014.690283,14891854950.435178,1105900,177776,634934,1918610
2012-12-03,CHX (M),5297148,7846718,6014141,19158007,197456609.451500,572501426.037200,430784887.627600,1200742923.116300,258,1513,359,2130
2012-12-03,NYSE (N),657620853,0,0,657620853,20799186986.979081,0.000000,0.000000,20799186986.979081,1828268,0,0,1828268
2012-12-03,NYSE Arca (P),322173430,187521191,175717941,685412562,9763120780.252387,11191312568.223190,5868649337.580501,26823082686.056078,1824903,438583,871258,3134744
2012-12-03,NASDAQ (Q),360165703,125620205,382713414,868499322,11389393631.047361,8429799209.080199,11595270417.457424,31414463257.584984,2159321,396988,1620874,4177183
2012-12-03,CBSX (W),9889911,4155378,6282323,20327612,278957846.026600,173831988.650000,149045543.460800,601835378.137400,66694,9706,35883,112283
2012-12-03,NASDAQ PSX (X),22017802,13716063,21494954,57228819,439210486.444000,817264524.580000,446793470.280000,1703268481.304000,86348,27786,59720,173854
2012-12-03,BATS BYX (Y),111176925,24491058,56326100,191994083,2813731681.733803,1216692600.273600,1324870674.963800,5355294956.971203,764377,101969,371657,1238003
2012-12-03,BATS BZX (Z),232589054,108876826,163590590,505056470,6504478279.148688,6544500190.523897,4528781172.349310,17577759642.021895,1407934,366296,874523,2648753
2012-11-30,NYSE MKT (A),0,15215412,6659156,21874568,0.000000,96720816.746800,84599364.672700,181320181.419500,0,21317,23134,44451
2012-11-30,NASDAQ BX (B),80345027,25881122,42292269,148518418,2146907746.275001,1443923048.474801,1281000709.479300,4871831504.229102,515808,92013,262605,870426
2012-11-30,NSX (C),14496592,4348120,9504179,28348891,395028514.177500,152131045.062000,217604247.662100,764763806.901600,52053,9321,28017,89391
2012-11-30,NYSE (DN),105900382,16029722,55117740,177047844,3218376201.826785,858433992.379601,1573507151.314094,5650317345.520480,668212,73896,310340,1052448
2012-11-30,NASDAQ (DQ),1195210364,282131731,772667978,2250010073,33690130553.705166,14590556525.626563,19025307076.661215,67305994155.992944,2850758,457944,1460799,4769501
2012-11-30,EDGA (J),64241624,37522605,34133145,135897374,1497376416.738305,1653539785.763198,786628050.353200,3937544252.854703,371277,104824,186846,662947
2012-11-30,EDGX (K),212184659,69736619,165794706,447715984,6105324263.347901,3037576713.187204,4459628331.534399,13602529308.069504,1020041,185016,608033,1813090
2012-11-30,CHX (M),10268604,7829435,5757019,23855058,384501185.703600,471434371.037300,815613464.711600,1671549021.452500,545,1471,457,2473
2012-11-30,NYSE (N),1183559526,0,0,1183559526,39154179726.264694,0.000000,0.000000,39154179726.264694,1994935,0,0,1994935
2012-11-30,NYSE Arca (P),333124179,194155726,191054265,718334170,10265217622.250487,11172517824.092987,6273448128.636884,27711183574.980358,1866715,429391,933552,3229658
2012-11-30,NASDAQ (Q),373348371,133225852,669335549,1175909772,12122608431.281033,9134690575.698914,17701239942.297579,38958538949.277526,2196061,406668,1670204,4272933
2012-11-30,CBSX (W),16738003,5830969,10149689,32718661,457583140.070000,279799882.010000,214711268.000000,952094290.080000,116192,12084,62444,190720
2012-11-30,NASDAQ PSX (X),23110352,15423507,23318094,61851953,489313594.315000,905759719.325000,466407454.385000,1861480768.025000,94112,30524,62518,187154
2012-11-30,BATS BYX (Y),115348448,24370332,58628250,198347030,3053468316.367396,1232657241.461000,1352777437.735297,5638902995.563693,783472,99525,378889,1261886
2012-11-30,BATS BZX (Z),238517100,114874609,170884631,524276340,6702602345.385318,7027384629.886216,4484370209.800002,18214357185.071536,1423732,359405,884327,2667464
2012-11-29,NYSE MKT (A),0,9647436,5715045,15362481,0.000000,59617692.676700,77184450.073000,136802142.749700,0,20235,21983,42218
2012-11-29,NASDAQ BX (B),82623097,30077289,43523807,156224193,2149658493.655899,1542364461.973602,1409581624.689997,5101604580.319498,520215,103162,265211,888588
2012-11-29,NSX (C),13201660,4116139,8527206,25845005,323049435.882200,152418446.006500,236856772.627300,712324654.516000,43046,9251,25810,78107
2012-11-29,NYSE (DN),100315724,15583033,47094409,162993166,3039289841.801987,814424480.116501,1564850150.986395,5418564472.904883,633194,70662,273238,977094
2012-11-29,NASDAQ (DQ),1000927923,340748060,600665595,1942341578,26572811595.287754,16897239428.019081,17792328406.297039,61262379429.603874,2820908,528198,1401969,4751075
2012-11-29,EDGA (J),64699424,39636377,32735544,137071345,1489184443.513904,1766567543.866300,777004645.690801,4032756633.071005,369873,113059,180190,663122
2012-11-29,EDGX (K),235408202,81878765,167075262,484362229,6658955134.044793,3563264474.260300,4949216496.501318,15171436104.806411,1100215,208875,635875,1944965
2012-11-29,CHX (M),11010999,10248926,5662516,26922441,419750291.939800,636180281.125000,262092187.191000,1318022760.255800,382,1647,454,2483
2012-11-29,NYSE (N),682474797,0,0,682474797,21753574900.846696,0.000000,0.000000,21753574900.846696,2083859,0,0,2083859
2012-11-29,NYSE Arca (P),369353792,216483638,194774634,780612064,11220353463.408884,11847199653.186892,7401754363.101185,30469307479.696961,2014112,483393,959402,3456907
2012-11-29,NASDAQ (Q),385490003,154300971,394150749,933941723,12371863565.199717,10218252916.070777,12438262554.401189,35028379035.671683,2280218,470640,1671507,4422365
2012-11-29,CBSX (W),14495448,4656159,7769277,26920884,382174848.490000,258003583.540000,188841213.094100,829019645.124100,99366,12436,51263,163065
2012-11-29,NASDAQ PSX (X),23531160,17390708,24098767,65020635,488034668.955000,1007665793.140000,523258751.880000,2018959213.975000,93112,31390,63720,188222
2012-11-29,BATS BYX (Y),118488528,30370047,59269321,208127896,3092697972.049099,1329745772.547900,1444597891.807797,5867041636.404796,805859,115300,382998,1304157
2012-11-29,BATS BZX (Z),255231608,140774833,176893750,572900191,7265389586.854204,8273483200.075376,4991028983.653491,20529901770.583071,1543383,431314,908192,2882889
2012-11-28,NYSE MKT (A),0,8720217,7509136,16229353,0.000000,58702976.604400,72838089.311000,131541065.915400,0,18572,20849,39421
2012-11-28,NASDAQ BX (B),85438828,28353306,42131927,155924061,2154838332.373702,1613144161.250300,1292079052.199701,5060061545.823703,534527,104572,269901,909000
2012-11-28,NSX (C),11066494,3831255,6602589,21500338,253026359.208800,136843286.556100,185748001.044000,575617646.808900,34895,8788,22091,65774
2012-11-28,NYSE (DN),89550270,16165408,43567607,149283285,2699214208.038173,935009047.069702,1537076555.498991,5171299810.606866,569398,75842,262516,907756
2012-11-28,NASDAQ (DQ),939991488,316398661,562430756,1818820905,25099244637.428984,17691910451.103947,16447666467.014551,59238821555.547482,2652325,505565,1326933,4484823
2012-11-28,EDGA (J),63109474,38190156,31542522,132842152,1476146680.269201,1812650578.418801,766141774.118899,4054939032.806901,367026,120642,180725,668393
2012-11-28,EDGX (K),233977998,88668501,158256638,480903137,6393108396.820316,3935668713.089503,4865418171.563890,15194195281.473709,1109629,225802,635469,1970900
2012-11-28,CHX (M),10716638,11438086,3602998,25757722,298346302.442900,833720643.877500,192688352.750800,1324755299.071200,540,3207,661,4408
2012-11-28,NYSE (N),711938507,0,0,711938507,22704293540.465650,0.000000,0.000000,22704293540.465650,2078866,0,0,2078866
2012-11-28,NYSE Arca (P),378095735,218196449,189277717,785569901,11029702852.214156,12994381377.633127,6863810893.300234,30887895123.147517,2078578,528824,953269,3560671
2012-11-28,NASDAQ (Q),410624979,155553160,425290413,991468552,12617352502.067623,10412403224.522136,13293812664.327495,36323568390.917254,2427504,518749,1775595,4721848
2012-11-28,CBSX (W),15447700,3716515,7916999,27081214,395036903.670000,198345048.520000,189686189.190000,783068141.380000,100635,13025,53728,167388
2012-11-28,NASDAQ PSX (X),23756977,20296470,23006552,67059999,477735728.495000,1406629101.985000,479958772.610000,2364323603.090000,94546,40257,62750,197553
2012-11-28,BATS BYX (Y),117690653,28675527,54922710,201288890,2977031206.227898,1406911061.785000,1338279875.872201,5722222143.885099,794668,116222,366344,1277234
2012-11-28,BATS BZX (Z),271649613,140515798,178133619,590299030,7451039897.680491,8743779371.484605,4881767813.827109,21076587082.992205,1623084,478948,939125,3041157
2012-11-27,NYSE MKT (A),0,8111204,4882771,12993975,0.000000,60619291.049800,60889639.439000,121508930.488800,0,18530,20997,39527
2012-11-27,NASDAQ BX (B),82499070,23989266,41495352,147983688,2146973217.258100,1259718355.353600,1221993401.619499,4628684974.231199,514386,87632,259530,861548
2012-11-27,NSX (C),12057418,3416630,7647623,23121671,308067583.473300,100538812.127700,183436230.949200,592042626.550200,41937,7352,22435,71724
2012-11-27,NYSE (DN),96653837,12974828,45757610,155386275,2862262923.592891,690744827.099401,1474209310.404501,5027217061.096793,588057,61096,260118,909271
2012-11-27,NASDAQ (DQ),979788380,267259871,593926152,1840974403,26508398604.385160,13850840605.325685,16436072950.550691,56795312160.261536,2751756,429912,1365898,4547566
2012-11-27,EDGA (J),63489283,30154703,31885746,125529732,1580008891.924198,1431156205.874700,764328581.867300,3775493679.666198,369014,100079,179439,648532
2012-11-27,EDGX (K),231050409,65498248,166195175,462743832,6599858239.302393,2749728247.828298,4777788203.493262,14127374690.623953,1079549,178663,634422,1892634
2012-11-27,CHX (M),9956607,5860708,4609946,20427261,319895747.814200,397216489.141000,406480095.841100,1123592332.796300,396,1796,470,2662
2012-11-27,NYSE (N),689395312,0,0,689395312,21752055887.681714,0.000000,0.000000,21752055887.681714,2011052,0,0,2011052
2012-11-27,NYSE Arca (P),354349109,197231106,196681091,748261306,10884055400.925804,11259431337.563626,6592516904.151408,28736003642.640838,1923367,463228,954764,3341359
2012-11-27,NASDAQ (Q),384336969,120821966,406352530,911511465,12120822580.351399,7908844658.261626,12105543070.943952,32135210309.556977,2268445,404432,1652888,4325765
2012-11-27,CBSX (W),15379665,3941428,8157171,27478264,421077208.630000,240540618.940000,175351756.110000,836969583.680000,106576,12400,54296,173272
2012-11-27,NASDAQ PSX (X),23414088,15097528,24569665,63081281,478742400.300000,1019373944.745000,493818953.440000,1991935298.485000,89041,29397,62908,181346
2012-11-27,BATS BYX (Y),118284121,23552660,56130561,197967342,3017849807.680999,1077375304.559600,1278525874.626799,5373750986.867398,790697,96129,360721,1247547
2012-11-27,BATS BZX (Z),263254720,109438695,180517044,553210459,7373768973.091881,6793984675.037505,4768356964.199523,18936110612.328909,1562386,384302,921131,2867819
2012-11-26,NYSE MKT (A),0,8785168,4390749,13175917,0.000000,52016292.194900,53031670.594000,105047962.788900,0,17831,18600,36431
2012-11-26,NASDAQ BX (B),70582015,23213849,40398507,134194371,1723914765.841201,1218695640.491897,1232317770.800001,4174928177.133099,452451,84380,254308,791139
2012-11-26,NSX (C),8509233,3149048,6201069,17859350,210393235.560700,63777870.052100,172455213.076500,446626318.689300,31458,6678,19859,57995
2012-11-26,NYSE (DN),83937166,13437477,42096158,139470801,2456002770.240597,635938456.222601,1446884881.007996,4538826107.471194,528037,61123,250994,840154
2012-11-26,NASDAQ (DQ),911040110,251387471,582674564,1745102145,24394899060.406340,12623755890.195148,17102663123.082451,54121318073.683939,2460604,404452,1272829,4137885
2012-11-26,EDGA (J),53549641,29076248,29673311,112299200,1259662862.950499,1428833515.215797,717933465.013401,3406429843.179697,317233,104657,169252,591142
2012-11-26,EDGX (K),189610608,62040894,144119518,395771020,5184002999.806690,2504252185.880900,4616424524.834583,12304679710.522173,904748,158084,564795,1627627
2012-11-26,CHX (M),8576289,4960201,3061842,16598332,251421496.540000,384626964.755800,176479349.777400,812527811.073200,290,1332,321,1943
2012-11-26,NYSE (N),633103165,0,0,633103165,19725628913.716193,0.000000,0.000000,19725628913.716193,1814735,0,0,1814735
2012-11-26,NYSE Arca (P),313933788,159406021,166558572,639898381,8933887834.127798,8736517481.785304,6226354239.290336,23896759555.203438,1724016,384645,829733,2938394
2012-11-26,NASDAQ (Q),322414490,102505499,389881272,814801261,9789886637.983662,6339984014.097887,13219542241.323519,29349412893.405068,1936236,344659,1508909,3789804
2012-11-26,CBSX (W),13745220,7763956,8524529,30033705,291912188.380000,331648190.660000,167994049.260000,791554428.300000,91418,11847,52711,155976
2012-11-26,NASDAQ PSX (X),20765909,13380924,21830950,55977783,406634643.295000,790547541.820000,458763738.387100,1655945923.502100,83511,27768,60231,171510
2012-11-26,BATS BYX (Y),98372363,21055357,48746015,168173735,2383861810.976003,940502958.900100,1192983841.555300,4517348611.431403,664018,85094,322478,1071590
2012-11-26,BATS BZX (Z),223340985,92086727,161208990,476636702,5861387621.866813,5145583866.691200,4602356761.570885,15609328250.128898,1333910,328914,845091,2507915
2012-11-23,NYSE MKT (A),0,5403345,1390243,6793588,0.000000,32885318.952100,16419417.226000,49304736.178100,0,9720,5498,15218
2012-11-23,NASDAQ BX (B),38695028,13920582,19564193,72179803,879383389.457000,742650253.175000,655855986.478600,2277889629.110600,235708,48232,125811,409751
2012-11-23,NSX (C),5076869,1814591,3535181,10426641,110737563.170000,57163824.249300,77828013.787300,245729401.206600,16048,3551,9752,29351
2012-11-23,NYSE (DN),39937888,8804328,17550243,66292459,1109028174.727803,452773214.271200,580067276.722501,2141868665.721504,263856,39842,114657,418355
2012-11-23,NASDAQ (DQ),475479273,152935815,297057081,925472169,11403563531.018820,7398190309.521422,7894683941.545985,26696437782.086227,1112294,250270,598338,1960902
2012-11-23,EDGA (J),27016670,15488230,13221981,55726881,555780545.323300,743247274.278700,321858041.543000,1620885861.145000,144280,48629,75767,268676
2012-11-23,EDGX (K),99063523,42074905,74413467,215551895,2507925929.657800,1738817443.212500,2121530525.156497,6368273898.026797,422121,104033,269165,795319
2012-11-23,CHX (M),858490,2092432,2491493,5442415,36769866.076500,179632192.506700,64996032.008100,281398090.591300,95,1254,185,1534
2012-11-23,NYSE (N),328939939,0,0,328939939,9984516568.987450,0.000000,0.000000,9984516568.987450,912946,0,0,912946
2012-11-23,NYSE Arca (P),167331862,115877309,87229549,370438720,4565612417.110189,6505887485.450995,3022186423.733123,14093686326.294307,872431,244775,411324,1528530
2012-11-23,NASDAQ (Q),154937143,63972330,188669776,407579249,4517095933.333895,4099815680.772305,5909633518.785296,14526545132.891496,907307,207888,725076,1840271
2012-11-23,CBSX (W),6971701,2251569,4236625,13459895,144136923.700000,65986702.460000,80500270.280000,290623896.440000,47090,5194,28720,81004
2012-11-23,NASDAQ PSX (X),7342055,6188947,6951988,20482990,154474233.030000,336950849.460000,168327409.900000,659752492.390000,37799,15019,25899,78717
2012-11-23,BATS BYX (Y),47249368,13009082,21514684,81773134,1100404139.694999,615087513.155000,546621299.412000,2262112952.261999,306121,50224,145751,502096
2012-11-23,BATS BZX (Z),106091624,61186216,77446430,244724270,2641499364.291596,3539964088.010603,2077266104.542601,8258729556.844800,620957,190571,401677,1213205
2012-11-21,NYSE MKT (A),0,7391192,4360783,11751975,0.000000,41812778.301100,48367357.610500,90180135.911600,0,16637,17509,34146
2012-11-21,NASDAQ BX (B),66804610,21104998,33969624,121879232,1565131101.500002,988917372.846101,982772823.728300,3536821298.074403,409271,69106,211549,689926
2012-11-21,NSX (C),8863900,2275689,5520249,16659838,218069119.124500,76354373.922000,119718092.053600,414141585.100100,32061,5470,16533,54064
2012-11-21,NYSE (DN),81210247,13684613,39352440,134247300,2267601112.139602,666064738.529500,1157810813.412802,4091476664.081904,493199,60454,224159,777812
2012-11-21,NASDAQ (DQ),863370371,217552296,538288211,1619210878,21784101745.467090,9864092341.400983,13932515448.923174,45580709535.791247,2228256,376839,1134206,3739301
2012-11-21,EDGA (J),50783064,24791244,27041968,102616276,1122206670.979900,1052429455.710099,610144160.842800,2784780287.532799,276598,80594,140815,498007
2012-11-21,EDGX (K),173118483,51440675,127474552,352033710,4507643410.528000,2083490227.068398,3508039705.448303,10099173343.044701,780796,135098,477729,1393623
2012-11-21,CHX (M),8835523,7377265,5460909,21673697,213938329.021800,512675029.122000,206344550.085800,932957908.229600,1180,1008,454,2642
2012-11-21,NYSE (N),521924481,0,0,521924481,15798216604.558674,0.000000,0.000000,15798216604.558674,1550978,0,0,1550978
2012-11-21,NYSE Arca (P),285235626,144007597,145849071,575092294,7946804195.991799,8074092029.061304,4589718729.975809,20610614955.028912,1520235,326003,710951,2557189
2012-11-21,NASDAQ (Q),286891938,88513843,297172084,672577865,8508026613.861413,4980978534.179603,8787219972.643252,22276225120.684268,1661145,276996,1225410,3163551
2012-11-21,CBSX (W),13092334,3099104,7131912,23323350,273346621.790000,136047511.994800,130862896.850000,540257030.634800,89226,10134,48438,147798
2012-11-21,NASDAQ PSX (X),17465308,11045906,18089508,46600722,322392080.640000,669787408.450000,339034235.835000,1331213724.925000,69050,24657,47323,141030
2012-11-21,BATS BYX (Y),91490846,21091746,43888608,156471200,2154441828.395700,920855991.034800,1021193368.274397,4096491187.704897,597051,79555,279800,956406
2012-11-21,BATS BZX (Z),202222574,85624269,143287714,431134557,5280048740.370410,4537261428.558002,3581083879.340997,13398394048.269409,1178032,276639,710041,2164712
2012-11-20,NYSE MKT (A),0,6946917,3476783,10423700,0.000000,48117304.113700,41706634.197000,89823938.310700,0,17846,14693,32539
2012-11-20,NASDAQ BX (B),80738190,24433145,45318289,150489624,2016067698.293000,1408234422.467199,1524165085.285201,4948467206.045400,516934,92936,285484,895354
2012-11-20,NSX (C),10680167,2102057,6266641,19048865,243525995.719700,85432120.423100,165824712.059800,494782828.202600,36829,5754,19679,62262
2012-11-20,NYSE (DN),97107297,15153978,48235186,160496461,2893137341.651607,720478723.315800,1577946595.876384,5191562660.843791,614431,65601,284781,964813
2012-11-20,NASDAQ (DQ),956746903,269683744,522971548,1749402195,24697162822.946165,13655414989.594539,16230795381.867042,54583373194.407746,2665465,411639,1277547,4354651
2012-11-20,EDGA (J),60708778,32442782,30925023,124076583,1402969434.017201,1505152305.001801,799624379.716099,3707746118.735101,334498,101798,166763,603059
2012-11-20,EDGX (K),221459110,62714644,136205864,420379618,5976824772.481609,2722245356.084404,4369831092.432210,13068901220.998223,1042953,169514,558527,1770994
2012-11-20,CHX (M),8193329,12004892,4342184,24540405,260207431.570400,774792878.697300,136986340.334500,1171986650.602200,606,1362,419,2387
2012-11-20,NYSE (N),644537833,0,0,644537833,19355163647.264797,0.000000,0.000000,19355163647.264797,1957430,0,0,1957430
2012-11-20,NYSE Arca (P),356603501,176970204,177623432,711197137,10127227506.382926,10135350432.714695,6600508271.173905,26863086210.271526,1932771,416976,875638,3225385
2012-11-20,NASDAQ (Q),367025230,118163243,363110421,848298894,11007825624.069153,7093846648.837698,11963263862.000914,30064936134.907765,2147293,372396,1550505,4070194
2012-11-20,CBSX (W),16348611,2443282,7769509,26561402,340034749.330000,144995343.140000,153814845.490000,638844937.960000,102447,9862,52313,164622
2012-11-20,NASDAQ PSX (X),20197842,13970533,20598834,54767209,394227773.140400,896246480.430000,454861576.730000,1745335830.300400,82214,29069,54377,165660
2012-11-20,BATS BYX (Y),114081990,22961265,54969685,192012940,2844769469.506795,1151489936.228000,1285683110.123398,5281942515.858193,772048,92836,351101,1215985
2012-11-20,BATS BZX (Z),260692296,106935783,171598364,539226443,6960483131.150701,6095039468.244706,4971003816.030806,18026526415.426213,1532078,358616,889011,2779705
2012-11-19,NYSE MKT (A),0,9087468,2657079,11744547,0.000000,71402321.604800,31618126.872000,103020448.476800,0,20654,11351,32005
2012-11-19,NASDAQ BX (B),83860450,32065371,48497564,164423385,2148070850.670302,1669142506.653200,1683468905.478703,5500682262.802205,544549,102977,296874,944400
2012-11-19,NSX (C),9132086,2469033,5706963,17308082,234441772.772700,103211658.693600,179999497.255100,517652928.721400,33762,6059,19534,59355
2012-11-19,NYSE (DN),108169360,20044170,55900255,184113785,3121884675.971775,979107686.905501,1936764299.331082,6037756662.208358,664061,88859,311107,1064027
2012-11-19,NASDAQ (DQ),994242220,387732667,589114187,1971089074,26345032958.689021,19336631026.015575,18551344815.497190,64233008800.201786,2917785,501649,1454525,4873959
2012-11-19,EDGA (J),60740400,36186357,32590303,129517060,1470697652.799400,1638191350.126299,817364880.676801,3926253883.602500,357415,107912,182789,648116
2012-11-19,EDGX (K),227436941,80195793,151643572,459276306,6482220827.003216,3418991811.413997,5198455915.139486,15099668553.556699,1085740,204870,628118,1918728
2012-11-19,CHX (M),12964842,6856923,4180007,24001772,381047186.910200,462248642.943600,307098734.176000,1150394564.029800,385,2038,522,2945
2012-11-19,NYSE (N),710891376,0,0,710891376,22462586941.185916,0.000000,0.000000,22462586941.185916,2033622,0,0,2033622
2012-11-19,NYSE Arca (P),371942366,230634720,190159450,792736536,11327450811.319905,12352680701.269612,7557627046.473165,31237758559.062682,2088858,487013,956469,3532340
2012-11-19,NASDAQ (Q),373398863,136162999,415932179,925494041,11575270146.815104,8270712301.120402,13922959029.844148,33768941477.779654,2237932,415923,1662462,4316317
2012-11-19,CBSX (W),16392988,5097421,9307004,30797413,359188111.460000,237966510.890000,182148848.770000,779303471.120000,106589,11052,59542,177183
2012-11-19,NASDAQ PSX (X),21636405,18462123,22404059,62502587,469305065.020000,1060806041.330000,437712405.865000,1967823512.215000,97413,34600,65471,197484
2012-11-19,BATS BYX (Y),120935519,28250901,59287299,208473719,3188391048.178303,1342941723.800299,1589835714.270201,6121168486.248803,838168,103247,386380,1327795
2012-11-19,BATS BZX (Z),263571664,134528046,189403685,587503395,7572175623.175198,7594907058.596804,5699268893.999472,20866351575.771474,1636161,415868,983981,3036010
2012-11-16,NYSE MKT (A),0,10680573,4705927,15386500,0.000000,71280007.289500,50984195.364000,122264202.653500,0,26085,15261,41346
2012-11-16,NASDAQ BX (B),94570361,35386274,53168022,183124657,2368180169.124604,2101009474.319000,1914325633.832998,6383515277.276602,608744,122820,329917,1061481
2012-11-16,NSX (C),14122678,3730495,7145021,24998194,344259032.890700,148019242.537600,255554910.177800,747833185.606100,51265,8345,25212,84822
2012-11-16,NYSE (DN),115718244,19501798,60498750,195718792,3311622039.516627,971314534.114500,2508338404.720718,6791274978.351845,713113,86904,337571,1137588
2012-11-16,NASDAQ (DQ),1132251316,380632383,695609206,2208492905,29868593963.297924,21775907339.832568,23135929948.110694,74780431251.241186,3123261,537452,1648221,5308934
2012-11-16,EDGA (J),67298507,37998768,38369716,143666991,1519943731.566502,1947209476.953700,1005213664.014501,4472366872.534703,382765,115861,204525,703151
2012-11-16,EDGX (K),266841070,90879760,175603101,533323931,7239076985.829823,3932249695.122897,6227381821.459627,17398708502.412347,1263578,242785,744397,2250760
2012-11-16,CHX (M),7975515,15312193,9804177,33091885,237843164.261500,957318590.664500,551778865.725900,1746940620.651900,1045,2726,610,4381
2012-11-16,NYSE (N),948570823,0,0,948570823,30798176196.926627,0.000000,0.000000,30798176196.926627,2468308,0,0,2468308
2012-11-16,NYSE Arca (P),433050334,258726056,247064172,938840562,12489153866.404255,15944343430.184102,10707415496.044877,39140912792.633234,2403503,606937,1220229,4230669
2012-11-16,NASDAQ (Q),477091810,184524174,574941116,1236557100,14286399641.717994,12353968437.789010,19214374324.093599,45854742403.600603,2803599,583765,2132305,5519669
2012-11-16,CBSX (W),18436125,3555149,8928385,30919659,397356422.580000,179491853.260000,186862133.210000,763710409.050000,115532,8033,59263,182828
2012-11-16,NASDAQ PSX (X),27329368,22343490,27728076,77400934,561483979.910000,1403089297.990000,578927602.375000,2543500880.275000,117679,44249,77244,239172
2012-11-16,BATS BYX (Y),137481460,32087503,69080331,238649294,3403482562.898294,1617097752.205001,1910572360.726499,6931152675.829794,939149,123894,446444,1509487
2012-11-16,BATS BZX (Z),315909812,174705008,237634229,728249049,8647894971.383503,10986421874.298907,7291518117.930229,26925834963.612639,1918834,584005,1210897,3713736
2012-11-15,NYSE MKT (A),0,12857414,4552484,17409898,0.000000,88196788.260200,43318374.318800,131515162.579000,0,30272,14475,44747
2012-11-15,NASDAQ BX (B),93200120,37434989,52979364,183614473,2389097112.265200,2042497469.159997,1679189642.638598,6110784224.063795,608292,122629,318473,1049394
2012-11-15,NSX (C),11778393,4148714,8981379,24908486,300100494.018400,140999740.512600,271542100.077001,712642334.608001,47016,9704,28175,84895
2012-11-15,NYSE (DN),115994729,24268300,63333313,203596342,3457724907.051673,1134611942.872696,2023064168.244785,6615401018.169154,724783,99042,343974,1167799
2012-11-15,NASDAQ (DQ),1169251854,401294798,683255898,2253802550,29584487804.445700,17702967182.417695,19393341368.012151,66680796354.875546,3283379,627964,1623968,5535311
2012-11-15,EDGA (J),67151947,44584665,38080773,149817385,1582431735.443799,2062836267.302002,909007570.708001,4554275573.453802,390047,130301,199484,719832
2012-11-15,EDGX (K),273416064,95861722,172489659,541767445,7276898344.320895,3898433449.104200,5106202602.630082,16281534396.055177,1327780,253869,725942,2307591
2012-11-15,CHX (M),11450323,11935289,5380365,28765977,379282089.671600,922076417.785400,174564334.431500,1475922841.888500,378,2253,503,3134
2012-11-15,NYSE (N),779381365,0,0,779381365,23580891993.396843,0.000000,0.000000,23580891993.396843,2453008,0,0,2453008
2012-11-15,NYSE Arca (P),444675114,283405141,235519500,963599755,12790268192.924493,14681637984.737635,8532744485.376793,36004650663.038921,2472132,612244,1162627,4247003
2012-11-15,NASDAQ (Q),476791011,189222794,464486533,1130500338,14185542989.794758,11049549668.605469,14244722173.531681,39479814831.931908,2818864,578541,1982334,5379739
2012-11-15,CBSX (W),16323777,5972295,8665029,30961101,298999777.280000,300614190.010000,163452458.100000,763066425.390000,101306,15002,56462,172770
2012-11-15,NASDAQ PSX (X),27569760,23843315,25418232,76831307,501129119.750000,1484293462.625000,516778530.875000,2502201113.250000,104038,46392,68749,219179
2012-11-15,BATS BYX (Y),134632863,36150548,63873980,234657391,3275069286.179999,1624629004.005999,1594957429.594701,6494655719.780699,912581,130297,408269,1451147
2012-11-15,BATS BZX (Z),307953512,171432241,214061164,693446917,8404303050.234882,9674942723.989708,6101111936.687131,24180357710.911721,1875814,544012,1111872,3531698
2012-11-14,NYSE MKT (A),0,10805369,5107167,15912536,0.000000,77222951.846900,59205356.588000,136428308.434900,0,27075,18430,45505
2012-11-14,NASDAQ BX (B),97841095,34605295,50187283,182633673,2401730409.984599,1961599421.320497,1544054812.508998,5907384643.814094,617379,120388,316833,1054600
2012-11-14,NSX (C),14539402,4879475,8854148,28273025,352982625.729100,202051250.130500,250573461.668400,805607337.528000,50726,10696,28169,89591
2012-11-14,NYSE (DN),125001529,19959436,64810493,209771458,3383576251.674478,921115939.024099,1804460423.156581,6109152613.855158,748624,88218,336952,1173794
2012-11-14,NASDAQ (DQ),1214620886,409016547,691880283,2315517716,29074461112.224320,20216815037.340324,19689339389.108951,68980615538.673595,3277191,588457,1547255,5412903
2012-11-14,EDGA (J),73881060,37405194,37517739,148803993,1628560888.987502,1784392498.533200,892596032.946800,4305549420.467502,402201,115672,200171,718044
2012-11-14,EDGX (K),283390678,96811350,175642762,555844790,7205947547.514187,4242283321.866301,4813587689.784001,16261818559.164489,1259700,257917,703895,2221512
2012-11-14,CHX (M),8350870,12838955,4401415,25591240,268230624.233700,1039738408.868000,203012425.858000,1510981458.959700,402,2014,405,2821
2012-11-14,NYSE (N),830254452,0,0,830254452,24621743466.443943,0.000000,0.000000,24621743466.443943,2371828,0,0,2371828
2012-11-14,NYSE Arca (P),454515837,261920123,253120625,969556585,13022361074.453284,14652186063.659584,7990766117.285400,35665313255.398268,2435186,601951,1188442,4225579
2012-11-14,NASDAQ (Q),493012203,186433086,503025769,1182471058,14720129506.997659,11826161259.416207,14757371040.228185,41303661806.642051,2805097,568841,1976474,5350412
2012-11-14,CBSX (W),16748731,5119391,8274507,30142629,311402947.050000,226606128.290000,152230166.710000,690239242.050000,106148,12609,54868,173625
2012-11-14,NASDAQ PSX (X),29468310,22874166,30053458,82395934,546694022.790000,1363003253.145000,638464776.455000,2548162052.390000,106380,44072,78970,229422
2012-11-14,BATS BYX (Y),141226956,32251685,66236384,239715025,3319420566.119100,1689257147.645000,1631550513.110007,6640228226.874107,920158,132482,424812,1477452
2012-11-14,BATS BZX (Z),327283482,170038504,229889016,727211002,8602525568.436570,10206664220.467402,6040317790.189898,24849507579.093870,1911628,538165,1155043,3604836
2012-11-13,NYSE MKT (A),0,7770516,5412854,13183370,0.000000,54705421.695700,93437906.826000,148143328.521700,0,20244,15000,35244
2012-11-13,NASDAQ BX (B),82881840,28651391,47672062,159205293,1998085245.115000,1537378735.602500,1426182462.496298,4961646443.213798,517667,93105,290664,901436
2012-11-13,NSX (C),10821524,2727323,7761153,21310000,274369591.071300,111010307.725300,219828806.725200,605208705.521800,37962,6922,24052,68936
2012-11-13,NYSE (DN),109577299,17234818,52458307,179270424,3013327719.628321,778952782.176500,1659276862.262998,5451557364.067819,634600,69821,292927,997348
2012-11-13,NASDAQ (DQ),1043867779,275775065,580500408,1900143252,25883649042.022659,12794114707.007604,16483500996.330969,55161264745.361232,2818755,425443,1385425,4629623
2012-11-13,EDGA (J),65697332,32865023,35801171,134363526,1461869653.088900,1538459246.014401,845569113.610400,3845898012.713701,355613,95204,184042,634859
2012-11-13,EDGX (K),233910821,68424688,158078662,460414171,6241514214.453877,2809336120.110102,4558890116.688800,13609740451.252779,1086356,185321,643856,1915533
2012-11-13,CHX (M),9066047,7300690,5136871,21503608,318763704.700800,493144444.911900,224575491.422200,1036483641.034900,629,1258,388,2275
2012-11-13,NYSE (N),677438422,0,0,677438422,20712370348.801421,0.000000,0.000000,20712370348.801421,2092607,0,0,2092607
2012-11-13,NYSE Arca (P),372029871,197835540,208344947,778210358,10489041013.293254,10529426891.277295,6851954312.826615,27870422217.397164,1992836,450760,959511,3403107
2012-11-13,NASDAQ (Q),416746643,141170629,432845687,990762959,12389636166.638811,8399063305.394790,12942151393.934005,33730850865.967606,2374576,453466,1704527,4532569
2012-11-13,CBSX (W),15122474,4477428,8098076,27697978,305455708.940000,210552295.280000,148195686.920000,664203691.140000,98089,10471,52423,160983
2012-11-13,NASDAQ PSX (X),21816556,16853996,26453406,65123958,390463417.955000,1151499689.850000,540464553.880000,2082427661.685000,80295,34424,62998,177717
2012-11-13,BATS BYX (Y),125446180,25269059,60551273,211266512,2912449084.737497,1283632790.743000,1506310650.465601,5702392525.946098,797207,99660,373765,1270632
2012-11-13,BATS BZX (Z),271919720,124455494,196024040,592399254,7329700754.015511,7263776117.840221,5260596747.034906,19854073618.890638,1605830,409762,972600,2988192
2012-11-12,NYSE MKT (A),0,6263777,3580554,9844331,0.000000,47143789.242900,38993962.879000,86137752.121900,0,15755,14303,30058
2012-11-12,NASDAQ BX (B),67840436,20127564,35006125,122974125,1711280911.494001,1094156067.309200,1128006991.200499,3933443970.003700,437324,71391,228095,736810
2012-11-12,NSX (C),8042285,2786328,4912561,15741174,194838244.213200,105875331.247600,149276783.253200,449990358.714000,30403,5817,17498,53718
2012-11-12,NYSE (DN),83110888,13998831,42678608,139788327,2370829661.562100,637653317.219300,1373254866.901587,4381737845.682987,489601,54733,240845,785179
2012-11-12,NASDAQ (DQ),780353386,229849010,462057692,1472260088,20332569029.529823,11012273758.661386,14356416755.590379,45701259543.781588,2305656,349517,1199922,3855095
2012-11-12,EDGA (J),53573556,23176132,26247532,102997220,1286853118.628600,1126547199.179600,664463843.377100,3077864161.185300,307257,75208,150640,533105
2012-11-12,EDGX (K),198798976,51345877,128141374,378286227,5543439141.998913,2015074336.988203,3828972895.277311,11387486374.264427,983990,132950,533285,1650225
2012-11-12,CHX (M),6895956,4720793,7227966,18844715,273087080.112200,373954181.191400,411901786.264500,1058943047.568100,351,1082,395,1828
2012-11-12,NYSE (N),291945746,0,0,291945746,8888631085.740094,0.000000,0.000000,8888631085.740094,844727,0,0,844727
2012-11-12,NYSE Arca (P),325348472,129628453,149532056,604508981,9726774543.648653,7240223501.488612,5103664009.012593,22070662054.149858,1851219,310960,762539,2924718
2012-11-12,NASDAQ (Q),366009303,85937212,307605602,759552117,11624675498.902883,5341507500.614096,9572217152.734587,26538400152.251566,2209735,292500,1395513,3897748
2012-11-12,CBSX (W),13722969,3579219,6926791,24228979,273082185.810000,187967908.540000,135115757.350000,596165851.700000,90273,9041,44816,144130
2012-11-12,NASDAQ PSX (X),19242793,10904949,17080979,47228721,360954261.600000,708426775.020000,336563838.125000,1405944874.745000,73873,21947,46994,142814
2012-11-12,BATS BYX (Y),96377490,18281854,45698845,160358189,2392619344.120800,906665937.080000,1153883221.632698,4453168502.833498,634591,75313,300270,1010174
2012-11-12,BATS BZX (Z),256927097,81067938,147466099,485461134,7254299876.050794,4676824588.376599,4144938363.241201,16076062827.668594,1561092,270206,787390,2618688
2012-11-09,NYSE MKT (A),0,9434883,3662780,13097663,0.000000,67386416.006500,42358881.470000,109745297.476500,0,21568,15144,36712
2012-11-09,NASDAQ BX (B),86336509,34421255,43184152,163941916,2213451007.752998,1923607298.765001,1577072899.523500,5714131206.041499,539946,121071,267230,928247
2012-11-09,NSX (C),11285109,3011220,7466086,21762415,279957355.222400,115780652.562000,253004354.298500,648742362.082900,40183,7994,22840,71017
2012-11-09,NYSE (DN),107665732,19816752,50502472,177984956,2992622606.165704,989900316.183201,1886992214.696903,5869515137.045808,613864,81418,285206,980488
2012-11-09,NASDAQ (DQ),1063193273,342264746,598351357,2003809376,27930714985.974780,17281811469.543454,18462343444.806491,63674869900.324725,2798250,499695,1380360,4678305
2012-11-09,EDGA (J),70989847,39412468,31587008,141989323,1587184951.744900,1965462809.563596,893107984.502100,4445755745.810596,381813,126178,171192,679183
2012-11-09,EDGX (K),255388908,94385807,154518136,504292851,6807415005.157002,4269916620.389801,5056648894.866697,16133980520.413500,1207766,242275,669270,2119311
2012-11-09,CHX (M),11224811,7879750,4160661,23265222,402547957.934700,563457329.919800,295168005.116000,1261173292.970500,377,2354,445,3176
2012-11-09,NYSE (N),740129460,0,0,740129460,23083386166.993805,0.000000,0.000000,23083386166.993805,2287086,0,0,2287086
2012-11-09,NYSE Arca (P),388638300,254207914,196541284,839387498,11284341140.342878,14850617532.962180,8066622000.369546,34201580673.674604,2115729,553365,988391,3657485
2012-11-09,NASDAQ (Q),448955780,179060057,435116944,1063132781,13835181663.172287,11491914471.219079,14664125077.919983,39991221212.311349,2674525,567858,1871045,5113428
2012-11-09,CBSX (W),15483103,6324643,7899641,29707387,336427392.010000,344938578.460000,148168260.420000,829534230.890000,102463,16079,49523,168065
2012-11-09,NASDAQ PSX (X),22260183,22340119,20396596,64996898,419549109.080000,1511076273.560000,412947140.035000,2343572522.675000,82195,38775,52759,173729
2012-11-09,BATS BYX (Y),124777332,31125657,59418000,215320989,3060296186.260006,1610169125.984999,1509867877.432897,6180333189.677902,813679,125556,375009,1314244
2012-11-09,BATS BZX (Z),301605685,158650647,196766451,657022783,8384987252.934500,9682240165.655558,5948639625.088098,24015867043.678156,1793460,516090,1018161,3327711
2012-11-08,NYSE MKT (A),0,9979461,4315551,14295012,0.000000,69508204.121600,55364154.180000,124872358.301600,0,23376,17126,40502
2012-11-08,NASDAQ BX (B),97068059,35447049,50309521,182824629,2451720720.246999,1954538779.196498,1870228595.452500,6276488094.895997,600084,127557,319645,1047286
2012-11-08,NSX (C),12708599,3981149,7885399,24575147,296567142.535300,145023729.724600,277023426.730900,718614298.990800,43012,8745,26982,78739
2012-11-08,NYSE (DN),109369069,21840424,53323626,184533119,3235976832.930798,1059163351.493100,2136417435.252198,6431557619.676096,658867,87622,298388,1044877
2012-11-08,NASDAQ (DQ),1071047913,349972669,587068373,2008088955,29559429885.422388,17570796511.464673,20338351029.488732,67468577426.375793,2821923,535260,1405628,4762811
2012-11-08,EDGA (J),70178016,41338044,36447871,147963931,1659570010.011400,1868300382.182000,1228094796.644700,4755965188.838100,388598,123299,202496,714393
2012-11-08,EDGX (K),270317053,101200854,171621361,543139268,7356998028.245791,4616994423.312490,5839109834.246997,17813102285.805278,1259181,269819,746111,2275111
2012-11-08,CHX (M),11101168,9760219,5169048,26030435,345119039.890500,685252351.354600,488109308.719800,1518480699.964900,854,1666,438,2958
2012-11-08,NYSE (N),758546195,0,0,758546195,23520968443.587194,0.000000,0.000000,23520968443.587194,2332875,0,0,2332875
2012-11-08,NYSE Arca (P),414557330,257463764,202509916,874531010,12007200386.996962,14580179155.065237,8438942734.333406,35026322276.395605,2197838,570765,1038609,3807212
2012-11-08,NASDAQ (Q),464431528,179127782,458816598,1102375908,14396419304.743248,11210224348.900816,15416678215.166863,41023321868.810927,2712191,571018,1951780,5234989
2012-11-08,CBSX (W),18447248,5765830,8241465,32454543,370750812.950000,312286221.430000,162090461.990000,845127496.370000,117050,15277,53734,186061
2012-11-08,NASDAQ PSX (X),25514829,23593474,23180916,72289219,459946691.510000,1327007844.220000,474399635.265000,2261354170.995000,89955,38595,58761,187311
2012-11-08,BATS BYX (Y),131435828,34526878,63676535,229639241,3282992721.257898,1738647225.274500,1751956976.298300,6773596922.830698,865324,129442,409705,1404471
2012-11-08,BATS BZX (Z),326027842,178880958,215936765,720845565,9031068875.365992,10913666261.418982,6607800922.751514,26552536059.536488,1889231,555228,1105522,3549981
2012-11-07,NYSE MKT (A),0,9453248,4322323,13775571,0.000000,69817329.380300,46374665.660000,116191995.040300,0,22044,14227,36271
2012-11-07,NASDAQ BX (B),108297285,45442349,52672029,206411663,2908927036.301501,2572841765.729001,2020078027.177603,7501846829.208105,675258,147025,331992,1154275
2012-11-07,NSX (C),16321325,4611494,8760661,29693480,400529431.733400,217981204.989100,300777177.695700,919287814.418200,53065,10176,29293,92534
2012-11-07,NYSE (DN),130354797,29334098,57918823,217607718,3744981671.802710,1501629566.672498,1998300366.625330,7244911605.100538,783734,114009,336157,1233900
2012-11-07,NASDAQ (DQ),1198981422,430903664,629057114,2258942200,31588622174.315717,24270641978.253570,19921869380.082032,75781133532.651319,3360384,672277,1596742,5629403
2012-11-07,EDGA (J),79463170,44799360,38619121,162881651,1883808093.911598,2241616771.081803,996857549.840799,5122282414.834200,444746,137861,215672,798279
2012-11-07,EDGX (K),325659080,114438438,190697149,630794667,8887342385.866212,5378305187.077900,5921720552.376483,20187368125.320595,1472554,305802,835751,2614107
2012-11-07,CHX (M),19422184,8880115,4677385,32979684,372382495.003300,633923972.798000,323314244.873100,1329620712.674400,484,2745,564,3793
2012-11-07,NYSE (N),878085034,0,0,878085034,27307573993.213908,0.000000,0.000000,27307573993.213908,2629400,0,0,2629400
2012-11-07,NYSE Arca (P),476388614,309258543,229092623,1014739780,13879753530.806972,18774328212.176323,8486867142.630412,41140948885.613707,2547817,661485,1172034,4381336
2012-11-07,NASDAQ (Q),530982778,223352557,499670256,1254005591,16499295755.864224,14634678981.271377,15866041011.864445,47000015749.000046,3138039,689460,2225896,6053395
2012-11-07,CBSX (W),19029465,5641313,9980590,34651368,387844847.860000,257225280.980000,205833872.810000,850904001.650000,118086,14282,62077,194445
2012-11-07,NASDAQ PSX (X),31726066,26798624,27721588,86246278,594850004.975000,1693645192.990000,556232129.515000,2844727327.480000,111568,48361,71555,231484
2012-11-07,BATS BYX (Y),160609035,41124312,72380629,274113976,4040093417.904600,2096165391.680501,1816723531.212800,7952982340.797901,1036348,155075,459071,1650494
2012-11-07,BATS BZX (Z),381840682,211831726,247820506,841492914,10810842697.673106,13901965947.888983,6999248315.200303,31712056960.762392,2256714,666427,1282787,4205928
2012-11-06,NYSE MKT (A),0,8665217,3944983,12610200,0.000000,59526338.266700,58405117.027000,117931455.293700,0,19484,16195,35679
2012-11-06,NASDAQ BX (B),83126194,28143270,47382469,158651933,2196247340.872002,1408655594.880000,1388701655.892800,4993604591.644802,545464,93625,296306,935395
2012-11-06,NSX (C),11427119,3177140,9849713,24453972,284371396.599800,114050369.344100,194857845.258900,593279611.202800,38523,7065,25151,70739
2012-11-06,NYSE (DN),109173721,19308226,55802700,184284647,3300324633.282396,931715564.945001,1641035467.500503,5873075665.727900,680030,78969,312823,1071822
2012-11-06,NASDAQ (DQ),969252815,256995646,575832800,1802081261,26700255838.012024,11764363616.015856,14817462564.856551,53282082018.884431,2748365,435880,1427893,4612138
2012-11-06,EDGA (J),63604454,30343629,36579385,130527468,1539085387.976400,1382440530.700899,836409267.472803,3757935186.150102,376009,95173,193920,665102
2012-11-06,EDGX (K),236190523,72123831,167928719,476243073,6748251532.701890,2855717910.699897,4495194087.988031,14099163531.389818,1113534,184468,687225,1985227
2012-11-06,CHX (M),8456191,7129210,3832973,19418374,325086747.811500,611827930.760000,371531294.318200,1308445972.889700,303,1388,447,2138
2012-11-06,NYSE (N),672955492,0,0,672955492,21685669675.920952,0.000000,0.000000,21685669675.920952,2060233,0,0,2060233
2012-11-06,NYSE Arca (P),339883298,180922506,193476488,714282292,10346072363.604899,9875203550.503208,6144087940.547479,26365363854.655586,1900335,400655,968422,3269412
2012-11-06,NASDAQ (Q),391727027,124993141,413841241,930561409,12458339687.368116,7492026585.757799,12784691298.495282,32735057571.621197,2328064,400137,1831860,4560061
2012-11-06,CBSX (W),19062950,5794691,10814597,35672238,407528005.150000,260023847.140000,194901069.878800,862452922.168800,127570,14308,68447,210325
2012-11-06,NASDAQ PSX (X),20556136,13670029,21625378,55851543,394902016.825000,799820156.190000,394106301.610000,1588828474.625000,80384,28159,58996,167539
2012-11-06,BATS BYX (Y),121335509,25389075,61396015,208120599,3111153290.767504,1298403835.614600,1478427474.455903,5887984600.838007,805833,103191,382875,1291899
2012-11-06,BATS BZX (Z),260793867,115652944,189296344,565743155,7462927353.368191,6878179371.098204,5093062732.142790,19434169456.609185,1586800,370055,1001762,2958617
2012-11-05,NYSE MKT (A),0,8455953,3719272,12175225,0.000000,65776625.698400,45178344.988000,110954970.686400,0,19883,14491,34374
2012-11-05,NASDAQ BX (B),74108170,23166930,40323136,137598236,1957322171.940000,1222974336.765001,1290421676.289999,4470718184.995000,484512,75017,260429,819958
2012-11-05,NSX (C),8470427,2729862,6218500,17418789,216928116.809700,103031659.981600,202406906.371800,522366683.163100,32723,6067,20642,59432
2012-11-05,NYSE (DN),107238327,13812101,53754120,174804548,3237124896.367676,682375580.822299,1613274882.389512,5532775359.579487,659193,56499,298213,1013905
2012-11-05,NASDAQ (DQ),833343154,230088215,483329165,1546760534,22319442416.249663,11192248699.581508,14468367162.666835,47980058278.498006,2544424,380699,1271596,4196719
2012-11-05,EDGA (J),56944047,22801740,30063544,109809331,1398665811.674900,1078690947.408100,774863108.950901,3252219868.033901,338129,73004,167675,578808
2012-11-05,EDGX (K),200621919,57406866,130606120,388634905,5840833707.093900,2338792008.393299,4117628292.900508,12297254008.387707,1020740,152345,579427,1752512
2012-11-05,CHX (M),10757630,4112815,6781913,21652358,309736426.536200,332192422.174200,480371028.349500,1122299877.059900,307,1042,367,1716
2012-11-05,NYSE (N),600729136,0,0,600729136,19256783744.665807,0.000000,0.000000,19256783744.665807,1877548,0,0,1877548
2012-11-05,NYSE Arca (P),299116069,152351907,156557049,608025025,8824342746.419795,8765778727.863502,5801186566.408809,23391308040.692106,1669442,341919,822939,2834300
2012-11-05,NASDAQ (Q),340697579,102487995,350292357,793477931,10947628844.934209,6173772518.363994,11520871466.863864,28642272830.162067,2108895,336244,1597418,4042557
2012-11-05,CBSX (W),17819776,6027569,10399120,34246465,385192536.450000,333953584.230000,196721561.147400,915867681.827400,122461,13898,63504,199863
2012-11-05,NASDAQ PSX (X),20226582,12732819,17007005,49966406,378615809.870000,677590798.315000,340648439.935000,1396855048.120000,76612,22734,48462,147808
2012-11-05,BATS BYX (Y),113327837,19202725,54032920,186563482,2979792830.834998,978637221.317600,1351365299.330004,5309795351.482602,779396,77567,352980,1209943
2012-11-05,BATS BZX (Z),238019246,93164523,158009253,489193022,6890126305.027701,5467917491.392509,4547778683.223101,16905822479.643311,1465810,300781,866550,2633141
2012-11-02,NYSE MKT (A),0,8430476,5772353,14202829,0.000000,59566417.228900,105852402.592000,165418819.820900,0,18868,15610,34478
2012-11-02,NASDAQ BX (B),90468764,29532685,48563339,168564788,2388120401.847799,1625301224.090000,1661394880.611001,5674816506.548800,570902,96458,303819,971179
2012-11-02,NSX (C),12835506,3464194,7804754,24104454,345397230.841400,177410658.692200,255777667.717400,778585557.251000,46377,7421,24820,78618
2012-11-02,NYSE (DN),113070280,18548523,58496082,190114885,3481948173.994804,903244544.081401,2067291796.406709,6452484514.482914,684771,79100,317222,1081093
2012-11-02,NASDAQ (DQ),1147087129,273123511,605847565,2026058205,33196274929.794550,13899660210.591116,17963713848.397855,65059648988.783521,2909177,437493,1472536,4819206
2012-11-02,EDGA (J),71008539,30883880,36538492,138430911,1718379425.055001,1476398076.767200,929498706.370301,4124276208.192502,401813,104488,195258,701559
2012-11-02,EDGX (K),254033085,76872303,162802571,493707959,7380580398.770577,3349995688.188602,5254547568.396899,15985123655.356078,1230030,202879,699713,2132622
2012-11-02,CHX (M),7080959,9004505,2696526,18781990,295382388.737200,617059196.036400,114312241.787500,1026753826.561100,369,2210,373,2952
2012-11-02,NYSE (N),793038787,0,0,793038787,25371515111.772216,0.000000,0.000000,25371515111.772216,2291112,0,0,2291112
2012-11-02,NYSE Arca (P),376799274,205608426,190043463,772451163,11528306863.371819,11798307627.729421,7264360173.814919,30590974664.916159,2069805,466216,958471,3494492
2012-11-02,NASDAQ (Q),420337672,144026632,439251066,1003615370,13550102296.889266,9117076846.993408,14575324414.004489,37242503557.887163,2528064,474436,1877868,4880368
2012-11-02,CBSX (W),20039892,5414856,11159873,36614621,441629604.820000,325238349.810000,211181612.247000,978049566.877000,130664,13620,60403,204687
2012-11-02,NASDAQ PSX (X),22480968,16662219,19887338,59030525,449665122.745000,1128081287.340000,429710155.305000,2007456565.390000,90731,32589,55605,178925
2012-11-02,BATS BYX (Y),131175428,25039371,61871072,218085871,3344907118.518700,1318672702.064101,1592591540.695202,6256171361.278003,869786,99849,392799,1362434
2012-11-02,BATS BZX (Z),294249814,134231523,193841081,622322418,8541538688.875190,8382922863.721703,5701143554.059383,22625605106.656276,1791552,441755,1044603,3277910
2012-11-01,NYSE MKT (A),0,10473685,3512608,13986293,0.000000,80405617.519400,39672936.411000,120078553.930400,0,20928,13953,34881
2012-11-01,NASDAQ BX (B),108895206,33252895,54584023,196732124,2872981914.250005,1706413285.344999,1662853873.357502,6242249072.952506,689520,104226,342644,1136390
2012-11-01,NSX (C),11976720,3520459,9448378,24945557,329171116.852600,135763642.753000,203516111.361800,668450870.967400,45469,7755,24490,77714
2012-11-01,NYSE (DN),141779650,20827566,63127280,225734496,4374918619.348992,969286473.926204,1930391057.087584,7274596150.362780,846714,89559,362206,1298479
2012-11-01,NASDAQ (DQ),1175774645,358202712,606597587,2140574944,32924837585.350308,18864695812.345016,16267610627.374580,68057144025.069904,3350022,430380,1527893,5308295
2012-11-01,EDGA (J),77816136,32913905,39588036,150318077,1963119335.122599,1554232238.204300,955682433.665499,4473034006.992398,444750,100804,212919,758473
2012-11-01,EDGX (K),260750920,77318634,160197230,498266784,7946559673.521502,3357752007.512898,4617060768.493633,15921372449.528033,1314880,190838,685584,2191302
2012-11-01,CHX (M),7083056,9509335,3243011,19835402,258344255.993000,553400860.184800,205688517.315400,1017433633.493200,326,2059,416,2801
2012-11-01,NYSE (N),797529844,0,0,797529844,26092803948.302664,0.000000,0.000000,26092803948.302664,2366406,0,0,2366406
2012-11-01,NYSE Arca (P),391411781,194277031,193564514,779253326,12429784386.033088,10772798878.934101,6491348107.051801,29693931372.018990,2174733,431151,936655,3542539
2012-11-01,NASDAQ (Q),455777350,134742988,467064442,1057584780,14734373307.731087,8437533535.422491,14191126899.746595,37363033742.900173,2668536,424476,1836845,4929857
2012-11-01,CBSX (W),21993645,8144843,12271660,42410148,476215296.910000,395676663.530000,330412498.914100,1202304459.354100,138876,13322,68819,221017
2012-11-01,NASDAQ PSX (X),22571717,12962783,20235154,55769654,448349810.825000,811512197.370000,421569433.365000,1681431441.560000,88558,27754,51874,168186
2012-11-01,BATS BYX (Y),144782450,24641251,65102552,234526253,3903681599.679992,1235797324.291600,1667619186.122699,6807098110.094291,978528,95319,421268,1495115
2012-11-01,BATS BZX (Z),312863546,127078018,197110178,637051742,9193120636.132519,7593683656.009180,5342391455.698911,22129195747.840610,1875717,395510,1036187,3307414
2012-10-31,NYSE MKT (A),0,12288156,6979593,19267749,0.000000,95935305.894700,120607149.084000,216542454.978700,0,23846,18850,42696
2012-10-31,NASDAQ BX (B),105477701,31132481,50497777,187107959,2887678356.454997,1519722767.457199,1697262220.690002,6104663344.602198,666751,108452,325759,1100962
2012-10-31,NSX (C),9804572,3208186,8797952,21810710,268970626.303800,104856551.342800,209192313.581600,583019491.228200,40687,7965,24149,72801
2012-10-31,NYSE (DN),128666040,12335660,61137172,202138872,3852424365.172766,551676985.249401,1929236322.021685,6333337672.443852,800725,59027,350850,1210602
2012-10-31,NASDAQ (DQ),972107775,288410970,575972115,1836490860,26956870289.126304,12164431192.543888,16475647186.043277,55596948667.713469,2985691,416212,1389425,4791328
2012-10-31,EDGA (J),67161211,27919244,33056127,128136582,1684096876.329002,1274533979.211199,924308506.008302,3882939361.548503,384766,89342,185548,659656
2012-10-31,EDGX (K),217664312,73775270,149275645,440715227,6583693702.738091,2905161567.845606,4443335289.176665,13932190559.760362,1149785,186880,605988,1942653
2012-10-31,CHX (M),3864758,6395418,4125626,14385802,181291492.938400,572294089.921900,131161270.881000,884746853.741300,867,1975,741,3583
2012-10-31,NYSE (N),852913208,0,0,852913208,28072276677.731123,0.000000,0.000000,28072276677.731123,2437003,0,0,2437003
2012-10-31,NYSE Arca (P),370522323,202241706,188787289,761551318,11410457941.526654,11441102624.406188,6575107398.962716,29426667964.895558,2108571,440479,975270,3524320
2012-10-31,NASDAQ (Q),411468260,129904363,461549174,1002921797,13171559073.296380,7689742577.594106,14670613600.403120,35531915251.293606,2487354,424423,1848083,4759860
2012-10-31,CBSX (W),20454057,7367013,10841301,38662371,450248518.480000,354599563.330000,214393256.160000,1019241337.970000,130448,13449,68055,211952
2012-10-31,NASDAQ PSX (X),19189262,12321245,18815554,50326061,386884150.920000,694014313.595000,389524317.740000,1470422782.255000,83560,25790,57338,166688
2012-10-31,BATS BYX (Y),127422774,24021378,61772556,213216708,3382247892.884900,1163047682.741100,1528662559.455398,6073958135.081398,879495,98923,401680,1380098
2012-10-31,BATS BZX (Z),270792241,112619348,183068797,566480386,8258393990.953807,6605068801.836412,5284791441.513227,20148254234.303446,1731732,373287,1018766,3123785
2012-10-26,NYSE MKT (A),0,9425111,4733001,14158112,0.000000,109287212.173000,55366862.668000,164654074.841000,0,19485,13419,32904
2012-10-26,NASDAQ BX (B),85515240,25678838,51744166,162938244,2234066768.977000,1452542503.091400,1924937538.572898,5611546810.641298,543949,88751,316421,949121
2012-10-26,NSX (C),9190082,2985296,8814124,20989502,236624665.761200,122450613.151200,295516862.989699,654592141.902099,34541,6388,24358,65287
2012-10-26,NYSE (DN),106236675,15363181,59095443,180695299,3055690539.728707,758889381.188201,2588952934.224184,6403532855.141092,650902,62392,330567,1043861
2012-10-26,NASDAQ (DQ),944306203,241395276,603006812,1788708291,25151816104.890928,13578149701.868966,21784842327.664100,60514808134.423994,2624392,360699,1376493,4361584
2012-10-26,EDGA (J),61153308,27843917,36955693,125952918,1533346398.161402,1354837278.072600,1139298790.041898,4027482466.275900,359248,86744,194942,640934
2012-10-26,EDGX (K),209834154,64257474,161022525,435114153,5841466747.531004,2859685757.181300,5938826501.173423,14639979005.885727,1027980,167596,656405,1851981
2012-10-26,CHX (M),9739350,6361802,5014769,21115921,238866534.749200,509789689.054000,384269760.346700,1132925984.149900,263,1990,574,2827
2012-10-26,NYSE (N),738287847,0,0,738287847,23735847594.978750,0.000000,0.000000,23735847594.978750,2041357,0,0,2041357
2012-10-26,NYSE Arca (P),344216975,186105657,200884138,731206770,10059731419.425635,10630222836.502198,9814289427.233190,30504243683.161023,1898433,418833,980768,3298034
2012-10-26,NASDAQ (Q),390625049,136406157,422995455,950026661,12399039275.142808,8993316466.703509,17052181986.628623,38444537728.474940,2367984,441849,1830115,4639948
2012-10-26,CBSX (W),16760994,3346155,10173665,30280814,347677151.040000,187354680.080000,203402305.610000,738434136.730000,109387,12279,63430,185096
2012-10-26,NASDAQ PSX (X),20708767,13420659,21161923,55291349,409731311.555000,889045054.080000,458860633.110000,1757636998.745000,83678,26707,62050,172435
2012-10-26,BATS BYX (Y),113484976,21300710,62681474,197467160,2865502140.674998,1129871400.540000,1739191695.923398,5734565237.138396,762699,85074,379825,1227598
2012-10-26,BATS BZX (Z),278969620,112497291,197667711,589134622,7787581784.074191,7099015461.039093,6900340506.963791,21786937752.077075,1683130,371526,1050955,3105611
2012-10-25,NYSE MKT (A),0,6943314,5696294,12639608,0.000000,56132616.958600,62419741.702100,118552358.660700,0,18481,16895,35376
2012-10-25,NASDAQ BX (B),92775076,25613568,56051659,174440303,2354483998.169996,1468896061.508699,1637358882.838492,5460738942.517187,604511,90331,337598,1032440
2012-10-25,NSX (C),9061858,2860847,9628844,21551549,237809945.131000,129465364.998600,199661256.802100,566936566.931700,33953,6340,22658,62951
2012-10-25,NYSE (DN),111273840,16144644,59291369,186709853,3381701624.996085,864231000.691301,1982519032.727691,6228451658.415077,666281,69103,316842,1052226
2012-10-25,NASDAQ (DQ),1070376600,242002202,644044588,1956423390,29393338589.755973,12041956496.107929,19201937156.999900,60637232242.863802,2846549,397807,1416523,4660879
2012-10-25,EDGA (J),68005572,32338591,39378176,139722339,1630092213.274501,1604008740.972101,979063219.417600,4213164173.664202,377522,98405,196941,672868
2012-10-25,EDGX (K),218582849,67623679,163486979,449693507,6368790218.232294,3057188233.414898,4933448642.365910,14359427094.013102,1069090,175294,605127,1849511
2012-10-25,CHX (M),11160059,13887640,8705882,33753581,452241206.110400,848033642.115900,543714880.122100,1843989728.348400,360,1363,489,2212
2012-10-25,NYSE (N),696047945,0,0,696047945,22678250537.607394,0.000000,0.000000,22678250537.607394,2142084,0,0,2142084
2012-10-25,NYSE Arca (P),366253526,185527806,222370248,774151580,11031860390.550303,10974463471.313019,8775141705.995691,30781465567.859013,1997377,428657,999032,3425066
2012-10-25,NASDAQ (Q),425089265,130826990,447065560,1002981815,13485943738.006496,8419784819.488315,15193597655.234651,37099326212.729462,2520721,423588,1811196,4755505
2012-10-25,CBSX (W),15930398,2613277,9010238,27553913,339800929.920000,160784854.900000,187397334.967600,687983119.787600,103429,11311,54811,169551
2012-10-25,NASDAQ PSX (X),21529018,14611728,23721673,59862419,418512059.160000,943581647.515000,468296831.560000,1830390538.235000,80586,29860,58112,168558
2012-10-25,BATS BYX (Y),112058307,23638203,57796248,193492758,2901630953.925000,1180485341.552000,1539100050.493802,5621216345.970802,731173,92574,350745,1174492
2012-10-25,BATS BZX (Z),301419299,119952685,217151180,638523164,8513451466.262784,7228305453.088208,5977361355.241581,21719118274.592573,1779809,380019,1057135,3216963
2012-10-24,NYSE MKT (A),0,7371621,3759253,11130874,0.000000,61540750.554300,43539065.278000,105079815.832300,0,19517,14148,33665
2012-10-24,NASDAQ BX (B),82510070,24806768,48180129,155496967,2072779868.647301,1263201566.654999,1532792993.363000,4868774428.665300,523580,83107,295669,902356
2012-10-24,NSX (C),9217457,2424933,10339670,21982060,231640324.295300,88216368.329600,216838566.429101,536695259.054001,33442,5378,21027,59847
2012-10-24,NYSE (DN),112626306,15452920,58526509,186605735,3380237478.535498,824279555.088101,1971906592.720905,6176423626.344504,657527,67143,315379,1040049
2012-10-24,NASDAQ (DQ),1006288239,233208402,648526894,1888023535,27680810592.677639,11563259939.424193,18846208079.790603,58090278611.892435,2835311,381410,1461923,4678644
2012-10-24,EDGA (J),68439543,28345939,37929792,134715274,1661709294.882502,1432290905.811200,941526749.698999,4035526950.392701,390333,94298,196219,680850
2012-10-24,EDGX (K),218991394,62927889,190471327,472390610,6270965530.187397,2772283294.171598,5233742482.648072,14276991307.007067,1058990,164772,639163,1862925
2012-10-24,CHX (M),11554179,7700848,5820337,25075364,331718054.126600,539394604.196000,339020175.452500,1210132833.775100,483,1882,329,2694
2012-10-24,NYSE (N),649594659,0,0,649594659,20962533962.593097,0.000000,0.000000,20962533962.593097,2022872,0,0,2022872
2012-10-24,NYSE Arca (P),363311227,179240174,225368063,767919464,10719141901.962257,9912161554.068886,7690142390.429654,28321445846.460797,1921882,419496,1028626,3370004
2012-10-24,NASDAQ (Q),412208127,127856699,460633365,1000698191,13015549572.789811,8128451667.103805,15110725080.239537,36254726320.133153,2446352,425694,1876279,4748325
2012-10-24,CBSX (W),15926381,5099008,9333803,30359192,347061538.990000,237037426.670000,183049271.990000,767148237.650000,102845,11175,54507,168527
2012-10-24,NASDAQ PSX (X),26325671,12514089,26845112,65684872,626697811.475000,783712303.380000,572732833.910000,1983142948.765000,117456,29167,84071,230694
2012-10-24,BATS BYX (Y),116404485,21767661,58922921,197095067,2964131144.754996,1088783925.989800,1540869303.930199,5593784374.674995,776174,88917,377148,1242239
2012-10-24,BATS BZX (Z),293152343,112556640,203131539,608840522,8306927212.469991,6880773924.720593,5887996704.852899,21075697842.043483,1733938,371010,1062908,3167856
2012-10-23,NYSE MKT (A),0,9501099,3463620,12964719,0.000000,57792309.362300,41116449.202000,98908758.564300,0,21176,12566,33742
2012-10-23,NASDAQ BX (B),92927789,35728154,50888254,179544197,2279923333.619899,1906355488.575201,1767608098.260200,5953886920.455300,566995,124961,311387,1003343
2012-10-23,NSX (C),8543228,3590934,8924525,21058687,231718753.897800,160100714.983600,215283839.093700,607103307.975100,33004,7888,20802,61694
2012-10-23,NYSE (DN),112604088,22733042,58904966,194242096,3353597375.502203,1128017035.355798,2068540955.344793,6550155366.202794,682998,91499,318178,1092675
2012-10-23,NASDAQ (DQ),1036606984,339914843,582962784,1959484611,27966364005.507037,18077050727.333270,18939311078.665607,64982725811.505914,2949102,523613,1442123,4914838
2012-10-23,EDGA (J),71000457,36090219,38588628,145679304,1686863949.787900,1725981416.451998,991072203.081499,4403917569.321397,396015,111217,199570,706802
2012-10-23,EDGX (K),234818636,93218315,172637202,500674153,6705761482.313086,4040889495.710808,5243413750.341111,15990064728.365005,1103813,234412,615020,1953245
2012-10-23,CHX (M),11231094,9009325,5806513,26046932,305170656.753600,535524119.072400,308737280.213700,1149432056.039700,452,1925,324,2701
2012-10-23,NYSE (N),670870430,0,0,670870430,21303643531.447590,0.000000,0.000000,21303643531.447590,2061562,0,0,2061562
2012-10-23,NYSE Arca (P),396633593,238479411,219203435,854316439,11636768152.724591,13645419946.408474,8331053051.388380,33613241150.521445,2043127,558931,1024389,3626447
2012-10-23,NASDAQ (Q),446728469,183220617,424817857,1054766943,13963524483.607487,11968821212.054400,14330826608.664245,40263172304.326132,2555218,566292,1810326,4931836
2012-10-23,CBSX (W),18108841,6089419,8124562,32322822,372479079.180000,292342299.640000,170388133.190000,835209512.010000,115611,14827,52335,182773
2012-10-23,NASDAQ PSX (X),26266685,20756182,22787630,69810497,495833654.085000,1331245803.355000,457979895.310000,2285059352.750000,92566,38651,54650,185867
2012-10-23,BATS BYX (Y),132425422,32724778,62018966,227169166,3314547358.939095,1540613052.765700,1703075930.599203,6558236342.303998,860968,122495,384423,1367886
2012-10-23,BATS BZX (Z),329371002,154472442,204210626,688054070,9102171668.789990,9477660602.193704,6258047352.294391,24837879623.278085,1844756,501231,1054474,3400461
2012-10-22,NYSE MKT (A),0,7819732,4203989,12023721,0.000000,51815436.405600,38101579.308000,89917015.713600,0,17435,14295,31730
2012-10-22,NASDAQ BX (B),84349581,31134641,44855073,160339295,2160236962.374999,1471340440.195000,1563658756.074202,5195236158.644201,520438,93382,278471,892291
2012-10-22,NSX (C),9416422,3403417,11310005,24129844,231761892.077000,119479081.986200,234332584.794199,585573558.857399,33051,7067,22460,62578
2012-10-22,NYSE (DN),105908195,18267221,54296583,178471999,3179240764.345192,825608069.766700,1816318822.424398,5821167656.536290,633971,74081,295594,1003646
2012-10-22,NASDAQ (DQ),910332080,276547161,540632411,1727511652,24534259545.236958,12010605337.540113,16472259985.776780,53017124868.553851,2546879,406998,1275012,4228889
2012-10-22,EDGA (J),63402121,33112861,35681276,132196258,1579288666.013897,1375064003.744400,944497392.382102,3898850062.140399,362983,90423,179034,632440
2012-10-22,EDGX (K),209270424,69409320,162521646,441201390,5614789541.251582,2782621838.521805,4360305177.805866,12757716557.579253,931021,168645,534121,1633787
2012-10-22,CHX (M),8430223,10355435,5356980,24142638,269265022.440100,630628202.673000,292581401.278000,1192474626.391100,368,1223,375,1966
2012-10-22,NYSE (N),634488677,0,0,634488677,20779013633.805613,0.000000,0.000000,20779013633.805613,1874863,0,0,1874863
2012-10-22,NYSE Arca (P),352415210,201177797,180488855,734081862,10352519580.895809,11100067832.574179,6862399113.239584,28314986526.709572,1822271,419880,855787,3097938
2012-10-22,NASDAQ (Q),397572007,142577708,378934693,919084408,12335750127.511426,8994821357.609293,12717529137.457421,34048100622.578140,2247281,426660,1580820,4254761
2012-10-22,CBSX (W),13498549,5939753,7138573,26576875,286730596.622400,229595519.530000,146528344.105000,662854460.257400,87770,11329,45028,144127
2012-10-22,NASDAQ PSX (X),24002516,16656966,19506899,60166381,481649226.470000,958974409.660000,389625488.765000,1830249124.895000,85909,28002,48683,162594
2012-10-22,BATS BYX (Y),114219474,26009952,49187047,189416473,2974453197.725000,1170725241.246301,1369757439.232701,5514935878.204002,732118,93577,307052,1132747
2012-10-22,BATS BZX (Z),289639850,122125821,174941504,586707175,8142889796.320013,7133283157.907786,5384704319.866091,20660877274.093890,1653717,384553,891492,2929762
2012-10-19,NYSE MKT (A),0,9734283,4062038,13796321,0.000000,71002711.001600,43225527.263000,114228238.264600,0,21649,12974,34623
2012-10-19,NASDAQ BX (B),98765281,35041844,55566402,189373527,2559498020.735900,2062245045.310000,2048745743.255401,6670488809.301301,591747,117077,321343,1030167
2012-10-19,NSX (C),9915185,3949911,10902331,24767427,278700806.362500,180926503.625100,284832143.559499,744459453.547099,36430,7498,24449,68377
2012-10-19,NYSE (DN),121142859,22190928,63870940,207204727,3685111787.375117,1116691906.614901,2235664172.489514,7037467866.479532,705781,90203,334754,1130738
2012-10-19,NASDAQ (DQ),1057868517,346100372,705609183,2109578072,28534528963.634038,18140917305.181954,22054220537.840553,68729666806.656545,2861695,501045,1508131,4870871
2012-10-19,EDGA (J),71168799,36434923,39737351,147341073,1695635815.669798,1775334915.365999,1034903381.172196,4505874112.207993,389561,99119,193858,682538
2012-10-19,EDGX (K),228881928,84386628,202454578,515723134,6391179974.282802,3840286867.377500,5468530573.500798,15699997415.161100,1022142,203009,641870,1867021
2012-10-19,CHX (M),14685117,10515322,6285552,31485991,409669639.544800,859733591.301400,533015053.671000,1802418284.517200,294,3143,434,3871
2012-10-19,NYSE (N),945540552,0,0,945540552,32705990527.628436,0.000000,0.000000,32705990527.628436,2025431,0,0,2025431
2012-10-19,NYSE Arca (P),395822232,234744564,228809455,859376251,12045780055.896215,14149463601.439676,9792398527.995985,35987642185.331876,2020238,513847,1048037,3582122
2012-10-19,NASDAQ (Q),433316460,174139208,601095885,1208551553,14077387367.871548,11745708590.410416,21961664265.158301,47784760223.440265,2460732,518248,1905017,4883997
2012-10-19,CBSX (W),18541295,5348126,9048694,32938115,486775983.516700,302574170.520000,202815161.350000,992165315.386700,120185,13665,56373,190223
2012-10-19,NASDAQ PSX (X),27409509,20287647,26911046,74608202,611686477.135000,1201910676.190000,567154457.330000,2380751610.655000,112147,37063,66025,215235
2012-10-19,BATS BYX (Y),136133771,29519967,67302492,232956230,3663366659.157996,1495508213.630003,1678706570.633296,6837581443.421295,880823,111694,388148,1380665
2012-10-19,BATS BZX (Z),323961391,151465612,223929172,699356175,9231583652.895584,9682846285.463592,7097988353.529297,26012418291.888473,1806229,464789,1078961,3349979
2012-10-18,NYSE MKT (A),0,11210375,4062408,15272783,0.000000,115201162.934900,49881517.639000,165082680.573900,0,24346,14417,38763
2012-10-18,NASDAQ BX (B),92158832,29036118,51813613,173008563,2461790312.297998,1594403484.070000,1923126662.777703,5979320459.145701,564128,98352,298928,961408
2012-10-18,NSX (C),11309052,3263676,12176363,26749091,291865839.487000,144083772.209300,281175975.272500,717125586.968800,39339,6311,25438,71088
2012-10-18,NYSE (DN),126239593,20061678,62470823,208772094,4004175256.578187,967670083.453301,2404221146.324001,7376066486.355489,731408,78611,325606,1135625
2012-10-18,NASDAQ (DQ),1137228011,268740334,691488678,2097457023,30590553625.559658,13701225943.569255,20407346318.713164,64699125887.842077,2866145,388572,1383872,4638589
2012-10-18,EDGA (J),74759027,31397788,40642397,146799212,1819670957.952300,1479658105.841300,1210747182.438901,4510076246.232501,407567,93922,191356,692845
2012-10-18,EDGX (K),247201746,67101709,192198352,506501807,7112374374.124501,2981464966.571700,5031526721.187482,15125366061.883683,1111951,168053,609852,1889856
2012-10-18,CHX (M),10070718,9030029,4629723,23730470,324337479.765600,708997588.990700,213527276.144400,1246862344.900700,352,1970,466,2788
2012-10-18,NYSE (N),719227526,0,0,719227526,22797707783.178340,0.000000,0.000000,22797707783.178340,2013153,0,0,2013153
2012-10-18,NYSE Arca (P),438610336,181929315,234731133,855270784,12559224266.461494,11217685850.998806,9044052697.971272,32820962815.431572,2121004,443049,1079962,3644015
2012-10-18,NASDAQ (Q),473746622,153920448,452966610,1080633680,14919577328.518761,11054766962.056019,15799155044.569772,41773499335.144552,2538141,468895,1757630,4764666
2012-10-18,CBSX (W),26037237,3279235,8664539,37981011,665701722.470000,160304281.650000,198392953.780000,1024398957.900000,136203,10624,56641,203468
2012-10-18,NASDAQ PSX (X),31068864,16380631,25664139,73113634,671042264.655000,1014178266.395000,505352842.260000,2190573373.310000,104299,28421,58139,190859
2012-10-18,BATS BYX (Y),144435645,26644466,63715069,234795180,4263368902.849202,1338999924.484601,1976028090.937991,7578396918.271794,952590,109414,392092,1454096
2012-10-18,BATS BZX (Z),348240411,124158675,214981464,687380550,9589703608.858797,7917769003.519800,6911328561.573598,24418801173.952195,1828057,387359,1027295,3242711
2012-10-17,NYSE MKT (A),0,7936066,3143228,11079294,0.000000,63276348.212600,41059871.022000,104336219.234600,0,18431,13233,31664
2012-10-17,NASDAQ BX (B),92432026,27878209,45325442,165635677,2412876196.285000,1418869751.683701,1466593088.542805,5298339036.511506,561392,91946,282677,936015
2012-10-17,NSX (C),10777306,2784448,10153575,23715329,284556586.552800,126252486.764500,243992667.615000,654801740.932300,38188,6045,23472,67705
2012-10-17,NYSE (DN),125578805,18900194,60279220,204758219,4005786410.674388,929406281.049099,1966463551.685085,6901656243.408572,752003,76182,332341,1160526
2012-10-17,NASDAQ (DQ),1084021970,303705548,583346415,1971073933,30423675835.119422,15563596895.976713,16474978662.319748,62462251393.415883,2857334,389698,1347026,4594058
2012-10-17,EDGA (J),73770610,31325078,33615276,138710964,1803585426.133000,1435216531.464202,819258699.083399,4058060656.680601,403264,80123,178267,661654
2012-10-17,EDGX (K),234912922,58428202,162841264,456182388,6590174013.116502,2636090573.580799,4081524948.204537,13307789534.901838,1008777,143311,545338,1697426
2012-10-17,CHX (M),15160836,9716208,2654360,27531404,445822629.825000,579604550.420900,252799994.995800,1278227175.241700,295,1665,437,2397
2012-10-17,NYSE (N),688330191,0,0,688330191,22669151176.563179,0.000000,0.000000,22669151176.563179,1841202,0,0,1841202
2012-10-17,NYSE Arca (P),410320730,188759067,194370851,793450648,12120671441.555907,11272929876.560584,6923647493.888456,30317248812.004947,2025558,397484,961062,3384104
2012-10-17,NASDAQ (Q),435096833,136022661,418055791,989175285,13748725551.397946,9111347389.944704,13123278912.456821,35983351853.799471,2326818,400464,1630221,4357503
2012-10-17,CBSX (W),20243525,4551408,8212848,33007781,579388636.890000,237268335.040000,207873058.330000,1024530030.260000,132057,11135,56489,199681
2012-10-17,NASDAQ PSX (X),25819269,14556944,20559948,60936161,562048729.320000,755273945.237500,407234218.347500,1724556892.905000,100819,24109,51627,176555
2012-10-17,BATS BYX (Y),134796258,25546353,57429237,217771848,3962687949.922099,1251951005.456000,1630121368.482205,6844760323.860304,903783,98137,377386,1379306
2012-10-17,BATS BZX (Z),304674561,112258743,181109901,598043205,8577682125.129221,6560871688.502093,5434789960.864983,20573343774.496297,1650225,327547,919837,2897609
2012-10-16,NYSE MKT (A),0,8916814,2754018,11670832,0.000000,59715928.790500,34363574.437000,94079503.227500,0,18306,11862,30168
2012-10-16,NASDAQ BX (B),90808981,29825487,46352812,166987280,2259536825.859599,1395613245.463000,1430191611.669102,5085341682.991701,534634,91423,270434,896491
2012-10-16,NSX (C),10310187,3468145,9603427,23381759,262684516.180500,144039634.071100,246995797.881001,653719948.132601,35038,6655,20234,61927
2012-10-16,NYSE (DN),124032489,20084299,58926759,203043547,3795205051.385571,1018205263.309203,1878535596.709395,6691945911.404169,732204,78842,302162,1113208
2012-10-16,NASDAQ (DQ),1092683109,265160761,578023725,1935867595,28866012368.223729,11894376594.788985,15725057401.240518,56485446364.253232,2760880,387195,1242468,4390543
2012-10-16,EDGA (J),65739460,30492900,35725835,131958195,1555074121.852100,1404790730.760000,801697430.582000,3761562283.194100,355212,80740,164579,600531
2012-10-16,EDGX (K),231030639,63709057,175480274,470219970,6382928068.473098,2814193153.879501,4150990071.414821,13348111293.767420,985622,150094,511068,1646784
2012-10-16,CHX (M),18015704,9609956,4878025,32503685,543962343.342600,636510179.520000,340839068.079600,1521311590.942200,654,1426,602,2682
2012-10-16,NYSE (N),641090461,0,0,641090461,19950309840.048039,0.000000,0.000000,19950309840.048039,1772579,0,0,1772579
2012-10-16,NYSE Arca (P),410251360,178656897,194139483,783047740,11749977588.201554,9649112744.958384,6819289887.057601,28218380220.217539,1924036,385566,876004,3185606
2012-10-16,NASDAQ (Q),409939466,126581400,380793280,917314146,12652035763.263296,8608477623.789675,11934902195.268526,33195415582.321497,2163535,377784,1456014,3997333
2012-10-16,CBSX (W),19249600,3985564,8903677,32138841,526778638.010000,210505994.030000,204717231.430000,942001863.470000,123489,10701,58707,192897
2012-10-16,NASDAQ PSX (X),28733189,15962104,22315343,67010636,579624354.955000,838919093.600000,421240125.560000,1839783574.115000,100195,25367,55148,180710
2012-10-16,BATS BYX (Y),126496297,26105997,54092242,206694536,3576972577.477098,1246541403.544601,1492011095.301499,6315525076.323198,824951,94366,333125,1252442
2012-10-16,BATS BZX (Z),301666828,102857724,176200977,580725529,8147285272.143126,6255259824.822485,5238229323.778687,19640774420.744298,1602949,312062,861887,2776898
2012-10-15,NYSE MKT (A),0,7846905,3622173,11469078,0.000000,48080320.934400,43859226.798000,91939547.732400,0,17192,14011,31203
2012-10-15,NASDAQ BX (B),88449645,28245009,43734212,160428866,2206884640.817599,1324811930.004999,1278159647.997299,4809856218.819897,542793,93765,272583,909141
2012-10-15,NSX (C),60032435,3225481,7020948,70278864,280763958.353900,128211145.834400,223238129.208900,632213233.397200,41058,7010,21061,69129
2012-10-15,NYSE (DN),111573535,18258449,60439919,190271903,3345300937.100705,883829075.476501,1799950312.614192,6029080325.191398,658914,75526,300921,1035361
2012-10-15,NASDAQ (DQ),1034256986,241353485,475668157,1751278628,24639046645.921357,10965796149.514956,13966826514.581380,49571669310.017693,2582221,379080,1206744,4168045
2012-10-15,EDGA (J),64702474,27871505,31679293,124253272,1495527874.593299,1240786005.597800,700984433.019301,3437298313.210400,344429,79606,162306,586341
2012-10-15,EDGX (K),221417269,60259219,141822634,423499122,5781111131.094517,2716073058.332298,3749614820.024695,12246799009.451510,921254,144425,503086,1568765
2012-10-15,CHX (M),21082482,4524221,6809471,32416174,425252007.165000,361255593.628600,410593588.269500,1197101189.063100,358,2067,591,3016
2012-10-15,NYSE (N),618829451,0,0,618829451,19391678874.696700,0.000000,0.000000,19391678874.696700,1691282,0,0,1691282
2012-10-15,NYSE Arca (P),397474129,177686028,176038656,751198813,10002937333.227338,10458169493.967313,5910849045.165500,26371955872.360151,1777417,406176,838377,3021970
2012-10-15,NASDAQ (Q),417658351,124773712,369352883,911784946,12081747628.974043,7913868281.594488,12071599652.521273,32067215563.089804,2144544,393137,1451097,3988778
2012-10-15,CBSX (W),18519682,4940722,7683678,31144082,485848778.060000,221931227.740000,173978774.320000,881758780.120000,118149,11331,50672,180152
2012-10-15,NASDAQ PSX (X),34807784,14029675,22964455,71801914,641672853.575000,793720236.150000,443673419.305000,1879066509.030000,104132,25908,56520,186560
2012-10-15,BATS BYX (Y),120417686,23967327,54258312,198643325,3380874183.469497,1092081946.643900,1445301213.723600,5918257343.836997,794383,89850,345368,1229601
2012-10-15,BATS BZX (Z),275440584,102067589,167423371,544931544,7101630329.948710,6053871537.957203,4782934553.323896,17938436421.229809,1444860,307912,834660,2587432
2012-10-12,NYSE MKT (A),0,7134988,3632750,10767738,0.000000,44776870.778500,42599252.075000,87376122.853500,0,15332,15066,30398
2012-10-12,NASDAQ BX (B),79628852,24917862,45142578,149689292,1964615701.104301,1230694334.315000,1394869761.343200,4590179796.762501,494721,88655,273653,857029
2012-10-12,NSX (C),20376185,2966491,7562637,30905313,227649982.437900,113757152.795100,202806552.986100,544213688.219100,32610,5714,18899,57223
2012-10-12,NYSE (DN),100349711,17037458,55239533,172626702,3005733245.954317,767315355.166101,1787155207.308810,5560203808.429228,597939,69441,288830,956210
2012-10-12,NASDAQ (DQ),920827786,248577523,497263869,1666669178,23220784215.661354,12621508888.513567,13726686129.326128,49568979233.501049,2390064,349429,1178297,3917790
2012-10-12,EDGA (J),61373972,28223119,32920381,122517472,1443055109.882700,1223627152.857500,781650497.529700,3448332760.269900,344152,78155,169408,591715
2012-10-12,EDGX (K),191974793,57701340,125697290,375373423,4933978835.939098,2521681803.168498,3318888163.581885,10774548802.689481,846166,140335,471599,1458100
2012-10-12,CHX (M),5801773,6373349,2975552,15150674,180161793.369600,452067280.357600,198059660.854000,830288734.581200,176,2186,283,2645
2012-10-12,NYSE (N),624502700,0,0,624502700,19599809563.186295,0.000000,0.000000,19599809563.186295,1658555,0,0,1658555
2012-10-12,NYSE Arca (P),361075872,160996607,173410369,695482848,9939382199.647169,9561993997.661872,6376033484.306296,25877409681.615337,1831039,386433,872595,3090067
2012-10-12,NASDAQ (Q),365495336,122780117,368894802,857170255,10903445982.738036,8531279921.520393,11931723226.651466,31366449130.909895,2047506,390141,1471528,3909175
2012-10-12,CBSX (W),16637121,3753385,8435889,28826395,424590331.790000,232788730.580000,177840552.336700,835219614.706700,107610,10171,51572,169353
2012-10-12,NASDAQ PSX (X),27724560,14003577,23718464,65446601,579063401.190000,840061190.770000,458758118.410000,1877882710.370000,93860,25754,57529,177143
2012-10-12,BATS BYX (Y),120113045,24106133,54804176,199023354,3289173906.885001,1100560295.493999,1454219228.233799,5843953430.612799,800191,90075,347228,1237494
2012-10-12,BATS BZX (Z),258037236,96373725,154014453,508425414,6820228078.475201,6062612168.159715,4520085753.399185,17402926000.034101,1429910,293184,797446,2520540
2012-10-11,NYSE MKT (A),0,7840647,3953394,11794041,0.000000,57240427.176400,48903659.578800,106144086.755200,0,18718,15194,33912
2012-10-11,NASDAQ BX (B),88418642,26943089,44302366,159664097,2077044229.924399,1340379137.092800,1326023195.894797,4743446562.911996,513472,92172,258152,863796
2012-10-11,NSX (C),34977730,3001058,8025046,46003834,290889894.345299,112997246.453000,224305711.001300,628192851.799599,41544,6438,20349,68331
2012-10-11,NYSE (DN),118705495,16548335,55042354,190296184,3367931099.607716,835211891.254403,1815041630.857494,6018184621.719613,669066,68211,276110,1013387
2012-10-11,NASDAQ (DQ),1112006354,230159804,512507044,1854673202,25792368682.027363,11437296033.666046,15895429247.427520,53125093963.120929,2666642,361096,1207322,4235060
2012-10-11,EDGA (J),69800435,29310506,32841068,131952009,1551797849.760298,1282372685.909601,721824729.539500,3555995265.209399,362568,82437,156539,601544
2012-10-11,EDGX (K),239988558,58821945,137192764,436003267,5814951216.163905,2608690126.252202,3835258367.247699,12258899709.663806,958752,147557,481232,1587541
2012-10-11,CHX (M),12634123,10189683,3926357,26750163,320650203.287200,1128752751.911401,439541292.704700,1888944247.903301,414,1913,446,2773
2012-10-11,NYSE (N),646686325,0,0,646686325,19417107375.819325,0.000000,0.000000,19417107375.819325,1757306,0,0,1757306
2012-10-11,NYSE Arca (P),444512502,169731859,189557883,803802244,10655254387.019562,9626552132.046683,6608742564.768806,26890549083.835051,1912664,391110,885505,3189279
2012-10-11,NASDAQ (Q),439171900,124810891,361733548,925716339,11985604713.463219,8884036450.259901,11593931181.845701,32463572345.568821,2204730,390564,1481582,4076876
2012-10-11,CBSX (W),16882577,2686594,8592418,28161589,436123081.110000,142183114.340000,182502652.383200,760808847.833200,109283,8465,51445,169193
2012-10-11,NASDAQ PSX (X),33080661,13795663,26827548,73703872,714719440.313800,789704407.710000,526119473.835000,2030543321.858800,109084,25567,60387,195038
2012-10-11,BATS BYX (Y),137891680,23477730,55505443,216874853,3654650644.165001,1116617834.586001,1494260261.324997,6265528740.075999,862700,91237,344225,1298162
2012-10-11,BATS BZX (Z),284860584,98962399,163531634,547354617,7417818669.967319,6142123732.134185,4915649330.683999,18475591732.785503,1502188,291571,804622,2598381
2012-10-10,NYSE MKT (A),0,9575268,3675099,13250367,0.000000,58292545.636200,42669910.493200,100962456.129400,0,21468,14427,35895
2012-10-10,NASDAQ BX (B),85817582,27798312,53866820,167482714,2166866146.531400,1461291353.005900,1441494184.941699,5069651684.478999,548025,99512,304219,951756
2012-10-10,NSX (C),20204377,3985243,8322648,32512268,245153694.220100,132488545.385600,258342034.835300,635984274.441000,36410,8203,24038,68651
2012-10-10,NYSE (DN),109909819,17570887,72853026,200333732,3376793874.216087,879960355.233499,1959766422.073194,6216520651.522780,679479,78516,297680,1055675
2012-10-10,NASDAQ (DQ),936406519,261104773,618228289,1815739581,25390180983.104101,12716917266.250717,17425126530.413504,55532224779.768322,2642786,395497,1335125,4373408
2012-10-10,EDGA (J),61720529,31026237,36308064,129054830,1490229124.681399,1384533516.481399,802401929.445101,3677164570.607899,366906,93169,179290,639365
2012-10-10,EDGX (K),205156813,70070731,139019538,414247082,5756456170.869570,2938630967.441199,4157022980.846180,12852110119.156949,982179,179674,541094,1702947
2012-10-10,CHX (M),7204056,6136928,3884321,17225305,253977820.143000,503560061.924300,396842496.147100,1154380378.214400,420,1784,361,2565
2012-10-10,NYSE (N),590818519,0,0,590818519,18676395041.466810,0.000000,0.000000,18676395041.466810,1827785,0,0,1827785
2012-10-10,NYSE Arca (P),356622333,183837103,203050401,743509837,10535185460.667175,10423158397.229714,6958138949.633432,27916482807.530321,1927470,446024,954201,3327695
2012-10-10,NASDAQ (Q),405590313,150202072,371660845,927453230,12713033492.606958,10110465660.895317,11687528998.908469,34511028152.410744,2317534,486150,1582464,4386148
2012-10-10,CBSX (W),17965132,3395488,9073114,30433734,478154409.700000,191845077.870000,214231865.840000,884231353.410000,121932,10905,59455,192292
2012-10-10,NASDAQ PSX (X),33840657,20444572,32867001,87152230,770310276.217700,1367667298.730000,666675685.030000,2804653259.977700,110878,34242,69031,214151
2012-10-10,BATS BYX (Y),128698845,26358498,61552798,216610141,3634874880.620004,1215541342.741600,1629056205.524402,6479472428.886006,871681,104457,380237,1356375
2012-10-10,BATS BZX (Z),274763006,116946853,183447584,575157443,7759469678.706692,7130864405.322012,5365919619.306092,20256253703.334796,1575328,359314,915520,2850162
2012-10-09,NYSE MKT (A),0,10820029,2775267,13595296,0.000000,70704378.955600,39184547.905000,109888926.860600,0,24249,12440,36689
2012-10-09,NASDAQ BX (B),86670187,30411645,47853231,164935063,2287303684.281002,1636871789.255199,1848132710.637803,5772308184.174004,558604,109917,299885,968406
2012-10-09,NSX (C),13200964,4490344,8311831,26003139,261823495.290300,136410491.914300,315709533.768200,713943520.972800,37497,8316,24480,70293
2012-10-09,NYSE (DN),101944408,18604497,54944718,175493623,3203163452.598877,932851990.203999,2130012216.394382,6266027659.197258,652132,80679,315515,1048326
2012-10-09,NASDAQ (DQ),917203407,297037267,553770151,1768010825,24971596636.499032,14462440679.051141,20509943657.487120,59943980973.037293,2609935,444644,1355625,4410204
2012-10-09,EDGA (J),61355304,33805789,33877120,129038213,1510500855.411003,1620326951.994600,951399711.702100,4082227519.107703,359697,103942,186594,650233
2012-10-09,EDGX (K),208604919,78394316,132315238,419314473,5884668428.458525,3221465179.215397,4910100138.503827,14016233746.177749,995592,194971,551257,1741820
2012-10-09,CHX (M),10207381,6884423,4472123,21563927,350499937.695200,373582981.527200,176765914.879800,900848834.102200,278,1669,408,2355
2012-10-09,NYSE (N),612531993,0,0,612531993,19492616060.633844,0.000000,0.000000,19492616060.633844,1775630,0,0,1775630
2012-10-09,NYSE Arca (P),359567267,193145258,181440846,734153371,10625885430.022584,10653188964.630797,8697463716.406294,29976538111.059675,1911310,463300,948355,3322965
2012-10-09,NASDAQ (Q),397519634,159542877,364238367,921300878,12670998421.141020,11085770255.863409,13282122343.523568,37038891020.527997,2287333,496086,1572629,4356048
2012-10-09,CBSX (W),17020223,5477502,9995112,32492837,462988420.540000,289445077.290000,229482586.283400,981916084.113400,114148,12216,62418,188782
2012-10-09,NASDAQ PSX (X),36420585,21504453,31942660,89867698,835481929.460500,1559091027.520000,712057081.420000,3106630038.400500,111357,36665,67719,215741
2012-10-09,BATS BYX (Y),123519809,31384847,55490842,210395498,3478283085.362496,1450955510.997400,1607509252.144399,6536747848.504295,830304,118741,367595,1316640
2012-10-09,BATS BZX (Z),271369207,126961840,179283320,577614367,7735721959.105191,7992501038.177075,6169615995.908306,21897838993.190572,1556997,378855,948491,2884343
2012-10-08,NYSE MKT (A),0,8134397,1671940,9806337,0.000000,49252320.994500,20136087.835200,69388408.829700,0,16144,9054,25198
2012-10-08,NASDAQ BX (B),70938136,16296010,36781081,124015227,1797013477.634997,882372462.905700,1375383187.246002,4054769127.786699,465947,64383,243077,773407
2012-10-08,NSX (C),6077615,3397767,5328336,14803718,163746307.421800,60149348.128900,217879579.916600,441775235.467300,23788,6260,17825,47873
2012-10-08,NYSE (DN),77984834,11673504,42173754,131832092,2423764058.881801,593055336.779600,1391833110.063098,4408652505.724499,509206,54273,244183,807662
2012-10-08,NASDAQ (DQ),644993597,172819626,378285348,1196098571,17686522672.361789,7307621520.542933,14404564728.534824,39398708921.439546,1995127,286647,1046587,3328361
2012-10-08,EDGA (J),53608217,21769624,24752329,100130170,1410803137.490001,968183905.930400,688200552.617100,3067187596.037501,341797,70754,139865,552416
2012-10-08,EDGX (K),149589415,47556017,95078965,292224397,4303741112.240194,1712903701.478402,3795862551.797679,9812507365.516275,743080,110665,414700,1268445
2012-10-08,CHX (M),8174846,4165396,2859924,15200166,298844210.787200,271858461.533000,256851608.971700,827554281.291900,256,1184,274,1714
2012-10-08,NYSE (N),464356458,0,0,464356458,14578913235.455301,0.000000,0.000000,14578913235.455301,1412032,0,0,1412032
2012-10-08,NYSE Arca (P),238856309,119956193,126171772,484984274,7132676737.506003,6422818339.058409,5974020130.886676,19529515207.451088,1302287,287061,670436,2259784
2012-10-08,NASDAQ (Q),285351286,88524168,276453710,650329164,8842312659.779001,6172915699.019607,10439580688.267772,25454809047.066380,1637977,290644,1243997,3172618
2012-10-08,CBSX (W),14088270,2486749,8063510,24638529,358779562.570000,108739832.760000,170128160.364800,637647555.694800,101853,4965,53430,160248
2012-10-08,NASDAQ PSX (X),29549101,9569225,22755741,61874067,765643388.250000,611592260.110000,529571166.685000,1906806815.045000,105891,18196,61359,185446
2012-10-08,BATS BYX (Y),85915866,16708673,42112561,144737100,2335690501.470999,787411951.956500,1150474839.929800,4273577293.357299,584251,68542,276851,929644
2012-10-08,BATS BZX (Z),199832235,66669361,125438790,391940386,5587072725.099196,4006928063.322002,4340896880.238081,13934897668.659279,1158485,214523,688729,2061737
2012-10-05,NYSE MKT (A),0,10108011,2166117,12274128,0.000000,60228596.654000,25695114.037700,85923710.691700,0,21237,9672,30909
2012-10-05,NASDAQ BX (B),86353235,30406913,43948476,160708624,2086397937.710001,1572515434.351600,1493864381.888004,5152777753.949605,523016,105637,251738,880391
2012-10-05,NSX (C),9371569,4229967,6311268,19912804,258565630.018100,131693698.207800,220259171.336900,610518499.562800,34966,8413,20834,64213
2012-10-05,NYSE (DN),101724739,20523176,52902805,175150720,3222544346.917890,991895982.838000,1701456205.075886,5915896534.831776,644246,84806,281567,1010619
2012-10-05,NASDAQ (DQ),939509072,265048000,558385289,1762942361,25844613429.305350,12137890740.338715,17225621379.508225,55208125549.152290,2670665,412825,1330552,4414042
2012-10-05,EDGA (J),65581265,31507603,32417509,129506377,1736787219.213600,1465488044.354900,785192080.874099,3987467344.442599,407803,99091,161188,668082
2012-10-05,EDGX (K),211696273,73203563,135980506,420880342,5854618649.663305,2878245513.352099,4310026548.716074,13042890711.731478,950447,173619,516540,1640606
2012-10-05,CHX (M),9077946,7016065,3956290,20050301,222593874.887300,523957945.860500,177163747.869700,923715568.617500,525,2048,394,2967
2012-10-05,NYSE (N),606704552,0,0,606704552,19116167990.605525,0.000000,0.000000,19116167990.605525,1703781,0,0,1703781
2012-10-05,NYSE Arca (P),330891504,193490952,169724992,694107448,9759943653.489941,11528591440.101698,6819977477.831291,28108512571.422930,1688447,453410,801443,2943300
2012-10-05,NASDAQ (Q),393356896,154023251,359978501,907358648,11933588789.192480,10158173915.036088,12195029974.871630,34286792679.100198,2167651,482444,1508922,4159017
2012-10-05,CBSX (W),17915457,5579787,8203497,31698741,469149812.700000,287939847.710000,186658580.152000,943748240.562000,117379,12000,53335,182714
2012-10-05,NASDAQ PSX (X),28551548,15612081,21720997,65884626,632003914.200000,980531132.495000,415512520.230000,2028047566.925000,94706,28266,52411,175383
2012-10-05,BATS BYX (Y),121618998,29328486,55242944,206190428,3354945599.575000,1336987379.880801,1512013880.884996,6203946860.340797,797674,113013,346529,1257216
2012-10-05,BATS BZX (Z),259663654,122164751,161311533,543139938,7324677413.496399,7313376551.613603,5017575366.027311,19655629331.137313,1460426,369206,808286,2637918
2012-10-04,NYSE MKT (A),0,9976407,3196577,13172984,0.000000,67786742.927400,39837091.860000,107623834.787400,0,24298,13281,37579
2012-10-04,NASDAQ BX (B),96889116,30782721,43029575,170701412,2337922501.720005,1479993633.125000,1356753767.179501,5174669902.024506,576645,95700,270452,942797
2012-10-04,NSX (C),11200595,4155868,7129403,22485866,287708722.920800,116783545.063600,229623671.428900,634115939.413300,38863,8231,23664,70758
2012-10-04,NYSE (DN),120045703,20461734,51420768,191928205,3485224332.728209,926827475.327001,1577400454.055902,5989452262.111112,710296,80831,289207,1080334
2012-10-04,NASDAQ (DQ),1072291519,274519215,530178326,1876989060,28133572579.999268,11643484537.250224,16572791726.397312,56349848843.646804,2827785,405656,1309052,4542493
2012-10-04,EDGA (J),71530946,36641519,29030867,137203332,1664491869.786100,1609241657.058301,695973583.350001,3969707110.194402,389599,93207,163723,646529
2012-10-04,EDGX (K),253696766,77964195,137931053,469592014,6642616004.617591,3043169987.932696,4124440856.531004,13810226849.081291,1133113,175055,575112,1883280
2012-10-04,CHX (M),12167671,9204628,3701695,25073994,427663438.360300,643113806.711000,118498316.404300,1189275561.475600,380,1834,352,2566
2012-10-04,NYSE (N),674721487,0,0,674721487,20871680861.926116,0.000000,0.000000,20871680861.926116,1857728,0,0,1857728
2012-10-04,NYSE Arca (P),371783913,194836790,175217101,741837804,10367398866.957084,10816120963.488607,6224355085.871308,27407874916.316999,1867218,423691,907801,3198710
2012-10-04,NASDAQ (Q),447900903,151588524,368777273,968266700,13227844804.913517,10255767428.226993,12151567729.471833,35635179962.612343,2403572,480515,1549610,4433697
2012-10-04,CBSX (W),17223525,4946517,8379884,30549926,447887743.960000,244153209.210000,201277219.620000,893318172.790000,115867,13104,54544,183515
2012-10-04,NASDAQ PSX (X),32295926,17462019,21438748,71196693,702324607.100000,963613804.030000,451881533.520000,2117819944.650000,115227,28896,60943,205066
2012-10-04,BATS BYX (Y),137907995,29645495,53520305,221073795,3641134411.869997,1345159944.462101,1380698078.435399,6366992434.767497,880580,104825,353703,1339108
2012-10-04,BATS BZX (Z),314290635,122271140,166821473,603383248,8621291725.871512,6998054113.183805,4897623927.466085,20516969766.521402,1751430,353162,875318,2979910
2012-10-03,NYSE MKT (A),0,9442864,2878785,12321649,0.000000,58219229.530700,33667908.270000,91887137.800700,0,22389,10791,33180
2012-10-03,NASDAQ BX (B),88738647,30173730,48023941,166936318,2209269906.899997,1500944567.209199,1483022179.928098,5193236654.037294,543832,98913,287249,929994
2012-10-03,NSX (C),10467188,4125408,10093301,24685897,279162564.857600,128773159.701700,216337626.463300,624273351.022600,37762,7542,25115,70419
2012-10-03,NYSE (DN),111205152,17212336,51863338,180280826,3305103683.872522,733628065.766200,1609388289.342491,5648120038.981213,665672,70005,291173,1026850
2012-10-03,NASDAQ (DQ),1075861436,355661211,575067947,2006590594,29144190459.019667,14823582059.705942,16680536049.202297,60648308567.927906,2796387,403982,1318094,4518463
2012-10-03,EDGA (J),65434340,38105136,32790762,136330238,1494043959.415399,1519844843.825298,765213412.594198,3779102215.834895,360394,102310,172841,635545
2012-10-03,EDGX (K),239252885,71498357,142919467,453670709,6314809969.228585,2706728589.772500,4018618787.414792,13040157346.415877,1111610,163793,581214,1856617
2012-10-03,CHX (M),14026702,4437401,6155778,24619881,411478990.695000,342978837.429900,623776730.654000,1378234558.778900,330,1477,424,2231
2012-10-03,NYSE (N),665986418,0,0,665986418,20681647733.982940,0.000000,0.000000,20681647733.982940,1876613,0,0,1876613
2012-10-03,NYSE Arca (P),366547218,189303768,180690753,736541739,10404181265.534079,10200321099.666401,6368638939.906214,26973141305.106694,1902353,406982,924333,3233668
2012-10-03,NASDAQ (Q),437054304,146918201,391094914,975067419,12940996525.026983,9860323543.723101,12256396984.788293,35057717053.538377,2385961,457372,1581602,4424935
2012-10-03,CBSX (W),17641650,3810665,7470285,28922600,444593130.630000,216453806.220000,165453264.830000,826500201.680000,118563,12427,51861,182851
2012-10-03,NASDAQ PSX (X),28526326,15320753,26727388,70574467,622579913.755000,889301947.030000,511701998.268200,2023583859.053200,97653,26994,60372,185019
2012-10-03,BATS BYX (Y),129059442,28923998,58982749,216966189,3381617815.925997,1244797095.876500,1429463832.170600,6055878743.973097,834813,106014,373338,1314165
2012-10-03,BATS BZX (Z),304293532,115154034,178027468,597475034,8540460876.257697,6553241263.888503,5178040053.134988,20271742193.281188,1742361,339160,900897,2982418
2012-10-02,NYSE MKT (A),0,7803981,2805734,10609715,0.000000,57442231.281200,26798241.930000,84240473.211200,0,19685,9393,29078
2012-10-02,NASDAQ BX (B),91913008,27683994,48295718,167892720,2425283294.375000,1438758518.617000,1609998899.807202,5474040712.799202,590818,96294,314894,1002006
2012-10-02,NSX (C),10714916,3378555,8136700,22230171,293213541.937300,118417939.345800,311898958.203400,723530439.486500,39821,7257,23687,70765
2012-10-02,NYSE (DN),104844009,16052077,50571159,171467245,3028076332.031893,720546941.478401,1750101911.049698,5498725184.559992,624706,62210,296012,982928
2012-10-02,NASDAQ (DQ),996552573,223481965,561378617,1781413155,26174761138.404248,9951222888.826489,18232500516.228539,54358484543.459276,2707195,354100,1319181,4380476
2012-10-02,EDGA (J),69609521,35501762,30872959,135984242,1441808872.559999,1529428829.833700,751022306.034397,3722260008.428096,379420,94682,165119,639221
2012-10-02,EDGX (K),224498952,62084936,135479313,422063201,5992859458.411191,2450483923.973400,4254376080.696196,12697719463.080787,1033357,152112,535415,1720884
2012-10-02,CHX (M),16303215,6610538,3958173,26871926,460022379.859400,406595442.889500,152963650.040300,1019581472.789200,344,1552,350,2246
2012-10-02,NYSE (N),596297525,0,0,596297525,18672171023.974402,0.000000,0.000000,18672171023.974402,1821978,0,0,1821978
2012-10-02,NYSE Arca (P),346705583,176095359,174420416,697221358,9951923230.471835,9288174220.283506,6773388434.687715,26013485885.443056,1846388,400148,883120,3129656
2012-10-02,NASDAQ (Q),426340457,138076891,371002190,935419538,12713160958.331186,9399087161.490815,13041032463.410108,35153280583.232109,2349909,445003,1597827,4392739
2012-10-02,CBSX (W),15220599,9870419,7505973,32596991,381412817.660000,332447580.930000,171337912.070000,885198310.660000,103244,11663,49302,164209
2012-10-02,NASDAQ PSX (X),24605943,13223584,22448011,60277538,501997611.140000,747460351.740000,475325932.945000,1724783895.825000,82921,24932,57945,165798
2012-10-02,BATS BYX (Y),123880932,26715471,55214859,205811262,3206135731.829999,1237785866.549298,1464468368.403500,5908389966.782797,799693,99964,359950,1259607
2012-10-02,BATS BZX (Z),285918822,106854442,174333494,567106758,7800651597.584092,6521630012.793893,5601774830.811212,19924056441.189197,1595119,323307,895190,2813616
2012-10-01,NYSE MKT (A),0,8789356,2905507,11694863,0.000000,70384318.412400,32232092.020000,102616410.432400,0,22100,11740,33840
2012-10-01,NASDAQ BX (B),79292643,29371152,44150790,152814585,2065773635.657998,1645573808.578998,1519021953.111002,5230369397.347998,504870,94740,272049,871659
2012-10-01,NSX (C),11377270,4614881,9592678,25584829,338759082.761900,145710973.275700,309596597.794000,794066653.831600,47428,9214,27027,83669
2012-10-01,NYSE (DN),95937293,16723993,52051495,164712781,2974255142.974895,852290886.766001,1671838428.059301,5498384457.800197,599064,71619,304205,974888
2012-10-01,NASDAQ (DQ),1063654987,339087860,563455587,1966198434,28644332879.829397,17089055705.476919,18290339692.839133,64023728278.145449,2957475,448065,1489521,4895061
2012-10-01,EDGA (J),70946343,38362351,36041782,145350476,1638588191.031200,1754867502.792201,890020314.692301,4283476008.515702,421287,99937,204550,725774
2012-10-01,EDGX (K),247173013,82674525,158512279,488359817,6859589450.788005,3559515393.536894,4622975621.627493,15042080465.952392,1183254,200928,652348,2036530
2012-10-01,CHX (M),4188312,5129450,3349135,12666897,152592846.580400,458251928.794000,155915104.401200,766759879.775600,406,3012,431,3849
2012-10-01,NYSE (N),672311147,0,0,672311147,21019262430.708697,0.000000,0.000000,21019262430.708697,1967259,0,0,1967259
2012-10-01,NYSE Arca (P),349642192,197406586,179021532,726070310,10542293727.408692,11683433465.649460,7112474196.617086,29338201389.675238,1910367,440626,936128,3287121
2012-10-01,NASDAQ (Q),439261679,164668390,427574962,1031505031,13685976350.754289,11563296251.375498,14208936899.557897,39458209501.687684,2508081,513104,1739052,4760237
2012-10-01,CBSX (W),17184830,9203623,9423304,35811757,437181214.710000,540338734.580000,205182830.898400,1182702780.188400,119529,14468,63643,197640
2012-10-01,NASDAQ PSX (X),28637181,18436729,27247936,74321846,678020929.775000,1156242703.955000,643256908.275000,2477520542.005000,121137,38197,85741,245075
2012-10-01,BATS BYX (Y),140291721,29304621,63985532,233581874,3908754696.416502,1480384971.105002,1736584519.143606,7125724186.665110,967513,109121,410456,1487090
2012-10-01,BATS BZX (Z),285565768,129259172,192918247,607743187,8130274958.851399,7957937653.673907,6068210689.045161,22156423301.570467,1669986,389463,1018023,3077472
2012-09-28,NYSE MKT (A),0,9603634,4292883,13896517,0.000000,69641984.163100,42567688.860000,112209673.023100,0,20789,10908,31697
2012-09-28,NASDAQ BX (B),80998945,30653397,50585126,162237468,2110329785.519999,1551346260.429999,1553352124.890697,5215028170.840695,503263,98222,288804,890289
2012-09-28,NSX (C),6647121,2933397,5929571,15510089,189771754.052500,86817663.842800,198175903.569101,474765321.464401,24689,6225,16822,47736
2012-09-28,NYSE (DN),99917857,20510580,54148905,174577342,3093158212.234693,903917685.522399,1701225345.702801,5698301243.459893,637760,88020,301597,1027377
2012-09-28,NASDAQ (DQ),1040380759,287009161,618264137,1945654057,29451590287.452135,13750603284.000954,17601568706.822610,60803762278.275699,2562249,411602,1347684,4321535
2012-09-28,EDGA (J),65487950,37915814,37877413,141281177,1604997954.668699,1718443459.768098,904284645.536203,4227726059.973000,374450,102822,204862,682134
2012-09-28,EDGX (K),186864963,70433907,145689299,402988169,5207819952.469206,3000159378.452000,4040022297.950186,12248001628.871392,877111,177983,530904,1585998
2012-09-28,CHX (M),7242865,8683510,4230809,20157184,235446823.255200,729792588.915500,208500190.090600,1173739602.261300,291,2345,423,3059
2012-09-28,NYSE (N),832360361,0,0,832360361,27092246407.210889,0.000000,0.000000,27092246407.210889,1871846,0,0,1871846
2012-09-28,NYSE Arca (P),336597864,216632728,190120429,743351021,9986492916.144970,12954783309.187193,7008444536.421371,29949720761.753534,1783620,421930,888984,3094534
2012-09-28,NASDAQ (Q),431554889,163502145,483501401,1078558435,13727400608.750014,11520619856.624810,14977132268.331870,40225152733.706694,2445606,501068,1648247,4594921
2012-09-28,CBSX (W),15796031,5386845,7991342,29174218,422043492.630000,229883411.830000,184277011.230000,836203915.690000,109294,12214,51367,172875
2012-09-28,NASDAQ PSX (X),26322537,17414079,27124792,70861408,630525234.305000,1140675015.200000,579301513.210000,2350501762.715000,113907,34758,81057,229722
2012-09-28,BATS BYX (Y),121187610,28228913,60650108,210066631,3396809781.780002,1316295333.475000,1472494973.867198,6185600089.122200,812427,100440,365331,1278198
2012-09-28,BATS BZX (Z),267577464,114617617,193411610,575606691,7691663134.080010,7093770728.271102,5516029416.255091,20301463278.606203,1562743,355151,950238,2868132
2012-09-27,NYSE MKT (A),0,10417752,3599511,14017263,0.000000,64437316.261000,53988212.320000,118425528.581000,0,22436,15938,38374
2012-09-27,NASDAQ BX (B),80126635,30543960,47921724,158592319,2028635079.774300,1341887958.928202,1615067122.546290,4985590161.248792,497052,97769,288785,883606
2012-09-27,NSX (C),7228813,4058129,7016967,18303909,196757376.416500,99980178.077200,281588050.053400,578325604.547100,26619,7299,18460,52378
2012-09-27,NYSE (DN),71312528,14983806,37054790,123351124,2190118210.078393,670759761.620899,1141726512.442693,4002604484.141985,465632,62976,220792,749400
2012-09-27,NASDAQ (DQ),939120846,266814482,566061180,1771996508,25414209131.915804,11104645910.835263,17722048368.422486,54240903411.173553,2664626,414586,1378667,4457879
2012-09-27,EDGA (J),64123125,35022174,35940040,135085339,1531113714.369499,1375949588.435000,795722797.312100,3702786100.116599,359272,93930,184272,637474
2012-09-27,EDGX (K),199345745,68676073,151909073,419930891,5518164092.132391,2562683201.158200,4361531306.368162,12442378599.658753,953307,162987,576607,1692901
2012-09-27,CHX (M),5658830,9710080,4719987,20088897,227534850.022100,1006014124.708000,256612463.569000,1490161438.299100,335,1710,556,2601
2012-09-27,NYSE (N),634053946,0,0,634053946,19624892130.716103,0.000000,0.000000,19624892130.716103,1818516,0,0,1818516
2012-09-27,NYSE Arca (P),330381120,191558753,176410303,698350176,9525713754.267065,10048389276.386515,6994576379.284859,26568679409.938439,1753539,381004,869232,3003775
2012-09-27,NASDAQ (Q),396722100,143864537,406692637,947279274,11997047711.447626,9190967919.854986,13045479376.235877,34233495007.538489,2255981,433929,1652095,4342005
2012-09-27,CBSX (W),16196224,4356273,8114494,28666991,441256072.580000,221881943.170000,175169341.776700,838307357.526700,114527,13492,53490,181509
2012-09-27,NASDAQ PSX (X),28975367,14758035,26832174,70565576,600821548.425000,798278171.035000,566168997.735000,1965268717.195000,107155,30207,78314,215676
2012-09-27,BATS BYX (Y),115992801,28321398,58487129,202801328,3083106462.618599,1212561845.302001,1560326672.024199,5855994979.944799,761850,98044,355158,1215052
2012-09-27,BATS BZX (Z),262565817,104031236,180924992,547522045,7294648728.144992,5978004188.920793,5372779807.088008,18645432724.153793,1501094,317424,931304,2749822
2012-09-26,NYSE MKT (A),0,10203390,2585923,12789313,0.000000,66276016.700000,39004134.490000,105280151.190000,0,23155,12950,36105
2012-09-26,NASDAQ BX (B),99522595,33718257,49315855,182556707,2467102312.730803,1688584266.625000,1715505606.063200,5871192185.419003,608654,112104,302487,1023245
2012-09-26,NSX (C),8807734,4811436,8217891,21837061,227837183.510600,137465701.161000,256430812.725500,621733697.397100,32849,7839,21800,62488
2012-09-26,NYSE (DN),115027616,22281922,56548298,193857836,3400388133.034685,960948847.816800,1977423829.583799,6338760810.435284,697436,95897,334911,1128244
2012-09-26,NASDAQ (DQ),1040713793,346270960,570416873,1957401626,26575026559.635078,15815568045.423856,18295808500.963398,60686403106.022332,2942119,501324,1452262,4895705
2012-09-26,EDGA (J),85298791,35560006,36110990,156969787,2175793266.187000,1623265820.470100,884886880.677498,4683945967.334598,498911,109089,191359,799359
2012-09-26,EDGX (K),239145929,81067976,152719407,472933312,6491682162.827408,3121450927.568495,4635333645.056935,14248466735.452838,1135911,191485,632900,1960296
2012-09-26,CHX (M),6790293,6265952,4263007,17319252,198609421.228800,702270808.080000,120973958.288000,1021854187.596800,384,2583,655,3622
2012-09-26,NYSE (N),738631397,0,0,738631397,21789142781.323239,0.000000,0.000000,21789142781.323239,2065510,0,0,2065510
2012-09-26,NYSE Arca (P),389956871,203981124,183732324,777670319,10990252129.311121,10776615179.562898,7201668260.416521,28968535569.290540,2041892,468461,956457,3466810
2012-09-26,NASDAQ (Q),486016178,172042762,404353348,1062412288,14336369116.619846,11047200775.717398,13571756452.333831,38955326344.671075,2735947,526750,1807721,5070418
2012-09-26,CBSX (W),19059571,3949239,9205810,32214620,491753439.150000,196833521.180000,187723802.380000,876310762.710000,124921,14612,58421,197954
2012-09-26,NASDAQ PSX (X),34755880,19107967,32839899,86703746,792547014.505000,1077171502.055000,712107281.805000,2581825798.365000,143893,39240,107267,290400
2012-09-26,BATS BYX (Y),134169958,35381508,59226348,228777814,3506607587.659997,1531993513.006500,1637103390.095099,6675704490.761596,865221,118913,376487,1360621
2012-09-26,BATS BZX (Z),312213989,128449919,180687704,621351612,8688015292.304590,7591389431.988512,5708699500.576405,21988104224.869507,1813533,397868,980611,3192012
2012-09-25,NYSE MKT (A),0,13800387,2136851,15937238,0.000000,67186109.544200,34699539.400000,101885648.944200,0,24811,11793,36604
2012-09-25,NASDAQ BX (B),101746538,33453223,56149912,191349673,2693316448.019998,1653457601.701800,1750445214.124496,6097219263.846294,640555,103680,325358,1069593
2012-09-25,NSX (C),9435360,5841566,8883708,24160634,247663718.927600,147241719.851500,245711962.734600,640617401.513700,33050,8842,22192,64084
2012-09-25,NYSE (DN),112008428,22656715,62075500,196740643,3473498305.981972,1046260078.137600,2038608525.140781,6558366909.260353,692726,89035,326351,1108112
2012-09-25,NASDAQ (DQ),1098602754,327294875,693199782,2119097411,29745605057.073503,14694118232.869441,20123438693.141626,64563161983.084570,3012331,459920,1574783,5047034
2012-09-25,EDGA (J),77670193,39242057,42374145,159286395,2104343651.521598,1716485994.477101,1104293303.431598,4925122949.430297,472352,103091,229205,804648
2012-09-25,EDGX (K),247205313,79649129,174089107,500943549,6725486831.853807,3124760411.484602,4960821428.835083,14811068672.173492,1140813,188343,679010,2008166
2012-09-25,CHX (M),11358497,10061498,7371179,28791174,359198907.242500,800535952.632100,410972404.075300,1570707263.949900,258,2377,583,3218
2012-09-25,NYSE (N),755740771,0,0,755740771,24548540981.380902,0.000000,0.000000,24548540981.380902,2088678,0,0,2088678
2012-09-25,NYSE Arca (P),388821124,227057108,214323656,830201888,11387312568.088607,12844188579.619669,7819795896.245141,32051297043.953417,2013068,451854,1043172,3508094
2012-09-25,NASDAQ (Q),461177655,167634944,458570561,1087383160,14413085018.637210,11045450889.175483,15168579995.392578,40627115903.205271,2613423,493551,1868630,4975604
2012-09-25,CBSX (W),19230935,4323342,8476166,32030443,494571899.060000,223928541.780000,188087994.142500,906588434.982500,128719,12815,53378,194912
2012-09-25,NASDAQ PSX (X),28973118,18473840,32208546,79655504,656152992.485000,1091841695.705000,672576326.800000,2420571014.990000,112780,34587,83795,231162
2012-09-25,BATS BYX (Y),132457638,32202705,63368505,228028848,3504290641.154996,1519580196.956399,1649317788.931002,6673188627.042397,870229,110416,389285,1369930
2012-09-25,BATS BZX (Z),296034614,121789859,194273668,612098141,8468687881.315218,7484705056.688493,5883865852.841211,21837258790.844922,1736892,366762,1019419,3123073
2012-09-24,NYSE MKT (A),0,10913725,2583025,13496750,0.000000,61888640.435200,48089503.380000,109978143.815200,0,21696,11691,33387
2012-09-24,NASDAQ BX (B),78415231,25710336,45907022,150032589,2038004181.494800,1197153971.541500,1584104655.143400,4819262808.179700,504583,85084,282536,872203
2012-09-24,NSX (C),7381386,3660803,7952180,18994369,207749062.998700,107710237.308900,272470991.232000,587930291.539600,27930,6954,20855,55739
2012-09-24,NYSE (DN),94605460,18114532,51074861,163794853,2876252451.562464,887070183.020802,1742067688.605283,5505390323.188549,609821,74067,302146,986034
2012-09-24,NASDAQ (DQ),859429452,257335656,558687883,1675452991,23321661600.392802,11688227073.819373,16782068886.588912,51791957560.801087,2626363,386917,1418708,4431988
2012-09-24,EDGA (J),62558820,29895979,35536020,127990819,1570746088.973100,1298152183.003200,887600775.720899,3756499047.697199,367420,91850,186544,645814
2012-09-24,EDGX (K),200847136,61236813,164097206,426181155,5723351013.006305,2164398550.676098,4779348056.692864,12667097620.375267,1012645,142008,632502,1787155
2012-09-24,CHX (M),10116596,16596358,5597529,32310483,396480346.859800,1301713195.691200,386784232.814000,2084977775.365000,338,1361,551,2250
2012-09-24,NYSE (N),625659303,0,0,625659303,20191789752.769372,0.000000,0.000000,20191789752.769372,1759061,0,0,1759061
2012-09-24,NYSE Arca (P),301866063,166692099,180105546,648663708,9160776398.083212,9215816708.518512,7131894781.771924,25508487888.373648,1681542,374469,927498,2983509
2012-09-24,NASDAQ (Q),367121288,125789169,405716256,898626713,11668372790.502124,7963353722.578177,14630885622.790533,34262612135.870834,2141171,392159,1604858,4138188
2012-09-24,CBSX (W),17354679,5115086,8474463,30944228,446346116.450000,255504907.290000,199689362.460000,901540386.200000,115932,11508,56209,183649
2012-09-24,NASDAQ PSX (X),24808933,13702542,27175254,65686729,563561672.239000,814126554.500000,538878062.755000,1916566289.494000,104224,28341,77486,210051
2012-09-24,BATS BYX (Y),107864605,23901406,53925900,185691911,2844453729.524997,1048208839.958800,1422025088.603599,5314687658.087396,726592,93125,344281,1163998
2012-09-24,BATS BZX (Z),251402076,89931388,167500368,508833832,7354102729.936989,5202829717.219794,5289553320.454202,17846485767.610985,1521146,286585,898866,2706597
2012-09-21,NYSE MKT (A),0,36999581,3255046,40254627,0.000000,260246111.892400,57091797.200000,317337909.092400,0,31518,15732,47250
2012-09-21,NASDAQ BX (B),92700314,29736202,52970924,175407440,2506633626.629999,1381854622.885700,1854980620.327201,5743468869.842900,571880,97083,308888,977851
2012-09-21,NSX (C),10189228,3228210,13725296,27142734,297118597.128600,84291903.307000,205607108.828100,587017609.263700,35621,6954,24840,67415
2012-09-21,NYSE (DN),117095356,22247822,57263578,196606756,3662006307.608568,1068101598.178903,1760438573.868998,6490546479.656469,760906,88874,345775,1195555
2012-09-21,NASDAQ (DQ),1222410579,298791155,848793602,2369995336,34581206467.848544,13828287078.344766,26448816841.126114,74858310387.319424,3025013,430465,1581078,5036556
2012-09-21,EDGA (J),71677144,31141383,37412100,140230627,1898254406.325601,1420710966.998700,920691636.694400,4239657010.018701,420644,97217,202669,720530
2012-09-21,EDGX (K),245222534,65742344,165449510,476414388,7071737613.461305,2585718720.029202,4821661733.158128,14479118066.648635,1173549,152228,661788,1987565
2012-09-21,CHX (M),9213123,12551811,8401467,30166401,304073969.407900,1003023185.072399,648313505.842200,1955410660.322499,765,2358,722,3845
2012-09-21,NYSE (N),1809401657,0,0,1809401657,63795414295.211982,0.000000,0.000000,63795414295.211982,2059242,0,0,2059242
2012-09-21,NYSE Arca (P),355710124,188041854,192907015,736658993,11021341628.654360,10377370705.540488,7531310742.455927,28930023076.650775,1883729,398876,994654,3277259
2012-09-21,NASDAQ (Q),424641252,134440264,924025821,1483107337,13591808691.117106,8755607230.369309,30301621048.098799,52649036969.585214,2359916,416473,1858948,4635337
2012-09-21,CBSX (W),20388546,3812799,9687136,33888481,569508761.230000,210360926.981200,232019254.115900,1011888942.327100,141340,14227,61039,216606
2012-09-21,NASDAQ PSX (X),29841776,12552735,29510541,71905052,786764499.500000,673386145.915000,641555175.685000,2101705821.100000,136734,28301,92664,257699
2012-09-21,BATS BYX (Y),133911721,27304280,59965328,221181329,3806450698.922207,1220762686.455600,1576442832.903399,6603656218.281206,889156,105602,382195,1376953
2012-09-21,BATS BZX (Z),291878050,100116580,184171952,576166582,8810161600.459797,5764627979.669792,5779642558.370288,20354432138.499877,1740514,321965,978855,3041334
2012-09-20,NYSE MKT (A),0,12599631,2548772,15148403,0.000000,104473160.835200,42789489.920000,147262650.755200,0,24691,14143,38834
2012-09-20,NASDAQ BX (B),91647180,32187632,51705398,175540210,2678894272.541003,1594062339.113699,1633272896.352499,5906229508.007201,608199,101239,310848,1020286
2012-09-20,NSX (C),9184482,3408329,9782578,22375389,264510014.323600,98901633.796500,185274666.696500,548686314.816600,33643,7441,24677,65761
2012-09-20,NYSE (DN),100565756,22523864,56723058,179812678,3225810199.935706,946833798.129202,1657605070.946898,5830249069.011806,660487,88603,326673,1075763
2012-09-20,NASDAQ (DQ),981207221,318514306,625646472,1925367999,27181182641.167145,17341136621.380551,17074193805.234685,61596513067.782381,2897143,436892,1508388,4842423
2012-09-20,EDGA (J),77766200,35349890,37277341,150393431,1914586374.229598,1561571193.806000,856572388.561399,4332729956.596997,459433,107507,196360,763300
2012-09-20,EDGX (K),227149975,65180505,160294154,452624634,6530688337.700026,2475078181.408397,4215756923.371194,13221523442.479617,1082182,157487,606540,1846209
2012-09-20,CHX (M),10711728,9528620,6480457,26720805,337313927.724000,786928199.476200,701693060.336000,1825935187.536200,1009,1862,696,3567
2012-09-20,NYSE (N),678748278,0,0,678748278,22439803016.218391,0.000000,0.000000,22439803016.218391,1910913,0,0,1910913
2012-09-20,NYSE Arca (P),345316346,196269568,187991897,729577811,10840100774.147343,10998337676.440068,6524658680.144812,28363097130.732223,1872038,404331,931264,3207633
2012-09-20,NASDAQ (Q),437215701,143333518,412749804,993299023,14305028270.381556,9435660916.332184,13070093365.186645,36810782551.900385,2483789,441230,1697049,4622068
2012-09-20,CBSX (W),18483164,3621532,8162415,30267111,483722104.550000,185379050.896400,193282058.396000,862383213.842400,127409,13357,55369,196135
2012-09-20,NASDAQ PSX (X),29145095,17363882,31439896,77948873,678677353.710000,1005730882.780000,609017399.115000,2293425635.605000,126535,35009,92965,254509
2012-09-20,BATS BYX (Y),129622657,29859927,58455245,217937829,3609828699.004999,1324032712.460800,1418932487.864500,6352793899.330299,862122,105594,364730,1332446
2012-09-20,BATS BZX (Z),282195246,103555645,180844508,566595399,8389552040.463827,6105705618.388692,5259721318.690984,19754978977.543503,1682493,334266,975851,2992610
2012-09-19,NYSE MKT (A),0,11314789,3262785,14577574,0.000000,68755810.309000,51742163.529300,120497973.838300,0,23251,16244,39495
2012-09-19,NASDAQ BX (B),86942756,28242607,45875535,161060898,2286000314.075001,1254627405.103998,1572811106.354301,5113438825.533300,530467,89481,285486,905434
2012-09-19,NSX (C),9476257,3165882,10594697,23236836,232625459.653300,88806995.925300,188486174.058100,509918629.636700,31228,7318,22751,61297
2012-09-19,NYSE (DN),106182325,17661674,54893074,178737073,3351489453.373585,808160737.152401,1631535415.183784,5791185605.709770,670195,78282,311851,1060328
2012-09-19,NASDAQ (DQ),1058175327,354498119,691976885,2104650331,28489255853.889040,18065528882.525546,17948518083.082311,64503302819.496897,2814645,419518,1485572,4719735
2012-09-19,EDGA (J),81530030,32573519,40009367,154112916,1976681479.091901,1410882884.422702,905688717.565900,4293253081.080503,466548,100249,214814,781611
2012-09-19,EDGX (K),236735522,63947230,172125771,472808523,6322671074.938974,2394312053.130094,4511166211.496487,13228149339.565555,1022136,152899,639639,1814674
2012-09-19,CHX (M),12769519,12275248,8199245,33244012,542924196.587000,1000693500.475800,502053211.176700,2045670908.239500,329,1719,861,2909
2012-09-19,NYSE (N),644100593,0,0,644100593,21095043092.511209,0.000000,0.000000,21095043092.511209,1826775,0,0,1826775
2012-09-19,NYSE Arca (P),325506040,172140038,176193109,673839187,9834869376.772489,9019966043.870594,6004071912.475105,24858907333.118188,1717731,375407,895480,2988618
2012-09-19,NASDAQ (Q),425716415,135942603,417062299,978721317,13063278525.315147,8230790658.582585,13339032617.848070,34633101801.745802,2293430,412331,1636579,4342340
2012-09-19,CBSX (W),18504299,4279566,7993775,30777640,500311111.758200,225086662.991000,184744859.538700,910142634.287900,123283,12562,53478,189323
2012-09-19,NASDAQ PSX (X),22706269,13427171,21738921,57872361,509901230.215000,755177349.460000,462170541.645000,1727249121.320000,102774,29272,70922,202968
2012-09-19,BATS BYX (Y),139230813,27615007,57129646,223975466,3966996020.817495,1202394707.706200,1404490469.303197,6573881197.826892,938597,109217,363077,1410891
2012-09-19,BATS BZX (Z),284435429,100924901,181741180,567101510,8105205675.116313,5789899158.757303,5353730648.247880,19248835482.121496,1610206,315676,963591,2889473
2012-09-18,NYSE MKT (A),0,11153928,3539410,14693338,0.000000,73255345.031600,53859114.760000,127114459.791600,0,22988,17045,40033
2012-09-18,NASDAQ BX (B),82167574,30063123,47622065,159852762,2184858349.434995,1329415440.571100,1658208418.621802,5172482208.627897,510109,98663,287668,896440
2012-09-18,NSX (C),8581295,3109697,9961599,21652591,227421834.479100,85477306.019600,182425335.030800,495324475.529500,30738,6504,21668,58910
2012-09-18,NYSE (DN),101291164,22707603,48333191,172331958,3197101095.974876,924990804.091200,1449011754.042499,5571103654.108575,632722,86946,270509,990177
2012-09-18,NASDAQ (DQ),1004452797,329489661,599771211,1933713669,26804537212.689452,13870952684.205382,15606735555.338460,56282225452.233294,2818477,418903,1373130,4610510
2012-09-18,EDGA (J),73653963,32548127,38957927,145160017,1776705487.955000,1337066533.896499,823220162.316599,3936992184.168098,415119,102166,197724,715009
2012-09-18,EDGX (K),231971317,60711956,152730617,445413890,6375692562.399293,2209421861.491695,4115208553.685980,12700322977.576968,1064293,151799,562191,1778283
2012-09-18,CHX (M),8990140,10463650,5981230,25435020,303416614.131000,996228420.649400,132808466.803800,1432453501.584200,358,2001,842,3201
2012-09-18,NYSE (N),632877181,0,0,632877181,20391338119.504248,0.000000,0.000000,20391338119.504248,1798763,0,0,1798763
2012-09-18,NYSE Arca (P),335217782,160754283,157252215,653224280,9753592155.711380,8302057637.220599,5556988990.661283,23612638783.593262,1784156,365722,789186,2939064
2012-09-18,NASDAQ (Q),442146257,144353485,387812147,974311889,13357932321.868857,8889581689.460492,12400090139.461545,34647604150.790894,2394531,451237,1552422,4398190
2012-09-18,CBSX (W),16722121,3049895,9907422,29679438,448442342.820000,147940589.100000,186472703.000000,782855634.920000,111559,10061,58710,180330
2012-09-18,NASDAQ PSX (X),29778642,14973466,29584191,74336299,650817372.055000,798352505.820000,583150752.370000,2032320630.245000,122939,32664,82227,237830
2012-09-18,BATS BYX (Y),124665561,28597902,54781825,208045288,3475088248.584994,1199104413.104999,1349437217.896199,6023629879.586192,831855,105733,333799,1271387
2012-09-18,BATS BZX (Z),285186655,102328658,169145369,556660682,8136911250.920984,5526840295.415996,4794899211.063878,18458650757.400858,1649144,319435,883880,2852459
2012-09-17,NYSE MKT (A),0,9863206,2688897,12552103,0.000000,72029706.176400,39877978.101400,111907684.277800,0,22434,12989,35423
2012-09-17,NASDAQ BX (B),77943924,27260315,38146367,143350606,2032635530.045001,1253454703.441799,1404306445.323098,4690396678.809898,477363,94159,237507,809029
2012-09-17,NSX (C),9316895,2973585,8531659,20822139,248103786.107000,90406808.481300,182971965.324000,521482559.912300,32626,6637,20292,59555
2012-09-17,NYSE (DN),101833146,19281026,45773274,166887446,3195952669.737892,894124988.271501,1494022267.324404,5584099925.333797,629046,81694,271877,982617
2012-09-17,NASDAQ (DQ),1196793562,280118717,534337770,2011250049,35691035936.224596,14403145995.685146,15909811940.629763,66003993872.539505,2597555,430966,1224686,4253207
2012-09-17,EDGA (J),71639596,30719626,34124111,136483333,1752877487.138398,1288713713.927199,798528171.163000,3840119372.228597,401418,99839,180187,681444
2012-09-17,EDGX (K),213746235,57236499,133880563,404863297,5920676243.295801,2195859119.461297,3810027560.164485,11926562922.921583,1000038,144865,516283,1661186
2012-09-17,CHX (M),8238452,10107433,5064406,23410291,298249591.888700,972590984.216000,174949714.840700,1445790290.945400,382,2047,700,3129
2012-09-17,NYSE (N),665964651,0,0,665964651,21847400175.417571,0.000000,0.000000,21847400175.417571,1744372,0,0,1744372
2012-09-17,NYSE Arca (P),301590206,170761034,131593554,603944794,8935453628.643601,9551170806.976978,5032162013.315000,23518786448.935579,1662576,378933,694427,2735936
2012-09-17,NASDAQ (Q),414322761,147620259,363341580,925284600,12825907068.628222,9119910499.706394,12562934020.648937,34508751588.983553,2298221,458646,1439341,4196208
2012-09-17,CBSX (W),17286983,3525897,7986726,28799606,474770930.190000,182589465.870000,191179663.710000,848540059.770000,118749,11988,51778,182515
2012-09-17,NASDAQ PSX (X),29991091,15464103,26420541,71875735,665358673.950000,800179665.105000,556223932.000000,2021762271.055000,120866,30494,76574,227934
2012-09-17,BATS BYX (Y),119021243,26261808,47571943,192854994,3298613532.482401,1163736160.013000,1284318765.266099,5746668457.761500,774955,101899,305477,1182331
2012-09-17,BATS BZX (Z),258636337,97067893,142834929,498539159,7514675781.424899,5350824167.023704,4383875285.587717,17249375234.036320,1537055,313007,793427,2643489
2012-09-14,NYSE MKT (A),0,13935705,3363603,17299308,0.000000,81430320.904300,50772488.856600,132202809.760900,0,27350,17443,44793
2012-09-14,NASDAQ BX (B),110689532,42041232,49142753,201873517,2832807544.934996,2011871820.835000,2084528208.234404,6929207574.004400,637389,134754,297990,1070133
2012-09-14,NSX (C),16037698,4814845,12063938,32916481,438015174.474600,170615297.597900,314142874.222700,922773346.295200,52215,9577,27427,89219
2012-09-14,NYSE (DN),149155067,32170626,58377782,239703475,4510683863.487365,1536647076.158005,2049748811.762591,8097079751.407961,865185,123167,338139,1326491
2012-09-14,NASDAQ (DQ),1628976355,471599271,688689318,2789264944,42950766911.901214,19213747866.214457,20417030505.338831,82581545283.454502,3838580,631794,1622828,6093202
2012-09-14,EDGA (J),115163684,55801389,42652265,213617338,2914682875.140100,2405349599.630398,1099261283.026799,6419293757.797297,638149,162641,231107,1031897
2012-09-14,EDGX (K),338596678,109987991,188112764,636697433,9138011161.116388,4352983486.484902,5520518541.451295,19011513189.052585,1468270,261216,715206,2444692
2012-09-14,CHX (M),14806205,15467378,5427866,35701449,541240981.223500,1554663452.502200,224795449.128000,2320699882.853700,436,3984,744,5164
2012-09-14,NYSE (N),899787166,0,0,899787166,29866421779.868027,0.000000,0.000000,29866421779.868027,2322003,0,0,2322003
2012-09-14,NYSE Arca (P),494653284,299975527,197630620,992259431,14278646525.622923,16547015046.912078,8425074707.894387,39250736280.429388,2432006,611277,1007658,4050941
2012-09-14,NASDAQ (Q),634744756,224784991,476955603,1336485350,19172184138.695327,13850508937.527372,17162352730.712299,50185045806.934998,3381411,650803,1934150,5966364
2012-09-14,CBSX (W),20870037,5225420,8775600,34871057,565683617.400000,313808949.340000,215677364.580900,1095169931.320900,131752,15517,57699,204968
2012-09-14,NASDAQ PSX (X),42756666,26961048,36012937,105730651,903762818.675000,1575447168.002200,756552962.770000,3235762949.447200,152829,49868,101256,303953
2012-09-14,BATS BYX (Y),177268274,40288829,62702231,280259334,4787818816.734992,1896630311.706997,1780901549.420005,8465350677.861994,1107298,148164,402523,1657985
2012-09-14,BATS BZX (Z),414768770,169468905,198713890,782951565,11820763418.525104,9998657880.804301,6516059110.480910,28335480409.810315,2334325,509633,1087802,3931760
2012-09-13,NYSE MKT (A),0,14333199,3116049,17449248,0.000000,76871368.913000,40528334.583600,117399703.496600,0,31221,15106,46327
2012-09-13,NASDAQ BX (B),104461161,44428456,45615227,194504844,2644533561.185008,2098695634.773400,1859599495.678591,6602828691.636999,603619,141352,292284,1037255
2012-09-13,NSX (C),14829596,6498958,13274493,34603047,380703634.830300,182702765.253200,254875700.977701,818282101.061201,42321,11210,26519,80050
2012-09-13,NYSE (DN),128573191,35482008,52690484,216745683,3725946918.620188,1652628121.017210,1771658500.374989,7150233540.012387,768232,129606,310905,1208743
2012-09-13,NASDAQ (DQ),1426063162,541773718,596165975,2564002855,37137883729.197549,26326379174.008769,17607300062.671128,81071562965.877446,3452657,700716,1445301,5598674
2012-09-13,EDGA (J),104551758,56664742,42182542,203399042,2476576038.624898,2473826535.812199,1089990810.323996,6040393384.761093,567029,155389,234757,957175
2012-09-13,EDGX (K),328145388,132120745,184604307,644870440,8395853741.982120,5132549863.143714,5160197063.058415,18688600668.184249,1354650,292697,666626,2313973
2012-09-13,CHX (M),6756088,15209269,4559728,26525085,253607309.723000,1527465982.373100,245223913.455900,2026297205.552000,384,6990,784,8158
2012-09-13,NYSE (N),802375204,0,0,802375204,25150524781.235919,0.000000,0.000000,25150524781.235919,2309484,0,0,2309484
2012-09-13,NYSE Arca (P),454622188,326429420,196409450,977461058,12714888710.360783,17779707998.413263,7874079253.004475,38368675961.778521,2241909,636789,990516,3869214
2012-09-13,NASDAQ (Q),620984378,279285604,465035407,1365305389,18083536083.367815,16845405268.482497,16010340035.853987,50939281387.704299,3291457,827091,1978989,6097537
2012-09-13,CBSX (W),19926318,7514242,8320759,35761319,523353147.730000,365613713.682000,183259083.324000,1072225944.736000,123564,16098,54219,193881
2012-09-13,NASDAQ PSX (X),37504330,30625369,29836163,97965862,805158157.385000,1733162529.370000,647483371.470000,3185804058.225000,146819,56010,95465,298294
2012-09-13,BATS BYX (Y),165993704,42012944,59343312,267349960,4295728005.492203,1893215420.487000,1568165446.516094,7757108872.495297,1040540,151713,382116,1574369
2012-09-13,BATS BZX (Z),393018253,198869672,185575412,777463337,10851557600.721616,10900593090.246976,5975110290.287399,27727260981.255991,2201195,579748,1019471,3800414
2012-09-12,NYSE MKT (A),0,10882867,3647120,14529987,0.000000,59629899.370400,49528564.686300,109158464.056700,0,21001,17097,38098
2012-09-12,NASDAQ BX (B),87762740,24695714,39875777,152334231,2230459322.429999,1064368239.873800,1486506706.017700,4781334268.321499,512062,84794,243776,840632
2012-09-12,NSX (C),8864186,3637432,9347439,21849057,222528638.316900,73320849.018400,221663740.450500,517513227.785800,29085,7067,19550,55702
2012-09-12,NYSE (DN),111930480,19790794,50415962,182137236,3206294314.357712,960760401.320401,1985566232.290320,6152620947.968433,645136,80081,275600,1000817
2012-09-12,NASDAQ (DQ),1176822934,274507009,618636817,2069966760,28336460533.131961,11035904205.706173,18585391957.073501,57957756695.911635,2815890,411128,1331623,4558641
2012-09-12,EDGA (J),82506694,34700267,35680625,152887586,1888769045.439802,1401875277.652801,965447684.107399,4256092007.200002,432259,100661,186409,719329
2012-09-12,EDGX (K),236893600,68951692,161809955,467655247,6200955131.888406,2336119532.319295,4764752426.748880,13301827090.956581,1053997,156689,582565,1793251
2012-09-12,CHX (M),8104980,8854017,7721175,24680172,290384393.084700,599295103.114000,325116522.036500,1214796018.235200,345,1761,501,2607
2012-09-12,NYSE (N),663826409,0,0,663826409,20467852947.782784,0.000000,0.000000,20467852947.782784,1822728,0,0,1822728
2012-09-12,NYSE Arca (P),354826673,169693047,176352331,700872051,9808746864.333038,8573090658.076176,7414365739.184807,25796203261.594021,1768748,377106,879007,3024861
2012-09-12,NASDAQ (Q),436106797,138487106,375454163,950048066,12568196031.127109,7861243171.255521,13322721204.890901,33752160407.273531,2321340,425152,1555929,4302421
2012-09-12,CBSX (W),19089682,5289045,7560779,31939506,492856378.730000,201219137.145000,179386966.266000,873462482.141000,125478,11672,50583,187733
2012-09-12,NASDAQ PSX (X),32248087,17066282,29692578,79006947,651035375.290000,1021503653.654000,568785081.670000,2241324110.614000,116719,34644,80119,231482
2012-09-12,BATS BYX (Y),129374167,25621016,52217241,207212424,3374422263.269999,1110129574.578099,1467556227.200100,5952108065.048198,805231,97848,318693,1221772
2012-09-12,BATS BZX (Z),293372066,103087300,155603281,552062647,8000016183.414984,5614429341.514304,5131590661.451398,18746036186.380686,1669198,311985,835115,2816298
2012-09-11,NYSE MKT (A),0,11181562,2605722,13787284,0.000000,78871081.389900,36875180.280000,115746261.669900,0,22562,11569,34131
2012-09-11,NASDAQ BX (B),87317773,24981236,41397000,153696009,2299381316.764003,1078935819.088600,1326856496.676800,4705173632.529403,497256,85025,243905,826186
2012-09-11,NSX (C),8519440,4172532,8794922,21486894,197116543.774500,56619866.387100,187221676.080000,440958086.241600,24824,7053,16984,48861
2012-09-11,NYSE (DN),116976705,20058361,48458568,185493634,3516740800.092787,920243689.147302,1638913977.045303,6075898466.285392,642940,81030,274448,998418
2012-09-11,NASDAQ (DQ),1058293775,284254023,542235871,1884783669,27978122317.751604,11976444654.574016,15482314060.649804,55436881032.975424,2743099,400084,1314244,4457427
2012-09-11,EDGA (J),82885542,30514465,36044414,149444421,2088988391.223498,1200436321.942800,884171278.615799,4173595991.782097,431304,90557,190696,712557
2012-09-11,EDGX (K),232361453,65419026,151352632,449133111,6114242210.657899,2257638534.096302,4191913696.129522,12563794440.883723,990271,150619,555076,1695966
2012-09-11,CHX (M),12596381,5755679,5632836,23984896,423701955.870000,353588808.667000,197946266.323700,975237030.860700,938,1121,534,2593
2012-09-11,NYSE (N),666987293,0,0,666987293,20886336025.032163,0.000000,0.000000,20886336025.032163,1706863,0,0,1706863
2012-09-11,NYSE Arca (P),370453745,165580481,165423883,701458109,10664469429.667520,8057042729.635300,6293659977.366710,25015172136.669530,1663753,350884,838874,2853511
2012-09-11,NASDAQ (Q),414722713,121702071,356816908,893241692,12595313257.641018,7244402627.741614,11831768853.306259,31671484738.688891,2157131,374826,1478971,4010928
2012-09-11,CBSX (W),19949351,6049723,9032308,35031382,527066150.280000,300901769.710000,186369703.385000,1014337623.375000,126740,10561,59443,196744
2012-09-11,NASDAQ PSX (X),28523837,15941568,23449101,67914506,715876432.545000,997800106.915000,484964251.055000,2198640790.515000,121807,34366,74599,230772
2012-09-11,BATS BYX (Y),127372296,24579437,53097027,205048760,3410031530.425003,1008438887.336801,1330708400.117902,5749178817.879706,772377,92178,320796,1185351
2012-09-11,BATS BZX (Z),283647070,90274602,151661525,525583197,8051811748.421492,4787877933.772108,4583671523.606510,17423361205.800110,1601883,286415,831455,2719753
2012-09-10,NYSE MKT (A),0,10230297,2390305,12620602,0.000000,63133174.865400,34154352.870000,97287527.735400,0,21982,12364,34346
2012-09-10,NASDAQ BX (B),84379650,27739295,43712307,155831252,2189869925.012401,1194395206.137500,1419064649.566297,4803329780.716198,519966,90750,277801,888517
2012-09-10,NSX (C),8170293,2823469,10769874,21763636,180826345.442400,55014802.427600,222087122.622399,457928270.492399,26488,5786,21042,53316
2012-09-10,NYSE (DN),105844305,19235334,51050467,176130106,3144336106.545991,967975625.147200,1691501750.961897,5803813482.655088,634305,76849,279724,990878
2012-09-10,NASDAQ (DQ),971339561,245188499,530301966,1746830026,24612615048.802483,10556678592.903087,16156853014.947956,51326146656.653526,2763128,383093,1383846,4530067
2012-09-10,EDGA (J),76028633,27085526,33260056,136374215,1797673076.249000,1073931477.723000,821834084.522599,3693438638.494599,422925,88754,179316,690995
2012-09-10,EDGX (K),214519977,58000476,146846451,419366904,5881850307.468278,2065146944.999800,4254606846.676510,12201604099.144588,1003337,132961,551658,1687956
2012-09-10,CHX (M),8771148,6388942,4625340,19785430,311415095.929400,403170084.474400,184346711.313900,898931891.717700,353,1116,523,1992
2012-09-10,NYSE (N),616084047,0,0,616084047,19526861015.739626,0.000000,0.000000,19526861015.739626,1695483,0,0,1695483
2012-09-10,NYSE Arca (P),314679171,161635052,153901334,630215557,8951065600.251310,8404454973.314231,6211325305.115013,23566845878.680554,1631215,356194,803381,2790790
2012-09-10,NASDAQ (Q),380130682,121797533,361895194,863823409,11405097383.304926,7328426069.846814,12101996328.894474,30835519782.046214,2115788,384786,1478616,3979190
2012-09-10,CBSX (W),18731212,3171650,9626684,31529546,509158660.650000,161363142.960000,227880865.174400,898402668.784400,127345,11381,58554,197280
2012-09-10,NASDAQ PSX (X),26434963,13450426,22544542,62429931,546953313.740000,777051373.440000,481594918.735000,1805599605.915000,107916,30796,73618,212330
2012-09-10,BATS BYX (Y),122064440,23675977,53685131,199425548,3185541822.074999,1018169310.172000,1493623002.763203,5697334135.010202,774783,95070,333811,1203664
2012-09-10,BATS BZX (Z),277515023,84818134,155354434,517687591,7671920895.604098,4467359362.597506,4860270396.163688,16999550654.365292,1617336,286281,870402,2774019
2012-09-07,NYSE MKT (A),0,10883981,3327675,14211656,0.000000,74882212.055900,51319621.600000,126201833.655900,0,23764,14952,38716
2012-09-07,NASDAQ BX (B),95289490,33462963,45432488,174184941,2475285489.824999,1423958130.705000,1651610514.650197,5550854135.180196,583748,110111,283230,977089
2012-09-07,NSX (C),10367126,3693847,6667571,20728544,225266696.661000,94582533.614600,154289614.166500,474138844.442100,29570,7803,16630,54003
2012-09-07,NYSE (DN),125890712,28506956,58335732,212733400,3528712872.087060,1324305791.813497,1773633998.588697,6626652662.489254,730237,118103,318953,1167293
2012-09-07,NASDAQ (DQ),1132281858,330488889,580621954,2043392701,27995495343.086651,14199162093.512629,15722909571.441561,57917567008.040841,3006481,504991,1403406,4914878
2012-09-07,EDGA (J),85842457,39409652,39146301,164398410,1911353259.224197,1687959185.124201,925545060.101699,4524857504.450097,447184,122496,208807,778487
2012-09-07,EDGX (K),263202857,77593888,156393346,497190091,6823970964.722898,2914567114.218599,4604897590.402740,14343435669.344237,1146659,179295,606433,1932387
2012-09-07,CHX (M),13309503,12851754,5908870,32070127,338765989.082200,731390839.721000,205458555.922900,1275615384.726100,387,2911,415,3713
2012-09-07,NYSE (N),679953080,0,0,679953080,21016952792.607967,0.000000,0.000000,21016952792.607967,1861546,0,0,1861546
2012-09-07,NYSE Arca (P),362630422,215930172,188992624,767553218,10127520551.390859,11365783360.751605,6954868433.597579,28448172345.740043,1821465,463381,934795,3219641
2012-09-07,NASDAQ (Q),446797113,154239569,393815972,994852654,13071769523.597690,9134786759.599213,12987391228.646985,35193947511.843888,2396481,470770,1623227,4490478
2012-09-07,CBSX (W),20185081,5187966,8375393,33748440,543102225.200000,235030211.840000,193410731.415900,971543168.455900,131372,14633,53957,199962
2012-09-07,NASDAQ PSX (X),27959445,16978748,26282171,71220364,602146747.535000,973828920.355000,579319423.505000,2155295091.395000,116453,40166,80833,237452
2012-09-07,BATS BYX (Y),140833894,32502516,57743406,231079816,3654109619.739998,1356929071.257000,1571757092.175001,6582795783.171999,886228,123491,359307,1369026
2012-09-07,BATS BZX (Z),313870877,120810237,174214159,608895273,8395654973.356304,6656461217.439096,5299980766.403914,20352096957.199314,1760728,377685,951332,3089745
2012-09-06,NYSE MKT (A),0,14094982,2796503,16891485,0.000000,68534460.941000,37717139.745000,106251600.686000,0,21182,11765,32947
2012-09-06,NASDAQ BX (B),104468897,42064501,52008933,198542331,2462609040.019999,1866151229.378799,1924269757.007503,6253030026.406301,583238,131200,335975,1050413
2012-09-06,NSX (C),10644534,5174093,6558915,22377542,244972968.249100,141849167.625200,227443342.426300,614265478.300600,31060,8563,18928,58551
2012-09-06,NYSE (DN),127769073,31296912,61705418,220771403,3746967964.788780,1325746169.589704,1811346401.555895,6884060535.934379,759849,112228,349996,1222073
2012-09-06,NASDAQ (DQ),1192036911,397717176,614048915,2203803002,29590089675.683135,17069766954.312060,17300910634.371956,63960767264.367151,3294166,537527,1598148,5429841
2012-09-06,EDGA (J),89177216,43345384,40267281,172789881,2006471340.604399,1801892758.890799,983266321.623999,4791630421.119197,457670,124509,217178,799357
2012-09-06,EDGX (K),283454517,92865936,163889647,540210100,7555069912.650391,3415172265.563702,4855021901.015013,15825264079.229106,1252756,197011,668131,2117898
2012-09-06,CHX (M),13421926,8773527,12656600,34852053,392836808.053000,815717340.317600,297736531.378900,1506290679.749500,279,2662,596,3537
2012-09-06,NYSE (N),736474147,0,0,736474147,22845043548.282672,0.000000,0.000000,22845043548.282672,2052015,0,0,2052015
2012-09-06,NYSE Arca (P),393463564,240931622,208436644,842831830,11043680263.856089,13072501845.261802,7469393089.986305,31585575199.104196,2004030,487975,1038759,3530764
2012-09-06,NASDAQ (Q),460440462,166425232,458109447,1084975141,13928854958.617574,10234504723.804323,14380073948.684406,38543433631.106303,2557671,512331,1921204,4991206
2012-09-06,CBSX (W),23015269,9644689,10497376,43157334,607731877.470000,499757672.989200,243517333.342700,1351006883.801900,144622,17366,67426,229414
2012-09-06,NASDAQ PSX (X),30364800,21666378,30581640,82612818,653529387.385000,1291396686.265000,641169576.220000,2586095649.870000,126213,44440,89877,260530
2012-09-06,BATS BYX (Y),160525675,37614916,70812103,268952694,4302689487.606900,1608384654.679495,1822688244.637299,7733762386.923694,1023788,135679,456999,1616466
2012-09-06,BATS BZX (Z),328344186,139059404,197683705,665087295,8959149126.814118,7806757261.625891,5604207243.882398,22370113632.322407,1870105,413713,1082765,3366583
2012-09-05,NYSE MKT (A),0,12862465,3447170,16309635,0.000000,61928256.219700,44398870.630000,106327126.849700,0,20145,16156,36301
2012-09-05,NASDAQ BX (B),89221244,25180712,39444233,153846189,2169540679.091999,1215863377.535000,1445703040.064402,4831107096.691401,526566,88183,264843,879592
2012-09-05,NSX (C),8783308,3682370,5328330,17794008,190245032.322800,74721473.369300,151136563.789799,416103069.481899,25980,7531,14799,48310
2012-09-05,NYSE (DN),115558152,17953478,47915604,181427234,3365656230.130431,821076379.627401,1432661435.637289,5619394045.395121,697285,73588,288199,1059072
2012-09-05,NASDAQ (DQ),1041889255,247099337,496392095,1785380687,25239284810.926058,10485206210.878197,13415517596.060073,49140008617.864328,2896168,347264,1286228,4529660
2012-09-05,EDGA (J),71874608,30242424,31819860,133936892,1673207189.305400,1250531835.193098,778566220.918400,3702305245.416898,394828,96092,180198,671118
2012-09-05,EDGX (K),211397108,57635248,116649815,385682171,5614972290.530302,2108135545.891393,3432845306.002800,11155953142.424495,982474,130025,501972,1614471
2012-09-05,CHX (M),10340121,8266893,5995812,24602826,305792003.908900,553043484.977600,253649258.566300,1112484747.452800,312,1443,347,2102
2012-09-05,NYSE (N),675645830,0,0,675645830,20525721912.126435,0.000000,0.000000,20525721912.126435,1824111,0,0,1824111
2012-09-05,NYSE Arca (P),327529574,152365534,153052803,632947911,9184788409.894421,8344722933.216306,5253761224.575362,22783272567.686089,1727453,340217,803825,2871495
2012-09-05,NASDAQ (Q),381001769,122237431,372295029,875534229,11262980895.360557,7777642924.316915,11532249004.378627,30572872824.056099,2160038,378184,1580240,4118462
2012-09-05,CBSX (W),19162473,7381520,7897295,34441288,496839543.933000,232776509.730000,173485807.340000,903101861.003000,128343,10155,53043,191541
2012-09-05,NASDAQ PSX (X),25475602,12765167,23593099,61833868,540529056.860000,704501877.190000,501165394.640000,1746196328.690000,109177,28699,78444,216320
2012-09-05,BATS BYX (Y),132795838,24454128,51265004,208514970,3437155461.348904,1013945382.638599,1313642791.034995,5764743635.022498,844604,93709,341294,1279607
2012-09-05,BATS BZX (Z),279435087,92978144,150881717,523294948,7488324350.900993,5358056427.435098,4284015056.984597,17130395835.320688,1608766,292719,882839,2784324
2012-09-04,NYSE MKT (A),0,10821985,3426125,14248110,0.000000,60326758.155700,38557499.617300,98884257.773000,0,19423,14421,33844
2012-09-04,NASDAQ BX (B),87408369,31529566,46307947,165245882,2254649329.160000,1554592900.139100,1592418515.773999,5401660745.073099,564109,118673,302395,985177
2012-09-04,NSX (C),8534295,3389251,6540011,18463557,208407587.920700,91702552.954400,212414437.098500,512524577.973600,29713,7375,18387,55475
2012-09-04,NYSE (DN),102323568,21955790,48067724,172347082,2893514787.156584,1053122013.768201,1478262692.572100,5424899493.496885,619246,93505,272448,985199
2012-09-04,NASDAQ (DQ),996911477,328028419,464020058,1788959954,27057409758.691732,17069892527.931638,13022554710.597899,57149856997.221269,2721863,427737,1314590,4464190
2012-09-04,EDGA (J),72399191,35216462,36578597,144194250,1687211907.719899,1601501667.448301,839788506.032699,4128502081.200899,408495,116528,197324,722347
2012-09-04,EDGX (K),199238040,74079950,128349013,401667003,5643445246.575391,3094364092.456898,3869793516.702192,12607602855.734481,1016419,178664,544028,1739111
2012-09-04,CHX (M),5406229,5906776,4087858,15400863,200842439.965000,505497465.352700,216149601.585100,922489506.902800,231,2003,380,2614
2012-09-04,NYSE (N),639224017,0,0,639224017,20159963185.829128,0.000000,0.000000,20159963185.829128,1843663,0,0,1843663
2012-09-04,NYSE Arca (P),293111746,191320433,155370309,639802488,8685090231.571708,10683795174.436701,5708830328.916707,25077715734.925116,1606080,416376,830619,2853075
2012-09-04,NASDAQ (Q),364952320,146450243,374767762,886170325,11149386499.183430,9436914725.915113,12067162335.887127,32653463560.985670,2175226,458016,1626575,4259817
2012-09-04,CBSX (W),18992981,50733085,7850406,77576472,519192964.420000,3946918022.800000,187577830.369900,4653688817.589900,121464,12439,56032,189935
2012-09-04,NASDAQ PSX (X),23132515,15044775,21200795,59378085,545013109.900000,895789948.845000,451171568.341000,1891974627.086000,105872,35032,74165,215069
2012-09-04,BATS BYX (Y),127810875,31593410,58272485,217676770,3291977216.700008,1438329700.624300,1491345023.630601,6221651940.954909,820196,126288,369387,1315871
2012-09-04,BATS BZX (Z),261390191,115733374,158796017,535919582,7406666055.682199,6851688557.668993,4670994915.278063,18929349528.629255,1601963,368805,928937,2899705
2012-08-31,NYSE MKT (A),0,9614469,2601985,12216454,0.000000,62309642.959200,34126442.100800,96436085.060000,0,19413,10904,30317
2012-08-31,NASDAQ BX (B),77135103,31316957,39440003,147892063,1975180809.833003,1546575599.735098,1331839907.508100,4853596317.076201,491692,118639,243366,853697
2012-08-31,NSX (C),7080121,3885939,4784427,15750487,173031076.092600,131101811.573000,136368974.978500,440501862.644100,23871,7750,14937,46558
2012-08-31,NYSE (DN),85948763,20492180,40265466,146706409,2473129335.947292,976623961.283702,1178380924.084899,4628134221.315893,552224,84351,230686,867261
2012-08-31,NASDAQ (DQ),835633566,293059050,420254203,1548946819,22879791448.708753,12196879076.627925,11942258869.831078,47018929395.167756,2084192,413399,1066396,3563987
2012-08-31,EDGA (J),58112447,41470584,30933454,130516485,1397776507.251600,1838036885.879700,774085012.843500,4009898405.974800,344604,133653,169480,647737
2012-08-31,EDGX (K),146024175,62747252,95458715,304230142,4085740835.391192,2627410339.672397,2545806643.556294,9258957818.619883,770317,153103,415497,1338917
2012-08-31,CHX (M),3289082,7481195,1655513,12425790,101623187.725000,664346827.152700,60637765.672000,826607780.549700,174,3080,341,3595
2012-08-31,NYSE (N),746071562,0,0,746071562,23725118136.046862,0.000000,0.000000,23725118136.046862,1708913,0,0,1708913
2012-08-31,NYSE Arca (P),283638502,225708182,160630935,669977619,8148007958.365881,12531360796.821489,6155607049.515197,26834975804.702567,1528191,467409,779720,2775320
2012-08-31,NASDAQ (Q),324557817,180567180,393110526,898235523,9807481667.962905,12420952121.436589,12210751836.266285,34439185625.665779,1939258,566155,1391840,3897253
2012-08-31,CBSX (W),15141551,3938448,7288545,26368544,383185374.350000,189192128.200000,156047445.010000,728424947.560000,107841,14746,48422,171009
2012-08-31,NASDAQ PSX (X),17288175,16320335,17977422,51585932,383404488.795000,1078286492.600000,387715873.550000,1849406854.945000,77106,35299,54395,166800
2012-08-31,BATS BYX (Y),113123422,35096555,52114839,200334816,2923475638.704993,1623890339.547899,1355717788.208201,5903083766.461093,742421,128242,324670,1195333
2012-08-31,BATS BZX (Z),225456424,129947194,136723716,492127334,6396352024.089981,7820090870.351610,4172485902.429614,18388928796.871205,1395609,411298,750550,2557457
2012-08-30,NYSE MKT (A),0,7701649,3820097,11521746,0.000000,41605993.850900,43750382.510000,85356376.360900,0,15688,10946,26634
2012-08-30,NASDAQ BX (B),70057393,22792700,38499214,131349307,1773446441.185001,1085765167.608000,1234434709.720903,4093646318.513904,436322,79586,240219,756127
2012-08-30,NSX (C),6505295,2702558,4818121,14025974,141886191.269900,63731039.769500,160383028.751400,366000259.790800,21153,5307,13734,40194
2012-08-30,NYSE (DN),82883018,19381561,39337292,141601871,2427735600.744390,920782949.282201,1181576159.440797,4530094709.467388,500969,74907,228519,804395
2012-08-30,NASDAQ (DQ),782326145,215852043,374276513,1372454701,20084989653.993103,9558483742.253322,10679541981.177894,40323015377.424319,2032859,342685,1018994,3394538
2012-08-30,EDGA (J),52527348,27260418,27727687,107515453,1252740925.171799,1193246874.244300,657546964.015200,3103534763.431299,302039,87800,150572,540411
2012-08-30,EDGX (K),139592757,43283106,93245782,276121645,4046007199.581109,1608626592.190602,2580500787.568911,8235134579.340622,732093,104262,401937,1238292
2012-08-30,CHX (M),12950299,6283338,3699820,22933457,368267039.826800,496488094.170000,102256777.117300,967011911.114100,263,1241,336,1840
2012-08-30,NYSE (N),511726120,0,0,511726120,15735367313.846681,0.000000,0.000000,15735367313.846681,1431192,0,0,1431192
2012-08-30,NYSE Arca (P),255059906,144771634,140893507,540725047,7463355356.148119,7411970514.749302,5027357633.900182,19902683504.797603,1352639,307549,680981,2341169
2012-08-30,NASDAQ (Q),285544752,114978734,302020767,702544253,8780396963.767890,7047080556.955905,9558439072.763227,25385916593.487022,1671493,333287,1270491,3275271
2012-08-30,CBSX (W),18532560,2938834,6866239,28337633,440411978.030000,145293878.040000,159955094.020000,745660950.090000,114227,10931,50707,175865
2012-08-30,NASDAQ PSX (X),18766629,12877396,17568812,49212837,452873817.120000,821816676.709800,356022597.805000,1630713091.634800,92714,26698,54580,173992
2012-08-30,BATS BYX (Y),99745309,25439240,46428209,171612758,2561873549.733501,1192061511.447499,1091490502.368799,4845425563.549799,634645,95867,283661,1014173
2012-08-30,BATS BZX (Z),194541775,81402480,121647845,397592100,5715840017.133321,4590064137.982502,3539830522.349601,13845734677.465424,1199403,259361,682204,2140968
2012-08-29,NYSE MKT (A),0,6373823,7647789,14021612,0.000000,43573749.654000,72708698.740000,116282448.394000,0,14933,14258,29191
2012-08-29,NASDAQ BX (B),74679063,18588834,39460068,132727965,2056390589.295000,843626566.148000,1229976335.550795,4129993490.993795,484276,68749,235279,788304
2012-08-29,NSX (C),7157082,2593754,7749230,17500066,169989407.672100,69734959.692000,173455254.053100,413179621.417200,22869,5855,15697,44421
2012-08-29,NYSE (DN),96162847,14613623,41634186,152410656,2820978531.434403,700808921.299899,1199013882.783096,4720801335.517398,589433,63247,237839,890519
2012-08-29,NASDAQ (DQ),771712181,176880008,425542447,1374134636,19283864774.247086,7332947283.312023,11779747519.808452,38396559577.367561,2104715,299814,1016081,3420610
2012-08-29,EDGA (J),66533100,24348390,31458616,122340106,1575581359.311199,1059490324.188699,770694998.273201,3405766681.773099,381252,84138,176645,642035
2012-08-29,EDGX (K),139016287,36319964,94804562,270140813,4051906745.510199,1435325459.557001,2442229273.891223,7929461478.958423,711558,92379,406283,1210220
2012-08-29,CHX (M),7705113,8055988,8715936,24477037,195516086.938400,621279293.597500,226676402.277600,1043471782.813500,199,1246,551,1996
2012-08-29,NYSE (N),509406431,0,0,509406431,16189857302.543795,0.000000,0.000000,16189857302.543795,1469368,0,0,1469368
2012-08-29,NYSE Arca (P),264162685,113876089,138753672,516792446,7862781057.061384,5914187193.163103,4688201137.002787,18465169387.227274,1387284,269599,679802,2336685
2012-08-29,NASDAQ (Q),299966500,102647731,296905350,699519581,9182945508.639798,6508238863.677592,8843551235.005417,24534735607.322807,1747230,316459,1255370,3319059
2012-08-29,CBSX (W),17446733,2764847,6982138,27193718,450411735.940000,141046822.510000,158603473.170000,750062031.620000,123605,10145,50584,184334
2012-08-29,NASDAQ PSX (X),16654492,10116795,17891645,44662932,346600008.825000,570812182.030000,341310768.014400,1258722958.869400,69634,22087,47168,138889
2012-08-29,BATS BYX (Y),104994812,20718807,47233023,172946642,2744014741.450004,935798433.315000,1129674860.181900,4809488034.946904,683706,84269,287979,1055954
2012-08-29,BATS BZX (Z),198056179,70351248,122968042,391375469,5714059875.734007,3867828491.289098,3374366168.794603,12956254535.817708,1211278,230386,654557,2096221
2012-08-28,NYSE MKT (A),0,7630872,3922359,11553231,0.000000,44108204.438900,53837548.744000,97945753.182900,0,17405,16212,33617
2012-08-28,NASDAQ BX (B),76098606,18688642,42143610,136930858,2037811679.404001,865285244.070000,1282120996.161601,4185217919.635602,498757,74202,241257,814216
2012-08-28,NSX (C),7240691,2753104,7327808,17321603,176572924.657300,84070901.797900,146929069.510000,407572895.965200,24389,6254,16991,47634
2012-08-28,NYSE (DN),83897373,12838145,39129056,135864574,2441865400.031987,598775665.694200,1137987073.656096,4178628139.382283,521405,57949,224474,803828
2012-08-28,NASDAQ (DQ),751611283,181075944,436869796,1369557023,19929774002.322201,7268799061.839750,11410036402.464485,38608609466.626436,2207369,306527,1074364,3588260
2012-08-28,EDGA (J),63261879,26109863,32647796,122019538,1478457009.490997,1087508932.356100,833932754.785100,3399898696.632197,358433,87832,182262,628527
2012-08-28,EDGX (K),143388465,40068134,99751864,283208463,4199325833.279398,1479872099.867802,2675075345.635715,8354273278.782915,736702,100224,432455,1269381
2012-08-28,CHX (M),7325634,5800264,4683566,17809464,280880149.557500,346974698.457200,243831331.831300,871686179.846000,602,1186,603,2391
2012-08-28,NYSE (N),516705950,0,0,516705950,15729598131.196586,0.000000,0.000000,15729598131.196586,1585281,0,0,1585281
2012-08-28,NYSE Arca (P),296754818,127853682,167980769,592589269,8976632451.892208,6428023499.935197,5700554953.033097,21105210904.860502,1584299,309191,780783,2674273
2012-08-28,NASDAQ (Q),334805453,112948401,327740430,775494284,10333002176.692706,7317752855.653084,9700762998.322174,27351518030.667964,1958351,356954,1402892,3718197
2012-08-28,CBSX (W),17112374,3278707,7736506,28127587,428779789.230000,143184247.800000,163726400.565000,735690437.595000,122912,10263,54556,187731
2012-08-28,NASDAQ PSX (X),17874076,10522615,22466520,50863211,394319638.680000,676472082.457800,441886533.665000,1512678254.802800,80348,25106,61898,167352
2012-08-28,BATS BYX (Y),107170901,21664335,54761276,183596512,2759853419.229998,962831445.217000,1255640413.893300,4978325278.340298,697516,91065,331699,1120280
2012-08-28,BATS BZX (Z),207090117,77858215,133469539,418417871,5820360703.445115,4228083346.080606,3708784657.360518,13757228706.886239,1255392,256257,732722,2244371
2012-08-27,NYSE MKT (A),0,7422076,3917029,11339105,0.000000,46122809.349200,52941377.407400,99064186.756600,0,16688,15302,31990
2012-08-27,NASDAQ BX (B),68045886,18191531,42621685,128859102,1727531842.704998,844998389.286700,1171286613.293802,3743816845.285500,428168,71693,233578,733439
2012-08-27,NSX (C),6657132,2465444,6463210,15585786,155758295.204800,72667955.014400,186271210.286600,414697460.505800,21143,5035,15860,42038
2012-08-27,NYSE (DN),81461805,15178421,45930951,142571177,2399745171.087799,719904445.433698,1215976901.830598,4335626518.352095,500668,64030,228642,793340
2012-08-27,NASDAQ (DQ),692109314,182185454,433642447,1307937215,18133738339.662047,7520739343.967955,11935846654.635005,37590324338.265007,2011609,309475,1007714,3328798
2012-08-27,EDGA (J),55193891,27209210,32224083,114627184,1375458106.589999,1183487437.526000,736640776.275400,3295586320.391399,316804,94772,164768,576344
2012-08-27,EDGX (K),145162304,39587330,102503947,287253581,4324587086.271605,1510749053.115899,2936935210.622196,8772271350.009700,753486,97611,414762,1265859
2012-08-27,CHX (M),8217814,3502136,3748451,15468401,199494307.818000,246974374.687600,149349197.990500,595817880.496100,258,1091,527,1876
2012-08-27,NYSE (N),504298740,0,0,504298740,15726612787.093753,0.000000,0.000000,15726612787.093753,1474180,0,0,1474180
2012-08-27,NYSE Arca (P),276377500,128525732,158720797,563624029,7863703873.270313,6416269915.019202,5786104964.118792,20066078752.408307,1426904,290905,714694,2432503
2012-08-27,NASDAQ (Q),310706078,96672751,335637382,743016211,9457569171.270916,5859109999.324888,10546550887.015307,25863230057.611111,1774059,305480,1326837,3406376
2012-08-27,CBSX (W),16375124,2353286,7185509,25913919,410093011.590000,121640840.050000,157090747.140000,688824598.780000,111017,9852,50715,171584
2012-08-27,NASDAQ PSX (X),17306245,9587133,23686693,50580071,370365440.435000,597082654.730000,382870692.390000,1350318787.555000,71977,20929,55459,148365
2012-08-27,BATS BYX (Y),99766412,21163313,55108201,176037926,2685153429.916001,953583635.847000,1270485890.855499,4909222956.618500,669060,84782,332646,1086488
2012-08-27,BATS BZX (Z),191229948,70648704,136598059,398476711,5461744031.019006,3887722426.457596,3705633443.106801,13055099900.583403,1169003,233632,705252,2107887
2012-08-24,NYSE MKT (A),0,8195763,2581149,10776912,0.000000,50715940.665500,37232024.610000,87947965.275500,0,17488,11322,28810
2012-08-24,NASDAQ BX (B),68840837,21112922,37118466,127072225,1771757172.495299,937447637.828200,1291191134.861401,4000395945.184900,428264,77525,235440,741229
2012-08-24,NSX (C),7115128,3355415,7385224,17855767,173710451.665500,98466846.622500,177595488.642201,449772786.930201,23493,6666,17733,47892
2012-08-24,NYSE (DN),81591118,15297261,36910875,133799254,2441145655.191190,795303859.672099,1206691564.619895,4443141079.483184,490520,64206,206197,760923
2012-08-24,NASDAQ (DQ),732490577,248365765,432700612,1413556954,19567704761.701648,11015206726.194524,13172974910.848603,43755886398.744775,2082290,349385,1079555,3511230
2012-08-24,EDGA (J),58473329,30380219,32346931,121200479,1409711962.991701,1333707235.912299,833700114.911903,3577119313.815903,326867,103668,176968,607503
2012-08-24,EDGX (K),147035850,46140258,99840777,293016885,4535462771.676296,1807392357.464700,3013235336.607691,9356090465.748687,772345,109917,446804,1329066
2012-08-24,CHX (M),8888847,7136008,2192250,18217105,324087504.981600,472439181.262300,106428006.777100,902954693.021000,218,1505,344,2067
2012-08-24,NYSE (N),515249848,0,0,515249848,16633091542.847772,0.000000,0.000000,16633091542.847772,1551906,0,0,1551906
2012-08-24,NYSE Arca (P),289999550,148451507,163094000,601545057,8544021552.732311,7950997570.780302,6546055896.904008,23041075020.416621,1528700,320735,801908,2651343
2012-08-24,NASDAQ (Q),331473684,114802695,328536248,774812627,10179797788.781195,7190470486.288802,11536051381.252719,28906319656.322716,1901918,355203,1453135,3710256
2012-08-24,CBSX (W),17320844,2727893,7540135,27588872,450461570.970000,145523790.150000,173386969.240000,769372330.360000,123381,10773,52067,186221
2012-08-24,NASDAQ PSX (X),18582973,12574839,20504918,51662730,433025010.755000,800781602.600000,455936644.545000,1689743257.900000,81334,25360,60533,167227
2012-08-24,BATS BYX (Y),111809568,24851630,52532153,189193351,2988937970.334997,1142333705.396699,1411821307.707599,5543092983.439295,733226,96065,340147,1169438
2012-08-24,BATS BZX (Z),210519140,93315445,130869309,434703894,5959476609.123604,5500015433.088901,4220920267.653095,15680412309.865600,1250261,292067,745220,2287548
2012-08-23,NYSE MKT (A),0,9939744,3323089,13262833,0.000000,70209028.388800,43575494.132500,113784522.521300,0,22501,15360,37861
2012-08-23,NASDAQ BX (B),77041485,24760831,37569937,139372253,1899229974.071699,1067166953.425000,1301138049.431799,4267534976.928498,474523,90320,241412,806255
2012-08-23,NSX (C),8822719,3738454,6195777,18756950,197661747.045300,92367404.855900,246666067.589301,536695219.490501,25972,7408,16087,49467
2012-08-23,NYSE (DN),95554892,20127384,38451210,154133486,2591713586.112783,956726514.481597,1275266776.284899,4823706876.879279,564905,78259,227464,870628
2012-08-23,NASDAQ (DQ),842511568,266332155,421432585,1530276308,20906265471.308491,12167127444.270711,13184182089.551548,46257575005.130750,2335286,402610,1110445,3848341
2012-08-23,EDGA (J),67510303,34998288,31242168,133750759,1528321246.860700,1496819550.905800,799986633.080601,3825127430.847101,368018,116949,171859,656826
2012-08-23,EDGX (K),183959206,59462813,108898146,352320165,5205807863.546500,2187349356.667603,3223316340.362695,10616473560.576798,944699,138111,484761,1567571
2012-08-23,CHX (M),6583262,8268917,4918838,19771017,206988324.651500,510167364.460700,152955104.015000,870110793.127200,271,2220,407,2898
2012-08-23,NYSE (N),592711934,0,0,592711934,18040893795.634763,0.000000,0.000000,18040893795.634763,1737798,0,0,1737798
2012-08-23,NYSE Arca (P),334792262,181762218,175860807,692415287,9003080401.884582,9688403102.754802,6835549449.089717,25527032953.729101,1672691,391006,875491,2939188
2012-08-23,NASDAQ (Q),400771387,133121662,353641105,887534154,11330052225.045748,7824804890.114296,11693103943.644313,30847961058.804357,2222580,423222,1541994,4187796
2012-08-23,CBSX (W),16768545,4600157,7927208,29295910,447755478.890000,201772155.940000,171650104.990000,821177739.820000,116244,12543,55863,184650
2012-08-23,NASDAQ PSX (X),22378811,13255892,20113348,55748051,474877854.455000,782042587.230500,412990660.420000,1669911102.105500,91189,28175,58553,177917
2012-08-23,BATS BYX (Y),123242597,30806798,50361809,204411204,3075311276.236491,1346459551.156098,1334372629.678997,5756143457.071586,783634,121153,334480,1239267
2012-08-23,BATS BZX (Z),237234478,101757298,132780611,471772387,6489670491.557288,5930337077.126009,4279143790.113393,16699151358.796690,1425517,330177,776897,2532591
2012-08-22,NYSE MKT (A),0,7689177,4039541,11728718,0.000000,50410848.622200,53947786.560000,104358635.182200,0,18421,16362,34783
2012-08-22,NASDAQ BX (B),76421150,25951085,39559535,141931770,1883463939.630000,1197903774.218400,1451078434.549498,4532446148.397898,470009,95279,243017,808305
2012-08-22,NSX (C),9129842,3461355,5938064,18529261,204627098.550600,107274298.741700,256449885.987300,568351283.279600,28907,7175,16145,52227
2012-08-22,NYSE (DN),89882363,18175602,40890927,148948892,2564378390.744597,928167812.144100,1388193144.756791,4880739347.645488,551538,78878,233652,864068
2012-08-22,NASDAQ (DQ),845487257,293601007,447270520,1586358784,21061070348.773288,14833608807.595839,14379424952.225041,50274104108.594168,2298876,389316,1124870,3813062
2012-08-22,EDGA (J),66469218,38502760,33750135,138722113,1510653005.616599,1641567791.929699,858332172.639699,4010552970.185997,364009,121249,178124,663382
2012-08-22,EDGX (K),182673677,59745540,111292159,353711376,5077281020.659795,2304754338.655899,3192910492.870477,10574945852.186171,929435,137189,481410,1548034
2012-08-22,CHX (M),9321835,10174603,7901536,27397974,229022339.485400,678965432.206400,215203233.959500,1123191005.651300,425,2075,418,2918
2012-08-22,NYSE (N),600776474,0,0,600776474,18913313139.935753,0.000000,0.000000,18913313139.935753,1785594,0,0,1785594
2012-08-22,NYSE Arca (P),357772455,173979016,179002838,710754309,9254899173.048599,9008380899.609213,7421611523.857963,25684891596.515775,1673161,399688,870865,2943714
2012-08-22,NASDAQ (Q),400811552,152201366,363298825,916311743,11267493212.378758,9465609064.632903,12444196648.655115,33177298925.666776,2201570,466000,1534386,4201956
2012-08-22,CBSX (W),18392413,3934209,8187607,30514229,487403307.530000,222973307.660000,170341657.640000,880718272.830000,124358,11014,54696,190068
2012-08-22,NASDAQ PSX (X),26228774,16118816,22164549,64512139,523204645.685000,1015351947.553900,495330821.615000,2033887414.853900,94855,32576,63830,191261
2012-08-22,BATS BYX (Y),126852347,30718011,53985568,211555926,3131886514.607394,1450915925.563500,1467983605.332600,6050786045.503494,799268,116789,344664,1260721
2012-08-22,BATS BZX (Z),253449962,108183159,144737817,506370938,6706817740.679889,6256246261.325592,4673972476.145612,17637036478.151093,1448213,344791,804738,2597742
2012-08-21,NYSE MKT (A),0,11886363,3821890,15708253,0.000000,70925141.801800,51461027.459600,122386169.261400,0,23331,13970,37301
2012-08-21,NASDAQ BX (B),79190405,27619503,39703139,146513047,1951333069.014999,1209339456.855000,1648540409.296598,4809212935.166597,482496,94947,251032,828475
2012-08-21,NSX (C),10503548,3639549,7234388,21377485,236405515.691600,104152090.968800,295062555.528900,635620162.189300,29436,7436,18009,54881
2012-08-21,NYSE (DN),103585673,20415049,44991531,168992253,2904995366.623789,1003824418.275895,1757632900.105311,5666452685.004995,612735,79644,254092,946471
2012-08-21,NASDAQ (DQ),962747543,291757626,496242023,1750747192,24811561849.224566,12631305247.877953,17759755562.576450,55202622659.678969,2567644,437401,1275793,4280838
2012-08-21,EDGA (J),69391324,35266817,34245164,138903305,1578786156.574800,1422204409.748199,918498685.469198,3919489251.792197,375752,104961,182581,663294
2012-08-21,EDGX (K),204498225,57206670,118801633,380506528,5877622873.450813,2060708733.940899,3931651108.566009,11869982715.957721,1046081,136506,520313,1702900
2012-08-21,CHX (M),8725054,7719930,5669739,22114723,264032399.117000,587571827.315600,178993334.208000,1030597560.640600,472,1819,429,2720
2012-08-21,NYSE (N),640964563,0,0,640964563,19291990688.893801,0.000000,0.000000,19291990688.893801,1830246,0,0,1830246
2012-08-21,NYSE Arca (P),356062415,175591500,196708752,728362667,9687836249.957101,8843504709.417386,9160533433.442255,27691874392.816742,1738727,387471,933653,3059851
2012-08-21,NASDAQ (Q),418720271,143186419,396169856,958076546,11995015752.662041,8591715621.969486,14671601540.971924,35258332915.603451,2276644,445840,1667194,4389678
2012-08-21,CBSX (W),19800875,3138877,9253042,32192794,521906828.680000,153673494.990000,217903199.490000,893483523.160000,131829,12996,62130,206955
2012-08-21,NASDAQ PSX (X),23665543,17592713,22195540,63453796,522867152.045000,1026184442.630000,477435432.825000,2026487027.500000,98389,35079,64384,197852
2012-08-21,BATS BYX (Y),130158247,29872083,56387424,216417754,3289725711.870003,1351463821.258200,1621731455.080501,6262920988.208704,821540,113811,364207,1299558
2012-08-21,BATS BZX (Z),255496008,101868415,156880739,514245162,7028319370.260587,5804878606.890512,5442456548.283291,18275654525.434390,1521480,339846,901239,2762565
2012-08-20,NYSE MKT (A),0,8662103,2277689,10939792,0.000000,46138496.288600,29589213.070000,75727709.358600,0,16408,10758,27166
2012-08-20,NASDAQ BX (B),70153981,17908532,36613269,124675782,1798829675.044998,844515316.253000,1493555845.902296,4136900837.200294,444565,66722,236173,747460
2012-08-20,NSX (C),7414505,2436615,7678176,17529296,183773687.095100,68434057.054700,272713435.797598,524921179.947398,23995,5138,17789,46922
2012-08-20,NYSE (DN),89181793,14137972,38848521,142168286,2640067459.065676,661103815.901200,1393509422.839600,4694680697.806476,541688,58310,224894,824892
2012-08-20,NASDAQ (DQ),767123540,202806126,463124194,1433053860,20413055172.528387,9379485029.634189,14575790256.367010,44368330458.529586,2289803,311449,1169239,3770491
2012-08-20,EDGA (J),67757281,26969395,36477288,131203964,1739093489.687999,1218996501.897300,942130040.999302,3900220032.584601,397272,98178,198793,694243
2012-08-20,EDGX (K),170743423,43172490,110363607,324279520,5079436658.105413,1554481484.395600,3258062680.094701,9891980822.595714,893539,101082,470257,1464878
2012-08-20,CHX (M),8995977,10908267,5741436,25645680,310833841.388400,573573457.844000,215395289.004900,1099802588.237300,496,1244,381,2121
2012-08-20,NYSE (N),550725544,0,0,550725544,17430955923.261498,0.000000,0.000000,17430955923.261498,1584464,0,0,1584464
2012-08-20,NYSE Arca (P),307578800,132965813,176859300,617403913,8583712965.560109,6800770048.934691,7368931840.295974,22753414854.790774,1554526,300016,840380,2694922
2012-08-20,NASDAQ (Q),351412941,103228562,351550485,806191988,10495125263.320990,6335025714.628506,11464361934.758555,28294512912.708051,1978477,314055,1497781,3790313
2012-08-20,CBSX (W),20935973,3020991,10591527,34548491,557105874.800000,158963011.730000,231364131.450000,947433017.980000,146920,10546,72323,229789
2012-08-20,NASDAQ PSX (X),21513356,11342645,22393790,55249791,461657948.445000,743206773.380000,441528283.401000,1646393005.226000,86586,23617,64444,174647
2012-08-20,BATS BYX (Y),120552116,21175370,55606586,197334072,3102871012.899997,967718692.242500,1474681939.394799,5545271644.537296,774146,88811,356359,1219316
2012-08-20,BATS BZX (Z),212808473,70997795,140214746,424021014,6058186790.126288,3774628221.463694,4350165767.175298,14182980778.765280,1293395,237293,803297,2333985
2012-08-17,NYSE MKT (A),0,9932430,3361281,13293711,0.000000,53231249.193900,33812311.702600,87043560.896500,0,17902,11851,29753
2012-08-17,NASDAQ BX (B),72973145,22512108,43383857,138869110,1836555564.999999,984953928.986500,1605942905.843294,4427452399.829793,455605,79818,263526,798949
2012-08-17,NSX (C),6988525,2734684,7539876,17263085,184523684.125700,69215501.014700,161966959.699501,415706144.839901,25120,5314,19162,49596
2012-08-17,NYSE (DN),96931871,17781972,48030199,162744042,2737426291.092613,861006549.088500,1376142401.542997,4974575241.724110,577652,69994,265792,913438
2012-08-17,NASDAQ (DQ),804443294,230122795,517576606,1552142695,20734500668.159379,10364483917.139921,13811017386.922959,44910001972.222259,2270869,343165,1239726,3853760
2012-08-17,EDGA (J),68498663,27900349,35863686,132262698,1581695683.440200,1243034927.620399,883389860.840201,3708120471.900800,390777,91075,192818,674670
2012-08-17,EDGX (K),164143617,43594136,119476228,327213981,4814072682.709205,1707710053.497298,3330943159.769022,9852725895.975525,846628,107326,492107,1446061
2012-08-17,CHX (M),8559552,5394271,5995054,19948877,248034972.976900,438678878.516000,200394546.502100,887108397.995000,276,1243,459,1978
2012-08-17,NYSE (N),675845759,0,0,675845759,22541959917.226371,0.000000,0.000000,22541959917.226371,1608228,0,0,1608228
2012-08-17,NYSE Arca (P),304868323,154300636,196791190,655960149,8639805153.356689,8289959129.765291,7213205415.178293,24142969698.300273,1547589,330562,872936,2751087
2012-08-17,NASDAQ (Q),341058631,113543260,426620351,881222242,10186806839.809216,7259022291.151902,13996495459.222025,31442324590.183143,1914997,345825,1525390,3786212
2012-08-17,CBSX (W),21370564,4670096,11741423,37782083,565505280.320000,218012730.260000,245053064.230000,1028571074.810000,151748,14131,75709,241588
2012-08-17,NASDAQ PSX (X),21810186,13804787,23973481,59588454,465397028.290000,865656727.690000,488950400.774400,1820004156.754400,89713,30156,73679,193548
2012-08-17,BATS BYX (Y),118529768,23437635,56599411,198566814,3004248270.239798,1045908955.283600,1455553169.809201,5505710395.332599,762122,93431,360499,1216052
2012-08-17,BATS BZX (Z),217259327,80181382,148926274,446366983,6196608106.296610,4541843022.873996,4369403134.032373,15107854263.202979,1317900,268385,840603,2426888
2012-08-16,NYSE MKT (A),0,8627575,3057727,11685302,0.000000,53684498.614100,37422913.703300,91107412.317400,0,18531,12623,31154
2012-08-16,NASDAQ BX (B),72744481,26482822,51023959,150251262,1813896652.085002,1206784958.103401,1572576454.528798,4593258064.717201,455177,87438,288006,830621
2012-08-16,NSX (C),8788825,3353846,6925257,19067928,212858172.889400,104341960.644800,159925988.844100,477126122.378300,26342,6725,18753,51820
2012-08-16,NYSE (DN),109804117,20620226,62349458,192773801,3267810116.706389,1064964545.521599,1679559379.682902,6012334041.910890,645791,74930,314841,1035562
2012-08-16,NASDAQ (DQ),945559875,266707235,636964380,1849231490,25712916891.990462,13008291566.479819,15383443661.085642,54104652119.555923,2508632,387770,1454645,4351047
2012-08-16,EDGA (J),73431433,32166914,44749367,150347714,1711632111.003101,1402380893.534900,1030811689.789802,4144824694.327803,417912,104109,216406,738427
2012-08-16,EDGX (K),182182631,57567369,147458489,387208489,5335883395.853310,2275927718.446801,3837218645.554010,11449029759.854121,935007,133693,591474,1660174
2012-08-16,CHX (M),8851527,11251917,5062466,25165910,290122065.023800,1088365485.502600,183495757.465800,1561983307.992200,723,1670,630,3023
2012-08-16,NYSE (N),595983488,0,0,595983488,18903081903.391329,0.000000,0.000000,18903081903.391329,1838194,0,0,1838194
2012-08-16,NYSE Arca (P),324149273,172417264,245597740,742164277,9159517610.545014,9003576235.056710,7291991451.528462,25455085297.130186,1673225,369466,1053326,3096017
2012-08-16,NASDAQ (Q),396471790,125362771,456176175,978010736,11860617377.141046,7632784216.662688,12797120711.786833,32290522305.590567,2234029,393074,1828011,4455114
2012-08-16,CBSX (W),21029857,3868039,14056802,38954698,577271247.960000,221423038.560000,270980525.460000,1069674811.980000,147588,14021,82679,244288
2012-08-16,NASDAQ PSX (X),25548901,16327950,26076545,67953396,587893702.255000,1031238887.070000,528554837.130000,2147687426.455000,104970,31566,77358,213894
2012-08-16,BATS BYX (Y),121047334,28787486,69864594,219699414,3073482759.529995,1344877503.503002,1653238756.539903,6071599019.572900,780133,108498,412821,1301452
2012-08-16,BATS BZX (Z),237966419,94914635,180828892,513709946,6827149367.754610,5480169390.369499,4834290487.227094,17141609245.351203,1443368,305737,949998,2699103
2012-08-15,NYSE MKT (A),0,9526477,2260648,11787125,0.000000,44024943.658500,29798495.175600,73823438.834100,0,16751,9828,26579
2012-08-15,NASDAQ BX (B),63822692,20074748,41562488,125459928,1610783890.684999,872581147.033200,1154933973.093799,3638299010.811998,396939,69249,239212,705400
2012-08-15,NSX (C),7998384,4286459,7101396,19386239,181477206.478700,66326647.849700,170826223.843800,418630078.172200,23099,7317,15653,46069
2012-08-15,NYSE (DN),90873003,13995005,43138472,148006480,2723038092.718403,622357303.235100,1148870489.465006,4494265885.418509,545414,58219,236047,839680
2012-08-15,NASDAQ (DQ),778004232,184999275,498984541,1461988048,20056845471.605443,7653527332.839621,12072731363.445738,39783104167.890802,2103822,292853,1135205,3531880
2012-08-15,EDGA (J),60930725,22812707,34776772,118520204,1407023695.417599,995186343.609600,742159441.191099,3144369480.218298,344663,83465,180793,608921
2012-08-15,EDGX (K),158817408,45274219,116743899,320835526,4690410955.244003,1592292325.811700,2749932806.548910,9032636087.604613,819668,104009,488466,1412143
2012-08-15,CHX (M),6022659,4454987,5102564,15580210,169094772.211000,421412413.190000,317212437.030000,907719622.431000,501,992,118,1611
2012-08-15,NYSE (N),497834063,0,0,497834063,15569547457.959841,0.000000,0.000000,15569547457.959841,1549761,0,0,1549761
2012-08-15,NYSE Arca (P),287086366,131333543,195887863,614307772,8115162270.687781,6572561285.330511,5764241328.320901,20451964884.339193,1476204,299904,863302,2639410
2012-08-15,NASDAQ (Q),350552815,96085583,375153756,821792154,10384282640.494192,5945053988.090309,10273958864.600440,26603295493.184941,1952774,308803,1527517,3789094
2012-08-15,CBSX (W),18096728,2870208,9302213,30269149,499295496.200000,142683336.170000,197105481.250000,839084313.620000,127626,10739,63049,201414
2012-08-15,NASDAQ PSX (X),19902584,11013827,21246650,52163061,441047459.095000,667565234.130000,406141738.095000,1514754431.320000,80665,24935,59654,165254
2012-08-15,BATS BYX (Y),100099537,21330650,52552215,173982402,2533560436.219998,982498236.716200,1202147828.553800,4718206501.489998,641828,84394,315147,1041369
2012-08-15,BATS BZX (Z),216513022,72806624,147820371,437140017,6118388724.205092,4046231828.743594,3794054486.847388,13958675039.796074,1301783,235640,800834,2338257
2012-08-14,NYSE MKT (A),0,7850270,3116470,10966740,0.000000,43411491.812500,37847259.884700,81258751.697200,0,16695,11742,28437
2012-08-14,NASDAQ BX (B),73543584,22338675,41899188,137781447,1796522115.930002,1061400880.286800,1368799119.709093,4226722115.925895,465611,83945,248861,798417
2012-08-14,NSX (C),8258530,3160394,7376498,18795422,198753000.076000,70568688.965300,184482525.339500,453804214.380800,25661,6488,17886,50035
2012-08-14,NYSE (DN),96067773,14565148,44463067,155095988,2736552729.699693,711196916.026602,1340804815.403006,4788554461.129301,570150,60378,248915,879443
2012-08-14,NASDAQ (DQ),844152396,207248114,497887154,1549287664,21709246726.657168,9423770884.888558,12655691908.256369,43788709519.802095,2343478,323364,1210696,3877538
2012-08-14,EDGA (J),66640205,26976250,37034887,130651342,1522882097.837000,1228272698.479100,793719794.137898,3544874590.453998,361853,95325,199680,656858
2012-08-14,EDGX (K),174699746,50000443,120874792,345574981,4914910633.676991,2051300032.660999,2871234600.242195,9837445266.580185,882718,114615,497465,1494798
2012-08-14,CHX (M),6256292,4108876,6432821,16797989,201109989.181600,313960950.835000,135964686.214100,651035626.230700,383,1335,604,2322
2012-08-14,NYSE (N),566690380,0,0,566690380,17471695479.298456,0.000000,0.000000,17471695479.298456,1717671,0,0,1717671
2012-08-14,NYSE Arca (P),328374651,146866177,193106704,668347532,8854202680.529910,7723500228.415689,6124429912.617714,22702132821.563313,1668323,338568,883924,2890815
2012-08-14,NASDAQ (Q),373609890,111986671,382022001,867618562,11027964119.082609,7312883229.561822,11246006243.194890,29586853591.839321,2092418,347003,1604255,4043676
2012-08-14,CBSX (W),19898668,4687096,8837407,33423171,523810675.040000,190620712.940000,204648476.040000,919079864.020000,138221,11569,59508,209298
2012-08-14,NASDAQ PSX (X),26130689,11846511,26807774,64784974,561922430.040000,725574308.890000,483587426.257600,1771084165.187600,101985,25826,70725,198536
2012-08-14,BATS BYX (Y),114080332,24374067,57070494,195524893,2793651410.380001,1195154723.551900,1371804261.308104,5360610395.240005,721397,94804,345685,1161886
2012-08-14,BATS BZX (Z),233401833,82317016,147487130,463205979,6367537655.917511,4695177308.587806,4054896941.997608,15117611906.502925,1394956,267108,793517,2455581
2012-08-13,NYSE MKT (A),0,6868015,2361659,9229674,0.000000,39617689.242000,31812908.494500,71430597.736500,0,16095,10662,26757
2012-08-13,NASDAQ BX (B),61461626,19528006,35944960,116934592,1569166478.089001,857009594.830800,1229672549.664698,3655848622.584499,404151,74631,229692,708474
2012-08-13,NSX (C),7516253,2568376,6606724,16691353,171915197.437400,70189371.922100,163504296.269000,405608865.628500,23140,5818,17724,46682
2012-08-13,NYSE (DN),81749618,13898888,41238457,136886963,2303792895.087081,674251745.196000,1179589041.993902,4157633682.276983,506777,57591,230116,794484
2012-08-13,NASDAQ (DQ),715939408,199190886,433480269,1348610563,18184744672.024508,7702957499.066374,10828589628.648699,36716291799.739581,2086466,307747,1071846,3466059
2012-08-13,EDGA (J),53151581,19004513,32277154,104433248,1245484559.341498,848671770.808100,699288580.186700,2793444910.336298,307896,72862,183699,564457
2012-08-13,EDGX (K),147671426,43389162,97007392,288067980,4222121742.705589,1784004530.559900,2652879135.694496,8659005408.959985,771041,105172,433222,1309435
2012-08-13,CHX (M),5068933,6640442,3569528,15278903,170916936.502000,466029075.254300,127815574.401400,764761586.157700,486,1297,465,2248
2012-08-13,NYSE (N),484087772,0,0,484087772,15121141897.057749,0.000000,0.000000,15121141897.057749,1552135,0,0,1552135
2012-08-13,NYSE Arca (P),276513551,146656506,169752985,592923042,7459033642.872393,7672834319.187327,5370559401.002274,20502427363.061994,1485044,315799,802000,2602843
2012-08-13,NASDAQ (Q),326825982,99493833,329596511,755916326,9766334538.808027,6328963074.568093,9971790563.740111,26067088177.116231,1888100,311210,1426143,3625453
2012-08-13,CBSX (W),19468841,3327002,9843556,32639399,508085768.380000,160047529.300000,213427119.990000,881560417.670000,139496,11066,69881,220443
2012-08-13,NASDAQ PSX (X),21294678,13522931,21881375,56698984,450628247.640000,867361070.260000,444761314.160000,1762750632.060000,91609,29236,64399,185244
2012-08-13,BATS BYX (Y),95820881,22851789,47542223,166214893,2444307856.659998,1009135432.075000,1154987639.675599,4608430928.410597,647211,88337,304839,1040387
2012-08-13,BATS BZX (Z),203780277,77550664,132179629,413510570,5748661684.304003,4244903859.302900,3615610625.789293,13609176169.396196,1263325,250815,729408,2243548
2012-08-10,NYSE MKT (A),0,6803317,4339189,11142506,0.000000,43370469.632100,53654156.975900,97024626.608000,0,15196,13480,28676
2012-08-10,NASDAQ BX (B),65656176,19655032,42658248,127969456,1738397325.425202,833552718.243100,1215021004.143602,3786971047.811904,423711,71275,242186,737172
2012-08-10,NSX (C),7066343,2590114,9816709,19473166,160708979.528500,79108880.983900,126220731.050700,366038591.563100,23247,5367,23510,52124
2012-08-10,NYSE (DN),96540384,15821968,49811570,162173922,2819069457.675882,683545619.242400,1166942353.468696,4669557430.386978,585789,64365,261719,911873
2012-08-10,NASDAQ (DQ),765718016,203332148,483691159,1452741323,19590289028.969682,8560037383.031296,10037666657.167104,38187993069.168082,2194144,307042,1156185,3657371
2012-08-10,EDGA (J),62469343,25791621,34332761,122593725,1478673641.809500,1127460361.656099,743693713.943999,3349827717.409598,353317,86751,180308,620376
2012-08-10,EDGX (K),163187005,42883242,118235678,324305925,4729848766.817099,1660489199.652900,2523665018.471061,8914002984.941060,882665,105747,492111,1480523
2012-08-10,CHX (M),6981756,9047217,6891636,22920609,247643344.206600,980613276.813500,245125545.357600,1473382166.377700,602,1514,732,2848
2012-08-10,NYSE (N),566082868,0,0,566082868,17876605621.869287,0.000000,0.000000,17876605621.869287,1674280,0,0,1674280
2012-08-10,NYSE Arca (P),315391550,137141614,192911544,645444708,8541133976.662715,7334930433.043007,5273992739.623287,21150057149.329009,1645308,323773,887154,2856235
2012-08-10,NASDAQ (Q),352224584,107568091,370739308,830531983,10392793896.567387,7209217674.368595,10039511457.079455,27641523028.015437,2001214,334574,1506642,3842430
2012-08-10,CBSX (W),18942013,2749693,11323509,33015215,522313289.360000,139539389.380000,222518801.064500,884371479.804500,136528,10888,73275,220691
2012-08-10,NASDAQ PSX (X),23210705,13713655,25853283,62777643,501162072.590000,913826985.430000,461788973.265000,1876778031.285000,92250,29395,66877,188522
2012-08-10,BATS BYX (Y),101039557,22457386,56428920,179925863,2602838515.579903,1023665032.693400,1206201391.517998,4832704939.791301,664155,90307,336704,1091166
2012-08-10,BATS BZX (Z),224714861,82061528,154735564,461511953,6246637511.075011,4633599026.950797,3659525966.899591,14539762504.925399,1358903,262839,804530,2426272
2012-08-09,NYSE MKT (A),0,7639722,3134491,10774213,0.000000,46902791.861600,38804479.163600,85707271.025200,0,16527,13324,29851
2012-08-09,NASDAQ BX (B),74774185,20189174,44617068,139580427,1907746181.632999,904105314.722801,1231888944.769505,4043740441.125305,473720,72950,264501,811171
2012-08-09,NSX (C),8302912,2773841,7742481,18819234,177552062.064000,75474337.622700,155248609.005200,408275008.691900,26595,5602,18065,50262
2012-08-09,NYSE (DN),104901933,15574761,52452951,172929645,2975891850.883096,752608578.227199,1228813387.018996,4957313816.129291,615594,66331,274838,956763
2012-08-09,NASDAQ (DQ),907335536,201756663,541112429,1650204628,22486963183.509056,8693840205.679191,11497454863.334164,42678258252.522411,2494057,330764,1263623,4088444
2012-08-09,EDGA (J),67505253,24599021,38353652,130457926,1540833316.218102,1046817420.787200,809111434.793200,3396762171.798502,372324,85661,195193,653178
2012-08-09,EDGX (K),195353574,44303545,122501333,362158452,5290031832.317809,1745873168.549000,2735271996.562509,9771176997.429318,1016571,113394,537990,1667955
2012-08-09,CHX (M),6923666,4685680,5784168,17393514,252860689.705000,297013947.336800,540728937.528000,1090603574.569800,389,1205,705,2299
2012-08-09,NYSE (N),575756030,0,0,575756030,17688141875.692011,0.000000,0.000000,17688141875.692011,1772960,0,0,1772960
2012-08-09,NYSE Arca (P),354346243,139441160,214174283,707961686,9510241060.522016,7048264027.943799,5704125122.367213,22262630210.833028,1734803,322581,981181,3038565
2012-08-09,NASDAQ (Q),402221983,105876905,399088467,907187355,11494415380.179393,6682715608.311412,10840189955.341964,29017320943.832769,2170212,335272,1614723,4120207
2012-08-09,CBSX (W),23239285,3484775,11644807,38368867,565545892.590000,194882397.490000,250570498.040000,1010998788.120000,157250,11504,81374,250128
2012-08-09,NASDAQ PSX (X),28160828,15378327,29023929,72563084,578829079.530000,978723800.355000,524723912.502000,2082276792.387000,105113,31086,74844,211043
2012-08-09,BATS BYX (Y),114123335,24516536,57246671,195886542,2788128005.009899,1122318703.104100,1162133547.662601,5072580255.776600,723398,94323,343621,1161342
2012-08-09,BATS BZX (Z),257501762,82934818,163378434,503815014,6797256453.471781,4661517268.689795,3850694154.453308,15309467876.614884,1485846,270928,866704,2623478
2012-08-08,NYSE MKT (A),0,7430052,3604200,11034252,0.000000,53407933.500900,37811106.728100,91219040.229000,0,18062,12858,30920
2012-08-08,NASDAQ BX (B),82098261,20993000,51488977,154580238,2191396211.615000,924337544.240000,1518336026.770902,4634069782.625902,541846,77719,297197,916762
2012-08-08,NSX (C),8455392,2456563,10078895,20990850,213994201.469900,65358886.490300,155028915.239500,434382003.199700,29984,6142,21832,57958
2012-08-08,NYSE (DN),122631283,17220183,75573557,215425023,3598054284.021477,828138460.100000,1617046581.788800,6043239325.910277,720766,68617,315688,1105071
2012-08-08,NASDAQ (DQ),912687891,207503333,630067122,1750258346,23512305845.930404,8832649816.617013,13086139939.073483,45431095601.620900,2589101,329868,1315487,4234456
2012-08-08,EDGA (J),73161403,21655991,45010850,139828244,1779269692.541900,975238550.833700,995570224.021900,3750078467.397500,426641,83964,221557,732162
2012-08-08,EDGX (K),193324807,43112674,131518770,367956251,5522909049.315502,1798570487.917996,3096857368.923513,10418336906.157011,1051111,119888,567365,1738364
2012-08-08,CHX (M),9936067,6952201,5840985,22729253,306500744.327800,502712710.976500,302362119.022300,1111575574.326600,590,1268,911,2769
2012-08-08,NYSE (N),637109142,0,0,637109142,20054158404.675762,0.000000,0.000000,20054158404.675762,2028010,0,0,2028010
2012-08-08,NYSE Arca (P),358747414,153643804,224711774,737102992,9784347531.437566,7590989528.921996,6337488698.175602,23712825758.535164,1844387,352962,1008363,3205712
2012-08-08,NASDAQ (Q),385049198,109432760,415636228,910118186,10938145376.104797,6844432256.502787,11546274333.921630,29328851966.529214,2138214,342155,1677238,4157607
2012-08-08,CBSX (W),24486906,4215829,11864770,40567505,607789494.480000,194899361.160000,263384612.477300,1066073468.117300,172030,11763,82209,266002
2012-08-08,NASDAQ PSX (X),25656434,14558119,23643310,63857863,542772359.850000,946019803.400000,442066821.230000,1930858984.480000,108636,32355,71137,212128
2012-08-08,BATS BYX (Y),125017120,25450873,67433750,217901743,3173370965.534998,1128326270.012201,1386184953.497601,5687882189.044800,826850,102652,369891,1299393
2012-08-08,BATS BZX (Z),263891557,89024918,184549027,537465502,7281680212.877601,5094598311.307393,4298746283.286491,16675024807.471485,1599023,290730,922003,2811756
2012-08-07,NYSE MKT (A),0,10835106,3365844,14200950,0.000000,65152061.647700,37588223.250000,102740284.897700,0,20983,13630,34613
2012-08-07,NASDAQ BX (B),90352885,28463864,51507177,170323926,2357948024.835000,1302852085.551001,1479333797.608500,5140133907.994501,566186,96008,303231,965425
2012-08-07,NSX (C),10184779,3371434,8463337,22019550,253389288.930700,107967728.429300,179665664.798900,541022682.158900,34712,7034,20302,62048
2012-08-07,NYSE (DN),139685822,23204933,66684758,229575513,4013797112.899884,1094387828.693398,1707921724.975690,6816106666.568972,788609,89898,334750,1213257
2012-08-07,NASDAQ (DQ),1075928308,278845677,588183162,1942957147,27935148780.200245,12960407959.240661,13723723760.258367,54619280499.699273,3015433,403969,1403035,4822437
2012-08-07,EDGA (J),85219725,30462601,42112263,157794589,1966396105.715100,1313631143.005800,973865653.246499,4253892901.967399,486933,108253,219080,814266
2012-08-07,EDGX (K),219986561,55759720,130244959,405991240,6304264963.310792,2197275402.559399,3293624147.690400,11795164513.560591,1145474,144162,586472,1876108
2012-08-07,CHX (M),7715914,6941058,4540470,19197442,303381629.083000,491726401.480000,295561134.531600,1090669165.094600,558,1516,635,2709
2012-08-07,NYSE (N),728410333,0,0,728410333,22820693940.692022,0.000000,0.000000,22820693940.692022,2264432,0,0,2264432
2012-08-07,NYSE Arca (P),404869242,185404631,244147859,834421732,11161617915.697283,9177123579.203697,7284131806.432471,27622873301.333451,2106967,425911,1104554,3637432
2012-08-07,NASDAQ (Q),439892799,134806017,463244006,1037942822,12965155312.840434,8331499682.990819,12943288789.265906,34239943785.097159,2486093,410229,1916600,4812922
2012-08-07,CBSX (W),26850944,4432283,13881997,45165224,687308584.260000,222077608.310000,294131417.944800,1203517610.514800,184247,13878,91032,289157
2012-08-07,NASDAQ PSX (X),31418913,19794991,31025660,82239564,668199165.580000,1277214260.600000,601323882.865000,2546737309.045000,118756,38259,85352,242367
2012-08-07,BATS BYX (Y),137489984,31548390,70129431,239167805,3439417388.250000,1376474798.546701,1511025976.184499,6326918162.981200,888394,116851,414031,1419276
2012-08-07,BATS BZX (Z),284416404,108411280,188245870,581073554,7931380227.875594,6014758589.403805,4825037003.461171,18771175820.740570,1715700,337991,1003773,3057464
2012-08-06,NYSE MKT (A),0,8958758,3496383,12455141,0.000000,52066576.335200,43478786.468700,95545362.803900,0,19653,15413,35066
2012-08-06,NASDAQ BX (B),79504187,26498237,42050859,148053283,1969925422.845101,1100594044.990000,1433446199.559898,4503965667.394999,504479,93064,273692,871235
2012-08-06,NSX (C),10749479,2891692,6753023,20394194,204841715.552000,73275146.722900,199541516.035900,477658378.310800,33873,6539,19146,59558
2012-08-06,NYSE (DN),111300232,18678385,55481052,185459669,3101713408.634971,834880624.115003,1445761935.610001,5382355968.359975,668510,75477,308180,1052167
2012-08-06,NASDAQ (DQ),850683900,219175685,445388148,1515247733,20705321936.953067,9235894820.797455,11508060297.953110,41449277055.703632,2376310,339866,1175174,3891350
2012-08-06,EDGA (J),76792443,25845508,33998531,136636482,1725420403.737197,1117974817.740400,795851290.991398,3639246512.468995,446361,92017,194978,733356
2012-08-06,EDGX (K),196193341,48300368,110076929,354570638,5296746405.661209,1842523731.011800,3038741755.186395,10178011891.859404,981511,125919,522511,1629941
2012-08-06,CHX (M),5921783,7055125,3684946,16661854,168788988.597900,536764343.058400,140516281.650400,846069613.306700,475,1683,647,2805
2012-08-06,NYSE (N),647199962,0,0,647199962,19786870289.144881,0.000000,0.000000,19786870289.144881,2012839,0,0,2012839
2012-08-06,NYSE Arca (P),352983946,168911189,188858644,710753779,9056046137.304698,8493346364.137800,5680615429.346119,23230007930.788617,1791452,385543,966265,3143260
2012-08-06,NASDAQ (Q),388868251,113743971,394169478,896781700,11023890160.202228,6707419909.469703,11337760635.534209,29069070705.206140,2201662,358830,1737311,4297803
2012-08-06,CBSX (W),23134403,4107380,11498459,38740242,558752999.540000,201366558.690000,228976340.360000,989095898.590000,151774,12901,74524,239199
2012-08-06,NASDAQ PSX (X),30416218,15154885,26638267,72209370,634729271.135000,870797386.950000,520014850.260000,2025541508.345000,117282,33941,77863,229086
2012-08-06,BATS BYX (Y),113088745,26001033,57877537,196967315,2738409238.250799,1102653768.335000,1343141488.330698,5184204494.916497,744142,103713,377332,1225187
2012-08-06,BATS BZX (Z),235870804,87980199,151037686,474888689,6398823022.344495,4742115324.599002,4156707217.928093,15297645564.871590,1443443,283799,888650,2615892
2012-08-03,NYSE MKT (A),0,9636338,3354067,12990405,0.000000,65107144.382900,45533500.643000,110640645.025900,0,22401,15354,37755
2012-08-03,NASDAQ BX (B),99869124,34096132,48700923,182666179,2535514690.385702,1584971840.090000,1659486590.860003,5779973121.335705,632980,120312,321772,1075064
2012-08-03,NSX (C),15390650,3633530,7100034,26124214,274890990.058200,115053945.507200,210790223.217400,600735158.782800,40200,7719,21097,69016
2012-08-03,NYSE (DN),145282925,26864043,57689273,229836241,3878033979.106795,1200303451.113899,1629943534.081002,6708280964.301696,835584,108947,336500,1281031
2012-08-03,NASDAQ (DQ),1023208221,296827143,501489792,1821525156,25728171912.261128,15842909749.432750,12918997023.180729,54490078684.874607,2673911,387030,1242922,4303863
2012-08-03,EDGA (J),95464259,37707899,41654680,174826838,2276508238.617198,1552500057.405000,1031433751.892301,4860442047.914499,574440,121980,247812,944232
2012-08-03,EDGX (K),226347507,66945602,122496142,415789251,6027001888.725270,2714800527.293101,3400373186.161512,12142175602.179883,1125581,167516,587196,1880293
2012-08-03,CHX (M),5903143,7959292,5955005,19817440,210802302.121400,642200331.672200,199399938.215700,1052402572.009300,880,2507,622,4009
2012-08-03,NYSE (N),753600044,0,0,753600044,23565131342.977507,0.000000,0.000000,23565131342.977507,2372037,0,0,2372037
2012-08-03,NYSE Arca (P),444184249,256705556,220705811,921595616,11663871360.326549,13519833581.888815,7366704872.270837,32550409814.486201,2220845,525964,1107051,3853860
2012-08-03,NASDAQ (Q),468865494,177796322,447501472,1094163288,13447727310.294922,11241252443.866742,13049208811.711951,37738188565.873615,2686976,540016,2049263,5276255
2012-08-03,CBSX (W),23491548,6262575,12966942,42721065,602419651.320000,405638688.630000,251181403.028900,1259239742.978900,158747,16820,86638,262205
2012-08-03,NASDAQ PSX (X),37309765,23165748,30452027,90927540,763303486.990000,1403573200.750000,670314377.630000,2837191065.370000,136348,47610,93463,277421
2012-08-03,BATS BYX (Y),133121234,34560551,59236575,226918360,3233088775.644996,1427732484.039201,1407812539.449701,6068633799.133898,850872,128304,394332,1373508
2012-08-03,BATS BZX (Z),292325985,134620223,174560546,601506754,8144332877.738784,7612701066.468302,4927945679.376594,20684979623.583680,1795016,412856,1030637,3238509
2012-08-02,NYSE MKT (A),0,9409137,3232205,12641342,0.000000,68176311.548900,43891837.993000,112068149.541900,0,20295,16815,37110
2012-08-02,NASDAQ BX (B),108575716,35283889,51140763,195000368,2717803089.940301,1644892915.050001,1591116959.718099,5953812964.708401,693880,135898,335015,1164793
2012-08-02,NSX (C),12730860,4322742,6740963,23794565,265530328.238000,154948749.637300,177660771.832600,598139849.707900,45407,10310,22456,78173
2012-08-02,NYSE (DN),162913195,23752671,59403927,246069793,4186639100.408768,1101711217.675302,1604755936.337512,6893106254.421582,933512,99184,358110,1390806
2012-08-02,NASDAQ (DQ),1063696198,282482176,500025549,1846203923,25069694089.808733,14455929348.045931,13330731923.842183,52856355361.696847,3036596,390927,1352643,4780166
2012-08-02,EDGA (J),113207284,39560941,45519610,198287835,2577785715.150200,1788989338.649300,1150980772.996198,5517755826.795698,673592,161071,271680,1106343
2012-08-02,EDGX (K),257511650,69530365,129032843,456074858,6794173935.363474,2893047583.855999,3452458225.901678,13139679745.121151,1348897,186525,647288,2182710
2012-08-02,CHX (M),5602680,10075631,5997609,21675920,170353614.414000,1048384442.935600,178355791.964800,1397093849.314400,571,4522,916,6009
2012-08-02,NYSE (N),825647747,0,0,825647747,24663090475.444175,0.000000,0.000000,24663090475.444175,2752036,0,0,2752036
2012-08-02,NYSE Arca (P),491700328,257863140,240206053,989769521,12280181612.131244,14151479931.121798,7796966754.482783,34228628297.735825,2481032,577289,1233503,4291824
2012-08-02,NASDAQ (Q),572399292,199332963,489419157,1261151412,15473026406.941691,12215424728.188729,13651175228.096172,41339626363.226592,3259983,633877,2281060,6174920
2012-08-02,CBSX (W),21892681,5590803,10238254,37721738,542700783.300000,297002947.790000,214228991.670000,1053932722.760000,147914,16942,68099,232955
2012-08-02,NASDAQ PSX (X),40795518,29282901,36532451,106610870,834117141.985000,2084485360.370999,820337945.780000,3738940448.135999,140060,53104,97465,290629
2012-08-02,BATS BYX (Y),150961904,35972649,62307562,249242115,3402144033.185003,1602381253.458901,1475612291.711799,6480137578.355703,954509,139640,412767,1506916
2012-08-02,BATS BZX (Z),367362984,162825844,200333501,730522329,9507217817.594317,9218414860.839482,5548856862.971907,24274489541.405706,2205181,505534,1181112,3891827
2012-08-01,NYSE MKT (A),0,26330560,2876406,29206966,0.000000,134648208.097102,46086019.430000,180734227.527102,0,133890,14431,148321
2012-08-01,NASDAQ BX (B),105805951,32628743,47953177,186387871,2897286796.615005,1483911560.207501,1611285071.060196,5992483427.882702,695469,131130,312906,1139505
2012-08-01,NSX (C),12717989,5132259,6417422,24267670,296680936.856600,131004459.599300,206588956.309500,634274352.765400,55889,14478,19804,90171
2012-08-01,NYSE (DN),135721076,25390292,56527968,217639336,3729011439.568806,1226805960.074099,1526340329.046313,6482157728.689218,832202,113520,332199,1277921
2012-08-01,NASDAQ (DQ),1056071264,279409094,480771906,1816252264,27025884057.842814,13236643273.437234,12599492005.310437,52862019336.590485,2934727,378515,1250894,4564136
2012-08-01,EDGA (J),95643121,39435807,40365334,175444262,2182389516.898702,1733557691.418800,976556629.120597,4892503837.438099,585798,161412,241085,988295
2012-08-01,EDGX (K),280663082,79214928,134579295,494457305,7747537143.108692,3047355053.903800,3527324653.689214,14322216850.701706,1536221,243978,640117,2420316
2012-08-01,CHX (M),6768626,7080614,8463085,22312325,214228188.035200,607888050.897000,191250013.678000,1013366252.610200,694,4061,656,5411
2012-08-01,NYSE (N),1025015649,0,0,1025015649,28429582535.684557,0.000000,0.000000,28429582535.684557,4648226,0,0,4648226
2012-08-01,NYSE Arca (P),515190949,281203094,219942508,1016336551,13522763844.868762,13597815441.370022,7098833178.215620,34219412464.454404,2881090,822611,1106092,4809793
2012-08-01,NASDAQ (Q),616424025,217890998,489280372,1323595395,17185439416.722366,12116858564.236484,13437187887.007973,42739485867.966823,3667079,755699,2165489,6588267
2012-08-01,CBSX (W),20982916,17427558,10175172,48585646,480395483.380000,1202274155.860000,189987261.050700,1872656900.290700,132668,16434,62334,211436
2012-08-01,NASDAQ PSX (X),35970675,21723171,27579242,85273088,755774610.475000,1264484439.950000,548484585.357000,2568743635.782000,129187,44539,75177,248903
2012-08-01,BATS BYX (Y),148040749,34838644,56290908,239170301,3509611180.589995,1528241727.866701,1294338776.176399,6332191684.633095,933955,138148,367901,1440004
2012-08-01,BATS BZX (Z),378374903,158888704,179673320,716936927,10264966004.647824,8458022937.507595,4995960419.938487,23718949362.093906,2318577,544187,1058219,3920983
2012-07-31,NYSE MKT (A),0,10479723,2468979,12948702,0.000000,71012212.374300,28817906.016800,99830118.391100,0,18370,10927,29297
2012-07-31,NASDAQ BX (B),95116829,27984016,46749331,169850176,2413191341.389994,1253280286.662501,1659666245.772103,5326137873.824598,579480,101364,297455,978299
2012-07-31,NSX (C),9019689,2864157,6638641,18522487,211979049.602900,100863927.887300,217026882.653101,529869860.143301,31008,6218,20597,57823
2012-07-31,NYSE (DN),120265052,19590399,55411272,195266723,3345029960.002698,858695453.069501,1542565511.432805,5746290924.505004,723519,80353,317316,1121188
2012-07-31,NASDAQ (DQ),1024998332,285587572,556712878,1867298782,26250741076.525694,13483227026.137077,15361613242.728450,55095581345.391221,2869866,376342,1400988,4647196
2012-07-31,EDGA (J),87240223,29629283,40907059,157776565,2033908707.085403,1277776375.565900,981325836.222799,4293010918.874102,515171,116008,237001,868180
2012-07-31,EDGX (K),231089798,59193181,132840676,423123655,6719565754.430201,2480548770.665499,3786881482.848090,12986996007.943790,1210121,156936,626287,1993344
2012-07-31,CHX (M),6980067,7950203,5555298,20485568,273609921.305000,675116768.756800,245608237.633200,1194334927.695000,276,2063,623,2962
2012-07-31,NYSE (N),887939882,0,0,887939882,27260043932.801130,0.000000,0.000000,27260043932.801130,2308963,0,0,2308963
2012-07-31,NYSE Arca (P),384627164,193377597,222382397,800387158,10608022600.341704,10170189257.022905,7550301993.501502,28328513850.866111,1957703,428232,1059193,3445128
2012-07-31,NASDAQ (Q),519426570,182606958,494334093,1196367621,15160748388.509528,11666871819.716610,14580255733.082156,41407875941.308294,2828033,534845,2046445,5409323
2012-07-31,CBSX (W),22128771,3650238,9649215,35428224,578399597.900000,185289522.960000,198629173.637800,962318294.497800,153627,13623,67344,234594
2012-07-31,NASDAQ PSX (X),6830706,6217368,5892220,18940294,162939416.150000,361160011.198500,145910340.051800,670009767.400300,37259,14830,25993,78082
2012-07-31,BATS BYX (Y),126465581,28122105,58184732,212772418,2995113844.840003,1193557862.542000,1328806465.772998,5517478173.155001,795633,109443,377303,1282379
2012-07-31,BATS BZX (Z),300032964,122391772,180100034,602524770,8244420312.635092,6780452533.785404,5144882078.934082,20169754925.354578,1765604,374065,1041482,3181151
2012-07-30,NYSE MKT (A),0,7802874,2169449,9972323,0.000000,48154132.274400,20261782.450200,68415914.724600,0,17087,8522,25609
2012-07-30,NASDAQ BX (B),76658408,23936243,42230071,142824722,2007192493.826001,1092431855.018000,1351735634.933901,4451359983.777902,485047,95407,254945,835399
2012-07-30,NSX (C),8296989,2329270,5767015,16393274,177126345.341700,87359851.975500,152563579.308100,417049776.625300,26265,5420,17058,48743
2012-07-30,NYSE (DN),105043880,18088315,50556153,173688348,3012408094.708280,729603793.957001,1434322967.316395,5176334855.981676,636685,72315,293278,1002278
2012-07-30,NASDAQ (DQ),866982615,244046326,424776305,1535805246,23104708980.312325,10931159235.887744,12433130683.467372,46468998899.667441,2493109,353017,1198597,4044723
2012-07-30,EDGA (J),89234472,30263770,39376039,158874281,2186860070.385799,1304362434.878001,1021389821.001601,4512612326.265401,553879,118837,240734,913450
2012-07-30,EDGX (K),202170087,55378979,118347083,375896149,5796557136.121410,2242141821.874900,3571405917.452874,11610104875.449184,1066008,146741,568284,1781033
2012-07-30,CHX (M),7952416,5818054,5001759,18772229,305283430.203300,429948640.781800,201946602.464400,937178673.449500,496,1364,444,2304
2012-07-30,NYSE (N),658580999,0,0,658580999,21021389460.474681,0.000000,0.000000,21021389460.474681,2038455,0,0,2038455
2012-07-30,NYSE Arca (P),355510854,177379794,204160696,737051344,10139425121.006114,9075971779.010891,7049374650.197889,26264771550.214894,1876495,417095,994770,3288360
2012-07-30,NASDAQ (Q),434718293,147868894,372307489,954894676,13078355421.267568,9212597179.265179,11416979269.737761,33707931870.270508,2483281,462598,1741119,4686998
2012-07-30,CBSX (W),19277510,4023439,8062703,31363652,502396837.850000,222647411.110000,171906722.880000,896950971.840000,132581,12570,56011,201162
2012-07-30,NASDAQ PSX (X),6387297,5484495,4723794,16595586,146231230.620000,343510798.220000,115002702.850000,604744731.690000,37063,14746,23108,74917
2012-07-30,BATS BYX (Y),108226133,26995928,49776497,184998558,2589837445.924998,1124371676.451000,1191204762.809003,4905413885.185001,684693,96555,318615,1099863
2012-07-30,BATS BZX (Z),273550361,108665403,162967560,545183324,7728040590.882386,6071261077.055705,4894311434.613698,18693613102.551789,1652279,340939,964109,2957327
2012-07-27,NYSE MKT (A),0,10732656,5080653,15813309,0.000000,74670164.202200,101457107.126000,176127271.328200,0,23156,13306,36462
2012-07-27,NASDAQ BX (B),108260083,35921975,55277787,199459845,2742903969.649998,1807733470.946000,2118920412.483406,6669557853.079404,680440,136018,351514,1167972
2012-07-27,NSX (C),10704561,3840245,7399772,21944578,272462380.299000,162190716.247800,216321568.535400,650974665.082200,33894,8276,20643,62813
2012-07-27,NYSE (DN),135023563,22538602,64346991,221909156,3765394269.909608,1069394214.959399,1916566844.548194,6751355329.417201,800605,88439,349673,1238717
2012-07-27,NASDAQ (DQ),1261291013,370177832,627671821,2259140666,32400592354.573758,20260703151.167083,16946581312.654974,69607876818.395815,3162365,492433,1589031,5243829
2012-07-27,EDGA (J),113318341,37688885,51326012,202333238,2703605342.266698,1836075068.254800,1336706587.125403,5876386997.646901,669709,142564,300048,1112321
2012-07-27,EDGX (K),270871870,76061124,159181019,506114013,7534648447.981087,3596744843.139504,4583261847.951685,15714655139.072276,1355218,197908,713034,2266160
2012-07-27,CHX (M),9932213,14353094,5868300,30153607,277085169.128500,1522814926.744000,305917182.713600,2105817278.586100,812,3514,823,5149
2012-07-27,NYSE (N),912943346,0,0,912943346,28727251640.822701,0.000000,0.000000,28727251640.822701,2569780,0,0,2569780
2012-07-27,NYSE Arca (P),455231166,264902825,288402191,1008536182,12184931916.715309,15336352590.907985,10044605425.743794,37565889933.367088,2198324,583817,1282356,4064497
2012-07-27,NASDAQ (Q),603691081,219147588,535944605,1358783274,17425128027.972869,14423326676.032010,16635644338.590167,48484099042.595046,3236597,694338,2288986,6219921
2012-07-27,CBSX (W),24892266,6187472,10755430,41835168,645106945.520000,298176541.650000,238116843.740000,1181400330.910000,168937,16994,70656,256587
2012-07-27,NASDAQ PSX (X),8207584,8463034,6347140,23017758,195299207.725000,557355169.265000,171610778.930000,924265155.920000,45625,20017,29490,95132
2012-07-27,BATS BYX (Y),139581915,33515368,63866581,236963864,3304549825.779996,1552907768.507000,1675465021.801100,6532922616.088096,860960,120322,405588,1386870
2012-07-27,BATS BZX (Z),350015191,159628757,209190543,718834491,9650616069.626679,10184819941.119586,6357706622.384791,26193142633.131056,2048160,485324,1189915,3723399
2012-07-26,NYSE MKT (A),0,11152984,2521109,13674093,0.000000,82076401.578100,30124331.260000,112200732.838100,0,25157,10215,35372
2012-07-26,NASDAQ BX (B),116915559,31147648,57606290,205669497,2803140639.475001,1407336858.244000,1792018563.292796,6002496061.011797,711295,112696,358488,1182479
2012-07-26,NSX (C),11670502,3389829,8116240,23176571,268992832.457600,134052198.760100,205760363.809602,608805395.027302,36156,7718,23358,67232
2012-07-26,NYSE (DN),148551060,22796307,67283392,238630759,3982892138.330646,1036066411.090699,1923131809.795279,6942090359.216624,837324,87624,364925,1289873
2012-07-26,NASDAQ (DQ),1206535680,312572861,583004290,2102112831,28731724358.699913,14090562323.045450,15236952052.129220,58059238733.874583,3236597,434020,1524406,5195023
2012-07-26,EDGA (J),116316234,32720235,50406894,199443363,2547603892.611501,1436476942.083100,1236733935.966389,5220814770.660990,661922,124696,287444,1074062
2012-07-26,EDGX (K),280796681,70228740,147799419,498824840,7368229351.687779,2798323747.066101,4219460504.653369,14386013603.407249,1342163,183867,673883,2199913
2012-07-26,CHX (M),10797980,8811597,7476277,27085854,246706987.544300,682728816.181400,328273471.602100,1257709275.327800,634,2764,785,4183
2012-07-26,NYSE (N),897883915,0,0,897883915,26869168877.787427,0.000000,0.000000,26869168877.787427,2657738,0,0,2657738
2012-07-26,NYSE Arca (P),493195791,227962828,274971502,996130121,12419889377.812600,11851072683.839578,9286564756.084519,33557526817.736697,2246432,506345,1245861,3998638
2012-07-26,NASDAQ (Q),651393011,188116215,504838031,1344347257,17729560509.911980,11326622851.063788,15650507267.682818,44706690628.658586,3338669,596012,2351678,6286359
2012-07-26,CBSX (W),15218066,3215948,7035104,25469118,352907230.030000,183111476.875000,142553875.020000,678572581.925000,94980,10140,44069,149189
2012-07-26,NASDAQ PSX (X),8770247,8252880,6422146,23445273,196457129.055000,501860751.840000,160895790.440000,859213671.335000,44958,18508,27742,91208
2012-07-26,BATS BYX (Y),138191093,32753895,60281507,231226495,3085168073.412995,1288449988.556000,1472435371.386098,5846053433.355093,833099,111893,390375,1335367
2012-07-26,BATS BZX (Z),343709484,131789706,189756154,665255344,8813248982.826185,7318443454.083599,5497661789.681217,21629354226.591001,1941460,401401,1125227,3468088
2012-07-25,NYSE MKT (A),0,9640152,2104310,11744462,0.000000,66992469.270300,26858842.385800,93851311.656100,0,23476,9291,32767
2012-07-25,NASDAQ BX (B),98898243,27570907,51273336,177742486,2464438408.775002,1249183177.877000,2105516455.501503,5819138042.153505,635611,105508,330478,1071597
2012-07-25,NSX (C),9629002,3201554,6960865,19791421,247762030.876300,109133843.418400,244168560.733301,601064435.028001,34129,7105,22228,63462
2012-07-25,NYSE (DN),126570574,17310390,58802148,202683112,3552006890.623499,799565751.879699,2098203851.315573,6449776493.818771,715823,70682,316923,1103428
2012-07-25,NASDAQ (DQ),1006028174,268719079,520802022,1795549275,25731938369.678457,11643696549.826865,16827725983.406839,54203360902.912161,2841283,387062,1371480,4599825
2012-07-25,EDGA (J),95927559,28713973,44430085,169071617,2256852590.304300,1271533505.309901,1242148561.102596,4770534656.716797,588015,118972,262745,969732
2012-07-25,EDGX (K),228863102,58633834,130220372,417717308,6373238711.842007,2355632022.457501,4267041659.520007,12995912393.819515,1210140,159974,611942,1982056
2012-07-25,CHX (M),11016982,6304550,5342111,22663643,315280399.926600,511665579.803000,335224392.116000,1162170371.845600,592,2141,508,3241
2012-07-25,NYSE (N),783501381,0,0,783501381,23501296710.711982,0.000000,0.000000,23501296710.711982,2438066,0,0,2438066
2012-07-25,NYSE Arca (P),392076430,195071225,249332608,836480263,10757830646.373486,10048734742.170307,10287333795.000048,31093899183.543841,2011242,457183,1139432,3607857
2012-07-25,NASDAQ (Q),525858697,160660607,475259978,1161779282,15227960711.676656,9051675071.331299,16761527765.094519,41041163548.102474,2969389,526782,2158954,5655125
2012-07-25,CBSX (W),22247814,4667835,8458894,35374543,526359995.010000,207781329.260000,176055012.372000,910196336.642000,140861,12757,58307,211925
2012-07-25,NASDAQ PSX (X),6986947,6508110,5930731,19425788,174704402.195000,353561205.420000,169660154.840000,697925762.455000,39214,19783,25857,84854
2012-07-25,BATS BYX (Y),119533983,28034025,57138798,204706806,2789750557.492601,1139405517.993200,1622668907.824897,5551824983.310698,758823,108657,372587,1240067
2012-07-25,BATS BZX (Z),299660678,115872426,183246903,598780007,8192669087.735400,6541210889.639293,5830731808.416924,20564611785.791617,1837224,381758,1072742,3291724
2012-07-24,NYSE MKT (A),0,9357963,2095938,11453901,0.000000,63503356.966100,26316901.508400,89820258.474500,0,21504,10054,31558
2012-07-24,NASDAQ BX (B),102248129,33483455,49846922,185578506,2521447857.265000,1513733550.292699,1889486969.117995,5924668376.675694,630198,121544,314486,1066228
2012-07-24,NSX (C),10682907,4205454,9278203,24166564,269561390.177400,153051094.409200,238922632.312301,661535116.898901,37184,8781,24122,70087
2012-07-24,NYSE (DN),124965140,20680613,52429847,198075600,3486694583.041363,986948360.536401,1673334151.787192,6146977095.364956,728956,78572,301415,1108943
2012-07-24,NASDAQ (DQ),1067496971,310525119,518949695,1896971785,27001534865.340108,14818813793.970195,16062342984.214593,57882691643.524896,2856259,453239,1331405,4640903
2012-07-24,EDGA (J),100107957,34928642,46951676,181988275,2363245731.679204,1557479013.105699,1177477082.013301,5098201826.798204,592626,139386,269566,1001578
2012-07-24,EDGX (K),236448909,70326683,131285199,438060791,6542095317.721504,2842832142.630697,3539713531.398890,12924640991.751091,1203722,182999,601891,1988612
2012-07-24,CHX (M),9478263,7456130,4595268,21529661,308502591.287500,592132154.208200,396750169.461600,1297384914.957300,471,2143,515,3129
2012-07-24,NYSE (N),808380751,0,0,808380751,23860036521.656380,0.000000,0.000000,23860036521.656380,2531334,0,0,2531334
2012-07-24,NYSE Arca (P),420469436,226392963,219684901,866547300,11217759623.769809,12182364133.362106,8524532852.788144,31924656609.920059,2087389,521109,1069880,3678378
2012-07-24,NASDAQ (Q),531055524,190215392,471950946,1193221862,14950627863.625221,11327823318.588795,14650768437.399449,40929219619.613465,2969268,623357,2094274,5686899
2012-07-24,CBSX (W),21608088,5099781,7180698,33888567,518686187.940000,229146848.090000,174098519.240000,921931555.270000,141793,15351,49602,206746
2012-07-24,NASDAQ PSX (X),8282758,7571955,6757527,22612240,187285739.865000,483306310.180000,167204502.155000,837796552.200000,44491,18601,27797,90889
2012-07-24,BATS BYX (Y),130510706,33260975,52665214,216436895,3013258785.654995,1338376205.197000,1359411891.834297,5711046882.686292,799150,123711,349139,1272000
2012-07-24,BATS BZX (Z),320594647,133388537,186650219,640633403,8529625483.839216,7736392600.844216,5268768221.849481,21534786306.532913,1882675,422905,1065812,3371392
2012-07-23,NYSE MKT (A),0,10157919,2246889,12404808,0.000000,60538400.018500,29270872.804100,89809272.822600,0,20995,9692,30687
2012-07-23,NASDAQ BX (B),102298393,31114081,45985506,179397980,2349544813.854999,1393668247.014999,1746783130.292299,5489996191.162297,598762,121513,299526,1019801
2012-07-23,NSX (C),8992789,4124025,7360936,20477750,249945584.459800,126106398.646500,235548081.036700,611600064.143000,34523,8422,20695,63640
2012-07-23,NYSE (DN),111462571,21395622,46787371,179645564,3055868455.242393,982640306.246400,1570191376.511999,5608700138.000792,671646,85938,272117,1029701
2012-07-23,NASDAQ (DQ),1067009580,293520589,492913679,1853443848,26702308884.055008,13192629068.343352,15528507427.053201,55423445379.451561,2614095,426869,1216100,4257064
2012-07-23,EDGA (J),97758256,33723124,42137854,173619234,2297352444.336198,1434314244.374500,1163237234.887603,4894903923.598301,565364,128429,250062,943855
2012-07-23,EDGX (K),224685957,67680661,118777057,411143675,6319557072.897983,2687609316.144698,3416453849.482797,12423620238.525478,1136660,175561,551543,1863764
2012-07-23,CHX (M),10594922,6823864,6560955,23979741,403887660.864100,523882296.345300,231453493.419800,1159223450.629200,443,2353,535,3331
2012-07-23,NYSE (N),743090918,0,0,743090918,21636735612.407432,0.000000,0.000000,21636735612.407432,2213599,0,0,2213599
2012-07-23,NYSE Arca (P),406682304,242069115,196622736,845374155,10527416306.506213,12160575226.531614,7342716101.748314,30030707634.786141,1847106,511959,971783,3330848
2012-07-23,NASDAQ (Q),505170205,173680467,423160317,1102010989,14277807261.114113,10023798063.699607,13473699951.555028,37775305276.368748,2662148,550240,1833095,5045483
2012-07-23,CBSX (W),22536934,4514639,7523571,34575144,526142217.930000,209852892.920000,172538748.470000,908533859.320000,141994,14574,51763,208331
2012-07-23,NASDAQ PSX (X),7800642,7188608,5612573,20601823,176333506.635000,417726601.130000,143787796.390000,737847904.155000,40162,19310,23697,83169
2012-07-23,BATS BYX (Y),124599576,29467660,48240102,202307338,2811208866.550002,1286733793.584000,1347659268.124902,5445601928.258904,720478,114973,321822,1157273
2012-07-23,BATS BZX (Z),308978373,124508011,165840210,599326594,8119420868.880009,6669743019.293885,5052540403.815495,19841704291.989389,1716701,396684,963975,3077360
2012-07-20,NYSE MKT (A),0,9369106,2027774,11396880,0.000000,71737118.395000,28582201.062000,100319319.457000,0,17099,9720,26819
2012-07-20,NASDAQ BX (B),98576558,29489443,46609498,174675499,2588839834.735002,1351307456.799500,1990689396.586100,5930836688.120602,608796,114094,308023,1030913
2012-07-20,NSX (C),9997267,2709393,6841027,19547687,269924880.038700,113159534.456600,271432146.521600,654516561.016900,33548,5799,20701,60048
2012-07-20,NYSE (DN),117468842,18282611,50054226,185805679,3360831340.864668,815922654.699299,1886763749.578079,6063517745.142046,684134,76205,295732,1056071
2012-07-20,NASDAQ (DQ),1071469822,271131133,543442001,1886042956,28011598399.766244,13435022510.920598,16274170813.390975,57720791724.077817,2643989,375437,1275173,4294599
2012-07-20,EDGA (J),99268765,29783073,43723483,172775321,2488359053.058500,1327173870.046500,1219471354.180300,5035004277.285300,579362,116036,250713,946111
2012-07-20,EDGX (K),224507316,58121711,115906684,398535711,6591010142.951994,2316983317.333802,3511243970.818692,12419237431.104488,1130095,156125,548962,1835182
2012-07-20,CHX (M),8101414,10367552,4319935,22788901,347560985.046800,697325155.754200,304865989.582200,1349752130.383200,235,2287,355,2877
2012-07-20,NYSE (N),1002587562,0,0,1002587562,32231976934.056481,0.000000,0.000000,32231976934.056481,2245130,0,0,2245130
2012-07-20,NYSE Arca (P),387893629,214421630,204696424,807011683,11107052373.984823,11091035160.110704,7985405977.799229,30183493511.894756,1884488,465549,1008004,3358041
2012-07-20,NASDAQ (Q),469374989,164048950,565196508,1198620447,13840045431.353933,10002153824.689214,18972883601.507214,42815082857.550361,2557360,498541,1966423,5022324
2012-07-20,CBSX (W),23375913,4045162,7076578,34497653,569079482.380000,193179858.020000,171669365.190000,933928705.590000,155720,13132,51049,219901
2012-07-20,NASDAQ PSX (X),7670504,7600435,5845787,21116726,180168257.040000,452017189.180000,162739665.305000,794925111.525000,41391,18958,24676,85025
2012-07-20,BATS BYX (Y),120607403,28708913,51115362,200431678,2974286850.004999,1226176350.010000,1485383732.565499,5685846932.580498,763073,104660,342055,1209788
2012-07-20,BATS BZX (Z),279597842,115750418,168508112,563856372,7908794317.730994,6502851290.339996,5406990203.377309,19818635811.448299,1694708,356837,982978,3034523
2012-07-19,NYSE MKT (A),0,9744580,2422417,12166997,0.000000,63152533.875400,31845224.895400,94997758.770800,0,20469,10953,31422
2012-07-19,NASDAQ BX (B),103734078,26015643,49184781,178934502,2629223272.266999,1219642084.811000,2026274398.033202,5875139755.111201,632980,103335,315779,1052094
2012-07-19,NSX (C),11673574,3206129,7749504,22629207,313772337.984500,109699628.667700,289494249.965401,712966216.617601,39806,6988,23650,70444
2012-07-19,NYSE (DN),127247338,18468613,53758224,199474175,3831598858.090296,936220211.559100,1894823700.905487,6662642770.554883,728224,70547,303927,1102698
2012-07-19,NASDAQ (DQ),1230826370,250126689,536606379,2017559438,32199760104.403826,11583540858.329220,15929299873.946321,59712600836.679367,2857217,368077,1315526,4540820
2012-07-19,EDGA (J),101083385,30923898,42009257,174016540,2542676793.158998,1383595949.989200,1193285248.742801,5119557991.890999,584027,119256,242805,946088
2012-07-19,EDGX (K),263301027,58534350,126524451,448359828,7758977039.546498,2437771273.085504,4037462567.535107,14234210880.167109,1313446,159261,599367,2072074
2012-07-19,CHX (M),7411910,9965999,4126796,21504705,278950604.850500,800292399.566400,285452992.132500,1364695996.549400,701,1763,499,2963
2012-07-19,NYSE (N),756589117,0,0,756589117,23807294152.354742,0.000000,0.000000,23807294152.354742,2403425,0,0,2403425
2012-07-19,NYSE Arca (P),433069312,197187601,220649321,850906234,12363699497.069690,10377254007.731614,8640607710.811209,31381561215.612513,2063719,461876,1082223,3607818
2012-07-19,NASDAQ (Q),550468075,163572730,454938761,1168979566,17100400815.279425,10088359662.216402,15356931424.411879,42545691901.907706,3018359,515745,2028458,5562562
2012-07-19,CBSX (W),25813550,7932186,8508667,42254403,559436478.879800,373305742.650000,185359115.528600,1118101337.058400,149377,13673,54229,217279
2012-07-19,NASDAQ PSX (X),8287993,7469287,5947156,21704436,214120333.990000,411042063.060000,160792711.905000,785955108.955000,43668,19428,26760,89856
2012-07-19,BATS BYX (Y),126139611,26699466,54722677,207561754,3103205962.919099,1221754863.170000,1503626028.357399,5828586854.446498,773165,104397,348613,1226175
2012-07-19,BATS BZX (Z),315487900,108843450,171908999,596240349,8981954164.311990,6386654468.143611,5619114812.537217,20987723444.992818,1864968,352707,1026204,3243879
2012-07-18,NYSE MKT (A),0,9352493,2049705,11402198,0.000000,58926637.884000,27881222.730500,86807860.614500,0,19241,9408,28649
2012-07-18,NASDAQ BX (B),98698131,27750936,49150875,175599942,2444361522.502395,1237037280.584000,1578537443.553997,5259936246.640392,619952,107374,317776,1045102
2012-07-18,NSX (C),9870194,3114447,8707129,21691770,262974036.501700,103526942.843200,199991803.672300,566492783.017200,36710,6385,22889,65984
2012-07-18,NYSE (DN),120965774,18248572,53976015,193190361,3596476730.987354,887606854.879999,1633732112.122872,6117815697.990225,722555,72180,325679,1120414
2012-07-18,NASDAQ (DQ),1013895237,263197609,556152467,1833245313,25815126625.874657,11123815976.171481,13271106017.587014,50210048619.633152,2710285,371023,1369722,4451030
2012-07-18,EDGA (J),88769874,29414423,43308919,161493216,2230017971.489101,1427497009.727699,1122334480.686099,4779849461.902899,511789,123391,242389,877569
2012-07-18,EDGX (K),244560697,59290442,141418612,445269751,7178213759.400310,2340290684.074100,3510327310.355877,13028831753.830287,1245491,155113,629913,2030517
2012-07-18,CHX (M),7139594,10901248,5731868,23772710,243505258.479800,750688096.706500,240627287.030800,1234820642.217100,527,2022,611,3160
2012-07-18,NYSE (N),727451704,0,0,727451704,22467529827.924485,0.000000,0.000000,22467529827.924485,2313094,0,0,2313094
2012-07-18,NYSE Arca (P),397763567,190361046,239685476,827810089,11111118874.310009,9789404763.417612,7748804791.989408,28649328429.717029,1953109,427690,1106423,3487222
2012-07-18,NASDAQ (Q),492783314,155191431,463513323,1111488068,14503677185.089191,8921912577.340402,13033689513.436680,36459279275.866273,2732856,477804,2002310,5212970
2012-07-18,CBSX (W),19283644,4691579,6506438,30481661,409771344.800000,259363708.870000,128344172.151000,797479225.821000,122494,11031,43324,176849
2012-07-18,NASDAQ PSX (X),7831773,8333449,6440251,22605473,191899605.395000,475228782.900000,163131629.630000,830260017.925000,41436,20297,26027,87760
2012-07-18,BATS BYX (Y),115081467,26077326,52567019,193725812,2770187049.924997,1113027454.356400,1369548349.724301,5252762854.005698,734285,95953,336971,1167209
2012-07-18,BATS BZX (Z),295560332,113026950,182595704,591182986,8284963566.236512,6275017386.121405,4980334432.114195,19540315384.472112,1821343,337287,1057845,3216475
2012-07-17,NYSE MKT (A),0,12304717,2051418,14356135,0.000000,91723908.748900,26037372.614700,117761281.363600,0,21493,9961,31454
2012-07-17,NASDAQ BX (B),98490541,31064891,48362691,177918123,2469101784.100000,1431030554.104500,1499102377.664600,5399234715.869100,620155,122464,314765,1057384
2012-07-17,NSX (C),9658220,3804897,8725740,22188857,257521682.643000,113580355.216900,187759720.899300,558861758.759200,33053,7605,22648,63306
2012-07-17,NYSE (DN),121599952,21791095,52331976,195723023,3568249647.983877,1067524878.046699,1452267949.570277,6088042475.600853,718097,80681,301764,1100542
2012-07-17,NASDAQ (DQ),1004804546,295503409,535398297,1835706252,24755361831.495699,13211808120.694201,12931888845.974779,50899058798.164679,2610343,407353,1267786,4285482
2012-07-17,EDGA (J),82796847,35411474,45915090,164123411,2154842785.174999,1620933929.333399,1117366945.782799,4893143660.291197,486776,136341,239347,862464
2012-07-17,EDGX (K),232453368,68235295,136817716,437506379,6863482230.802906,2831309314.684700,3377222567.746400,13072014113.234006,1201255,182539,602422,1986216
2012-07-17,CHX (M),10329219,13489094,4089424,27907737,335772455.780000,1095154907.315000,111342781.040900,1542270144.135900,665,2868,850,4383
2012-07-17,NYSE (N),697744531,0,0,697744531,21291598250.787893,0.000000,0.000000,21291598250.787893,2231444,0,0,2231444
2012-07-17,NYSE Arca (P),373099133,211455691,229534749,814089573,10479257270.620887,10883789177.145382,7122671893.679683,28485718341.445952,1837696,484916,1042093,3364705
2012-07-17,NASDAQ (Q),510235175,189123558,454655103,1154013836,14817475573.996976,10927226666.388201,12494864636.329623,38239566876.714800,2755150,579835,2003575,5338560
2012-07-17,CBSX (W),16292690,3631411,6665963,26590064,368229402.900000,179403723.690000,128718653.585000,676351780.175000,104393,11114,40652,156159
2012-07-17,NASDAQ PSX (X),7541523,10704296,7797646,26043465,180385115.140000,603229192.252600,214085109.210000,997699416.602600,36993,27915,28165,93073
2012-07-17,BATS BYX (Y),113719660,30509898,51240937,195470495,2691163164.665901,1332016011.306100,1195075750.033399,5218254926.005400,717054,120405,317998,1155457
2012-07-17,BATS BZX (Z),289683182,126309189,179939941,595932312,7999077446.152415,7118283049.832114,4761679163.555801,19879039659.540330,1773493,400202,1007949,3181644
2012-07-16,NYSE MKT (A),0,9053663,1831393,10885056,0.000000,54470206.642600,24633661.919500,79103868.562100,0,18802,8407,27209
2012-07-16,NASDAQ BX (B),80571071,20696853,46059250,147327174,2010774093.204995,972211756.149000,1480456296.743497,4463442146.097492,513244,80426,256674,850344
2012-07-16,NSX (C),7607409,2328801,6877398,16813608,199432781.520200,92109621.444400,159120748.416500,450663151.381100,27048,5045,18225,50318
2012-07-16,NYSE (DN),97583895,14349447,45213248,157146590,2880825274.130298,650797724.299599,1229079531.239094,4760702529.668991,599745,58980,246754,905479
2012-07-16,NASDAQ (DQ),818302750,197933100,457825144,1474060994,20984475566.127945,9051964125.129619,11221095900.141170,41257535591.398734,2291698,303498,1072747,3667943
2012-07-16,EDGA (J),74300048,25704512,41482254,141486814,1902111814.376101,1151105767.350600,932577294.639901,3985794876.366602,439762,95763,202546,738071
2012-07-16,EDGX (K),189706102,48223991,105906443,343836536,5727674377.399216,1915340601.063400,2806845420.746687,10449860399.209303,989080,123569,466952,1579601
2012-07-16,CHX (M),8034426,8857680,2818235,19710341,248780259.844900,493520046.826800,89371327.532000,831671634.203700,364,1262,519,2145
2012-07-16,NYSE (N),602078185,0,0,602078185,18461312580.401981,0.000000,0.000000,18461312580.401981,1909960,0,0,1909960
2012-07-16,NYSE Arca (P),294459149,146528872,175484956,616472977,8359330534.783193,7284030986.361486,5397497584.727289,21040859105.871968,1485261,352923,775590,2613774
2012-07-16,NASDAQ (Q),394355274,127764706,353738649,875858629,11729988347.563891,7600075290.223504,10263667031.291621,29593730669.079016,2230390,414051,1548849,4193290
2012-07-16,CBSX (W),14556104,3018287,5975797,23550188,326206991.730000,129711525.080000,123225121.894000,579143638.704000,92037,7872,37713,137622
2012-07-16,NASDAQ PSX (X),6166709,7841020,5467930,19475659,150185149.795000,524503816.000000,153920569.440000,828609535.235000,33260,19564,21256,74080
2012-07-16,BATS BYX (Y),94848449,20494206,44460010,159802665,2221015034.469998,880395237.287600,1008470538.756700,4109880810.514298,604251,76843,261253,942347
2012-07-16,BATS BZX (Z),230880197,85101456,140480985,456462638,6631206731.049199,4639987652.822803,3711262901.544414,14982457285.416416,1450968,281676,791414,2524058
2012-07-13,NYSE MKT (A),0,7833817,1863641,9697458,0.000000,57750676.490500,21406093.239500,79156769.730000,0,19810,8819,28629
2012-07-13,NASDAQ BX (B),93077494,29664134,39400988,162142616,2227064029.572503,1325216137.635499,1408633341.818196,4960913509.026198,574286,100247,262627,937160
2012-07-13,NSX (C),10023752,3253921,5972667,19250340,241663664.495000,106820566.402900,151687307.329700,500171538.227600,32531,6021,18273,56825
2012-07-13,NYSE (DN),106099941,19626510,40605545,166331996,3084458252.382797,880224460.053095,1160438098.075691,5125120810.511583,640035,69253,238104,947392
2012-07-13,NASDAQ (DQ),874982566,255084431,407288701,1537355698,22188398833.422963,10649041504.877490,10359878441.664491,43197318779.964944,2363587,381185,1042884,3787656
2012-07-13,EDGA (J),82243311,28910737,35886127,147040175,2081787351.271497,1373412812.195599,881643505.547700,4336843669.014796,477044,104535,202908,784487
2012-07-13,EDGX (K),196305452,58276351,102639609,357221412,5589693253.352391,2382208928.218601,2833908946.300209,10805811127.871201,996144,145109,469785,1611038
2012-07-13,CHX (M),9888995,7088053,7286076,24263124,278917136.809400,547761598.876200,177866395.168100,1004545130.853700,579,1813,387,2779
2012-07-13,NYSE (N),683002768,0,0,683002768,21008364758.641246,0.000000,0.000000,21008364758.641246,2071696,0,0,2071696
2012-07-13,NYSE Arca (P),337434667,191927609,167073413,696435689,9284587540.909198,9786162184.800492,5914290279.696230,24985040005.405920,1616370,420272,793302,2829944
2012-07-13,NASDAQ (Q),431615578,168617377,359676171,959909126,12584383136.509587,9752497084.647615,10782248358.185947,33119128579.343149,2343973,477271,1599761,4421005
2012-07-13,CBSX (W),16719710,4295457,5973576,26988743,364407145.040000,183051590.220000,137638634.174200,685097369.434200,102222,11531,38337,152090
2012-07-13,NASDAQ PSX (X),6951169,7989096,4853621,19793886,163149883.925000,412464721.965000,132768091.215000,708382697.105000,36361,20341,20925,77627
2012-07-13,BATS BYX (Y),105357435,28520721,40460178,174338334,2429272022.298400,1249285465.687999,984432467.118999,4662989955.105398,654210,102010,265952,1022172
2012-07-13,BATS BZX (Z),256682482,113498505,137921464,508102451,7179106488.491777,6413251502.108889,3873448498.576100,17465806489.176766,1568488,346392,803627,2718507
2012-07-12,NYSE MKT (A),0,11101612,1532721,12634333,0.000000,79555779.074400,21172597.295000,100728376.369400,0,25400,8656,34056
2012-07-12,NASDAQ BX (B),100330478,32154860,50661026,183146364,2487706103.019997,1410430425.410499,1786939515.518702,5685076043.949198,633384,124721,316265,1074370
2012-07-12,NSX (C),9782655,4074187,6824808,20681650,249208869.398200,106674487.182800,193186152.448700,549069509.029700,36431,9211,21505,67147
2012-07-12,NYSE (DN),122947367,21556861,54172789,198677017,3663262551.205071,996613287.425802,1699769019.110485,6359644857.741358,720314,79627,305994,1105935
2012-07-12,NASDAQ (DQ),962911653,300656330,497483667,1761051650,24906188314.404033,13521948274.513152,14261413584.849357,52689550173.766542,2689851,438172,1270240,4398263
2012-07-12,EDGA (J),91376277,36645566,49136023,177157866,2352671035.780198,1723401585.472998,1182078092.413400,5258150713.666596,556791,144695,256242,957728
2012-07-12,EDGX (K),236272588,72400222,129985721,438658531,7051640871.387204,2791130328.607102,3599230583.939994,13442001783.934300,1299245,188011,610264,2097520
2012-07-12,CHX (M),10442236,13842464,3124560,27409260,486317681.108000,799529071.961900,206574734.034300,1492421487.104200,648,2420,487,3555
2012-07-12,NYSE (N),763794103,0,0,763794103,23685215064.025691,0.000000,0.000000,23685215064.025691,2547640,0,0,2547640
2012-07-12,NYSE Arca (P),376127597,229625084,213533638,819286319,10729517159.568196,11654268361.941590,7551600035.918515,29935385557.428301,1961682,544904,1010298,3516884
2012-07-12,NASDAQ (Q),532100601,202357850,459795448,1194253899,15642952727.546427,11102042596.272997,13145341195.638597,39890336519.458021,3023366,614214,2057580,5695160
2012-07-12,CBSX (W),16917826,6151589,7103498,30172913,382457792.720000,280429488.800000,123880101.357200,786767382.877200,105872,11337,40387,157596
2012-07-12,NASDAQ PSX (X),8598728,10511476,8387999,27498203,205444735.235000,602647899.610000,213140625.375000,1021233260.220000,49365,29129,34487,112981
2012-07-12,BATS BYX (Y),117063087,31625425,51284443,199972955,2798054167.859399,1400935826.752000,1228874361.021099,5427864355.632498,752213,124033,321167,1197413
2012-07-12,BATS BZX (Z),305324248,142005818,179898755,627228821,8605778911.930715,7814811126.123918,5087523368.866511,21508113406.921144,1937934,461045,1021839,3420818
2012-07-11,NYSE MKT (A),0,9861813,1481513,11343326,0.000000,56686626.628400,20138218.866000,76824845.494400,0,21474,7599,29073
2012-07-11,NASDAQ BX (B),87104231,27276175,42932971,157313377,2301193322.998001,1257149659.107401,1479208073.646500,5037551055.751902,579970,108519,289539,978028
2012-07-11,NSX (C),9308636,3594411,7180256,20083303,254973363.067600,118124905.421600,233975299.359299,607073567.848499,34798,7487,21981,64266
2012-07-11,NYSE (DN),109555400,18108231,48748609,176412240,3268119711.548869,878487403.150202,1574561839.279593,5721168953.978664,681235,71365,286614,1039214
2012-07-11,NASDAQ (DQ),861757970,248222687,470739131,1580719788,22577656546.216205,10701508367.075441,13717178331.601883,46996343244.893529,2410634,377570,1199184,3987388
2012-07-11,EDGA (J),87910538,35290955,43250400,166451893,2202070668.337099,1686203674.575701,1132832790.514202,5021107133.427002,532491,138053,248589,919133
2012-07-11,EDGX (K),214684140,72581585,122573956,409839681,6436480757.355177,2918325326.121603,3553563094.248388,12908369177.725168,1197462,175272,591166,1963900
2012-07-11,CHX (M),8648227,10289897,5953579,24891703,305132670.729000,662801951.893200,255780362.294500,1223714984.916700,1043,2573,552,4168
2012-07-11,NYSE (N),768005612,0,0,768005612,24052965964.098217,0.000000,0.000000,24052965964.098217,2499562,0,0,2499562
2012-07-11,NYSE Arca (P),347586553,208324424,202065496,757976473,9922414219.178170,10678427236.900084,7447513649.442819,28048355105.521073,1820020,481459,976107,3277586
2012-07-11,NASDAQ (Q),502877045,200922713,454612048,1158411806,14996113187.299945,11917037628.623217,14467856942.903807,41381007758.826969,2926233,600642,2014309,5541184
2012-07-11,CBSX (W),13182735,2333911,5646097,21162743,277080226.510000,125989359.150000,116822540.560000,519892126.220000,85510,9622,38132,133264
2012-07-11,NASDAQ PSX (X),10363865,11960454,9745477,32069796,238276914.540000,765162995.000000,232467880.580000,1235907790.120000,53813,31523,37398,122734
2012-07-11,BATS BYX (Y),112860922,28872571,48158889,189892382,2712836653.429394,1244783345.136300,1192638696.452500,5150258695.018194,729528,112393,313757,1155678
2012-07-11,BATS BZX (Z),281911297,133401536,168402420,583715253,8028439469.346315,7587998148.915299,4955053936.968106,20571491555.229720,1793273,420989,977409,3191671
2012-07-10,NYSE MKT (A),0,9848366,1860679,11709045,0.000000,56024265.595000,25412852.770000,81437118.365000,0,21413,10243,31656
2012-07-10,NASDAQ BX (B),90536337,30579763,47707133,168823233,2286876248.548999,1327868373.098999,1721686191.328298,5336430812.976296,588736,110077,311308,1010121
2012-07-10,NSX (C),10922424,3926718,7290260,22139402,254106761.539700,123544960.700600,230511606.527000,608163328.767300,33170,8080,21781,63031
2012-07-10,NYSE (DN),115833547,19840507,55738312,191412366,3274674375.504122,1013530932.074299,1670839116.371500,5959044423.949921,707868,79570,321837,1109275
2012-07-10,NASDAQ (DQ),921414548,309726846,507713530,1738854924,23841681319.554409,15776881685.276337,14957031840.582599,54575594845.413345,2513182,415224,1295203,4223609
2012-07-10,EDGA (J),86545937,35548885,43688082,165782904,2175101135.185000,1760312646.437899,1169963037.224200,5105376818.847099,505563,138080,242942,886585
2012-07-10,EDGX (K),218808092,69393762,129678693,417880547,6397698509.738785,2807352158.489101,3786429655.579717,12991480323.807603,1154935,173937,593007,1921879
2012-07-10,CHX (M),8910350,11788461,5244974,25943785,304907573.525700,872385989.033000,127404648.784800,1304698211.343500,1742,2261,662,4665
2012-07-10,NYSE (N),727593400,0,0,727593400,22018881457.971108,0.000000,0.000000,22018881457.971108,2271991,0,0,2271991
2012-07-10,NYSE Arca (P),367203563,215030995,207983733,790218291,10015380363.398095,11231409573.645807,7847543320.473043,29094333257.516945,1788168,467557,990146,3245871
2012-07-10,NASDAQ (Q),489453904,194427446,456439068,1140320418,14006192018.707085,11462288460.930415,14120090511.015352,39588570990.652852,2712172,568838,1993137,5274147
2012-07-10,CBSX (W),17924647,3867614,6334178,28126439,390884256.050000,169251161.550000,135293412.170000,695428829.770000,113179,10758,42615,166552
2012-07-10,NASDAQ PSX (X),10968514,12576872,9175550,32720936,240905622.075000,674143671.855000,210391979.260000,1125441273.190000,55489,29964,36637,122090
2012-07-10,BATS BYX (Y),115020065,31051588,52628851,198700504,2694340299.487797,1377706037.518000,1331392067.529998,5403438404.535795,732311,119066,333930,1185307
2012-07-10,BATS BZX (Z),282769018,135303703,177532907,595605628,7601270429.193181,7591342710.480619,5346305250.860602,20538918390.534402,1689235,408507,995149,3092891
2012-07-09,NYSE MKT (A),0,8534921,1784073,10318994,0.000000,50243530.072200,24917452.047000,75160982.119200,0,18203,9262,27465
2012-07-09,NASDAQ BX (B),71771317,21364455,41127993,134263765,1958344419.261502,937696888.064600,1440893859.819901,4336935167.146003,489956,79431,271069,840456
2012-07-09,NSX (C),8346774,3177955,5863010,17387739,192748921.222000,79378425.346400,180422289.837300,452549636.405700,26556,6754,17433,50743
2012-07-09,NYSE (DN),87291685,13428224,42899778,143619687,2723058812.261199,638828484.660500,1270882498.008698,4632769794.930397,539349,53386,249443,842178
2012-07-09,NASDAQ (DQ),827820576,234327145,430505522,1492653243,24287104030.716005,10619491573.245749,11848692847.624020,46755288451.585774,2300674,333475,1154002,3788151
2012-07-09,EDGA (J),71274699,25454986,38754292,135483977,1877515448.156998,1262999065.392600,955149969.669600,4095664483.219198,428217,99771,214963,742951
2012-07-09,EDGX (K),182356249,49740449,107008130,339104828,5555870891.004600,2130550297.926899,3034578364.862600,10720999553.794099,971868,132601,494184,1598653
2012-07-09,CHX (M),7261014,4010203,3504710,14775927,247456582.148000,329638373.207000,104969635.259000,682064590.614000,563,1546,556,2665
2012-07-09,NYSE (N),649719168,0,0,649719168,20430254471.981904,0.000000,0.000000,20430254471.981904,1985090,0,0,1985090
2012-07-09,NYSE Arca (P),286830090,145120949,169537554,601488593,8316241542.589180,7770443290.412110,5756070867.437985,21842755700.439275,1483512,357807,799930,2641249
2012-07-09,NASDAQ (Q),379478333,133339463,395021890,907839686,11394006727.501029,8250117498.572005,11622955253.735782,31267079479.808816,2216831,427701,1657658,4302190
2012-07-09,CBSX (W),16246312,4058230,7511437,27815979,389422767.060000,164247545.947400,132595335.050000,686265648.057400,113627,9835,50003,173465
2012-07-09,NASDAQ PSX (X),9574936,9124033,9097685,27796654,211641570.420000,516433587.020000,219863785.090000,947938942.530000,49128,23097,34599,106824
2012-07-09,BATS BYX (Y),90319802,21778007,43644848,155742657,2236314128.042599,964676033.139000,1036133771.367199,4237123932.548798,599091,82695,278572,960358
2012-07-09,BATS BZX (Z),214370673,95226791,146860033,456457497,6256844704.295610,5396068912.054991,4181140700.887907,15834054317.238508,1368410,297968,842405,2508783
2012-07-06,NYSE MKT (A),0,8027817,1780534,9808351,0.000000,50809573.977000,23500472.600000,74310046.577000,0,19263,9293,28556
2012-07-06,NASDAQ BX (B),76722366,27960928,40572246,145255540,1945421317.395000,1252447009.089800,1677209114.646999,4875077441.131799,504222,104890,273398,882510
2012-07-06,NSX (C),8729671,3719513,5289878,17739062,202789211.192100,136326616.664400,168620442.902300,507736270.758800,27708,6923,17187,51818
2012-07-06,NYSE (DN),63392047,10915796,33612257,107920100,1906815458.269004,509671608.722000,1074424549.765804,3490911616.756808,368833,39068,185864,593765
2012-07-06,NASDAQ (DQ),759020832,262473121,417478043,1438971996,21211443265.312647,12546349636.177659,11699390175.913843,45457183077.404149,2183944,395412,1212547,3791903
2012-07-06,EDGA (J),75667068,29527052,40610593,145804713,1922996544.597401,1476921501.735199,1037245565.286301,4437163611.618901,436281,115944,219314,771539
2012-07-06,EDGX (K),172844677,58206725,113181224,344232626,5191927762.688009,2396176918.293998,3323863315.203604,10911967996.185611,922003,147372,527099,1596474
2012-07-06,CHX (M),6445133,7205261,3643385,17293779,174408826.671000,667148252.841000,150626166.504400,992183246.016400,1003,2245,517,3765
2012-07-06,NYSE (N),596396635,0,0,596396635,18655775581.579873,0.000000,0.000000,18655775581.579873,1950176,0,0,1950176
2012-07-06,NYSE Arca (P),290282513,198995524,180924170,670202207,8208532144.910689,10807178585.095698,6725271428.707001,25740982158.713388,1489880,456353,849931,2796164
2012-07-06,NASDAQ (Q),367120061,167593320,382675772,917389153,10928996221.498447,10405981494.453735,12082703442.958880,33417681158.911062,2166828,501395,1724202,4392425
2012-07-06,CBSX (W),15842302,5057686,6594851,27494839,361473213.070000,280578361.720000,135831575.698900,777883150.488900,107038,12304,47008,166350
2012-07-06,NASDAQ PSX (X),11112138,14575115,11197664,36884917,252205198.310000,885236931.770000,248275441.865000,1385717571.945000,55160,34436,38536,128132
2012-07-06,BATS BYX (Y),85017406,25623908,43450835,154092149,2035387773.445600,1189515165.830000,1142325283.694700,4367228222.970300,555020,99882,273998,928900
2012-07-06,BATS BZX (Z),214940707,110836854,149034316,474811877,6044394362.557192,6567416322.147112,4654265395.123891,17266076079.828195,1356706,356641,851148,2564495
2012-07-05,NYSE MKT (A),0,9147923,2080072,11227995,0.000000,55172023.185100,26291121.450000,81463144.635100,0,21030,10450,31480
2012-07-05,NASDAQ BX (B),75168648,24027555,39961210,139157413,2013694989.385000,1085447788.680101,1608882949.603999,4708025727.669100,522114,90475,276350,888939
2012-07-05,NSX (C),9527220,3678959,5975363,19181542,222864586.569900,145842154.647400,194872708.385900,563579449.603200,30122,7982,19736,57840
2012-07-05,NYSE (DN),62478963,11883769,31816037,106178769,1926957466.486301,572748040.935400,976909454.195800,3476614961.617501,354533,41047,172009,567589
2012-07-05,NASDAQ (DQ),885888886,273788405,436631868,1596309159,24537415415.525810,12686782960.894873,13554892926.618619,50779091303.039302,2527669,407416,1205702,4140787
2012-07-05,EDGA (J),75690697,27308919,37957854,140957470,1956455317.035102,1459437779.409000,1010434302.669999,4426327399.114101,457605,116262,208312,782179
2012-07-05,EDGX (K),189559309,58357652,112655577,360572538,5546964950.268498,2434526298.484798,3306368227.760787,11287859476.514083,1005741,151468,506371,1663580
2012-07-05,CHX (M),7056359,5367679,2508226,14932264,272916122.646800,452998079.021000,125680693.377300,851594895.045100,772,2282,635,3689
2012-07-05,NYSE (N),684104456,0,0,684104456,21098492038.148685,0.000000,0.000000,21098492038.148685,2166374,0,0,2166374
2012-07-05,NYSE Arca (P),299574463,183779184,160975473,644329120,8293731350.236703,9517582899.682296,6510978768.508740,24322293018.427739,1551655,423681,772825,2748161
2012-07-05,NASDAQ (Q),394434060,157053976,381579500,933067536,11602111477.512164,9765786503.986288,12304680520.220453,33672578501.718905,2317577,503631,1637623,4458831
2012-07-05,CBSX (W),17724416,4824296,6531237,29079949,390636752.250000,225834018.810000,135461595.221100,751932366.281100,118922,11746,45845,176513
2012-07-05,NASDAQ PSX (X),12537480,10615701,6676103,29829284,347194885.670000,657196077.700000,163880598.052500,1168271561.422500,67101,27216,32039,126356
2012-07-05,BATS BYX (Y),90811845,22611009,42493787,155916641,2204829062.929999,1027605255.709001,1075774955.675701,4308209274.314701,609222,93114,269479,971815
2012-07-05,BATS BZX (Z),227121007,104953634,140072571,472147212,6459399103.774205,6221129771.017211,4219161207.847819,16899690082.639235,1465090,340550,812088,2617728
2012-07-03,NYSE MKT (A),0,8116628,1075677,9192305,0.000000,51204736.342400,12543569.190000,63748305.532400,0,16811,5999,22810
2012-07-03,NASDAQ BX (B),48854370,19235546,25764447,93854363,1276564236.464999,815868344.971000,942979853.620498,3035412435.056497,339524,71587,166555,577666
2012-07-03,NSX (C),6549849,1850416,5486207,13886472,160144912.937400,50487324.198300,97929242.436100,308561479.571800,21836,4645,14801,41282
2012-07-03,NYSE (DN),49219261,9259202,23099657,81578120,1509568107.752600,451318687.556700,684397138.260900,2645283933.570200,262149,35007,111848,409004
2012-07-03,NASDAQ (DQ),618301375,212027411,337605518,1167934304,16172568347.006699,9552763197.210504,8497349986.400609,34222681530.617812,1828789,341833,843226,3013848
2012-07-03,EDGA (J),53854500,24399597,26155746,104409843,1459263549.131101,1319803796.968699,681435962.227901,3460503308.327701,339305,96053,145524,580882
2012-07-03,EDGX (K),129736436,45643346,76409145,251788927,3907560031.716298,2041693640.904801,1985005694.179302,7934259366.800401,700882,120955,323162,1144999
2012-07-03,CHX (M),2995958,6768121,5584310,15348389,100192795.417000,503517554.979000,95375229.910100,699085580.306100,391,1504,428,2323
2012-07-03,NYSE (N),466464059,0,0,466464059,14653304931.569491,0.000000,0.000000,14653304931.569491,1417730,0,0,1417730
2012-07-03,NYSE Arca (P),215765382,150016278,118189154,483970814,6111786807.411203,7486870761.141006,3996238524.890591,17594896093.442800,1103439,339768,539530,1982737
2012-07-03,NASDAQ (Q),281369315,116338607,271664900,669372822,8581852635.628484,6616641068.057707,7862328197.722996,23060821901.409187,1661433,372375,1122196,3156004
2012-07-03,CBSX (W),9344282,4375967,3588655,17308904,233114525.460000,206301022.240000,80719851.390000,520135399.090000,63661,8684,23513,95858
2012-07-03,NASDAQ PSX (X),6197884,10060933,3573096,19831913,154763750.295000,537265117.310000,96907797.805000,788936665.410000,40332,25563,19418,85313
2012-07-03,BATS BYX (Y),62490097,18770387,30520984,111781468,1532283889.920802,846904198.347000,746757873.809201,3125945962.077003,414900,76173,180371,671444
2012-07-03,BATS BZX (Z),157804362,80478006,100219969,338502337,4600466887.787907,4439004336.851503,2842457523.761385,11881928748.400795,1022623,261005,527526,1811154
2012-07-02,NYSE MKT (A),0,9244221,2095368,11339589,0.000000,70409739.053700,25498022.380000,95907761.433700,0,18381,9195,27576
2012-07-02,NASDAQ BX (B),91528296,31675167,51666821,174870284,2281915055.965000,1390972498.980000,1740123576.560001,5413011131.505001,601164,111994,317882,1031040
2012-07-02,NSX (C),9029546,2980116,6799532,18809194,230393522.220200,111574752.672800,232927362.896500,574895637.789500,31567,6587,21339,59493
2012-07-02,NYSE (DN),70653278,14463240,42500819,127617337,2127092356.720401,693352960.972000,1358300786.126600,4178746103.819001,404868,52539,215996,673403
2012-07-02,NASDAQ (DQ),930582472,370814857,572722178,1874119507,23790335937.876171,17766825814.188219,15519129141.383354,57076290893.447744,2809159,485168,1415681,4710008
2012-07-02,EDGA (J),86190140,34919640,44512048,165621828,2126632600.013200,1633271264.672099,1177346072.257201,4937249936.942500,503201,124791,239331,867323
2012-07-02,EDGX (K),204758854,62673552,128621814,396054220,6157920028.236790,2938207948.208801,3544143695.269677,12640271671.715268,1135966,164990,603132,1904088
2012-07-02,CHX (M),4362751,7134282,3208524,14705557,169488815.049800,593468538.313000,139940740.250000,902898093.612800,625,2433,480,3538
2012-07-02,NYSE (N),736117928,0,0,736117928,22861701829.643236,0.000000,0.000000,22861701829.643236,2302481,0,0,2302481
2012-07-02,NYSE Arca (P),337048874,210485284,224345791,771879949,9448000527.189318,11395002526.115617,7614856815.510806,28457859868.815741,1749792,466930,944822,3161544
2012-07-02,NASDAQ (Q),441201097,176901375,476985285,1095087757,13115514144.989042,10647451948.392983,13983343843.069978,37746309936.452003,2556589,561463,1890762,5008814
2012-07-02,CBSX (W),16178842,16068315,6984379,39231536,356495033.840000,1161830395.210000,139827332.310000,1658152761.360000,102862,12981,45072,160915
2012-07-02,NASDAQ PSX (X),14842951,17571685,11151534,43566170,387788304.240000,987595093.095000,337278776.425000,1712662173.760000,76981,37453,40565,154999
2012-07-02,BATS BYX (Y),102777173,27734141,55062458,185573772,2444302573.618998,1249532888.852000,1374515806.190701,5068351268.661699,667218,99153,325635,1092006
2012-07-02,BATS BZX (Z),251979290,115780592,180736108,548495990,7187082640.622308,6646550863.683789,5128589180.279768,18962222684.585865,1608393,365048,940787,2914228
2012-06-29,NYSE MKT (A),0,10937646,2005156,12942802,0.000000,74172643.544400,23454240.480000,97626884.024400,0,22322,8960,31282
2012-06-29,NASDAQ BX (B),116202971,40951507,52308863,209463341,2822911221.373404,1762075357.075001,1715078349.235102,6300064927.683507,709827,136422,328861,1175110
2012-06-29,NSX (C),12479013,4606639,8184054,25269706,350542970.532500,142406684.184100,188372922.169300,681322576.885900,39675,8380,21840,69895
2012-06-29,NYSE (DN),109182026,16021182,47218363,172421571,3320878176.899095,796858058.951800,1469344049.041500,5587080284.892395,585820,56799,247847,890466
2012-06-29,NASDAQ (DQ),1331112806,400138810,621414361,2352665977,34112592777.232480,20377933939.856910,15652993183.341498,70143519900.430888,3680048,594555,1578445,5853048
2012-06-29,EDGA (J),114218042,42617119,47407852,204243013,2912935694.107097,2079983446.231202,1212412279.792300,6205331420.130599,640662,157315,263868,1061845
2012-06-29,EDGX (K),273103365,78168831,128497547,479769743,7450773763.877284,3590141464.791401,3485357232.266998,14526272460.935683,1214574,203353,611692,2029619
2012-06-29,CHX (M),12144461,9965340,3614386,25724187,299699513.430000,783357663.738400,140106449.575200,1223163626.743600,332,3071,599,4002
2012-06-29,NYSE (N),1094367956,0,0,1094367956,34058041067.553805,0.000000,0.000000,34058041067.553805,2628796,0,0,2628796
2012-06-29,NYSE Arca (P),416133266,299123941,208517818,923775025,11612402820.871401,16077658816.409652,7286577298.703741,34976638935.984794,2028742,607270,968186,3604198
2012-06-29,NASDAQ (Q),595549222,239599261,591673970,1426822453,17706072059.804610,14884276834.711623,17658605949.531494,50248954844.047727,3278045,709180,2091654,6078879
2012-06-29,CBSX (W),22205158,7170611,8645782,38021551,543131048.830000,389882720.110000,183310884.000000,1116324652.940000,141043,19201,58312,218556
2012-06-29,NASDAQ PSX (X),44185139,35656987,32941864,112783990,931726173.220000,2145525419.900000,759652076.270000,3836903669.390000,169218,76033,107637,352888
2012-06-29,BATS BYX (Y),135081654,33908818,53892246,222882718,3107603309.108501,1585487594.862000,1337848999.128198,6030939903.098699,839124,125109,334662,1298895
2012-06-29,BATS BZX (Z),307667649,149546394,165972279,623186322,8674558715.135894,8701422304.188375,4880796931.227594,22256777950.551863,1784116,471876,947987,3203979
2012-06-28,NYSE MKT (A),0,10798741,2076779,12875520,0.000000,59965399.554000,23928516.671500,83893916.225500,0,21632,10528,32160
2012-06-28,NASDAQ BX (B),98065210,33716485,44729282,176510977,2375162894.937702,1417346788.471000,1607408657.104403,5399918340.513105,620450,124654,306183,1051287
2012-06-28,NSX (C),10496794,4922414,8934710,24353918,275468364.946500,172086944.617500,179392400.181200,626947709.745200,34681,9254,24276,68211
2012-06-28,NYSE (DN),89132602,14213802,42976115,146322519,2615722442.420200,680817359.014900,1345522640.003103,4642062441.438203,453027,49122,214189,716338
2012-06-28,NASDAQ (DQ),1097011549,293028006,519770692,1909810247,27286353791.846032,12438603120.733539,13745969165.048557,53470926077.628128,2929189,472655,1332060,4733904
2012-06-28,EDGA (J),98899216,37515361,44867952,181282529,2401071678.456999,1830045095.904001,1103996654.101199,5335113428.462199,568352,147265,255814,971431
2012-06-28,EDGX (K),227821169,65074572,133250566,426146307,6365805534.625290,2789506374.298200,3565350995.090694,12720662904.014184,1136722,170984,648358,1956064
2012-06-28,CHX (M),8911013,8664204,4482165,22057382,237339093.290200,738312240.534400,130544353.045400,1106195686.870000,745,2968,547,4260
2012-06-28,NYSE (N),906623265,0,0,906623265,26861165569.339657,0.000000,0.000000,26861165569.339657,2584680,0,0,2584680
2012-06-28,NYSE Arca (P),395760779,235209872,215808958,846779609,11190609277.845392,12519613960.970893,6935967631.361459,30646190870.177744,2055455,554382,1029036,3638873
2012-06-28,NASDAQ (Q),556156171,209063549,495360300,1260580020,16253515707.538087,12531959004.041110,14438066158.862101,43223540870.441298,3180881,645953,2083486,5910320
2012-06-28,CBSX (W),17193368,4984156,6828077,29005601,343413084.090000,313220321.430000,146073259.490000,802706665.010000,100901,13819,43977,158697
2012-06-28,NASDAQ PSX (X),41848375,32081066,33010148,106939589,884627255.650000,2104958256.430000,717416115.250000,3707001627.330000,163898,67777,100392,332067
2012-06-28,BATS BYX (Y),114343776,30542421,50344568,195230765,2675107106.520603,1312374293.579999,1282753330.779097,5270234730.879699,730958,117615,323730,1172303
2012-06-28,BATS BZX (Z),299062974,141643111,176668696,617374781,8461706436.707399,8152274159.419298,4945134015.657186,21559114611.783883,1872141,454996,1009304,3336441
2012-06-27,NYSE MKT (A),0,8712652,2964304,11676956,0.000000,51647037.275300,37625713.771700,89272751.047000,0,20434,14615,35049
2012-06-27,NASDAQ BX (B),83857204,28533193,42854510,155244907,2187834324.395002,1108789176.810400,1312917484.411402,4609540985.616804,567496,101513,300870,969879
2012-06-27,NSX (C),9957002,3448530,7184741,20590273,252693833.140200,117603013.851900,164223357.489800,534520204.481900,34171,7497,22470,64138
2012-06-27,NYSE (DN),74662530,12026821,36662848,123352199,2333319990.299900,533153375.464500,1092877426.273400,3959350792.037800,399579,41233,192935,633747
2012-06-27,NASDAQ (DQ),947139858,251870706,529298183,1728308747,24376203163.821700,10441946878.227463,12427479589.863737,47245629631.912900,2808363,405954,1428431,4642748
2012-06-27,EDGA (J),88544547,33917556,42512684,164974787,2256897284.407597,1500140779.782800,1014196883.033200,4771234947.223597,518333,127008,251825,897166
2012-06-27,EDGX (K),207519303,52502127,124361479,384382909,5861358456.135704,2164590275.815707,3168314389.791991,11194263121.743402,1052308,139724,614406,1806438
2012-06-27,CHX (M),8878137,8115632,3947476,20941245,262289296.584200,530129382.704700,139169011.476000,931587690.764900,501,2161,530,3192
2012-06-27,NYSE (N),684631458,0,0,684631458,20879491139.681445,0.000000,0.000000,20879491139.681445,2200861,0,0,2200861
2012-06-27,NYSE Arca (P),324450052,187307839,195677092,707434983,9105683328.299122,9143316264.076599,5811922321.118530,24060921913.494251,1719786,440322,940237,3100345
2012-06-27,NASDAQ (Q),441202045,157110434,417488828,1015801307,13011032793.982831,8589038127.558304,11303402234.236176,32903473155.777311,2573082,493511,1880323,4946916
2012-06-27,CBSX (W),17683433,5704445,7028786,30416664,423132740.250000,371094640.680000,138960353.215000,933187734.145000,114917,13053,46311,174281
2012-06-27,NASDAQ PSX (X),36027554,24040744,32416041,92484339,748009917.130000,1404467496.304000,649360413.150000,2801837826.584000,154623,51592,111674,317889
2012-06-27,BATS BYX (Y),102446189,27051310,46332969,175830468,2394410231.729999,1051185086.482000,1057255859.879001,4502851178.091000,671062,104840,310196,1086098
2012-06-27,BATS BZX (Z),250291584,109014837,159386844,518693265,6931953036.600989,5826041910.682704,4141313745.204377,16899308692.488070,1560619,347454,927266,2835339
2012-06-26,NYSE MKT (A),0,7495829,2715034,10210863,0.000000,47879393.058900,33872588.998200,81751982.057100,0,19322,13317,32639
2012-06-26,NASDAQ BX (B),91506006,28577774,42053784,162137564,2204875161.028601,1203089057.200399,1226142931.092801,4634107149.321801,589472,113233,284985,987690
2012-06-26,NSX (C),9661944,3672213,6640393,19974550,240576706.153100,136014665.962200,162745744.724600,539337116.839900,33270,7666,20177,61113
2012-06-26,NYSE (DN),74942135,12049412,33440586,120432133,2181219148.482001,615608804.302300,1017272985.663199,3814100938.447500,401684,47254,180453,629391
2012-06-26,NASDAQ (DQ),960262096,273179243,483295079,1716736418,24266175217.665380,11950458088.621712,11786882765.880817,48003516072.167909,2870887,448417,1382385,4701689
2012-06-26,EDGA (J),92521015,33847555,43971258,170339828,2252266630.218402,1661502820.163000,1018173576.463198,4931943026.844600,538665,136764,252234,927663
2012-06-26,EDGX (K),205638704,57639920,131295641,394574265,5576923920.313711,2421790653.617698,3326819287.785375,11325533861.716784,1049010,159708,634545,1843263
2012-06-26,CHX (M),6169366,5641180,5644431,17454977,203561923.136200,441837226.863000,235434212.109800,880833362.109000,681,1851,490,3022
2012-06-26,NYSE (N),712297040,0,0,712297040,21402179141.010197,0.000000,0.000000,21402179141.010197,2296245,0,0,2296245
2012-06-26,NYSE Arca (P),322793826,191448589,191347976,705590391,8815796061.912599,10048726467.138586,5792521876.653514,24657044405.704699,1752985,458893,926540,3138418
2012-06-26,NASDAQ (Q),495530299,180185617,416611497,1092327413,14256067804.676676,10725612928.652279,11737684833.664367,36719365566.993322,2873162,573690,1920759,5367611
2012-06-26,CBSX (W),15828323,3374872,6263181,25466376,344564412.920000,190111316.100000,119902673.770000,654578402.790000,101262,13052,42314,156628
2012-06-26,NASDAQ PSX (X),38698672,27420602,31376127,97495401,768456210.595000,1734756914.920000,657767149.705000,3160980275.220000,154219,60270,101740,316229
2012-06-26,BATS BYX (Y),105914165,27644046,49867640,183425851,2341919512.810000,1254940456.292200,1122341637.600200,4719201606.702400,681736,115192,320481,1117409
2012-06-26,BATS BZX (Z),270931531,118316889,163505049,552753469,7109953999.407201,6689470540.720418,4242842469.405077,18042267009.532696,1664792,390836,917578,2973206
2012-06-25,NYSE MKT (A),0,8189383,2208446,10397829,0.000000,51804102.775500,24098754.725000,75902857.500500,0,21036,9726,30762
2012-06-25,NASDAQ BX (B),88175744,30558227,41759778,160493749,2053313865.683000,1241609388.852100,1213164205.410900,4508087459.946000,564166,115358,273828,953352
2012-06-25,NSX (C),10948469,3576567,5900183,20425219,246974598.092200,133255700.603800,169218429.704200,549448728.400200,33368,7767,18457,59592
2012-06-25,NYSE (DN),76360036,14368704,35335861,126064601,2299887521.073197,706937871.564500,1038351901.893599,4045177294.531296,434013,50127,182623,666763
2012-06-25,NASDAQ (DQ),1059525871,309463328,446613888,1815603087,28308925718.424087,14255070814.432267,11445166344.720659,54009162877.577013,2944966,501705,1342695,4789366
2012-06-25,EDGA (J),94321023,35545418,43098510,172964951,2302656091.428600,1796633216.656800,1021803390.810300,5121092698.895700,542867,146940,239667,929474
2012-06-25,EDGX (K),220785802,63138400,110779414,394703616,6130622199.588099,2713592163.196897,2781160085.701085,11625374448.486081,1139366,173800,534704,1847870
2012-06-25,CHX (M),9902523,6187766,3608259,19698548,308148675.922000,565489342.458900,132311733.575500,1005949751.956400,527,2471,833,3831
2012-06-25,NYSE (N),753754149,0,0,753754149,22347409565.977882,0.000000,0.000000,22347409565.977882,2179155,0,0,2179155
2012-06-25,NYSE Arca (P),319568739,214943402,171939035,706451176,9129175181.486923,11279572329.594175,5428007137.890108,25836754648.971206,1726585,506582,839702,3072869
2012-06-25,NASDAQ (Q),457591082,179142637,414082108,1050815827,13139627292.473422,10453145975.934047,11843932884.211321,35436706152.618790,2599596,564225,1803661,4967482
2012-06-25,CBSX (W),16319514,8678125,6674138,31671777,347377986.210000,382765429.110000,122816100.400000,852959515.720000,102365,15399,45073,162837
2012-06-25,NASDAQ PSX (X),35788167,27157918,26967666,89913751,739153820.225000,1626903360.960000,557835182.720000,2923892363.905000,147594,60446,88960,297000
2012-06-25,BATS BYX (Y),102138316,27799254,44558219,174495789,2280810393.993596,1216327111.223000,1008370188.361797,4505507693.578393,655474,112913,281984,1050371
2012-06-25,BATS BZX (Z),257309598,120905553,147537205,525752356,7045460480.833584,6777209044.046390,3945639074.568294,17768308599.448268,1588855,404011,838329,2831195
2012-06-22,NYSE MKT (A),0,58467491,2307216,60774707,0.000000,276421417.225500,26093903.270000,302515320.495500,0,30934,9304,40238
2012-06-22,NASDAQ BX (B),92578293,29873935,44426660,166878888,2296967348.065001,1232306426.348600,1369388686.862502,4898662461.276103,607490,114915,296199,1018604
2012-06-22,NSX (C),10521535,3589866,8185681,22297082,279634560.348300,119194886.748600,177677748.080501,576507195.177401,36033,9069,26002,71104
2012-06-22,NYSE (DN),74189481,12766212,34431692,121387385,2209756614.283202,587086765.562500,974994359.468699,3771837739.314401,412025,43361,181958,637344
2012-06-22,NASDAQ (DQ),2035519643,321641445,1684674499,4041835587,55030674680.825164,11703531272.045314,28859032352.676492,95593238305.546970,3009571,465282,1543093,5017946
2012-06-22,EDGA (J),100756579,32656863,48869934,182283376,2667308209.647305,1547473885.173299,1104267581.114098,5319049675.934702,595010,130524,273118,998652
2012-06-22,EDGX (K),214010495,59594453,108746897,382351845,5999196199.838978,2483963175.333999,2647941193.530158,11131100568.703135,1094779,161294,529575,1785648
2012-06-22,CHX (M),6933751,10382677,3861936,21178364,198348539.698900,849458389.109900,103510336.462300,1151317265.271100,495,2142,563,3200
2012-06-22,NYSE (N),1578052509,0,0,1578052509,44059053587.399872,0.000000,0.000000,44059053587.399872,2405767,0,0,2405767
2012-06-22,NYSE Arca (P),320797099,195312932,186352588,702462619,9504933853.424246,10482084269.510903,5736576262.843935,25723594385.779084,1746243,478028,903253,3127524
2012-06-22,NASDAQ (Q),468754261,165953313,1105593677,1740301251,14054889308.909408,9512998264.965318,20641221939.450985,44209109513.325711,2671334,531580,2011369,5214283
2012-06-22,CBSX (W),17828358,6056604,8171903,32056865,428379576.020000,249786431.200000,155200111.420000,833366118.640000,114392,13499,56961,184852
2012-06-22,NASDAQ PSX (X),33888665,24444400,30522179,88855244,727968641.198200,1511674142.820000,677269575.165000,2916912359.183200,143294,59733,91873,294900
2012-06-22,BATS BYX (Y),108806452,25543328,49568796,183918576,2673749026.068299,1107854319.589000,1139463674.015703,4921067019.673002,710176,112686,321962,1144824
2012-06-22,BATS BZX (Z),252674442,112430730,151300332,516405504,6908562246.156002,6403008195.438802,3979795741.495178,17291366183.089982,1524302,375628,832637,2732567
2012-06-21,NYSE MKT (A),0,13701934,3417614,17119548,0.000000,68447304.723700,48677230.224400,117124534.948100,0,27885,12465,40350
2012-06-21,NASDAQ BX (B),102713825,41739879,49603188,194056892,2483790581.589999,1656496833.846500,1678767355.994095,5819054771.430594,647117,151805,319946,1118868
2012-06-21,NSX (C),13395465,6339757,8113042,27848264,352334863.343400,213494137.494000,264932638.494501,830761639.331901,45754,13518,23802,83074
2012-06-21,NYSE (DN),85839992,16806616,43162726,145809334,2634864532.245200,842540424.638100,1317472864.307600,4794877821.190900,484066,57767,224507,766340
2012-06-21,NASDAQ (DQ),1193645780,394333067,535012985,2122991832,31811582895.504089,17002961361.106783,14314828845.282914,63129373101.893786,3338514,650432,1521651,5510597
2012-06-21,EDGA (J),114873054,48651576,50527042,214051672,2942595285.555600,2374597655.916000,1272853074.845899,6590046016.317499,670252,186366,288893,1145511
2012-06-21,EDGX (K),273652378,85413531,126465344,485531253,7650665862.555481,3763126579.576393,3428743496.715688,14842535938.847562,1348307,240787,609979,2199073
2012-06-21,CHX (M),6734106,11635074,8344776,26713956,246493600.896400,1090423651.051900,266900774.833500,1603818026.781800,1150,4270,760,6180
2012-06-21,NYSE (N),865874907,0,0,865874907,26590881363.682642,0.000000,0.000000,26590881363.682642,2657991,0,0,2657991
2012-06-21,NYSE Arca (P),396215021,275813811,218825521,890854353,11501099706.415392,14938769200.328232,7068327898.025814,33508196804.769438,2176423,664388,1057315,3898126
2012-06-21,NASDAQ (Q),544351874,245331541,482582067,1272265482,15943216054.436309,14980779531.150692,14135046971.273875,45059042556.860876,3116585,794366,2230120,6141071
2012-06-21,CBSX (W),18653100,5719469,7774492,32147061,421716790.990000,288833038.160000,157002502.160000,867552331.310000,108567,17894,47929,174390
2012-06-21,NASDAQ PSX (X),42073005,35551121,34117378,111741504,900050037.525000,2301979031.170000,724618235.704900,3926647304.399900,170138,80270,107068,357476
2012-06-21,BATS BYX (Y),125090769,35721409,55399582,216211760,3011306903.562300,1504979965.274999,1290316381.949900,5806603250.787199,800703,147807,350940,1299450
2012-06-21,BATS BZX (Z),302910010,167784866,174747622,645442498,8065784677.318779,10063634161.989090,4890084760.592521,23019503599.900390,1806402,545591,971077,3323070
2012-06-20,NYSE MKT (A),0,9608766,3112206,12720972,0.000000,63826662.441100,42018421.345000,105845083.786100,0,26097,13533,39630
2012-06-20,NASDAQ BX (B),90359657,39399428,41500315,171259400,2229104113.778399,1673417640.833199,1478890726.342401,5381412480.953999,576319,155181,277481,1008981
2012-06-20,NSX (C),14430157,6889978,6505851,27825986,360398897.807600,234529501.706200,234922137.497900,829850537.011700,41450,13307,22547,77304
2012-06-20,NYSE (DN),86919972,18914242,41210559,147044773,2692427121.884701,1031039899.894600,1256555094.609902,4980022116.389203,493646,67540,224035,785221
2012-06-20,NASDAQ (DQ),984332923,347332484,460932562,1792597969,26349892129.305789,15772514477.225959,12803260317.084459,54925666923.616207,3004633,574005,1330659,4909297
2012-06-20,EDGA (J),103393474,48066053,41817515,193277042,2633854334.964204,2224286948.597600,1060418304.739800,5918559588.301604,608862,175079,252261,1036202
2012-06-20,EDGX (K),263319509,86281446,121394845,470995800,7369866702.903385,3743153474.185697,3311241778.362195,14424261955.451277,1323365,238046,583046,2144457
2012-06-20,CHX (M),5091525,16130232,6980391,28202148,172617614.533700,1240407661.630000,297407129.326300,1710432405.490000,448,5692,570,6710
2012-06-20,NYSE (N),751151618,0,0,751151618,23179691623.870572,0.000000,0.000000,23179691623.870572,2562208,0,0,2562208
2012-06-20,NYSE Arca (P),373303558,272205196,187362413,832871167,10938647412.548399,14204180462.371416,6452427240.892421,31595255115.812236,2074534,674564,960068,3709166
2012-06-20,NASDAQ (Q),545287138,283105093,419244679,1247636910,16082437034.262253,17492877087.939490,12734929685.666169,46310243807.867912,3142076,921458,2022769,6086303
2012-06-20,CBSX (W),13656612,3350082,5624887,22631581,322166250.630000,167006773.540000,110911421.810000,600084445.980000,83379,13728,35778,132885
2012-06-20,NASDAQ PSX (X),40502094,38333939,29547859,108383892,887173956.520000,2371448259.645000,660547240.315000,3919169456.480000,171082,85565,98447,355094
2012-06-20,BATS BYX (Y),114213748,36580339,48033252,198827339,2839832423.299998,1641798004.259400,1174465527.071696,5656095954.631094,755610,161741,317988,1235339
2012-06-20,BATS BZX (Z),310936233,177548455,160139980,648624668,8631385453.650254,10264861487.579737,4596205319.300208,23492452260.530199,1896266,577066,924067,3397399
2012-06-19,NYSE MKT (A),0,12958122,4188712,17146834,0.000000,70303767.076000,54836384.195000,125140151.271000,0,26510,15041,41551
2012-06-19,NASDAQ BX (B),102141132,31756863,51185780,185083775,2378852540.423997,1291096227.661399,1524105769.446401,5194054537.531797,642098,119023,321586,1082707
2012-06-19,NSX (C),11195668,4888481,6737480,22821629,336539050.110100,152731732.767700,215935155.817099,705205938.694899,41451,9511,22347,73309
2012-06-19,NYSE (DN),96796592,16378111,48992569,162167272,2787288071.178696,773388856.207600,1477181659.660802,5037858587.047098,533449,53234,246540,833223
2012-06-19,NASDAQ (DQ),1120351149,366551527,592784217,2079686893,28823597887.366824,15470951109.997028,15318411124.867859,59612960122.231711,3428766,541311,1674403,5644480
2012-06-19,EDGA (J),104906906,41429122,51807997,198144025,2667915208.517696,1901988777.951099,1280632475.603901,5850536462.072696,609781,139968,283724,1033473
2012-06-19,EDGX (K),261140639,76127882,132329941,469598462,7204277736.950005,3265748458.194800,3603653070.581924,14073679265.726729,1289380,196017,611033,2096430
2012-06-19,CHX (M),9501548,13275064,9262009,32038621,310496952.286800,803766316.223300,444665547.373000,1558928815.883100,862,2529,438,3829
2012-06-19,NYSE (N),772238044,0,0,772238044,23282023581.900025,0.000000,0.000000,23282023581.900025,2346031,0,0,2346031
2012-06-19,NYSE Arca (P),370373049,228639709,207633094,806645852,10520502418.282382,11291674776.254856,6863128676.331190,28675305870.868428,1978286,511762,1006075,3496123
2012-06-19,NASDAQ (Q),489266141,186816154,467747068,1143829363,14097411729.324044,10889603192.043899,13480188745.115160,38467203666.483103,2786049,582663,2088538,5457250
2012-06-19,CBSX (W),17284437,5188339,7335803,29808579,394804041.440000,263615212.250000,147425558.050000,805844811.740000,104043,14299,46452,164794
2012-06-19,NASDAQ PSX (X),37708310,30462305,34701781,102872396,814978119.475000,1856953607.920000,684190052.865000,3356121780.260000,156762,65838,101969,324569
2012-06-19,BATS BYX (Y),122087143,31162851,58141446,211391440,2957276430.785903,1409343139.312200,1279590178.176699,5646209748.274802,794676,127096,348010,1269782
2012-06-19,BATS BZX (Z),288399858,128097422,172994305,589491585,7691296237.860407,7305528621.438569,4595224741.658034,19592049600.957010,1754531,404728,944632,3103891
2012-06-18,NYSE MKT (A),0,11162750,3623457,14786207,0.000000,66899611.139500,51934217.570000,118833828.709500,0,25808,16902,42710
2012-06-18,NASDAQ BX (B),82208035,29586428,44155037,155949500,1981819840.925700,1262545803.329900,1612839584.838501,4857205229.094101,553061,122345,301014,976420
2012-06-18,NSX (C),10227168,4426821,5822329,20476318,276676298.667200,135016412.524700,304214537.725800,715907248.917700,35684,8966,20447,65097
2012-06-18,NYSE (DN),76694661,14104054,42533800,133332515,2262404195.321899,608160210.740300,1445039443.281298,4315603849.343497,459372,54005,229137,742514
2012-06-18,NASDAQ (DQ),906286121,281687576,498817099,1686790796,22871259539.237956,11457848937.870505,14383172854.530418,48712281331.638879,2878592,515689,1465359,4859640
2012-06-18,EDGA (J),94294080,35759498,45081237,175134815,2412090451.073399,1608724235.356800,1144544773.762601,5165359460.192800,564035,134450,267906,966391
2012-06-18,EDGX (K),223824392,66583443,120525527,410933362,6223494522.404800,2909490074.828797,3372050883.115790,12505035480.349387,1146936,180589,586656,1914181
2012-06-18,CHX (M),10456424,9628277,3915173,23999874,323637548.056100,629809213.429200,100075206.825600,1053521968.310900,765,2684,428,3877
2012-06-18,NYSE (N),707413130,0,0,707413130,21203870907.419464,0.000000,0.000000,21203870907.419464,2264786,0,0,2264786
2012-06-18,NYSE Arca (P),305576834,221850888,186163060,713590782,8617946752.440210,11002143855.950062,6718014294.529103,26338104902.919375,1701286,511609,913399,3126294
2012-06-18,NASDAQ (Q),438535151,182609265,425388989,1046533405,12521010056.058721,10430129047.857658,13058715332.396897,36009854436.313276,2510689,587508,1948626,5046823
2012-06-18,CBSX (W),14877498,3674515,6615310,25167323,348334118.270000,190969795.820000,132669474.616800,671973388.706800,96682,12104,42994,151780
2012-06-18,NASDAQ PSX (X),32345621,27262353,26930943,86538917,707842019.000000,1570515909.240000,578655372.475000,2857013300.715000,144175,61440,89966,295581
2012-06-18,BATS BYX (Y),105349256,29181527,52464516,186995299,2532963478.250300,1185362265.640001,1326908046.900197,5045233790.790498,707775,128042,331817,1167634
2012-06-18,BATS BZX (Z),257472680,122084597,155860117,535417394,6778468004.168916,6554638845.919910,4409511211.231509,17742618061.320335,1597674,403791,901963,2903428
2012-06-15,NYSE MKT (A),0,43734901,3333994,47068895,0.000000,214389889.902500,48185708.093500,262575597.996000,0,31922,14603,46525
2012-06-15,NASDAQ BX (B),97481526,35429922,45442265,178353713,2311346452.400000,1445263310.174400,1436448431.807299,5193058194.381699,612151,119749,292958,1024858
2012-06-15,NSX (C),9778283,4523704,5960138,20262125,251145125.936600,129557369.771600,209541881.022900,590244376.731100,32449,10269,19776,62494
2012-06-15,NYSE (DN),85674161,15930219,44881791,146486171,2551420132.828197,758627071.084600,1333892955.102503,4643940159.015300,484712,61080,238899,784691
2012-06-15,NASDAQ (DQ),1108397756,347927595,600168692,2056494043,27829946619.167213,15045308836.921117,15987417172.189362,58862672628.277692,3150232,558370,1430376,5138978
2012-06-15,EDGA (J),102359974,41649995,48443807,192453776,2607921143.033100,1859958150.774201,1205398245.443497,5673277539.250798,582067,142544,278331,1002942
2012-06-15,EDGX (K),225108086,66448025,112649651,404205762,6325972097.622693,2867729817.686899,3042229070.448488,12235930985.758080,1157398,186068,550051,1893517
2012-06-15,CHX (M),40892896,22779615,5627911,69300422,348785367.448000,1635535075.125500,302621054.240700,2286941496.814200,421,1932,608,2961
2012-06-15,NYSE (N),1513365671,0,0,1513365671,47015448568.599784,0.000000,0.000000,47015448568.599784,2314642,0,0,2314642
2012-06-15,NYSE Arca (P),340703732,244891886,185959061,771554679,9646488288.753947,12634304496.825516,6094232388.777592,28375025174.357055,1764969,523076,886639,3174684
2012-06-15,NASDAQ (Q),452502851,203835338,791490154,1447828343,13104978617.209774,12353176862.008818,21761878368.612236,47220033847.830828,2498289,594087,1941225,5033601
2012-06-15,CBSX (W),16681636,5303405,7609507,29594548,411923591.190000,266904497.970000,167300042.190000,846128131.350000,103874,13810,47812,165496
2012-06-15,NASDAQ PSX (X),33812168,29263074,25510924,88586166,723697740.585000,1765386230.555000,559063110.865000,3048147082.005000,142007,62821,87526,292354
2012-06-15,BATS BYX (Y),114694368,31413866,52348771,198457005,2794404504.891998,1306146997.679400,1267590447.175497,5368141949.746895,741261,121177,328277,1190715
2012-06-15,BATS BZX (Z),268184116,132360699,156699404,557244219,7402134409.178868,7068470569.377417,4257980346.769184,18728585325.325469,1657612,412061,888307,2957980
2012-06-14,NYSE MKT (A),0,10690598,2734478,13425076,0.000000,61720601.843100,40004515.819700,101725117.662800,0,24981,13652,38633
2012-06-14,NASDAQ BX (B),97317077,35968646,44691076,177976799,2381179843.344999,1630649342.844602,1643699810.359899,5655528996.549500,629050,139561,301723,1070334
2012-06-14,NSX (C),11042302,5223260,5654306,21919868,284097113.572400,182920167.651200,224311848.008300,691329129.231900,36919,10148,19904,66971
2012-06-14,NYSE (DN),79967933,16542193,41212036,137722162,2279143676.402997,827917394.816200,1238474548.294002,4345535619.513199,451805,61761,220232,733798
2012-06-14,NASDAQ (DQ),979800876,354326917,481119701,1815247494,24230131959.164962,18272561460.294109,13493348271.258954,55996041690.718025,3042794,550257,1356255,4949306
2012-06-14,EDGA (J),103040643,45449029,48536565,197026237,2632109245.373398,2143164795.634699,1204607932.887898,5979881973.895995,607104,174031,286484,1067619
2012-06-14,EDGX (K),247962312,81213076,117149133,446324521,6825968352.903906,3758171754.316898,3182227710.395200,13766367817.616004,1274204,225680,598957,2098841
2012-06-14,CHX (M),10165077,15758470,4365582,30289129,437646334.816100,1191335696.170800,136579074.352700,1765561105.339600,646,3243,636,4525
2012-06-14,NYSE (N),779391781,0,0,779391781,23833941672.768226,0.000000,0.000000,23833941672.768226,2573834,0,0,2573834
2012-06-14,NYSE Arca (P),377547589,250874445,190595804,819017838,10443819345.915876,13244500198.017502,6683991511.023995,30372311054.957373,1995748,592253,973632,3561633
2012-06-14,NASDAQ (Q),531570937,247486103,447098342,1226155382,15058551974.570569,15052252770.951791,13097899580.749085,43208704326.271445,2976001,776700,2099221,5851922
2012-06-14,CBSX (W),12859310,5095905,5460705,23415920,294086675.140000,316243317.240000,116538546.390000,726868538.770000,76331,13191,35740,125262
2012-06-14,NASDAQ PSX (X),38018193,36504492,29707785,104230470,824717367.155000,2442645287.809999,720700510.377300,3988063165.342299,154802,82426,102862,340090
2012-06-14,BATS BYX (Y),123047565,32978684,55110741,211136990,3002919868.187204,1449684274.530000,1328501193.707098,5781105336.424302,810415,137724,354109,1302248
2012-06-14,BATS BZX (Z),298333973,152021251,171260953,621616177,8181904717.817412,8722885912.140198,4662741495.946385,21567532125.903995,1836371,493181,996131,3325683
2012-06-13,NYSE MKT (A),0,9779913,2628832,12408745,0.000000,58633817.364900,36799343.808200,95433161.173100,0,25882,13775,39657
2012-06-13,NASDAQ BX (B),89824043,29877040,45013956,164715039,2186911544.895800,1267795361.140900,1489783053.930199,4944489959.966899,599292,114553,293920,1007765
2012-06-13,NSX (C),9597514,4166875,6544117,20308506,265650062.184400,133456288.255500,198769564.989800,597875915.429700,33081,8270,19107,60458
2012-06-13,NYSE (DN),79618587,15965311,42486048,138069946,2387920906.250799,813081033.736101,1201949578.597202,4402951518.584102,466111,59613,232522,758246
2012-06-13,NASDAQ (DQ),1018302380,297303281,525889434,1841495095,27181456469.100239,13985146352.396338,13139719474.427597,54306322295.924174,2895843,502416,1356896,4755155
2012-06-13,EDGA (J),103405658,42960886,46317338,192683882,2662115965.388499,1936305005.097601,1111706552.693099,5710127523.179199,628212,150166,272825,1051203
2012-06-13,EDGX (K),227109494,74004656,117926301,419040451,6569476685.914204,3368729143.226805,3071913293.755195,13010119122.896204,1227105,202305,594825,2024235
2012-06-13,CHX (M),16335056,18513096,7084820,41932972,824931974.661000,1480434729.505200,221982311.641600,2527349015.807800,910,2552,434,3896
2012-06-13,NYSE (N),707133343,0,0,707133343,21627942338.780545,0.000000,0.000000,21627942338.780545,2337639,0,0,2337639
2012-06-13,NYSE Arca (P),342695236,230305898,188941981,761943115,10296566808.916692,11948754015.233055,5997355304.117618,28242676128.267365,1902143,548702,947180,3398025
2012-06-13,NASDAQ (Q),485900832,212368091,437513274,1135782197,14189511100.346100,12598767004.638069,12212933128.763605,39001211233.747774,2779621,677693,2048838,5506152
2012-06-13,CBSX (W),13123691,3454254,5397369,21975314,294364347.170000,217720159.170000,100345391.950000,612429898.290000,78275,11514,34874,124663
2012-06-13,NASDAQ PSX (X),32156370,30698922,29682325,92537617,746624702.915000,1814917619.360000,635680720.356300,3197223042.631300,141394,66719,95790,303903
2012-06-13,BATS BYX (Y),112454657,28074868,51486873,192016398,2735770311.055597,1221383304.750000,1163946510.561201,5121100126.366798,740885,119329,330731,1190945
2012-06-13,BATS BZX (Z),266961581,140828470,161993970,569784021,7479796088.870699,7960248649.351991,4217039424.386701,19657084162.609391,1695403,467181,922923,3085507
2012-06-12,NYSE MKT (A),0,9863091,2842581,12705672,0.000000,60845289.472900,39778551.430000,100623840.902900,0,25946,14210,40156
2012-06-12,NASDAQ BX (B),94050664,32682342,45367938,172100944,2353173150.489996,1427306043.466699,1612727523.610297,5393206717.566992,636670,131044,305246,1072960
2012-06-12,NSX (C),10217902,4464303,6931525,21613730,260026212.682300,153591360.155000,245194643.351201,658812216.188501,36365,10017,21270,67652
2012-06-12,NYSE (DN),78411356,17945603,38684438,135041397,2191973066.654200,911301569.960800,1246521166.683300,4349795803.298300,445749,67532,216446,729727
2012-06-12,NASDAQ (DQ),938350586,310129509,478499366,1726979461,23982241735.963464,14544969309.063638,13185487464.668272,51712698509.695374,3026623,526619,1397521,4950763
2012-06-12,EDGA (J),101716873,42100783,45400111,189217767,2518283251.555197,2018430085.761300,1124850814.285197,5661564151.601694,621431,172138,271548,1065117
2012-06-12,EDGX (K),228051417,69337189,117644632,415033238,6349783309.786300,3163092140.126695,3208768241.847682,12721643691.760677,1247323,210038,599646,2057007
2012-06-12,CHX (M),8252238,15353584,4291361,27897183,285206121.555300,1131667232.329800,232659931.171600,1649533285.056700,680,3685,673,5038
2012-06-12,NYSE (N),723970448,0,0,723970448,21848996034.354250,0.000000,0.000000,21848996034.354250,2417575,0,0,2417575
2012-06-12,NYSE Arca (P),347520914,234465033,191039678,773025625,9718495824.240870,12253861451.461412,6690319257.714230,28662676533.416512,1938882,590272,975823,3504977
2012-06-12,NASDAQ (Q),487721454,227421615,427301655,1142444724,13784335397.393245,13386138201.543035,13154893794.730722,40325367393.667002,2836569,727234,2040429,5604232
2012-06-12,CBSX (W),13360592,2734040,5812714,21907346,320075318.530000,155908843.530000,108531302.850000,584515464.910000,84763,12035,36532,133330
2012-06-12,NASDAQ PSX (X),33465879,34709330,29299564,97474773,719109229.520000,2038400292.935000,675689213.960000,3433198736.415000,145257,80408,101264,326929
2012-06-12,BATS BYX (Y),112296397,29823974,51647275,193767646,2735215104.149998,1300712096.113400,1235114416.027800,5271041616.291198,753556,137386,343115,1234057
2012-06-12,BATS BZX (Z),268756721,153405751,155236686,577399158,7276161625.553485,8737825124.329811,4414594835.963998,20428581585.847294,1717386,517834,922358,3157578
2012-06-11,NYSE MKT (A),0,10167651,2944958,13112609,0.000000,55680349.941700,40942686.900000,96623036.841700,0,26952,14833,41785
2012-06-11,NASDAQ BX (B),98560763,33268569,43464048,175293380,2243567568.501197,1435726014.609899,2006899005.104699,5686192588.215795,623128,132742,307121,1062991
2012-06-11,NSX (C),11465738,5276659,5963146,22705543,269054195.543200,163700537.476100,324598044.939500,757352777.958800,39248,11664,20224,71136
2012-06-11,NYSE (DN),76583237,16971607,36599394,130154238,2080207217.917899,819927824.797700,1280938309.715799,4181073352.431398,439339,64026,201045,704410
2012-06-11,NASDAQ (DQ),1015282566,320443344,445268963,1780994873,26262271560.277486,14050203512.390067,13865856283.408755,54178331356.076308,2926102,538410,1328650,4793162
2012-06-11,EDGA (J),104741258,48232126,44256403,197229787,2547416993.064402,2113883684.963603,1166271469.214798,5827572147.242803,619435,169720,276639,1065794
2012-06-11,EDGX (K),231037022,72820180,110452473,414309675,6193310252.221195,3336385848.560198,3401722768.888788,12931418869.670181,1191289,209224,590246,1990759
2012-06-11,CHX (M),9054003,10181808,3251945,22487756,288416745.204300,700613815.115000,234745749.805000,1223776310.124300,2082,3251,907,6240
2012-06-11,NYSE (N),740472095,0,0,740472095,21892813047.123220,0.000000,0.000000,21892813047.123220,2374565,0,0,2374565
2012-06-11,NYSE Arca (P),346972120,247040282,172770615,766783017,9404399105.836494,13119601224.458618,7113399308.483556,29637399638.778668,1880794,591684,934928,3407406
2012-06-11,NASDAQ (Q),471253858,221528541,423319802,1116102201,13077671229.852611,12907634550.964301,13476290451.828726,39461596232.645638,2722267,714164,2011328,5447759
2012-06-11,CBSX (W),12837958,2555945,5585001,20978904,282250441.470000,128112182.050000,115157098.682000,525519722.202000,79494,10040,38179,127713
2012-06-11,NASDAQ PSX (X),28702768,32203103,23311736,84217607,589732923.220000,1967841958.170000,536437994.501800,3094012875.891800,127401,71910,85808,285119
2012-06-11,BATS BYX (Y),118577966,32270857,47273017,198121840,2718063602.622799,1400656892.125000,1215753391.297900,5334473886.045699,757776,137884,322051,1217711
2012-06-11,BATS BZX (Z),268145211,147548872,148985716,564679799,7086801714.603617,8201102436.862678,4500269447.959605,19788173599.425900,1690033,486869,910840,3087742
2012-06-08,NYSE MKT (A),0,8996047,2501607,11497654,0.000000,57733114.807000,34677655.496800,92410770.303800,0,22329,12532,34861
2012-06-08,NASDAQ BX (B),107039692,27197044,42420282,176657018,2329921037.392796,1189628150.325300,1472834203.272500,4992383390.990596,623000,110068,286208,1019276
2012-06-08,NSX (C),9949935,4140813,5262078,19352826,253569651.553200,130133968.232400,186661819.572600,570365439.358200,34931,8964,17505,61400
2012-06-08,NYSE (DN),75275624,13243156,36396423,124915203,2164676285.774600,644899672.127800,1060432097.919700,3870008055.822100,421390,53031,199273,673694
2012-06-08,NASDAQ (DQ),1067767868,278374876,415201092,1761343836,27192356311.272777,12934929787.228517,11859656887.507317,51986942986.008611,2925326,493739,1323980,4743045
2012-06-08,EDGA (J),102935825,33522815,44734125,181192765,2488364457.762797,1598611690.226000,1140812562.077601,5227788710.066398,581234,136713,258829,976776
2012-06-08,EDGX (K),214811242,58167823,97007775,369986840,5717233257.384493,2636389958.260798,2697048133.857286,11050671349.502577,1040743,170451,494729,1705923
2012-06-08,CHX (M),5708704,11525115,2071653,19305472,216832452.837000,906016623.829700,97568667.288800,1220417743.955500,596,3192,375,4163
2012-06-08,NYSE (N),692559633,0,0,692559633,20713485235.410124,0.000000,0.000000,20713485235.410124,2161248,0,0,2161248
2012-06-08,NYSE Arca (P),339363086,210620340,157204346,707187772,9089372173.909909,10856917356.316715,5628066777.975406,25574356308.202030,1765089,510077,843294,3118460
2012-06-08,NASDAQ (Q),459544032,177579537,381966664,1019090233,12604338175.896482,10736193602.877188,11220473037.593877,34561004816.367547,2549991,584608,1809565,4944164
2012-06-08,CBSX (W),14729306,2908611,6075507,23713424,324147623.650000,144521649.712000,126632679.069500,595301952.431500,88144,10350,39474,137968
2012-06-08,NASDAQ PSX (X),33359752,24285300,25252867,82897919,661428893.680000,1572003450.040000,544354790.185000,2777787133.905000,125922,55845,79267,261034
2012-06-08,BATS BYX (Y),116892394,25062169,47180702,189135265,2693375750.421402,1112030165.010999,1169553890.155500,4974959805.587901,720931,112027,309178,1142136
2012-06-08,BATS BZX (Z),254110959,108112580,133271158,495494697,6555491894.922972,6321438832.644903,3788092261.263799,16665022988.831674,1541903,391058,808341,2741302
2012-06-07,NYSE MKT (A),0,10029248,2769613,12798861,0.000000,65617524.369500,36730409.074000,102347933.443500,0,25170,12729,37899
2012-06-07,NASDAQ BX (B),112526305,37649971,47911137,198087413,2632063916.814999,1627390611.466600,1721018225.250102,5980472753.531701,710138,144090,327739,1181967
2012-06-07,NSX (C),12718326,5818408,6745474,25282208,328443552.248800,219499087.766300,276873124.930000,824815764.945100,45566,12850,21931,80347
2012-06-07,NYSE (DN),89612274,18256515,44102502,151971291,2652376727.400101,902356479.755500,1311442184.452398,4866175391.607999,512459,62071,234447,808977
2012-06-07,NASDAQ (DQ),1371988403,352627135,511302340,2235917878,36837690199.102568,16042267318.350070,13706772500.894019,66586730018.346657,3418491,635916,1485144,5539551
2012-06-07,EDGA (J),118872996,46608744,50810083,216291823,2972693881.080207,2237007299.049300,1289603817.846796,6499304997.976303,691257,179253,301248,1171758
2012-06-07,EDGX (K),264192672,75661268,115033224,454887164,7434426184.052115,3400390012.950896,3261134423.622891,14095950620.625902,1383454,223036,598995,2205485
2012-06-07,CHX (M),8035622,14559369,3656114,26251105,283769103.930800,1255330814.385000,228449118.764500,1767549037.080300,530,4442,618,5590
2012-06-07,NYSE (N),854611409,0,0,854611409,25606252854.570430,0.000000,0.000000,25606252854.570430,2555249,0,0,2555249
2012-06-07,NYSE Arca (P),404601768,272210839,186403247,863215854,11412074733.885301,14388298905.937394,6633767206.195906,32434140846.018601,2221596,676292,974326,3872214
2012-06-07,NASDAQ (Q),551484622,250577575,459181429,1261243626,15889108269.748485,15060611509.070257,13341691804.318184,44291411583.136926,3225371,839323,2120396,6185090
2012-06-07,CBSX (W),15300182,6813583,6915341,29029106,357794720.780000,367742636.370000,145603872.490000,871141229.640000,90601,12608,39516,142725
2012-06-07,NASDAQ PSX (X),35549042,36730161,28750877,101030080,761232684.100000,2276997760.160000,598531164.000000,3636761608.260000,148184,80977,90351,319512
2012-06-07,BATS BYX (Y),128342902,33570612,51208627,213122141,3106109721.824997,1446105176.630200,1261640112.564998,5813855011.020195,819030,136222,334915,1290167
2012-06-07,BATS BZX (Z),292848036,156188935,156797505,605834476,8033868155.655012,8790006067.354080,4299359119.914591,21123233342.923683,1846334,537508,931381,3315223
2012-06-06,NYSE MKT (A),0,11944467,2020707,13965174,0.000000,74241279.441400,26059913.180000,100301192.621400,0,27269,9580,36849
2012-06-06,NASDAQ BX (B),119440066,40704013,53100025,213244104,2668862106.710301,1718814937.489900,1785345383.147498,6173022427.347699,726996,147064,347345,1221405
2012-06-06,NSX (C),13540092,6541618,6682300,26764010,337976794.321900,225107218.514100,211287758.600100,774371771.436100,46945,14154,22403,83502
2012-06-06,NYSE (DN),97375611,20115892,48392564,165884067,2606481972.725401,903120377.103900,1433509226.169198,4943111575.998499,531378,69010,263137,863525
2012-06-06,NASDAQ (DQ),1278151341,391198143,575838069,2245187553,32270390682.031482,17764946533.525158,15464522700.362359,65499859915.918999,3559031,678734,1576685,5814450
2012-06-06,EDGA (J),128804546,46869669,53698783,229372998,3086529223.917000,2155198007.896302,1342245609.545600,6583972841.358902,709803,163605,312576,1185984
2012-06-06,EDGX (K),295312723,86958591,131543737,513815051,7740912954.473106,4215891456.237491,3710216391.685713,15667020802.396310,1412080,238748,646117,2296945
2012-06-06,CHX (M),9787308,11890359,4455938,26133605,271786820.614500,814865667.148500,160891041.858500,1247543529.621500,695,4058,679,5432
2012-06-06,NYSE (N),864200305,0,0,864200305,25625649169.805719,0.000000,0.000000,25625649169.805719,2513880,0,0,2513880
2012-06-06,NYSE Arca (P),417887957,263293279,198332310,879513546,11298796431.022322,13744905622.486479,6981281854.122425,32024983907.631226,2135628,596167,988089,3719884
2012-06-06,NASDAQ (Q),552451761,235778965,456846156,1245076882,15246004835.210113,14245719155.962182,13562556396.726720,43054280387.899015,2990571,716576,2037474,5744621
2012-06-06,CBSX (W),17765212,8260439,7747677,33773328,419352253.910000,539728867.290000,177754202.520000,1136835323.720000,105834,15273,47782,168889
2012-06-06,NASDAQ PSX (X),38964522,36138870,32468768,107572160,793574279.320000,2174802210.900000,731914760.390000,3700291250.610000,154843,75599,104031,334473
2012-06-06,BATS BYX (Y),138715155,35780604,54090795,228586554,3108863965.272403,1550308719.880000,1316106523.743700,5975279208.896103,831736,141724,348360,1321820
2012-06-06,BATS BZX (Z),304876120,148378330,165358076,618612526,7907813001.257402,8376366767.329596,4431024793.453083,20715204562.040081,1804705,496291,946513,3247509
2012-06-05,NYSE MKT (A),0,10833560,2326370,13159930,0.000000,68878173.752600,31622068.710000,100500242.462600,0,27993,10845,38838
2012-06-05,NASDAQ BX (B),91740102,32737567,44550742,169028411,2149358161.256300,1395854134.637901,1387086419.048898,4932298714.943099,606905,128042,297486,1032433
2012-06-05,NSX (C),9930628,5260382,6031233,21222243,254536772.745300,176296138.562400,190114701.468500,620947612.776200,35547,10998,20535,67080
2012-06-05,NYSE (DN),86412831,16000715,39978652,142392198,2403474520.574501,707612677.106200,1249775372.482998,4360862570.163699,494328,59109,228040,781477
2012-06-05,NASDAQ (DQ),956573212,325442057,514278219,1796293488,24274119201.211779,14990291496.825153,13499004476.047686,52763415174.084618,3052986,537029,1429891,5019906
2012-06-05,EDGA (J),101355510,41884506,47390109,190630125,2562409667.187400,1843825700.413899,1219561398.742000,5625796766.343299,616308,154596,285712,1056616
2012-06-05,EDGX (K),206037169,71014757,112831825,389883751,5767987951.140111,3299939407.650096,3089101077.318199,12157028436.108406,1098229,197022,582205,1877456
2012-06-05,CHX (M),7201818,9130028,3604453,19936299,211949268.541400,668683629.133000,91699529.133600,972332426.808000,780,2715,635,4130
2012-06-05,NYSE (N),711572816,0,0,711572816,21590270438.509878,0.000000,0.000000,21590270438.509878,2361999,0,0,2361999
2012-06-05,NYSE Arca (P),334443696,222601729,184192274,741237699,9545495234.088774,11289983686.157299,6636344985.764564,27471823906.010637,1916198,544001,949154,3409353
2012-06-05,NASDAQ (Q),485448329,209922907,431199221,1126570457,13847483729.699572,12089432713.731618,12565820207.956338,38502736651.387528,2848252,665760,2077173,5591185
2012-06-05,CBSX (W),14647775,4042681,7652543,26342999,338421683.280000,149062084.400000,152178864.220000,639662631.900000,91697,9284,42305,143286
2012-06-05,NASDAQ PSX (X),30855348,32048844,30015889,92920081,651980149.650000,1925007058.950000,622463261.170000,3199450469.770000,128126,66204,90798,285128
2012-06-05,BATS BYX (Y),116161346,30189655,51001206,197352207,2610642473.780000,1273498316.755000,1239170961.186798,5123311751.721798,754483,126399,336456,1217338
2012-06-05,BATS BZX (Z),259019390,135132516,156489175,550641081,6909657237.360215,6961025217.950611,4194180220.811682,18064862676.122508,1618851,434164,917480,2970495
2012-06-04,NYSE MKT (A),0,12421718,3029618,15451336,0.000000,88471314.823100,39748958.863000,128220273.686100,0,30045,12079,42124
2012-06-04,NASDAQ BX (B),105952365,37872862,49779425,193604652,2478145742.736500,1546043541.143499,1608364892.342299,5632554176.222298,693226,144712,325319,1163257
2012-06-04,NSX (C),12421171,5821937,7668648,25911756,323814692.515000,222344518.910300,251019323.444501,797178534.869801,47679,14398,24758,86835
2012-06-04,NYSE (DN),100417662,20341059,45103760,165862481,2771029250.102199,920978345.133400,1339375435.229000,5031383030.464599,565160,72505,238484,876149
2012-06-04,NASDAQ (DQ),1131867058,408337168,565680526,2105884752,28246488522.420334,18574390499.389632,17391304250.410295,64212183272.220261,3735732,719014,1612708,6067454
2012-06-04,EDGA (J),119876354,44950440,53558957,218385751,2961612769.405103,2071684498.539699,1387748697.931302,6421045965.876104,726383,176044,321766,1224193
2012-06-04,EDGX (K),249385449,82219698,117105235,448710382,6840418790.457097,3743833101.686595,3416416683.522297,14000668575.665989,1307822,228266,616217,2152305
2012-06-04,CHX (M),10204862,11352014,4478031,26034907,290461530.819000,801086320.373400,157124503.203600,1248672354.396000,646,3273,643,4562
2012-06-04,NYSE (N),824339813,0,0,824339813,24280210460.960609,0.000000,0.000000,24280210460.960609,2596965,0,0,2596965
2012-06-04,NYSE Arca (P),389188199,272751694,197172572,859112465,10752357016.962377,14474871343.850296,7455576972.566208,32682805333.378881,2156025,640357,1018779,3815161
2012-06-04,NASDAQ (Q),559438984,231074155,478811325,1269324464,15639256879.467304,13407383760.155011,15051924127.539643,44098564767.161958,3231660,741450,2208498,6181608
2012-06-04,CBSX (W),15935598,7018776,7804273,30758647,351769105.040000,279076912.520000,150738378.000000,781584395.560000,96852,13607,45392,155851
2012-06-04,NASDAQ PSX (X),38092205,32014903,30541550,100648658,754074169.055000,1928523138.681100,692859721.805000,3375457029.541100,147630,68053,100540,316223
2012-06-04,BATS BYX (Y),137003409,32841767,54569785,224414961,3064110916.082199,1347998753.310000,1377829812.341702,5789939481.733901,880411,137941,347996,1366348
2012-06-04,BATS BZX (Z),312831137,159574587,180709549,653115273,8221570489.828989,8505268667.647995,5094357330.072705,21821196487.549689,1924989,534174,1041753,3500916
2012-06-01,NYSE MKT (A),0,12669671,4100944,16770615,0.000000,84378217.025200,55343912.360000,139722129.385200,0,29499,15979,45478
2012-06-01,NASDAQ BX (B),119096742,50533946,55383105,225013793,2828667576.988806,2201313009.262200,1963072879.245298,6993053465.496304,760954,186126,359727,1306807
2012-06-01,NSX (C),15994265,7808597,8423859,32226721,438693070.893200,315895050.729000,254651804.161600,1009239925.783800,58136,19233,26994,104363
2012-06-01,NYSE (DN),110924317,25656378,49189617,185770312,3268831634.719496,1248478044.929500,1630658677.694700,6147968357.343696,621253,89212,270752,981217
2012-06-01,NASDAQ (DQ),1295469997,523066670,580494481,2399031148,32748390319.933711,25218463781.566213,16185614032.316817,74152468133.816741,4266979,878519,1831576,6977074
2012-06-01,EDGA (J),143213264,61297507,61511097,266021868,3510128449.864802,2906473787.060103,1677834308.057800,8094436544.982705,845296,233775,366373,1445444
2012-06-01,EDGX (K),300331383,107150602,140036833,547518818,8197640626.231798,5074594516.241994,3822270410.770909,17094505553.244701,1541832,303194,731014,2576040
2012-06-01,CHX (M),13832627,17376142,7905629,39114398,425623523.426800,1752011221.448000,237848945.633900,2415483690.508700,647,8111,777,9535
2012-06-01,NYSE (N),999488054,0,0,999488054,30174717626.501685,0.000000,0.000000,30174717626.501685,3027313,0,0,3027313
2012-06-01,NYSE Arca (P),467950788,354027045,226535773,1048513606,13483602894.779621,19125403653.256949,8562261903.353800,41171268451.390370,2594726,805644,1156707,4557077
2012-06-01,NASDAQ (Q),640572912,301730624,554949131,1497252667,18203544166.851424,17717724184.159583,16351962296.747434,52273230647.758441,3670557,964262,2499901,7134720
2012-06-01,CBSX (W),18931683,6573224,8222379,33727286,450785133.540000,346823981.976000,194305522.900000,991914638.416000,111603,19197,51295,182095
2012-06-01,NASDAQ PSX (X),41757919,38260486,34704038,114722443,859768293.885000,2312829793.435000,783102136.855000,3955700224.175000,166060,85399,108444,359903
2012-06-01,BATS BYX (Y),146993197,44167184,63877786,255038167,3493906091.893400,1937429088.843000,1615503714.108699,7046838894.845099,939759,179007,403054,1521820
2012-06-01,BATS BZX (Z),361636358,194217924,190301580,746155862,9894335835.235177,10805189916.339594,5490506569.666200,26190032321.240971,2245857,668896,1123717,4038470
2012-05-31,NYSE MKT (A),0,18113427,3330447,21443874,0.000000,121904572.269500,44124993.493000,166029565.762500,0,24330,13518,37848
2012-05-31,NASDAQ BX (B),108902898,40072002,57463606,206438506,2676791259.029201,1676433180.345000,1751417652.274201,6104642091.648402,708612,156419,351867,1216898
2012-05-31,NSX (C),12976662,6017163,7827857,26821682,354263024.633000,260510531.947700,278167796.074400,892941352.655100,48465,13625,24568,86658
2012-05-31,NYSE (DN),92021044,18239999,47950402,158211445,2627031876.539998,920439880.943500,1370983926.889602,4918455684.373100,533842,64364,254706,852912
2012-05-31,NASDAQ (DQ),1162732853,397343167,631111258,2191187278,31220955501.487080,18342198173.921513,18262972647.750059,67826126323.158652,3441443,671148,1640275,5752866
2012-05-31,EDGA (J),125246451,54116465,59584248,238947164,3123537530.544297,2725003886.081399,1470927224.622102,7319468641.247798,759216,207491,345810,1312517
2012-05-31,EDGX (K),242679485,95193379,131349399,469222263,6799926745.363780,4607175690.213903,3766044784.741124,15173147220.318807,1281937,272947,655768,2210652
2012-05-31,CHX (M),9976993,10782103,5295568,26054664,297705952.972600,816477921.597000,174082517.759100,1288266392.328700,479,3766,602,4847
2012-05-31,NYSE (N),1327718668,0,0,1327718668,41237220807.711854,0.000000,0.000000,41237220807.711854,2754283,0,0,2754283
2012-05-31,NYSE Arca (P),418614256,295915634,229690927,944220817,12017877489.375292,15508468267.806447,8262465448.259624,35788811205.441363,2268031,685471,1106815,4060317
2012-05-31,NASDAQ (Q),590383904,272064889,757307828,1619756621,17231897148.541248,16535156249.071171,20917127605.346624,54684181002.959043,3436981,892267,2386892,6716140
2012-05-31,CBSX (W),15650488,4087495,7385062,27123045,371084904.770000,213203721.320000,148928648.850000,733217274.940000,96187,16670,47460,160317
2012-05-31,NASDAQ PSX (X),35898347,36417288,32792451,105108086,760174751.630000,2311224409.540001,690848752.685000,3762247913.855001,150194,80792,105082,336068
2012-05-31,BATS BYX (Y),128075840,37627914,59954134,225657888,3091178702.378898,1727146849.924999,1426416069.341498,6244741621.645395,836627,157621,381603,1375851
2012-05-31,BATS BZX (Z),309910887,171886006,177358952,659155845,8451426374.975477,9847157400.817896,4975580522.252196,23274164298.045569,1938851,596478,1016151,3551480
2012-05-30,NYSE MKT (A),0,10509123,3146394,13655517,0.000000,69996874.776900,42156199.369800,112153074.146700,0,22065,14057,36122
2012-05-30,NASDAQ BX (B),102840167,33037484,49883051,185760702,2471503060.511597,1319205504.840600,1918668942.393997,5709377507.746194,642548,133004,326656,1102208
2012-05-30,NSX (C),10893423,6116718,6292240,23302381,303135474.639000,226316065.466200,280191045.400501,809642585.505701,39611,13936,22074,75621
2012-05-30,NYSE (DN),79252125,18641298,39464816,137358239,2231790404.145701,840651021.640300,1206789926.297700,4279231352.083701,439946,62977,206368,709291
2012-05-30,NASDAQ (DQ),997922735,322230797,517611053,1837764585,25297884399.511968,15096787872.400977,15161976374.946615,55556648646.859560,3091616,562981,1479787,5134384
2012-05-30,EDGA (J),106110995,45472961,48320216,199904172,2711683131.024297,2139097418.127302,1264408868.441700,6115189417.593299,637493,168968,292980,1099441
2012-05-30,EDGX (K),195582755,73116547,106010237,374709539,5408283127.488305,3445905190.330497,3214399850.624798,12068588168.443600,991691,208601,535221,1735513
2012-05-30,CHX (M),10839103,9681816,7614815,28135734,322638573.118000,768108285.210000,365211270.248200,1455958128.576200,1259,3456,501,5216
2012-05-30,NYSE (N),768669012,0,0,768669012,23517744931.123361,0.000000,0.000000,23517744931.123361,2350961,0,0,2350961
2012-05-30,NYSE Arca (P),358392504,249755299,199798584,807946387,10428753599.635515,13020728167.903739,7769648214.342883,31219129981.882137,1977413,574390,1002097,3553900
2012-05-30,NASDAQ (Q),493522607,208875946,458972991,1161371544,14604712880.230964,12134049449.590779,13802213962.850926,40540976292.672669,2912442,677921,2028668,5619031
2012-05-30,CBSX (W),13680645,5721038,5944146,25345829,318200368.200000,318720904.306000,122712831.690000,759634104.196000,84806,13979,39039,137824
2012-05-30,NASDAQ PSX (X),29303439,27271449,28894361,85469249,636814491.705000,1560003735.590000,685350837.285000,2882169064.580000,138281,62569,99641,300491
2012-05-30,BATS BYX (Y),109868507,32642223,50049854,192560584,2680913031.681099,1403031263.988000,1278629957.143000,5362574252.812099,717413,138570,321006,1176989
2012-05-30,BATS BZX (Z),266845954,143973590,155731434,566550978,7225169443.806803,7541942270.845497,4568065213.124491,19335176927.776791,1673541,455400,897494,3026435
2012-05-29,NYSE MKT (A),0,9085072,2707708,11792780,0.000000,57299105.861000,34767300.660000,92066406.521000,0,21459,12529,33988
2012-05-29,NASDAQ BX (B),92103539,35578191,47507656,175189386,2191089237.010000,1385262416.928000,1441403826.387803,5017755480.325803,600053,129849,312251,1042153
2012-05-29,NSX (C),10783880,5006245,7194967,22985092,288436279.399900,198918703.530800,272182543.648201,759537526.578901,38538,11506,24198,74242
2012-05-29,NYSE (DN),83692315,18969541,41396943,144058799,2441327660.920598,868313370.463700,1203326686.296500,4512967717.680798,470458,57844,227070,755372
2012-05-29,NASDAQ (DQ),1028352493,305878495,508913240,1843144228,27521925703.441449,13376739091.608232,14955897495.717965,55854562290.767646,2887899,510279,1474688,4872866
2012-05-29,EDGA (J),100231825,45421549,49948375,195601749,2596174142.414900,2165980209.255401,1275080819.191998,6037235170.862299,606451,174500,301326,1082277
2012-05-29,EDGX (K),209715924,67462843,116838281,394017048,5884356676.904596,3102837374.075603,3274009935.171088,12261203986.151287,1110363,197786,566616,1874765
2012-05-29,CHX (M),14614479,8992998,4675462,28282939,307025405.253400,722733871.082000,157842470.449500,1187601746.784900,732,3504,546,4782
2012-05-29,NYSE (N),714346831,0,0,714346831,21432452522.473449,0.000000,0.000000,21432452522.473449,2266368,0,0,2266368
2012-05-29,NYSE Arca (P),331752417,233722640,197119809,762594866,9162257696.593463,12278451944.825105,6851656366.768693,28292366008.187261,1770265,560496,984180,3314941
2012-05-29,NASDAQ (Q),453897828,200073813,458157897,1112129538,13390546465.918687,12239125404.047493,14044441947.035324,39674113817.001504,2689334,665893,2018933,5374160
2012-05-29,CBSX (W),13521708,3084181,7134151,23740040,297623951.230000,161641978.220000,161883349.830000,621149279.280000,83050,12299,41545,136894
2012-05-29,NASDAQ PSX (X),26421968,24078994,28196234,78697196,544229076.930000,1476318935.480000,635247465.720000,2655795478.130000,119655,57759,97975,275389
2012-05-29,BATS BYX (Y),105108548,33100363,51323337,189532248,2478808261.620502,1507196715.305000,1270314445.528899,5256319422.454401,678181,137830,333585,1149596
2012-05-29,BATS BZX (Z),256941320,131297499,151060000,539298819,6899705177.530082,7325682279.135992,4209503086.051910,18434890542.717984,1590604,439664,904009,2934277
2012-05-25,NYSE MKT (A),0,7820546,2453935,10274481,0.000000,48796046.713200,32547859.550100,81343906.263300,0,19207,10280,29487
2012-05-25,NASDAQ BX (B),83281814,25473846,40102283,148857943,1963590302.601300,1107570237.481100,1337305408.528000,4408465948.610400,550807,106490,270188,927485
2012-05-25,NSX (C),8682768,4100657,5260596,18044021,222446587.273200,141664375.840900,172308724.501600,536419687.615700,31946,8332,17778,58056
2012-05-25,NYSE (DN),66174622,10435502,30330005,106940129,2018832987.804802,573249677.323300,1002896586.014301,3594979251.142403,385684,42003,173674,601361
2012-05-25,NASDAQ (DQ),878786313,225133566,386296624,1490216503,23765123297.729292,10481647760.184208,10429120415.342594,44675891473.256094,2421726,400178,1162830,3984734
2012-05-25,EDGA (J),86520438,33618974,38812856,158952268,2325645986.896299,1649303034.774901,1026945238.148101,5001894259.819301,547012,137550,247658,932220
2012-05-25,EDGX (K),170773174,48448312,92665021,311886507,4858516629.770302,2117084011.142199,2573688732.221399,9549289373.133900,930145,141717,465711,1537573
2012-05-25,CHX (M),7565029,9794829,3414309,20774167,205042275.741900,826933079.732500,120428933.589100,1152404289.063500,1704,2067,905,4676
2012-05-25,NYSE (N),595640238,0,0,595640238,18157565807.344073,0.000000,0.000000,18157565807.344073,1961537,0,0,1961537
2012-05-25,NYSE Arca (P),273049069,169794377,146751053,589594499,7732080893.597504,9132407680.037216,5515479705.209607,22379968278.844327,1525851,412479,758090,2696420
2012-05-25,NASDAQ (Q),373258146,148694647,348000204,869952997,11042027455.401026,8980461538.871401,10400060682.438380,30422549676.710807,2246260,509114,1554516,4309890
2012-05-25,CBSX (W),12949988,2818472,6034340,21802800,306899334.780000,140314078.140000,125154677.406800,572368090.326800,82082,10360,40681,133123
2012-05-25,NASDAQ PSX (X),22858802,17090996,22269055,62218853,472419746.415000,1061647135.840000,476322775.055000,2010389657.310000,110742,43960,79366,234068
2012-05-25,BATS BYX (Y),87263752,23189752,40431094,150884598,2088863922.644201,1042828416.972100,977688548.451998,4109380888.068299,577820,102726,263743,944289
2012-05-25,BATS BZX (Z),206793164,97711749,121934320,426439233,5701997221.975987,5806126568.914706,3541961101.152117,15050084892.042810,1318318,345948,729764,2394030
2012-05-24,NYSE MKT (A),0,9346310,3303570,12649880,0.000000,56237564.348800,45425334.437300,101662898.786100,0,21760,13510,35270
2012-05-24,NASDAQ BX (B),96610125,38576713,48946205,184133043,2348584815.752397,1545147879.191200,1626032211.648500,5519764906.592097,628989,153357,315218,1097564
2012-05-24,NSX (C),12207062,5434342,7371307,25012711,321615789.800400,211408157.545100,286742160.423600,819766107.769100,44687,11634,25698,82019
2012-05-24,NYSE (DN),78701307,17432703,41324439,137458449,2281634930.134798,836248933.212600,1255081954.695599,4372965818.042997,436597,55376,214951,706924
2012-05-24,NASDAQ (DQ),1197660907,315359618,509418305,2022438830,31840679129.787669,13803216965.965415,16938136892.549573,62582032988.302657,2997134,533825,1452388,4983347
2012-05-24,EDGA (J),116139239,51951407,55434302,223524948,3010302014.736199,2343945104.271801,1511048823.023998,6865295942.031998,707500,192707,343602,1243809
2012-05-24,EDGX (K),234454518,70690154,121530168,426674840,6646781425.140180,3131253081.059400,3623897089.297499,13401931595.497079,1239672,211877,616811,2068360
2012-05-24,CHX (M),15453952,12506904,5715161,33676017,329167272.950200,797374254.475500,198616234.780900,1325157762.206600,695,3349,783,4827
2012-05-24,NYSE (N),796671037,0,0,796671037,23902213254.494703,0.000000,0.000000,23902213254.494703,2517441,0,0,2517441
2012-05-24,NYSE Arca (P),391134967,237644083,212092264,840871314,11033315011.035076,11954474879.255790,7932010745.523624,30919800635.814490,2109507,618921,1069867,3798295
2012-05-24,NASDAQ (Q),551264723,227875125,486835175,1265975023,15524731693.428872,13125834710.791207,15650077682.966814,44300644087.186893,3141519,745280,2193487,6080286
2012-05-24,CBSX (W),10573529,5227246,5760589,21561364,257614675.170000,274335942.847000,142292591.380000,674243209.397000,55883,12562,30585,99030
2012-05-24,NASDAQ PSX (X),34463437,27665104,34492756,96621297,727470097.365000,1641434456.100000,838518433.648000,3207422987.113000,149771,64712,104719,319202
2012-05-24,BATS BYX (Y),117278809,36810296,53045056,207134161,2814699845.319999,1598407473.875000,1417796851.364599,5830904170.559598,775063,158506,339907,1273476
2012-05-24,BATS BZX (Z),291843451,146694464,173636258,612174173,7899350349.654285,7956703312.161704,5329606517.445525,21185660179.261514,1795052,502678,1010746,3308476
2012-05-23,NYSE MKT (A),0,10638130,3906241,14544371,0.000000,70291430.108100,55198011.390300,125489441.498400,0,28330,14438,42768
2012-05-23,NASDAQ BX (B),111585559,46817877,58681679,217085115,2689897887.676004,1947040257.010801,1886984154.327396,6523922299.014201,707887,197476,365600,1270963
2012-05-23,NSX (C),14074399,6530016,8391726,28996141,345976341.505900,250849475.631200,323520995.501499,920346812.638599,47748,15034,27567,90349
2012-05-23,NYSE (DN),87991599,25924634,47594766,161510999,2547691710.124301,1187818817.561700,1513439902.666500,5248950430.352501,469394,81616,234181,785191
2012-05-23,NASDAQ (DQ),1093864230,400436575,557296470,2051597275,27648931444.896860,17002824932.156958,16477062259.044036,61128818636.097854,3393577,713159,1626064,5732800
2012-05-23,EDGA (J),127867937,60659401,60653631,249180969,3223109855.740800,2968280813.857303,1552184969.940799,7743575639.538902,763408,235894,361729,1361031
2012-05-23,EDGX (K),260978699,98137453,138476193,497592345,7339061106.121206,4293098813.085703,4107245472.984390,15739405392.191299,1367788,282140,697064,2346992
2012-05-23,CHX (M),10463694,16954631,8911987,36330312,406364711.036900,1197478377.918500,252861481.515500,1856704570.470900,594,4893,888,6375
2012-05-23,NYSE (N),863015503,0,0,863015503,26236099446.188056,0.000000,0.000000,26236099446.188056,2798780,0,0,2798780
2012-05-23,NYSE Arca (P),436136444,298707806,250840134,985684384,12500237529.801010,15297126901.883693,9429907949.927348,37227272381.612051,2349394,778911,1248651,4376956
2012-05-23,NASDAQ (Q),599324940,290799014,523327653,1413451607,16775157795.416601,16661560233.850469,16057702106.483484,49494420135.750554,3404596,960911,2340270,6705777
2012-05-23,CBSX (W),10768222,3480309,5744629,19993160,256544065.480000,196699891.510000,126293405.900000,579537362.890000,57546,14418,30996,102960
2012-05-23,NASDAQ PSX (X),39108144,36779426,36807319,112694889,815811599.800000,2253383598.605000,801262651.240000,3870457849.645000,166259,80553,117734,364546
2012-05-23,BATS BYX (Y),135417389,43348036,62626602,241392027,3219482245.774996,1880524198.285000,1641448172.452995,6741454616.512991,891056,195906,399545,1486507
2012-05-23,BATS BZX (Z),319482328,190167669,187621650,697271647,8570304018.026720,10296487847.373101,5600972870.862892,24467764736.262713,1949258,664662,1087197,3701117
2012-05-22,NYSE MKT (A),0,9781149,3824109,13605258,0.000000,60611317.360800,50210431.920000,110821749.280800,0,25557,13475,39032
2012-05-22,NASDAQ BX (B),108108230,39931992,55625384,203665606,2571518946.271796,1623451551.165001,1927583161.926201,6122553659.362998,695851,152675,347472,1195998
2012-05-22,NSX (C),12486666,4868321,7761510,25116497,306417083.545700,190000852.674300,330487019.450899,826904955.670899,40870,12179,23072,76121
2012-05-22,NYSE (DN),87524142,21730176,42786614,152040932,2482418605.990703,1219405049.278500,1401834510.786299,5103658166.055502,467468,65135,215404,748007
2012-05-22,NASDAQ (DQ),1156537133,379516354,585467943,2121521430,28897521918.392005,18085808976.227142,18619439853.459111,65602770748.078258,3488046,628716,1671393,5788155
2012-05-22,EDGA (J),128351583,46437679,49887972,224677234,3119869230.351494,2254585275.650099,1289549123.558099,6664003629.559692,780203,170400,297998,1248601
2012-05-22,EDGX (K),264478471,82883155,133872445,481234071,7279796788.567607,3662766655.598796,4075736568.604493,15018300012.770896,1359318,239535,659842,2258695
2012-05-22,CHX (M),11228003,13873886,6213226,31315115,292467716.316600,1093211943.358400,182088804.010500,1567768463.685500,719,3235,703,4657
2012-05-22,NYSE (N),846967818,0,0,846967818,25207514400.437331,0.000000,0.000000,25207514400.437331,2738662,0,0,2738662
2012-05-22,NYSE Arca (P),438706692,255886749,225901401,920494842,12386316138.286399,13193463078.319387,8929108507.905393,34508887724.511179,2388135,605600,1123269,4117004
2012-05-22,NASDAQ (Q),589015295,231634428,486716779,1307366502,16434902951.411177,14150720943.241796,15604301975.084307,46189925869.737280,3364553,774170,2207883,6346606
2012-05-22,CBSX (W),11978852,4458522,4710706,21148080,253085131.230000,278551582.930600,117935704.225000,649572418.385600,62975,14022,24825,101822
2012-05-22,NASDAQ PSX (X),37645139,31138454,32053438,100837031,729540584.210000,2119448509.710000,706218500.115000,3555207594.035000,156492,69677,102619,328788
2012-05-22,BATS BYX (Y),123807477,35781052,61975299,221563828,2901147412.421800,1628616972.020000,1565269783.029500,6095034167.471300,807368,149537,387822,1344727
2012-05-22,BATS BZX (Z),304949126,157017719,171589749,633556594,8065114912.413368,8611218598.640786,5083689729.420798,21760023240.474952,1858061,511479,955237,3324777
2012-05-21,NYSE MKT (A),0,10108369,3062924,13171293,0.000000,71076985.291900,40292885.380000,111369870.671900,0,23118,12070,35188
2012-05-21,NASDAQ BX (B),99891850,34913052,53234536,188039438,2557993724.465492,1530701600.289600,1744958098.374101,5833653423.129193,641398,140532,351103,1133033
2012-05-21,NSX (C),11158619,4615184,7380433,23154236,320232551.905300,188809981.530800,333490966.669700,842533500.105800,43728,10477,25188,79393
2012-05-21,NYSE (DN),94742317,20575283,45396043,160713643,2779065260.624000,1034200272.309900,1445276971.643101,5258542504.577001,482937,71840,234769,789546
2012-05-21,NASDAQ (DQ),1100239970,348644701,569652820,2018537491,28527089657.440924,16224426724.730752,18116535945.961209,62868052328.132885,3421671,624526,1716460,5762657
2012-05-21,EDGA (J),113512768,43468335,55345599,212326702,2937854207.800501,2129599382.659300,1557871034.011397,6625324624.471198,707449,172202,342301,1221952
2012-05-21,EDGX (K),233781315,73054063,133637244,440472622,6552328140.588703,3264016887.612207,4191760902.817819,14008105931.018729,1210287,211958,662259,2084504
2012-05-21,CHX (M),8606186,9650800,5124957,23381943,284590690.198300,678003267.809000,216239362.489000,1178833320.496300,661,2531,759,3951
2012-05-21,NYSE (N),798097581,0,0,798097581,24163916193.279087,0.000000,0.000000,24163916193.279087,2460357,0,0,2460357
2012-05-21,NYSE Arca (P),385712716,255541903,230598571,871853190,11422986103.033183,13239438616.009804,8719571452.148415,33381996171.191402,2087079,570236,1123326,3780641
2012-05-21,NASDAQ (Q),512176112,217509431,504825400,1234510943,14770622434.513758,12736017652.041364,16282300852.906222,43788940939.461344,2908735,703726,2109525,5721986
2012-05-21,CBSX (W),13835682,4078153,7027819,24941654,330768556.950000,199345141.210000,158291446.200000,688405144.360000,78395,13720,40640,132755
2012-05-21,NASDAQ PSX (X),34268521,28175759,33120631,95564911,751754263.465000,1857763161.649999,744446254.653800,3353963679.768799,150083,61524,111975,323582
2012-05-21,BATS BYX (Y),109825984,31625076,57789674,199240734,2748541312.529996,1461790766.860000,1491748849.992197,5702080929.382193,740764,138555,388031,1267350
2012-05-21,BATS BZX (Z),270419290,146841171,172662063,589922524,7507937151.399491,8045616132.424202,5231540153.020882,20785093436.844575,1669782,498355,1002256,3170393
2012-05-18,NYSE MKT (A),0,14639374,3479330,18118704,0.000000,88157367.572700,46733373.957100,134890741.529800,0,27777,13086,40863
2012-05-18,NASDAQ BX (B),115438288,49261617,99752329,264452234,2857108231.071003,2120397082.398601,3640954880.630513,8618460194.100117,771200,194498,553981,1519679
2012-05-18,NSX (C),14364642,6731480,10347623,31443745,389888418.958200,250944010.911700,435068503.893000,1075900933.762900,49871,14153,31776,95800
2012-05-18,NYSE (DN),103085266,24389520,58167314,185642100,2886087782.234500,1285820233.719999,2012487108.598603,6184395124.553102,550540,85804,288297,924641
2012-05-18,NASDAQ (DQ),1169468922,478291858,694276720,2342037500,29338891501.031131,25771012571.127656,21367831852.428200,76477735924.586987,3795726,748952,2031769,6576447
2012-05-18,EDGA (J),132423704,58627668,78903461,269954833,3424237191.111097,3004074513.658402,2361644204.723900,8789955909.493399,809796,231136,424697,1465629
2012-05-18,EDGX (K),276849696,94584701,187420150,558854547,7714943125.019811,4234419199.490506,5850133662.691424,17799495987.201741,1443103,261823,845011,2549937
2012-05-18,CHX (M),13065063,23152543,4866546,41084152,342166803.134200,1660039038.645000,238915835.830000,2241121677.609200,616,4104,539,5259
2012-05-18,NYSE (N),1162102717,0,0,1162102717,36991345793.911653,0.000000,0.000000,36991345793.911653,2934953,0,0,2934953
2012-05-18,NYSE Arca (P),436334317,325087271,317868866,1079290454,12709314911.880883,17901209051.810023,12757983717.306246,43368507680.997152,2399107,755177,1404175,4558459
2012-05-18,NASDAQ (Q),562543966,285720372,869247785,1717512123,16135425020.944789,17160362865.516832,29461173637.184983,62756961523.646604,3279851,907405,2805392,6992648
2012-05-18,CBSX (W),15802894,4914146,8930468,29647508,352194636.810000,285451842.930000,219013241.127100,856659720.867100,79747,17145,39032,135924
2012-05-18,NASDAQ PSX (X),37017796,45004117,47859564,129881477,796051644.170000,3108702235.830001,1344083194.695000,5248837074.695001,169624,87874,159384,416882
2012-05-18,BATS BYX (Y),134926630,44700120,87367263,266994013,3296814836.745002,2142450288.750000,2411469030.695892,7850734156.190894,894764,182604,499412,1576780
2012-05-18,BATS BZX (Z),336421633,210540443,242226938,789189014,9156171669.751931,12034558930.847975,7967927683.991351,29158658284.591257,2086406,668881,1275368,4030655
2012-05-17,NYSE MKT (A),0,13525144,3087975,16613119,0.000000,85051458.929300,42826895.090000,127878354.019300,0,31482,11720,43202
2012-05-17,NASDAQ BX (B),127358539,46735708,64015719,238109966,3185786057.669900,2015237618.190099,2176989112.725892,7378012788.585891,831342,184549,387343,1403234
2012-05-17,NSX (C),17028352,7559998,9690129,34278479,441397772.419300,281873672.520500,367378705.176000,1090650150.115800,57747,17087,29090,103924
2012-05-17,NYSE (DN),107956610,25639924,51610930,185207464,3044039313.425097,1276067072.077501,1639460238.575902,5959566624.078500,582876,79804,255716,918396
2012-05-17,NASDAQ (DQ),1297228093,446478240,617300712,2361007045,32835989347.867903,20954520271.584106,17258490967.185596,71049000586.637605,4094337,757801,1726365,6578503
2012-05-17,EDGA (J),138037745,57639029,62974697,258651471,3549386170.661295,2924012552.062101,1639325026.968297,8112723749.691693,832192,214574,363794,1410560
2012-05-17,EDGX (K),298251998,104897784,142498918,545648700,8162979556.575203,4813727261.945210,4127828467.350278,17104535285.870691,1516219,300362,691087,2507668
2012-05-17,CHX (M),14118697,21834482,6173531,42126710,415861348.634400,1535944138.346000,283353498.777400,2235158985.757800,928,5282,279,6489
2012-05-17,NYSE (N),945137422,0,0,945137422,27980329195.406000,0.000000,0.000000,27980329195.406000,3137985,0,0,3137985
2012-05-17,NYSE Arca (P),481029345,332961347,243283528,1057274220,13716758411.247625,16820935385.808844,9426235025.412590,39963928822.469059,2559779,737225,1176266,4473270
2012-05-17,NASDAQ (Q),676337431,303953807,530250166,1510541404,19472721826.553795,17567854837.328715,15931648557.116772,52972225220.999282,3896953,977991,2384371,7259315
2012-05-17,CBSX (W),14241566,3841432,5307919,23390917,340364108.410000,202874531.370000,113708435.615500,656947075.395500,79792,15162,31006,125960
2012-05-17,NASDAQ PSX (X),39239713,43416202,33116597,115772512,786069036.760000,2970820999.305001,682718004.965000,4439608041.030001,168884,90575,99697,359156
2012-05-17,BATS BYX (Y),143525145,46003364,66792211,256320720,3453692897.924496,2134251262.760000,1655232567.949397,7243176728.633893,950840,188903,413703,1553446
2012-05-17,BATS BZX (Z),365673172,210911940,198685155,775270267,10002565715.363608,11830568245.196816,5823839027.577283,27656972988.137707,2282723,710996,1094746,4088465
2012-05-16,NYSE MKT (A),0,13838310,3503562,17341872,0.000000,77899263.379500,40104431.190000,118003694.569500,0,31115,11525,42640
2012-05-16,NASDAQ BX (B),120666244,41318531,55668922,217653697,2916546839.886799,1764228357.445401,1827349828.296696,6508125025.628896,785922,165409,365780,1317111
2012-05-16,NSX (C),14827627,5799736,8686326,29313689,384421317.318900,200112024.900600,366099648.324200,950632990.543700,51778,14247,27855,93880
2012-05-16,NYSE (DN),95728519,20156830,46691468,162576817,2693435470.111300,1038457830.050400,1533914096.501901,5265807396.663601,526498,71715,242338,840551
2012-05-16,NASDAQ (DQ),1201894643,389209221,612478379,2203582243,29649892586.049110,17510804783.710078,17575356190.501402,64736053560.260590,3662111,656247,1680498,5998856
2012-05-16,EDGA (J),125601804,52139466,56463712,234204982,3187741625.433399,2423988419.825300,1493711888.899297,7105441934.157996,743509,197527,333607,1274643
2012-05-16,EDGX (K),262014374,87952266,130666492,480633132,7151628583.896898,3685217390.859901,3881261725.454674,14718107700.211473,1300456,244835,663207,2208498
2012-05-16,CHX (M),14675330,18968439,4756043,38399812,403003724.222000,1386812858.246600,183826726.466500,1973643308.935100,627,5337,715,6679
2012-05-16,NYSE (N),872492874,0,0,872492874,25915158369.997890,0.000000,0.000000,25915158369.997890,2827970,0,0,2827970
2012-05-16,NYSE Arca (P),445239971,288730998,237377501,971348470,12734266331.505611,14706224273.541501,8996674168.260561,36437164773.307673,2389544,669204,1166368,4225116
2012-05-16,NASDAQ (Q),634035838,259823324,503750914,1397610076,18182417901.082688,15277298996.102105,15368386940.919647,48828103838.104440,3608978,860917,2311329,6781224
2012-05-16,CBSX (W),10563632,3226926,5529278,19319836,250948954.250000,175963073.100000,106177243.900000,533089271.250000,58577,12346,28490,99413
2012-05-16,NASDAQ PSX (X),36876662,34673820,30559592,102110074,745349179.865000,2215559807.880001,674899291.580400,3635808279.325401,152891,73918,99061,325870
2012-05-16,BATS BYX (Y),132900972,39742932,62213222,234857126,3225473136.910699,1769391847.019600,1555728828.360598,6550593812.290897,872729,165779,396540,1435048
2012-05-16,BATS BZX (Z),313515978,187152683,179434995,680103656,8512539384.412785,10409991808.430275,5401878039.044808,24324409231.887868,1926624,618136,1024822,3569582
2012-05-15,NYSE MKT (A),0,12510318,3492535,16002853,0.000000,82527399.799000,50336109.320000,132863509.119000,0,28144,12934,41078
2012-05-15,NASDAQ BX (B),114440747,41045933,57085238,212571918,2721782091.038498,1828970057.680002,1959610664.255295,6510362812.973795,742205,168713,363269,1274187
2012-05-15,NSX (C),14224797,5439746,8303448,27967991,362274174.982800,200376177.724500,317146235.743801,879796588.451101,49302,12561,26900,88763
2012-05-15,NYSE (DN),88087106,19765843,44593109,152446058,2582796164.587300,894266258.918200,1274533098.663398,4751595522.168898,492385,67293,220901,780579
2012-05-15,NASDAQ (DQ),1159347907,395413754,578041040,2132802701,28783276474.174143,18200328610.867601,14479591784.670924,61463196869.712668,3540761,624945,1556494,5722200
2012-05-15,EDGA (J),118673318,49473603,55646324,223793245,3067205773.647299,2275245963.594499,1463274805.957098,6805726543.198896,708956,175427,324690,1209073
2012-05-15,EDGX (K),258354336,83933239,135293237,477580812,7101545420.934084,3686134436.017402,3760821294.032226,14548501150.983712,1307437,238248,675953,2221638
2012-05-15,CHX (M),15276885,10706015,4898721,30881621,418759770.307200,791219171.103700,207462616.219000,1417441557.629900,659,3323,633,4615
2012-05-15,NYSE (N),868731771,0,0,868731771,26331328063.455698,0.000000,0.000000,26331328063.455698,2702027,0,0,2702027
2012-05-15,NYSE Arca (P),432514219,254585374,220025095,907124688,12126034262.801977,13442045976.448786,7948690364.453308,33516770603.704071,2252820,618548,1055952,3927320
2012-05-15,NASDAQ (Q),575211826,234787126,465444485,1275443437,16756994879.345362,14175515361.291494,14322671652.169704,45255181892.806560,3271769,758143,2035734,6065646
2012-05-15,CBSX (W),14285939,2797101,5421857,22504897,353231594.350000,126707131.140000,113458333.602000,593397059.092000,70333,11732,32964,115029
2012-05-15,NASDAQ PSX (X),31943657,30182283,31903861,94029801,663830929.890000,2040597538.650000,709912652.875000,3414341121.415000,135448,62518,89259,287225
2012-05-15,BATS BYX (Y),123375186,38782796,57571082,219729064,3015467650.047902,1705738087.490001,1398557428.093997,6119763165.631900,805374,156988,352352,1314714
2012-05-15,BATS BZX (Z),298937782,162228072,174489024,635654878,8207632630.093112,9636772635.728307,5012635392.206194,22857040658.027613,1809766,536869,969304,3315939
2012-05-14,NYSE MKT (A),0,11634137,3285205,14919342,0.000000,75053051.364300,48343000.540000,123396051.904300,0,26859,12209,39068
2012-05-14,NASDAQ BX (B),102497444,36339498,53770622,192607564,2548795278.397197,1485534585.967500,1592222856.592496,5626552720.957193,656384,137084,331913,1125381
2012-05-14,NSX (C),12254218,5065756,7499666,24819640,319392702.367400,182669233.664000,226870379.138500,728932315.169900,42395,12141,23043,77579
2012-05-14,NYSE (DN),79689095,17823298,41969616,139482009,2391893857.160699,834928897.531700,1183894167.549300,4410716922.241699,451486,60212,207668,719366
2012-05-14,NASDAQ (DQ),1110073051,378052713,520143687,2008269451,30515542351.798131,17346754248.177020,13035611083.879083,60897907683.854234,3252536,599857,1492725,5345118
2012-05-14,EDGA (J),103475825,42344594,51284151,197104570,2801324264.987895,2036464591.622900,1294823401.724901,6132612258.335696,637944,158036,304630,1100610
2012-05-14,EDGX (K),215048805,76014167,120283368,411346340,6184188127.198301,3260725004.748098,3302773514.302182,12747686646.248581,1106151,213384,602133,1921668
2012-05-14,CHX (M),10830715,11526768,3539871,25897354,292089286.233700,853951527.602200,147948222.735600,1293989036.571500,2565,3014,797,6376
2012-05-14,NYSE (N),803055151,0,0,803055151,24593488802.122822,0.000000,0.000000,24593488802.122822,2404568,0,0,2404568
2012-05-14,NYSE Arca (P),355269715,246915896,198721397,800907008,10339760394.630640,12650484260.245533,6643783081.155269,29634027736.031442,1869774,560213,932214,3362201
2012-05-14,NASDAQ (Q),489828902,206111005,449607591,1145547498,14601653527.161348,12046200691.715948,12819288936.406340,39467143155.283636,2804364,667169,1895108,5366641
2012-05-14,CBSX (W),11967008,3445182,5023487,20435677,304767886.570000,182486963.190000,107847777.691000,595102627.451000,69927,12584,30085,112596
2012-05-14,NASDAQ PSX (X),29420320,26418317,28260427,84099064,622128881.720000,1773909753.675000,606344184.085000,3002382819.480000,126488,58834,83908,269230
2012-05-14,BATS BYX (Y),116097782,33463283,54079539,203640604,2822313582.944998,1457528151.505000,1212465801.435401,5492307535.885399,768374,136123,331221,1235718
2012-05-14,BATS BZX (Z),248661384,137198334,155522883,541382601,6972951121.251393,7685570848.471991,4244269514.863691,18902791484.587075,1529968,456454,857594,2844016
2012-05-11,NYSE MKT (A),0,10451861,3029390,13481251,0.000000,65969902.953500,37095840.340000,103065743.293500,0,23516,10505,34021
2012-05-11,NASDAQ BX (B),102732699,30299693,53342299,186374691,2520562229.523199,1293217713.766600,1671473789.948096,5485253733.237895,642774,125448,337722,1105944
2012-05-11,NSX (C),12813820,4335725,8877759,26027304,352943900.619800,153903771.472100,252434166.541200,759281838.633100,46423,10511,27775,84709
2012-05-11,NYSE (DN),85223355,15801568,41807657,142832580,2431593516.790700,797748093.188100,1364806026.442198,4594147636.420998,428454,46112,208514,683080
2012-05-11,NASDAQ (DQ),1162461251,282384767,553236881,1998082899,31121665938.463456,12367032132.706442,14498782949.296454,57987481020.466352,3100660,465346,1539238,5105244
2012-05-11,EDGA (J),108076839,35079648,53091555,196248042,2837485873.022599,1779014332.287999,1410648795.936599,6027149001.247197,633108,133693,325350,1092151
2012-05-11,EDGX (K),236728953,56910657,129061151,422700761,6666728253.823483,2483317004.215400,3684776760.083983,12834822018.122866,1140705,156468,635854,1933027
2012-05-11,CHX (M),10214857,12077339,4846630,27138826,311211200.831400,792931785.413800,215729461.870600,1319872448.115800,760,3232,605,4597
2012-05-11,NYSE (N),785740479,0,0,785740479,23976841248.711333,0.000000,0.000000,23976841248.711333,2374731,0,0,2374731
2012-05-11,NYSE Arca (P),393540070,208621995,204883353,807045418,11019395220.242702,11231401059.901600,7525678251.151114,29776474531.295416,1911903,482775,977916,3372594
2012-05-11,NASDAQ (Q),536931532,171628368,443916693,1152476593,15650302981.519562,10702028899.265626,13295308681.892000,39647640562.677188,2918815,567975,1979670,5466460
2012-05-11,CBSX (W),10218721,2366874,4115306,16700901,249749381.150000,144698340.140000,82991429.850000,477439151.140000,53356,8628,24165,86149
2012-05-11,NASDAQ PSX (X),32749119,23783289,26418388,82950796,671324351.825000,1540288626.795000,600509803.795000,2812122782.415000,133142,52001,88735,273878
2012-05-11,BATS BYX (Y),116799381,30365570,54499414,201664365,2776567985.417702,1349270413.630900,1284991944.784398,5410830343.833000,750886,123827,342562,1217275
2012-05-11,BATS BZX (Z),276135614,124332286,161834042,562301942,7487374326.913082,7232797213.904505,4869378947.452929,19589550488.270516,1610529,424535,930009,2965073
2012-05-10,NYSE MKT (A),0,8625552,3020598,11646150,0.000000,63755506.531000,43344706.910000,107100213.441000,0,23106,11666,34772
2012-05-10,NASDAQ BX (B),94456153,27618596,63397050,185471799,2481658048.114302,1227678678.788400,1835469881.735499,5544806608.638201,634469,118646,363952,1117067
2012-05-10,NSX (C),12733051,4721114,8122733,25576898,330652901.908600,200760885.240600,284624314.760200,816038101.909400,45865,9924,27543,83332
2012-05-10,NYSE (DN),77463477,12356841,52729955,142550273,2470080858.388202,636988949.958800,1418011642.448001,4525081450.795003,437876,47287,232361,717524
2012-05-10,NASDAQ (DQ),1077337932,272566950,642292681,1992197563,30368454893.068331,12303547698.553510,16648946633.611929,59320949225.233770,3068523,457972,1681026,5207521
2012-05-10,EDGA (J),106989529,36038261,62447600,205475390,2895197172.614702,1835588809.706801,1554349834.448295,6285135816.769798,675982,144238,353812,1174032
2012-05-10,EDGX (K),225085159,62445542,141768070,429298771,6545304184.201605,2662242711.730600,3898081789.560805,13105628685.493010,1163159,183893,702214,2049266
2012-05-10,CHX (M),14201590,14566340,5701465,34469395,403974499.124900,834068829.396000,165773224.256800,1403816552.777700,861,2595,560,4016
2012-05-10,NYSE (N),784064356,0,0,784064356,24206416418.434332,0.000000,0.000000,24206416418.434332,2565307,0,0,2565307
2012-05-10,NYSE Arca (P),391761637,211098172,241239558,844099367,11295658430.140311,11058298550.858299,7886874740.875848,30240831721.874458,2021586,497827,1070271,3589684
2012-05-10,NASDAQ (Q),536934130,186680704,511994446,1235609280,15972956519.929429,11191739827.582187,14653641313.145643,41818337660.657259,3097275,608952,2230040,5936267
2012-05-10,CBSX (W),9945283,2252389,5580841,17778513,241349399.190000,133583271.870000,106161575.050000,481094246.110000,56808,8672,28331,93811
2012-05-10,NASDAQ PSX (X),32321593,24321935,33267178,89910706,663351205.630000,1712082311.560000,726899801.545000,3102333318.735000,139912,51156,101401,292469
2012-05-10,BATS BYX (Y),107395751,29682035,63127731,200205517,2757229353.379703,1364219137.505000,1441849185.347299,5563297676.232002,723900,121492,363292,1208684
2012-05-10,BATS BZX (Z),265527079,131721551,193749124,590997754,7399442714.056195,7898521046.308103,5290803556.593482,20588767316.957780,1653703,449041,1038969,3141713
2012-05-09,NYSE MKT (A),0,11379481,2916373,14295854,0.000000,78434531.288600,40286517.700000,118721048.988600,0,28641,10638,39279
2012-05-09,NASDAQ BX (B),117689703,46100547,66445388,230235638,2964625197.952204,2015386956.625099,1944614601.864998,6924626756.442301,764519,182449,392289,1339257
2012-05-09,NSX (C),15851507,7278319,9521044,32650870,412264202.856700,297870193.304600,358578864.417100,1068713260.578400,56576,14610,29420,100606
2012-05-09,NYSE (DN),95955677,16608513,43912561,156476751,2826827685.453602,887480752.642200,1389997147.286600,5104305585.382402,498438,54384,219664,772486
2012-05-09,NASDAQ (DQ),1128376930,382991254,625659306,2137027490,29543671037.594383,17112649241.470863,16804977612.808782,63461297891.874028,3523248,638411,1671648,5833307
2012-05-09,EDGA (J),115911480,50699455,55159964,221770899,3033513546.525096,2589643388.134100,1426191106.133500,7049348040.792696,721479,179815,316319,1217613
2012-05-09,EDGX (K),265023139,98645705,149268473,512937317,7704638674.465917,4231511334.833704,4228012944.136601,16164162953.436222,1384924,263752,744169,2392845
2012-05-09,CHX (M),10843076,12411149,8795785,32050010,316199854.255200,1030573984.346400,297869789.089100,1644643627.690700,923,4844,650,6417
2012-05-09,NYSE (N),940147081,0,0,940147081,29066731113.714212,0.000000,0.000000,29066731113.714212,3099750,0,0,3099750
2012-05-09,NYSE Arca (P),449914324,309709371,264338595,1023962290,13222681106.181086,16237277458.126712,9357987973.045650,38817946537.353448,2434761,699107,1186004,4319872
2012-05-09,NASDAQ (Q),657325813,286361169,537106681,1480793663,19612480493.574740,17605330326.569213,16268737751.747720,53486548571.891673,3877357,914601,2437445,7229403
2012-05-09,CBSX (W),7663553,2361178,4170855,14195586,177108329.730000,97911477.550000,107492125.830000,382511933.110000,43043,6504,20336,69883
2012-05-09,NASDAQ PSX (X),39720538,36377294,36831789,112929621,836895433.060000,2197904525.310000,814531549.209999,3849331507.579999,164170,80466,109848,354484
2012-05-09,BATS BYX (Y),125936955,42746707,66915277,235598939,3170479157.440002,1921025096.901200,1488452505.621099,6579956759.962301,843753,170399,383423,1397575
2012-05-09,BATS BZX (Z),328784291,200108971,209405183,738298445,9175364735.348381,11737365106.564043,5754094495.390825,26666824337.303249,2060029,639649,1086894,3786572
2012-05-08,NYSE MKT (A),0,11936629,3682745,15619374,0.000000,80718011.875700,68959078.930000,149677090.805700,0,27030,12744,39774
2012-05-08,NASDAQ BX (B),113558743,44912647,71664090,230135480,2932866524.340002,1929660495.846997,2101316729.872704,6963843750.059703,769653,172287,422428,1364368
2012-05-08,NSX (C),15270956,6210089,10600461,32081506,403028119.616000,238352847.833100,354326900.625199,995707868.074299,53854,14074,32859,100787
2012-05-08,NYSE (DN),100467893,18361038,53895431,172724362,3042893649.753500,1032300566.258801,1645909014.608894,5721103230.621195,566504,64085,267576,898165
2012-05-08,NASDAQ (DQ),1230929642,394916616,685735124,2311581382,33596969218.946659,17811431416.007390,19178497480.466480,70586898115.420529,3855957,665240,1931709,6452906
2012-05-08,EDGA (J),113305819,47365406,59895590,220566815,3050229601.664902,2354343384.623999,1541324909.220492,6945897895.509393,717352,172937,349370,1239659
2012-05-08,EDGX (K),259694853,94869598,158554983,513119434,7642348164.620088,4312645304.915691,4533074743.909956,16488068213.445735,1358998,264886,776004,2399888
2012-05-08,CHX (M),9562583,14841665,5843483,30247731,340925248.918600,1086280569.151900,258621319.299000,1685827137.369500,712,4695,790,6197
2012-05-08,NYSE (N),902479457,0,0,902479457,28651008305.009706,0.000000,0.000000,28651008305.009706,2934312,0,0,2934312
2012-05-08,NYSE Arca (P),421568599,272907621,256521368,950997588,12933451578.112128,14295209453.987246,9160837440.473127,36389498472.572501,2297956,615217,1189970,4103143
2012-05-08,NASDAQ (Q),603185279,251891019,553810348,1408886646,18508800469.448756,15804423376.769845,16753091477.750847,51066315323.969448,3515624,782947,2511926,6810497
2012-05-08,CBSX (W),10981658,3456535,5863359,20301552,250499960.100000,153695180.870000,112531784.288600,516726925.258600,62400,11207,30768,104375
2012-05-08,NASDAQ PSX (X),38505154,36167039,42221243,116893436,817015990.925000,2705352971.140001,909739992.249999,4432108954.315000,172998,71654,126953,371605
2012-05-08,BATS BYX (Y),124018126,40180682,69401088,233599896,3131675467.934403,1776128608.049995,1648001544.892200,6555805620.876598,829843,152435,412138,1394416
2012-05-08,BATS BZX (Z),317756479,173226053,210794350,701776882,9066773815.091353,10138154959.656597,6004135704.867435,25209064479.615385,1998106,561837,1143784,3703727
2012-05-07,NYSE MKT (A),0,9867703,2545875,12413578,0.000000,71616196.492500,42767818.740000,114384015.232500,0,23682,10507,34189
2012-05-07,NASDAQ BX (B),100677063,31981744,59127721,191786528,2546541477.920000,1333185383.415999,1705617961.720000,5585344823.055999,672201,121047,348030,1141278
2012-05-07,NSX (C),11232589,4422957,7217014,22872560,331071483.848000,166461089.612000,280632735.677800,778165309.137800,40763,8119,23830,72712
2012-05-07,NYSE (DN),80166161,14565044,41691142,136422347,2438930397.997299,776940637.797300,1311455733.511402,4527326769.306001,441176,48696,210832,700704
2012-05-07,NASDAQ (DQ),1005335410,300924295,552238459,1858498164,26886002401.019960,13240873024.621870,15936733873.782072,56063609299.423902,3205368,494557,1575434,5275359
2012-05-07,EDGA (J),99925494,34357054,52613600,186896148,2751252462.886994,1576991041.037500,1402760131.929897,5731003635.854391,635357,125604,303610,1064571
2012-05-07,EDGX (K),217512521,57983256,122150850,397646627,6435402651.679102,2384584400.209297,3842901421.047846,12662888472.936245,1143995,160602,634089,1938686
2012-05-07,CHX (M),10506881,5169585,3533259,19209725,303716844.892500,352080585.061000,205189929.705800,860987359.659300,1766,2114,639,4519
2012-05-07,NYSE (N),754300867,0,0,754300867,23551190124.396695,0.000000,0.000000,23551190124.396695,2357819,0,0,2357819
2012-05-07,NYSE Arca (P),370881917,195618563,203162166,769662646,11311458330.223945,9957159502.512429,7404796269.745910,28673414102.482284,1871457,430071,967175,3268703
2012-05-07,NASDAQ (Q),492729461,171436763,446942380,1111108604,15201781732.391394,10170909813.288412,13966938683.355335,39339630229.035141,2832686,546757,2014986,5394429
2012-05-07,CBSX (W),11234796,3082033,6164176,20481005,274270397.850000,135472841.710000,117874498.310000,527617737.870000,65712,8664,32477,106853
2012-05-07,NASDAQ PSX (X),35819155,24364125,29639918,89823198,773698082.965000,1511587952.060000,665403631.320001,2950689666.345001,144180,46416,94226,284822
2012-05-07,BATS BYX (Y),101744814,28930839,61636936,192312589,2565558594.900004,1258970061.555000,1338342664.724901,5162871321.179905,677929,114126,326540,1118595
2012-05-07,BATS BZX (Z),263910271,119991708,163190913,547092892,7498696119.029875,6496593216.447199,4755968638.843713,18751257974.320787,1641656,391878,908423,2941957
2012-05-04,NYSE MKT (A),0,10267972,2541709,12809681,0.000000,70928396.582400,32671033.290000,103599429.872400,0,23582,9224,32806
2012-05-04,NASDAQ BX (B),116182686,41069193,63332581,220584460,2881843403.469200,1823203500.895001,2230042945.607695,6935089849.971896,767708,144268,389131,1301107
2012-05-04,NSX (C),14616434,5460354,8652571,28729359,401599222.965300,237583181.262700,299316038.549502,938498442.777502,56415,10826,29125,96366
2012-05-04,NYSE (DN),108991319,20875898,48863564,178730781,3388661780.077193,1066344275.105400,1514257151.129300,5969263206.311893,587235,66126,255172,908533
2012-05-04,NASDAQ (DQ),1158613763,354163999,619954443,2132732205,30193278589.410419,17841591916.609142,17944215845.163258,65979086351.182819,3623921,576532,1739462,5939915
2012-05-04,EDGA (J),110169284,39485449,57829563,207484296,2948148702.559004,2049343421.524598,1576477367.017001,6573969491.100603,687239,148345,332539,1168123
2012-05-04,EDGX (K),249511425,71850395,145386717,466748537,7324848661.977607,3204953200.656102,4514992709.659728,15044794572.293437,1261502,198090,714210,2173802
2012-05-04,CHX (M),14298301,10715652,8076659,33090612,433575494.697700,908892463.100000,307839243.792500,1650307201.590200,1835,3766,645,6246
2012-05-04,NYSE (N),825458382,0,0,825458382,25641246505.586771,0.000000,0.000000,25641246505.586771,2622450,0,0,2622450
2012-05-04,NYSE Arca (P),386022358,229088463,219849401,834960222,11735323303.734585,12641644445.559385,8444089272.705318,32821057021.999288,2070016,528591,1064138,3662745
2012-05-04,NASDAQ (Q),538112335,218391960,492129224,1248633519,16386895475.739647,14194378308.643254,14977141424.699062,45558415209.081963,3113228,661892,2194210,5969330
2012-05-04,CBSX (W),11883439,3629596,5232935,20745970,289962042.890000,159629039.120000,115707683.870000,565298765.880000,68033,11110,32541,111684
2012-05-04,NASDAQ PSX (X),33950181,29825313,32030414,95805908,714585848.270000,2301273543.829999,744616506.469999,3760475898.569998,163593,58919,108861,331373
2012-05-04,BATS BYX (Y),117420953,34088023,61299689,212808665,2930461308.080002,1635100784.527598,1564200692.767698,6129762785.375298,782989,127565,366027,1276581
2012-05-04,BATS BZX (Z),286046287,144727664,189576767,620350718,7959708805.003421,8572581295.821196,5782474115.743858,22314764216.568475,1736791,462765,1036524,3236080
2012-05-03,NYSE MKT (A),0,11679983,2527150,14207133,0.000000,78062135.802800,33652074.467400,111714210.270200,0,26489,9988,36477
2012-05-03,NASDAQ BX (B),109433057,32772759,54459070,196664886,2824822515.170001,1407395790.288498,1761917757.588899,5994136063.047398,723848,120738,365644,1210230
2012-05-03,NSX (C),14850119,4844479,9863014,29557612,405344116.107300,155246488.975000,269440334.338001,830030939.420301,51825,10861,31205,93891
2012-05-03,NYSE (DN),102446533,14735793,45860529,163042855,3286621304.799801,739211667.459400,1367988344.511002,5393821316.770203,548810,46271,244199,839280
2012-05-03,NASDAQ (DQ),1200378397,303486631,590332066,2094197094,32388922338.635029,14101009422.579808,16141619702.907873,62631551464.122710,3705142,497907,1773426,5976475
2012-05-03,EDGA (J),102651789,34088031,49614738,186354558,2829192075.129592,1676450076.045002,1318894515.438795,5824536666.613389,640790,119618,306624,1067032
2012-05-03,EDGX (K),252200223,64074057,146522185,462796465,7438806781.551092,2721155980.546202,4167450511.646423,14327413273.743717,1232375,180078,721632,2134085
2012-05-03,CHX (M),11720776,8856651,5144989,25722416,405281957.328200,642541821.810900,253820441.393000,1301644220.532100,1032,3317,891,5240
2012-05-03,NYSE (N),844168916,0,0,844168916,26759698097.875837,0.000000,0.000000,26759698097.875837,2621224,0,0,2621224
2012-05-03,NYSE Arca (P),384482277,206962671,217524574,808969522,11866553174.485594,11136553640.503172,7405088159.166863,30408194974.155629,2048262,458611,1053418,3560291
2012-05-03,NASDAQ (Q),542399344,186713660,496173374,1225286378,17080368073.779818,12081157220.321761,14649061482.322451,43810586776.424030,3192529,606148,2222977,6021654
2012-05-03,CBSX (W),11066421,3416321,5949888,20432630,274652986.320000,146495185.510000,120050697.436800,541198869.266800,63094,8315,33771,105180
2012-05-03,NASDAQ PSX (X),31504603,22697308,26936514,81138425,680983886.555000,1610481767.555000,623551973.119800,2915017627.229800,146015,48213,97370,291598
2012-05-03,BATS BYX (Y),114429846,28569920,51764755,194764521,2930305942.260002,1352035676.550001,1304574467.507995,5586916086.317998,759377,114138,339347,1212862
2012-05-03,BATS BZX (Z),275960582,124320995,178995895,579277472,8127784253.485378,7080121045.542093,5077932894.199069,20285838193.226540,1731969,423441,1020295,3175705
2012-05-02,NYSE MKT (A),0,9597792,2408498,12006290,0.000000,66031221.787600,29120656.670000,95151878.457600,0,20571,8410,28981
2012-05-02,NASDAQ BX (B),106457216,30829611,55961792,193248619,2788239625.081898,1314043549.204501,1656423940.161903,5758707114.448302,704839,112437,356176,1173452
2012-05-02,NSX (C),14520818,3866322,8152158,26539298,406169718.766000,149500640.257900,248016026.165502,803686385.189402,50554,8833,25623,85010
2012-05-02,NYSE (DN),102720691,14451955,50223939,167396585,3188465075.755801,716702674.621600,1422557568.844700,5327725319.222101,543029,45324,237575,825928
2012-05-02,NASDAQ (DQ),1137361493,270362667,603820589,2011544749,30694916375.680704,12304628208.786373,17352439072.806782,60351983657.273859,3575674,460082,1641678,5677434
2012-05-02,EDGA (J),100404065,30770704,50900619,182075388,2732024591.167502,1465607770.889000,1367592086.220099,5565224448.276601,625906,109641,302899,1038446
2012-05-02,EDGX (K),246797406,52867267,133030819,432695492,7343622453.786274,2166522706.785097,3826982061.515397,13337127222.086768,1214855,145126,656647,2016628
2012-05-02,CHX (M),10016932,10901975,5375182,26294089,291469976.503300,768129142.928000,263855033.248500,1323454152.679800,718,2447,639,3804
2012-05-02,NYSE (N),780191974,0,0,780191974,24662385601.724888,0.000000,0.000000,24662385601.724888,2437964,0,0,2437964
2012-05-02,NYSE Arca (P),375273797,192326044,219766731,787366572,11202879342.347197,10304610644.756423,7422705079.864340,28930195066.967960,1936028,418670,970158,3324856
2012-05-02,NASDAQ (Q),506856029,157956333,461238233,1126050595,15429142364.082845,9679328857.312317,13317569629.217705,38426040850.612867,2920477,505499,2000706,5426682
2012-05-02,CBSX (W),9169988,3693286,5259813,18123087,226384935.260000,138166319.180000,101521700.575800,466072955.015800,55441,6791,26842,89074
2012-05-02,NASDAQ PSX (X),32455059,21526657,31149756,85131472,699034859.935000,1487715256.255000,634879340.950000,2821629457.140000,152935,43766,97917,294618
2012-05-02,BATS BYX (Y),116040238,26665245,54906504,197611987,2959351240.365003,1155257615.183001,1311384126.000203,5425992981.548207,776126,103196,336242,1215564
2012-05-02,BATS BZX (Z),268727483,105897973,176105442,550730898,7705599294.849003,6004670027.383709,4773011870.746279,18483281192.978991,1676250,364368,948891,2989509
2012-05-01,NYSE MKT (A),0,10643682,2285268,12928950,0.000000,70020250.183800,35273712.190000,105293962.373800,0,23353,11561,34914
2012-05-01,NASDAQ BX (B),106251903,33808806,58090357,198151066,2762524441.158498,1553004780.103398,1887731874.890594,6203261096.152490,702369,121418,363521,1187308
2012-05-01,NSX (C),15081429,4653471,8076394,27811294,410223614.487500,168239797.897400,335208006.096499,913671418.481399,50791,9340,26123,86254
2012-05-01,NYSE (DN),90247086,14728916,49944627,154920629,2880741837.119294,814109331.030900,1586713864.393896,5281565032.544090,488881,46907,245320,781108
2012-05-01,NASDAQ (DQ),1177039609,348883934,622942267,2148865810,32843709590.432547,17760658805.433111,19778244610.390724,70382613006.256382,3680650,524765,1769220,5974635
2012-05-01,EDGA (J),104352383,31581916,50709877,186644176,2802137882.542402,1542887055.720000,1396306531.789195,5741331470.051597,639907,103530,302372,1045809
2012-05-01,EDGX (K),243015630,59372942,131213875,433602447,7242885698.900522,2667586660.612294,4080729144.848126,13991201504.360942,1191268,152685,664193,2008146
2012-05-01,CHX (M),12622398,8503261,4700303,25825962,366605643.804000,772200916.893200,263759060.502000,1402565621.199200,793,3244,746,4783
2012-05-01,NYSE (N),771656358,0,0,771656358,25258784905.616096,0.000000,0.000000,25258784905.616096,2434398,0,0,2434398
2012-05-01,NYSE Arca (P),358506796,202511610,204673285,765691691,10977786378.485434,10596046998.377599,7992767781.690366,29566601158.553399,1872864,421151,963259,3257274
2012-05-01,NASDAQ (Q),509771182,173902704,484308304,1167982190,15971193471.697031,11103681922.073918,14951568341.145798,42026443734.916747,2963221,561801,2110702,5635724
2012-05-01,CBSX (W),10864939,8498913,5746478,25110330,286950624.470000,691647817.060000,147355311.005000,1125953752.535000,64974,7409,29725,102108
2012-05-01,NASDAQ PSX (X),29987123,22162727,27185264,79335114,651318264.550000,1577770138.730000,623334059.070000,2852422462.350000,151548,47684,99466,298698
2012-05-01,BATS BYX (Y),111134330,31829852,55241360,198205542,2845425630.100001,1445833357.878000,1348827566.535898,5640086554.513899,721925,110022,338420,1170367
2012-05-01,BATS BZX (Z),268332344,116312376,174988851,559633571,7973407310.741589,6392963098.105521,5113595355.651107,19479965764.498217,1656326,374128,977368,3007822
2012-04-30,NYSE MKT (A),0,11153481,1311821,12465302,0.000000,74059129.969200,24113271.490000,98172401.459200,0,21688,4673,26361
2012-04-30,NASDAQ BX (B),93921754,29126024,48090451,171138229,2386972995.076995,1222026394.582999,1708089158.635701,5317088548.295695,610735,101558,313733,1026026
2012-04-30,NSX (C),9610193,3598083,6332492,19540768,254358317.875100,112590181.483800,276158956.466399,643107455.825299,33021,6913,20632,60566
2012-04-30,NYSE (DN),78846574,11732728,39920565,130499867,2442128835.016898,601430039.225800,1381455652.764199,4425014527.006897,433018,40317,196590,669925
2012-04-30,NASDAQ (DQ),1139796342,262968896,543889420,1946654658,31003878429.004623,11810165653.180876,17301039117.230675,60115083199.416174,3118445,415818,1515115,5049378
2012-04-30,EDGA (J),91507482,27423301,44219246,163150029,2406367307.943497,1352733677.600399,1155133879.336391,4914234864.880287,571467,100758,274216,946441
2012-04-30,EDGX (K),178079151,49270766,105310771,332660688,5175940428.708391,2077719817.744699,3415882960.565389,10669543207.018479,882726,127342,510337,1520405
2012-04-30,CHX (M),9287594,4427981,4856397,18571972,306766870.077300,370658930.542000,220212710.058000,897638510.677300,425,2913,440,3778
2012-04-30,NYSE (N),851909032,0,0,851909032,26670747154.560803,0.000000,0.000000,26670747154.560803,2216914,0,0,2216914
2012-04-30,NYSE Arca (P),294710991,178708413,173819323,647238727,8848133621.711523,10129684390.996685,7419600007.409314,26397418020.117522,1561318,365178,837213,2763709
2012-04-30,NASDAQ (Q),468221973,149154145,456229190,1073605308,14776408899.290094,9696016992.369305,15200446362.529331,39672872254.188730,2709533,484505,1944984,5139022
2012-04-30,CBSX (W),9252266,2412165,4526102,16190533,229604745.400000,113825958.530000,126185774.570000,469616478.500000,54648,8898,27931,91477
2012-04-30,NASDAQ PSX (X),27799891,21172857,25771243,74743991,605544049.670000,1504445872.585000,545310901.150000,2655300823.405000,133375,45665,94702,273742
2012-04-30,BATS BYX (Y),92258470,24806424,44372151,161437045,2408287627.101605,1091483831.989999,1145217311.610302,4644988770.701906,622266,93254,286532,1002052
2012-04-30,BATS BZX (Z),228594771,96107850,147865049,472567670,6602463558.003398,5372915526.231795,4608113604.362807,16583492688.598000,1415978,335374,851448,2602800
2012-04-27,NYSE MKT (A),0,11655600,1224431,12880031,0.000000,76486442.193100,21250795.951400,97737238.144500,0,22906,4553,27459
2012-04-27,NASDAQ BX (B),98123903,26479738,50083839,174687480,2470782132.295007,1077324559.740998,1897339255.278103,5445445947.314108,633690,96205,338987,1068882
2012-04-27,NSX (C),11323127,3471206,7922491,22716824,314906904.884500,124901480.622700,340227840.650001,780036226.157201,39430,7329,26580,73339
2012-04-27,NYSE (DN),81675155,13794376,48025444,143494975,2481868192.065599,718149061.914800,1559477710.287503,4759494964.267902,438486,41891,226591,706968
2012-04-27,NASDAQ (DQ),1239494810,250363556,622576204,2112434570,34310450808.152079,11611686068.330130,18604997264.999081,64527134141.481290,3586671,435144,1889464,5911279
2012-04-27,EDGA (J),92357156,24662087,48170465,165189708,2555367882.435497,1176106161.884802,1407158444.963001,5138632489.283300,575040,90094,293322,958456
2012-04-27,EDGX (K),197911547,45079423,125772269,368763239,5930401384.059518,2020492199.003903,4184355913.400795,12135249496.464216,970551,125162,619503,1715216
2012-04-27,CHX (M),9092748,7808417,3118233,20019398,331531151.544000,633145602.526000,120460335.792800,1085137089.862800,745,2383,547,3675
2012-04-27,NYSE (N),787788480,0,0,787788480,24754272575.998084,0.000000,0.000000,24754272575.998084,2233353,0,0,2233353
2012-04-27,NYSE Arca (P),317121750,167533989,202955129,687610868,9864736346.882514,9343471933.071493,8281145471.127690,27489353751.081697,1680869,369865,977099,3027833
2012-04-27,NASDAQ (Q),453418751,148934258,457318148,1059671157,14226036567.291376,10028650896.354562,15227309623.361156,39481997087.007094,2620592,489717,2040223,5150532
2012-04-27,CBSX (W),11223434,2448189,4789909,18461532,276931212.120000,122175430.320000,126308676.230000,525415318.670000,62521,7355,28426,98302
2012-04-27,NASDAQ PSX (X),28177163,17830041,26654170,72661374,604183031.975000,1351322966.610000,620735055.720000,2576241054.305000,131396,39995,96388,267779
2012-04-27,BATS BYX (Y),96384616,23983560,50900882,171269058,2453575859.449999,1022044270.904999,1347368446.208602,4822988576.563600,631359,89253,329064,1049676
2012-04-27,BATS BZX (Z),236378562,89048939,162623697,488051198,6740526568.227788,5172617122.669407,5127735701.461514,17040879392.358709,1467475,308934,937459,2713868
2012-04-26,NYSE MKT (A),0,9470628,1525805,10996433,0.000000,67844829.299800,29355299.540000,97200128.839800,0,21886,5732,27618
2012-04-26,NASDAQ BX (B),108710068,27979298,50166925,186856291,2750967372.608398,1189146515.930999,1781277514.341196,5721391402.880593,693325,101673,339353,1134351
2012-04-26,NSX (C),13443429,3477498,7374151,24295078,352258429.355700,129947204.642200,326599732.573700,808805366.571600,43732,7913,24832,76477
2012-04-26,NYSE (DN),94603592,14289655,44341855,153235102,3028935390.481401,789558388.924600,1568342170.090801,5386835949.496802,484455,44016,227156,755627
2012-04-26,NASDAQ (DQ),1351168791,267484619,608068031,2226721441,36359252604.232053,11809424985.687572,19584285705.362473,67752963295.282098,3599418,468582,1703805,5771805
2012-04-26,EDGA (J),103134893,28686523,45177982,176999398,2806577152.457096,1391997721.904103,1247158175.296101,5445733049.657300,618974,101136,281633,1001743
2012-04-26,EDGX (K),224840177,56077752,122108162,403026091,6754464561.338190,2420933050.373802,4068810973.508471,13244208585.220463,1095925,151427,615612,1862964
2012-04-26,CHX (M),8822740,10879845,4538000,24240585,348322589.763400,764955465.465000,203295800.607600,1316573855.836000,516,3102,536,4154
2012-04-26,NYSE (N),780189739,0,0,780189739,25327069845.201625,0.000000,0.000000,25327069845.201625,2439004,0,0,2439004
2012-04-26,NYSE Arca (P),372809725,183950128,199346679,756106532,11402354229.055473,10477996656.755087,8666505506.203260,30546856392.013820,1931410,410804,958329,3300543
2012-04-26,NASDAQ (Q),537850880,167831679,461067388,1166749947,16576291125.600457,10630019452.047735,15652143258.883335,42858453836.531527,2994152,557705,2090261,5642118
2012-04-26,CBSX (W),11056077,3850142,4912384,19818603,263139465.140000,210895523.890000,105666082.520000,579701071.550000,61397,7395,26488,95280
2012-04-26,NASDAQ PSX (X),29444017,19866224,25507125,74817366,605813711.779400,1410200683.520000,620731387.520000,2636745782.819400,134295,42875,90268,267438
2012-04-26,BATS BYX (Y),112461470,25951568,50753568,189166606,2825300070.436001,1112200883.598000,1325191032.809995,5262691986.843996,708954,101925,331472,1142351
2012-04-26,BATS BZX (Z),288063082,105507928,162782580,556353590,7905865908.600406,6008593397.449488,5092248333.572428,19006707639.622322,1677039,357382,948082,2982503
2012-04-25,NYSE MKT (A),0,9069843,1216394,10286237,0.000000,65236958.521300,21282734.645500,86519693.166800,0,22374,4945,27319
2012-04-25,NASDAQ BX (B),110575864,34187390,52182171,196945425,2831965720.174997,1470129812.025002,2263064980.409894,6565160512.609893,717000,128791,350589,1196380
2012-04-25,NSX (C),14420576,4220106,6805448,25446130,412609094.587300,174111325.137800,353607027.557500,940327447.282600,50679,9906,24311,84896
2012-04-25,NYSE (DN),92074084,16524298,43465696,152064078,2789602449.126698,860212276.005099,1716464852.220800,5366279577.352597,484291,49029,220758,754078
2012-04-25,NASDAQ (DQ),1182287854,290246223,549994647,2022528724,31303174545.222286,13650255342.257355,19831625361.293167,64785055248.772808,3503861,504118,1618989,5626968
2012-04-25,EDGA (J),108111765,36604990,46211259,190928014,2824842917.576002,1786115738.534999,1390752254.020197,6001710910.131198,640942,130107,287005,1058054
2012-04-25,EDGX (K),219867669,60266867,112992456,393126992,6597373318.890896,2616222181.507501,4406642823.266891,13620238323.665288,1096343,169785,578165,1844293
2012-04-25,CHX (M),11072278,11258111,5294807,27625196,358110097.963600,853782038.965000,307274508.291900,1519166645.220500,491,4707,425,5623
2012-04-25,NYSE (N),822652957,0,0,822652957,26573162871.409824,0.000000,0.000000,26573162871.409824,2627321,0,0,2627321
2012-04-25,NYSE Arca (P),403991990,217150647,196023962,817166599,12078202862.902307,12024416565.119502,10343746785.328091,34446366213.349900,2093989,509603,992080,3595672
2012-04-25,NASDAQ (Q),585846626,219390585,474813715,1280050926,17840758424.520628,13917965352.623208,17690474458.354065,49449198235.497901,3303801,788043,2180850,6272694
2012-04-25,CBSX (W),12246711,2319447,4615077,19181235,255726259.380000,94100437.120000,101068574.040000,450895270.540000,61008,7825,26519,95352
2012-04-25,NASDAQ PSX (X),32890004,25652588,27765779,86308371,684899687.830000,1738660922.740000,758536953.770000,3182097564.340000,152182,62976,102771,317929
2012-04-25,BATS BYX (Y),119665817,32179529,49789668,201635014,2966863096.639999,1456265424.290003,1505113884.030004,5928242404.960006,754381,136414,321706,1212501
2012-04-25,BATS BZX (Z),286277962,135170329,158248383,579696674,8291517459.764599,7666141590.767292,5456400681.880899,21414059732.412790,1732362,472343,928726,3133431
2012-04-24,NYSE MKT (A),0,9036432,1491069,10527501,0.000000,62747043.437600,27604988.100000,90352031.537600,0,20411,6309,26720
2012-04-24,NASDAQ BX (B),102154224,28240083,53472894,183867201,2576047661.270400,1183617351.617000,2156589437.238086,5916254450.125486,648269,114882,344092,1107243
2012-04-24,NSX (C),11229967,3285445,6608950,21124362,294762945.498500,113265692.453100,344311337.870102,752339975.821702,37347,7677,24329,69353
2012-04-24,NYSE (DN),80328437,11805083,41016959,133150479,2457105978.520200,582003050.294800,1620890217.955897,4659999246.770897,427215,38396,210792,676403
2012-04-24,NASDAQ (DQ),1074617230,242006559,522515581,1839139370,28025432252.377085,10568547319.758684,18383841830.088936,56977821402.224705,3246733,442298,1549988,5239019
2012-04-24,EDGA (J),93556231,28090961,44845425,166492617,2484943702.351501,1363156087.782001,1304128492.304899,5152228282.438401,567139,106759,275105,949003
2012-04-24,EDGX (K),192935304,50159602,115485143,358580049,5645576011.086100,2212679280.512300,4381035664.916382,12239290956.514782,953539,144437,571722,1669698
2012-04-24,CHX (M),12850641,10864818,4601848,28317307,360970238.955700,731455210.171600,356073901.309000,1448499350.436300,560,1819,422,2801
2012-04-24,NYSE (N),752118899,0,0,752118899,24027885974.741337,0.000000,0.000000,24027885974.741337,2372626,0,0,2372626
2012-04-24,NYSE Arca (P),354510391,185820442,201995907,742326740,10494647323.784676,10459468925.176707,11023298032.035326,31977414280.996709,1879771,434647,1004698,3319116
2012-04-24,NASDAQ (Q),530686459,175902269,466549215,1173137943,16494404572.489716,11765998319.192693,17472335528.156559,45732738419.838968,3010903,617481,2101268,5729652
2012-04-24,CBSX (W),9351835,3232171,5714832,18298838,217618880.790000,189859291.170000,112396832.270000,519875004.230000,53388,5694,26881,85963
2012-04-24,NASDAQ PSX (X),29746049,21552318,29890392,81188759,612134913.970000,1521247510.890000,726811755.820000,2860194180.680000,132263,50715,97824,280802
2012-04-24,BATS BYX (Y),106316472,27393369,51321776,185031617,2602856803.195000,1205249474.585000,1435127135.042995,5243233412.822995,675214,117803,334235,1127252
2012-04-24,BATS BZX (Z),266700260,110499590,163044362,540244212,7608600378.815129,6365050460.907936,5319579833.234319,19293230672.957384,1613579,393470,952168,2959217
2012-04-23,NYSE MKT (A),0,9871037,1264527,11135564,0.000000,66910459.112600,22828331.910000,89738791.022600,0,22058,5680,27738
2012-04-23,NASDAQ BX (B),105900108,35332000,59008065,200240173,2549328142.065003,1505480108.865400,1994491507.519797,6049299758.450200,677092,133271,361818,1172181
2012-04-23,NSX (C),10746986,4014958,6453658,21215602,285992514.138300,142370211.791800,261439372.894502,689802098.824602,36915,10893,23062,70870
2012-04-23,NYSE (DN),84334424,15889287,44488910,144712621,2540342025.220902,773738215.712000,1650992169.301798,4965072410.234700,472356,53571,224195,750122
2012-04-23,NASDAQ (DQ),1039885408,324470170,563310508,1927666086,26479541582.344194,16250796356.179480,20484179260.726898,63214517199.250572,3258448,539471,1626012,5423931
2012-04-23,EDGA (J),99768057,34898883,49303576,183970516,2549586616.160798,1652158808.924200,1340531825.724502,5542277250.809500,598902,127524,294956,1021382
2012-04-23,EDGX (K),207225173,65158514,118519045,390902732,5900911804.735094,2715657785.746597,4196400637.616839,12812970228.098530,1013035,177011,569546,1759592
2012-04-23,CHX (M),8465255,9974051,3782776,22222082,326208165.127200,719163193.709400,294465291.408600,1339836650.245200,517,2551,575,3643
2012-04-23,NYSE (N),784675819,0,0,784675819,24698421691.506867,0.000000,0.000000,24698421691.506867,2433604,0,0,2433604
2012-04-23,NYSE Arca (P),353687765,238705541,204453602,796846908,10423938963.702703,12740367047.441397,10086769202.862329,33251075214.006429,1925054,550439,1011454,3486947
2012-04-23,NASDAQ (Q),531778400,220199398,482929113,1234906911,16182047920.231469,13241896075.394900,16994349333.389206,46418293329.015575,3041430,760611,2147510,5949551
2012-04-23,CBSX (W),13632322,2716039,5487539,21835900,248397287.250000,127026334.450000,114371283.805000,489794905.505000,62169,7247,26592,96008
2012-04-23,NASDAQ PSX (X),29323957,27079291,31384470,87787718,618808688.790000,1916515506.760000,790099984.800001,3325424180.350001,138417,58133,106901,303451
2012-04-23,BATS BYX (Y),111889201,33161906,56570757,201621864,2621867423.837998,1415689850.620000,1480276997.001098,5517834271.459096,708891,136832,355808,1201531
2012-04-23,BATS BZX (Z),274669014,136005752,177885047,588559813,7921973106.110691,7728962553.371076,5788796738.940928,21439732398.422695,1693932,496718,1002445,3193095
2012-04-20,NYSE MKT (A),0,10102508,1460708,11563216,0.000000,66452411.125300,30529647.730000,96982058.855300,0,17538,5824,23362
2012-04-20,NASDAQ BX (B),96773996,29570352,54104466,180448814,2384769998.294998,1330447140.638000,2067199535.966295,5782416674.899293,606517,114673,337906,1059096
2012-04-20,NSX (C),10696209,3762184,7104883,21563276,297467338.033900,164360838.725900,305079755.170401,766907931.930201,39552,8427,24396,72375
2012-04-20,NYSE (DN),101579844,14800541,48878255,165258640,3144011040.336897,911583756.492300,2080857926.720102,6136452723.549299,535515,45993,249829,831337
2012-04-20,NASDAQ (DQ),1124322689,249531412,592386055,1966240156,27330923965.965353,12271960263.883305,21665930238.395149,61268814468.243807,3179674,437637,1609573,5226884
2012-04-20,EDGA (J),100455338,28725674,49226339,178407351,2570228327.249999,1509152367.482800,1432255660.764801,5511636355.497600,579791,108661,298359,986811
2012-04-20,EDGX (K),202699334,53750334,129658087,386107755,5825397544.091889,2406610074.068503,4838322442.932226,13070330061.092618,934820,150974,604693,1690487
2012-04-20,CHX (M),7510441,12447350,6781378,26739169,251316906.399000,1100754519.083500,343550035.584500,1695621461.067000,251,1651,457,2359
2012-04-20,NYSE (N),965984592,0,0,965984592,32275977775.010591,0.000000,0.000000,32275977775.010591,2273563,0,0,2273563
2012-04-20,NYSE Arca (P),346241574,174659520,204771961,725673055,10615699776.604740,9640049123.532568,10602055374.625780,30857804274.763088,1823921,430275,1005924,3260120
2012-04-20,NASDAQ (Q),487646500,175296097,585294742,1248237339,14643206838.870436,11089730591.941187,20467083664.388512,46200021095.200135,2735386,613511,2123361,5472258
2012-04-20,CBSX (W),9824246,2964357,3970542,16759145,219827679.210000,149868894.060000,94582232.980000,464278806.250000,50834,6189,21321,78344
2012-04-20,NASDAQ PSX (X),27555583,26221057,26730792,80507432,578982144.900000,1830292288.800000,704560081.675000,3113834515.375000,127985,50224,100928,279137
2012-04-20,BATS BYX (Y),99745135,26508424,51351225,177604784,2450802043.155002,1247558893.025000,1424743577.870000,5123104514.050002,626836,113037,319594,1059467
2012-04-20,BATS BZX (Z),258975062,108271904,180038999,547285965,7461371609.346012,6602418483.004399,6337844446.555483,20401634538.905894,1556193,401404,1008494,2966091
2012-04-19,NYSE MKT (A),0,8471202,1101142,9572344,0.000000,59445353.836300,17803498.120000,77248851.956300,0,19726,5248,24974
2012-04-19,NASDAQ BX (B),112253937,35197748,55435582,202887267,2719854607.265004,1651896657.577998,2226425194.288095,6598176459.131097,693643,137802,365489,1196934
2012-04-19,NSX (C),13683345,4968232,8181034,26832611,351946234.257100,210081737.640900,378449836.677796,940477808.575796,45838,10267,27544,83649
2012-04-19,NYSE (DN),93537919,15966877,45225573,154730369,2662783910.527092,833109092.534599,1787390816.991498,5283283820.053189,466754,47012,222955,736721
2012-04-19,NASDAQ (DQ),1189744468,309956350,606675331,2106376149,30422512975.434779,14588971686.592309,21734147629.757069,66745632291.784157,3319889,470288,1679122,5469299
2012-04-19,EDGA (J),110716517,40733902,53536505,204986924,2759121814.958999,1980663477.499002,1677661045.761805,6417446338.219806,636473,138664,325401,1100538
2012-04-19,EDGX (K),260608854,77481941,141427275,479518070,7090969934.131700,3577999788.993602,5123190433.321230,15792160156.446532,1169533,214778,693227,2077538
2012-04-19,CHX (M),8886771,11909661,4408035,25204467,262653756.518300,1012920937.535400,158055371.846500,1433630065.900200,677,3095,589,4361
2012-04-19,NYSE (N),822916944,0,0,822916944,25388441703.729742,0.000000,0.000000,25388441703.729742,2679076,0,0,2679076
2012-04-19,NYSE Arca (P),437297098,241727113,245887370,924911581,12568191394.891370,13800598585.084148,11470144899.123295,37838934879.098813,2230644,599576,1197760,4027980
2012-04-19,NASDAQ (Q),638988494,264724235,540176835,1443889564,18588109371.184208,16921315303.012768,18516941109.468739,54026365783.665715,3512664,928903,2486069,6927636
2012-04-19,CBSX (W),9084190,3119870,3957166,16161226,178071981.170000,141930330.640000,91767259.660000,411769571.470000,42045,5580,19370,66995
2012-04-19,NASDAQ PSX (X),32490623,32318933,31335007,96144563,670239916.170000,2303541105.630001,771754303.745000,3745535325.545001,145165,68831,116077,330073
2012-04-19,BATS BYX (Y),122357575,34751393,56214951,213323919,2874019313.340006,1634298131.176499,1627774041.729998,6136091486.246503,731692,149222,354597,1235511
2012-04-19,BATS BZX (Z),338808786,164620849,208343664,711773299,9290836771.942662,9999271032.148380,6926478822.175121,26216586626.266163,1960483,600387,1204785,3765655
2012-04-18,NYSE MKT (A),0,8905182,2283700,11188882,0.000000,60174787.847700,40460659.750000,100635447.597700,0,19454,6425,25879
2012-04-18,NASDAQ BX (B),96888313,23865485,50400608,171154406,2445966774.424998,1041555640.013999,2096560441.719996,5584082856.158993,640362,96488,324811,1061661
2012-04-18,NSX (C),11048812,3328293,7442666,21819771,287206213.355500,126229087.571900,310834903.964499,724270204.891899,38121,8733,22593,69447
2012-04-18,NYSE (DN),87877331,12353093,40218031,140448455,2602123664.169000,671641510.715899,1751687837.017205,5025453011.902104,468161,38258,204554,710973
2012-04-18,NASDAQ (DQ),1036333853,234326088,512019100,1782679041,27078546147.812073,10624474642.227484,20155558538.493626,57858579328.533183,3008961,415713,1358704,4783378
2012-04-18,EDGA (J),93623987,26795905,42956778,163376670,2426872773.278803,1321582834.483700,1346358052.087199,5094813659.849702,565178,105894,260024,931096
2012-04-18,EDGX (K),204564203,51896980,116156669,372617852,5842229163.617704,2226111484.221900,4799345902.993139,12867686550.832743,984836,149000,546436,1680272
2012-04-18,CHX (M),10647574,7924145,6508302,25080021,283702309.711900,624662839.042200,244300320.375000,1152665469.129100,787,2087,518,3392
2012-04-18,NYSE (N),720972011,0,0,720972011,22268013441.431263,0.000000,0.000000,22268013441.431263,2236236,0,0,2236236
2012-04-18,NYSE Arca (P),325954298,175788414,185197326,686940038,9930234707.254706,9389000683.712671,10352968178.759996,29672203569.727373,1771535,424200,913470,3109205
2012-04-18,NASDAQ (Q),494022743,173711086,423594161,1091327990,14690299870.887066,11298933531.020602,16128790397.606075,42118023799.513743,2776135,611861,1868048,5256044
2012-04-18,CBSX (W),10430748,4204249,4210818,18845815,210215200.270000,266037930.216800,93997990.270000,570251120.756800,51049,6013,19379,76441
2012-04-18,NASDAQ PSX (X),27461181,21728365,23711917,72901463,561499813.480000,1610438731.450000,554604934.610000,2726543479.540000,125896,48204,83789,257889
2012-04-18,BATS BYX (Y),100781979,26019240,46160306,172961525,2425178705.860000,1146880898.900000,1297443736.001601,4869503340.761601,628803,109256,283079,1021138
2012-04-18,BATS BZX (Z),256881954,111367042,153724353,521973349,7367420427.631107,6681165426.096513,5547878331.060708,19596464184.788328,1570884,399084,880295,2850263
2012-04-17,NYSE MKT (A),0,10587951,1982962,12570913,0.000000,75700376.084300,29374226.330000,105074602.414300,0,22876,6232,29108
2012-04-17,NASDAQ BX (B),105191880,29544371,54269415,189005666,2568920140.229102,1273066445.698000,2026587008.704696,5868573594.631798,653624,108154,321657,1083435
2012-04-17,NSX (C),11398191,3973212,7381480,22752883,302547717.934900,149388283.985400,372512628.794501,824448630.714801,37643,8866,24637,71146
2012-04-17,NYSE (DN),81430427,15837748,34958198,132226373,2435379802.553698,879529950.970800,1457134753.405402,4772044506.929900,439857,56422,187114,683393
2012-04-17,NASDAQ (DQ),1036034266,287102161,502510218,1825646645,27358931172.104858,13158683828.739331,19489863772.226181,60007478773.070370,3026816,501661,1425356,4953833
2012-04-17,EDGA (J),94363032,32516881,42086478,168966391,2511271684.672799,1529023029.074203,1547849600.944799,5588144314.691801,564174,112832,256318,933324
2012-04-17,EDGX (K),205658798,61055397,112863643,379577838,6214677211.684095,2698950034.191699,4681651078.041898,13595278323.917692,992351,177024,513744,1683119
2012-04-17,CHX (M),7071850,8570805,6468028,22110683,243742283.434800,644843040.396000,236648340.053400,1125233663.884200,695,2067,627,3389
2012-04-17,NYSE (N),709765282,0,0,709765282,22671225366.654281,0.000000,0.000000,22671225366.654281,2183012,0,0,2183012
2012-04-17,NYSE Arca (P),339267459,198602745,175466194,713336398,10675900592.439299,10910915387.036782,9866483045.679565,31453299025.155646,1812313,461711,861403,3135427
2012-04-17,NASDAQ (Q),490402281,195953648,419920140,1106276069,14919312627.281462,12239426081.889268,15629080119.770897,42787818828.941627,2729531,642355,1828775,5200661
2012-04-17,CBSX (W),8215954,2449911,4247717,14913582,170818181.680000,132163949.110000,86460614.246000,389442745.036000,37187,6159,21997,65343
2012-04-17,NASDAQ PSX (X),23928443,19625233,22011993,65565669,508213778.680000,1501296177.940000,513832114.874999,2523342071.494999,114634,43503,79132,237269
2012-04-17,BATS BYX (Y),99178723,31161974,44882380,175223077,2554313187.870998,1337045038.970001,1233032522.647700,5124390749.488699,638100,124427,275812,1038339
2012-04-17,BATS BZX (Z),251305208,124014774,141550061,516870043,7235536291.641313,7141766426.864982,5009146422.849223,19386449141.355518,1514680,432627,823438,2770745
2012-04-16,NYSE MKT (A),0,12504024,1939369,14443393,0.000000,80601406.752000,36585270.690000,117186677.442000,0,26312,7117,33429
2012-04-16,NASDAQ BX (B),102685750,38390908,53428769,194505427,2529109516.284295,1510211664.084198,2284698466.212295,6324019646.580788,657467,134535,327272,1119274
2012-04-16,NSX (C),10857104,4804859,7119747,22781710,270500999.198901,162151586.529700,339349042.323499,772001628.052100,36611,10631,22033,69275
2012-04-16,NYSE (DN),74978838,17574145,37191013,129743996,2196269628.814996,800505936.375000,1743213137.344397,4739988702.534393,426894,55301,194080,676275
2012-04-16,NASDAQ (DQ),1038631497,342927396,485817776,1867376669,28936908369.010720,13203029914.739403,19187171130.006023,61327109413.756146,2806283,512469,1336820,4655572
2012-04-16,EDGA (J),98443385,38448143,43711238,180602766,2592095000.650603,1723301702.801000,1255855678.009999,5571252381.461602,592700,131026,263917,987643
2012-04-16,EDGX (K),209818933,78375498,114702778,402897209,6000838836.329267,3134915644.869599,4866072218.532501,14001826699.731367,1001886,211382,519634,1732902
2012-04-16,CHX (M),9364106,5520360,11069870,25954336,241730441.816800,394427986.040000,271863733.903700,908022161.760500,891,1997,618,3506
2012-04-16,NYSE (N),735514262,0,0,735514262,23334311266.567280,0.000000,0.000000,23334311266.567280,2327314,0,0,2327314
2012-04-16,NYSE Arca (P),355772687,231472196,185119059,772363942,10729233562.740763,12243768216.545479,10276934138.951462,33249935918.237704,1971970,564043,923325,3459338
2012-04-16,NASDAQ (Q),529145212,244098053,438144285,1211387550,15790505523.283857,14616096543.803908,16727544422.233036,47134146489.320801,3016018,830721,2018187,5864926
2012-04-16,CBSX (W),7156138,3270660,4200313,14627111,154318996.690000,159904887.620000,89120507.991400,403344392.301400,37320,6426,19646,63392
2012-04-16,NASDAQ PSX (X),27595587,25368555,22583899,75548041,564970703.100000,1843727427.600000,576133235.515000,2984831366.215000,129074,56384,84958,270416
2012-04-16,BATS BYX (Y),100444891,35030074,46542672,182017637,2486433393.450003,1461936192.342000,1242817392.204299,5191186977.996302,651713,136805,286473,1074991
2012-04-16,BATS BZX (Z),274022712,161867298,160511090,596401100,7657015158.312586,8891422866.837597,5458866713.590633,22007304738.740816,1674627,587625,902119,3164371
2012-04-13,NYSE MKT (A),0,9121751,1310203,10431954,0.000000,70870922.509600,22825867.620000,93696790.129600,0,22395,4798,27193
2012-04-13,NASDAQ BX (B),105924006,35377306,49512639,190813951,2540602378.949991,1445365628.563201,2202083576.836395,6188051584.349587,668496,126692,316314,1111502
2012-04-13,NSX (C),12853256,4500228,6097812,23451296,305714260.538600,173256610.431000,381360899.881403,860331770.851003,39229,9053,22669,70951
2012-04-13,NYSE (DN),76287935,16732331,34225161,127245427,2215532072.260799,905683162.833700,1673815428.054400,4795030663.148899,415999,53154,180889,650042
2012-04-13,NASDAQ (DQ),1068680100,313295004,459633349,1841608453,29335885833.405537,14984143154.934161,18325939775.370045,62645968763.709743,2732994,475260,1256301,4464555
2012-04-13,EDGA (J),101430944,35342221,42259002,179032167,2483720702.128601,1701955139.444901,1298335771.888401,5484011613.461903,572629,128590,256698,957917
2012-04-13,EDGX (K),207883046,65149921,101805512,374838479,5866979569.674405,2946519554.065597,4397097615.321943,13210596739.061945,976291,187339,484812,1648442
2012-04-13,CHX (M),7976148,9224182,4960188,22160518,200412062.644000,680218459.611100,184206520.616100,1064837042.871200,1704,2786,808,5298
2012-04-13,NYSE (N),771014317,0,0,771014317,24343633929.834634,0.000000,0.000000,24343633929.834634,2202989,0,0,2202989
2012-04-13,NYSE Arca (P),355740949,244051891,167416145,767208985,10584565948.687209,13321337275.619034,9690359708.910982,33596262933.217225,1886772,549934,845619,3282325
2012-04-13,NASDAQ (Q),516147510,237898349,406187008,1160232867,15388028219.634531,14852982791.263191,16614710375.324736,46855721386.222458,2900333,787801,1839887,5528021
2012-04-13,CBSX (W),9101562,2620405,4450850,16172817,186946348.230000,131041070.140000,101783928.810000,419771347.180000,46531,7340,25108,78979
2012-04-13,NASDAQ PSX (X),31792517,29805130,24833591,86431238,654055156.035000,1969368416.469999,601292065.450001,3224715637.955000,137476,65206,89526,292208
2012-04-13,BATS BYX (Y),100416818,31452621,43508732,175378171,2451188831.122499,1458158129.644999,1286793962.270095,5196140923.037593,625571,128383,270277,1024231
2012-04-13,BATS BZX (Z),267436526,147525973,144857747,559820246,7615421810.049119,8682489931.580684,5546465444.249349,21844377185.879152,1616578,556526,851621,3024725
2012-04-12,NYSE MKT (A),0,10735998,1657235,12393233,0.000000,67449477.508500,25962466.220000,93411943.728500,0,24317,4573,28890
2012-04-12,NASDAQ BX (B),103823310,36434122,50000306,190257738,2491971916.806006,1452889131.309899,1934979840.639797,5879840888.755702,651625,126173,306853,1084651
2012-04-12,NSX (C),13088867,3994290,6828283,23911440,337070833.009700,147900519.376800,314522128.709602,799493481.096102,41983,9163,22841,73987
2012-04-12,NYSE (DN),86988963,17131372,36412501,140532836,2583433733.904997,1009248033.411101,1638267817.222802,5230949584.538900,464909,60546,185513,710968
2012-04-12,NASDAQ (DQ),1105683359,323761924,487051227,1916496510,30467890453.728014,13992713313.681212,17092469511.192791,61553073278.602017,3048415,528556,1350978,4927949
2012-04-12,EDGA (J),95039733,37544441,39834676,172418850,2418986039.430201,1677534973.010000,1172792315.956597,5269313328.396798,546495,128077,235049,909621
2012-04-12,EDGX (K),207784444,68543613,100972874,377300931,6018497539.057273,3063458713.259300,3840562522.311293,12922518774.627866,984801,197258,470711,1652770
2012-04-12,CHX (M),10950859,11040431,5101313,27092603,306865797.009800,804343668.202000,127606952.775500,1238816417.987300,1227,2994,797,5018
2012-04-12,NYSE (N),756755459,0,0,756755459,23726702734.903503,0.000000,0.000000,23726702734.903503,2232083,0,0,2232083
2012-04-12,NYSE Arca (P),346623480,228460024,161383246,736466750,10755404137.122802,12698907264.928289,8343736840.903077,31798048242.954168,1869123,543453,812366,3224942
2012-04-12,NASDAQ (Q),495055624,229712106,397457604,1122225334,15239832880.893415,14332920445.488307,14408696601.817520,43981449928.199242,2805011,779115,1775784,5359910
2012-04-12,CBSX (W),9340894,4036080,3334375,16711349,197806148.850000,156063131.020000,75618875.432500,429488155.302500,47244,8351,19043,74638
2012-04-12,NASDAQ PSX (X),30219171,24678334,21361746,76259251,669533243.745000,1803392178.522800,514305728.235000,2987231150.502800,139303,53516,86244,279063
2012-04-12,BATS BYX (Y),98363400,32378182,41046483,171788065,2478660453.396801,1380868044.625000,1139668876.075197,4999197374.096998,630960,129419,253475,1013854
2012-04-12,BATS BZX (Z),258327143,146275984,141004068,545607195,7581654841.487055,8554071366.577071,5110774005.033831,21246500213.097957,1597702,541394,816040,2955136
2012-04-11,NYSE MKT (A),0,10097865,1404175,11502040,0.000000,65006213.939400,22969880.304100,87976094.243500,0,22155,4945,27100
2012-04-11,NASDAQ BX (B),114165107,30018189,49630832,193814128,2610786115.815502,1279588899.198800,2013082862.809395,5903457877.823697,686103,105119,322952,1114174
2012-04-11,NSX (C),13325986,4327786,6420953,24074725,321290898.153700,152352684.050400,263742693.240099,737386275.444199,43758,9694,22807,76259
2012-04-11,NYSE (DN),79723574,16588403,36989099,133301076,2203263023.281400,866246621.547500,1486565299.828598,4556074944.657498,411914,51115,193014,656043
2012-04-11,NASDAQ (DQ),1103915529,305622822,483133778,1892672129,27187553168.081615,13866414793.074604,17238745021.163700,58292712982.319919,3120127,461331,1371906,4953364
2012-04-11,EDGA (J),108091836,32841327,42327293,183260456,2601465532.982699,1525650894.684701,1203682403.547200,5330798831.214600,590865,113768,255213,959846
2012-04-11,EDGX (K),218019065,62442318,104720454,385181837,6077036277.051626,2859570831.089697,3996437773.125938,12933044881.267261,1014594,181104,506326,1702024
2012-04-11,CHX (M),11370630,8227891,4029986,23628507,341344452.591000,704903716.771600,163942482.138200,1210190651.500800,1126,2755,791,4672
2012-04-11,NYSE (N),790207361,0,0,790207361,24315678225.923289,0.000000,0.000000,24315678225.923289,2307934,0,0,2307934
2012-04-11,NYSE Arca (P),374555541,210986493,162586106,748128140,10567252023.344614,11172272263.513421,8060950400.428286,29800474687.286321,1924380,518097,859464,3301941
2012-04-11,NASDAQ (Q),540728175,210232590,435130867,1186091632,15792703491.320298,13458837666.711303,15693231070.942497,44944772228.974098,2966389,748913,1963293,5678595
2012-04-11,CBSX (W),9401720,4154249,4069294,17625263,198967178.040000,226412270.055200,135485495.830000,560864943.925200,46579,5555,17706,69840
2012-04-11,NASDAQ PSX (X),31400645,23832119,22467268,77700032,631745746.120000,1746474894.835000,519463666.895000,2897684307.850000,134532,49959,85514,270005
2012-04-11,BATS BYX (Y),106025558,30614241,41982533,178622332,2503510806.188204,1332841649.753999,1146957770.700201,4983310226.642404,639050,123717,271869,1034636
2012-04-11,BATS BZX (Z),286924823,129971470,149940944,566837237,7716443913.230215,7780692799.708575,5132433781.934794,20629570494.873584,1640516,484687,864968,2990171
2012-04-10,NYSE MKT (A),0,13305596,1245791,14551387,0.000000,81805733.336200,20771048.235000,102576781.571200,0,29440,5119,34559
2012-04-10,NASDAQ BX (B),133548561,41727120,63969888,239245569,3208018558.230000,1726462666.253000,2679059592.036193,7613540816.519193,873963,151606,423234,1448803
2012-04-10,NSX (C),17949453,7218474,10425059,35592986,438140136.305900,296805308.155300,395013542.168599,1129958986.629799,59331,16503,32103,107937
2012-04-10,NYSE (DN),105522944,28839091,54796299,189158334,3032373791.183100,1524257902.388000,2060649646.541500,6617281340.112600,546872,85147,273328,905347
2012-04-10,NASDAQ (DQ),1342541568,462641242,597257846,2402440656,32990131038.380037,21262119316.844618,21093781635.704617,75346031990.929272,3862528,731363,1714266,6308157
2012-04-10,EDGA (J),136237245,52797757,56375885,245410887,3409396287.040686,2434496739.123201,1586762090.786893,7430655116.950780,772085,179602,337264,1288951
2012-04-10,EDGX (K),289128849,104535153,141405632,535069634,7903370352.021971,4823957145.365463,4898649089.893032,17625976587.280466,1348392,303947,654936,2307275
2012-04-10,CHX (M),14656743,13105060,4186597,31948400,413452790.018700,1116989327.725000,220444511.271100,1750886629.014800,925,4639,801,6365
2012-04-10,NYSE (N),972156628,0,0,972156628,29214976281.175525,0.000000,0.000000,29214976281.175525,2918166,0,0,2918166
2012-04-10,NYSE Arca (P),455723250,315112987,213685128,984521365,13322399318.601460,17559952256.307553,10135207115.779123,41017558690.688136,2470659,776372,1071499,4318530
2012-04-10,NASDAQ (Q),682808401,329220756,532613887,1544643044,20023628165.689974,20990643477.607896,17880565787.177876,58894837430.475746,3836711,1093545,2452946,7383202
2012-04-10,CBSX (W),13095564,6370285,4589071,24054920,249172498.590000,370044893.701200,96810368.710000,716027761.001200,69000,8126,25326,102452
2012-04-10,NASDAQ PSX (X),35032910,37261536,29074218,101368664,746546265.725000,2771307296.460001,666573806.221801,4184427368.406802,159627,74137,111760,345524
2012-04-10,BATS BYX (Y),127165525,48067257,56054964,231287746,3088580258.245600,2047970885.264996,1492296790.547493,6628847934.058089,816982,182271,358664,1357917
2012-04-10,BATS BZX (Z),351941275,208899836,194859922,755701033,9676597959.058193,12470626229.915974,6495878818.138147,28643103007.112314,2111617,776799,1141366,4029782
2012-04-09,NYSE MKT (A),0,10742651,1138660,11881311,0.000000,73244817.877600,18857594.590000,92102412.467600,0,23794,4845,28639
2012-04-09,NASDAQ BX (B),91279600,26271783,43507633,161059016,2237127894.667097,1069532824.894999,1482740103.326003,4789400822.888099,615852,94265,291928,1002045
2012-04-09,NSX (C),10930319,3575622,7370713,21876654,270136289.582600,127527258.417400,300467529.831402,698131077.831402,38263,8805,23812,70880
2012-04-09,NYSE (DN),70078991,11867809,34437914,116384714,2137171402.025800,619905530.821200,1158089074.722698,3915166007.569698,379853,41758,182440,604051
2012-04-09,NASDAQ (DQ),920441593,289588796,432891220,1642921609,23745905443.860627,13885215437.575739,14547926051.676657,52179046933.113023,2843432,473759,1283103,4600294
2012-04-09,EDGA (J),81275947,29959946,34833639,146069532,2008296795.021499,1324708125.899999,957602994.023699,4290607914.945197,463919,95189,208580,767688
2012-04-09,EDGX (K),184050202,54375933,99181251,337607386,5310648683.607917,2382736238.521199,3432806131.429303,11126191053.558419,880997,168764,455712,1505473
2012-04-09,CHX (M),7779531,5425057,3812891,17017479,245491604.540000,374434051.800800,127665264.253800,747590920.594600,493,2379,508,3380
2012-04-09,NYSE (N),724798345,0,0,724798345,22672670732.771359,0.000000,0.000000,22672670732.771359,2081036,0,0,2081036
2012-04-09,NYSE Arca (P),302623888,200761692,146805232,650190812,9276358390.626701,10738179932.356269,7035869002.454457,27050407325.437427,1671986,471535,762976,2906497
2012-04-09,NASDAQ (Q),434562177,189146530,385656241,1009364948,13338447632.965390,11220136683.250683,12506242788.323101,37064827104.539174,2493926,616292,1700942,4811160
2012-04-09,CBSX (W),7965586,4085351,2683695,14734632,145476799.140000,211677816.210000,56087738.810000,413242354.160000,40924,5628,13872,60424
2012-04-09,NASDAQ PSX (X),25860209,21182961,21082843,68126013,564331370.685000,1417221883.090000,444730834.056400,2426284087.831400,122380,44198,85483,252061
2012-04-09,BATS BYX (Y),85791865,28432088,38141587,152365540,2179274970.921802,1218540597.836100,980309660.389001,4378125229.146903,572876,108403,248483,929762
2012-04-09,BATS BZX (Z),220484993,115088611,128177078,463750682,6501085595.765608,6483551893.743204,4162779670.293500,17147417159.802312,1384006,427598,780849,2592453
2012-04-05,NYSE MKT (A),0,9777559,1015102,10792661,0.000000,58201318.948200,16218334.585000,74419653.533200,0,22022,4405,26427
2012-04-05,NASDAQ BX (B),101853104,25916816,49820701,177590621,2539225951.845002,1019625302.797000,1738545093.226002,5297396347.868004,658433,93335,303433,1055201
2012-04-05,NSX (C),10639202,4066226,7962622,22668050,288492625.308700,126375642.456900,266988325.662402,681856593.428002,36075,8836,22516,67427
2012-04-05,NYSE (DN),68961125,13276925,39371018,121609068,2136291395.549998,736662394.716100,1334234539.224397,4207188329.490495,374492,40740,181936,597168
2012-04-05,NASDAQ (DQ),938187728,267875575,499678469,1705741772,24875961779.281924,12412759776.530438,15487720933.618898,52776442489.431260,2883354,439125,1305572,4628051
2012-04-05,EDGA (J),93629002,26410235,42200422,162239659,2395871651.349193,1229195126.714002,1085274245.663201,4710341023.726396,539844,96201,246510,882555
2012-04-05,EDGX (K),194838514,47306594,114142786,356287894,5684499783.231099,2114691037.433403,3792159084.866035,11591349905.530537,913728,146164,485380,1545272
2012-04-05,CHX (M),6228712,9606623,4016604,19851939,237220073.610000,790503878.269600,369560935.995500,1397284887.875100,890,2302,877,4069
2012-04-05,NYSE (N),719364126,0,0,719364126,22546631725.135741,0.000000,0.000000,22546631725.135741,2097016,0,0,2097016
2012-04-05,NYSE Arca (P),336825240,181576467,186271488,704673195,10168101666.291578,10541629777.666691,8129921459.098437,28839652903.056706,1824745,429331,845677,3099753
2012-04-05,NASDAQ (Q),463857938,174876250,388431575,1027165763,14162560480.414225,10889963683.843512,12284012189.490732,37336536353.748469,2615769,594457,1704388,4914614
2012-04-05,CBSX (W),6916024,3616575,4764815,15297414,163679097.370000,213782901.110000,65517328.280000,442979326.760000,34607,4911,17641,57159
2012-04-05,NASDAQ PSX (X),27835283,21563708,30418470,79817461,585091025.525000,1567174650.310000,539081934.185000,2691347610.020000,119517,46306,84116,249939
2012-04-05,BATS BYX (Y),91763162,27529287,44017157,163309606,2346336506.300602,1199671058.654101,1062733076.622000,4608740641.576703,601110,115178,264541,980829
2012-04-05,BATS BZX (Z),239409327,100986286,148793955,489189568,7024405100.784791,5862446018.091812,4837611317.959599,17724462436.836202,1467566,388026,830024,2685616
2012-04-04,NYSE MKT (A),0,12784365,1655679,14440044,0.000000,86431258.486900,22094539.380000,108525797.866900,0,27302,5525,32827
2012-04-04,NASDAQ BX (B),115863240,35320871,57152755,208336866,2793429425.509995,1404783985.451000,1973948350.840204,6172161761.801199,743257,127604,360719,1231580
2012-04-04,NSX (C),13648408,5026137,9317911,27992456,358904260.034100,189574374.091300,354747083.110300,903225717.235700,44024,12095,27157,83276
2012-04-04,NYSE (DN),83872953,18746766,46718396,149338115,2472966473.692801,920226918.919800,1507457712.096101,4900651104.708702,436264,60435,213245,709944
2012-04-04,NASDAQ (DQ),1113275037,348978049,574436836,2036689922,28688465947.252216,14896412285.712384,17184147187.599236,60769025420.563836,3239958,608365,1514657,5362980
2012-04-04,EDGA (J),108007920,36511021,48963662,193482603,2651937266.139505,1709463047.368200,1239965617.797395,5601365931.305100,597989,135252,280945,1014186
2012-04-04,EDGX (K),233742799,67118940,127838698,428700437,6739236682.489326,3001200024.921107,4059514576.939592,13799951284.350025,1084341,199718,555115,1839174
2012-04-04,CHX (M),7011777,8591431,4722955,20326163,235872997.991200,710757725.788100,159389958.418600,1106020682.197900,674,4057,1459,6190
2012-04-04,NYSE (N),832489309,0,0,832489309,25651390598.955703,0.000000,0.000000,25651390598.955703,2325924,0,0,2325924
2012-04-04,NYSE Arca (P),385785602,237995864,204254282,828035748,11802884680.596358,13058106228.738804,8383638363.126464,33244629272.461626,2040552,610500,977171,3628223
2012-04-04,NASDAQ (Q),547347675,248442970,492709541,1288500186,16535334345.555193,15546575448.366750,14911985861.583260,46993895655.505203,3042824,818139,2074176,5935139
2012-04-04,CBSX (W),5963980,5756702,2906985,14627667,124068171.640000,354236163.824000,59837610.040000,538141945.504000,27351,6829,12284,46464
2012-04-04,NASDAQ PSX (X),30476484,29279730,29032058,88788272,694764492.790000,2209471658.524999,655272339.635001,3559508490.950000,140566,65496,94297,300359
2012-04-04,BATS BYX (Y),103589831,36205985,50855179,190650995,2633909872.660192,1526536282.929999,1212793673.570002,5373239829.160193,668217,145934,303398,1117549
2012-04-04,BATS BZX (Z),273811122,143964505,168544499,586320126,8001897392.105821,8337596699.467323,5154892878.751798,21494386970.324942,1668890,545426,936098,3150414
2012-04-03,NYSE MKT (A),0,11863470,1843299,13706769,0.000000,74153251.982500,27044976.382400,101198228.364900,0,25155,7509,32664
2012-04-03,NASDAQ BX (B),108834265,33531845,56812409,199178519,2766044894.066104,1440899974.044999,2207082855.847805,6414027723.958908,720701,127992,368810,1217503
2012-04-03,NSX (C),14366053,5304347,10055274,29725674,369213972.194000,172399349.551200,389247230.245500,930860551.990700,46436,11595,28081,86112
2012-04-03,NYSE (DN),74054017,15670116,40954218,130678351,2319047587.320797,811708317.494500,1563362505.979200,4694118410.794497,401539,54761,203119,659419
2012-04-03,NASDAQ (DQ),1072816445,328484863,584758821,1986060129,28887640444.306440,14932143454.765298,19747672305.134586,63567456204.206324,3187922,532568,1493042,5213532
2012-04-03,EDGA (J),103961838,40815403,47325120,192102361,2626760667.107199,1873537430.647801,1254193884.346699,5754491982.101699,597063,137074,279160,1013297
2012-04-03,EDGX (K),238980003,72109785,127656481,438746269,6665855407.034409,3046062970.684099,4607893434.271273,14319811811.989781,1084421,202939,555604,1842964
2012-04-03,CHX (M),6575823,5182043,5064530,16822396,255727579.779000,466668410.917000,261592395.231000,983988385.927000,743,3530,566,4839
2012-04-03,NYSE (N),817206663,0,0,817206663,25921014164.057713,0.000000,0.000000,25921014164.057713,2469370,0,0,2469370
2012-04-03,NYSE Arca (P),376112143,236699009,196257020,809068172,11543885362.366975,12510998550.723624,10225223108.493513,34280107021.584112,2039860,592710,959804,3592374
2012-04-03,NASDAQ (Q),584377808,263343870,487345100,1335066778,17742113317.015987,16605382381.949052,17152606854.395748,51500102553.360787,3253556,914839,2141474,6309869
2012-04-03,CBSX (W),6819906,3636360,3466568,13922834,144358321.240000,156699963.670000,70689025.130000,371747310.040000,37720,6176,17367,61263
2012-04-03,NASDAQ PSX (X),32085872,32133606,30844955,95064433,710740832.015000,2401805167.549999,752468390.180000,3865014389.744999,150616,69713,109325,329654
2012-04-03,BATS BYX (Y),98687841,33936520,48209628,180833989,2555107526.889996,1391696714.376401,1222507838.185196,5169312079.451593,665449,137690,305157,1108296
2012-04-03,BATS BZX (Z),282466220,164002219,178475751,624944190,8310219130.510981,9085726807.625879,5810334844.158303,23206280782.295163,1727395,587592,996178,3311165
2012-04-02,NYSE MKT (A),0,12065116,1801271,13866387,0.000000,76753692.488600,32755858.870000,109509551.358600,0,25838,6144,31982
2012-04-02,NASDAQ BX (B),107236793,30679110,56136836,194052739,2716998492.069998,1364012520.412001,1621353367.290901,5702364379.772900,735218,118402,367699,1221319
2012-04-02,NSX (C),13859733,4518524,12804974,31183231,375990154.844900,166192515.685400,348447786.405201,890630456.935501,48309,10365,31831,90505
2012-04-02,NYSE (DN),79893285,20980648,43670489,144544422,2380704310.044795,1035095558.331799,1518027332.335306,4933827200.711900,456308,70683,218661,745652
2012-04-02,NASDAQ (DQ),1034192944,405274815,592880485,2032348244,27866212802.201377,19938199587.374446,17421750632.049294,65226163021.625117,3360498,550705,1603260,5514463
2012-04-02,EDGA (J),99882198,35934216,31093173,166909587,2605752857.681796,1634131641.221602,777889987.849198,5017774486.752596,599659,122800,175645,898104
2012-04-02,EDGX (K),223890663,65779511,129315046,418985220,6700349290.602083,2848384019.312603,3906436937.051296,13455170246.965982,1091055,180585,550225,1821865
2012-04-02,CHX (M),9805201,7607006,5177583,22589790,322624495.009400,579835770.362800,418660807.730900,1321121073.103100,1211,2740,592,4543
2012-04-02,NYSE (N),763489200,0,0,763489200,24653165978.418055,0.000000,0.000000,24653165978.418055,2246489,0,0,2246489
2012-04-02,NYSE Arca (P),339315661,231642918,188491804,759450383,10666475372.026152,12701050986.564000,7606745650.255092,30974272008.845244,1851226,532238,871765,3255229
2012-04-02,NASDAQ (Q),509470109,229516457,470900151,1209886717,16028440653.406745,14196755111.554468,14916487206.794853,45141682971.756066,2957465,779392,2037152,5774009
2012-04-02,CBSX (W),7678579,3533360,5602687,16814626,175885955.630000,176221343.590000,92917948.390300,445025247.610300,42305,6744,20474,69523
2012-04-02,NASDAQ PSX (X),27395871,25820803,28379713,81596387,648473337.335000,1808405363.345000,601994839.408000,3058873540.088000,142421,55678,97654,295753
2012-04-02,BATS BYX (Y),103151450,33867455,50493283,187512188,2754091494.461000,1579136461.840001,1175824121.806501,5509052078.107502,708016,132368,312326,1152710
2012-04-02,BATS BZX (Z),247553494,144184805,166470924,558209223,7528980395.303904,8085236908.334820,4818649034.257150,20432866337.895874,1585717,485089,921035,2991841
2012-03-30,NYSE MKT (A),0,13339785,2181448,15521233,0.000000,106168594.946100,36616947.145200,142785542.091300,0,22774,9393,32167
2012-03-30,NASDAQ BX (B),104791626,26787199,52653482,184232307,2681845998.449999,1142251441.470000,1799066937.715106,5623164377.635105,670960,102445,329159,1102564
2012-03-30,NSX (C),11956530,4009469,8456239,24422238,320912748.451100,139002915.552900,264937142.462300,724852806.466300,42131,8644,24122,74897
2012-03-30,NYSE (DN),65601571,11768213,39211994,116581778,2038408328.863299,615869205.776100,1398670616.958599,4052948151.597998,375133,42684,195166,612983
2012-03-30,NASDAQ (DQ),1025274853,279260248,607303428,1911838529,27606676949.834953,13091088510.344693,17860041984.707817,58557807444.887463,2978504,465264,1441625,4885393
2012-03-30,EDGA (J),94299041,31121375,43046011,168466427,2419660548.623300,1461417423.950001,1102714398.419402,4983792370.992703,541098,105347,251656,898101
2012-03-30,EDGX (K),189050806,51113669,120668156,360832631,5459192094.566704,2313233611.113301,3845891649.885787,11618317355.565792,887451,148067,495795,1531313
2012-03-30,CHX (M),7654322,10339132,4681843,22675297,235566129.167000,842954337.431100,196984944.799400,1275505411.397500,393,2098,557,3048
2012-03-30,NYSE (N),966408641,0,0,966408641,31186856197.718737,0.000000,0.000000,31186856197.718737,2181267,0,0,2181267
2012-03-30,NYSE Arca (P),356125468,204032913,192922319,753080700,11068019956.417919,11066767323.812330,8707572986.573439,30842360266.803688,1911948,464527,905238,3281713
2012-03-30,NASDAQ (Q),486588204,186493693,536261180,1209343077,15037730662.666991,11886336919.843137,16507082124.078613,43431149706.588741,2727796,612677,1942136,5282609
2012-03-30,CBSX (W),7956059,4358632,3031528,15346219,175397792.390000,290114151.194300,65166038.900000,530677982.484300,37315,5000,15941,58256
2012-03-30,NASDAQ PSX (X),24217594,23344573,25614522,73176689,539903655.645000,1718396475.635000,558398124.849999,2816698256.129999,122381,48095,90429,260905
2012-03-30,BATS BYX (Y),92940853,27182973,46896262,167020088,2413566737.345695,1208827421.335000,1197442871.648401,4819837030.329096,603804,110016,282243,996063
2012-03-30,BATS BZX (Z),244913590,115429418,162902351,523245359,7115909806.442590,6704899913.158110,5150140173.961612,18970949893.562312,1469732,411429,899575,2780736
2012-03-29,NYSE MKT (A),0,11460099,3320510,14780609,0.000000,74292541.339100,66896449.380000,141188990.719100,0,24720,12543,37263
2012-03-29,NASDAQ BX (B),116316870,31453559,55513354,203283783,2783517540.259600,1282982342.046000,2008821707.342896,6075321589.648496,695064,125286,349416,1169766
2012-03-29,NSX (C),14219670,5061828,7884227,27165725,399424736.998300,176911152.407200,279102657.651800,855438547.057300,49935,11024,26581,87540
2012-03-29,NYSE (DN),72971357,15114929,37090365,125176651,2258941246.841899,807798259.675500,1313240537.026703,4379980043.544102,396228,47165,183303,626696
2012-03-29,NASDAQ (DQ),1096111692,360260078,554536823,2010908593,29374520643.271027,15980393835.546700,16886125587.664116,62241040066.481843,3176584,524316,1426032,5126932
2012-03-29,EDGA (J),107295211,39706039,44713287,191714537,2675916314.882797,1610803717.226002,1165952422.216598,5452672454.325397,592338,121662,258992,972992
2012-03-29,EDGX (K),224173632,63558844,120034392,407766868,6271622127.773605,2753342678.767097,3881586097.262005,12906550903.802707,1003913,179570,529787,1713270
2012-03-29,CHX (M),13725067,8865256,6555520,29145843,332558781.915200,800369779.730000,255422484.775500,1388351046.420700,759,2534,571,3864
2012-03-29,NYSE (N),817404861,0,0,817404861,26024596394.998892,0.000000,0.000000,26024596394.998892,2329939,0,0,2329939
2012-03-29,NYSE Arca (P),404733403,249365347,213513437,867612187,12382108336.892986,12803805650.979390,9047277160.303921,34233191148.176297,2141355,562571,1006620,3710546
2012-03-29,NASDAQ (Q),553222863,236290523,473955969,1263469355,16866780194.419653,14093837317.560505,14458884851.449604,45419502363.429762,3076279,741236,2026613,5844128
2012-03-29,CBSX (W),8341862,4808989,3331087,16481938,174152977.180000,212196152.485800,49736609.665000,436085739.330800,36421,5794,12883,55098
2012-03-29,NASDAQ PSX (X),27624018,27961708,26479670,82065396,622560567.430000,2021768274.300000,552278531.085000,3196607372.815000,137436,58423,95352,291211
2012-03-29,BATS BYX (Y),104503846,35467387,50360188,190331421,2619361230.089998,1551054689.812999,1203352243.162497,5373768163.065494,662093,143832,299047,1104972
2012-03-29,BATS BZX (Z),271525415,157413914,172192643,601131972,7897776093.262996,8728854238.650580,5082053849.483208,21708684181.396784,1635943,525442,935220,3096605
2012-03-28,NYSE MKT (A),0,12052089,2220077,14272166,0.000000,74744122.765900,47129113.940000,121873236.705900,0,26387,10334,36721
2012-03-28,NASDAQ BX (B),105152661,36069817,51317626,192540104,2656954438.272399,1466824600.819999,1927712030.577205,6051491069.669603,682001,132847,333141,1147989
2012-03-28,NSX (C),15322787,4782038,7871729,27976554,431065981.754700,172190223.467600,265491937.347202,868748142.569502,54454,11711,27475,93640
2012-03-28,NYSE (DN),80102793,17073839,33747759,130924391,2417591620.211300,870839050.192000,1250138909.335799,4538569579.739099,425979,50846,164448,641273
2012-03-28,NASDAQ (DQ),1136414784,343750560,571857675,2052023019,31062255656.702860,14839889819.789691,18156469067.847149,64058614544.339700,3356896,576609,1523462,5456967
2012-03-28,EDGA (J),106219419,35086244,42484708,183790371,2739150711.099603,1504918923.141201,1118258760.771902,5362328395.012706,604638,113481,253492,971611
2012-03-28,EDGX (K),237249300,66794922,126660402,430704624,6767454464.355290,2760075596.667404,4220145644.645731,13747675705.668425,1071495,188171,569313,1828979
2012-03-28,CHX (M),9494674,10245838,4631251,24371763,296970136.576600,712360880.040100,289716651.287200,1299047667.903900,1338,2575,364,4277
2012-03-28,NYSE (N),817028680,0,0,817028680,26319378778.331832,0.000000,0.000000,26319378778.331832,2333726,0,0,2333726
2012-03-28,NYSE Arca (P),411326452,249850510,209410460,870587422,12502970397.202712,13064366483.736447,9358330693.947844,34925667574.887003,2180756,587904,1030720,3799380
2012-03-28,NASDAQ (Q),563604994,235381212,474704629,1273690835,17171069312.790025,13713936728.002793,15367518106.832191,46252524147.625009,3129999,774272,2072671,5976942
2012-03-28,CBSX (W),8168345,4951693,4778815,17898853,189150385.730000,267050985.260000,74702634.758400,530904005.748400,40428,5947,17717,64092
2012-03-28,NASDAQ PSX (X),27309185,20949635,25708186,73967006,619178988.920000,1390217019.850000,540553885.290000,2549949894.060000,137388,44955,97783,280126
2012-03-28,BATS BYX (Y),105889859,33979421,49208455,189077735,2734852849.189996,1421376409.090001,1222628892.140202,5378858150.420199,696418,137444,304989,1138851
2012-03-28,BATS BZX (Z),268708117,146949502,164406381,580064000,7827735423.363800,8194390001.524003,5047313080.222422,21069438505.110225,1619498,526223,940291,3086012
2012-03-27,NYSE MKT (A),0,9326676,2416506,11743182,0.000000,61348296.341800,56716581.700000,118064878.041800,0,24354,11550,35904
2012-03-27,NASDAQ BX (B),100465531,25920539,49853734,176239804,2604131517.225004,1101666041.467800,1899033411.750204,5604830970.443008,661160,104430,323074,1088664
2012-03-27,NSX (C),13860677,3913862,8797428,26571967,376130105.536000,119282113.345300,302191666.291099,797603885.172399,48450,9015,27659,85124
2012-03-27,NYSE (DN),80703824,11778639,37382416,129864879,2558457911.418302,554496403.568800,1323991300.445402,4436945615.432504,428845,39402,179842,648089
2012-03-27,NASDAQ (DQ),1104174137,294867892,583442933,1982484962,29676654404.732482,14014809554.593867,17026997343.177231,60718461302.503580,3209704,465312,1473020,5148036
2012-03-27,EDGA (J),93919792,25857911,39774550,159552253,2479512703.929997,1292139041.507499,983327109.479399,4754978854.916895,540234,90912,227325,858471
2012-03-27,EDGX (K),211611978,53208074,119623313,384443365,6087718645.360114,2301744154.965797,4113321160.528947,12502783960.854858,941051,153784,503422,1598257
2012-03-27,CHX (M),11273582,8971716,5894693,26139991,390517181.210400,826084932.786000,403534953.507000,1620137067.503400,1372,2326,660,4358
2012-03-27,NYSE (N),730240858,0,0,730240858,23420599726.844378,0.000000,0.000000,23420599726.844378,2072024,0,0,2072024
2012-03-27,NYSE Arca (P),350191897,198013668,188445111,736650676,10954238145.317863,10453647672.900608,8150463466.445315,29558349284.663786,1856841,448870,853084,3158795
2012-03-27,NASDAQ (Q),463367761,169998469,415580685,1048946915,14498659333.770568,10490254080.611499,13189568846.697218,38178482261.079285,2611703,613637,1790060,5015400
2012-03-27,CBSX (W),7002018,2307634,2724654,12034306,165091588.330000,87999175.454000,52817585.468500,305908349.252500,36665,5385,12500,54550
2012-03-27,NASDAQ PSX (X),23277760,16566039,23227338,63071137,527977570.865000,1185917452.030000,473131201.925000,2187026224.820000,123190,39824,89856,252870
2012-03-27,BATS BYX (Y),91221168,25494193,42934729,159650090,2424085175.550004,1065984135.135000,1045902311.515698,4535971622.200702,602777,106895,263699,973371
2012-03-27,BATS BZX (Z),233368505,107043248,151588013,491999766,7057801777.040502,5878475004.010094,4582924535.249670,17519201316.300266,1426420,389893,833693,2650006
2012-03-26,NYSE MKT (A),0,11292742,2143147,13435889,0.000000,70814245.262600,52120853.547900,122935098.810500,0,25630,10060,35690
2012-03-26,NASDAQ BX (B),100975796,31131589,50261756,182369141,2654191954.704996,1474211325.237699,1776559807.286000,5904963087.228695,660880,107907,328572,1097359
2012-03-26,NSX (C),13017144,4078422,8889459,25985025,361659183.035300,142957064.753500,309205143.458302,813821391.247102,43082,10175,26859,80116
2012-03-26,NYSE (DN),78552363,14800094,33459193,126811650,2390810422.202801,767487473.205600,1239043554.569300,4397341449.977701,408724,51546,168558,628828
2012-03-26,NASDAQ (DQ),1186540152,338735584,574664805,2099940541,32632299889.021997,14836615581.112468,17163719720.662846,64632635190.797311,3082440,514314,1487706,5084460
2012-03-26,EDGA (J),91740910,32404304,38594496,162739710,2410816188.418498,1630654139.936000,1065664867.825204,5107135196.179702,524834,101405,224848,851087
2012-03-26,EDGX (K),208060381,57455782,117382130,382898293,6088589141.076100,2540589077.302397,4271099742.954313,12900277961.332810,923713,155671,505931,1585315
2012-03-26,CHX (M),11354614,10517052,7803331,29674997,212934868.992000,1047229792.712200,182192602.256000,1442357263.960200,931,2755,607,4293
2012-03-26,NYSE (N),754941093,0,0,754941093,24710376183.867044,0.000000,0.000000,24710376183.867044,2096541,0,0,2096541
2012-03-26,NYSE Arca (P),337219393,202860001,176703262,716782656,10650146963.679173,10755433321.335979,7931152922.010095,29336733207.025247,1825779,477728,875548,3179055
2012-03-26,NASDAQ (Q),449979718,191668172,415685864,1057333754,14213872278.296437,11483547539.432009,13892965197.363464,39590385015.091910,2559305,614133,1834165,5007603
2012-03-26,CBSX (W),7734522,4667898,4015199,16417619,169870029.630000,258806590.301600,99689137.200000,528365757.131600,40166,5224,19852,65242
2012-03-26,NASDAQ PSX (X),23622354,20272818,21082049,64977221,523876208.430000,1245390277.340000,510699014.675000,2279965500.445000,121542,42722,82787,247051
2012-03-26,BATS BYX (Y),85997630,28921160,41788504,156707294,2323306164.075004,1221665935.715000,1132398375.301103,4677370475.091107,584107,112980,261623,958710
2012-03-26,BATS BZX (Z),226351457,119114058,141211763,486677278,6783762151.705016,6663269005.225604,4539044341.347458,17986075498.278078,1378075,413882,814873,2606830
2012-03-23,NYSE MKT (A),0,11065593,2358644,13424237,0.000000,72249582.768500,56202466.690000,128452049.458500,0,23330,11616,34946
2012-03-23,NASDAQ BX (B),97512663,29272037,46072637,172857337,2492644150.095003,1262164188.172501,1684735942.398998,5439544280.666502,616340,111530,292700,1020570
2012-03-23,NSX (C),11322483,3761887,7745195,22829565,325793382.933900,123850561.427800,244125344.933501,693769289.295201,42686,9563,24092,76341
2012-03-23,NYSE (DN),74233422,15904184,32674952,122812558,2335780177.204400,829315086.013400,1145840143.869900,4310935407.087700,403124,50988,158127,612239
2012-03-23,NASDAQ (DQ),1137370409,294681402,466335456,1898387267,30658221212.329204,12043625989.171982,13715768770.223742,56417615971.724928,2934566,494482,1257721,4686769
2012-03-23,EDGA (J),86224935,32640715,35432912,154298562,2246678006.695004,1528152472.040402,965664389.853400,4740494868.588806,489086,107964,206578,803628
2012-03-23,EDGX (K),203611283,61412522,103013725,368037530,5761511201.680197,2730064849.961502,3187952450.361983,11679528502.003682,926477,178915,471069,1576461
2012-03-23,CHX (M),8721743,12916802,3189496,24828041,250784909.869800,1048672024.871600,195688428.941900,1495145363.683300,746,2821,560,4127
2012-03-23,NYSE (N),741765974,0,0,741765974,23779959238.529971,0.000000,0.000000,23779959238.529971,2100167,0,0,2100167
2012-03-23,NYSE Arca (P),337445832,197225346,163790782,698461960,10485775133.472911,10487612711.354117,6918207066.928338,27891594911.755366,1845220,508514,822480,3176214
2012-03-23,NASDAQ (Q),486377166,203096883,408181184,1097655233,14961908109.862400,11841827134.865503,12636934837.171396,39440670081.899299,2756261,718531,1756767,5231559
2012-03-23,CBSX (W),7191625,2371246,2698681,12261552,157833525.060000,101260435.030000,51219009.300000,310312969.390000,35786,4898,12672,53356
2012-03-23,NASDAQ PSX (X),21409951,23113624,18792255,63315830,482045976.030000,1594219697.320000,445818869.035000,2522084542.385000,111860,51891,74039,237790
2012-03-23,BATS BYX (Y),84116702,28531201,38856726,151504629,2172706642.620000,1208834447.975000,994445842.626501,4375986933.221501,553771,117679,240234,911684
2012-03-23,BATS BZX (Z),175397716,110636813,107634099,393668628,5142037381.673589,6090217685.281718,3225219019.369327,14457474086.324634,1077086,422350,608110,2107546
2012-03-22,NYSE MKT (A),0,10624845,2314749,12939594,0.000000,61472920.611900,59193704.300000,120666624.911900,0,21527,10651,32178
2012-03-22,NASDAQ BX (B),102583232,35529819,46373297,184486348,2667356449.296399,1420755253.340100,1912634878.776799,6000746581.413298,675495,124916,319381,1119792
2012-03-22,NSX (C),13623301,5208595,7831296,26663192,374123065.983400,151883691.280500,320854318.872399,846861076.136299,48918,12250,24807,85975
2012-03-22,NYSE (DN),82504457,18118441,31842915,132465813,2612313148.262202,967112266.755400,1161080323.641700,4740505738.659302,440009,55574,162362,657945
2012-03-22,NASDAQ (DQ),1176343881,345203224,485210041,2006757146,32563798246.384964,14886892836.859784,16008005743.644262,63458696826.889010,3127973,573191,1320365,5021529
2012-03-22,EDGA (J),95994202,40605258,38354323,174953783,2477058663.895998,1882324752.738901,1092754202.938399,5452137619.573298,543901,135863,231565,911329
2012-03-22,EDGX (K),233835654,77382514,111194656,422412824,6792698872.072395,3115115444.496099,3869060204.772905,13776874521.341399,1062974,210346,500606,1773926
2012-03-22,CHX (M),8498240,10984156,4446342,23928738,304141270.683400,818796617.756500,100419546.857000,1223357435.296900,1051,3141,595,4787
2012-03-22,NYSE (N),762971351,0,0,762971351,24087175968.739916,0.000000,0.000000,24087175968.739916,2248908,0,0,2248908
2012-03-22,NYSE Arca (P),361730960,251733873,176371874,789836707,11164617041.181209,12805435281.460844,8424175824.224339,32394228146.866392,1947838,594983,894343,3437164
2012-03-22,NASDAQ (Q),513509654,238893638,410865380,1163268672,16016889420.252131,13956427234.576231,13842638867.120527,43815955521.948889,2903022,794692,1859870,5557584
2012-03-22,CBSX (W),7803000,4044530,3423055,15270585,177451707.190000,200474625.359200,68514009.780000,446440342.329200,36981,6885,17049,60915
2012-03-22,NASDAQ PSX (X),24626059,26204761,21032521,71863341,554606957.240000,1740178827.885000,537112430.345000,2831898215.470000,125193,58020,82210,265423
2012-03-22,BATS BYX (Y),101416143,37815350,42120161,181351654,2675043684.478201,1592114020.374999,1154712006.904800,5421869711.758000,666364,138948,272779,1078091
2012-03-22,BATS BZX (Z),260624832,170451529,149658742,580735103,7877849873.722582,8719480550.050975,5160035301.862456,21757365725.636013,1617980,571081,889751,3078812
2012-03-21,NYSE MKT (A),0,11276281,2687249,13963530,0.000000,60105062.444900,63537946.760000,123643009.204900,0,22544,12637,35181
2012-03-21,NASDAQ BX (B),102742833,26411527,46868267,176022627,2701169473.100004,1080050893.575001,1916438072.560308,5697658439.235313,635489,99671,311500,1046660
2012-03-21,NSX (C),12397823,4419712,7273690,24091225,347114621.118100,112737396.135600,281970521.451800,741822538.705500,45207,10305,24485,79997
2012-03-21,NYSE (DN),78139386,12946591,32424845,123510822,2354015996.962099,697063658.473100,1329652861.393301,4380732516.828500,396391,43195,165642,605228
2012-03-21,NASDAQ (DQ),1110307392,279506904,527449166,1917263462,28552034172.867613,12832354456.639923,17625943882.492809,59010332512.000345,2889258,445640,1332672,4667570
2012-03-21,EDGA (J),95444429,30183654,37627759,163255842,2429761918.125002,1514728627.454399,1090088580.472496,5034579126.051897,512904,104998,224595,842497
2012-03-21,EDGX (K),230032811,53097310,117263893,400394014,6525276822.574289,2341938012.435897,4026573624.857913,12893788459.868099,999714,154507,515510,1669731
2012-03-21,CHX (M),9443409,13315043,4133500,26891952,303565090.713500,875806246.844000,358948408.793600,1538319746.351100,790,2043,610,3443
2012-03-21,NYSE (N),726466275,0,0,726466275,23244508278.346212,0.000000,0.000000,23244508278.346212,2074652,0,0,2074652
2012-03-21,NYSE Arca (P),346794447,196811902,173966820,717573169,10572737455.102684,10158264216.683414,8324078705.153203,29055080376.939301,1761422,467504,865866,3094792
2012-03-21,NASDAQ (Q),492782493,190458305,408521634,1091762432,15176272181.307834,11836235891.055041,13944728888.343191,40957236960.706066,2709964,706024,1836508,5252496
2012-03-21,CBSX (W),6583430,2085687,2489676,11158793,161321362.810000,88656091.850000,55946686.320000,305924140.980000,31150,4774,11592,47516
2012-03-21,NASDAQ PSX (X),24020372,19447892,19795625,63263889,537017777.815000,1276267622.130000,476083169.635000,2289368569.580000,117902,42703,81286,241891
2012-03-21,BATS BYX (Y),94910070,27110748,38052965,160073783,2474364187.574997,1203704030.444001,1095772458.155000,4773840676.173998,593605,109604,247961,951170
2012-03-21,BATS BZX (Z),247749367,128350020,146058159,522157546,7417152880.484685,7001484636.379390,4935397798.855211,19354035315.719286,1487273,442375,868029,2797677
2012-03-20,NYSE MKT (A),0,10784232,2416392,13200624,0.000000,66439762.563000,57981370.718000,124421133.281000,0,23629,11663,35292
2012-03-20,NASDAQ BX (B),102002559,29503639,43726157,175232355,2555635504.729996,1220319221.381703,1966439877.419997,5742394603.531696,621503,113846,287812,1023161
2012-03-20,NSX (C),14344451,4750533,8079409,27174393,401947003.818400,141874411.563400,320853556.479000,864674971.860800,47967,11156,24718,83841
2012-03-20,NYSE (DN),86340773,13901014,34624023,134865810,2572107469.843398,751145275.419700,1420338632.441201,4743591377.704299,438380,44788,170444,653612
2012-03-20,NASDAQ (DQ),1182056933,303329420,504901141,1990287494,30094939618.869366,13258687565.662021,17599688488.069553,60953315672.600940,3056590,498252,1321218,4876060
2012-03-20,EDGA (J),102332468,34037005,37822668,174192141,2547437513.500003,1631453547.353200,1156287065.000404,5335178125.853607,537008,119461,223415,879884
2012-03-20,EDGX (K),241454628,55955011,115823820,413233459,6576694635.369713,2497269492.950198,4285543360.665246,13359507488.985157,981117,165968,507240,1654325
2012-03-20,CHX (M),7143184,12181104,7798366,27122654,248719709.960000,736625869.395100,669380953.505000,1654726532.860100,949,2672,780,4401
2012-03-20,NYSE (N),711143726,0,0,711143726,22365902825.950864,0.000000,0.000000,22365902825.950864,2061029,0,0,2061029
2012-03-20,NYSE Arca (P),363205482,207780779,174124007,745110268,10487046757.496227,10690898702.347828,8556633017.945629,29734578477.789684,1784676,497566,854052,3136294
2012-03-20,NASDAQ (Q),498431116,199667800,394401908,1092500824,14947347801.027837,12509672184.841239,13614105979.569506,41071125965.438582,2695893,722689,1797279,5215861
2012-03-20,CBSX (W),7152398,1739541,2466189,11358128,159590929.135000,85067168.180000,48524028.827200,293182126.142200,32734,5131,11216,49081
2012-03-20,NASDAQ PSX (X),24587846,20320865,22249939,67158650,527357626.790000,1455839183.820000,525497129.075000,2508693939.685000,115458,47807,79282,242547
2012-03-20,BATS BYX (Y),95861901,27026677,36290322,159178900,2494655832.918798,1196613650.122000,1083300097.700202,4774569580.741000,587593,109789,231134,928516
2012-03-20,BATS BZX (Z),264919805,131370891,149368032,545658728,7638029426.165018,7336247016.307890,5017213439.595413,19991489882.068321,1515039,461444,856490,2832973
2012-03-19,NYSE MKT (A),0,11589374,2433838,14023212,0.000000,69007313.211700,54206795.810000,123214109.021700,0,25030,11500,36530
2012-03-19,NASDAQ BX (B),119593368,29953587,49937309,199484264,2705364766.250001,1150050407.371000,2033662818.234604,5889077991.855605,685224,106279,333012,1124515
2012-03-19,NSX (C),14795205,5004416,8956676,28756297,354039594.197700,135000729.361500,288939633.905697,777979957.464897,43744,11076,25879,80699
2012-03-19,NYSE (DN),90848679,17356080,35555859,143760618,2505874925.716698,879523503.321801,1553042293.204004,4938440722.242503,427294,50998,178971,657263
2012-03-19,NASDAQ (DQ),1279932124,341554642,506656657,2128143423,30405199275.548018,15099781564.007351,18190283121.026100,63695263960.581469,3268500,529588,1431233,5229321
2012-03-19,EDGA (J),105569602,33713831,37308624,176592057,2440228690.130797,1603407345.807801,1150536397.832100,5194172433.770698,523320,111219,224397,858936
2012-03-19,EDGX (K),255162883,57695507,108068945,420927335,6323423202.240386,2408205612.793493,4075347025.784803,12806975840.818682,906098,156515,459951,1522564
2012-03-19,CHX (M),13942963,11788110,8476002,34207075,534657065.412200,1109227391.324400,403108851.987200,2046993308.723800,1147,2525,724,4396
2012-03-19,NYSE (N),721408595,0,0,721408595,21711089104.444683,0.000000,0.000000,21711089104.444683,2099018,0,0,2099018
2012-03-19,NYSE Arca (P),380582901,213361773,174426018,768370692,10390892076.706724,11237495955.201798,9199072251.216236,30827460283.124758,1787079,499712,876488,3163279
2012-03-19,NASDAQ (Q),536583787,213145464,403908636,1153637887,15420258078.300513,12505750277.448409,14729993423.807947,42656001779.556869,2764247,720502,1855130,5339879
2012-03-19,CBSX (W),8411349,2212123,3303267,13926739,159391757.040000,104479812.320000,59684162.231600,323555731.591600,31567,5334,14482,51383
2012-03-19,NASDAQ PSX (X),30433488,20706756,22101104,73241348,636504524.020000,1359548771.410000,566246990.495000,2562300285.925000,130689,47825,85702,264216
2012-03-19,BATS BYX (Y),105678414,29138574,40689645,175506633,2572496474.145003,1208791065.369999,1227297444.417603,5008584983.932605,629696,114595,257097,1001388
2012-03-19,BATS BZX (Z),267792909,132723288,152190754,552706951,7377989272.940896,7511842429.705605,5412671626.952900,20302503329.599401,1512357,474892,894699,2881948
2012-03-16,NYSE MKT (A),0,39151143,3048433,42199576,0.000000,285439529.166500,68953020.620600,354392549.787100,0,33409,12580,45989
2012-03-16,NASDAQ BX (B),124528591,26782224,51114802,202425617,2902769374.335004,1030807386.099999,1664796560.118603,5598373320.553606,749499,99843,336628,1185970
2012-03-16,NSX (C),14997246,4015047,8177057,27189350,375076116.455300,132376008.136000,279267323.706201,786719448.297501,47664,10333,24856,82853
2012-03-16,NYSE (DN),97999600,17357735,37697795,153055130,2962797875.423497,873244431.394701,1434268971.011597,5270311277.829795,483455,57967,192057,733479
2012-03-16,NASDAQ (DQ),1523412989,343233462,670749698,2537396149,38643373624.529239,16919272782.780312,21377977997.084473,76940624404.394024,3382202,490983,1446627,5319812
2012-03-16,EDGA (J),108714179,35119847,41485851,185319877,2636417604.222503,1751246113.841600,1227632773.170702,5615296491.234805,572625,119152,249070,940847
2012-03-16,EDGX (K),281481046,63183010,120929854,465593910,7183559117.226893,3044882807.242396,3894360879.615209,14122802804.084498,1086491,177148,530549,1794188
2012-03-16,CHX (M),12049162,18787781,3637500,34474443,341843921.799700,1229353229.557400,152754706.719400,1723951858.076500,458,2372,402,3232
2012-03-16,NYSE (N),1648061567,0,0,1648061567,53645784878.041023,0.000000,0.000000,53645784878.041023,2261404,0,0,2261404
2012-03-16,NYSE Arca (P),390973941,221857275,175491276,788322492,11099215897.534088,12171277810.781628,8338627716.573261,31609121424.888977,1868451,495823,855676,3219950
2012-03-16,NASDAQ (Q),538855572,194058329,811521000,1544434901,15431706698.478998,11990529227.345804,25829788318.369019,53252024244.193821,2777820,629112,1875979,5282911
2012-03-16,CBSX (W),5462017,1822527,4090579,11375123,113858115.400000,83083771.928500,70083978.800000,267025866.128500,23298,4641,17065,45004
2012-03-16,NASDAQ PSX (X),30569083,20571209,22198588,73338880,641255565.695000,1554976335.775000,467114992.100000,2663346893.570000,135569,45843,88918,270330
2012-03-16,BATS BYX (Y),109730338,30810333,43022754,183563425,2765252079.145002,1336753232.840000,1115411170.410000,5217416482.395002,673180,114710,263656,1051546
2012-03-16,BATS BZX (Z),278224096,114558417,154230108,547012621,7715117738.535320,6498670248.079510,5091205239.768012,19304993226.382842,1563873,413914,888834,2866621
2012-03-15,NYSE MKT (A),0,12028757,4098511,16127268,0.000000,93857363.446400,92578258.386500,186435621.832900,0,30332,14967,45299
2012-03-15,NASDAQ BX (B),121698740,30883398,52841281,205423419,2874042980.850000,1201266629.637901,2027916246.442696,6103225856.930597,754195,117116,350608,1221919
2012-03-15,NSX (C),16790167,4424407,7297550,28512124,411716223.365500,151040969.117100,399151241.838701,961908434.321301,52783,9492,24472,86747
2012-03-15,NYSE (DN),95217110,18212929,39627111,153057150,2717328089.681701,867226274.335900,1875529188.945104,5460083552.962705,481570,51855,201736,735161
2012-03-15,NASDAQ (DQ),1303303077,355985031,547219689,2206507797,31708256686.619445,17620930754.004992,21114795199.241138,70443982639.865575,3505763,507633,1466879,5480275
2012-03-15,EDGA (J),117044285,41046066,44851669,202942020,2843082327.793597,2038924468.820297,1468158083.560095,6350164880.173989,622897,132254,269122,1024273
2012-03-15,EDGX (K),299815935,68870492,121459411,490145838,7681779635.427683,3021267541.634511,4818423627.562817,15521470804.625011,1179624,186883,561015,1927522
2012-03-15,CHX (M),11174992,12968814,5403536,29547342,488842718.189400,1004493116.870000,540198078.377100,2033533913.436500,1097,3629,511,5237
2012-03-15,NYSE (N),844455591,0,0,844455591,26493656288.998757,0.000000,0.000000,26493656288.998757,2345809,0,0,2345809
2012-03-15,NYSE Arca (P),403163360,236951329,182207654,822322343,11569790033.434094,13049515731.406431,10181008541.729868,34800314306.570393,1999540,562495,924522,3486557
2012-03-15,NASDAQ (Q),607875827,231826600,452848669,1292551096,17743591271.502663,14392184061.189206,16552787280.842825,48688562613.534694,3198285,783286,2004767,5986338
2012-03-15,CBSX (W),7140805,2560236,2264102,11965143,138962474.970000,106294006.480000,63013462.320000,308269943.770000,33124,5351,12928,51403
2012-03-15,NASDAQ PSX (X),29470928,20366403,20390813,70228144,619505138.380000,1351858919.755000,490924618.155000,2462288676.290000,136627,41560,85873,264060
2012-03-15,BATS BYX (Y),114712818,32885748,43945447,191544013,2885942630.352799,1418676449.810002,1266149598.493102,5570768678.655903,699323,119772,269431,1088526
2012-03-15,BATS BZX (Z),300969734,137500650,165067196,603537580,8383310417.537091,7712107561.135819,6158401380.448905,22253819359.121815,1700708,491044,934027,3125779
2012-03-14,NYSE MKT (A),0,14045083,2667366,16712449,0.000000,111911015.386900,68926211.790000,180837227.176900,0,30458,12753,43211
2012-03-14,NASDAQ BX (B),130945194,34303392,48347268,213595854,2993294032.740004,1312408337.477800,2260157413.809992,6565859784.027796,752332,124192,328702,1205226
2012-03-14,NSX (C),15398844,5688049,7771225,28858118,420152268.785600,173177098.371800,445364995.907099,1038694363.064499,47109,13929,24464,85502
2012-03-14,NYSE (DN),98393933,20673842,38359132,157426907,2768551112.750098,1066283988.855200,1920914163.072200,5755749264.677498,481409,64395,193085,738889
2012-03-14,NASDAQ (DQ),1388821809,392837290,545702791,2327361890,34951091719.236166,17699342149.961874,22809152484.973133,75459586354.171173,3570690,621613,1461532,5653835
2012-03-14,EDGA (J),127933869,43465528,42743375,214142772,2996196909.204996,1894495330.543000,1422642712.815904,6313334952.563900,639369,136226,256880,1032475
2012-03-14,EDGX (K),280926955,77192568,118058504,476178027,7464866337.118183,3548332404.407287,5284199388.644534,16297398130.170004,1141070,217375,533490,1891935
2012-03-14,CHX (M),14013824,14925173,2853512,31792509,336770763.197200,894982696.675801,266528821.846500,1498282281.719501,747,4879,773,6399
2012-03-14,NYSE (N),853216662,0,0,853216662,26302835085.980000,0.000000,0.000000,26302835085.980000,2364769,0,0,2364769
2012-03-14,NYSE Arca (P),444599246,266827246,190545758,901972250,12427659651.679989,13793093690.620070,12277022850.293324,38497776192.593383,2118955,613478,962628,3695061
2012-03-14,NASDAQ (Q),662539971,266973736,451550026,1381063733,19363122093.736316,15768803965.732890,17438548181.733906,52570474241.203112,3353996,858478,2028687,6241161
2012-03-14,CBSX (W),6988895,2897670,1511550,11398115,120652765.930000,136817272.690000,43222674.000000,300692712.620000,29003,6356,9280,44639
2012-03-14,NASDAQ PSX (X),35081538,25987152,23922470,84991160,740310201.970000,1828231367.200000,589741749.420000,3158283318.590000,146050,54499,78260,278809
2012-03-14,BATS BYX (Y),127103285,39108390,40223987,206435662,3151160575.164001,1653166165.939999,1282984334.968802,6087311076.072802,743385,138563,257785,1139733
2012-03-14,BATS BZX (Z),322501266,160990247,158114156,641605669,8766453618.100010,8689341317.920301,6349343896.675993,23805138832.696304,1744595,587847,912115,3244557
2012-03-13,NYSE MKT (A),0,9937124,3036056,12973180,0.000000,71647288.792400,69918191.670000,141565480.462400,0,25103,13519,38622
2012-03-13,NASDAQ BX (B),126418944,38997820,51368338,216785102,3091277827.239994,1614333413.319999,1809386055.541598,6514997296.101591,779068,131966,340529,1251563
2012-03-13,NSX (C),16043383,4997881,8063621,29104885,428315673.191300,172509892.153800,324211555.049799,925037120.394899,47687,10315,24061,82063
2012-03-13,NYSE (DN),101727402,21387254,36679140,159793796,3051242703.395301,1127293549.330000,1376205707.160199,5554741959.885500,486349,62653,182315,731317
2012-03-13,NASDAQ (DQ),1326232066,410722742,557572474,2294527282,34819764838.874519,18210042337.514117,17740085780.068226,70769892956.456862,3463339,576044,1475169,5514552
2012-03-13,EDGA (J),124090587,49655695,47738510,221484792,3198360962.585202,2325746185.829505,1365063462.586601,6889170611.001308,678243,147843,283759,1109845
2012-03-13,EDGX (K),274130581,86934956,129899318,490964855,7811048994.934412,3965215427.370397,4629727377.674951,16405991799.979760,1199934,216890,589342,2006166
2012-03-13,CHX (M),16628359,13657202,5061932,35347493,287881941.395000,1135843069.183300,232564387.008801,1656289397.587101,442,5649,751,6842
2012-03-13,NYSE (N),907482546,0,0,907482546,29920409642.411741,0.000000,0.000000,29920409642.411741,2496190,0,0,2496190
2012-03-13,NYSE Arca (P),420509569,292465306,189689400,902664275,12667525682.014402,15518978621.733748,8826135176.651299,37012639480.399449,2118761,603893,955179,3677833
2012-03-13,NASDAQ (Q),614343484,280424464,459580589,1354348537,18687215198.685179,16557962920.940626,14846514375.309090,50091692494.934895,3252943,843376,2027252,6123571
2012-03-13,CBSX (W),7510769,4217034,2434349,14162152,145890074.900000,142340972.950000,53494902.190000,341725950.040000,30728,5168,12852,48748
2012-03-13,NASDAQ PSX (X),33831216,33723638,23811773,91366627,758157497.455000,2279674523.580000,590406304.754999,3628238325.789999,158371,67845,97199,323415
2012-03-13,BATS BYX (Y),116259300,39942435,45043043,201244778,3114088369.604999,1828706686.000000,1284284098.525097,6227079154.130096,728647,138191,277828,1144666
2012-03-13,BATS BZX (Z),304803342,172109924,164885560,641798826,8825077634.003945,9766711519.217188,5405324785.859255,23997113939.080388,1746893,568938,951095,3266926
2012-03-12,NYSE MKT (A),0,9043529,2722170,11765699,0.000000,67750828.194400,55922385.269600,123673213.464000,0,22199,12142,34341
2012-03-12,NASDAQ BX (B),88489577,19479248,39357451,147326276,2205084976.602504,820741658.989000,1272984161.880002,4298810797.471506,598146,86790,277298,962234
2012-03-12,NSX (C),10957326,3182032,6793046,20932404,304524336.653900,118019244.849500,224438100.704601,646981682.208001,37614,7923,21889,67426
2012-03-12,NYSE (DN),49513434,12385838,21165653,83064925,1584638099.148700,559707348.509700,777550974.894101,2921896422.552501,307926,42878,128961,479765
2012-03-12,NASDAQ (DQ),937000766,234887415,423172899,1595061080,25747202417.945647,10921196555.813084,12121367806.358541,48789766780.117272,2784749,393383,1205290,4383422
2012-03-12,EDGA (J),87321719,30397818,37834536,155554073,2343864738.530801,1438714569.759000,1010758482.473596,4793337790.763397,520010,103604,234905,858519
2012-03-12,EDGX (K),188588254,46502741,103350560,338441555,5562023704.051700,2156243725.409001,3264327316.609183,10982594746.069884,904183,136134,474629,1514946
2012-03-12,CHX (M),7191746,5743234,2847771,15782751,251380399.617600,490894183.124900,101564643.594000,843839226.336500,1127,2213,490,3830
2012-03-12,NYSE (N),643720676,0,0,643720676,21016890020.045210,0.000000,0.000000,21016890020.045210,1966778,0,0,1966778
2012-03-12,NYSE Arca (P),293805369,160075553,154872897,608753819,8971775357.517686,8589251881.509409,6019260594.525539,23580287833.552634,1608033,417477,783244,2808754
2012-03-12,NASDAQ (Q),432863926,158097290,355327791,946289007,13624416658.868101,9307111446.425236,10906254042.287916,33837782147.581253,2511879,543256,1664563,4719698
2012-03-12,CBSX (W),4014251,2182049,1911340,8107640,86358025.830000,135633468.610000,42937072.780000,264928567.220000,22607,4259,9937,36803
2012-03-12,NASDAQ PSX (X),22830027,15343705,19868608,58042340,538606608.285000,1042814467.215000,413267379.980000,1994688455.480000,123354,36774,82771,242899
2012-03-12,BATS BYX (Y),84118124,22795980,35582832,142496936,2286473221.636005,1038859794.331001,916071969.854999,4241404985.822005,565833,96846,235771,898450
2012-03-12,BATS BZX (Z),224948355,97421777,140144324,462514456,6698945910.851618,5596467052.997805,3954384353.495109,16249797317.344532,1374762,382994,800944,2558700
2012-03-09,NYSE MKT (A),0,10039662,2682215,12721877,0.000000,68240798.124000,64631467.877000,132872266.001000,0,21532,12692,34224
2012-03-09,NASDAQ BX (B),98081441,25008832,44530913,167621186,2341495535.214997,1027844172.730000,1477315556.715998,4846655264.660995,635954,98365,296448,1030767
2012-03-09,NSX (C),13696207,3766388,7326988,24789583,327532161.547700,113112290.385100,226386828.069099,667031280.001899,40427,8698,23257,72382
2012-03-09,NYSE (DN),86415576,17085821,34830605,138332002,2581295797.877903,851298226.846800,1166336175.165897,4598930199.890600,461139,50806,183662,695607
2012-03-09,NASDAQ (DQ),1179171480,313691205,534904807,2027767492,31452354948.245177,13386749971.090317,14604780978.235723,59443885897.571217,3102757,469687,1425814,4998258
2012-03-09,EDGA (J),95769980,34476132,40226132,170472244,2413174416.110805,1698162832.104998,1152539119.342798,5263876367.558601,543370,111498,240197,895065
2012-03-09,EDGX (K),221033243,58718666,113616087,393367996,6121858058.540202,2673100116.667097,3570248462.695639,12365206637.902938,967525,154206,524410,1646141
2012-03-09,CHX (M),9250080,8393916,3581081,21225077,321443937.801300,697506198.926500,122162000.507000,1141112137.234800,904,3837,509,5250
2012-03-09,NYSE (N),719249555,0,0,719249555,22241710784.549808,0.000000,0.000000,22241710784.549808,2123866,0,0,2123866
2012-03-09,NYSE Arca (P),339502245,201312170,173604076,714418491,9946957327.929360,10941121189.659011,6985840964.450089,27873919482.038460,1751413,466852,879017,3097282
2012-03-09,NASDAQ (Q),503283974,198916708,421818229,1124018911,14813506742.887656,11671460050.650975,13068711213.043348,39553678006.581979,2694555,626582,1870841,5191978
2012-03-09,CBSX (W),5292016,2204910,2707594,10204520,106424814.278900,126901566.415000,50405379.010000,283731759.703900,26795,4001,10540,41336
2012-03-09,NASDAQ PSX (X),24690517,19085666,19308095,63084278,528218851.535000,1391915665.200001,464770305.390000,2384904822.125001,124302,43232,80839,248373
2012-03-09,BATS BYX (Y),95830174,29471983,38313003,163615160,2462613088.855002,1322963715.874999,1045328822.645002,4830905627.375003,607145,110376,249335,966856
2012-03-09,BATS BZX (Z),246195061,120429074,152837984,519462119,6918345712.059698,6803009225.785994,4614899104.975212,18336254042.820904,1440307,421092,886493,2747892
2012-03-08,NYSE MKT (A),0,8392390,2525171,10917561,0.000000,61710195.475300,66320377.350000,128030572.825300,0,20168,11417,31585
2012-03-08,NASDAQ BX (B),92828877,24738300,45368882,162936059,2198546494.730000,978396995.885001,1540478177.100002,4717421667.715003,608697,85521,295607,989825
2012-03-08,NSX (C),12404794,3383334,7355927,23144055,337518957.776100,111525494.560400,232917295.117800,681961747.454300,41065,8592,23045,72702
2012-03-08,NYSE (DN),80305803,15600872,35963025,131869700,2551686405.300096,796660244.029500,1166526347.450099,4514872996.779695,427046,49407,183029,659482
2012-03-08,NASDAQ (DQ),1133373654,285775707,526327817,1945477178,31172802719.324343,12072105690.174902,15002521760.336275,58247430169.835520,3134029,459858,1447480,5041367
2012-03-08,EDGA (J),96641057,31325255,44282523,172248835,2506513829.982503,1546412145.680000,1285879970.747902,5338805946.410405,572344,112082,268958,953384
2012-03-08,EDGX (K),213064356,56284208,117982564,387331128,6243734812.315491,2562237105.166008,3844660573.565293,12650632491.046792,994452,158865,534624,1687941
2012-03-08,CHX (M),9721378,7247976,8523282,25492636,312634272.213000,547550429.388500,224577024.325500,1084761725.927000,811,2407,505,3723
2012-03-08,NYSE (N),716609686,0,0,716609686,22631497698.779152,0.000000,0.000000,22631497698.779152,2161010,0,0,2161010
2012-03-08,NYSE Arca (P),336159975,190762273,192576401,719498649,10182617636.736015,10202993847.472503,7599155144.725048,27984766628.933566,1805965,455271,928669,3189905
2012-03-08,NASDAQ (Q),488744921,175731784,440122594,1104599299,14811347816.102263,10474925660.889008,13540910426.496078,38827183903.487349,2701633,556017,1940758,5198408
2012-03-08,CBSX (W),5158338,2801099,2398614,10358051,111731522.520000,148492299.830000,49882405.390000,310106227.740000,28315,4916,12616,45847
2012-03-08,NASDAQ PSX (X),22456599,17338716,21503218,61298533,531622426.110000,1311333931.815000,490871292.545000,2333827650.470000,121714,40204,84541,246459
2012-03-08,BATS BYX (Y),95589544,27477250,41298802,164365596,2579784631.562506,1147635852.210001,1108852372.719499,4836272856.492006,640773,109629,268448,1018850
2012-03-08,BATS BZX (Z),240864376,110027739,148402682,499294797,7001864364.114297,5921178940.924511,4362484951.737758,17285528256.776566,1465833,389456,867420,2722709
2012-03-07,NYSE MKT (A),0,8933144,2037574,10970718,0.000000,64758665.336000,47136003.740000,111894669.076000,0,21501,9848,31349
2012-03-07,NASDAQ BX (B),91221864,24830871,44140285,160193020,2061028892.335003,903094878.105000,1549178439.374007,4513302209.814010,565622,90021,284791,940434
2012-03-07,NSX (C),10315611,4084473,7755527,22155611,290629573.800400,141083093.845200,305376299.111599,737088966.757199,36857,9488,23572,69917
2012-03-07,NYSE (DN),69840995,15094218,33885538,118820751,2111057119.653701,719076156.068400,1260145182.052705,4090278457.774806,375093,41126,168026,584245
2012-03-07,NASDAQ (DQ),1099816519,328805606,510305467,1938927592,28049354108.641696,15516715510.293327,16730075190.414106,60296144809.349129,2964357,492594,1407072,4864023
2012-03-07,EDGA (J),98315696,34825579,44940303,178081578,2496208779.816999,1718347772.565000,1471640744.140302,5686197296.522301,552059,119556,266370,937985
2012-03-07,EDGX (K),200489806,55565402,115143013,371198221,5762675389.756498,2546362767.319403,4028560156.434504,12337598313.510405,932637,162052,519344,1614033
2012-03-07,CHX (M),11903162,8559560,3520368,23983090,458506207.160700,713558063.606600,117021223.796800,1289085494.564100,715,2831,742,4288
2012-03-07,NYSE (N),800913391,0,0,800913391,23834782094.379159,0.000000,0.000000,23834782094.379159,2143131,0,0,2143131
2012-03-07,NYSE Arca (P),318948191,186249280,180655007,685852478,9373014786.348482,10474990196.221808,8476986793.157813,28324991775.728103,1711849,468141,921131,3101121
2012-03-07,NASDAQ (Q),529163944,204146232,444580631,1177890807,15640371994.012899,12433738826.275652,13983044952.818960,42057155773.107511,2697298,653906,1936149,5287353
2012-03-07,CBSX (W),4177810,4502850,1834854,10515514,95679425.232000,333596664.770000,40518565.300000,469794655.302000,23889,4585,10638,39112
2012-03-07,NASDAQ PSX (X),17320836,17991978,17400213,52713027,407107481.215000,1393357450.044999,428424232.819999,2228889164.079998,81867,38114,56628,176609
2012-03-07,BATS BYX (Y),92354706,27359867,38967571,158682144,2480462895.000001,1152196582.575000,1103237527.484997,4735897005.059998,611024,106542,257159,974725
2012-03-07,BATS BZX (Z),234248589,115733609,149816251,499798449,6525493980.463502,6681367237.253220,4509786877.475163,17716648095.191885,1387399,415035,884451,2686885
2012-03-06,NYSE MKT (A),0,11827954,2458349,14286303,0.000000,81652445.050100,62528570.840400,144181015.890500,0,25959,13325,39284
2012-03-06,NASDAQ BX (B),110191950,36808546,49248730,196249226,2504069111.770000,1426233120.084999,1731076003.512499,5661378235.367498,685729,131792,321529,1139050
2012-03-06,NSX (C),13996543,6426028,8526677,28949248,383916828.227700,221482196.453200,275323944.075602,880722968.756502,47371,14407,26619,88397
2012-03-06,NYSE (DN),102042478,26327777,43620480,171990735,3030821701.075403,1330747602.913499,1539895230.849104,5901464534.838006,531083,81804,227966,840853
2012-03-06,NASDAQ (DQ),1235232717,471044686,595532740,2301810143,32587293200.358790,22894115620.896051,18346421856.575596,73827830677.830437,3669425,722197,1636095,6027717
2012-03-06,EDGA (J),121690061,51988163,53990741,227668965,3087930525.905498,2579549520.573198,1560829262.564605,7228309309.043301,690092,175066,319197,1184355
2012-03-06,EDGX (K),263811564,88025635,138228814,490066013,7564244771.488713,4247792246.147501,4539897722.680513,16351934740.316727,1249670,263803,635941,2149414
2012-03-06,CHX (M),11194674,10207872,3529852,24932398,345689475.236600,809873776.761800,94104706.058400,1249667958.056800,1014,3889,527,5430
2012-03-06,NYSE (N),877839576,0,0,877839576,27117806470.807344,0.000000,0.000000,27117806470.807344,2599251,0,0,2599251
2012-03-06,NYSE Arca (P),415561238,292988204,215647935,924197377,12313115211.117788,15785183924.599833,8817303283.072725,36915602418.790346,2212076,704611,1063693,3980380
2012-03-06,NASDAQ (Q),611080765,285688000,516100710,1412869475,18635863490.337529,16832612882.207995,15968681667.098978,51437158039.644502,3338079,902454,2305474,6546007
2012-03-06,CBSX (W),5997051,7807024,2404576,16208651,114421592.950000,411642537.936600,47223852.840000,573287983.726600,27712,5564,12957,46233
2012-03-06,NASDAQ PSX (X),21786842,29696291,21338338,72821471,504934995.770000,2253745424.195000,515344677.169801,3274025097.134801,100185,63572,68083,231840
2012-03-06,BATS BYX (Y),113258351,41592472,47715484,202566307,2977175943.945005,1827378173.732601,1282824548.370174,6087378666.047780,734307,161543,304898,1200748
2012-03-06,BATS BZX (Z),309376258,177051692,183811188,670239138,8729320307.967476,9628929173.427801,5416145494.795794,23774394976.191071,1860874,611522,1067949,3540345
2012-03-05,NYSE MKT (A),0,10716431,2592553,13308984,0.000000,80225829.113400,63814083.235000,144039912.348400,0,25844,14339,40183
2012-03-05,NASDAQ BX (B),88011033,23238261,43209975,154459269,2056264916.944999,935106116.416500,1476950577.364605,4468321610.726104,570379,91946,283028,945353
2012-03-05,NSX (C),12932667,4811368,9026104,26770139,373168131.110500,160290891.337200,287347444.399203,820806466.846903,45268,10448,26551,82267
2012-03-05,NYSE (DN),82133585,17287886,39914697,139336168,2633739498.235100,868054345.981600,1392914756.852400,4894708601.069100,457514,53141,206427,717082
2012-03-05,NASDAQ (DQ),1032077966,290260506,546696995,1869035467,27780610911.443113,13340512283.265352,17210590384.539619,58331713579.248084,3206522,494915,1550514,5251951
2012-03-05,EDGA (J),100862307,37948796,50025295,188836398,2718286693.885002,1978139674.295000,1445132395.748799,6141558763.928801,606876,138707,304771,1050354
2012-03-05,EDGX (K),223855996,61692068,130046516,415594580,6588525635.833214,2810760587.998300,4460879722.710605,13860165946.542119,1059704,179786,577767,1817257
2012-03-05,CHX (M),14378080,7241759,3857962,25477801,460430424.068700,556613933.021500,132277185.725200,1149321542.815400,736,2824,763,4323
2012-03-05,NYSE (N),702723187,0,0,702723187,22642952803.223225,0.000000,0.000000,22642952803.223225,2229228,0,0,2229228
2012-03-05,NYSE Arca (P),324200355,214371985,188857032,727429372,10074594145.639980,11966113122.210565,8510702325.954643,30551409593.805188,1798700,523061,940349,3262110
2012-03-05,NASDAQ (Q),477887938,199197521,434608555,1111694014,14813424305.393945,12412712391.693548,13956279310.808891,41182416007.896384,2722571,706181,1997167,5425919
2012-03-05,CBSX (W),4654858,2277030,1858917,8790805,65312478.610000,114564359.420000,40124718.770000,220001556.800000,14251,3389,8025,25665
2012-03-05,NASDAQ PSX (X),19878846,16627528,20357013,56863387,452999086.940000,1258890451.430000,476195105.025000,2188084643.395000,94133,39117,66763,200013
2012-03-05,BATS BYX (Y),96030929,27998855,44861779,168891563,2539893555.189998,1285859735.493999,1151900985.825000,4977654276.508997,638262,121308,282950,1042520
2012-03-05,BATS BZX (Z),251428730,127947557,166161006,545537293,7370359699.289611,7246771216.397090,4969869632.467063,19587000548.153764,1570422,474045,968491,3012958
2012-03-02,NYSE MKT (A),0,9994620,3152004,13146624,0.000000,80957754.617200,64780911.920000,145738666.537200,0,24334,14066,38400
2012-03-02,NASDAQ BX (B),86242913,21759893,45587247,153590053,2030709856.170001,897544619.600000,1500256130.134998,4428510605.904999,570666,87689,299515,957870
2012-03-02,NSX (C),13001259,4230284,10261936,27493479,359906588.461200,134896475.727800,272305218.367699,767108282.556699,45694,9581,27113,82388
2012-03-02,NYSE (DN),83864731,13794510,44038524,141697765,2520862507.427201,751442574.165201,1380904445.871101,4653209527.463503,439959,41164,210141,691264
2012-03-02,NASDAQ (DQ),1026939482,279925016,570745842,1877610340,27048702746.939421,13945921339.114585,14634088699.971790,55628712786.025796,3071816,456746,1511901,5040463
2012-03-02,EDGA (J),95148054,34532184,52274763,181955001,2538955019.035001,1825339949.745001,1450335039.968697,5814630008.748699,583414,123913,311159,1018486
2012-03-02,EDGX (K),214406354,57582972,139344430,411333756,6239711880.466525,2641420011.531200,3966312780.832573,12847444672.830298,1063734,171189,606990,1841913
2012-03-02,CHX (M),6497307,8652943,4381147,19531397,226905273.115100,576451647.511600,175031803.424800,978388724.051500,843,2517,599,3959
2012-03-02,NYSE (N),699943200,0,0,699943200,21476786268.726165,0.000000,0.000000,21476786268.726165,2276856,0,0,2276856
2012-03-02,NYSE Arca (P),314705054,180407374,201277410,696389838,9482496665.959000,9641179582.341481,7275675406.848843,26399351655.149324,1780258,491747,991203,3263208
2012-03-02,NASDAQ (Q),460436830,193595078,454158235,1108190143,13777724563.722777,11676787298.278626,12971800057.316517,38426311919.317920,2651872,655916,2093591,5401379
2012-03-02,CBSX (W),3224330,4128045,1565775,8918150,56427920.290000,315496445.870000,26456871.760300,398381237.920300,14231,2284,4612,21127
2012-03-02,NASDAQ PSX (X),17801341,15341932,17403204,50546477,394729435.425000,1166562210.870000,360014903.615500,1921306549.910500,80700,34417,56513,171630
2012-03-02,BATS BYX (Y),90335516,24253476,44771316,159360308,2311984225.484998,1154555305.942999,1081968050.329401,4548507581.757398,605607,102605,281766,989978
2012-03-02,BATS BZX (Z),248074362,116888273,172977280,537939915,7219066696.880019,6939159249.013007,4927023356.787054,19085249302.680080,1576120,460631,1002996,3039747
2012-03-01,NYSE MKT (A),0,10852870,4300347,15153217,0.000000,91043148.737900,91803303.945000,182846452.682900,0,27165,19535,46700
2012-03-01,NASDAQ BX (B),100094768,27909793,47993547,175998108,2268829024.425000,1168539859.470000,1519656525.866595,4957025409.761595,608699,110619,305009,1024327
2012-03-01,NSX (C),14121467,4489206,9130641,27741314,401190716.835400,151557254.416700,303391497.196301,856139468.448401,48417,11677,26942,87036
2012-03-01,NYSE (DN),95862350,19122830,50288019,165273199,2750746186.479600,1010899763.577200,1751055772.294807,5512701722.351607,481039,59260,252396,792695
2012-03-01,NASDAQ (DQ),1154581295,347468719,606186033,2108236047,30138037495.802900,16645526543.569272,18253727788.686882,65037291828.059054,3424799,565934,1656733,5647466
2012-03-01,EDGA (J),108930275,40876783,54126124,203933182,2844850409.138200,2070908488.327801,1611795235.585803,6527554133.051804,646687,154820,330028,1131535
2012-03-01,EDGX (K),248394170,70628341,146212879,465235390,7222026826.127489,3222920105.217393,4899543117.908367,15344490049.253249,1174306,214688,667493,2056487
2012-03-01,CHX (M),9145425,9239003,6117422,24501850,322616379.748500,841298074.112000,190453047.705700,1354367501.566200,1344,3853,710,5907
2012-03-01,NYSE (N),814484832,0,0,814484832,25721469005.667071,0.000000,0.000000,25721469005.667071,2564164,0,0,2564164
2012-03-01,NYSE Arca (P),366603295,257985070,213481733,838070098,10926453415.517972,14379311839.691472,8974005735.441870,34279770990.651314,1974070,644398,1033203,3651671
2012-03-01,NASDAQ (Q),565199652,250809868,515036949,1331046469,16919905114.193128,15610900791.749868,15956963901.361799,48487769807.304795,3115033,864935,2313759,6293727
2012-03-01,CBSX (W),5137551,2701789,1410438,9249778,89504362.030000,110227685.130000,21608026.286600,221340073.446600,18722,2271,4059,25052
2012-03-01,NASDAQ PSX (X),23935777,23025440,23383736,70344953,532757330.025000,1676200487.295000,551873731.940000,2760831549.260000,112288,56138,77778,246204
2012-03-01,BATS BYX (Y),105219110,31173600,46404064,182796774,2652370937.089993,1526709100.609999,1255822965.929995,5434903003.629987,691672,138352,301812,1131836
2012-03-01,BATS BZX (Z),307686258,150369953,191999513,650055724,8674414563.824991,8993715792.480778,5920005643.019828,23588135999.325597,1819843,577934,1107687,3505464
2012-02-29,NYSE MKT (A),0,15324782,3948567,19273349,0.000000,129400642.613500,96075225.980000,225475868.593500,0,30644,17133,47777
2012-02-29,NASDAQ BX (B),104204016,40368884,52733906,197306806,2448578496.515002,1698130287.619201,1958475033.212996,6105183817.347199,646027,147743,323148,1116918
2012-02-29,NSX (C),14698859,7161991,8784507,30645357,422012929.487500,231622270.866200,326331844.352001,979967044.705701,52695,20527,28302,101524
2012-02-29,NYSE (DN),88016036,24517362,45094047,157627445,2632376285.216500,1320561056.563099,1640839042.029600,5593776383.809199,474079,69064,220623,763766
2012-02-29,NASDAQ (DQ),1287652783,440089193,710859408,2438601384,34949905698.344467,20422857659.744480,21412640474.562870,76785403832.651817,3514358,686092,1666222,5866672
2012-02-29,EDGA (J),108047309,54751822,53690309,216489440,2813150709.353900,2716608953.677999,1570982459.626298,7100742122.658197,645433,179518,321249,1146200
2012-02-29,EDGX (K),250382741,96849405,142837553,490069699,7341288860.681715,4467445747.338109,4896567559.858161,16705302167.877985,1201450,291044,642393,2134887
2012-02-29,CHX (M),7698137,13567576,7023415,28289128,274420506.589600,1311400713.188500,210177977.795600,1795999197.573700,531,9640,996,11167
2012-02-29,NYSE (N),1111243480,0,0,1111243480,36736006964.052502,0.000000,0.000000,36736006964.052502,2734472,0,0,2734472
2012-02-29,NYSE Arca (P),445432747,330356810,251886391,1027675948,13335114784.727625,18217670819.692716,11002007401.995157,42554793006.415498,2394927,803148,1196758,4394833
2012-02-29,NASDAQ (Q),596890651,339980465,625500709,1562371825,18448070988.207422,20900763686.982577,19530352354.598763,58879187029.788762,3408172,1101398,2417920,6927490
2012-02-29,CBSX (W),3804324,3325150,1207992,8337466,75687303.760000,114789513.760000,30633009.765900,221109827.285900,13815,2436,3245,19496
2012-02-29,NASDAQ PSX (X),31818309,29978958,28238176,90035443,736677551.810000,1966671509.035000,640058336.060000,3343407396.905000,134368,69612,86856,290836
2012-02-29,BATS BYX (Y),107110307,46737625,47557385,201405317,2786296820.670000,2127946232.701002,1259920995.426501,6174164048.797503,723327,196116,295173,1214616
2012-02-29,BATS BZX (Z),325952146,216087046,211626649,753665841,9903473199.106995,12281225217.776463,6582911685.201090,28767610102.084548,2078343,819846,1200370,4098559
2012-02-28,NYSE MKT (A),0,12856819,4370478,17227297,0.000000,77512460.672400,99041463.255000,176553923.927400,0,25133,18962,44095
2012-02-28,NASDAQ BX (B),89580507,26110983,46924611,162616101,2106175285.855000,1047280030.733001,1697173416.157495,4850628732.745496,551318,100598,285327,937243
2012-02-28,NSX (C),12312844,4523006,8438046,25273896,363882422.988000,109616493.654600,295900316.891101,769399233.533701,45929,10217,26162,82308
2012-02-28,NYSE (DN),76456164,13579131,37382199,127417494,2430326751.981305,678640520.940600,1241320602.248400,4350287875.170305,407466,41098,182155,630719
2012-02-28,NASDAQ (DQ),1102741716,303770773,608088951,2014601440,29416762323.772137,13429652179.181769,17741428461.682674,60587842964.636580,3180627,492093,1516041,5188761
2012-02-28,EDGA (J),94828888,31504058,45934265,172267211,2566464716.326198,1602331191.611001,1292582260.920997,5461378168.858196,575997,120257,283325,979579
2012-02-28,EDGX (K),207169949,55908695,128394431,391473075,6159955816.410391,2575590738.992901,4211908084.456898,12947454639.860190,1016911,169349,566860,1753120
2012-02-28,CHX (M),12728013,8348955,4671571,25748539,355441536.331200,582051009.942900,99291410.179100,1036783956.453200,894,3066,641,4601
2012-02-28,NYSE (N),754700539,0,0,754700539,24197413643.405005,0.000000,0.000000,24197413643.405005,2300585,0,0,2300585
2012-02-28,NYSE Arca (P),357759182,213082886,215651966,786494034,10735361366.005326,11722338856.625496,8812940726.014933,31270640948.645755,1904438,541067,1006672,3452177
2012-02-28,NASDAQ (Q),511933576,214620604,489152544,1215706724,15689776492.625999,13456951613.471454,15285944912.370630,44432673018.468083,2851494,716591,2053629,5621714
2012-02-28,CBSX (W),3253754,5249182,1219170,9722106,62009589.700000,263575129.520000,44702496.710000,370287215.930000,12532,1769,2377,16678
2012-02-28,NASDAQ PSX (X),20153649,16677706,19429651,56261006,480694477.830000,1203275382.915000,470189668.485000,2154159529.230000,87934,39683,59391,187008
2012-02-28,BATS BYX (Y),85635342,29086532,40070457,154792331,2239995843.620001,1288382165.335000,1021174083.898001,4549552092.853002,576303,122002,254807,953112
2012-02-28,BATS BZX (Z),252676062,128480903,176055005,557211970,7576256428.654989,7469211709.976689,5219533557.282310,20265001695.913988,1597357,502545,996502,3096404
2012-02-27,NYSE MKT (A),0,10991986,4040752,15032738,0.000000,84145211.148100,89187706.300000,173332917.448100,0,24690,17323,42013
2012-02-27,NASDAQ BX (B),95170392,25247034,44299289,164716715,2264674683.190005,977704298.543000,1479459756.918398,4721838738.651403,580389,91986,278368,950743
2012-02-27,NSX (C),11965477,4101743,11917407,27984627,356501755.548500,125059150.206000,246860452.761301,728421358.515801,43950,9508,28655,82113
2012-02-27,NYSE (DN),75405011,13249217,34717331,123371559,2312920309.248700,697357470.479900,1054549734.640199,4064827514.368799,390163,38685,173425,602273
2012-02-27,NASDAQ (DQ),1179401564,306555413,594850687,2080807664,32678507885.167795,13523114299.234960,15748965085.846216,61950587270.248971,3005838,481527,1480044,4967409
2012-02-27,EDGA (J),101958450,34728958,46702556,183389964,2732700711.779998,1657682862.417099,1265274438.723101,5655658012.920198,600137,121118,282805,1004060
2012-02-27,EDGX (K),210849292,57813487,129892767,398555546,6355868894.118513,2562539166.638901,3791535954.475768,12709944015.233182,1015919,168180,547450,1731549
2012-02-27,CHX (M),9261938,4231802,4753503,18247243,335219804.134800,385751194.433200,153631815.721000,874602814.289000,776,2346,1076,4198
2012-02-27,NYSE (N),732503737,0,0,732503737,22885014810.564810,0.000000,0.000000,22885014810.564810,2243873,0,0,2243873
2012-02-27,NYSE Arca (P),352031944,219693772,217345383,789071099,10612108341.890010,11971524202.120556,7805830596.713784,30389463140.724350,1896814,545911,979558,3422283
2012-02-27,NASDAQ (Q),504674163,217954248,458225561,1180853972,15643916554.149247,13634307986.513273,13575352095.885130,42853576636.547650,2811491,685397,2017055,5513943
2012-02-27,CBSX (W),2520332,4163910,1078191,7762433,57589374.670000,175144861.180000,19188503.940000,251922739.790000,8108,2181,3041,13330
2012-02-27,NASDAQ PSX (X),24275103,18569761,21185691,64030555,567868043.690000,1227679535.130000,468291637.440000,2263839216.260000,105406,43430,69173,218009
2012-02-27,BATS BYX (Y),90791131,25576127,42499001,158866259,2496461703.025000,1150115023.575001,1083251966.688298,4729828693.288299,614159,110822,271090,996071
2012-02-27,BATS BZX (Z),259517520,129795315,171743476,561056311,7858827366.186794,7637284820.251489,4821886953.270795,20317999139.709078,1616451,487563,971180,3075194
2012-02-24,NYSE MKT (A),0,10595996,3010435,13606431,0.000000,64707030.956900,73520624.860000,138227655.816900,0,20790,12478,33268
2012-02-24,NASDAQ BX (B),89894608,23689490,41444219,155028317,2105194570.969999,839014578.541101,1220002211.837297,4164211361.348397,542484,78866,248072,869422
2012-02-24,NSX (C),12266749,4298464,8889371,25454584,346637144.860200,115293498.357900,185730325.518501,647660968.736601,40339,9551,22654,72544
2012-02-24,NYSE (DN),78243847,15703996,37075107,131022950,2409575742.459298,813190468.977201,978397083.503101,4201163294.939600,391330,48330,166716,606376
2012-02-24,NASDAQ (DQ),1231358160,288665382,616347077,2136370619,35083951335.892332,12319321326.403520,15276712836.102022,62679985498.397874,3058799,452438,1398240,4909477
2012-02-24,EDGA (J),90856553,27846797,43648800,162352150,2456455821.720001,1272929912.221500,1174251207.756699,4903636941.698200,538277,97141,251543,886961
2012-02-24,EDGX (K),207356985,49354879,126346395,383058259,6222233069.847901,2142872745.008396,3483773230.876215,11848879045.732512,988291,142634,508532,1639457
2012-02-24,CHX (M),12508210,10176861,6357304,29042375,497253473.709400,835990018.165700,323200324.508000,1656443816.383100,926,2322,668,3916
2012-02-24,NYSE (N),640971924,0,0,640971924,20158564370.863706,0.000000,0.000000,20158564370.863706,1892446,0,0,1892446
2012-02-24,NYSE Arca (P),334419854,169437735,185960283,689817872,10008490029.120187,9028909683.463517,6490859981.640112,25528259694.223816,1739640,419921,840707,3000268
2012-02-24,NASDAQ (Q),458012855,171411320,393644659,1023068834,14295350929.183875,10493247620.032023,11558542764.895136,36347141314.111034,2607487,566890,1755745,4930122
2012-02-24,CBSX (W),4494192,2176381,1079103,7749676,71090047.121400,83619105.030000,19801840.560000,174510992.711400,8334,1875,3062,13271
2012-02-24,NASDAQ PSX (X),22676139,15775091,18522389,56973619,482216214.140000,1138154161.910000,443760037.050000,2064130413.100000,91503,37145,61837,190485
2012-02-24,BATS BYX (Y),80226669,25115064,36923782,142265515,2170214264.830000,1085736760.903199,932840840.880002,4188791866.613201,529841,96055,220455,846351
2012-02-24,BATS BZX (Z),241451402,102869410,153981903,498302715,7180046883.295201,5803756825.625012,4207629601.747381,17191433310.667594,1480281,378580,858094,2716955
2012-02-23,NYSE MKT (A),0,12549988,4452263,17002251,0.000000,80182193.927900,105554075.547500,185736269.475400,0,26834,18009,44843
2012-02-23,NASDAQ BX (B),91533751,25609645,43412349,160555745,2164181829.984999,952285482.425000,1376491073.905000,4492958386.314999,567528,91192,271701,930421
2012-02-23,NSX (C),14118756,5264903,9780787,29164446,395480706.048800,119369887.422100,268732780.138901,783583373.609801,46734,11034,28136,85904
2012-02-23,NYSE (DN),85693608,14557421,38813849,139064878,2456987246.896299,745285950.910000,1231507935.562802,4433781133.369101,420672,42380,187467,650519
2012-02-23,NASDAQ (DQ),1203432453,302606136,595654242,2101692831,33262676286.286589,14167102277.221483,16735724376.005144,64165502939.513216,3236648,469650,1515317,5221615
2012-02-23,EDGA (J),99802650,30918395,46979724,177700769,2697298609.534700,1557116074.754300,1304743986.089895,5559158670.378895,590893,114828,283413,989134
2012-02-23,EDGX (K),235073543,57092321,128353789,420519653,6928520451.250490,2570566436.740604,3945769530.045685,13444856418.036779,1117141,171468,583636,1872245
2012-02-23,CHX (M),10127126,9234075,5115303,24476504,363501909.401200,782114986.256900,245360873.931500,1390977769.589600,810,2996,683,4489
2012-02-23,NYSE (N),763096341,0,0,763096341,24028964717.845475,0.000000,0.000000,24028964717.845475,2305021,0,0,2305021
2012-02-23,NYSE Arca (P),371717575,195560334,209459795,776737704,11161277236.982966,11359356631.358102,8043739832.795262,30564373701.136330,1950581,506372,1007344,3464297
2012-02-23,NASDAQ (Q),520201550,212662093,458177855,1191041498,16070516307.747668,13308312011.305065,14064877975.535379,43443706294.588112,2931324,695093,2059144,5685561
2012-02-23,CBSX (W),4228689,2399312,1172769,7800770,60021789.450000,65912481.336500,27398034.380000,153332305.166500,10135,1985,2571,14691
2012-02-23,NASDAQ PSX (X),28239411,18375938,22919979,69535328,621025787.950000,1361533038.690000,546824197.070000,2529383023.710000,108968,43641,70706,223315
2012-02-23,BATS BYX (Y),93451443,27401760,41948207,162801410,2517251512.990001,1254037816.684999,1065648576.587003,4836937906.262003,626420,119479,259126,1005025
2012-02-23,BATS BZX (Z),268600258,124650938,174895729,568146925,8000285148.082999,7400795129.353590,5186222837.828311,20587303115.264900,1659352,496028,998079,3153459
2012-02-22,NYSE MKT (A),0,11537386,4286447,15823833,0.000000,76279107.186800,107942282.380000,184221389.566800,0,26990,15791,42781
2012-02-22,NASDAQ BX (B),94656742,26343934,45330495,166331171,2234378644.329998,989439545.000001,1501063388.528009,4724881577.858008,593004,97172,291926,982102
2012-02-22,NSX (C),11938247,4481070,8353439,24772756,335341796.496200,123071515.366500,246037128.484802,704450440.347502,41129,9754,24988,75871
2012-02-22,NYSE (DN),80853721,15122944,39729205,135705870,2396359435.346999,735487741.882699,1261286471.685700,4393133648.915398,402066,42437,177655,622158
2012-02-22,NASDAQ (DQ),1126032860,289925236,567226119,1983184215,29633626203.475412,12844827559.373853,15645244443.969498,58123698206.818763,3266154,458340,1537070,5261564
2012-02-22,EDGA (J),104627245,28884020,47532586,181043851,2683921020.551002,1426387420.632001,1421829116.321592,5532137557.504595,585772,108717,281637,976126
2012-02-22,EDGX (K),235327132,57464765,129366711,422158608,6627165669.191585,2536710852.713400,4158750092.192218,13322626614.097203,1075606,171862,571777,1819245
2012-02-22,CHX (M),20362455,14984821,6832161,42179437,628015960.976900,872555991.515600,216312161.728300,1716884114.220800,1152,3937,772,5861
2012-02-22,NYSE (N),729052847,0,0,729052847,23103682357.964919,0.000000,0.000000,23103682357.964919,2237052,0,0,2237052
2012-02-22,NYSE Arca (P),342507710,197369351,194032389,733909450,10075053311.999997,10636421041.410705,7053849764.915191,27765324118.325893,1821567,495456,927819,3244842
2012-02-22,NASDAQ (Q),517000815,214726858,445254249,1176981922,15740415295.409137,13457203478.400170,13663702672.690216,42861321446.499523,2929998,712753,2008178,5650929
2012-02-22,CBSX (W),3753355,1487400,1438839,6679594,49993633.420000,50762317.440000,23136326.380000,123892277.240000,8108,1561,3631,13300
2012-02-22,NASDAQ PSX (X),29012280,19957940,21621617,70591837,639901889.265000,1410188016.980000,493465178.310000,2543555084.555000,113919,49188,68973,232080
2012-02-22,BATS BYX (Y),93226420,28240103,43569767,165036290,2518677777.244001,1318006309.270000,1108715993.274999,4945400079.789000,628691,132342,268885,1029918
2012-02-22,BATS BZX (Z),260782186,122627594,161944832,545354612,7491810812.734990,6900662982.065803,4703908158.451721,19096381953.252514,1584432,469634,930110,2984176
2012-02-21,NYSE MKT (A),0,13991075,4327494,18318569,0.000000,89454424.275200,97561725.209800,187016149.485000,0,28283,15012,43295
2012-02-21,NASDAQ BX (B),95102864,28241330,44167322,167511516,2179764199.910000,1008514378.735000,1463656680.824603,4651935259.469603,557853,97108,268072,923033
2012-02-21,NSX (C),13117789,5459207,10804986,29381982,391562638.048400,124530270.196500,292994382.268002,809087290.512902,45950,11614,28815,86379
2012-02-21,NYSE (DN),66734749,16297026,31832789,114864564,1915734709.031301,790664622.505501,1057990391.388499,3764389722.925301,370904,44581,163855,579340
2012-02-21,NASDAQ (DQ),1202400521,338974765,637241729,2178617015,31765557610.437956,14350699356.607360,18509407886.326054,64625664853.371370,3450651,526154,1632124,5608929
2012-02-21,EDGA (J),102507964,31403164,46153791,180064919,2600052893.505498,1461951813.982500,1383381647.017600,5445386354.505598,556564,109406,271648,937618
2012-02-21,EDGX (K),251197395,61981722,142429125,455608242,7506219534.537994,2591105602.936594,4626215566.443972,14723540703.918560,1191479,173206,631996,1996681
2012-02-21,CHX (M),15439174,12251097,4176093,31866364,432554507.511000,912612959.202500,170667021.911000,1515834488.624500,679,3068,811,4558
2012-02-21,NYSE (N),797989499,0,0,797989499,24827494289.286274,0.000000,0.000000,24827494289.286274,2197618,0,0,2197618
2012-02-21,NYSE Arca (P),345772154,199325882,197897024,742995060,10368178612.918134,11123524720.508106,7583963766.400903,29075667099.827143,1809093,479234,950407,3238734
2012-02-21,NASDAQ (Q),507476494,215648587,471134069,1194259150,15173154078.767271,12845969691.565446,14755647848.494858,42774771618.827575,2740088,697070,1991241,5428399
2012-02-21,CBSX (W),5414705,4633230,1593360,11641295,131580206.140000,160043287.030000,21849585.651000,313473078.821000,6074,1435,2737,10246
2012-02-21,NASDAQ PSX (X),29996286,19340124,25933071,75269481,641940638.585000,1392278100.090000,525846907.595000,2560065646.270000,117627,43830,80715,242172
2012-02-21,BATS BYX (Y),100168301,27097312,43199844,170465457,2654281940.509996,1204754490.402000,1135027799.030199,4994064229.942195,643541,107481,271379,1022401
2012-02-21,BATS BZX (Z),260079773,125098173,166279756,551457702,7585399585.545009,6870356988.368705,4774489864.134007,19230246438.047721,1580635,446024,963129,2989788
2012-02-17,NYSE MKT (A),0,9912494,5338080,15250574,0.000000,73345722.486100,136317522.895000,209663245.381100,0,23002,20454,43456
2012-02-17,NASDAQ BX (B),91016054,23127088,47205081,161348223,1992840025.310000,770525127.145000,1429192470.393400,4192557622.848400,529846,74964,271957,876767
2012-02-17,NSX (C),11052765,3184029,10996207,25233001,329640059.514400,101883651.751700,265792533.827004,697316245.093104,41802,7099,29640,78541
2012-02-17,NYSE (DN),81881713,14376004,47695689,143953406,2571147341.021295,729835823.654600,1411518612.967102,4712501777.642997,422560,39808,200543,662911
2012-02-17,NASDAQ (DQ),1159472097,281479664,682815487,2123767248,29554341451.581535,12803881476.678898,20232902588.467335,62591125516.727768,3126616,438883,1524417,5089916
2012-02-17,EDGA (J),94419553,28331777,48675028,171426358,2493605689.264998,1293682621.169800,1428904085.301702,5216192395.736500,526203,96325,265057,887585
2012-02-17,EDGX (K),217995588,49526740,139569710,407092038,6549253701.251290,2198836845.674799,4512959088.430031,13261049635.356120,1048878,143005,612442,1804325
2012-02-17,CHX (M),12158332,14790878,5203295,32152505,436126143.148900,1007582959.130400,291828926.854000,1735538029.133300,693,2006,866,3565
2012-02-17,NYSE (N),897310601,0,0,897310601,29646522528.320250,0.000000,0.000000,29646522528.320250,2078649,0,0,2078649
2012-02-17,NYSE Arca (P),322949513,179198994,200348123,702496630,9658036807.521034,9768825811.956804,7630048176.646266,27056910796.124104,1660286,433325,914347,3007958
2012-02-17,NASDAQ (Q),469625072,176345581,553154041,1199124694,13892276781.276082,10924716992.610586,17689806496.905220,42506800270.791888,2463311,558039,1905313,4926663
2012-02-17,CBSX (W),2833836,2215696,1001215,6050747,51792552.150000,61416398.330000,25911751.050000,139120701.530000,7245,1257,2454,10956
2012-02-17,NASDAQ PSX (X),26819570,18228470,28787087,73835127,575716352.490000,1289046103.950000,687071454.780000,2551833911.220000,101970,39893,89385,231248
2012-02-17,BATS BYX (Y),87692313,21850100,42947368,152489781,2392460439.449997,989926934.425000,1180159286.119395,4562546659.994392,570137,87216,251324,908677
2012-02-17,BATS BZX (Z),242093416,109269097,172106465,523468978,7097116980.943394,6287874000.465007,5213548204.807534,18598539186.215935,1424921,379807,938741,2743469
2012-02-16,NYSE MKT (A),0,11396951,4651240,16048191,0.000000,79028139.942500,110098073.157000,189126213.099500,0,27502,16868,44370
2012-02-16,NASDAQ BX (B),109714428,28535169,47113013,185362610,2366665896.349997,1019212993.771000,1768914897.179200,5154793787.300197,615903,98447,297656,1012006
2012-02-16,NSX (C),11367234,4346781,11765717,27479732,339264334.909600,156075794.126500,290175074.748701,785515203.784801,42937,10360,30589,83886
2012-02-16,NYSE (DN),97852036,18497043,47740692,164089771,2945457575.517396,925402498.063900,1756618548.681004,5627478622.262300,492531,51555,221084,765170
2012-02-16,NASDAQ (DQ),1319340290,382083811,668859658,2370283759,34435686669.423086,18984561869.927625,22510817209.301323,75931065748.652034,3551296,552282,1656978,5760556
2012-02-16,EDGA (J),107326785,36353385,49378670,193058840,2703728827.618601,1753416597.908201,1628182486.499604,6085327912.026406,594660,130392,290453,1015505
2012-02-16,EDGX (K),273587975,70853726,149779154,494220855,8168488151.337724,3197426463.894801,5411877037.890113,16777791653.122638,1332098,211708,690933,2234739
2012-02-16,CHX (M),10603529,10497480,10408195,31509204,438296120.931500,610904239.314300,544675698.240200,1593876058.486000,858,3179,973,5010
2012-02-16,NYSE (N),805809396,0,0,805809396,24676214605.906798,0.000000,0.000000,24676214605.906798,2466212,0,0,2466212
2012-02-16,NYSE Arca (P),374987339,232572034,215987360,823546733,11110749003.218635,12883662972.270224,9828109649.728439,33822521625.217298,1966233,613058,1040057,3619348
2012-02-16,NASDAQ (Q),560863337,259204373,496893281,1316960991,16492957182.633489,15900486955.241831,17020936072.900578,49414380210.775898,2977812,857583,2156260,5991655
2012-02-16,CBSX (W),3488771,1887566,1058561,6434898,44191832.594600,105025842.740000,18386287.041200,167603962.375800,7732,1384,2373,11489
2012-02-16,NASDAQ PSX (X),32472331,24761260,28583903,85817494,692054146.350000,1587076116.650000,747128760.550001,3026259023.550001,127775,59780,92264,279819
2012-02-16,BATS BYX (Y),105069730,32115827,46155390,183340947,2707666274.895002,1466092106.670001,1417086893.484097,5590845275.049100,667334,128438,283519,1079291
2012-02-16,BATS BZX (Z),296854241,159415421,179681199,635950861,8361402566.744040,9163086248.315303,6068285062.192223,23592773877.251566,1717811,573091,1028719,3319621
2012-02-15,NYSE MKT (A),0,10960975,4574151,15535126,0.000000,73625057.650500,111700154.370000,185325212.020500,0,25816,19260,45076
2012-02-15,NASDAQ BX (B),104687470,29620966,53364838,187673274,2374618520.640001,1061617625.560001,2016274451.080495,5452510597.280497,630703,111530,318947,1061180
2012-02-15,NSX (C),12354665,4563996,8771320,25689981,359796971.128700,156997386.472500,387859737.042903,904654094.644103,45668,11400,27154,84222
2012-02-15,NYSE (DN),92431438,21487138,46630293,160548869,2659185091.223290,1123320156.244301,1700866470.221691,5483371717.689282,440345,54132,201667,696144
2012-02-15,NASDAQ (DQ),1231934803,320425464,675451870,2227812137,32350520140.116791,14129828051.741573,24145614940.626259,70625963132.484623,3360535,524725,1622731,5507991
2012-02-15,EDGA (J),109443288,38260530,54861672,202565490,2887009370.872500,1938711205.420999,1917576987.700796,6743297563.994295,635549,140918,308236,1084703
2012-02-15,EDGX (K),286463211,73221309,158149643,517834163,8451988971.442695,3390392886.255796,6043272754.461448,17885654612.159939,1426941,227742,733242,2387925
2012-02-15,CHX (M),11429580,9691023,17549062,38669665,415470781.832500,738284092.195200,846889436.511000,2000644310.538700,1051,3270,1128,5449
2012-02-15,NYSE (N),806387150,0,0,806387150,24934015558.058746,0.000000,0.000000,24934015558.058746,2598137,0,0,2598137
2012-02-15,NYSE Arca (P),395366503,252186730,238835160,886388393,11892799080.154129,14531248469.790891,11984996066.003027,38409043615.948047,2148891,645515,1144998,3939404
2012-02-15,NASDAQ (Q),600291611,284373179,525954266,1410619056,18185117923.253084,18313236162.750169,19572583867.731789,56070937953.735042,3338464,979685,2306191,6624340
2012-02-15,CBSX (W),3614735,2016831,1262972,6894538,41096897.200000,67332129.870000,21573651.566500,130002678.636500,6562,957,2667,10186
2012-02-15,NASDAQ PSX (X),32384921,21921111,28372258,82678290,695930912.025000,1414120672.229999,727262740.840000,2837314325.094999,124007,52878,84927,261812
2012-02-15,BATS BYX (Y),103414960,32255964,48177080,183848004,2724226013.134998,1558449950.924999,1557979602.440202,5840655566.500199,684462,136055,295142,1115659
2012-02-15,BATS BZX (Z),291548088,172461188,194481973,658491249,8465552605.867519,10445437275.073959,7180972701.968719,26091962582.910197,1771186,627466,1088145,3486797
2012-02-14,NYSE MKT (A),0,9441692,3933145,13374837,0.000000,71981233.600600,96560476.489600,168541710.090200,0,23991,16151,40142
2012-02-14,NASDAQ BX (B),98522822,28252340,47756750,174531912,2065452215.959997,915354026.539999,1477672484.507495,4458478727.007491,560631,90374,284352,935357
2012-02-14,NSX (C),12613105,4278358,10604550,27496013,321611262.157700,181959607.155100,222652640.271401,726223509.584201,41478,8986,25955,76419
2012-02-14,NYSE (DN),92444190,20446172,43095166,155985528,2575053261.300300,950038090.521200,1263459106.046500,4788550457.868000,431088,48953,185631,665672
2012-02-14,NASDAQ (DQ),1234975196,312420713,635153805,2182549714,31168568164.874459,14165542098.189218,16505095651.512371,61839205914.576048,3322039,484847,1528033,5334919
2012-02-14,EDGA (J),111373199,37474157,51854022,200701378,2891591566.353098,1831618499.290002,1456461952.485298,6179672018.128398,617703,124849,290568,1033120
2012-02-14,EDGX (K),264830753,63753283,146874912,475458948,7359370628.562631,2903822027.029705,4090128070.423227,14353320726.015563,1263517,185556,631198,2080271
2012-02-14,CHX (M),16667486,10044365,13022625,39734476,531005177.958100,747013181.289600,649964583.098800,1927982942.346500,785,2646,970,4401
2012-02-14,NYSE (N),743554084,0,0,743554084,22385462223.886916,0.000000,0.000000,22385462223.886916,2248459,0,0,2248459
2012-02-14,NYSE Arca (P),355856504,202237064,213677037,771770605,10208281991.166518,11447987771.661285,7013866259.826836,28670136022.654639,1866647,513922,958499,3339068
2012-02-14,NASDAQ (Q),545812506,229362762,476533324,1251708592,15828316526.563291,14340535435.220897,13621618873.538647,43790470835.322835,2880592,764750,1961567,5606909
2012-02-14,CBSX (W),3775249,1316707,1651807,6743763,45377656.130000,49945022.950000,15992504.432400,111315183.512400,8062,926,2931,11919
2012-02-14,NASDAQ PSX (X),31401202,20471033,30251641,82123876,644939720.315000,1291463943.620000,586899585.410000,2523303249.345000,116987,46073,85233,248293
2012-02-14,BATS BYX (Y),96468243,27631447,43840115,167939805,2480284904.020001,1237460125.250001,1140951641.030099,4858696670.300101,628537,109069,265910,1003516
2012-02-14,BATS BZX (Z),277316875,146407643,175943096,599667614,7649287467.444519,8370516946.189702,4901630487.395257,20921434901.029478,1597868,507110,947558,3052536
2012-02-13,NYSE MKT (A),0,10809101,3646529,14455630,0.000000,70759069.022200,85676099.320600,156435168.342800,0,24419,14972,39391
2012-02-13,NASDAQ BX (B),83983138,21241176,40799337,146023651,1808707252.510001,769880822.910000,1236487221.925002,3815075297.345003,495098,73908,243803,812809
2012-02-13,NSX (C),8822104,3337474,6664218,18823796,249629445.049000,88198399.929000,136094941.605599,473922786.583599,33658,7545,21126,62329
2012-02-13,NYSE (DN),83280642,14421468,34569487,132271597,2346702469.390902,756203161.548600,1074535310.088102,4177440941.027604,392721,40536,166716,599973
2012-02-13,NASDAQ (DQ),1263359638,260075587,557430300,2080865525,32398270806.265313,11215748336.946964,15428919211.446444,59042938354.658721,3096264,453411,1435163,4984838
2012-02-13,EDGA (J),101345938,29505278,47394471,178245687,2768815429.505001,1421292027.976600,1409708803.479700,5599816260.961301,582402,106710,276782,965894
2012-02-13,EDGX (K),240801546,50490968,132022792,423315306,6750322204.103905,2194299032.459993,4034195973.162385,12978817209.726283,1091812,144574,568179,1804565
2012-02-13,CHX (M),13139243,6812115,8252142,28203500,433597025.359300,647475455.784700,351328601.359300,1432401082.503300,659,2844,669,4172
2012-02-13,NYSE (N),682658997,0,0,682658997,20624178195.235511,0.000000,0.000000,20624178195.235511,2037001,0,0,2037001
2012-02-13,NYSE Arca (P),316331042,167159473,171230937,654721452,9008171148.770534,8910980160.099402,6170747219.751498,24089898528.621434,1629098,444012,847057,2920167
2012-02-13,NASDAQ (Q),477808313,181888833,419129743,1078826889,13683222669.521753,10998900547.256174,12943629736.825020,37625752953.602947,2513716,610984,1792285,4916985
2012-02-13,CBSX (W),3419217,3520342,1309153,8248712,40793940.310000,267166123.984600,18141010.400400,326101074.695000,8070,1365,3501,12936
2012-02-13,NASDAQ PSX (X),27076546,18132068,20224191,65432805,562841124.350000,1238167270.550000,429777009.630000,2230785404.530000,95531,40401,59550,195482
2012-02-13,BATS BYX (Y),89084255,23971078,39060242,152115575,2319793107.822802,1096818479.175001,1077854795.435297,4494466382.433100,579147,94245,250150,923542
2012-02-13,BATS BZX (Z),234706083,108539873,148682966,491928922,6619323288.426000,6247018956.543385,4386864659.624304,17253206904.593689,1383648,383065,853378,2620091
2012-02-10,NYSE MKT (A),0,11558092,3549615,15107707,0.000000,80002355.637300,90960816.020000,170963171.657300,0,26310,16554,42864
2012-02-10,NASDAQ BX (B),92103368,28300685,44214832,164618885,2042028849.764999,1033670813.860001,1301160041.515002,4376859705.140002,536394,96076,261079,893549
2012-02-10,NSX (C),13740384,3840024,8114128,25694536,372739228.321300,124870033.247300,261421517.536801,759030779.105401,44058,9811,25389,79258
2012-02-10,NYSE (DN),79629260,15948298,37384672,132962230,2321369890.667699,941287637.176001,1168713627.290401,4431371155.134101,375952,41549,163803,581304
2012-02-10,NASDAQ (DQ),1297900458,341979587,597056422,2236936467,33201754838.657336,15013546251.740907,16832091683.267179,65047392773.665422,3113837,534274,1487149,5135260
2012-02-10,EDGA (J),100730371,31946554,47273926,179950851,2686552808.084995,1558238323.599600,1473627021.533493,5718418153.218088,554356,111314,268788,934458
2012-02-10,EDGX (K),256611398,64588108,144485428,465684934,7245574486.424118,2866151627.131199,4265366295.802821,14377092409.358138,1187425,183529,622382,1993336
2012-02-10,CHX (M),11377625,9954895,8957777,30290297,441200496.713300,923862190.870100,286592580.989300,1651655268.572700,725,3936,829,5490
2012-02-10,NYSE (N),750746097,0,0,750746097,23022643887.197077,0.000000,0.000000,23022643887.197077,2194680,0,0,2194680
2012-02-10,NYSE Arca (P),360429911,218985496,200446081,779861488,10398952593.836420,12380699885.933421,7996065332.648328,30775717812.418169,1840336,537752,953564,3331652
2012-02-10,NASDAQ (Q),529388233,224821526,466647991,1220857750,15367316267.753058,13968832602.156267,14185392752.257980,43521541622.167305,2791483,722266,1944782,5458531
2012-02-10,CBSX (W),2567752,1553998,1179768,5301518,34243384.770000,60098491.536000,36574382.830000,130916259.136000,5960,1225,2672,9857
2012-02-10,NASDAQ PSX (X),30577438,22880674,26550074,80008186,635201054.570000,1552425000.330000,641483207.770000,2829109262.670000,113442,50240,77045,240727
2012-02-10,BATS BYX (Y),93697214,27934495,43907188,165538897,2559464022.934998,1205732022.485000,1177764121.384101,4942960166.804099,616632,111109,264309,992050
2012-02-10,BATS BZX (Z),256731319,131295609,171385788,559412716,7254018064.829992,7858492728.552548,5203794087.116388,20316304880.498928,1491373,473807,933321,2898501
2012-02-09,NYSE MKT (A),0,12557791,4425403,16983194,0.000000,89952415.043100,108119090.830000,198071505.873100,0,27539,18250,45789
2012-02-09,NASDAQ BX (B),96194093,25593187,52577111,174364391,2073334530.795000,975562631.625001,1791495596.240001,4840392758.660002,542275,87523,292445,922243
2012-02-09,NSX (C),13682588,3456130,10141670,27280388,390783483.843800,123355080.499600,357819496.539302,871958060.882702,48352,7404,29339,85095
2012-02-09,NYSE (DN),89189440,17305460,49040090,155534990,2559632946.145000,921447135.651000,1433114212.864200,4914194294.660200,406775,41051,209885,657711
2012-02-09,NASDAQ (DQ),1408946463,335898302,737794600,2482639365,36779982997.033797,14893418846.809982,20423185004.761154,72096586848.604933,3331786,477639,1721740,5531165
2012-02-09,EDGA (J),113077682,33246303,57113162,203437147,2904879490.448500,1550160674.892199,1750981724.140793,6206021889.481492,601407,118563,307462,1027432
2012-02-09,EDGX (K),301473975,61610963,180179336,543264274,8226697733.359383,2584329427.082198,5521612083.848547,16332639244.290128,1305209,178317,754206,2237732
2012-02-09,CHX (M),14235640,8133154,9409988,31778782,399608702.824700,791134550.030600,389421367.294900,1580164620.150200,640,4531,1033,6204
2012-02-09,NYSE (N),759183453,0,0,759183453,23322517526.721124,0.000000,0.000000,23322517526.721124,2325343,0,0,2325343
2012-02-09,NYSE Arca (P),391070655,209689883,247519338,848279876,11270077474.148253,11211991628.648909,9383783370.810297,31865852473.607459,1965355,518118,1105064,3588537
2012-02-09,NASDAQ (Q),588500361,230897398,534710878,1354108637,16980376874.110650,14380767293.974845,16458724318.442972,47819868486.528467,3029745,752060,2229074,6010879
2012-02-09,CBSX (W),4058343,5575896,1108260,10742499,52872503.320000,380096135.070000,24684065.555000,457652703.945000,7784,1072,2359,11215
2012-02-09,NASDAQ PSX (X),34300178,20587655,27537283,82425116,699228150.505000,1258824123.540000,618250522.555000,2576302796.600000,123964,45438,86830,256232
2012-02-09,BATS BYX (Y),103825159,28269939,50964087,183059185,2791130234.779999,1192957823.335000,1400133270.397802,5384221328.512801,668862,112519,304293,1085674
2012-02-09,BATS BZX (Z),282534279,135807244,202476176,620817699,8064686123.102014,7626184857.650705,6056438598.505070,21747309579.257789,1633967,459896,1051952,3145815
2012-02-08,NYSE MKT (A),0,11096857,3491273,14588130,0.000000,73571706.279700,89369216.190000,162940922.469700,0,24661,14876,39537
2012-02-08,NASDAQ BX (B),104947145,26302452,49235325,180484922,2130106945.054997,982565263.285000,1363925529.098499,4476597737.438496,549031,88026,270670,907727
2012-02-08,NSX (C),13918589,3436293,8426086,25780968,382160205.689900,115294705.264900,231660227.819202,729115138.774002,47150,7702,26980,81832
2012-02-08,NYSE (DN),94269692,14685076,44563396,153518164,2587618139.202099,752657004.156000,1285329333.893900,4625604477.251999,417547,37985,198322,653854
2012-02-08,NASDAQ (DQ),1320678308,284265370,677536110,2282479788,32572431065.644261,13513262283.454808,16363020263.784838,62448713612.883907,3350527,462552,1616023,5429102
2012-02-08,EDGA (J),110600386,30711442,52788661,194100489,2758229380.384998,1425575795.464599,1488855814.072301,5672660989.921898,582464,105925,284170,972559
2012-02-08,EDGX (K),292164784,56394937,169375375,517935096,8026567858.613504,2654553498.948003,4553535229.663802,15234656587.225309,1287175,166353,700305,2153833
2012-02-08,CHX (M),19261192,9863335,8147931,37272458,413579207.079500,735923815.359000,275630669.671200,1425133692.109700,945,3563,1243,5751
2012-02-08,NYSE (N),765357390,0,0,765357390,23057576437.665004,0.000000,0.000000,23057576437.665004,2274619,0,0,2274619
2012-02-08,NYSE Arca (P),395006257,188110384,226113617,809230258,10962524991.222073,10120202191.059922,7153750943.736122,28236478126.018117,1945094,469621,1052113,3466828
2012-02-08,NASDAQ (Q),563001922,209180883,503443216,1275626021,16308340248.688276,13316374607.288873,14281491737.399973,43906206593.377122,2964143,672877,2132794,5769814
2012-02-08,CBSX (W),3986453,3503667,1764613,9254733,46814754.050000,175356210.926500,23140187.539900,245311152.516400,8005,1195,4146,13346
2012-02-08,NASDAQ PSX (X),30330924,19676703,26133976,76141603,628447084.590000,1302380719.960000,576948253.505000,2507776058.055000,111920,44565,82811,239296
2012-02-08,BATS BYX (Y),104618813,25724292,49168405,179511510,2740435431.545006,1134790128.280000,1250307792.300399,5125533352.125405,676588,108516,288180,1073284
2012-02-08,BATS BZX (Z),282082574,123786844,184690277,590559695,7876605292.745009,7567878672.572996,5097496145.974128,20541980111.292133,1596734,442281,991923,3030938
2012-02-07,NYSE MKT (A),0,11811010,3576311,15387321,0.000000,77323954.506300,95449569.800700,172773524.307000,0,25551,16187,41738
2012-02-07,NASDAQ BX (B),96824007,27637526,45349542,169811075,2128692920.549998,1043147734.209900,1287012273.649997,4458852928.409895,571006,97146,273262,941414
2012-02-07,NSX (C),14149682,4295195,10613765,29058642,385955437.852400,151373528.033300,232761014.107500,770089979.993200,48654,8815,28018,85487
2012-02-07,NYSE (DN),82631055,13984895,36951125,133567075,2454801235.319999,760242066.855000,1087121982.386000,4302165284.560999,400813,40232,173321,614366
2012-02-07,NASDAQ (DQ),1210773155,298659682,615735363,2125168200,31943051418.826294,13963171943.806961,15364391779.395512,61270615142.028767,3303305,480891,1507172,5291368
2012-02-07,EDGA (J),104353576,31924700,50523553,186801829,2744849099.427997,1543238708.745000,1380043154.813603,5668130962.986600,592398,110845,288259,991502
2012-02-07,EDGX (K),264939036,61627255,150681294,477247585,7866021360.244611,2770501596.142104,4083215155.481100,14719738111.867815,1279786,179597,628582,2087965
2012-02-07,CHX (M),11660645,10643849,6757776,29062270,458593707.006800,849776537.814200,190337877.411900,1498708122.232900,933,4135,1336,6404
2012-02-07,NYSE (N),728984520,0,0,728984520,23101041962.723748,0.000000,0.000000,23101041962.723748,2255528,0,0,2255528
2012-02-07,NYSE Arca (P),361171147,190296958,201141862,752609967,10869384656.038130,10243129604.736502,6620617641.910084,27733131902.684716,1951354,510087,973853,3435294
2012-02-07,NASDAQ (Q),514001171,222086835,445139806,1181227812,15584530733.484086,13814710116.148505,12714771660.242367,42114012509.874958,2813400,717636,1928414,5459450
2012-02-07,CBSX (W),2127624,2551594,1374646,6053864,27156695.930000,100290773.830000,30656388.934000,158103858.694000,5852,1652,2298,9802
2012-02-07,NASDAQ PSX (X),28220251,19804940,23913271,71938462,611659278.660000,1329343548.200000,548431463.510000,2489434290.370000,106817,45821,70517,223155
2012-02-07,BATS BYX (Y),94699490,27091782,41536378,163327650,2614894221.035001,1236347674.700000,1109303720.081898,4960545615.816899,651359,114817,265767,1031943
2012-02-07,BATS BZX (Z),258691821,130109349,161561551,550362721,7714667273.470490,7478212374.347500,4570888697.956936,19763768345.774926,1572214,466162,921800,2960176
2012-02-06,NYSE MKT (A),0,10212286,3262568,13474854,0.000000,72647863.792600,90980607.040000,163628470.832600,0,23525,15029,38554
2012-02-06,NASDAQ BX (B),86862996,19555380,38392350,144810726,1897010459.830000,772507903.290000,1159705482.859701,3829223845.979701,499831,71681,237444,808956
2012-02-06,NSX (C),12373957,2977369,8611032,23962358,349122845.738900,90627539.637500,243818886.255001,683569271.631401,45521,6764,25462,77747
2012-02-06,NYSE (DN),78592950,15771665,37083147,131447762,2346425516.359998,727553709.797000,1169969025.459001,4243948251.615999,388627,43596,182872,615095
2012-02-06,NASDAQ (DQ),1061146276,278768428,584593300,1924508004,27649094570.878882,13326477500.862422,15052358407.988131,56027930479.729435,2940319,413224,1442079,4795622
2012-02-06,EDGA (J),95364337,24177658,45126902,164668897,2600190876.948195,1156806551.826200,1241229245.106106,4998226673.880501,537293,85066,261386,883745
2012-02-06,EDGX (K),230350868,47148066,141891925,419390859,6648857226.956001,2112468936.219398,3818389104.066074,12579715267.241473,1094057,137900,606873,1838830
2012-02-06,CHX (M),9036299,6046355,5281705,20364359,319687459.197200,465495429.476100,167901047.647100,953083936.320400,1027,2977,1126,5130
2012-02-06,NYSE (N),687230965,0,0,687230965,21973578305.687502,0.000000,0.000000,21973578305.687502,2073811,0,0,2073811
2012-02-06,NYSE Arca (P),307986266,168083627,183099312,659169205,9231086944.705024,8858588238.027106,5939803688.286389,24029478871.018519,1694043,424207,917531,3035781
2012-02-06,NASDAQ (Q),457305546,155955427,420451627,1033712600,13580266136.733031,9541516284.292609,12396452016.432379,35518234437.458019,2523281,534099,1862354,4919734
2012-02-06,CBSX (W),1609698,3902984,1687902,7200584,27806441.740000,96249594.050000,23169864.482200,147225900.272200,4956,1467,2403,8826
2012-02-06,NASDAQ PSX (X),25782333,13793187,24538765,64114285,559168582.690000,960252281.140000,555980195.280000,2075401059.110000,101467,34498,80534,216499
2012-02-06,BATS BYX (Y),89658122,22851407,37571984,150081513,2447907727.169999,1021440325.045000,1000631310.891303,4469979363.106302,601088,96260,240887,938235
2012-02-06,BATS BZX (Z),239214698,104239146,160410877,503864721,6937720827.614706,5908446318.635416,4593569210.095774,17439736356.345896,1439820,370502,932326,2742648
2012-02-03,NYSE MKT (A),0,13238507,3054476,16292983,0.000000,92033317.612600,80203352.453700,172236670.066300,0,27758,15255,43013
2012-02-03,NASDAQ BX (B),110916232,31708671,50524697,193149600,2439419055.700003,1132328803.000000,1309833082.774997,4881580941.475000,630464,101661,297848,1029973
2012-02-03,NSX (C),18198069,4464526,9739063,32401658,530277126.223601,140502579.252500,255727588.529100,926507294.005201,62292,10139,29809,102240
2012-02-03,NYSE (DN),107108496,20828388,52252908,180189792,3277054628.198105,1028228948.735100,1439634540.254502,5744918117.187707,527761,55608,240185,823554
2012-02-03,NASDAQ (DQ),1497830310,422298684,744356755,2664485749,38335557212.342627,19686081848.717854,17288022062.533264,75309661123.593745,3873462,601330,1797356,6272148
2012-02-03,EDGA (J),120703859,39044771,57344950,217093580,3192289954.733804,1792282335.935000,1528253737.673502,6512826028.342306,657534,122307,314752,1094593
2012-02-03,EDGX (K),336451298,72250830,177799105,586501233,9557026636.599081,3212728404.002495,4589215498.967861,17358970539.569437,1483075,202857,764663,2450595
2012-02-03,CHX (M),12039881,13877788,11554178,37471847,411743603.894500,1282016971.963300,251988007.328300,1945748583.186100,860,7761,1185,9806
2012-02-03,NYSE (N),905309237,0,0,905309237,28261042518.523162,0.000000,0.000000,28261042518.523162,2558126,0,0,2558126
2012-02-03,NYSE Arca (P),423135045,270981246,240200654,934316945,12507062341.951289,15204549383.914935,7350519717.832390,35062131443.698614,2191030,595891,1157340,3944261
2012-02-03,NASDAQ (Q),616931545,243716423,544160705,1404808673,18312350981.220035,14781729587.518158,15329102198.043077,48423182766.781270,3276612,783488,2323296,6383396
2012-02-03,CBSX (W),2661202,4839063,838839,8339104,43037746.200000,202676819.190000,9676828.535600,255391393.925600,6955,1717,1380,10052
2012-02-03,NASDAQ PSX (X),34635758,24167583,25042143,83845484,724744398.015000,1452004641.930000,599579645.629999,2776328685.574999,134026,51868,80553,266447
2012-02-03,BATS BYX (Y),114242816,35443152,47013738,196699706,3104221848.950004,1505582777.949998,1214029994.152501,5823834621.052503,747125,127598,298698,1173421
2012-02-03,BATS BZX (Z),315741314,158285936,195572621,669599871,9230765556.585031,8990584214.206200,5296972453.454407,23518322224.245638,1862767,535797,1109008,3507572
2012-02-02,NYSE MKT (A),0,14903329,3531148,18434477,0.000000,108666531.917400,83743170.071700,192409701.989100,0,29460,17269,46729
2012-02-02,NASDAQ BX (B),96388428,24963897,46175832,167528157,2194275550.870002,875459029.210000,1247750744.351600,4317485324.431602,596832,87967,292228,977027
2012-02-02,NSX (C),13901878,4110865,8179507,26192250,405135788.961200,153258696.451100,218663457.438900,777057942.851200,52247,9642,27314,89203
2012-02-02,NYSE (DN),86865445,17863758,46615028,151344231,2646742122.762002,933413008.795500,1375135961.882303,4955291093.439805,430952,52516,217296,700764
2012-02-02,NASDAQ (DQ),1323834286,394788100,642836436,2361458822,33362819253.359957,16496020472.183103,16315383431.748203,66174223157.291263,3464955,500463,1653978,5619396
2012-02-02,EDGA (J),103541734,31379283,49550486,184471503,2664142902.760000,1353230171.545000,1375687656.620100,5393060730.925100,585478,103949,289740,979167
2012-02-02,EDGX (K),296222208,62589986,167815861,526628055,8660511297.406994,2716129317.640697,4629595175.471042,16006235790.518733,1436119,192245,783466,2411830
2012-02-02,CHX (M),15652843,11411038,5242007,32305888,368758750.798000,769580970.902600,199336132.700700,1337675854.401300,841,2876,1061,4778
2012-02-02,NYSE (N),810386454,0,0,810386454,24878056008.398093,0.000000,0.000000,24878056008.398093,2390918,0,0,2390918
2012-02-02,NYSE Arca (P),384135501,207469188,209756291,801360980,11288881016.397944,10531908011.441603,6380271795.900932,28201060823.740479,2029527,516187,1070925,3616639
2012-02-02,NASDAQ (Q),548143498,202983766,487582414,1238709678,16159530244.738326,11620609546.553096,13696288934.330194,41476428725.621616,2973002,663916,2163398,5800316
2012-02-02,CBSX (W),1495265,5166293,1114640,7776198,29829099.160000,192704076.490000,23436653.640000,245969829.290000,5103,1285,2536,8924
2012-02-02,NASDAQ PSX (X),36758307,22352259,28276596,87387162,759784023.560000,1349504086.870000,662548405.055000,2771836515.485000,134341,53809,93026,281176
2012-02-02,BATS BYX (Y),101479981,27797492,44982223,174259696,2709681945.565004,1195186417.890000,1156958675.423604,5061827038.878608,697399,119076,302699,1119174
2012-02-02,BATS BZX (Z),285543949,137250558,182018730,604813237,8170265924.044997,7326694744.211299,5086512096.240104,20583472764.496400,1685677,487479,1066241,3239397
2012-02-01,NYSE MKT (A),0,12976079,3627352,16603431,0.000000,90638908.057300,103637322.908000,194276230.965300,0,28809,18002,46811
2012-02-01,NASDAQ BX (B),109589318,28685572,53233277,191508167,2405069516.097998,1001717097.822999,1411053533.314402,4817840147.235399,658221,97412,330347,1085980
2012-02-01,NSX (C),16946753,5249467,9516793,31713013,481937708.558900,160853282.939700,283380580.384999,926171571.883599,60598,12027,31898,104523
2012-02-01,NYSE (DN),101772410,20361878,48099403,170233691,3072404275.837595,982866597.232300,1470709651.059499,5525980524.129394,498305,58009,224918,781232
2012-02-01,NASDAQ (DQ),1436507189,417817362,716264251,2570588802,36944460775.676592,20333255083.467461,18665521084.763199,75943236943.907252,3851822,598353,1837945,6288120
2012-02-01,EDGA (J),119498923,36645428,59119931,215264282,3139033897.448894,1598933262.288001,1605642282.768005,6343609442.504900,674616,115839,333036,1123491
2012-02-01,EDGX (K),327290027,73216001,168941958,569447986,9667371817.874798,3382292147.080799,4669445595.929863,17719109560.885460,1574046,223441,776716,2574203
2012-02-01,CHX (M),13659364,9743444,8994493,32397301,492824694.110200,702908911.759500,299295841.766000,1495029447.635700,1164,2849,636,4649
2012-02-01,NYSE (N),892642949,0,0,892642949,27707453513.707729,0.000000,0.000000,27707453513.707729,2676837,0,0,2676837
2012-02-01,NYSE Arca (P),422790435,252360722,235337234,910488391,12815696250.397734,13340292594.889564,7606752690.489282,33762741535.776580,2279187,611162,1155038,4045387
2012-02-01,NASDAQ (Q),601476453,237628375,575969186,1415074014,18289393074.860989,14596704502.528028,16702174985.277981,49588272562.666998,3331429,780732,2503022,6615183
2012-02-01,CBSX (W),1613198,5836609,1176250,8626057,32416528.942500,353979632.620000,15021063.297800,401417224.860300,5837,1209,3727,10773
2012-02-01,NASDAQ PSX (X),30444039,23767711,25084527,79296277,682185650.480000,1494347522.820000,590629116.180000,2767162289.480000,124296,56583,82271,263150
2012-02-01,BATS BYX (Y),112273240,33162052,50573516,196008808,3047281475.654998,1507956438.320000,1324748958.794599,5879986872.769597,752910,129786,324250,1206946
2012-02-01,BATS BZX (Z),322652772,174234403,204181896,701069071,9281671457.614477,10084499005.004524,5790316375.008239,25156486837.627240,1929026,590253,1176507,3695786
2012-01-31,NYSE MKT (A),0,17217462,5760980,22978442,0.000000,142299845.650500,157352839.083500,299652684.734000,0,30668,34508,65176
2012-01-31,NASDAQ BX (B),90190310,24628816,42873090,157692216,1981571193.769997,878838013.358400,1174102730.034998,4034511937.163395,538681,79729,253616,872026
2012-01-31,NSX (C),18593049,5411701,8645546,32650296,562540573.250900,170666508.844900,242117972.387100,975325054.482900,76943,11586,33086,121615
2012-01-31,NYSE (DN),83658013,19252399,36660002,139570414,2535026678.531495,923527915.380200,1083595859.949000,4542150453.860695,427725,54869,180498,663092
2012-01-31,NASDAQ (DQ),1252556803,363046239,577708971,2193312013,32476889438.236511,16531815621.274795,15459289061.487925,64467994120.999231,3328753,493352,1412454,5234559
2012-01-31,EDGA (J),103713502,34414645,46017621,184145768,2737803528.452302,1468849739.607500,1245662606.574801,5452315874.634603,608736,112187,267291,988214
2012-01-31,EDGX (K),280452513,69625669,138355730,488433912,8368387640.870201,2892534205.400704,4165408746.934700,15426330593.205605,1375121,208480,661739,2245340
2012-01-31,CHX (M),15196407,12276649,6100769,33573825,490350904.141300,808893871.777600,228633811.018900,1527878586.937800,799,4686,734,6219
2012-01-31,NYSE (N),1034201742,0,0,1034201742,33611395007.198940,0.000000,0.000000,33611395007.198940,2531945,0,0,2531945
2012-01-31,NYSE Arca (P),412230488,260977629,207123256,880331373,12316412545.101405,13303183634.765824,7180731811.202195,32800327991.069424,2233567,622731,1006975,3863273
2012-01-31,NASDAQ (Q),527783525,226619874,501892505,1256295904,16165063569.528585,13607308355.507694,14589843816.688639,44362215741.724918,3066503,771705,1954930,5793138
2012-01-31,CBSX (W),1989661,3640792,838206,6468659,40335367.200000,269811982.609100,12656443.380000,322803793.189100,5200,1835,1675,8710
2012-01-31,NASDAQ PSX (X),27761103,23359090,22343167,73463360,598128307.255000,1451013632.510000,493827433.705000,2542969373.470000,114854,54495,72337,241686
2012-01-31,BATS BYX (Y),97269794,29525354,39282968,166078116,2627621076.375003,1350410674.131099,1032641689.562603,5010673440.068705,657449,114424,253761,1025634
2012-01-31,BATS BZX (Z),287345478,157870768,168770318,613986564,8467835720.721955,8645316395.356527,4743135681.599002,21856287797.677484,1744201,549562,951565,3245328
2012-01-30,NYSE MKT (A),0,11643486,6270782,17914268,0.000000,80376047.466200,166646169.500200,247022216.966400,0,26112,36676,62788
2012-01-30,NASDAQ BX (B),83652961,21936094,39038401,144627456,1825411773.840000,827882951.745000,1160633685.150001,3813928410.735001,501939,74492,249187,825618
2012-01-30,NSX (C),16664367,4225611,8095323,28985301,439568076.056000,151433221.962100,255253220.704102,846254518.722202,59871,9751,27375,96997
2012-01-30,NYSE (DN),75667508,13567178,39424393,128659079,2295134253.091003,691096143.867500,1131676972.569901,4117907369.528404,390960,42663,188011,621634
2012-01-30,NASDAQ (DQ),1156667505,298321430,549265009,2004253944,30521490018.658564,13383595282.956430,14403901536.205929,58308986837.820923,2966978,485307,1352042,4804327
2012-01-30,EDGA (J),97900761,28883240,46601938,173385939,2558880924.472603,1265033862.492301,1231679181.794105,5055593968.759009,575129,99558,269285,943972
2012-01-30,EDGX (K),259375178,60366637,134454385,454196200,7361731796.600674,2662573169.951306,3945657046.846676,13969962013.398656,1230912,180268,606647,2017827
2012-01-30,CHX (M),13961811,10014415,6401877,30378103,344275486.126800,643772614.703500,217827114.117800,1205875214.948100,975,3695,615,5285
2012-01-30,NYSE (N),743701780,0,0,743701780,23204629999.951328,0.000000,0.000000,23204629999.951328,2240514,0,0,2240514
2012-01-30,NYSE Arca (P),358573028,215427183,193482843,767483054,10621197117.478495,11476799019.491625,6523671130.115969,28621667267.086089,1943773,545960,950117,3439850
2012-01-30,NASDAQ (Q),472868512,196770445,427268501,1096907458,14379165040.030023,12090404110.739698,12409218136.089262,38878787286.858983,2779651,665477,1915609,5360737
2012-01-30,CBSX (W),1184670,3215893,675651,5076214,22344549.140000,143277133.940000,20299334.023900,185921017.103900,3220,1630,1409,6259
2012-01-30,NASDAQ PSX (X),28037930,20355721,24111066,72504717,617651304.570000,1276932741.380000,531058170.870000,2425642216.820000,109220,49087,72541,230848
2012-01-30,BATS BYX (Y),92871781,27880825,41237108,161989714,2548423343.854999,1259357366.895001,1044834504.957502,4852615215.707502,632184,112607,263766,1008557
2012-01-30,BATS BZX (Z),263423008,143805052,171748601,578976661,7518465017.646677,8083123218.312808,4772577074.056667,20374165310.016152,1569636,510838,949055,3029529
2012-01-27,NYSE MKT (A),0,11603422,6003796,17607218,0.000000,93740886.210800,163440073.129800,257180959.340600,0,28141,35738,63879
2012-01-27,NASDAQ BX (B),90108140,20646974,42868687,153623801,1992358996.254999,725601875.495000,1192417392.056997,3910378263.806996,529910,73013,261402,864325
2012-01-27,NSX (C),16744472,3480053,8730207,28954732,485099394.972800,131959029.144200,255024708.506101,872083132.623101,66274,8859,30978,106111
2012-01-27,NYSE (DN),93269672,15766249,43156263,152192184,2790086917.650999,750281575.233000,1305855346.852999,4846223839.736998,480789,39897,203056,723742
2012-01-27,NASDAQ (DQ),1259327893,301622849,598169005,2159119747,32195603766.981512,12307736778.043545,14710391020.517035,59213731565.542092,3032282,448067,1351976,4832325
2012-01-27,EDGA (J),100515590,31823347,46926546,179265483,2599133128.807302,1259324807.483401,1286966889.539296,5145424825.829999,588257,97308,274310,959875
2012-01-27,EDGX (K),262766966,57255667,136415820,456438453,7613095165.560095,2381020597.360798,3849523709.215499,13843639472.136392,1259778,169957,620827,2050562
2012-01-27,CHX (M),12787660,10236979,8123969,31148608,442143259.655600,770499630.095200,216255875.336600,1428898765.087400,749,4434,792,5975
2012-01-27,NYSE (N),850527487,0,0,850527487,26114737539.567733,0.000000,0.000000,26114737539.567733,2369877,0,0,2369877
2012-01-27,NYSE Arca (P),388805161,221496938,207871166,818173265,11335142604.519087,11608794258.676455,6707312682.623222,29651249545.818764,2031885,542820,987545,3562250
2012-01-27,NASDAQ (Q),514769472,205905012,463920290,1184594774,15456342708.330995,12323507932.312877,13485125022.296505,41264975662.940377,2973233,675395,1968464,5617092
2012-01-27,CBSX (W),1503161,4239123,807165,6549449,34213321.090000,172201277.560000,23848766.094200,230263364.744200,3672,1305,2169,7146
2012-01-27,NASDAQ PSX (X),30259553,20721876,22596910,73578339,665966162.925000,1215939577.340000,475327789.120000,2357233529.385000,125326,51062,75605,251993
2012-01-27,BATS BYX (Y),94691078,27200673,40605571,162497322,2642179811.444999,1297267875.830001,1072129370.899799,5011577058.174799,643411,104826,261402,1009639
2012-01-27,BATS BZX (Z),280396100,142540871,168721041,591658012,8045898101.154988,7902933892.725187,4787206506.365141,20736038500.245316,1633825,512119,947979,3093923
2012-01-26,NYSE MKT (A),0,13433118,7016838,20449956,0.000000,93221204.528200,200195548.217200,293416752.745400,0,29623,44447,74070
2012-01-26,NASDAQ BX (B),97110147,26000431,45608504,168719082,2109994838.199602,856149509.785000,1255379194.850998,4221523542.835600,560787,91378,266563,918728
2012-01-26,NSX (C),20861614,4316508,10118585,35296707,647520752.379301,149760120.980100,301630475.850101,1098911349.209502,79642,10390,34968,125000
2012-01-26,NYSE (DN),106187297,20417027,50206722,176811046,3238435928.786001,992369862.200000,1496322511.193599,5727128302.179600,524722,53404,219155,797281
2012-01-26,NASDAQ (DQ),1565935743,404448910,742186351,2712571004,41024931620.048615,18666824127.309383,17752870188.746605,77444625936.104603,3855717,588582,1607471,6051770
2012-01-26,EDGA (J),119207336,36559134,54937501,210703971,3016927048.263894,1468034758.960901,1449134696.702090,5934096503.926885,681024,117422,303495,1101941
2012-01-26,EDGX (K),312526883,65414094,150280229,528221206,9067970594.360406,2869625587.411900,4055914525.277270,15993510707.049576,1495738,206840,647599,2350177
2012-01-26,CHX (M),15130595,14768738,7690245,37589578,519035088.528399,1213191342.799900,249281522.020000,1981507953.348299,1404,5150,925,7479
2012-01-26,NYSE (N),866563469,0,0,866563469,27269395226.331658,0.000000,0.000000,27269395226.331658,2664727,0,0,2664727
2012-01-26,NYSE Arca (P),466014162,281308398,249013851,996336411,13625304140.648425,14887256493.652459,7673656500.710025,36186217135.010909,2413822,693047,1111957,4218826
2012-01-26,NASDAQ (Q),633984076,259883601,508085709,1401953386,19189791067.269695,15981946756.920302,14180285100.499308,49352022924.689305,3545088,880900,2234521,6660509
2012-01-26,CBSX (W),1540963,4621457,743993,6906413,36023644.010000,182525687.610000,22171105.040000,240720436.660000,2697,1901,1477,6075
2012-01-26,NASDAQ PSX (X),37258846,28613928,29140579,95013353,899404047.925000,1774045217.535000,567539806.519999,3240989071.979999,160507,69075,87011,316593
2012-01-26,BATS BYX (Y),106111310,30934800,44314375,181360485,2901381069.069000,1362783859.110000,1147510693.470003,5411675621.649003,734074,120086,283945,1138105
2012-01-26,BATS BZX (Z),337446522,175735852,201695845,714878219,9806187339.580205,9849189772.075976,5413896099.395328,25069273211.051509,2022122,654030,1079371,3755523
2012-01-25,NYSE MKT (A),0,13564175,9126696,22690871,0.000000,101363789.828100,230675399.020000,332039188.848100,0,34707,49280,83987
2012-01-25,NASDAQ BX (B),97802891,30747032,43832205,172382128,2124107860.149998,1103508147.095000,1436867579.730591,4664483586.975589,576522,97599,272420,946541
2012-01-25,NSX (C),20532789,5033227,8967684,34533700,605806132.637400,200233684.807400,318324157.283300,1124363974.728100,77202,12724,34408,124334
2012-01-25,NYSE (DN),103033306,19616357,49596929,172246592,3055091871.803998,1000855857.971300,1583961685.677996,5639909415.453294,522711,54174,220464,797349
2012-01-25,NASDAQ (DQ),1372472122,424789825,639292498,2436554445,36027730205.446694,20343476465.534630,18730935878.239838,75102142549.221162,3811887,604918,1582114,5998919
2012-01-25,EDGA (J),116902458,37193664,48766621,202862743,2945146890.063997,1574971428.348001,1586186538.265694,6106304856.677692,686512,122451,292639,1101602
2012-01-25,EDGX (K),311748249,78560141,144898903,535207293,8952908632.798635,3610139142.189205,5101865902.380308,17664913677.368148,1491543,233029,680590,2405162
2012-01-25,CHX (M),12571226,22876664,6303288,41751178,406776137.189400,1392959545.776300,275590837.538400,2075326520.504100,774,9334,773,10881
2012-01-25,NYSE (N),835693629,0,0,835693629,26587355650.360862,0.000000,0.000000,26587355650.360862,2670148,0,0,2670148
2012-01-25,NYSE Arca (P),441449597,273029499,233758863,948237959,12983687309.425762,14767541021.694778,9741045659.440063,37492273990.560603,2341291,704463,1120644,4166398
2012-01-25,NASDAQ (Q),661068710,290342854,517127501,1468539065,19796223274.839513,17675692488.942906,17518802145.113625,54990717908.896044,3760654,928340,2374306,7063300
2012-01-25,CBSX (W),1976147,2299802,583886,4859835,29944539.060000,77522803.360000,16493990.910000,123961333.330000,4825,1543,1614,7982
2012-01-25,NASDAQ PSX (X),35300241,29377492,25545775,90223508,862570984.885000,1733392658.470000,647323844.475000,3243287487.830000,155717,68048,92695,316460
2012-01-25,BATS BYX (Y),109829252,35583581,45230189,190643022,2955805106.214998,1611878395.269999,1552890593.825705,6120574095.310702,742984,133840,294273,1171097
2012-01-25,BATS BZX (Z),337151927,191252267,198977989,727382183,9950631970.843908,10700229064.807309,6680191613.307874,27331052648.959091,2047644,670728,1123809,3842181
2012-01-24,NYSE MKT (A),0,11351016,7358553,18709569,0.000000,73727463.223600,190033112.729500,263760575.953100,0,22971,45358,68329
2012-01-24,NASDAQ BX (B),77203946,17959673,34923972,130087591,1650669419.625001,624364626.530000,1122668118.105000,3397702164.260001,453597,63201,214409,731207
2012-01-24,NSX (C),14496684,2475200,6951670,23923554,420627456.001500,98188818.822100,202949377.514400,721765652.338000,50723,7139,23331,81193
2012-01-24,NYSE (DN),86665876,13614905,42033146,142313927,2658052678.422499,665432402.061000,1264010171.915998,4587495252.399497,446435,39213,195206,680854
2012-01-24,NASDAQ (DQ),1193214456,284980887,560674138,2038869481,30533320501.360956,12974360440.146362,14627206718.959095,58134887660.466413,3208704,431677,1399993,5040374
2012-01-24,EDGA (J),97336713,25353607,42795146,165485466,2524668182.279102,1021566807.806400,1102286640.274896,4648521630.360398,570137,79071,246293,895501
2012-01-24,EDGX (K),243609145,50061137,124536555,418206837,7055354167.248976,2105863605.634404,3447009188.415002,12608226961.298382,1176127,148204,570593,1894924
2012-01-24,CHX (M),10372577,8366330,5175560,23914467,329972831.933900,497907277.287000,262926959.520900,1090807068.741800,998,2998,751,4747
2012-01-24,NYSE (N),742709198,0,0,742709198,23383133199.367766,0.000000,0.000000,23383133199.367766,2199566,0,0,2199566
2012-01-24,NYSE Arca (P),359729875,183447646,194342706,737520227,10597971765.926262,9410046658.364604,7255938947.076416,27263957371.367282,1866329,453454,916829,3236612
2012-01-24,NASDAQ (Q),499684243,169070535,444488803,1113243581,15047896116.815453,9838583030.180802,13649978208.325771,38536457355.322026,2823899,571312,1916073,5311284
2012-01-24,CBSX (W),1952441,2497795,698572,5148808,35694455.060000,161999163.556000,15557558.577100,213251177.193100,5311,1493,1793,8597
2012-01-24,NASDAQ PSX (X),30502182,16722342,24255108,71479632,760038709.320000,1042173929.280000,533927810.300000,2336140448.900000,133925,43004,77322,254251
2012-01-24,BATS BYX (Y),81372906,20711336,37224762,139309004,2192669464.085001,898214549.760000,1025313168.123402,4116197181.968403,560568,83875,235853,880296
2012-01-24,BATS BZX (Z),258161594,120280894,158535749,536978237,7332416547.965278,6103049941.999801,4405315656.856288,17840782146.821367,1533824,418561,892631,2845016
2012-01-23,NYSE MKT (A),0,11087664,8058448,19146112,0.000000,79782314.836400,215336339.854000,295118654.690400,0,25180,56931,82111
2012-01-23,NASDAQ BX (B),86307200,21781083,40517732,148606015,1815872572.295000,645889099.354999,1081988408.937002,3543750080.587001,494537,72495,233005,800037
2012-01-23,NSX (C),13149909,3123124,7611025,23884058,390038129.472500,108159622.747900,197466032.303901,695663784.524301,47846,8082,23063,78991
2012-01-23,NYSE (DN),89498085,20353501,40973463,150825049,2664957768.448399,932012774.717400,1220253220.658201,4817223763.824000,473545,55061,202132,730738
2012-01-23,NASDAQ (DQ),1221718229,381928758,569632046,2173279033,30860558144.544597,15984218983.304156,14809917900.528074,61654695028.376827,3235982,528420,1379840,5144242
2012-01-23,EDGA (J),100619400,30732868,43240030,174592298,2535891713.704998,1208475387.195501,1081733456.200101,4826100557.100600,584056,87395,250805,922256
2012-01-23,EDGX (K),266947955,59995906,136460563,463404424,7363009854.260687,2552269328.105902,3624313801.415117,13539592983.781706,1241848,180613,592204,2014665
2012-01-23,CHX (M),15835143,7854735,8063617,31753495,576913471.555000,575009525.495700,235446734.083300,1387369731.134000,1188,3280,821,5289
2012-01-23,NYSE (N),723088524,0,0,723088524,22396027598.233509,0.000000,0.000000,22396027598.233509,2213987,0,0,2213987
2012-01-23,NYSE Arca (P),375979837,231879877,197337548,805197262,10862566528.959287,11608166545.899204,6154933390.191781,28625666465.050272,1973249,567587,926649,3467485
2012-01-23,NASDAQ (Q),478244709,185114452,416469731,1079828892,14354339477.723891,10588628654.730640,12069085033.923042,37012053166.377573,2779722,622565,1863175,5265462
2012-01-23,CBSX (W),2223460,4084942,1013166,7321568,45943079.141000,172380563.770000,18538185.660000,236861828.571000,4415,1355,2565,8335
2012-01-23,NASDAQ PSX (X),30061042,18792005,25397642,74250689,652160028.445000,1191888749.910000,528602597.800000,2372651376.155000,113825,42283,69803,225911
2012-01-23,BATS BYX (Y),93249464,26506589,39496989,159253042,2481695082.685000,1130840385.160000,985324476.386800,4597859944.231800,623372,100001,248610,971983
2012-01-23,BATS BZX (Z),273931040,142230967,167493579,583655586,7860111606.508203,7437570272.149692,4631667647.962068,19929349526.619963,1661761,511262,934976,3107999
2012-01-20,NYSE MKT (A),0,11663513,9398430,21061943,0.000000,61552386.900400,251608193.425500,313160580.325900,0,20822,68465,89287
2012-01-20,NASDAQ BX (B),92773844,21323722,48123470,162221036,1958908408.689999,664169830.824001,1487545000.917202,4110623240.431202,524365,66354,274878,865597
2012-01-20,NSX (C),14440668,3127473,8638237,26206378,429857309.444900,109929607.573200,277307323.882000,817094240.900100,55250,9273,28813,93336
2012-01-20,NYSE (DN),86712402,15271011,49706732,151690145,2686189267.968997,741552011.822300,1631407928.689301,5059149208.480598,460527,40109,227785,728421
2012-01-20,NASDAQ (DQ),1222284201,305609179,630327375,2158220755,32338453916.663911,13821637228.469063,17441950638.166222,63602041783.299196,3299199,444171,1548557,5291927
2012-01-20,EDGA (J),101636009,30045261,52973420,184654690,2626711360.615503,1203584576.334800,1505772885.051704,5336068822.002007,582154,86972,283784,952910
2012-01-20,EDGX (K),245119606,53947134,141867858,440934598,7303461233.827804,2374587640.027798,4345522640.216708,14023571514.072310,1225375,156732,630316,2012423
2012-01-20,CHX (M),16873439,17141056,10194486,44208981,590158789.234600,1269512033.212400,369088685.439800,2228759507.886800,1183,3926,931,6040
2012-01-20,NYSE (N),927244621,0,0,927244621,30704175493.442362,0.000000,0.000000,30704175493.442362,2181631,0,0,2181631
2012-01-20,NYSE Arca (P),369669353,235984683,223081557,828735593,10989944040.240799,12414128371.163295,8050702005.393354,31454774416.797448,1913289,505423,995335,3414047
2012-01-20,NASDAQ (Q),494034245,175422593,552773697,1222230535,15146419103.621426,10498927167.849560,17249802054.205498,42895148325.676484,2782911,566559,2023438,5372908
2012-01-20,CBSX (W),2599198,2175052,688566,5462816,55365160.292000,115368199.310000,16605352.251600,187338711.853600,7229,1720,1885,10834
2012-01-20,NASDAQ PSX (X),24929352,18304068,24671380,67904800,575497503.555000,1045793416.710000,560584878.485000,2181875798.750000,104703,42367,75937,223007
2012-01-20,BATS BYX (Y),94298397,26600388,46503927,167402712,2556278470.089995,1122653315.940000,1310651760.349997,4989583546.379992,627161,92717,275470,995348
2012-01-20,BATS BZX (Z),267775097,132479253,188881379,589135729,8061963141.462242,6925699408.809997,5709276728.909522,20696939279.181761,1627086,455091,1008913,3091090
2012-01-19,NYSE MKT (A),0,10136751,11609832,21746583,0.000000,67376540.490000,302421179.120400,369797719.610400,0,23942,76380,100322
2012-01-19,NASDAQ BX (B),107176853,22294405,49591800,179063058,2124364255.820004,672858051.830000,1337448753.893598,4134671061.543602,557136,70389,269110,896635
2012-01-19,NSX (C),18365250,4349482,10239536,32954268,546054052.737300,151735921.124200,293535160.555000,991325134.416500,63862,11035,33438,108335
2012-01-19,NYSE (DN),110316943,16139104,51662957,178119004,3327623951.406206,788097217.571000,1555042540.265001,5670763709.242207,563598,46766,247805,858169
2012-01-19,NASDAQ (DQ),1436322418,362224384,671555099,2470101901,35623911789.088801,15148175857.130620,17023034999.640461,67795122645.859882,3751885,534340,1662985,5949210
2012-01-19,EDGA (J),116153829,32685850,56126894,204966573,2930074377.648899,1294382495.812200,1468261490.733501,5692718364.194600,640221,93101,295189,1028511
2012-01-19,EDGX (K),308277954,61454374,156425458,526157786,8494839084.027167,2591230407.259000,4308384444.206324,15394453935.492491,1387279,176970,684997,2249246
2012-01-19,CHX (M),18599784,22640714,8766328,50006826,462102020.316100,1376129287.811000,306143212.230500,2144374520.357600,1299,3111,1087,5497
2012-01-19,NYSE (N),806035881,0,0,806035881,24610184856.721578,0.000000,0.000000,24610184856.721578,2336168,0,0,2336168
2012-01-19,NYSE Arca (P),466242282,232224139,239982891,938449312,12698302047.996350,11462112055.436909,8067181977.654863,32227596081.088122,2182310,530951,1081571,3794832
2012-01-19,NASDAQ (Q),613681355,189218537,497226707,1300126599,18060830576.033423,11068373725.785926,14931616994.298767,44060821296.118116,3267408,675735,2174397,6117540
2012-01-19,CBSX (W),2037644,5146142,1163774,8347560,39344976.340000,196811763.440000,17356623.614800,253513363.394800,4483,1808,2269,8560
2012-01-19,NASDAQ PSX (X),32952199,20350263,25217280,78519742,702049423.410000,1177065574.380000,538117217.110000,2417232214.900000,121433,45859,79443,246735
2012-01-19,BATS BYX (Y),104911308,27017337,47016301,178944946,2689910682.230002,1138324498.476801,1233592581.504199,5061827762.211002,671644,98203,277555,1047402
2012-01-19,BATS BZX (Z),325939109,134908808,196160450,657008367,8991475757.183423,6842695771.376488,5423678127.981596,21257849656.541507,1829477,463777,1055715,3348969
2012-01-18,NYSE MKT (A),0,12291266,11640895,23932161,0.000000,72981074.883400,303661735.367000,376642810.250400,0,24238,76267,100505
2012-01-18,NASDAQ BX (B),97443236,27989727,52214141,177647104,2033267971.120001,808232696.470000,1246917646.255000,4088418313.845001,558118,86077,293371,937566
2012-01-18,NSX (C),18268057,4330692,9337119,31935868,484531111.458800,161074513.072400,243554619.288497,889160243.819697,60138,10596,30020,100754
2012-01-18,NYSE (DN),90889643,16486362,52752083,160128088,2643451861.574000,760581096.233000,1495824618.195502,4899857576.002502,466851,46289,235469,748609
2012-01-18,NASDAQ (DQ),1270880455,351264324,663702952,2285847731,31737639962.578991,17037981452.214888,16262989870.615118,65038611285.408997,3465234,523392,1618101,5606727
2012-01-18,EDGA (J),110528105,30807059,55489190,196824354,2746313002.159598,1254939864.859500,1390620191.371198,5391873058.390296,617824,93906,292992,1004722
2012-01-18,EDGX (K),277407452,61265215,149887694,488560361,7592557241.473591,2809673158.281907,4035608441.734899,14437838841.490397,1276527,187047,660175,2123749
2012-01-18,CHX (M),12147183,9304858,7211092,28663133,401255657.501100,762080908.621200,191086912.675501,1354423478.797801,1201,3627,958,5786
2012-01-18,NYSE (N),797803883,0,0,797803883,24791884608.165773,0.000000,0.000000,24791884608.165773,2354952,0,0,2354952
2012-01-18,NYSE Arca (P),416633089,243406956,230533517,890573562,11874533354.168945,12839600947.526237,6904354438.727016,31618488740.422198,2138574,561904,1069600,3770078
2012-01-18,NASDAQ (Q),565854167,201420654,521022159,1288296980,16960549719.236902,12037083796.426950,14383092921.567093,43380726437.230945,3181546,672310,2203597,6057453
2012-01-18,CBSX (W),1625159,3100454,1429549,6155162,38792116.310000,113662650.500000,24816843.620000,177271610.430000,4080,2368,1890,8338
2012-01-18,NASDAQ PSX (X),29219336,20891015,27764036,77874387,639742062.040000,1294618818.120000,571601940.900000,2505962821.060000,116678,49024,79305,245007
2012-01-18,BATS BYX (Y),101988203,28043790,47053692,177085685,2579970716.544996,1211436468.795000,1213313044.669207,5004720230.009203,661053,102935,284705,1048693
2012-01-18,BATS BZX (Z),308111468,148365464,207214307,663691239,8568358241.575795,7824701890.762375,5422427457.421062,21815487589.759232,1782778,507752,1096965,3387495
2012-01-17,NYSE MKT (A),0,12764977,8853215,21618192,0.000000,71349814.411300,202988077.336300,274337891.747600,0,24300,45075,69375
2012-01-17,NASDAQ BX (B),94005771,22796647,47527920,164330338,1967074776.289999,661183790.760000,1163666790.364202,3791925357.414201,527621,68190,256603,852414
2012-01-17,NSX (C),16583993,4222766,9884410,30691169,469308622.497799,125594066.926100,240971568.862402,835874258.286301,62135,9829,32386,104350
2012-01-17,NYSE (DN),85991880,17047052,43545985,146584917,2468493685.594998,845006856.373000,1133667860.338002,4447168402.306000,462195,50436,215319,727950
2012-01-17,NASDAQ (DQ),1286205706,320085663,643242528,2249533897,33934641459.018248,13696540385.036940,14680961130.815788,62312142974.870976,3349909,493503,1460525,5303937
2012-01-17,EDGA (J),108530388,27902386,51290545,187723319,2685457195.506698,1177286757.672000,1227210653.969299,5089954607.147997,601783,90273,271177,963233
2012-01-17,EDGX (K),265198967,54799207,135826222,455824396,7342790781.204811,2430229522.749699,3360476624.899507,13133496928.854017,1196186,167277,586317,1949780
2012-01-17,CHX (M),9879036,11833583,4534690,26247309,377803955.344700,824147493.804600,169237886.547900,1371189335.697200,1395,2821,377,4593
2012-01-17,NYSE (N),810580145,0,0,810580145,24464947141.651759,0.000000,0.000000,24464947141.651759,2244865,0,0,2244865
2012-01-17,NYSE Arca (P),385080214,222716481,207962941,815759636,10805552696.922455,11601836099.590682,5775362749.318310,28182751545.831447,1949718,531574,925724,3407016
2012-01-17,NASDAQ (Q),531595045,178506384,468851120,1178952549,15607788681.715567,10581081690.379729,12617675376.470572,38806545748.565868,2919435,576673,1911954,5408062
2012-01-17,CBSX (W),2733606,2431748,1031719,6197073,42721473.880000,77410612.300000,21274915.647300,141407001.827300,6328,1732,2114,10174
2012-01-17,NASDAQ PSX (X),28222113,18879347,24323682,71425142,635015705.885000,1151502595.945600,482436776.720000,2268955078.550600,112884,45428,70168,228480
2012-01-17,BATS BYX (Y),97379592,26178151,41886289,165444032,2499397434.761100,1103347301.090000,988586492.101598,4591331227.952698,621401,95923,247604,964928
2012-01-17,BATS BZX (Z),288577854,133582353,180117332,602277539,8001068273.430111,6927957238.389836,4512965358.743943,19441990870.563890,1667407,454515,952695,3074617
2012-01-13,NYSE MKT (A),0,9327841,7347583,16675424,0.000000,58950828.494800,176222329.731500,235173158.226300,0,19700,47295,66995
2012-01-13,NASDAQ BX (B),83649631,22205414,41606267,147461312,1727630379.400800,700575166.735000,1023648542.103700,3451854088.239500,477598,66931,225058,769587
2012-01-13,NSX (C),16005377,3350293,8492044,27847714,362581448.032000,139224385.540000,198105172.276100,699911005.848100,51695,9216,25960,86871
2012-01-13,NYSE (DN),81150427,16965659,40298856,138414942,2428928040.700003,939015489.779000,1068454088.871001,4436397619.350004,419522,41151,185034,645707
2012-01-13,NASDAQ (DQ),1155450651,300860555,549697460,2006008666,30194536498.830422,13525933944.220452,12315234129.706623,56035704572.757497,2946126,464315,1304137,4714578
2012-01-13,EDGA (J),95031754,29064095,43689101,167784950,2352663162.073398,1240468101.730201,1058633223.365698,4651764487.169297,533424,92773,234556,860753
2012-01-13,EDGX (K),248383882,59763032,127236823,435383737,6758082589.121818,2820785278.247002,3172545807.222314,12751413674.591134,1189057,191589,576847,1957493
2012-01-13,CHX (M),15419832,9023337,6168463,30611632,374533844.498200,743619583.291800,189883560.123100,1308036987.913100,1589,3718,1025,6332
2012-01-13,NYSE (N),827879968,0,0,827879968,25750729368.239493,0.000000,0.000000,25750729368.239493,2308871,0,0,2308871
2012-01-13,NYSE Arca (P),382287069,236783994,195057433,814128496,10486564322.362078,12998358176.930743,5884038576.869658,29368961076.162479,1954062,599647,904825,3458534
2012-01-13,NASDAQ (Q),475576075,212053973,448090727,1135720775,13647298122.857769,13774209792.674760,12093655646.763018,39515163562.295547,2723169,722503,1866163,5311835
2012-01-13,CBSX (W),1977592,2179922,1928329,6085843,35625639.810000,60781051.170000,32608389.650000,129015080.630000,5556,2299,2047,9902
2012-01-13,NASDAQ PSX (X),25662538,25016105,19607739,70286382,555426386.900000,1680153797.570001,426091152.175000,2661671336.645001,104243,60078,65605,229926
2012-01-13,BATS BYX (Y),84590524,27216658,37511983,149319165,2210172821.389998,1254835725.720000,979625886.905504,4444634434.015502,560935,99273,222518,882726
2012-01-13,BATS BZX (Z),262950141,144786421,162996397,570732959,7421170778.814795,8315497089.651761,4266419894.748296,20003087763.214852,1581161,524001,883622,2988784
2012-01-12,NYSE MKT (A),0,9860898,7260197,17121095,0.000000,63663366.317700,167856527.318000,231519893.635700,0,23415,45952,69367
2012-01-12,NASDAQ BX (B),95561064,23826147,42686441,162073652,1832143618.716800,686806627.360000,1004644147.242100,3523594393.318900,510920,70576,237768,819264
2012-01-12,NSX (C),15009793,3774414,6718857,25503064,337627976.434400,135270452.653100,158707078.028001,631605507.115501,45618,9282,21951,76851
2012-01-12,NYSE (DN),96325376,19588295,39844369,155758040,2663005286.273800,805486594.282500,1082134249.822702,4550626130.379002,464728,43998,189965,698691
2012-01-12,NASDAQ (DQ),1354626843,311182708,592604944,2258414495,34137161216.678840,12713676784.945653,13599533438.134836,60450371439.759329,3379755,473424,1451807,5304986
2012-01-12,EDGA (J),109225506,30278237,46093345,185597088,2665653306.085003,1136959290.886199,1150657591.332299,4953270188.303501,590919,92141,254798,937858
2012-01-12,EDGX (K),271783288,60062337,134832917,466678542,7687430640.564444,2712645006.256006,3389306346.360193,13789381993.180643,1297671,188425,626175,2112271
2012-01-12,CHX (M),12447463,7868026,5079096,25394585,404856008.623600,525487495.805000,168920559.334000,1099264063.762600,1107,3583,766,5456
2012-01-12,NYSE (N),770312216,0,0,770312216,23351893657.830812,0.000000,0.000000,23351893657.830812,2231300,0,0,2231300
2012-01-12,NYSE Arca (P),388146479,208575030,187790637,784512146,10647028216.977364,10323189529.188421,5603229328.726583,26573447074.892368,1940746,544022,904696,3389464
2012-01-12,NASDAQ (Q),504905598,187220160,426651387,1118777145,14476248739.598869,10979932271.456820,11466229642.306759,36922410653.362448,2829118,675746,1895610,5400474
2012-01-12,CBSX (W),2996915,4312126,1023166,8332207,51030606.040000,180326938.410000,30750490.180000,262108034.630000,9324,2399,2435,14158
2012-01-12,NASDAQ PSX (X),26159401,20677153,17570421,64406975,557138004.810000,1209783133.600001,351834732.140000,2118755870.550001,102596,48456,56898,207950
2012-01-12,BATS BYX (Y),94705811,27720001,37919390,160345202,2372175700.869998,1057793523.749999,940271796.014998,4370241020.634995,598919,96018,232723,927660
2012-01-12,BATS BZX (Z),282008837,137236451,161498841,580744129,7719512072.956683,7080139026.880303,4009771616.333126,18809422716.170112,1649480,499016,916375,3064871
2012-01-11,NYSE MKT (A),0,9194551,7243678,16438229,0.000000,64001106.963700,174838961.783200,238840068.746900,0,22332,48520,70852
2012-01-11,NASDAQ BX (B),96219016,19903278,40732205,156854499,1819819819.784700,606909434.503500,986517072.875600,3413246327.163800,507356,62951,238862,809169
2012-01-11,NSX (C),19527520,3119618,7355581,30002719,370133984.510200,113695928.072500,199606360.513299,683436273.095999,52235,7691,25548,85474
2012-01-11,NYSE (DN),103716966,14227292,45400828,163345086,2797446941.590496,653248113.464200,1264832593.185396,4715527648.240092,482945,41408,204775,729128
2012-01-11,NASDAQ (DQ),1315324314,276440851,580601557,2172366722,30091174629.206591,11792581601.497700,13437192867.054459,55320949097.758750,3281797,438273,1448491,5168561
2012-01-11,EDGA (J),110122798,25964976,47862237,183950011,2643427373.761605,1079712946.656200,1208544386.013195,4931684706.431000,585408,84483,268270,938161
2012-01-11,EDGX (K),282161584,47843031,130583844,460588459,7339089762.323707,2099329425.517197,3263720330.887873,12702139518.728777,1274494,149167,633943,2057604
2012-01-11,CHX (M),13238235,10368057,6753003,30359295,416756137.277900,640572001.498800,199755348.325000,1257083487.101700,1629,3320,731,5680
2012-01-11,NYSE (N),759117850,0,0,759117850,22086369931.669676,0.000000,0.000000,22086369931.669676,2223075,0,0,2223075
2012-01-11,NYSE Arca (P),385281212,189943723,194858909,770083844,9971235608.460230,9635462367.764313,5834060012.776162,25440757989.000705,1871825,485682,925159,3282666
2012-01-11,NASDAQ (Q),504777531,161249956,445672432,1111699919,14384886676.383272,9619734106.346793,11960853583.424736,35965474366.154801,2841136,574849,1934312,5350297
2012-01-11,CBSX (W),3003144,1510848,1257677,5771669,49601860.920000,36036527.530000,25082615.739200,110721004.189200,5758,1470,2521,9749
2012-01-11,NASDAQ PSX (X),31240599,18688269,25610629,75539497,638111921.360000,1096995486.848000,523957387.719999,2259064795.927999,117062,44330,77816,239208
2012-01-11,BATS BYX (Y),91284799,22346278,37364607,150995684,2275591961.475901,934809550.209999,920046836.561902,4130448348.247802,575148,84268,228468,887884
2012-01-11,BATS BZX (Z),277531757,122750836,172663690,572946283,7536022023.987031,6629203663.123978,4430312625.040373,18595538312.151382,1601998,426668,943596,2972262
2012-01-10,NYSE MKT (A),0,10745426,7645142,18390568,0.000000,71820963.091300,187128688.615200,258949651.706500,0,23607,50654,74261
2012-01-10,NASDAQ BX (B),94399797,22040790,43321669,159762256,1839497676.332502,695764110.770000,1179003951.774999,3714265738.877501,529110,74843,265662,869615
2012-01-10,NSX (C),19042211,3709573,7386797,30138581,331413754.187201,124612338.959700,205005030.297100,661031123.444001,48298,9221,25521,83040
2012-01-10,NYSE (DN),108557542,17978039,46254314,172789895,3007260164.123702,841465637.781000,1408467994.447001,5257193796.351703,525710,52934,221723,800367
2012-01-10,NASDAQ (DQ),1374572040,301070964,622157264,2297800268,31857800648.850111,13244898113.581051,15551372368.333696,60654071130.764858,3569171,504921,1633734,5707826
2012-01-10,EDGA (J),114640267,32332749,49814018,196787034,2849458125.661201,1222756358.415801,1308508212.688492,5380722696.765494,618377,95747,290810,1004934
2012-01-10,EDGX (K),289340443,56740324,137869906,483950673,7840896236.193734,2487973214.467201,3913101196.861908,14241970647.522843,1353532,181894,688480,2223906
2012-01-10,CHX (M),10353016,11744896,10103234,32201146,290231149.780200,757996441.908400,233888771.615400,1282116363.304000,1471,4021,648,6140
2012-01-10,NYSE (N),840833355,0,0,840833355,25332195912.860509,0.000000,0.000000,25332195912.860509,2418757,0,0,2418757
2012-01-10,NYSE Arca (P),404505505,207837077,198023521,810366103,10706971298.128433,10204713241.649598,6495840173.960135,27407524713.738166,1970111,536993,975868,3482972
2012-01-10,NASDAQ (Q),538433092,179737522,478794602,1196965216,15513442707.897715,10641624509.266168,13459862611.076160,39614929828.240043,3034132,641529,2075354,5751015
2012-01-10,CBSX (W),2286970,3866418,823971,6977359,36315692.650000,162455195.560000,18217709.960000,216988598.170000,5641,2542,1898,10081
2012-01-10,NASDAQ PSX (X),34883608,21385514,28904904,85174026,772071070.755000,1277925477.064000,596377768.890000,2646374316.709000,138006,55835,85257,279098
2012-01-10,BATS BYX (Y),98352174,26003839,41451402,165807415,2463044275.596502,1053392012.975000,1057809500.199999,4574245788.771501,630385,99152,257593,987130
2012-01-10,BATS BZX (Z),295750707,130150370,180128473,606029550,8017405884.530301,7108456096.299713,5035244474.099000,20161106454.929014,1724696,485652,1018628,3228976
2012-01-09,NYSE MKT (A),0,10120575,8614201,18734776,0.000000,65556013.668000,203961252.390000,269517266.058000,0,24851,52291,77142
2012-01-09,NASDAQ BX (B),77869486,16762623,42897661,137529770,1581382760.088402,546675304.145000,1198885717.306996,3326943781.540398,453232,64646,253764,771642
2012-01-09,NSX (C),11868997,3020265,7127374,22016636,261963630.005100,96010271.179300,213015989.435100,570989890.619500,38233,8250,23705,70188
2012-01-09,NYSE (DN),78007171,12157943,50546461,140711575,2158763694.602000,554311319.167000,1404423333.924500,4117498347.693500,410745,38244,223410,672399
2012-01-09,NASDAQ (DQ),1078316692,256665746,609605455,1944587893,26580007666.061493,11547197682.505046,16154835187.561367,54282040536.127906,2843311,409154,1554720,4807185
2012-01-09,EDGA (J),98836690,23758786,51968856,174564332,2571049377.805694,981528353.369700,1374226735.372808,4926804466.548202,568952,85100,293901,947953
2012-01-09,EDGX (K),221336443,48559757,134800505,404696705,6161715532.106414,2148754328.427099,3964322660.565402,12274792521.098915,1096966,153674,655563,1906203
2012-01-09,CHX (M),7540176,7044611,4790391,19375178,273193213.228300,556734789.434700,139211200.032300,969139202.695300,855,2693,621,4169
2012-01-09,NYSE (N),721584691,0,0,721584691,21446289724.116781,0.000000,0.000000,21446289724.116781,2144836,0,0,2144836
2012-01-09,NYSE Arca (P),308069989,201737854,202853061,712660904,8412070266.978675,9844881295.773496,7057653387.972085,25314604950.724256,1617497,479526,974208,3071231
2012-01-09,NASDAQ (Q),426652783,162972342,474841071,1064466196,12344910226.975181,9356791184.380841,13812743193.113182,35514444604.469204,2494318,591536,2058064,5143918
2012-01-09,CBSX (W),2565029,2533290,2312029,7410348,39328535.110000,131120052.610000,70834347.570000,241282935.290000,5028,1232,2408,8668
2012-01-09,NASDAQ PSX (X),24963014,16389364,23747992,65100370,508926944.695000,983165790.390000,488189492.530000,1980282227.615000,95897,43886,68832,208615
2012-01-09,BATS BYX (Y),83510168,22595388,43187561,149293117,2110619076.514000,941399266.995000,1114987414.672997,4167005758.181997,557196,97206,261927,916329
2012-01-09,BATS BZX (Z),234519577,111553847,184520827,530594251,6456337426.374879,5956018989.898011,5058068470.083645,17470424886.356535,1430242,407698,1001068,2839008
2012-01-06,NYSE MKT (A),0,9656493,6504480,16160973,0.000000,64870458.091300,155827740.495600,220698198.586900,0,23571,46439,70010
2012-01-06,NASDAQ BX (B),76578243,17981479,42653528,137213250,1595058453.384000,642859023.890000,1077810121.321498,3315727598.595498,452623,71498,243951,768072
2012-01-06,NSX (C),12401938,3692961,7272385,23367284,279635186.701000,134325857.039200,196117968.870799,610079012.610999,42142,9945,22701,74788
2012-01-06,NYSE (DN),86331887,16643059,43383768,146358714,2430137679.647001,815643586.048000,1217094346.072502,4462875611.767503,430582,47705,198884,677171
2012-01-06,NASDAQ (DQ),1274059354,301731862,611779839,2187571055,32200671368.744036,14199046334.104405,14914664041.891962,61314381744.740403,3095858,456271,1496093,5048222
2012-01-06,EDGA (J),99992059,29393232,48357235,177742526,2483116238.013692,1186723382.597900,1273606475.245202,4943446095.856794,574262,93502,276457,944221
2012-01-06,EDGX (K),237778151,58131276,124568715,420478142,6860149791.434584,2618479790.380203,3709680841.334935,13188310423.149722,1184882,183360,608631,1976873
2012-01-06,CHX (M),9798438,14492450,6180263,30471151,346113698.691600,795619564.330500,174180691.838200,1315913954.860300,924,3823,675,5422
2012-01-06,NYSE (N),710509568,0,0,710509568,21827822993.456100,0.000000,0.000000,21827822993.456100,2203518,0,0,2203518
2012-01-06,NYSE Arca (P),342140161,214034692,193778252,749953105,9275150878.034975,11289381139.092719,6210503457.077747,26775035474.205441,1738575,547051,904148,3189774
2012-01-06,NASDAQ (Q),447405177,192451308,439562748,1079419233,12844364343.275124,11700186609.980681,12136387477.799809,36680938431.055614,2550996,672646,1919564,5143206
2012-01-06,CBSX (W),1224767,1935619,828474,3988860,26121263.730000,70768913.810000,12305033.800800,109195211.340800,3825,1090,2355,7270
2012-01-06,NASDAQ PSX (X),25956336,21117446,22510351,69584133,514150936.650000,1240007207.329999,483129109.966000,2237287253.945999,96795,51177,70133,218105
2012-01-06,BATS BYX (Y),87223615,26610545,41041652,154875812,2181939401.897503,1111304216.965000,1116640520.489999,4409884139.352502,556903,102824,242727,902454
2012-01-06,BATS BZX (Z),243953147,140223524,164609064,548785735,6712464016.929203,7441758582.286102,4594565433.628917,18748788032.844222,1458041,468911,908105,2835057
2012-01-05,NYSE MKT (A),0,11133732,6812245,17945977,0.000000,70533334.795200,150730889.161800,221264223.957000,0,23738,47014,70752
2012-01-05,NASDAQ BX (B),104001063,19825926,47084910,170911899,2053068744.886301,654273095.165000,1084230630.915000,3791572470.966301,547260,67591,256682,871533
2012-01-05,NSX (C),15306287,4197111,7603834,27107232,334183739.524300,182104996.268300,194075873.955999,710364609.748599,48950,10979,22209,82138
2012-01-05,NYSE (DN),114522928,17490798,48372446,180386172,3098989142.407001,800533330.318600,1283806425.957496,5183328898.683097,519294,50591,211947,781832
2012-01-05,NASDAQ (DQ),1401751558,323300444,631135869,2356187871,33347967889.948396,15896051373.901648,14442534182.376925,63686553446.226969,3451931,496353,1536216,5484500
2012-01-05,EDGA (J),124403983,30485637,55812235,210701855,2921959576.383395,1265855065.824400,1291621051.786504,5479435693.994299,669082,104846,315851,1089779
2012-01-05,EDGX (K),297661601,64147363,128096416,489905380,7997337563.806714,2990893892.522710,3322721503.558081,14310952959.887505,1325998,202237,620567,2148802
2012-01-05,CHX (M),12833401,16314111,4259781,33407293,329213884.849000,1192520930.462300,145749899.866100,1667484715.177400,1269,4226,661,6156
2012-01-05,NYSE (N),828794700,0,0,828794700,24432703107.382513,0.000000,0.000000,24432703107.382513,2459198,0,0,2459198
2012-01-05,NYSE Arca (P),428215529,232350750,215174801,875741080,10777364729.836319,12518646502.488325,6150092381.199732,29446103613.524376,1987648,577662,995360,3560670
2012-01-05,NASDAQ (Q),556833602,208552571,469792771,1235178944,15327659321.862266,12902298824.991975,12366500207.230341,40596458354.084582,2996670,714215,2076830,5787715
2012-01-05,CBSX (W),1897722,2752706,1219348,5869776,28021087.410000,97184611.780000,13278126.960000,138483826.150000,4757,1025,1849,7631
2012-01-05,NASDAQ PSX (X),32110228,22982513,27807775,82900516,617497877.530000,1414799605.450000,556907485.620000,2589204968.600000,113367,54527,78079,245973
2012-01-05,BATS BYX (Y),98299031,28719363,46346096,173364490,2351573179.332998,1260933896.974999,1040069294.170201,4652576370.478198,593517,108649,257134,959300
2012-01-05,BATS BZX (Z),299637534,137919758,186314267,623871559,7862225533.891711,7851934068.388709,4798346989.219691,20512506591.500111,1694842,474635,994221,3163698
2012-01-04,NYSE MKT (A),0,10398638,7152421,17551059,0.000000,76536062.400100,162101637.260000,238637699.660100,0,24752,42466,67218
2012-01-04,NASDAQ BX (B),85757733,19589324,39150533,144497590,1797001691.744394,600609704.890000,959315658.401202,3356927055.035596,495702,63848,227434,786984
2012-01-04,NSX (C),14051370,3271481,7240433,24563284,274613905.866000,125370743.818400,191960597.965900,591945247.650300,43396,9137,21292,73825
2012-01-04,NYSE (DN),94842112,16359561,47593455,158795128,2932532720.325500,769484966.223000,1306367557.450205,5008385243.998705,501590,49839,214491,765920
2012-01-04,NASDAQ (DQ),1153544489,283958439,576009972,2013512900,28929773017.760122,13840680467.651968,13591160471.320499,56361613956.732589,3138515,464338,1423033,5025886
2012-01-04,EDGA (J),105907966,29678630,48841192,184427788,2720270227.864201,1203301229.349801,1235269028.139899,5158840485.353901,613095,98853,274064,986012
2012-01-04,EDGX (K),239660997,52746124,118472772,410879893,6767030176.745810,2491815496.494001,3324345222.942469,12583190896.182280,1156290,171190,581555,1909035
2012-01-04,CHX (M),16618319,16220277,5644725,38483321,391499644.944900,1068757806.774400,163052417.071700,1623309868.791000,1359,3201,598,5158
2012-01-04,NYSE (N),759445165,0,0,759445165,23143556192.959944,0.000000,0.000000,23143556192.959944,2192360,0,0,2192360
2012-01-04,NYSE Arca (P),328295702,189384212,187798436,705478350,9159155324.860364,9774514226.186531,5444503582.665989,24378173133.712884,1688464,499678,844505,3032647
2012-01-04,NASDAQ (Q),431787928,169489230,436052625,1037329783,12716077084.714173,10036911852.800568,11779009587.274612,34531998524.789353,2486723,601564,1836589,4924876
2012-01-04,CBSX (W),1290928,4679195,2131577,8101700,22478925.350000,111385158.920000,18263442.019600,152127526.289600,3238,1577,1861,6676
2012-01-04,NASDAQ PSX (X),26689359,18016487,25791296,70497142,531026279.770000,1056092025.460000,523198654.040000,2110316959.270000,96928,45499,69400,211827
2012-01-04,BATS BYX (Y),85406341,24479182,39691523,149577046,2207068006.560604,1029463675.320000,989593991.678197,4226125673.558801,556725,94846,224443,876014
2012-01-04,BATS BZX (Z),249481091,119982628,165117451,534581170,7025983459.803019,6419529697.021293,4277908620.808693,17723421777.633005,1487363,428582,879720,2795665
2012-01-03,NYSE MKT (A),0,10928267,5935687,16863954,0.000000,78541328.147200,137641112.305000,216182440.452200,0,25997,42964,68961
2012-01-03,NASDAQ BX (B),95049858,26559038,42271240,163880136,2076935776.849796,897543810.410000,1087252071.010000,4061731658.269796,561151,84803,259985,905939
2012-01-03,NSX (C),16574561,4570550,6073334,27218445,357341348.850599,167126693.261600,185288448.270499,709756490.382698,50793,14179,21582,86554
2012-01-03,NYSE (DN),96520400,23618361,46332511,166471272,2712039003.601998,1259064144.202000,1248263028.770396,5219366176.574394,524383,79464,228132,831979
2012-01-03,NASDAQ (DQ),1195216059,444709375,524985021,2164910455,30253938412.830161,22050726011.616363,12994359808.389608,65299024232.836132,3439771,623704,1473475,5536950
2012-01-03,EDGA (J),120304623,43421670,53076834,216803127,3165542779.220411,1756947486.510100,1388757925.275701,6311248191.006212,701134,130225,317520,1148879
2012-01-03,EDGX (K),288286563,77176054,121675676,487138293,8404597709.594539,3880111969.964404,3460703474.622005,15745413154.180948,1415718,244911,632519,2293148
2012-01-03,CHX (M),10705922,14765409,8052546,33523877,408095693.553900,1124516619.637300,216586537.622000,1749198850.813200,1394,3931,674,5999
2012-01-03,NYSE (N),855123826,0,0,855123826,26743851776.689100,0.000000,0.000000,26743851776.689100,2532397,0,0,2532397
2012-01-03,NYSE Arca (P),362761587,300969493,181433802,845164882,10439922864.207650,15687234957.361060,5678752117.135399,31805909938.704109,1908568,679872,907511,3495951
2012-01-03,NASDAQ (Q),489402339,254517785,443839905,1187760029,14631971826.400920,15028850690.463630,12419225786.418348,42080048303.282898,2886759,813730,2034405,5734894
2012-01-03,CBSX (W),3150227,8098970,821316,12070513,46748459.746400,549634060.820000,13032883.210000,609415403.776400,6508,1152,1979,9639
2012-01-03,NASDAQ PSX (X),26814739,26241701,23228256,76284696,594607867.030000,1617082754.520000,481108874.160000,2692799495.710000,108361,60905,72473,241739
2012-01-03,BATS BYX (Y),101009682,34889507,43021023,178920212,2592671064.676801,1528222420.282799,1133717261.179003,5254610746.138603,659987,129306,263578,1052871
2012-01-03,BATS BZX (Z),280348007,167413686,174241067,622002760,8140911519.905331,9435788384.350928,4686168267.337506,22262868171.593765,1729562,582713,978464,3290739
