Day,Market Participant,Tape A Shares,Tape B Shares,Tape C Shares,Total Shares,Tape A Notional,Tape B Notional,Tape C Notional,Total Notional,Tape A Trade Count,Tape B Trade Count,Tape C Trade Count,Total Trade Count
2020-12-31,NYSE American (A),7942760,32637694,8211191,48791645,291481270.912000,472669349.974800,313028029.202100,1077178650.088900,99340,108300,74231,281871
2020-12-31,NASDAQ BX (B),20372161,14992090,22263197,57627448,867292551.313600,1010804721.092800,1231439083.724800,3109536356.131200,266748,72299,251786,590833
2020-12-31,NYSE National (C),34789501,19707020,21967439,76463960,864379700.472000,851070169.607600,683698643.954800,2399148514.034400,337180,95748,214529,647457
2020-12-31,FINRA / Nasdaq TRF Chicago (DB),7589086,4952113,13179561,25720760,327049139.330000,87415794.050800,755854444.945600,1170319378.326400,41076,10226,62814,114116
2020-12-31,FINRA / NYSE TRF (DN),265312516,142605189,702216832,1110134537,9414044948.885098,3749030410.346800,19799952694.511401,32963028053.743299,1134116,304568,1717168,3155852
2020-12-31,FINRA / Nasdaq TRF Carteret (DQ),984003880,509524463,1708557345,3202085688,40023097261.043196,31453999320.824507,61319643151.904143,132796739733.771846,5000190,1455730,5870868,12326788
2020-12-31,MIAX Pearl (H),2508227,2132599,5625295,10266121,135998499.485200,109622189.815400,229048835.937700,474669525.238300,25162,10326,32625,68113
2020-12-31,EDGA Equities (J),46810419,29802305,49186568,125799292,2156958466.330300,1738126247.881800,2409613473.517800,6304698187.729900,614307,198172,549405,1361884
2020-12-31,EDGX Equities (K),227011307,99591352,390077554,716680213,8370719134.157601,5575347815.736700,12368505674.993500,26314572624.887801,1735416,427103,1948093,4110612
2020-12-31,LTSE (L),500,100,13851,14451,1080.000000,2228.000000,45359.650000,48667.650000,1,1,47,49
2020-12-31,NYSE Chicago (M),8696621,7326515,6160363,22183499,489850748.719200,1216980651.558000,1302786265.966500,3009617666.243700,8202,3189,8186,19577
2020-12-31,NYSE (N),806636339,39268538,61004990,906909867,39190088085.213602,2526388762.858300,2739222635.972100,44455699484.044002,2700924,119885,385930,3206739
2020-12-31,NYSE Arca (P),169383241,239828629,427010066,836221936,7159801430.777404,15533990891.587699,14816564296.557208,37510356618.922311,1562906,831473,2405738,4800117
2020-12-31,NASDAQ (Q),291693455,136615765,1041846154,1470155374,13295265024.684894,9855388437.600402,52953648127.560604,76104301589.845900,3238070,692498,5759676,9690244
2020-12-31,Members Exchange (U),22649386,15984185,40542951,79176522,606967685.215000,399229393.976700,772340319.228000,1778537398.419700,232223,46194,286952,565369
2020-12-31,Investors Exchange (V),80691065,16793533,68617014,166101612,4560445168.606100,1244153995.186200,4834052648.295301,10638651812.087601,998085,111238,770050,1879373
2020-12-31,NASDAQ PSX (X),20325006,18405337,20258402,58988745,682731008.810400,1314933263.508700,1210926182.341300,3208590454.660400,140460,87455,156440,384355
2020-12-31,BYX Equities (Y),49019019,32557421,52292579,133869019,1843067951.208800,2019061995.003600,1901338029.217900,5763467975.430300,568881,151657,509601,1230139
2020-12-31,BZX Equities (Z),133606243,104727342,176810103,415143688,5581461560.368300,7339917040.840400,9174720190.990299,22096098792.198999,1423874,482295,1440952,3347121
2020-12-30,NYSE American (A),7342491,26653343,5859539,39855373,266119757.019500,340684157.602900,275797208.631800,882601123.254200,114462,96701,82108,293271
2020-12-30,NASDAQ BX (B),22516344,15245403,29174090,66935837,943537665.351400,835903491.675000,1260394007.328800,3039835164.355200,280378,65711,263711,609800
2020-12-30,NYSE National (C),34864306,17349599,26634220,78848125,817547183.780000,663323482.098900,648756133.533400,2129626799.412300,333835,81638,224477,639950
2020-12-30,FINRA / Nasdaq TRF Chicago (DB),8309948,2895899,19665799,30871646,401267436.054600,75291371.989100,781474505.476200,1258033313.519900,46541,10026,74731,131298
2020-12-30,FINRA / NYSE TRF (DN),270917245,141113272,863245097,1275275614,10309105486.174099,4702094331.398298,19193107158.942595,34204306976.514992,1127471,296720,1794843,3219034
2020-12-30,FINRA / Nasdaq TRF Carteret (DQ),1031349884,438451415,2042338846,3512140145,44447153053.750623,22403133975.007197,62126289094.123719,128976576122.881539,4995516,1253006,6130287,12378809
2020-12-30,MIAX Pearl (H),2165772,1898378,6903240,10967390,129420903.266800,77127453.803500,325415270.427100,531963627.497400,30584,8040,41422,80046
2020-12-30,EDGA Equities (J),49979486,26908407,46831891,123719784,2365240736.915200,1427572308.594700,2355114902.575099,6147927948.084999,651836,178914,554091,1384841
2020-12-30,EDGX Equities (K),232131203,83814514,403868771,719814488,8764056379.963701,4181785511.420600,12166189586.494196,25112031477.878497,1758432,367641,2048776,4174849
2020-12-30,NYSE Chicago (M),9690011,8290294,6524353,24504658,698964763.100000,1357841600.403500,2171521673.068001,4228328036.571501,8395,2589,8961,19945
2020-12-30,NYSE (N),691055272,32731348,72269108,796055728,32898057589.950402,1849596049.695200,2576789126.220200,37324442765.865802,2720098,99842,428312,3248252
2020-12-30,NYSE Arca (P),177157784,207929947,433426053,818513784,7655287480.583000,12575512482.406296,14561197208.706594,34791997171.695890,1652084,734820,2503970,4890874
2020-12-30,NASDAQ (Q),301227611,115062364,999171208,1415461183,13749489903.269599,7603115566.913700,47160524616.681618,68513130086.864917,3304228,596508,5928398,9829134
2020-12-30,Members Exchange (U),24157005,12587324,48895699,85640028,612838952.042600,325776166.786900,758152527.453800,1696767646.283300,238251,40768,306424,585443
2020-12-30,Investors Exchange (V),82329989,12835959,72085249,167251197,4646638320.864800,788478705.507200,5475995165.705597,10911112192.077597,878615,79453,738980,1697048
2020-12-30,NASDAQ PSX (X),21629214,15949191,21442464,59020869,644772064.062800,960933279.699800,1087253322.204600,2692958665.967200,148862,67197,160686,376745
2020-12-30,BYX Equities (Y),51750685,29771626,64116035,145638346,1826940888.458400,1600147390.764600,1829948606.123600,5257036885.346600,570009,136728,508129,1214866
2020-12-30,BZX Equities (Z),136281126,81238309,180565563,398084998,5687050192.803800,5448058210.633200,8519035300.854303,19654143704.291303,1452992,417179,1462495,3332666
2020-12-29,NYSE American (A),8030483,32904686,7096691,48031860,300789909.138500,416488141.206100,344834269.305500,1062112319.650100,114781,113135,90882,318798
2020-12-29,NASDAQ BX (B),20986461,14717329,21939846,57643636,938636617.680900,985563420.470100,1307195322.844700,3231395360.995700,272980,74046,273708,620734
2020-12-29,NYSE National (C),37208317,18112305,22816782,78137404,955227526.066500,679446840.096700,743076210.739000,2377750576.902200,353709,85928,234460,674097
2020-12-29,FINRA / Nasdaq TRF Chicago (DB),9614722,3718906,18072854,31406482,535405668.799700,115776752.140900,782633954.598700,1433816375.539300,58861,12778,79958,151597
2020-12-29,FINRA / NYSE TRF (DN),290106946,154100070,671869170,1116076186,12108537277.841500,4735393490.496997,18524428253.153803,35368359021.492300,1256585,375611,1793009,3425205
2020-12-29,FINRA / Nasdaq TRF Carteret (DQ),1111752869,506180462,1756585052,3374518383,49766265250.379921,27327292581.178794,63934204274.656177,141027762106.214892,5601444,1539429,6349445,13490318
2020-12-29,MIAX Pearl (H),2271421,1732521,4251068,8255010,154115298.174400,92038687.725900,143823585.079500,389977570.979800,32675,8536,35574,76785
2020-12-29,EDGA Equities (J),53330265,33344856,49826322,136501443,2482298971.014600,1801464380.522300,2455521605.622300,6739284957.159200,687928,224255,595626,1507809
2020-12-29,EDGX Equities (K),249345884,105525832,366366166,721237882,9986178877.595702,5395600549.631601,12263190243.255694,27644969670.482997,1964960,494188,2103252,4562400
2020-12-29,LTSE (L),41,100,2000,2141,40596.640000,699.000000,10300.000000,51595.640000,3,1,5,9
2020-12-29,NYSE Chicago (M),9071191,10917177,11157099,31145467,628266661.396000,1281996335.573800,1784777238.421400,3695040235.391200,8671,4075,8239,20985
2020-12-29,NYSE (N),724295351,43210342,73356294,840861987,33472939975.336401,2278722157.022600,2998225543.372500,38749887675.731501,3037966,124914,460924,3623804
2020-12-29,NYSE Arca (P),196049179,237317884,403238390,836605453,8988483835.878705,14733538653.672907,15973595081.808296,39695617571.359908,1891331,942831,2727379,5561541
2020-12-29,NASDAQ (Q),339568594,152374648,955350691,1447293933,16137481008.979396,9901953428.671799,49005993176.072297,75045427613.723492,3819314,857035,6613457,11289806
2020-12-29,Members Exchange (U),23975010,15043166,36442444,75460620,640230924.381400,397418466.716600,749796327.299400,1787445718.397400,257464,49834,304398,611696
2020-12-29,Investors Exchange (V),93069909,14444476,77126043,184640428,5640984150.413599,1003388602.849600,6055960439.734700,12700333192.997899,985394,92267,817852,1895513
2020-12-29,NASDAQ PSX (X),22766172,16946911,21115674,60828757,645188162.410000,1055783951.170599,1341167018.395100,3042139131.975699,155825,68389,184077,408291
2020-12-29,BYX Equities (Y),53878360,36689478,61015525,151583363,1919958970.383400,2134551993.399000,1913745203.159100,5968256166.941500,584916,159098,514366,1258380
2020-12-29,BZX Equities (Z),147970281,100412918,169296016,417679215,6242595400.704101,7017832147.096997,9126624033.948202,22387051581.749300,1612816,583624,1573107,3769547
2020-12-28,NYSE American (A),6910499,36024252,6520163,49454914,261650135.517300,434929428.512100,334258634.753000,1030838198.782400,100294,121329,84801,306424
2020-12-28,NASDAQ BX (B),21536192,14418127,23534371,59488690,961445195.338000,848580778.501300,1495555806.920400,3305581780.759700,268421,73439,280105,621965
2020-12-28,NYSE National (C),34230237,16845679,23543528,74619444,895252090.764100,661975262.207600,705688997.515900,2262916350.487600,332365,80200,228099,640664
2020-12-28,FINRA / Nasdaq TRF Chicago (DB),9813043,4694700,18199298,32707041,510744947.762500,104884168.945600,850913323.497700,1466542440.205800,61426,14607,91490,167523
2020-12-28,FINRA / NYSE TRF (DN),314403678,175865150,743242979,1233511807,12577164203.558499,3539920138.511402,20452388696.007494,36569473038.077395,1489638,399977,2137446,4027061
2020-12-28,FINRA / Nasdaq TRF Carteret (DQ),1205868552,523855944,1894359783,3624084279,53468574012.033814,23240753053.645387,70009821985.893084,146719149051.572285,6052535,1733490,7077785,14863810
2020-12-28,MIAX Pearl (H),2555323,2356912,5366184,10278419,128637743.479800,71976785.679300,259124196.189700,459738725.348800,28107,10833,41261,80201
2020-12-28,EDGA Equities (J),52894473,28998428,48104956,129997857,2548170267.707700,1473278290.448000,2635410499.838601,6656859057.994301,678442,202701,612273,1493416
2020-12-28,EDGX Equities (K),274685061,105428153,420662500,800775714,10165631381.625202,4477761079.779201,14307280731.332996,28950673192.737399,2098882,474879,2345210,4918971
2020-12-28,LTSE (L),0,0,1894,1894,0.000000,0.000000,10538.000000,10538.000000,0,0,11,11
2020-12-28,NYSE Chicago (M),8022489,5963050,4688387,18673926,814778927.944000,664303161.815900,1765086855.641400,3244168945.401300,9317,2855,8819,20991
2020-12-28,NYSE (N),734405838,42873858,78151237,855430933,35495879082.843100,2056682045.707600,2975748691.835500,40528309820.386200,2987763,122020,465131,3574914
2020-12-28,NYSE Arca (P),199274778,240061282,427143371,866479431,8968631223.570004,13898373185.953500,16868760506.030290,39735764915.553794,1864893,911904,2839824,5616621
2020-12-28,NASDAQ (Q),333862672,148187636,1040490715,1522541023,15560021048.529896,8196156067.636203,53083776811.412203,76839953927.578302,3614740,777719,6773049,11165508
2020-12-28,Members Exchange (U),24799841,11534122,39000482,75334445,662043220.697900,325822644.517600,930106178.854100,1917972044.069600,269986,49725,334362,654073
2020-12-28,Investors Exchange (V),89629459,13527415,77868814,181025688,5534228734.636801,781001694.123600,6111276203.177399,12426506631.937800,944653,89324,812651,1846628
2020-12-28,NASDAQ PSX (X),21846512,13927781,21794140,57568433,607935277.268000,811713298.182100,1303222012.214600,2722870587.664700,144149,66616,181402,392167
2020-12-28,BYX Equities (Y),54056083,37839892,60703168,152599143,1992694731.165900,1674373278.821000,2009651921.374100,5676719931.361000,600171,152849,519100,1272120
2020-12-28,BZX Equities (Z),146670549,89623489,175772412,412066450,6226325264.456801,5419646505.326901,9397854275.340999,21043826045.124701,1554812,480434,1581631,3616877
2020-12-24,NYSE American (A),4274407,31011408,4597939,39883754,184514771.460000,210219282.090000,156140320.072300,550874373.622300,53498,83142,43795,180435
2020-12-24,NASDAQ BX (B),10084502,7527662,11603496,29215660,543630784.583500,448378297.971700,595054408.321300,1587063490.876500,128694,35430,130006,294130
2020-12-24,NYSE National (C),13839984,9113910,10163112,33117006,419129446.444600,326790694.507300,322167104.570000,1068087245.521900,146529,45372,104530,296431
2020-12-24,FINRA / Nasdaq TRF Chicago (DB),6235839,3441660,11198888,20876387,442005980.030100,51882158.713900,487856030.728100,981744169.472100,42090,8760,47673,98523
2020-12-24,FINRA / NYSE TRF (DN),182867152,147753786,546364254,876985192,9539641168.531500,2035591634.179700,10845252275.920002,22420485078.631202,880843,238287,1178203,2297333
2020-12-24,FINRA / Nasdaq TRF Carteret (DQ),624936116,363792749,1233056466,2221785331,34811442963.491100,12781181752.256598,35073626101.154511,82666250816.902209,3381762,900825,3640994,7923581
2020-12-24,MIAX Pearl (H),1266410,1480836,3968896,6716142,96487059.103000,36399822.704200,102029478.906000,234916360.713200,15726,6832,21124,43682
2020-12-24,EDGA Equities (J),24533235,15089679,24571726,64194640,1512821895.683300,715714276.716700,1135136787.109600,3363672959.509600,315365,93882,280791,690038
2020-12-24,EDGX Equities (K),151464362,89431657,270876716,511772735,7226344576.281397,2443228803.754200,6901682467.473796,16571255847.509393,1201808,298109,1213379,2713296
2020-12-24,LTSE (L),0,0,401,401,0.000000,0.000000,4015.200000,4015.200000,0,0,3,3
2020-12-24,NYSE Chicago (M),4914701,3841557,2926006,11682264,684788305.089000,922969944.355000,819909081.043000,2427667330.487000,5398,1675,5300,12373
2020-12-24,NYSE (N),381099662,22725817,39918981,443744460,19632000749.822298,1052649181.079000,1657004890.973700,22341654821.874998,1623767,67615,244366,1935748
2020-12-24,NYSE Arca (P),117860462,173286725,303379814,594527001,7090345402.734497,7142726284.246499,8308369128.428298,22541440815.409294,1122816,541401,1548382,3212599
2020-12-24,NASDAQ (Q),180244023,94909020,621562901,896715944,10367021337.913703,4478695464.926900,25442054231.398798,40287771034.239401,1915431,422646,3493491,5831568
2020-12-24,Members Exchange (U),14748327,8948675,21941126,45638128,441264336.208700,170423725.393600,417740673.704700,1029428735.307000,157233,32550,181804,371587
2020-12-24,Investors Exchange (V),51541030,8979008,41676560,102196598,4193795997.113600,469817357.575700,2775404684.562600,7439018039.251900,509639,51150,412348,973137
2020-12-24,NASDAQ PSX (X),10815738,8681599,11358236,30855573,367920216.154100,447935487.538400,624007043.034700,1439862746.727200,76567,37655,92319,206541
2020-12-24,BYX Equities (Y),23235731,18125261,25463237,66824229,966934911.584000,950687227.892300,954348563.887100,2871970703.363400,267347,83931,261418,612696
2020-12-24,BZX Equities (Z),79826145,58986940,121338512,260151597,3983710139.161400,3059921641.198200,4852716792.258599,11896348572.618199,826349,293327,836861,1956537
2020-12-23,NYSE American (A),8710901,37441620,7332128,53484649,323305445.400700,412742867.090500,326263254.720200,1062311567.211400,139476,120563,104857,364896
2020-12-23,NASDAQ BX (B),24085417,13392563,29864788,67342768,1044160074.745700,825040764.652100,1341348353.702100,3210549193.099900,317181,70349,308961,696491
2020-12-23,NYSE National (C),39470503,22403424,29041670,90915597,1010602663.242500,709286247.444200,734801840.731500,2454690751.418200,391790,94869,276598,763257
2020-12-23,FINRA / Nasdaq TRF Chicago (DB),9502254,5200440,22934926,37637620,422300299.444100,93615080.804200,732717650.236100,1248633030.484400,49955,10673,81307,141935
2020-12-23,FINRA / NYSE TRF (DN),316304805,195244455,1196456823,1708006083,11135092416.141901,3448720374.679198,18825045246.852996,33408858037.674095,1331855,339462,2228843,3900160
2020-12-23,FINRA / Nasdaq TRF Carteret (DQ),1290003058,588451305,2693615418,4572069781,52899127487.165908,25212797199.597097,66085127599.793225,144197052286.556230,5739413,1366036,7147929,14253378
2020-12-23,MIAX Pearl (H),2385003,3123962,8843057,14352022,144232029.662900,79600428.777600,232264033.912200,456096492.352700,33402,12469,51331,97202
2020-12-23,EDGA Equities (J),54970281,28186622,56400288,139557191,2584946951.036400,1371919533.389600,2530737741.726600,6487604226.152600,717298,172782,631825,1521905
2020-12-23,EDGX Equities (K),260045621,117453081,536505087,914003789,9046770313.494204,4677199323.048300,11950269889.730802,25674239526.273306,1882018,415697,2329040,4626755
2020-12-23,LTSE (L),16536,0,126,16662,981312.790000,0.000000,17639.600000,998952.390000,13,0,2,15
2020-12-23,NYSE Chicago (M),10109586,9638909,5866762,25615257,724179167.354000,969429562.233200,1648857884.832500,3342466614.419700,11047,3662,9216,23925
2020-12-23,NYSE (N),812666631,42597194,91891031,947154856,38426186206.507196,1978987650.420500,2721700269.274200,43126874126.201896,3081756,113787,510018,3705561
2020-12-23,NYSE Arca (P),217652963,265051374,651404804,1134109141,9183012201.561301,13440891362.174402,14826523550.170102,37450427113.905805,1985064,795897,2981526,5762487
2020-12-23,NASDAQ (Q),366559368,156096247,1299416492,1822072107,16272268253.916107,8565547068.220102,49726934326.315577,74564749648.451786,3896819,709644,6975949,11582412
2020-12-23,Members Exchange (U),25854387,11084186,59111730,96050303,679751601.215600,337170331.851900,801559519.832200,1818481452.899700,270022,43683,345803,659508
2020-12-23,Investors Exchange (V),92977567,14089204,86528254,193595025,5632938653.688801,867705162.308700,5473092020.810700,11973735836.808201,998491,86831,861546,1946868
2020-12-23,NASDAQ PSX (X),23996988,15871922,25472654,65341564,633816078.557200,968110750.211500,1139111087.298200,2741037916.066900,158610,65389,188187,412186
2020-12-23,BYX Equities (Y),61084452,36842026,73016521,170942999,2143199809.404400,1573676048.571700,1966375009.022400,5683250866.998500,657002,146125,572631,1375758
2020-12-23,BZX Equities (Z),162766154,97830597,226550097,487146848,6585404594.013000,5839486981.623898,8485099388.833801,20909990964.470699,1628622,476899,1641065,3746586
2020-12-22,NYSE American (A),9694669,27027233,7740513,44462415,386269181.760900,371960582.014900,441316892.473500,1199546656.249300,170792,103271,128397,402460
2020-12-22,NASDAQ BX (B),26662573,14359070,26047619,67069262,1173237567.922800,927381420.411900,1583942471.729300,3684561460.064000,354602,82010,346550,783162
2020-12-22,NYSE National (C),39796827,20290537,24283307,84370671,1055463043.008100,762882377.906800,800590828.436100,2618936249.351000,440510,97035,283531,821076
2020-12-22,FINRA / Nasdaq TRF Chicago (DB),10359021,4446296,22032451,36837768,479638653.888000,116135607.709000,942434472.424500,1538208734.021500,55023,10808,96127,161958
2020-12-22,FINRA / NYSE TRF (DN),336193358,136937897,876449745,1349581000,11849064853.011107,3761330769.130101,24832839464.875993,40443235087.017201,1509770,335636,2334236,4179642
2020-12-22,FINRA / Nasdaq TRF Carteret (DQ),1379148754,515211810,2164562394,4058922958,60773451315.633802,27973604431.070894,82647519886.841003,171394575633.545699,6240595,1438338,7420955,15099888
2020-12-22,MIAX Pearl (H),2652981,2017906,6202898,10873785,148584136.924700,99390623.184700,209866153.225600,457840913.335000,40095,10226,47191,97512
2020-12-22,EDGA Equities (J),56515134,28360768,53814566,138690468,2761411194.267800,1519142235.462700,2817025404.422401,7097578834.152901,773255,189132,687755,1650142
2020-12-22,EDGX Equities (K),266645297,102683876,447407661,816736834,10050980467.396499,5229883946.864600,15738936456.142101,31019800870.403200,2012788,451077,2528078,4991943
2020-12-22,LTSE (L),104,0,136,240,10766.320000,0.000000,21210.610000,31976.930000,2,0,6,8
2020-12-22,NYSE Chicago (M),9422899,10960836,3914329,24298064,575424017.293800,1114025470.827500,651612775.940000,2341062264.061300,10181,4008,10776,24965
2020-12-22,NYSE (N),909279125,41468407,81320033,1032067565,43906756405.164509,2090202085.863900,3324701071.523701,49321659562.552110,3247168,122639,549503,3919310
2020-12-22,NYSE Arca (P),228511124,242153934,510761342,981426400,9857014300.725296,14856704258.237504,17573072777.082310,42286791336.045110,2131635,862058,3088159,6081852
2020-12-22,NASDAQ (Q),386789689,146878063,1181199958,1714867710,18050846689.605192,8982975715.112498,61040218772.809416,88074041177.527106,4285126,761699,7684063,12730888
2020-12-22,Members Exchange (U),28521456,11283097,38566776,78371329,757364543.714500,398175881.558700,932996237.104500,2088536662.377700,313062,46151,363409,722622
2020-12-22,Investors Exchange (V),102293464,15777755,90843558,208914777,6175623507.430500,1113473551.661300,6457286044.508400,13746383103.600200,1093697,92506,947856,2134059
2020-12-22,NASDAQ PSX (X),23592411,17110617,23026490,63729518,679093724.159100,904893551.397200,1522485320.958300,3106472596.514600,181969,75649,211388,469006
2020-12-22,BYX Equities (Y),64928742,36290399,59480161,160699302,2352742713.666400,1984966161.831299,2235828895.894300,6573537771.391999,709907,167441,600074,1477422
2020-12-22,BZX Equities (Z),172305453,100450340,194205173,466960966,7369758297.565902,6481617876.380700,10652223925.718097,24503600099.664699,1823675,519252,1811764,4154691
2020-12-21,NYSE American (A),12437078,34746157,7580233,54763468,445243178.991400,550069260.326700,422461256.503100,1417773695.821200,178951,122674,111474,413099
2020-12-21,NASDAQ BX (B),29121507,22136556,23975572,75233635,1283433178.664100,1619211088.133800,1664151641.094000,4566795907.891900,385299,108954,319752,814005
2020-12-21,NYSE National (C),46437838,25744937,24379002,96561777,1194451620.079400,926519434.398600,837957709.643400,2958928764.121400,430725,117570,254703,802998
2020-12-21,FINRA / Nasdaq TRF Chicago (DB),11673117,5160401,17525403,34358921,544900503.182700,151001270.563800,1005222456.530000,1701124230.276500,63141,14935,89865,167941
2020-12-21,FINRA / NYSE TRF (DN),353670233,155335690,699172816,1208178739,12607082022.112891,4997424120.995701,23114982844.444198,40719488987.552790,1609875,404475,2053044,4067394
2020-12-21,FINRA / Nasdaq TRF Carteret (DQ),1535523047,596629548,1898794503,4030947098,68204443765.330685,35018221131.882898,85370074949.065402,188592739846.278985,6745631,1752386,6807044,15305061
2020-12-21,MIAX Pearl (H),2979978,1950682,4774658,9705318,183753807.090200,157489011.825800,344972046.164600,686214865.080600,45925,10330,46482,102737
2020-12-21,EDGA Equities (J),62707703,41645539,51196307,155549549,2984564431.880200,2283468012.388200,3142455775.824500,8410488220.092900,833990,263265,672449,1769704
2020-12-21,EDGX Equities (K),327552961,146178102,413024768,886755831,12203861626.421102,8578238539.841602,16708568619.227091,37490668785.489795,2417500,637627,2401240,5456367
2020-12-21,LTSE (L),700,32,0,732,22839.000000,9818.100000,0.000000,32657.100000,2,4,0,6
2020-12-21,NYSE Chicago (M),8181321,6062910,5675424,19919655,586599382.956000,809032780.640000,926042998.133300,2321675161.729300,12031,4376,11046,27453
2020-12-21,NYSE (N),1144802871,60250413,82297865,1287351149,54399123318.618808,3335354087.312198,3532848508.369100,61267325914.300106,3928840,166822,518375,4614037
2020-12-21,NYSE Arca (P),270428530,333010323,397317970,1000756823,11612132284.229697,21499588434.441202,20765506892.066001,53877227610.736900,2527030,1190317,3079906,6797253
2020-12-21,NASDAQ (Q),484646315,213763410,1178245329,1876655054,21974105197.321499,14828943272.772306,72443809647.213628,109246858117.307433,5166045,1063904,7841261,14071210
2020-12-21,Members Exchange (U),28757435,17804067,33320041,79881543,779904581.630000,583186434.674800,888127458.656600,2251218474.961400,307647,62386,304547,674580
2020-12-21,Investors Exchange (V),116867908,18691187,91942177,227501272,6975496080.637799,1215015489.509400,7124139516.499700,15314651086.646899,1294018,102591,1008031,2404640
2020-12-21,NASDAQ PSX (X),31773303,26106820,25796291,83676414,896502114.445500,1564677673.007500,1661421430.573000,4122601218.026000,229174,114234,211277,554685
2020-12-21,BYX Equities (Y),68510156,48605124,50489880,167605160,2305079737.758800,2981300552.464900,2229076438.334600,7515456728.558300,721068,218325,536974,1476367
2020-12-21,BZX Equities (Z),212508181,152053522,187352696,551914399,8992574564.115799,10721488136.602707,11456863207.716507,31170925908.435013,2164083,738043,1839824,4741950
2020-12-18,NYSE American (A),11989854,92929439,9964271,114883564,460510944.947000,809473545.026500,512661507.501000,1782645997.474500,177386,106059,130278,413723
2020-12-18,NASDAQ BX (B),34147742,18640171,29182075,81969988,1473365126.592000,1440167372.507100,2401745917.275400,5315278416.374500,408152,92958,369335,870445
2020-12-18,NYSE National (C),60727813,24624875,29972963,115325651,1500143617.717700,932628132.129800,1088838969.448700,3521610719.296200,529566,105433,309697,944696
2020-12-18,FINRA / Nasdaq TRF Chicago (DB),9345785,4010135,17033369,30389289,421465533.777300,114374203.713600,1061118524.409800,1596958261.900700,51525,9644,86064,147233
2020-12-18,FINRA / NYSE TRF (DN),336970664,140646423,656917048,1134534135,11917054829.639700,4824719789.927098,26249490346.124300,42991264965.691098,1456192,321834,2111007,3889033
2020-12-18,FINRA / Nasdaq TRF Carteret (DQ),1881961658,579406786,2129284613,4590653057,88488390034.956903,50556465667.155411,136987991148.157379,276032846850.269693,6594975,1417773,6944744,14957492
2020-12-18,MIAX Pearl (H),3601523,1638285,4773747,10013555,212673725.656000,111993810.753800,291015285.267400,615682821.677200,47313,8554,47328,103195
2020-12-18,EDGA Equities (J),74287539,32858443,57269133,164415115,3530959698.031300,1876867779.831700,3970162921.655301,9377990399.518301,921062,205782,733310,1860154
2020-12-18,EDGX Equities (K),303486476,108479521,374415144,786381141,11782904441.984502,6871301846.112099,18739193888.954609,37393400177.051210,2294112,489650,2500028,5283790
2020-12-18,LTSE (L),0,400,886,1286,0.000000,8894.000000,39883.210000,48777.210000,0,4,13,17
2020-12-18,NYSE Chicago (M),15773676,9799500,14507098,40080274,1095532942.261800,1298843628.650000,3703923139.595899,6098299710.507699,12712,3791,10831,27334
2020-12-18,NYSE (N),3108899602,48076343,90092694,3247068639,157945426636.673706,2933791827.366500,4377112974.289899,165256331438.330105,3925603,138648,575382,4639633
2020-12-18,NYSE Arca (P),256430900,283378292,384147907,923957099,11734706288.249401,22185485588.782311,26469025054.570809,60389216931.602521,2407904,965979,3160021,6533904
2020-12-18,NASDAQ (Q),483419132,177194193,2872479143,3533092468,22787327904.603402,13927348698.321801,234326867396.888661,271041543999.813864,5043275,896525,8316213,14256013
2020-12-18,Members Exchange (U),31495296,12056973,33455494,77007763,876525997.454100,487341449.362000,1007030879.167700,2370898325.983800,320139,49813,327046,696998
2020-12-18,Investors Exchange (V),136272130,21522791,108441637,266236558,8142551355.930700,1700742323.289600,9170228910.789801,19013522590.010101,1354597,124228,1113750,2592575
2020-12-18,NASDAQ PSX (X),34423675,20435611,28365280,83224566,1084825488.986800,1398385267.370300,2563140255.626199,5046351011.983299,235467,87639,241361,564467
2020-12-18,BYX Equities (Y),84196175,45524691,69286623,199007489,3026224271.042800,2855965310.365300,3198778234.881400,9080967816.289500,867369,204891,677799,1750059
2020-12-18,BZX Equities (Z),229676636,121656072,216219877,567552585,10317717771.677897,8900163869.809598,16636549712.217505,35854431353.705000,2290759,587423,2100839,4979021
2020-12-17,NYSE American (A),10917343,26106834,7869230,44893407,428206569.246900,421298763.199800,408456396.384500,1257961728.831200,189136,102105,131212,422453
2020-12-17,NASDAQ BX (B),29288137,16012127,26304421,71604685,1355358914.901300,983602191.123500,1720123324.710000,4059084430.734800,400820,79701,345197,825718
2020-12-17,NYSE National (C),49203573,21614630,31559668,102377871,1306284930.099200,830807309.811400,978374932.821300,3115467172.731900,492663,102096,312607,907366
2020-12-17,FINRA / Nasdaq TRF Chicago (DB),8885937,2247694,16987145,28120776,396944329.329500,113993414.513300,861587792.149100,1372525535.991900,44881,9021,75142,129044
2020-12-17,FINRA / NYSE TRF (DN),331165446,130693946,715878526,1177737918,12015943593.247799,4829806316.482402,24044225032.477692,40889974942.207893,1390085,306608,2087125,3783818
2020-12-17,FINRA / Nasdaq TRF Carteret (DQ),1384864629,480379186,1822793314,3688037129,62558161905.551399,32729317522.908493,79524968107.385418,174812447535.845310,6141863,1294414,6528010,13964287
2020-12-17,MIAX Pearl (H),2884918,1748312,4544056,9177286,184140525.688800,93538503.435900,316850830.030000,594529859.154700,40854,8941,42327,92122
2020-12-17,EDGA Equities (J),64962127,29048456,53832908,147843491,3230270591.741900,1580211111.946800,3187994838.505900,7998476542.194600,866340,180813,693358,1740511
2020-12-17,EDGX Equities (K),275754830,95825159,403875067,775455056,10701426173.973600,4948122640.984300,15455607507.224695,31105156322.182595,2177562,427270,2451125,5055957
2020-12-17,LTSE (L),0,0,68,68,0.000000,0.000000,585.480000,585.480000,0,0,1,1
2020-12-17,NYSE Chicago (M),13039901,10242267,8683936,31966104,1020148240.440800,2302131620.913001,2525414570.942901,5847694432.296702,9980,4338,8949,23267
2020-12-17,NYSE (N),958845651,41129202,73251532,1073226385,48302094161.461898,2050249178.467800,3554487982.191700,53906831322.121398,3364717,110900,522383,3998000
2020-12-17,NYSE Arca (P),216980952,237542247,373347014,827870213,10425152667.435898,14748593156.029506,17294853672.810489,42468599496.275893,2215352,790188,2889700,5895240
2020-12-17,NASDAQ (Q),412494059,135049737,1081102426,1628646222,19700411605.380302,8672602062.796699,62768849621.360316,91141863289.537317,4738394,677071,7272842,12688307
2020-12-17,Members Exchange (U),26209283,10486971,40148943,76845197,744413186.418100,366108546.139700,820344904.880600,1930866637.438400,289671,40301,313991,643963
2020-12-17,Investors Exchange (V),122126947,17303366,93311626,232741939,7395931973.541900,1106895025.914600,6831174577.346804,15334001576.803304,1279592,111442,992847,2383881
2020-12-17,NASDAQ PSX (X),28052608,17368414,24348956,69769978,795484615.328800,918272645.894900,1287765318.301200,3001522579.524900,215839,74082,198334,488255
2020-12-17,BYX Equities (Y),68280305,35060784,65775892,169116981,2593427292.266200,2076067179.913700,2394767015.766699,7064261487.946599,781430,172986,623670,1578086
2020-12-17,BZX Equities (Z),188860771,93877206,186222074,468960051,8740329177.671598,5847323684.844403,10695718174.156699,25283371036.672700,2083433,465540,1799970,4348943
2020-12-16,NYSE American (A),10326552,25167749,7947306,43441607,366177014.345000,424575231.896900,502032402.078200,1292784648.320100,158284,94967,107367,360618
2020-12-16,NASDAQ BX (B),29071446,16469634,24978008,70519088,1338634661.443400,1175624095.370200,1564712641.269300,4078971398.082900,397968,77796,342016,817780
2020-12-16,NYSE National (C),48184393,19704096,25128240,93016729,1233298346.480600,779744774.204400,844515115.179900,2857558235.864900,474529,94918,279345,848792
2020-12-16,FINRA / Nasdaq TRF Chicago (DB),8438816,3095500,15063816,26598132,423259738.086400,102205835.502400,793749907.239600,1319215480.828400,44364,7899,74413,126676
2020-12-16,FINRA / NYSE TRF (DN),311243308,126055537,629163368,1066462213,11542631331.680500,5300279965.757904,21280871554.902590,38123782852.340994,1556044,316209,2308384,4180637
2020-12-16,FINRA / Nasdaq TRF Carteret (DQ),1327679629,458954764,1601333947,3387968340,60613118836.101506,29625815043.843305,75239683193.560976,165478617073.505787,5537778,1244384,5765951,12548113
2020-12-16,MIAX Pearl (H),2733527,1559959,4424253,8717739,157912500.117200,105965553.926500,234602017.880700,498480071.924400,41133,7710,41940,90783
2020-12-16,EDGA Equities (J),64479472,31283365,50242629,146005466,3042007517.291200,1650323999.464900,2866401826.132300,7558733342.888400,834508,189624,662173,1686305
2020-12-16,EDGX Equities (K),262947642,101229970,379703855,743881467,10324145704.624099,5398493297.604000,15660889753.578694,31383528755.806793,2032758,458736,2378523,4870017
2020-12-16,LTSE (L),200,0,1811,2011,4408.000000,0.000000,18822.000000,23230.000000,2,0,6,8
2020-12-16,NYSE Chicago (M),12381951,8931922,7100410,28414283,650801460.567000,752033764.760000,1521440815.788900,2924276041.115900,8890,4954,9033,22877
2020-12-16,NYSE (N),953274495,41961381,63103223,1058339099,47120778652.562395,2096127550.606100,3411167851.119000,52628074054.287495,3367717,118111,454716,3940544
2020-12-16,NYSE Arca (P),208735181,243333362,339584293,791652836,9561887619.605199,15360007304.366205,15481493794.903299,40403388718.874703,2063250,841179,2559012,5463441
2020-12-16,NASDAQ (Q),405848496,141288135,1071230235,1618366866,19274265498.662697,9523532051.950500,62265829120.008709,91063626670.621906,4475923,711938,7221451,12409312
2020-12-16,Members Exchange (U),26772349,10817448,36805978,74395775,759309595.763800,414904181.898400,993717054.035400,2167930831.697600,296703,44623,343813,685139
2020-12-16,Investors Exchange (V),119294844,14861664,92811767,226968275,7082291112.014498,1010235844.040400,6610035809.168798,14702562765.223696,1250702,86511,966742,2303955
2020-12-16,NASDAQ PSX (X),25350037,17885324,21579567,64814928,740545169.054600,1055865104.996500,1458419784.880700,3254830058.931800,197899,81015,187719,466633
2020-12-16,BYX Equities (Y),66487569,35186035,49206475,150880079,2518121063.958800,1957785958.669700,2321109251.828500,6797016274.457000,749808,161022,589376,1500206
2020-12-16,BZX Equities (Z),183791829,97207412,173296432,454295673,8261690691.883400,6400683124.718499,10308070895.741198,24970444712.343097,1938271,492663,1678115,4109049
2020-12-15,NYSE American (A),11614558,24529541,7636868,43780967,435931201.873300,386769374.237300,468786797.831400,1291487373.942000,176048,96700,111062,383810
2020-12-15,NASDAQ BX (B),32480836,15548478,27727138,75756452,1415822359.829100,1066465564.413300,1623029483.601000,4105317407.843400,400185,81779,327884,809848
2020-12-15,NYSE National (C),51691774,18934336,25423058,96049168,1315205010.932200,713232983.109500,1028547858.215600,3056985852.257300,476867,93230,272591,842688
2020-12-15,FINRA / Nasdaq TRF Chicago (DB),9840451,2912572,15149100,27902123,424816426.079200,109830912.969900,783492059.556500,1318139398.605600,51923,9962,74907,136792
2020-12-15,FINRA / NYSE TRF (DN),346146025,133740892,556952460,1036839377,11459017700.576999,4954480335.174198,21367367878.134803,37780865913.886000,1483058,309784,1913666,3706508
2020-12-15,FINRA / Nasdaq TRF Carteret (DQ),1493263074,513477400,1633614153,3640354627,63827079669.780979,31403466027.954206,78208821434.729585,173439367132.464770,6263886,1304830,6292098,13860814
2020-12-15,MIAX Pearl (H),3164587,1824972,3528366,8517925,185756560.685800,107138341.272000,160964892.954900,453859794.912700,39033,8523,35477,83033
2020-12-15,EDGA Equities (J),69664220,30551028,50919376,151134624,3275765948.838100,1619302079.111300,3032237769.726501,7927305797.675901,851960,194742,652564,1699266
2020-12-15,EDGX Equities (K),293181199,104569353,321601111,719351663,10852047565.294496,5451799723.757599,14272634934.613694,30576482223.665789,2163095,467754,2195222,4826071
2020-12-15,NYSE Chicago (M),10756358,11808343,8980667,31545368,634382295.324700,1305801533.247700,1599133400.277400,3539317228.849800,9691,6094,8435,24220
2020-12-15,NYSE (N),923658332,40546806,67513546,1031718684,47149635373.496506,2116205786.260100,3637789295.047099,52903630454.803705,3504867,114877,465432,4085176
2020-12-15,NYSE Arca (P),246112196,248111283,372656295,866879774,10550622104.528601,14838886011.349715,18430857758.277196,43820365874.155512,2226289,853887,2798116,5878292
2020-12-15,NASDAQ (Q),446119745,143465962,977385796,1566971503,21166922646.266004,9203507529.710104,57904589496.768620,88275019672.744728,4738036,732829,7123653,12594518
2020-12-15,Members Exchange (U),28328799,13347514,30247695,71924008,738392093.167800,378896543.822700,874070768.512300,1991359405.502800,287939,46607,294336,628882
2020-12-15,Investors Exchange (V),126319306,16571966,91132657,234023929,7436148772.274098,1153677872.898600,7040694754.533799,15630521399.706497,1283862,98353,973972,2356187
2020-12-15,NASDAQ PSX (X),29234534,17635933,22321396,69191863,836834700.680000,1062487648.552900,1461940516.667000,3361262865.899900,208721,72441,181308,462470
2020-12-15,BYX Equities (Y),69949504,34597368,49016415,153563287,2624982294.218400,2007911989.622700,2434176922.573600,7067071206.414700,770511,175521,574181,1520213
2020-12-15,BZX Equities (Z),195560520,91919558,161844922,449325000,8578645835.804800,6274927920.075399,10220377364.059698,25073951119.939897,2048584,481960,1692858,4223402
2020-12-14,NYSE American (A),11876322,26038930,7555783,45471035,433170890.777800,458161302.924100,399039116.069100,1290371309.771000,185685,98920,118424,403029
2020-12-14,NASDAQ BX (B),33628955,14304349,26461067,74394371,1533824672.383300,1035716422.972800,1773365936.802000,4342907032.158100,420470,77476,346339,844285
2020-12-14,NYSE National (C),55374110,19773244,26867699,102015053,1388417738.596900,778080566.178200,957408384.833300,3123906689.608400,502442,101014,296778,900234
2020-12-14,FINRA / Nasdaq TRF Chicago (DB),10656578,3436474,15134978,29228030,465787569.414000,136193566.827100,914874019.424200,1516855155.665300,55758,10108,80231,146097
2020-12-14,FINRA / NYSE TRF (DN),344481008,115578192,534922728,994981928,11468387820.152197,3733198492.366999,20151223734.925304,35352810047.444500,1644182,308108,2034486,3986776
2020-12-14,FINRA / Nasdaq TRF Carteret (DQ),1528677446,481043749,1660590378,3670311573,66333452313.907895,29712899229.225295,81293323887.981813,177339675431.115003,6613700,1298950,6639623,14552273
2020-12-14,MIAX Pearl (H),2964390,1635645,3827182,8427217,155030915.845600,113950214.845400,385138001.939500,654119132.630500,35881,8123,38156,82160
2020-12-14,EDGA Equities (J),73245171,31570236,53147547,157962954,3284910562.991900,1661636541.216800,3047421085.388800,7993968189.597500,907259,202436,711990,1821685
2020-12-14,EDGX Equities (K),310082280,102223146,326052408,738357834,11178986537.227297,6132742225.853896,14255664102.008902,31567392865.090095,2393983,466380,2335370,5195733
2020-12-14,LTSE (L),200,0,900,1100,2475.000000,0.000000,10524.000000,12999.000000,2,0,9,11
2020-12-14,NYSE Chicago (M),18704919,10589409,7315432,36609760,864285527.298900,1870534471.750000,1929905306.430200,4664725305.479100,9212,2827,8408,20447
2020-12-14,NYSE (N),1029842233,39407293,67867290,1137116816,50104032805.123001,2376263513.252700,3231854393.010100,55712150711.385801,3702718,120697,491730,4315145
2020-12-14,NYSE Arca (P),259501855,265577006,346194063,871272924,11031542164.112800,16592057090.618705,18354284599.751294,45977883854.482799,2405498,916686,2937979,6260163
2020-12-14,NASDAQ (Q),471824821,145271283,1042483015,1659579119,21508315590.088603,10311825153.773401,65371321171.405585,97191461915.267589,5099938,796856,7607809,13504603
2020-12-14,Members Exchange (U),32017234,13183381,33223033,78423648,854982994.526900,478387093.256400,970738925.417500,2304109013.200800,333592,48723,327744,710059
2020-12-14,Investors Exchange (V),131700545,15561514,98446284,245708343,7643124176.409701,1193677080.480000,7430604422.519398,16267405679.409099,1365186,93096,1078713,2536995
2020-12-14,NASDAQ PSX (X),27869197,16881834,21941744,66692775,830204001.608500,1078364851.203600,1418284572.518700,3326853425.330800,215681,71505,191194,478380
2020-12-14,BYX Equities (Y),74252753,33687730,50861685,158802168,2645389500.105100,2093135292.936701,2403213432.688200,7141738225.730001,814321,176275,616758,1607354
2020-12-14,BZX Equities (Z),207150567,97926899,169045292,474122758,8906229198.452399,7197055965.831202,10367167488.011301,26470452652.294902,2284153,517601,1861043,4662797
2020-12-11,NYSE American (A),12525686,23399687,7507704,43433077,465768105.688200,418175583.411300,476772726.672000,1360716415.771500,178889,87268,110202,376359
2020-12-11,NASDAQ BX (B),33450388,13393034,24747322,71590744,1489446864.076200,963071812.364701,1688639405.837300,4141158082.278201,439188,73486,343316,855990
2020-12-11,NYSE National (C),54591872,19428485,25866922,99887279,1365950804.336800,710494873.030200,965311553.415000,3041757230.782000,511458,95573,292664,899695
2020-12-11,FINRA / Nasdaq TRF Chicago (DB),10102414,3616206,15346686,29065306,463004320.208400,141967044.429500,806220459.647300,1411191824.285200,52207,9434,73411,135052
2020-12-11,FINRA / NYSE TRF (DN),343719857,124323523,548050100,1016093480,12445836851.684601,4006714139.704000,19365248216.163908,35817799207.552509,1603785,292927,2012849,3909561
2020-12-11,FINRA / Nasdaq TRF Carteret (DQ),1465508999,491965089,1574753752,3532227840,65371761090.953781,27853952961.712400,69786917393.721475,163012631446.387656,6198892,1276925,6204273,13680090
2020-12-11,MIAX Pearl (H),2775045,1337682,3482905,7595632,188842707.674400,104430288.767800,287886757.830700,581159754.272900,35610,6765,35564,77939
2020-12-11,EDGA Equities (J),70016035,30654492,49193100,149863627,3269694566.617900,1571474428.424500,2958047050.960201,7799216046.002601,884868,200832,652090,1737790
2020-12-11,EDGX Equities (K),296956902,91840208,325511969,714309079,11060906611.044202,5433180526.421601,13379963990.786699,29874051128.252502,2216370,429891,2173740,4820001
2020-12-11,LTSE (L),0,0,7,7,0.000000,0.000000,238.630000,238.630000,0,0,1,1
2020-12-11,NYSE Chicago (M),12508618,11655942,9361916,33526476,616255322.793000,1812363470.860000,1726232304.135000,4154851097.788000,9371,8103,8998,26472
2020-12-11,NYSE (N),909253905,38168706,61698962,1009121573,41892054756.385698,1946917652.667200,3293760112.138899,47132732521.191797,3351695,115525,445673,3912893
2020-12-11,NYSE Arca (P),252144786,231223709,343336723,826705218,10574143826.837106,13670049732.633597,16192829007.113785,40437022566.584488,2241822,816969,2676155,5734946
2020-12-11,NASDAQ (Q),448074049,138263043,952971761,1539308853,20329078666.293204,9765047939.544900,53821553759.649610,83915680365.487714,4630438,745774,6780786,12156998
2020-12-11,Members Exchange (U),30612766,12187239,31299839,74099844,757633345.564500,413734922.678100,878394597.851900,2049762866.094500,293937,45352,300991,640280
2020-12-11,Investors Exchange (V),126528419,13731395,87803530,228063344,7358012769.213701,897746055.477000,6454896792.452002,14710655617.142703,1317229,84694,968877,2370800
2020-12-11,NASDAQ PSX (X),32202333,17160377,20550502,69913212,839201513.344000,965763929.152300,1439157555.132000,3244122997.628300,211242,75036,171713,457991
2020-12-11,BYX Equities (Y),73239420,35674915,55114857,164029192,2631386926.072500,1940188152.111499,2234079814.798201,6805654892.982200,816220,171660,575853,1563733
2020-12-11,BZX Equities (Z),201259885,96571331,156087867,453919083,8928565678.245103,6580251415.136600,10252017218.166598,25760834311.548301,2154316,508385,1676178,4338879
2020-12-10,NYSE American (A),11925652,24979850,8208068,45113570,400823524.140000,441024808.654100,415256298.939100,1257104631.733200,151468,91208,99615,342291
2020-12-10,NASDAQ BX (B),33914479,15852904,25243555,75010938,1406378666.406100,965248425.924000,1872182613.980200,4243809706.310300,448288,78926,354686,881900
2020-12-10,NYSE National (C),57980770,21978340,24187559,104146669,1355439208.421500,816181567.554300,932868757.399300,3104489533.375100,478259,107684,260594,846537
2020-12-10,FINRA / Nasdaq TRF Chicago (DB),10306584,4133663,15706949,30147196,430942126.209500,118003338.989300,873671513.551000,1422616978.749800,49353,9894,78729,137976
2020-12-10,FINRA / NYSE TRF (DN),315074732,106427810,528559726,950062268,9799131574.759498,3412037381.334898,18169051103.599096,31380220059.693492,1467936,281231,1966406,3715573
2020-12-10,FINRA / Nasdaq TRF Carteret (DQ),1594544619,462305876,1743959490,3800809985,64771354069.782095,25448804987.397886,80170090871.841563,170390249929.021544,6295783,1210395,6703952,14210130
2020-12-10,MIAX Pearl (H),3303086,1128104,2970906,7402096,196621507.816300,103520310.958100,353066960.322300,653208779.096700,41851,5852,36064,83767
2020-12-10,EDGA Equities (J),77212270,35606661,50720106,163539037,3353425384.715900,1801712415.471300,3002907476.997600,8158045277.184800,955374,228400,672741,1856515
2020-12-10,EDGX Equities (K),313615134,96752198,344583077,754950409,10670013582.541996,5466122147.756500,15227188424.477801,31363324154.776297,2184129,434491,2281466,4900086
2020-12-10,LTSE (L),300,400,219,919,4471.000000,8895.000000,4280.530000,17646.530000,3,4,6,13
2020-12-10,NYSE Chicago (M),13578292,9352105,5790256,28720653,832567980.700000,1302034026.162500,1304124287.779000,3438726294.641500,8715,5769,9408,23892
2020-12-10,NYSE (N),965811479,44631835,58368810,1068812124,45282489793.422701,2232692046.022800,3129764159.906899,50644945999.352400,3454776,122627,425888,4003291
2020-12-10,NYSE Arca (P),267656522,248468927,367356432,883481881,10872742447.947300,15748316380.619798,19207688627.668099,45828747456.235197,2303080,851390,2801589,5956059
2020-12-10,NASDAQ (Q),490034197,148250242,990828392,1629112831,21079719554.599097,9955519287.695705,62139103400.675728,93174342242.970530,4846748,796659,7313753,12957160
2020-12-10,Members Exchange (U),32114750,14170863,31792606,78078219,762882938.827300,429636116.009000,844742942.939300,2037261997.775600,296327,43542,295582,635451
2020-12-10,Investors Exchange (V),132279980,14984499,87184895,234449374,7377795834.588900,1086134439.758000,6638318023.553900,15102248297.900800,1287554,88288,938033,2313875
2020-12-10,NASDAQ PSX (X),36951842,20419431,21097261,78468534,943753585.703200,1255328150.362900,1511408584.161300,3710490320.227400,228625,87695,184027,500347
2020-12-10,BYX Equities (Y),79105630,35805283,50403214,165314127,2721117277.016300,1975838731.205300,2328664906.128900,7025620914.350500,903250,176236,595420,1674906
2020-12-10,BZX Equities (Z),223076760,104306132,161622002,489004894,8947827279.673201,6908681198.847501,9917413474.126602,25773921952.647304,2218432,523359,1671875,4413666
2020-12-09,NYSE American (A),14163996,28261641,9156500,51582137,546525305.840000,539106924.884900,567605114.977000,1653237345.701900,218911,106287,140257,465455
2020-12-09,NASDAQ BX (B),38858526,18977650,29057760,86893936,1696258153.013500,1361951735.084000,2017962335.580700,5076172223.678200,522044,95877,402239,1020160
2020-12-09,NYSE National (C),63831305,26686431,28851715,119369451,1706908446.156500,1004554881.706800,1132259341.683200,3843722669.546500,593919,124097,314378,1032394
2020-12-09,FINRA / Nasdaq TRF Chicago (DB),13374301,5580402,19716282,38670985,579997032.267400,146421247.389800,1042378715.963500,1768796995.620700,66849,11957,94165,172971
2020-12-09,FINRA / NYSE TRF (DN),415791901,147469838,665700868,1228962607,13802442490.568403,4561438525.278502,24916233452.348304,43280114468.195209,1970057,378271,2496683,4845011
2020-12-09,FINRA / Nasdaq TRF Carteret (DQ),1738196815,596728276,1857598961,4192524052,70965699516.037600,35333869183.524319,89905023734.434714,196204592433.996633,7205742,1475994,7293733,15975469
2020-12-09,MIAX Pearl (H),3826120,1614706,4251222,9692048,216862382.955700,151996547.987900,370104524.223300,738963455.166900,43301,7672,41279,92252
2020-12-09,EDGA Equities (J),87549214,42013428,57328148,186890790,3881803064.359700,2205812216.250700,3380079094.313301,9467694374.923701,1113368,259340,760406,2133114
2020-12-09,EDGX Equities (K),389953441,126066273,419299556,935319270,14292318004.046494,7038629651.387998,18522304271.095898,39853251926.530390,2815722,556126,2734635,6106483
2020-12-09,LTSE (L),0,0,85,85,0.000000,0.000000,1240.150000,1240.150000,0,0,1,1
2020-12-09,NYSE Chicago (M),8927827,13468443,5886265,28282535,563715415.914900,1260903814.348100,1615473078.157800,3440092308.420800,10298,6038,10550,26886
2020-12-09,NYSE (N),1054094392,59326906,78947694,1192368992,50054454364.226097,3082382915.573400,4240986189.267000,57377823469.066497,3955331,162640,539155,4657126
2020-12-09,NYSE Arca (P),286127564,294566021,400499397,981192982,12305789580.434095,18372368314.471198,21797534422.178808,52475692317.084101,2566702,1034956,3181525,6783183
2020-12-09,NASDAQ (Q),552207331,189943461,1155046845,1897197637,25112002623.218103,12963715817.207799,72622255013.279469,110697973453.705371,5568066,1003662,8341256,14912984
2020-12-09,Members Exchange (U),34716704,15300734,40681497,90698935,877683168.479200,524952210.751700,965398632.607700,2368034011.838600,346518,54864,346535,747917
2020-12-09,Investors Exchange (V),152371515,17545010,103464671,273381196,8807368470.476301,1373235097.611700,8387925339.352798,18568528907.440799,1495564,103804,1093304,2692672
2020-12-09,NASDAQ PSX (X),38943288,24787932,27639561,91370781,1032371351.671500,1567583570.006000,2138388656.343099,4738343578.020599,240734,111797,220008,572539
2020-12-09,BYX Equities (Y),87099047,45934505,68611195,201644747,3133714292.220200,2669399603.789400,2664151351.765401,8467265247.775001,1046749,223083,686370,1956202
2020-12-09,BZX Equities (Z),252767176,124848880,196721743,574337799,10682750555.125798,8571831998.634296,12731638051.017606,31986220604.777700,2600898,626163,2004347,5231408
2020-12-08,NYSE American (A),11382992,31001480,7746689,50131161,404200507.579700,378336595.829200,352415159.826400,1134952263.235300,151367,97425,99974,348766
2020-12-08,NASDAQ BX (B),34339332,13648598,25089643,73077573,1410323044.016500,906933907.868600,1573096410.606100,3890353362.491200,467726,71629,342518,881873
2020-12-08,NYSE National (C),54182590,17574807,27582234,99339631,1312966010.983700,677253574.477500,929746130.938600,2919965716.399800,481998,86882,291500,860380
2020-12-08,FINRA / Nasdaq TRF Chicago (DB),11006599,3554792,18549504,33110895,462317056.577500,97375922.386400,791855566.692100,1351548545.656000,56263,8872,78167,143302
2020-12-08,FINRA / NYSE TRF (DN),358607327,135068572,659773841,1153449740,12337369059.529300,3578685974.351700,20729329091.781997,36645384125.662997,1636512,317800,2163275,4117587
2020-12-08,FINRA / Nasdaq TRF Carteret (DQ),1610439221,454721107,1781458068,3846618396,67042240355.968101,22370555248.303395,73850076483.766377,163262872088.037873,6526492,1303116,6635594,14465202
2020-12-08,MIAX Pearl (H),2776200,1471827,3566501,7814528,180637011.960300,85991101.928500,354272959.426000,620901073.314800,36534,7109,35852,79495
2020-12-08,EDGA Equities (J),74599320,28024806,54859973,157484099,3296701176.618700,1492687587.728500,3086863281.929000,7876252046.276200,1007192,177868,745667,1930727
2020-12-08,EDGX Equities (K),324304321,87356737,378616853,790277911,11673650983.780194,4221093649.577701,14624562151.777594,30519306785.135489,2331297,368109,2296252,4995658
2020-12-08,LTSE (L),0,100,0,100,0.000000,442.000000,0.000000,442.000000,0,1,0,1
2020-12-08,NYSE Chicago (M),14124524,9557636,5008072,28690232,981202394.544000,1222988368.797000,1105497141.107700,3309687904.448700,8375,4282,9563,22220
2020-12-08,NYSE (N),911242931,36835162,63827111,1011905204,42459225263.992401,1767130835.645299,3085080552.660999,47311436652.298699,3429521,104381,462536,3996438
2020-12-08,NYSE Arca (P),252567890,212434183,385923683,850925756,10089424421.137900,12697434357.695801,17879039471.249712,40665898250.083413,2218109,724700,2815378,5758187
2020-12-08,NASDAQ (Q),459844565,129960061,1025362650,1615167276,20190805271.793406,7908654189.403299,55517925270.662213,83617384731.858918,4732704,667526,7047869,12448099
2020-12-08,Members Exchange (U),24761333,10271260,26974543,62007136,540968866.945000,322630335.053700,581254180.204800,1444853382.203500,208405,28723,212715,449843
2020-12-08,Investors Exchange (V),133507534,14253466,93789052,241550052,7256568782.265099,939251023.618600,6498317273.663101,14694137079.546800,1312605,84420,977400,2374425
2020-12-08,NASDAQ PSX (X),32720395,14985421,22250036,69955852,837806904.603000,878470738.721400,1248905774.500400,2965183417.824800,209859,62217,176192,448268
2020-12-08,BYX Equities (Y),73046026,32655168,61381122,167082316,2579088889.033000,1614028041.729900,2287927429.904599,6481044360.667499,897242,153962,629859,1681063
2020-12-08,BZX Equities (Z),200946415,79873913,167726734,448547062,8278693309.346402,5111771573.142601,9296981617.174396,22687446499.663399,2114002,417789,1647215,4179006
2020-12-07,NYSE American (A),12513969,29064371,7255218,48833558,410479851.598700,434762772.517500,340645456.519300,1185888080.635500,169803,105278,109472,384553
2020-12-07,NASDAQ BX (B),32233992,17324894,29169249,78728135,1320255305.569400,1098887888.127700,1455071907.808800,3874215101.505900,436026,82243,339706,857975
2020-12-07,NYSE National (C),61935144,24091257,27192618,113219019,1362026205.957300,977039106.455800,872524644.550700,3211589956.963800,530002,128297,304761,963060
2020-12-07,FINRA / Nasdaq TRF Chicago (DB),5439532,2172376,9050118,16662026,231862100.156800,55199590.010600,434984761.317100,722046451.484500,31169,6762,45298,83229
2020-12-07,FINRA / NYSE TRF (DN),404221830,123227324,668020546,1195469700,13094384871.612100,3699803131.541502,20171961974.821697,36966149977.975299,1801406,329595,2205253,4336254
2020-12-07,FINRA / Nasdaq TRF Carteret (DQ),1652588069,489269464,1769054942,3910912475,67097157189.683786,25501340530.200008,73656482763.901697,166254980483.785491,6698071,1384699,6476691,14559461
2020-12-07,MIAX Pearl (H),2837579,1280650,3619565,7737794,185307235.590500,85917524.871900,309754974.556600,580979735.019000,36398,5456,36673,78527
2020-12-07,EDGA Equities (J),77482981,32748610,51626262,161857853,3143666850.596000,1675447167.880100,2762887207.303000,7582001225.779100,1004572,207317,700442,1912331
2020-12-07,EDGX Equities (K),361148580,93250371,401279515,855678466,12223685724.517796,4982164956.881899,15280483951.897402,32486334633.297097,2488669,411587,2342375,5242631
2020-12-07,NYSE Chicago (M),5840858,9023935,4087226,18952019,446391302.463100,1139846041.355000,1168934432.577800,2755171776.395900,9696,2344,8072,20112
2020-12-07,NYSE (N),926481834,39378754,64895489,1030756077,43023676392.473195,2011295485.023000,2717938823.559300,47752910701.055495,3443369,112575,445054,4000998
2020-12-07,NYSE Arca (P),277040833,257170531,380487531,914698895,9798672870.003706,15250401560.872112,15416808443.442394,40465882874.318212,2298947,835912,2679401,5814260
2020-12-07,NASDAQ (Q),488821404,146562603,984681202,1620065209,20327524578.690703,9369476226.880704,53076607976.937494,82773608782.508901,4907782,738380,6764556,12410718
2020-12-07,Members Exchange (U),27687879,10852467,34740761,73281107,601727038.085800,357566696.229000,522493869.259300,1481787603.574100,253044,30520,220445,504009
2020-12-07,Investors Exchange (V),133398876,15549084,90373007,239320967,7267023217.038301,1041572691.436900,6365715621.292900,14674311529.768101,1405316,96798,998163,2500277
2020-12-07,NASDAQ PSX (X),34449419,17222754,24312535,75984708,845775848.839500,1065080418.449600,1257712985.651000,3168569252.940100,214610,69855,183616,468081
2020-12-07,BYX Equities (Y),76556606,35728492,50632624,162917722,2494155211.885500,1943673696.382400,2171220020.914900,6609048929.182800,888569,169746,597036,1655351
2020-12-07,BZX Equities (Z),223829495,93130531,171346041,488306067,8870812592.064799,5827023516.796700,9028385885.220798,23726221994.082297,2296345,475280,1685037,4456662
2020-12-04,NYSE American (A),13627624,23679555,7975265,45282444,413109643.290500,463271976.398900,343429700.830400,1219811320.519800,185101,94042,102413,381556
2020-12-04,NASDAQ BX (B),35473474,17871956,32917627,86263057,1389963034.473700,1067704747.370200,1302694930.187400,3760362712.031300,474100,80873,314156,869129
2020-12-04,NYSE National (C),64265642,25473610,26676639,116415891,1434262755.758500,1014174362.953100,858804142.496000,3307241261.207600,552866,123207,280402,956475
2020-12-04,FINRA / Nasdaq TRF Chicago (DB),11919646,4490224,16194210,32604080,519044867.754200,104052622.377400,586318141.336500,1209415631.468100,58841,9527,65757,134125
2020-12-04,FINRA / NYSE TRF (DN),425152703,133283182,734659922,1293095807,13935003510.028702,3771007873.214902,17614225833.601909,35320237216.845513,1820204,314702,2062224,4197130
2020-12-04,FINRA / Nasdaq TRF Carteret (DQ),1759998077,463799333,1824924063,4048721473,73816908008.092761,25435246022.265703,65892847575.184400,165145001605.542864,6630756,1270778,6073267,13974801
2020-12-04,MIAX Pearl (H),3243356,1519180,23635141,28397677,187481833.766800,105796920.361100,274648521.955900,567927276.083800,40329,7775,50069,98173
2020-12-04,EDGA Equities (J),81117546,33830184,54871963,169819693,3505257345.330000,1822611497.958100,2635281273.850300,7963150117.138400,1023813,205716,660948,1890477
2020-12-04,EDGX Equities (K),357070765,91517046,411590199,860178010,12712837104.480602,5076826812.127000,12689687730.860602,30479351647.468204,2431554,400182,2155597,4987333
2020-12-04,LTSE (L),0,210,100,310,0.000000,4711.290000,1876.000000,6587.290000,0,4,1,5
2020-12-04,NYSE Chicago (M),12983390,12592538,8023098,33599026,685497726.388300,1778826150.306800,1347076530.490800,3811400407.185900,9154,1268,7543,17965
2020-12-04,NYSE (N),975214010,43452017,71480252,1090146279,44099829522.750400,2175787450.662200,3026806582.458200,49302423555.870800,3565800,119693,450209,4135702
2020-12-04,NYSE Arca (P),282262942,247124592,428362688,957750222,11572598303.580802,15231495415.963095,14366891867.413787,41170985586.957684,2388083,811923,2563977,5763983
2020-12-04,NASDAQ (Q),531668007,158529926,1063829022,1754026955,22997101951.731710,10099350152.438800,50662905816.400026,83759357920.570536,5206747,756145,6810066,12772958
2020-12-04,Members Exchange (U),33931149,9880930,32822527,76634606,613216980.942500,354797614.120100,561514328.676600,1529528923.739200,269572,29304,216081,514957
2020-12-04,Investors Exchange (V),141564965,15871402,89700036,247136403,7894675722.865201,986799954.414400,6131160447.398601,15012636124.678202,1350500,89239,894098,2333837
2020-12-04,NASDAQ PSX (X),38301510,18817057,22663723,79782290,968359708.595000,1056525630.409700,1274916627.742900,3299801966.747600,235047,75057,180452,490556
2020-12-04,BYX Equities (Y),83862129,37227731,51089119,172178979,2813789123.653700,2062966982.951500,2048831019.886300,6925587126.491500,962200,171513,574305,1708018
2020-12-04,BZX Equities (Z),247964633,94196916,185494206,527655755,10200223763.069901,6234008459.186502,9217644047.413402,25651876269.669805,2420449,464278,1725860,4610587
2020-12-03,NYSE American (A),13460676,24360973,7101120,44922769,380790011.253700,431953314.881900,385368949.173500,1198112275.309100,158638,91766,102010,352414
2020-12-03,NASDAQ BX (B),34671399,17272438,29928579,81872416,1425183577.873900,1135757197.848100,1418440975.450900,3979381751.172900,457962,86669,334116,878747
2020-12-03,NYSE National (C),67611405,25486716,28371790,121469911,1485342000.643900,1013313805.509700,980790151.927200,3479445958.080800,544227,133347,300339,977913
2020-12-03,FINRA / Nasdaq TRF Chicago (DB),11538623,3689398,14135792,29363813,504787865.060200,103543793.345100,729386723.909000,1337718382.314300,54724,8388,65701,128813
2020-12-03,FINRA / NYSE TRF (DN),416951767,134979081,697303867,1249234715,14073411724.347103,3819109241.038801,19001303616.902204,36893824582.288108,1785365,300191,2099480,4185036
2020-12-03,FINRA / Nasdaq TRF Carteret (DQ),1789544242,496074952,1779951137,4065570331,75394670651.407418,27134063223.853805,72273548323.589410,174802282198.850633,6607056,1249507,6110766,13967329
2020-12-03,MIAX Pearl (H),2915380,2073749,56803168,61792297,177184996.667300,140357519.603900,320882294.868300,638424811.139500,32825,7972,53856,94653
2020-12-03,EDGA Equities (J),82070029,36188878,53922706,172181613,3468886732.496300,1889680906.761800,2794514198.935600,8153081838.193700,1041070,220407,708243,1969720
2020-12-03,EDGX Equities (K),349522582,99393724,371136270,820052576,12315126917.737996,5604059749.516299,14272117963.993998,32191304631.248293,2392710,426343,2192233,5011286
2020-12-03,LTSE (L),100,0,0,100,2140.000000,0.000000,0.000000,2140.000000,2,0,0,2
2020-12-03,NYSE Chicago (M),5370467,6331153,4184520,15886140,475261583.819500,1374122727.245000,725931659.980400,2575315971.044900,9307,1486,7307,18100
2020-12-03,NYSE (N),979943240,47198716,59284130,1086426086,44238898013.883305,2578146134.201800,3053806469.254500,49870850617.339605,3663202,132061,434268,4229531
2020-12-03,NYSE Arca (P),266653342,252491973,385488328,904633643,10945759012.683602,15898775685.945988,16261942165.903402,43106476864.532992,2253615,838560,2663043,5755218
2020-12-03,NASDAQ (Q),507732901,160927885,976673191,1645333977,22236588055.449899,10791000452.115297,54177087226.630607,87204675734.195803,5010155,802324,6762547,12575026
2020-12-03,Members Exchange (U),26240659,8566726,409518070,444325455,568083769.070800,334081318.382900,819333922.801700,1721499010.255400,239043,29392,333760,602195
2020-12-03,Investors Exchange (V),149762127,16267287,91607665,257637079,7776999978.177801,1084822675.985100,6535583855.105500,15397406509.268401,1509423,102967,1012565,2624955
2020-12-03,NASDAQ PSX (X),36465262,21876949,20593800,78936011,920201252.477500,1319415262.968400,1337259960.586800,3576876476.032700,221012,90141,170107,481260
2020-12-03,BYX Equities (Y),82904699,36992859,50341837,170239395,2697160215.849900,2153431959.784700,2173891993.885100,7024484169.519700,924409,178548,601757,1704714
2020-12-03,BZX Equities (Z),241982654,106491312,173639672,522113638,10123800208.743999,7550002747.015900,9809400301.423500,27483203257.183399,2327359,525474,1713525,4566358
2020-12-02,NYSE American (A),11641278,32202095,8465114,52308487,417991992.600800,421314411.867600,333791678.800400,1173098083.268800,171366,103568,105428,380362
2020-12-02,NASDAQ BX (B),35093483,18040094,26955502,80089079,1560896161.518200,1145128104.653300,1488643749.679200,4194668015.850700,499431,94373,341149,934953
2020-12-02,NYSE National (C),60587507,25985110,29553806,116126423,1447669172.154900,1000141120.512900,989359644.136300,3437169936.804100,535921,133333,303856,973110
2020-12-02,FINRA / Nasdaq TRF Chicago (DB),11993510,6730987,17731908,36456405,471357809.496900,80255688.799500,701321976.764300,1252935475.060700,55413,8975,69813,134201
2020-12-02,FINRA / NYSE TRF (DN),433652992,171349363,723021847,1328024202,14102868131.920306,3584970290.725201,19526369986.836707,37214208409.482214,1894950,317488,2137328,4349766
2020-12-02,FINRA / Nasdaq TRF Carteret (DQ),1688229684,570446977,1816664922,4075341583,69379287372.555097,26163519453.651599,70065470560.270370,165608277386.477066,6745376,1356882,6057206,14159464
2020-12-02,MIAX Pearl (H),2075841,1460937,2045270,5582048,161011506.686100,105311418.517700,184672289.638400,450995214.842200,24310,7000,21623,52933
2020-12-02,EDGA Equities (J),78737565,35024377,55130108,168892050,3521674976.833700,1782072048.304700,2692864176.017000,7996611201.155400,1013464,217969,690353,1921786
2020-12-02,EDGX Equities (K),353086074,102992789,392787016,848865879,12801506352.149400,4860328093.776699,13452816541.779705,31114650987.705804,2482497,433555,2128364,5044416
2020-12-02,LTSE (L),0,200,0,200,0.000000,4428.000000,0.000000,4428.000000,0,2,0,2
2020-12-02,NYSE Chicago (M),15505767,11657637,6950246,34113650,551288437.015800,1738040229.955000,1167566793.094800,3456895460.065600,9194,1355,8419,18968
2020-12-02,NYSE (N),997382089,43141937,74327492,1114851518,46693286155.162705,2159182454.749700,2923597535.312400,51776066145.224805,3654071,125143,453102,4232316
2020-12-02,NYSE Arca (P),291400727,269111318,444539416,1005051461,12670137272.525601,15054528485.477394,16982915919.195992,44707581677.198987,2470107,838595,2771145,6079847
2020-12-02,NASDAQ (Q),535471542,168179338,1038002927,1741653807,24244439800.197695,9645502867.717898,52957666896.075590,86847609563.991183,5290020,781299,6544245,12615564
2020-12-02,Members Exchange (U),29773399,10006721,193403050,233183170,613410369.910000,329877008.136500,657473078.554400,1600760456.600900,265290,30632,282770,578692
2020-12-02,Investors Exchange (V),141372054,16437140,94907376,252716570,8210329697.645400,933436515.837500,6251249033.104600,15395015246.587500,1402904,95753,985566,2484223
2020-12-02,NASDAQ PSX (X),34532654,19503199,23574889,77610742,979620193.306800,1030632546.666200,1515636624.425700,3525889364.398700,224592,84682,181304,490578
2020-12-02,BYX Equities (Y),82605524,33802108,56850924,173258556,2882019106.556000,1860483838.575900,2277244006.697901,7019746951.829801,933131,170845,617664,1721640
2020-12-02,BZX Equities (Z),238109077,105307538,190049677,533466292,10215682088.250799,6660633074.209002,9678678595.889305,26554993758.349106,2426072,538963,1751220,4716255
2020-12-01,NYSE American (A),13382145,36833841,10284530,60500516,452555958.097900,562083565.316100,466655743.037300,1481295266.451300,181974,113783,118614,414371
2020-12-01,NASDAQ BX (B),38351581,20038481,43416738,101806800,1531116269.946400,1266720836.925900,1978607001.890600,4776444108.762900,489200,106138,382512,977850
2020-12-01,NYSE National (C),66228128,31551905,31080697,128860730,1528275300.941900,1176963422.232700,1261093186.805800,3966331909.980400,566165,147034,317153,1030352
2020-12-01,FINRA / Nasdaq TRF Chicago (DB),13606172,15219753,25485936,54311861,478647766.123300,144904886.715800,1032334568.242300,1655887221.081400,60756,13074,95612,169442
2020-12-01,FINRA / NYSE TRF (DN),493570296,198930007,1034477372,1726977675,13266664374.382297,5210831246.802100,24323397810.118107,42800893431.302504,2019507,360650,2705200,5085357
2020-12-01,FINRA / Nasdaq TRF Carteret (DQ),1851825379,637535322,2178790063,4668150764,72908047487.094291,32921826644.533092,87204384533.762271,193034258665.389654,7060771,1477668,7265063,15803502
2020-12-01,MIAX Pearl (H),1568357,1810451,2028017,5406825,49763761.475000,163001189.910800,47827037.027800,260591988.413600,15676,7703,13037,36416
2020-12-01,EDGA Equities (J),85613108,43123648,67669126,196405882,3557311071.318600,2163386182.723500,3457143297.659701,9177840551.701801,1086610,249143,787324,2123077
2020-12-01,EDGX Equities (K),373326298,131149767,539581172,1044057237,11896074291.169701,6915093339.639898,18328996778.353905,37140164409.163504,2594912,537189,2746607,5878708
2020-12-01,LTSE (L),0,0,100,100,0.000000,0.000000,281.000000,281.000000,0,0,1,1
2020-12-01,NYSE Chicago (M),13147102,12624818,5605296,31377216,786426506.506800,2284692462.330000,702654654.537000,3773773623.373800,9717,1376,10868,21961
2020-12-01,NYSE (N),1045468059,51772995,86735718,1183976772,46780305535.167912,2864486333.966000,4113599196.136001,53758391065.269913,4025428,155625,568233,4749286
2020-12-01,NYSE Arca (P),309333130,354332025,559301165,1222966320,12333020925.794302,20956235105.276795,21611514154.141290,54900770185.212387,2619913,1062067,3385866,7067846
2020-12-01,NASDAQ (Q),549800679,196067360,1336877291,2082745330,23575725886.575798,12591385687.667402,65516679262.418876,101683790836.662076,5556182,963687,8039152,14559021
2020-12-01,Members Exchange (U),33055685,10028487,163782765,206866937,629583735.004700,444980854.144400,750004680.211300,1824569269.360400,283377,37396,278610,599383
2020-12-01,Investors Exchange (V),143666309,22516634,102412418,268595361,8054741489.644999,1269281281.439200,7556393696.463404,16880416467.547603,1361029,113597,1039253,2513879
2020-12-01,NASDAQ PSX (X),34754635,22046253,25619349,82420237,915867861.586400,1336396578.080000,1661471645.291100,3913736084.957500,227493,92689,204638,524820
2020-12-01,BYX Equities (Y),92665644,50875758,69461794,213003196,3001518061.420200,2580649727.665599,3032296544.567101,8614464333.652900,1020839,222680,687458,1930977
2020-12-01,BZX Equities (Z),259122471,137270418,229815235,626208124,10093108832.004998,9105112803.181601,12387346747.347796,31585568382.534395,2690543,665537,2090862,5446942
2020-11-30,NYSE American (A),12413655,36835922,10213131,59462708,457310965.690000,633469524.965200,454633016.866500,1545413507.521700,182849,114259,122063,419171
2020-11-30,NASDAQ BX (B),40285391,22506326,44550092,107341809,1664731113.929900,1690402769.590600,1952206623.981000,5307340507.501500,506337,112788,385333,1004458
2020-11-30,NYSE National (C),68617403,32431345,54593998,155642746,1689428063.886500,1316656980.908500,1199508577.104000,4205593621.899000,601750,157514,358237,1117501
2020-11-30,FINRA / Nasdaq TRF Chicago (DB),12646253,3814002,24679641,41139896,527604235.816600,143278522.277400,1025959337.528900,1696842095.622900,64751,11966,94811,171528
2020-11-30,FINRA / NYSE TRF (DN),424767185,156920547,1254488301,1836176033,12504205784.428897,5591545652.571704,24690221665.636289,42785973102.636890,2062524,389631,2853505,5305660
2020-11-30,FINRA / Nasdaq TRF Carteret (DQ),1958154445,582290881,2651909226,5192354552,84177475734.894855,33772649668.187179,97060607555.258547,215010732958.340581,7402687,1539617,7478208,16420512
2020-11-30,MIAX Pearl (H),2116440,1549350,2170610,5836400,139199158.560000,134717038.121000,226551212.948300,500467409.629300,22625,5990,21191,49806
2020-11-30,EDGA Equities (J),78008869,39970298,75176770,193155937,3592323502.692101,2364429660.607800,3110551807.223600,9067304970.523501,1054263,247122,774549,2075934
2020-11-30,EDGX Equities (K),343065139,118633795,565820273,1027519207,11696581790.557597,6925420596.176698,16923749445.004996,35545751831.739291,2585456,549494,2695783,5830733
2020-11-30,LTSE (L),0,100,0,100,0.000000,2200.000000,0.000000,2200.000000,0,1,0,1
2020-11-30,NYSE Chicago (M),22093580,5911773,7505905,35511258,1141088665.436800,594576054.110000,1302554196.984200,3038218916.531000,9765,2677,9290,21732
2020-11-30,NYSE (N),1851414832,49633051,93032322,1994080205,94843144359.429112,2908025956.640100,4130984972.872301,101882155288.941513,4299661,154148,572377,5026186
2020-11-30,NYSE Arca (P),342270621,342132685,625050601,1309453907,13771169073.743000,21322558136.914401,23223799550.840301,58317526761.497702,2880985,1070285,3578924,7530194
2020-11-30,NASDAQ (Q),575434591,198304462,1834906630,2608645683,25095186287.849596,13122725099.119503,95968140847.791695,134186052234.760794,5783936,1007825,8347035,15138796
2020-11-30,Members Exchange (U),29705221,11581435,28169996,69456652,695280070.129400,450101662.572800,551460184.599500,1696841917.301700,293698,38277,233642,565617
2020-11-30,Investors Exchange (V),157051572,21623965,105865295,284540832,8761579870.324800,1461581985.115600,7581982521.382398,17805144376.822798,1494742,121462,1060492,2676696
2020-11-30,NASDAQ PSX (X),38539334,21981344,29789864,90310542,1057288695.598200,1204824423.848000,1834494824.611001,4096607944.057201,250294,87901,221690,559885
2020-11-30,BYX Equities (Y),94913763,45630250,89542376,230086389,3288652813.905400,2904869086.614700,2893756936.797099,9087278837.317199,1062733,224872,712457,2000062
2020-11-30,BZX Equities (Z),256912729,133275962,262934084,653122775,10682050871.611699,9126831866.788096,12317798937.918695,32126681676.318490,2724014,668602,2107714,5500330
2020-11-27,NYSE American (A),5802092,20745296,4319688,30867076,193347297.280000,244625796.040100,245569782.067800,683542875.387900,82792,64026,58272,205090
2020-11-27,NASDAQ BX (B),17597281,7945074,14065661,39608016,748951034.735000,513940797.752200,883030569.285500,2145922401.772700,229616,40249,173669,443534
2020-11-27,NYSE National (C),27197203,13400788,14369379,54967370,697538810.727300,519541756.441600,548328435.773500,1765409002.942400,255420,68516,154499,478435
2020-11-27,FINRA / Nasdaq TRF Chicago (DB),8711073,2081750,13823489,24616312,358720778.867500,64673739.257800,595335704.398600,1018730222.523900,46287,6222,56934,109443
2020-11-27,FINRA / NYSE TRF (DN),260166771,83413979,557344529,900925279,8484910293.612400,2312991660.294200,13711019743.166800,24508921697.073400,1281510,208450,1668174,3158134
2020-11-27,FINRA / Nasdaq TRF Carteret (DQ),927467185,275727386,1185131515,2388326086,36815230253.968293,13380372906.922113,44948787616.871510,95144390777.761916,3958492,766438,3991967,8716897
2020-11-27,MIAX Pearl (H),1248618,692837,1228008,3169463,64132415.150000,54789099.459200,116162778.797200,235084293.406400,12090,3622,11751,27463
2020-11-27,EDGA Equities (J),36000361,16848022,31263677,84112060,1611986165.761700,871100386.532300,1592355700.587000,4075442252.881000,479628,105219,374607,959454
2020-11-27,EDGX Equities (K),194095960,61234190,276575163,531905313,6497843108.299701,2770943781.352700,9337907510.974802,18606694400.627203,1368667,265793,1458034,3092494
2020-11-27,NYSE Chicago (M),3793444,3742645,2098273,9634362,231296187.499000,380048566.125000,421049590.683000,1032394344.307000,5582,806,5147,11535
2020-11-27,NYSE (N),530148181,22539893,43870184,596558258,23484601469.563201,1206159266.070500,2061218681.922400,26751979417.556101,2060323,73719,301348,2435390
2020-11-27,NYSE Arca (P),201069459,153621084,312886010,667576553,7581264500.229400,8586255076.963596,12015633734.559105,28183153311.752101,1578625,535999,1878559,3993183
2020-11-27,NASDAQ (Q),288324564,86268559,689905003,1064498126,12230780782.038903,5379194288.587600,34432079852.305986,52042054922.932489,2855753,458708,4208010,7522471
2020-11-27,Members Exchange (U),17059852,5845304,17711705,40616861,403482993.555000,165070708.188000,316430421.204800,884984122.947800,174764,17828,143494,336086
2020-11-27,Investors Exchange (V),71701228,8287154,50083527,130071909,3833286147.035800,530002083.120000,3604414046.093100,7967702276.248900,721613,53647,523625,1298885
2020-11-27,NASDAQ PSX (X),19651759,9716351,13910780,43278890,492850911.815700,529797988.832400,810593558.935200,1833242459.583300,114863,38625,104733,258221
2020-11-27,BYX Equities (Y),37905971,17774103,25454113,81134187,1332655847.014000,1034430725.298700,1195645260.584600,3562731832.897300,428391,90864,298176,817431
2020-11-27,BZX Equities (Z),130454677,61286541,147791476,339532694,5256082051.857902,3690321325.917000,6729163805.132700,15675567182.907602,1350441,309220,1125736,2785397
2020-11-25,NYSE American (A),12070026,31583566,6910470,50564062,366781731.662600,413695132.831100,334643313.937500,1115120178.431200,144484,109161,87761,341406
2020-11-25,NASDAQ BX (B),35145571,16152807,29591138,80889516,1399165947.527000,981148485.547600,1305875236.302300,3686189669.376900,444471,78187,287355,810013
2020-11-25,NYSE National (C),61292869,24579643,28247857,114120369,1424052074.856100,967145412.025000,825486503.193900,3216683990.075000,501163,116906,267583,885652
2020-11-25,FINRA / Nasdaq TRF Chicago (DB),12075649,4014576,17278862,33369087,493817975.010100,102337361.378500,737073552.178600,1333228888.567200,59038,9588,73994,142620
2020-11-25,FINRA / NYSE TRF (DN),444863498,178135358,667840639,1290839495,14465913427.778993,3642861490.456700,19357543363.499593,37466318281.735286,1930999,345147,2161909,4438055
2020-11-25,FINRA / Nasdaq TRF Carteret (DQ),1636975562,524028288,1562055254,3723059104,64384647207.182697,23797689424.717499,61232302147.614983,149414638779.515179,6489853,1203825,5642240,13335918
2020-11-25,MIAX Pearl (H),1787404,1301506,1933333,5022243,105372333.925000,95349536.885000,190808125.655000,391529996.465000,18219,5253,18371,41843
2020-11-25,EDGA Equities (J),69473191,29694475,47790667,146958333,3153381124.139500,1448958369.301500,2386429077.721800,6988768571.162800,900144,172609,597862,1670615
2020-11-25,EDGX Equities (K),328285599,108988226,354435779,791709604,11023647838.770797,4651253876.974799,12624128403.980396,28299030119.725992,2237049,435537,2028309,4700895
2020-11-25,LTSE (L),0,0,432,432,0.000000,0.000000,5925.430000,5925.430000,0,0,15,15
2020-11-25,NYSE Chicago (M),6808456,5519495,6221522,18549473,394254427.543000,737437291.162700,906837825.182500,2038529543.888200,8692,1373,7703,17768
2020-11-25,NYSE (N),965969155,41722398,62666899,1070358452,42864861574.148608,2016057946.415600,2974837656.971501,47855757177.535709,3571809,119315,428558,4119682
2020-11-25,NYSE Arca (P),314451220,278348250,367298105,960097575,12286083468.662293,15117642317.694504,15847700329.448696,43251426115.805493,2447316,853682,2612973,5913971
2020-11-25,NASDAQ (Q),501812166,154132609,947085204,1603029979,21520665751.842903,8518257490.666997,49648879605.396495,79687802847.906395,4917147,747859,6260230,11925236
2020-11-25,Members Exchange (U),36860837,8335544,26736249,71932630,767686698.022200,280854395.419900,498897118.532000,1547438211.974100,333937,26648,225693,586278
2020-11-25,Investors Exchange (V),134734715,14041018,79584978,228360711,7286675894.654801,884339258.933300,5181402639.335100,13352417792.923201,1247837,85523,812346,2145706
2020-11-25,NASDAQ PSX (X),34026527,17779816,20014987,71821330,830157959.328500,941978588.893700,1183171619.813600,2955308168.035800,192869,70870,152620,416359
2020-11-25,BYX Equities (Y),83226727,32264785,53139337,168630849,2770505282.485500,1862556588.903800,1862715570.683100,6495777442.072400,909936,163438,522631,1596005
2020-11-25,BZX Equities (Z),230590758,97855626,169814729,498261113,9377861621.035898,6280288519.819900,9003517669.878402,24661667810.734200,2336950,518166,1556580,4411696
2020-11-24,NYSE American (A),15892749,37369013,10589917,63851679,516890573.380000,596991451.195600,467553624.798900,1581435649.374500,206183,128966,127051,462200
2020-11-24,NASDAQ BX (B),43441872,22294831,33093859,98830562,1679750376.729600,1336636670.066300,1642857812.943600,4659244859.739500,530147,112627,361132,1003906
2020-11-24,NYSE National (C),81344120,31507687,41906606,154758413,1922326535.746400,1194062011.232900,1196536573.327800,4312925120.307100,657122,150977,364144,1172243
2020-11-24,FINRA / Nasdaq TRF Chicago (DB),14591359,3596831,21796360,39984550,562539217.337900,147215485.059800,800690055.960400,1510444758.358100,66933,11457,80342,158732
2020-11-24,FINRA / NYSE TRF (DN),544182607,170013692,964735422,1678931721,16381666646.278807,5012263454.016199,22228721066.119886,43622651166.414892,2361236,455381,2993249,5809866
2020-11-24,FINRA / Nasdaq TRF Carteret (DQ),2144398468,645363961,2244051424,5033813853,82275681167.778475,32477994923.136906,77752308837.997511,192505984928.912892,7899275,1609452,7223467,16732194
2020-11-24,MIAX Pearl (H),2920429,1687119,2072526,6680074,147873090.830000,140881423.520000,250273396.325000,539027910.675000,29330,6596,23134,59060
2020-11-24,EDGA Equities (J),89735429,36299796,62404858,188440083,3957719109.926800,1950156832.294000,2935512029.531000,8843387971.751800,1131084,221648,736150,2088882
2020-11-24,EDGX Equities (K),403292383,135524079,507764677,1046581139,12833740724.470492,6775073670.504801,14712790353.814204,34321604748.789497,2678463,572577,2570376,5821416
2020-11-24,LTSE (L),1100,0,4960,6060,70364.000000,0.000000,74311.010000,144675.010000,2,0,109,111
2020-11-24,NYSE Chicago (M),10116197,11161503,5902945,27180645,520244640.228800,1411596509.657000,819409842.971000,2751250992.856800,9984,2057,9016,21057
2020-11-24,NYSE (N),1202168849,49921623,92906089,1344996561,53159549614.393298,2893609057.915000,3643559848.377900,59696718520.686198,4235649,152543,540483,4928675
2020-11-24,NYSE Arca (P),397907096,317239764,530381157,1245528017,15169928986.868499,18698409395.697704,18864764858.161100,52733103240.727303,3062392,1093811,3290378,7446581
2020-11-24,NASDAQ (Q),637049321,191075873,1350050670,2178175864,26622912141.674701,12034253020.070000,61632018150.024024,100289183311.768725,6036322,976673,7873110,14886105
2020-11-24,Members Exchange (U),49224764,10313334,34024992,93563090,1011667807.972000,375188945.954100,675194979.837500,2062051733.763600,490823,36644,301689,829156
2020-11-24,Investors Exchange (V),194134032,21240186,111703119,327077337,9997976879.405098,1485975630.127900,7141934668.665798,18625887178.198796,1619104,121443,1035054,2775601
2020-11-24,NASDAQ PSX (X),42925117,22016754,26298674,91240545,1051963674.357100,1277921525.731400,1479237723.352400,3809122923.440900,254077,93045,196737,543859
2020-11-24,BYX Equities (Y),100973804,42883233,69913074,213770111,3374526173.580000,2485994066.787100,2358738070.153500,8219258310.520600,1118170,206521,630304,1954995
2020-11-24,BZX Equities (Z),305995729,125863361,229987165,661846255,12029625292.425600,8528982406.654300,10561498528.830794,31120106227.910694,3021418,648187,2044340,5713945
2020-11-23,NYSE American (A),11361775,38955552,8015438,58332765,378573633.755500,516285965.934700,411000756.178700,1305860355.868900,159259,146206,104438,409903
2020-11-23,NASDAQ BX (B),32585423,19486225,27728541,79800189,1349185840.124600,1167833066.204300,1483430189.967100,4000449096.296000,439486,100685,331956,872127
2020-11-23,NYSE National (C),65272520,29391415,30129331,124793266,1471247227.246600,1021399458.439500,1024586652.751800,3517233338.437900,548775,143746,314001,1006522
2020-11-23,FINRA / Nasdaq TRF Chicago (DB),13118761,6117550,20270151,39506462,547414838.704100,147628224.759500,809538143.049300,1504581206.512900,62326,15992,83788,162106
2020-11-23,FINRA / NYSE TRF (DN),469527976,191118831,841979434,1502626241,15268562110.108000,5376863360.074801,23555120663.945512,44200546134.128313,2122391,482535,2921513,5526439
2020-11-23,FINRA / Nasdaq TRF Carteret (DQ),1683384242,568297608,1916189078,4167870928,66899117567.336794,26840946831.879095,73759140435.498325,167499204834.714214,6461487,1630149,6520158,14611794
2020-11-23,MIAX Pearl (H),2677503,1743657,2484199,6905359,132050331.990000,87154903.178100,244966762.290900,464171997.459000,26089,6212,25668,57969
2020-11-23,EDGA Equities (J),71929332,35865090,54366579,162161001,3147597109.790900,1802702270.170500,2713768673.115300,7664068053.076700,920289,202595,669997,1792881
2020-11-23,EDGX Equities (K),340148847,148870838,461927039,950946724,11339833238.314296,6032839124.653703,15086370588.973496,32459042951.941495,2291186,635677,2476797,5403660
2020-11-23,LTSE (L),93,0,100,193,2310.120000,0.000000,1491.040000,3801.160000,7,0,3,10
2020-11-23,NYSE Chicago (M),9616765,10452411,8342781,28411957,677310201.253300,1296742851.799400,2942489520.722100,4916542573.774800,7371,1073,9878,18322
2020-11-23,NYSE (N),986816416,47587479,76221753,1110625648,42567878448.039503,2391767792.154800,3520598609.850001,48480244850.044304,3559056,143289,490341,4192686
2020-11-23,NYSE Arca (P),309611385,311660170,472311599,1093583154,12350467672.276705,15882949368.730396,18009738464.250893,46243155505.257994,2452190,1092862,2912029,6457081
2020-11-23,NASDAQ (Q),505737506,189523423,1118725403,1813986332,21182610999.701890,10511065925.205405,56111191704.112305,87804868629.019600,4908468,987684,7308460,13204612
2020-11-23,Members Exchange (U),43249283,10401732,36457394,90108409,901186058.005200,324231877.290200,618086270.256400,1843504205.551800,439422,40930,298754,779106
2020-11-23,Investors Exchange (V),155958037,19672705,106661852,282292594,8240214838.439700,1056585886.088500,7176841990.826798,16473642715.354998,1392972,108065,1011546,2512583
2020-11-23,NASDAQ PSX (X),33411114,19135124,22893300,75439538,863455530.451800,1022636459.767500,1281913079.371400,3168005069.590700,193926,73867,174590,442383
2020-11-23,BYX Equities (Y),84429612,42920526,67215760,194565898,2787457801.144199,2293489367.630500,2261709421.564599,7342656590.339298,937736,210700,585411,1733847
2020-11-23,BZX Equities (Z),238715603,118242047,201332007,558289657,9410961409.397402,7360448716.749302,10373859893.466807,27145270019.613511,2333684,589421,1800098,4723203
2020-11-20,NYSE American (A),9835639,25401806,7919261,43156706,341212191.875200,414529833.444600,398556436.919500,1154298462.239300,149540,84660,107824,342024
2020-11-20,NASDAQ BX (B),29046293,15277285,26301175,70624753,1191874816.901500,932845975.648800,1379925119.886300,3504645912.436600,395462,73834,320771,790067
2020-11-20,NYSE National (C),55004736,22885825,27335250,105225811,1274718244.831100,876528235.107400,915259259.668100,3066505739.606600,493462,113895,289573,896930
2020-11-20,FINRA / Nasdaq TRF Chicago (DB),9603777,2432680,17474630,29511087,430943336.384100,108833269.727500,701287847.637500,1241064453.749100,47583,7174,69653,124410
2020-11-20,FINRA / NYSE TRF (DN),362144523,125784888,884837072,1372766483,12972781999.306197,5054518453.844899,19109848626.978894,37137149080.129990,1656861,277242,2364221,4298324
2020-11-20,FINRA / Nasdaq TRF Carteret (DQ),1335886002,416003476,1787891373,3539780851,55148553754.985618,29679925032.298328,62822008031.104005,147650486818.387951,5565137,1015424,5551366,12131927
2020-11-20,MIAX Pearl (H),2014413,973524,1937404,4925341,125526720.345000,59309636.375400,213610652.614300,398447009.334700,22658,3570,19790,46018
2020-11-20,EDGA Equities (J),58613259,26825943,51936672,137375874,2827526557.031100,1524619485.843900,2537505871.993100,6889651914.868100,809047,160334,624785,1594166
2020-11-20,EDGX Equities (K),285872476,86051543,480160129,852084148,10655045168.609202,4690295620.727999,13444499770.265401,28789840559.602602,2096792,386754,2366172,4849718
2020-11-20,NYSE Chicago (M),13139924,16739358,6815577,36694859,953628659.407400,1940015712.588400,1501414346.506200,4395058718.502000,8785,1256,7893,17934
2020-11-20,NYSE (N),951506586,34083878,76210818,1061801282,45582634617.472698,1962230542.960800,3139536966.358600,50684402126.792098,3275737,105966,487749,3869452
2020-11-20,NYSE Arca (P),220574985,213965738,397637543,832178266,9858862647.474600,13669580360.022288,13129306575.693888,36657749583.190776,2021297,717824,2476136,5215257
2020-11-20,NASDAQ (Q),447725556,134066489,1181243627,1763035672,20693301970.382699,8872815400.001497,56295026799.376758,85861144169.760954,4803113,707758,6901578,12412449
2020-11-20,Members Exchange (U),34679412,6008828,28445476,69133716,780903746.043200,277003025.197400,529546134.656500,1587452905.897100,380001,23965,270378,674344
2020-11-20,Investors Exchange (V),128457743,13957344,91538442,233953529,7286880281.165901,1032394623.395900,6169719795.149297,14488994699.711098,1294870,81127,953722,2329719
2020-11-20,NASDAQ PSX (X),25810657,14620732,20297077,60728466,763237306.726600,775974235.811000,1072433012.568600,2611644555.106200,181284,60037,161861,403182
2020-11-20,BYX Equities (Y),70064696,30882495,59772004,160719195,2363879037.786600,1801079774.211700,2063081838.795300,6228040650.793600,810454,152872,570706,1534032
2020-11-20,BZX Equities (Z),196395060,82960872,203216740,482572672,8749655662.918499,5713039397.149197,9257946567.186900,23720641627.254596,2162723,439583,1689982,4292288
2020-11-19,NYSE American (A),11364408,22647540,7638093,41650041,383899353.919600,441060198.948900,406047380.204000,1231006933.072500,184344,81565,116230,382139
2020-11-19,NASDAQ BX (B),32642742,17465164,30719310,80827216,1313486153.767300,1091988685.793500,1427199178.995899,3832674018.556699,421666,82267,300833,804766
2020-11-19,NYSE National (C),58394301,24146170,26099272,108639743,1366466441.383900,971206504.716600,863446646.134700,3201119592.235200,521718,125966,276205,923889
2020-11-19,FINRA / Nasdaq TRF Chicago (DB),9697986,2557445,21535219,33790650,429981820.606500,98015929.211500,844578260.080900,1372576009.898900,47531,7565,72133,127229
2020-11-19,FINRA / NYSE TRF (DN),344776769,136499266,801631371,1282907406,11783051892.084394,4391550735.858400,19733404828.595104,35908007456.537898,1569723,285504,2134101,3989328
2020-11-19,FINRA / Nasdaq TRF Carteret (DQ),1405553791,453816227,1808247715,3667617733,57866273480.359492,25550294498.216599,69255114372.293988,152671682350.870079,5825481,1090973,5512357,12428811
2020-11-19,MIAX Pearl (H),1668211,697505,1560225,3925941,78197866.095000,65152011.994700,166577360.651300,309927238.741000,17813,2943,17630,38386
2020-11-19,EDGA Equities (J),63942540,31372230,60515089,155829859,2840297270.803200,1600798813.094800,2473115007.915199,6914211091.813199,843230,178074,612786,1634090
2020-11-19,EDGX Equities (K),288924234,101935888,454109663,844969785,9798039572.594197,5198237511.080898,13175998095.006601,28172275178.681696,2097254,424473,2104138,4625865
2020-11-19,NYSE Chicago (M),17992364,5705245,7272535,30970144,1146263733.018700,957199333.830000,1481375881.197200,3584838948.045900,10962,924,10064,21950
2020-11-19,NYSE (N),891590717,44970136,101210396,1037771249,40079366457.299597,2194435165.796900,3128763032.486300,45402564655.582797,3426762,121207,482273,4030242
2020-11-19,NYSE Arca (P),269521158,235503860,509730480,1014755498,11002738643.303204,14513471568.013806,16878942015.391089,42395152226.708099,2282068,810122,2658897,5751087
2020-11-19,NASDAQ (Q),477773331,147650455,1143079604,1768503390,21051882763.853102,10015933383.262700,52802841546.678923,83870657693.794725,5086284,806731,6671098,12564113
2020-11-19,Members Exchange (U),41174775,6715427,31563152,79453354,882570274.625100,273792837.755000,588439477.209800,1744802589.589900,440816,24768,273290,738874
2020-11-19,Investors Exchange (V),132316486,13971762,89814938,236103186,7610607789.157800,1087943327.430900,6126394544.152206,14824945660.740906,1328362,88041,927428,2343831
2020-11-19,NASDAQ PSX (X),30418830,16314118,22146344,68879292,807274488.028600,920152725.140500,1288561791.101100,3015989004.270200,189304,63162,164016,416482
2020-11-19,BYX Equities (Y),72917791,34043788,51638369,158599948,2494380411.169300,1948723428.957700,2024046371.865500,6467150211.992500,852894,155314,539664,1547872
2020-11-19,BZX Equities (Z),212706013,97515721,216685021,526906755,8598108014.159702,6448056021.154299,9170729943.935698,24216893979.249699,2273272,498931,1657665,4429868
2020-11-18,NYSE American (A),12657091,26170512,8070287,46897890,384612972.301000,481235907.127400,376272325.035800,1242121204.464200,154880,90934,95138,340952
2020-11-18,NASDAQ BX (B),35747857,17224031,35985079,88956967,1445968095.256500,1129811000.599200,1465843911.431500,4041623007.287200,442412,88153,303749,834314
2020-11-18,NYSE National (C),68122404,30201476,40975233,139299113,1417850599.797400,1070793802.686400,856779484.949300,3345423887.433100,532065,137288,289341,958694
2020-11-18,FINRA / Nasdaq TRF Chicago (DB),21509286,6927327,29363612,57800225,1015279689.928400,564457828.972300,1457681411.651500,3037418930.552200,119902,27577,127173,274652
2020-11-18,FINRA / NYSE TRF (DN),454379039,148487137,678050758,1280916934,15012933400.053298,5709281039.383496,20582822326.192495,41305036765.629289,2010105,332168,2165982,4508255
2020-11-18,FINRA / Nasdaq TRF Carteret (DQ),1806187005,500658540,1654602327,3961447872,69785530811.355084,27392755334.739604,70764724507.123098,167943010653.217786,6759504,1207520,5456357,13423381
2020-11-18,MIAX Pearl (H),938738,872805,1029876,2841419,61866820.550000,86763908.144400,153572770.684200,302203499.378600,9178,4089,11914,25181
2020-11-18,EDGA Equities (J),71541815,33227646,51654848,156424309,3031763327.273100,1737252889.922400,2581953957.067600,7350970174.263100,908378,191044,608082,1707504
2020-11-18,EDGX Equities (K),349618097,110144448,372125001,831887546,11475694773.093502,5899203648.332800,13075462746.175203,30450361167.601505,2393909,484668,2017572,4896149
2020-11-18,LTSE (L),100,0,0,100,2186.000000,0.000000,0.000000,2186.000000,1,0,0,1
2020-11-18,NYSE Chicago (M),11035562,8437441,7488048,26961051,853363399.379400,613113295.660000,1193475236.296800,2659951931.336200,9441,662,9995,20098
2020-11-18,NYSE (N),989752438,48651944,72545200,1110949582,42824177521.384906,2373012780.493099,3063814022.445700,48261004324.323705,3637959,133500,430060,4201519
2020-11-18,NYSE Arca (P),337913876,268131929,359319349,965365154,13086981819.405998,16624732652.558609,17558291591.641006,47270006063.605613,2601157,910481,2536880,6048518
2020-11-18,NASDAQ (Q),548911067,168202977,1017211809,1734325853,22982630400.759403,11534598808.582401,55218503727.451008,89735732936.792812,5454161,894865,6778279,13127305
2020-11-18,Members Exchange (U),44552991,8119419,24633820,77306230,909607426.062200,355477381.113300,496418249.501700,1761503056.677200,440985,29430,226225,696640
2020-11-18,Investors Exchange (V),171620917,15849389,101740742,289211048,9186062290.797101,1224591696.466700,6689682478.380702,17100336465.644503,1507800,101456,971267,2580523
2020-11-18,NASDAQ PSX (X),34215676,18660208,21382248,74258132,798273235.836900,1071960510.121900,1368800316.524900,3239034062.483700,188285,76375,161243,425903
2020-11-18,BYX Equities (Y),81947394,41738572,54857706,178543672,2646354394.147000,2087968326.352300,2132853817.875200,6867176538.374500,910306,175376,529906,1615588
2020-11-18,BZX Equities (Z),244168453,106385760,200392202,550946415,9471235048.325601,7117172735.687804,9367306644.795696,25955714428.809101,2463414,551379,1632139,4646932
2020-11-17,NYSE American (A),11066305,25908586,6596755,43571646,316780014.159600,422153565.666000,350302756.342100,1089236336.167700,142830,85574,92821,321225
2020-11-17,NASDAQ BX (B),34904685,17156568,28459744,80520997,1381451935.914500,1131857880.301500,1330046257.813199,3843356074.029199,448229,87719,307732,843680
2020-11-17,NYSE National (C),66828469,27339761,27172100,121340330,1403372946.880000,1062296833.466400,824804494.249300,3290474274.595700,548641,130212,283871,962724
2020-11-17,FINRA / Nasdaq TRF Chicago (DB),18620212,9070399,21266269,48956880,887168570.916900,531166096.064900,1116486559.214599,2534821226.196399,109190,29619,122950,261759
2020-11-17,FINRA / NYSE TRF (DN),392614892,202201308,553324884,1148141084,13673527381.228810,5551715143.690303,17813797604.385705,37039040129.304818,1775093,328070,2042971,4146134
2020-11-17,FINRA / Nasdaq TRF Carteret (DQ),1604423045,557438195,1489697480,3651558720,63041074552.867711,28517746404.448188,62489346787.769019,154048167745.084918,6294381,1231916,5374961,12901258
2020-11-17,MIAX Pearl (H),1847843,897530,1711623,4456996,79410688.120000,104214807.027300,124709252.738800,308334747.886100,19081,4848,19447,43376
2020-11-17,EDGA Equities (J),67209652,32166861,46895044,146271557,2899968654.431300,1615227351.506400,2341627914.147600,6856823920.085300,868969,183236,617059,1669264
2020-11-17,EDGX Equities (K),311872174,110541096,312698909,735112179,10544016394.383198,5477155685.673701,12209545571.565404,28230717651.622303,2179020,453491,1981242,4613753
2020-11-17,NYSE Chicago (M),11837722,10790155,5188845,27816722,808404627.559600,1355906165.810000,1303921056.925200,3468231850.294800,9456,1081,9324,19861
2020-11-17,NYSE (N),954611424,49193650,59626950,1063432024,43307075504.537205,2157910758.476000,2926510059.992700,48391496323.005905,3589121,118557,399014,4106692
2020-11-17,NYSE Arca (P),297026266,265435708,319050490,881512464,12055536551.694201,15183915772.377996,15583022692.681191,42822475016.753388,2386058,844964,2464868,5695890
2020-11-17,NASDAQ (Q),515571255,177105597,920312630,1612989482,23294807021.915998,10592863288.589496,52378363838.291225,86266034148.796719,5371993,828944,6569929,12770866
2020-11-17,Members Exchange (U),38457023,6252810,28127500,72837333,799988063.382000,326015988.662200,514033068.975900,1640037121.020100,381193,23694,247482,652369
2020-11-17,Investors Exchange (V),158065922,16232490,101235441,275533853,8739780245.089802,1144952975.946000,6497578665.507902,16382311886.543704,1467491,93302,988560,2549353
2020-11-17,NASDAQ PSX (X),27808962,16414276,17367277,61590515,713285589.009300,972528505.759500,1024363145.648200,2710177240.417000,169127,68057,137059,374243
2020-11-17,BYX Equities (Y),78952214,43003235,52844520,174799969,2480225466.290400,2182837964.454099,2040843185.558600,6703906616.303099,875565,166768,533190,1575523
2020-11-17,BZX Equities (Z),220470233,107645287,153453611,481569131,8743426888.377599,6976006400.733197,8629802531.098997,24349235820.209793,2279479,527094,1544856,4351429
2020-11-16,NYSE American (A),11650824,22727716,7389391,41767931,372802629.522600,515860621.921400,385813438.540700,1274476689.984700,145121,91734,94856,331711
2020-11-16,NASDAQ BX (B),36363640,18860072,24278418,79502130,1445519622.649800,1200835009.871900,1347115529.133300,3993470161.655000,451755,93365,299193,844313
2020-11-16,NYSE National (C),73783886,32141641,28505114,134430641,1590160734.516600,1267126348.762000,913365550.856800,3770652634.135400,579631,145617,286207,1011455
2020-11-16,FINRA / Nasdaq TRF Chicago (DB),21185273,7281262,21909813,50376348,1029477275.217100,489950429.909400,972241710.364499,2491669415.490999,130131,30728,114011,274870
2020-11-16,FINRA / NYSE TRF (DN),416644895,143745665,518281400,1078671960,13771047991.837002,4342265361.233298,16396335231.020102,34509648584.090402,1889841,347344,2081649,4318834
2020-11-16,FINRA / Nasdaq TRF Carteret (DQ),1740646867,563604777,1451640483,3755892127,68696735204.276400,31891574318.126303,63248685592.324022,163836995114.726725,6740804,1295171,5554702,13590677
2020-11-16,MIAX Pearl (H),2136185,784342,1573242,4493769,92545934.206400,80098212.961500,92273652.922900,264917800.090800,21061,3657,16724,41442
2020-11-16,EDGA Equities (J),74405525,33872229,46790779,155068533,3218469029.109300,1878754160.498500,2499208026.163000,7596431215.770800,936797,199679,621909,1758385
2020-11-16,EDGX Equities (K),331873831,108156420,305496916,745527167,10918378191.168103,6326463532.323599,11963639873.268002,29208481596.759704,2270183,488587,1967901,4726671
2020-11-16,NYSE Chicago (M),8669192,14267920,9703479,32640591,623339850.055000,1290208013.725000,1847785958.374600,3761333822.154600,11021,1580,12482,25083
2020-11-16,NYSE (N),1084473483,44739750,58770384,1187983617,48851767507.758807,2628171883.178300,3057080374.673700,54537019765.610807,3734651,133637,409105,4277393
2020-11-16,NYSE Arca (P),340616414,297081755,347545668,985243837,13191909461.218605,20539638069.870795,18389029846.326800,52120577377.416200,2577184,992177,2703318,6272679
2020-11-16,NASDAQ (Q),571034574,171645774,987014430,1729694778,24435037622.069003,12470232118.622300,56100234978.311000,93005504719.002303,5517149,905940,6744899,13167988
2020-11-16,Members Exchange (U),38457905,5183337,23135659,66776901,764579155.253300,235577851.580000,463726420.644000,1463883427.477300,376648,19005,222418,618071
2020-11-16,Investors Exchange (V),168814374,16470359,106051505,291336238,9552127462.358000,1172091072.329600,7341467391.030601,18065685925.718201,1532858,99316,1033171,2665345
2020-11-16,NASDAQ PSX (X),31823982,18087995,19649782,69561759,825072746.014800,1039320187.388500,1035484303.354500,2899877236.757800,188941,73990,146146,409077
2020-11-16,BYX Equities (Y),85357915,37932769,49125527,172416211,2820903903.269600,2221591192.999400,2119756605.558900,7162251701.827900,937098,172946,550246,1660290
2020-11-16,BZX Equities (Z),257577530,114222782,165709229,537509541,9893593864.990001,8206617989.365801,9067902197.500206,27168114051.856008,2483674,583205,1656555,4723434
2020-11-13,NYSE American (A),10371489,22954357,5593380,38919226,320639099.951800,385962495.415500,282679905.519300,989281500.886600,133721,78483,77900,290104
2020-11-13,NASDAQ BX (B),35344717,23799471,23593024,82737212,1387789044.486600,1089274814.853600,1270171611.661600,3747235471.001800,451046,81805,300341,833192
2020-11-13,NYSE National (C),63505101,26660012,25423052,115588165,1396390421.453200,1000613306.816200,828311294.588800,3225315022.858200,549845,131685,275365,956895
2020-11-13,FINRA / Nasdaq TRF Chicago (DB),19048254,8160313,21436748,48645315,926247475.104000,469416755.218700,985170980.308400,2380835210.631100,121825,26909,127312,276046
2020-11-13,FINRA / NYSE TRF (DN),388017305,152073205,462200904,1002291414,13401098845.717901,3348892267.189201,15026875153.988507,31776866266.895609,1883274,292614,1891053,4066941
2020-11-13,FINRA / Nasdaq TRF Carteret (DQ),1622808209,510914766,1309309701,3443032676,61570121166.814599,25782684112.645802,54979779203.523007,142332584482.983408,6092093,1076231,4908161,12076485
2020-11-13,MIAX Pearl (H),1238850,743993,818655,2801498,61360137.673600,81521680.103800,75461202.979500,218343020.756900,13445,3965,10186,27596
2020-11-13,EDGA Equities (J),67911830,33998641,42958705,144869176,2882692380.174101,1718064937.236800,2185944864.359900,6786702181.770801,865621,188258,590910,1644789
2020-11-13,EDGX Equities (K),319196229,120025617,281826449,721048295,11084859994.044702,5598346693.269900,11261449878.014406,27944656565.329008,2170697,454121,1863816,4488634
2020-11-13,LTSE (L),0,0,671,671,0.000000,0.000000,4146.610000,4146.610000,0,0,8,8
2020-11-13,NYSE Chicago (M),9105509,8407648,5818458,23331615,452645771.109000,1228092027.112400,732103220.575500,2412841018.796900,9683,2072,9374,21129
2020-11-13,NYSE (N),887004960,41251743,51613471,979870174,39072229989.118805,2242048666.687500,2982067486.321801,44296346142.128106,3233888,119353,395954,3749195
2020-11-13,NYSE Arca (P),285797707,271048744,277170771,834017222,11578156018.634304,14480548049.179594,13879166962.547701,39937871030.361599,2199163,805747,2241520,5246430
2020-11-13,NASDAQ (Q),513682159,167696414,832130307,1513508880,22289227470.422504,10113812372.495001,46781840059.886375,79184879902.803880,5045936,784940,6161579,11992455
2020-11-13,Members Exchange (U),31056499,5188264,18244956,54489719,588350276.205500,208177677.600000,395914712.055000,1192442665.860500,276631,16763,177021,470415
2020-11-13,Investors Exchange (V),149057220,16274161,93239023,258570404,8359331972.229702,1100158508.750900,6470883592.607401,15930374073.588003,1372689,93340,961724,2427753
2020-11-13,NASDAQ PSX (X),27501550,16472035,16778603,60752188,641145960.627900,787963187.795400,1023744548.186400,2452853696.609700,154227,62779,125320,342326
2020-11-13,BYX Equities (Y),76808016,37416040,46085623,160309679,2545780901.625600,2068534718.613600,1831362507.552300,6445678127.791500,847559,169924,487505,1504988
2020-11-13,BZX Equities (Z),212133841,104058103,139990871,456182815,8134000173.560100,6794103717.338401,8521414082.885797,23449517973.784298,2051169,501321,1480517,4033007
2020-11-12,NYSE American (A),11654217,19712425,7391744,38758386,365853689.098000,520243360.341000,404494662.210500,1290591711.649500,175983,85229,110963,372175
2020-11-12,NASDAQ BX (B),33899744,19502446,25785571,79187761,1347249025.184400,1169334460.194900,1496850918.579300,4013434403.958600,490788,90821,342777,924386
2020-11-12,NYSE National (C),65080160,29778498,27757447,122616105,1453643547.477900,1103294919.083400,970378069.482200,3527316536.043500,594030,154197,304176,1052403
2020-11-12,FINRA / Nasdaq TRF Chicago (DB),20668712,8288797,20569559,49527068,993735148.850800,441543338.102500,1022442863.221300,2457721350.174600,118680,28518,110952,258150
2020-11-12,FINRA / NYSE TRF (DN),381124963,119442703,507259404,1007827070,12934417346.835707,4132748409.201200,17167785456.223082,34234951212.259989,1720028,302710,1802702,3825440
2020-11-12,FINRA / Nasdaq TRF Carteret (DQ),1596635203,506672561,1335345148,3438652912,59545692724.645411,28964769901.508294,59895598837.715683,148406061463.869388,6060523,1163254,4930917,12154694
2020-11-12,MIAX Pearl (H),1298308,1276263,944587,3519158,65993903.555000,105451491.163500,81154572.125100,252599966.843600,14539,4021,12153,30713
2020-11-12,EDGA Equities (J),69356196,37272605,46510472,153139273,3021949884.060200,1864625013.885400,2561573864.470600,7448148762.416200,893718,207596,605175,1706489
2020-11-12,EDGX Equities (K),320793183,118727765,304019007,743539955,10852788864.268499,6904149452.660500,12640604928.552311,30397543245.481310,2253473,559839,1965395,4778707
2020-11-12,LTSE (L),0,300,0,300,0.000000,6591.000000,0.000000,6591.000000,0,3,0,3
2020-11-12,NYSE Chicago (M),14084554,8773575,5858888,28717017,694718541.847200,1020444328.433800,1638998201.319500,3354161071.600500,9814,1031,10713,21558
2020-11-12,NYSE (N),1043772952,52453705,57491922,1153718579,42326916506.786995,2963108389.936400,3345584761.710700,48635609658.434095,3538313,163672,436674,4138659
2020-11-12,NYSE Arca (P),299297420,299347115,307894079,906538614,12010409297.574796,18930334166.652895,15809112808.446201,46749856272.673892,2389086,1011936,2433488,5834510
2020-11-12,NASDAQ (Q),529688835,188179291,887498869,1605366995,22756874694.576503,13024961370.452494,49539330227.264421,85321166292.293418,5279279,1029753,6384811,12693843
2020-11-12,Members Exchange (U),31681640,5446793,18524222,55652655,675277180.870300,233418681.764400,416668137.985800,1325364000.620500,261595,18183,159419,439197
2020-11-12,Investors Exchange (V),156745702,16468216,97712232,270926150,8221431336.869800,1151468249.566400,7043008406.914499,16415907993.350699,1435426,95722,969636,2500784
2020-11-12,NASDAQ PSX (X),30964600,21394916,20342152,72701668,806009225.300600,1035851886.597900,1160119636.143400,3001980748.041900,190022,81744,156904,428670
2020-11-12,BYX Equities (Y),80868520,40194197,56348645,177411362,2613846134.725900,2493976155.154500,2268359926.863700,7376182216.744100,918124,191586,557926,1667636
2020-11-12,BZX Equities (Z),222052985,129237134,159417130,510707249,8505378723.297000,8776045574.193196,9406002706.404300,26687427003.894496,2214803,666327,1579283,4460413
2020-11-11,NYSE American (A),13836981,18539547,7532582,39909110,458631770.047100,435569592.109200,402748054.592000,1296949416.748300,184933,82786,110277,377996
2020-11-11,NASDAQ BX (B),39029118,18295642,26194529,83519289,1568588803.444600,1154192569.045200,1413521124.981800,4136302497.471600,507324,90435,343660,941419
2020-11-11,NYSE National (C),69970282,27991080,26926478,124887840,1549268362.769600,1070006310.514100,876182809.167400,3495457482.451100,590238,151640,298691,1040569
2020-11-11,FINRA / Nasdaq TRF Chicago (DB),18090816,6021675,19595278,43707769,931030658.618800,434041880.995200,948929953.184000,2314002492.798000,110567,26099,104914,241580
2020-11-11,FINRA / NYSE TRF (DN),345653367,95152421,467562694,908368482,11391987621.648997,4138553642.951896,16810441519.104290,32340982783.705183,1519758,270259,1654195,3444212
2020-11-11,FINRA / Nasdaq TRF Carteret (DQ),1498668779,417063934,1327667227,3243399940,61592089831.891495,24254644446.226990,62186414274.395595,148033148552.514080,5839950,1079617,4860740,11780307
2020-11-11,MIAX Pearl (H),1511972,1194269,924811,3631052,78575462.110000,168580471.195100,92661618.904000,339817552.209100,17039,4964,12230,34233
2020-11-11,EDGA Equities (J),73117360,32977144,47716997,153811501,3222770249.793700,1583906199.456600,2615702787.334500,7422379236.584800,946215,191118,645950,1783283
2020-11-11,EDGX Equities (K),316695453,98021765,291108660,705825878,10613251291.432802,5697764573.583403,12111242243.639098,28422258108.655303,2204104,467633,1894405,4566142
2020-11-11,LTSE (L),0,0,2,2,0.000000,0.000000,220.020000,220.020000,0,0,1,1
2020-11-11,NYSE Chicago (M),11637336,6354587,6753345,24745268,649049237.420100,960520522.748000,1005141747.578000,2614711507.746100,9986,1126,11200,22312
2020-11-11,NYSE (N),925449349,40475628,59751670,1025676647,40724121456.784494,2264670591.963500,3227700114.902201,46216492163.650195,3482554,131186,438298,4052038
2020-11-11,NYSE Arca (P),260378489,245418783,351916097,857713369,10673209686.338396,15554667718.843289,16713568030.265597,42941445435.447282,2270540,904721,2577581,5752842
2020-11-11,NASDAQ (Q),524413381,161040450,871809215,1557263046,23298855701.381391,10541725745.668699,52494376377.215206,86334957824.265296,5363145,880181,6570341,12813667
2020-11-11,Members Exchange (U),32858320,4250930,19469483,56578733,663637669.829900,215615955.325000,414089598.916900,1293343224.071800,282442,18790,160947,462179
2020-11-11,Investors Exchange (V),161375762,16594981,102917535,280888278,9271351481.500301,1022683610.819700,7431381378.049400,17725416470.369401,1495189,102340,1038346,2635875
2020-11-11,NASDAQ PSX (X),32462623,18825231,20551437,71839291,846954275.950700,1010353646.803800,1144669902.656900,3001977825.411400,210791,76409,159765,446965
2020-11-11,BYX Equities (Y),81789894,35560886,46239955,163590735,2736360846.582400,2058171529.645700,2188144437.562901,6982676813.791001,926244,175683,569972,1671899
2020-11-11,BZX Equities (Z),228624845,108529274,160048797,497202916,8938834107.654998,7186113632.383599,9546286195.925499,25671233935.964096,2330632,568092,1638234,4536958
2020-11-10,NYSE American (A),17654740,23388897,11117272,52160909,613865795.839500,667560934.202800,675797742.620500,1957224472.662800,216746,114184,146305,477235
2020-11-10,NASDAQ BX (B),52039642,25272281,37502581,114814504,2357348987.604400,1670649716.744100,2286456997.514099,6314455701.862599,653856,120833,454297,1228986
2020-11-10,NYSE National (C),93691074,42523661,37716577,173931312,2106835928.463500,1551285290.181400,1336001063.368000,4994122282.012900,711274,196033,361912,1269219
2020-11-10,FINRA / Nasdaq TRF Chicago (DB),24897878,7525658,25393507,57817043,1264035035.093200,571154932.299600,1401449256.011700,3236639223.404500,142012,34032,140335,316379
2020-11-10,FINRA / NYSE TRF (DN),418720161,127078395,540156103,1085954659,13923943638.455598,5132452718.840699,21193821523.601395,40250217880.897692,2047208,347310,2171132,4565650
2020-11-10,FINRA / Nasdaq TRF Carteret (DQ),1857701120,559158030,1574763710,3991622860,78244288058.239677,35970173744.344207,82894117235.047239,197108579037.631123,7382868,1403547,6155557,14941972
2020-11-10,MIAX Pearl (H),1206206,1311056,866077,3383339,93671411.360000,183247720.147500,129445442.094200,406364573.601700,13228,5359,10862,29449
2020-11-10,EDGA Equities (J),99408908,54406570,66735775,220551253,4409763791.165399,2566925493.904100,3895610338.756400,10872299623.825899,1162872,298186,797684,2258742
2020-11-10,EDGX Equities (K),412686834,133327902,353645141,899659877,14592528950.618999,8541826163.557803,16648667863.114695,39783022977.291497,2831858,657017,2433089,5921964
2020-11-10,LTSE (L),0,22172,0,22172,0.000000,435000.110000,0.000000,435000.110000,0,58,0,58
2020-11-10,NYSE Chicago (M),12998575,12796993,12014295,37809863,607079046.220300,1398611128.973900,2527162502.862900,4532852678.057100,11713,812,12537,25062
2020-11-10,NYSE (N),1222487037,64973931,82922752,1370383720,55240274100.111815,3884439447.543600,5028389154.824897,64153102702.480312,4687873,224184,581159,5493216
2020-11-10,NYSE Arca (P),361060155,364966493,412059319,1138085967,15323102073.298305,23420002060.556802,24714144229.986008,63457248363.841115,2995051,1321496,3324593,7641140
2020-11-10,NASDAQ (Q),724680253,241402611,1120249694,2086332558,33492424216.225008,17123212374.873801,73495369032.391500,124111005623.490309,7088759,1382633,8794982,17266374
2020-11-10,Members Exchange (U),37877368,4787031,21098621,63763020,707824382.405000,209531472.144200,423742425.143300,1341098279.692500,310668,14190,171414,496272
2020-11-10,Investors Exchange (V),223879461,23443198,132116936,379439595,13429587095.054498,1449044406.867800,11015555753.259598,25894187255.181896,1931363,128058,1272012,3331433
2020-11-10,NASDAQ PSX (X),43125863,28586669,30213800,101926332,1263876159.023500,1576744125.964500,2011034596.092500,4851654881.080500,278197,122105,246235,646537
2020-11-10,BYX Equities (Y),114348177,50870892,63236111,228455180,3864498303.498700,3223062074.680399,3242814437.746599,10330374815.925698,1228914,251961,725858,2206733
2020-11-10,BZX Equities (Z),319009851,170119497,214756511,703885859,12945382681.283700,11995922564.030197,13891242121.928600,38832547367.242497,3219956,909821,2416434,6546211
2020-11-09,NYSE American (A),23020476,36519949,13842581,73383006,863491007.943100,1144351645.294900,878671949.542700,2886514602.780700,271831,162045,172625,606501
2020-11-09,NASDAQ BX (B),64272323,38442102,41855764,144570189,2672835999.567300,2858599964.748701,2875191392.254699,8406627356.570700,777129,185667,503331,1466127
2020-11-09,NYSE National (C),112956359,64556955,43409569,220922883,2541571018.671300,2318315713.653400,1648666250.405700,6508552982.730400,873980,288713,409552,1572245
2020-11-09,FINRA / Nasdaq TRF Chicago (DB),40752349,13332182,28065665,82150196,1865968289.682400,840112701.631000,1515624837.848201,4221705829.161601,231539,51695,161521,444755
2020-11-09,FINRA / NYSE TRF (DN),596874903,167812796,592423677,1357111376,16777185555.717395,6353795463.412101,22268124497.678289,45399105516.807785,2949864,497359,2542057,5989280
2020-11-09,FINRA / Nasdaq TRF Carteret (DQ),2518481182,766075441,1805585494,5090142117,98736858517.195383,53289148038.199100,98637708084.928368,250663714640.322851,10339416,1936741,7026064,19302221
2020-11-09,MIAX Pearl (H),694462,1727220,716459,3138141,93316882.315000,234887383.043500,157864232.130400,486068497.488900,7876,6079,9389,23344
2020-11-09,EDGA Equities (J),130503099,75046500,86081426,291631025,5653635660.141000,3825590410.342700,4548485055.508801,14027711125.992501,1551905,406795,945446,2904146
2020-11-09,EDGX Equities (K),660369213,234027229,465430432,1359826874,21084526263.675596,15662836110.156491,21141912423.579402,57889274797.411489,4322726,1090607,2910457,8323790
2020-11-09,NYSE Chicago (M),9259032,9533730,13480035,32272797,1049287830.142300,1047774509.420000,2024296005.006100,4121358344.568400,11666,2005,12352,26023
2020-11-09,NYSE (N),1710518153,103631602,103050562,1917200317,73429781990.542502,6194639262.444800,5847496484.751899,85471917737.739201,6496950,327065,707508,7531523
2020-11-09,NYSE Arca (P),605899015,590046350,595347153,1791292518,23836207594.285794,38833516181.404375,33047300369.122205,95717024144.812374,4601869,2132959,4140498,10875326
2020-11-09,NASDAQ (Q),1083750183,386253486,1517020649,2987024318,46935845785.797588,29251776189.824190,93671200259.262372,169858822234.884150,9868430,2137875,10786532,22792837
2020-11-09,Members Exchange (U),14962817,6676586,9969760,31609163,230711000.013100,253967292.953100,182444753.555200,667123046.521400,97460,18174,54721,170355
2020-11-09,Investors Exchange (V),294452338,31207343,158976128,484635809,16602967602.216097,1930423595.330800,12486256625.421703,31019647822.968600,2415068,168480,1458236,4041784
2020-11-09,NASDAQ PSX (X),58663224,39723338,33790389,132176951,1832512608.183200,2255627319.934399,2402051370.513200,6490191298.630799,354979,171555,260171,786705
2020-11-09,BYX Equities (Y),154337589,78589790,71965490,304892869,4810090911.488000,5306990799.097099,3870786675.196199,13987868385.781298,1578646,389241,800544,2768431
2020-11-09,BZX Equities (Z),490747402,272874701,282898286,1046520389,19580658887.302202,21285451828.729486,17486100789.131691,58352211505.163379,4793750,1453159,3041650,9288559
2020-11-06,NYSE American (A),12363324,21128193,8417312,41908829,390478413.443800,533248330.978400,429654822.007500,1353381566.429700,168489,92856,113414,374759
2020-11-06,NASDAQ BX (B),36898955,19261420,31819318,87979693,1329038886.653900,1052548681.677600,1424699967.655400,3806287535.986900,465803,130388,330131,926322
2020-11-06,NYSE National (C),62028579,31065881,30593700,123688160,1231841188.004900,1133937084.380400,926622670.053400,3292400942.438700,526992,152702,286570,966264
2020-11-06,FINRA / Nasdaq TRF Chicago (DB),23753609,6489725,21007880,51251214,1051597329.070200,394955521.508500,942424793.838500,2388977644.417200,134859,26882,108579,270320
2020-11-06,FINRA / NYSE TRF (DN),396052546,105494311,534801673,1036348530,10862951353.430801,3626474427.963798,17527906276.451012,32017332057.845611,1701203,304783,1734772,3740758
2020-11-06,FINRA / Nasdaq TRF Carteret (DQ),1539566939,463321330,1392192546,3395080815,54318132020.557196,29746685506.951307,63481071555.234094,147545889082.742597,6293843,1168145,4875910,12337898
2020-11-06,MIAX Pearl (H),339028,835879,442930,1617837,43106021.315000,138798993.411400,80236758.279400,262141773.005800,3934,4142,5925,14001
2020-11-06,EDGA Equities (J),66472322,38763033,56820964,162056319,2706178636.234400,1791041605.541000,2656477343.927901,7153697585.703301,866510,214977,617233,1698720
2020-11-06,EDGX Equities (K),387289042,110512363,329250745,827052150,11320080627.936201,5974199273.482498,12734889430.051104,30029169331.469803,2416797,538864,1891918,4847579
2020-11-06,LTSE (L),100,610,0,710,1024.000000,99320.200000,0.000000,100344.200000,1,1,0,2
2020-11-06,NYSE Chicago (M),10664096,8831326,11492845,30988267,500696820.250000,1572937039.554000,2120313419.284801,4193947279.088801,8929,1245,8661,18835
2020-11-06,NYSE (N),926274192,49416713,68256217,1043947122,36987177657.238700,2538453763.391100,3257097048.396800,42782728469.026600,3511824,157124,447409,4116357
2020-11-06,NYSE Arca (P),285797622,275681612,344788731,906267965,9621831937.159994,16879233297.898294,16651568568.156711,43152633803.214999,2161141,995704,2344023,5500868
2020-11-06,NASDAQ (Q),560033875,183313085,956464227,1699811187,22358016040.207495,12659312057.077607,52259196534.668513,87276524631.953615,5346458,1028162,6463092,12837712
2020-11-06,Members Exchange (U),30929942,4123118,18367578,53420638,578748410.969500,147512352.505000,398739198.265000,1124999961.739500,284656,9286,152667,446609
2020-11-06,Investors Exchange (V),157955105,18593463,105281077,281829645,8288700171.183899,1200383385.402300,7063267545.787401,16552351102.373600,1435988,104392,1002832,2543212
2020-11-06,NASDAQ PSX (X),30677417,23572829,22833917,77084163,783637420.363400,1239668716.067400,1254627189.018200,3277933325.449000,220844,89587,179595,490026
2020-11-06,BYX Equities (Y),82093302,38583096,52621361,173297759,2387940762.808300,1981108931.523501,2199519936.193000,6568569630.524801,879671,199074,541027,1619772
2020-11-06,BZX Equities (Z),233279956,119871847,197773243,550925046,8354081295.075704,8145680205.327402,9976771273.009598,26476532773.412704,2258438,632737,1597592,4488767
2020-11-05,NYSE American (A),13449740,26108992,9482028,49040760,428732692.539200,711527950.556800,580944731.671200,1721205374.767200,189053,113088,126756,428897
2020-11-05,NASDAQ BX (B),36496731,24599010,25920674,87016415,1499052069.411100,1463116933.988700,1697061599.242000,4659230602.641800,511359,134490,362566,1008415
2020-11-05,NYSE National (C),66570841,41183210,28732021,136486072,1425744046.265500,1522780995.589400,1055256421.496900,4003781463.351800,590798,188486,307693,1086977
2020-11-05,FINRA / Nasdaq TRF Chicago (DB),20858056,8213429,19470629,48542114,996907970.503800,535439439.130100,1104358748.208300,2636706157.842200,126866,32200,116518,275584
2020-11-05,FINRA / NYSE TRF (DN),372399668,130137322,435823779,938360769,12548202986.028801,4758277005.708502,19729524467.752396,37036004459.489699,1682197,335756,1827593,3845546
2020-11-05,FINRA / Nasdaq TRF Carteret (DQ),1585485195,558563451,1329958238,3474006884,61027252313.537295,32413658632.401298,72818413350.708699,166259324296.647292,6221575,1347351,5374349,12943275
2020-11-05,MIAX Pearl (H),587865,1016447,641594,2245906,68139947.190000,125966248.245900,121414326.409500,315520521.845400,6218,3640,8335,18193
2020-11-05,EDGA Equities (J),71815038,48593267,49484273,169892578,3143457621.895300,2368845877.733400,3001225105.906801,8513528605.535501,947628,270669,670414,1888711
2020-11-05,EDGX Equities (K),355185634,142221676,273682415,771089725,11684815468.231497,7923018557.526000,13843500251.306690,33451334277.064187,2326327,668989,1950644,4945960
2020-11-05,NYSE Chicago (M),14808328,10759596,12132941,37700865,866260960.371400,1138375333.115800,1600710465.532800,3605346759.020000,10207,1961,9262,21430
2020-11-05,NYSE (N),927770411,62548648,67674760,1057993819,39907939549.235093,3567301638.269400,3924690734.951500,47399931922.455993,3750983,207310,484362,4442655
2020-11-05,NYSE Arca (P),290729975,369109358,332804226,992643559,11693826582.538007,23979740073.769484,21302065205.732897,56975631862.040388,2330200,1258758,2831168,6420126
2020-11-05,NASDAQ (Q),551950468,232211305,898778115,1682939888,24503281791.846292,16521164220.682899,62087016562.443710,103111462574.972901,5551969,1260014,7066398,13878381
2020-11-05,Members Exchange (U),27973316,5295919,18111711,51380946,556394490.958600,184349903.645000,420058981.527600,1160803376.131200,243899,12240,152240,408379
2020-11-05,Investors Exchange (V),170673191,23831370,110566830,305071391,9468540734.215400,1649498280.683200,8205504228.759504,19323543243.658104,1525848,119341,1088325,2733514
2020-11-05,NASDAQ PSX (X),33982571,24148270,22154154,80284995,910853528.685700,1273828349.001700,1468284412.589500,3652966290.276900,220292,103526,190878,514696
2020-11-05,BYX Equities (Y),82138606,48205116,45067954,175411676,2585203340.355800,2730393942.000001,2476888910.312301,7792486192.668102,938174,242238,564210,1744622
2020-11-05,BZX Equities (Z),235274687,153824879,167676715,556776281,9282482503.502399,11267758213.241094,11883935290.223000,32434176006.966493,2376906,810047,1761274,4948227
2020-11-04,NYSE American (A),16412847,25907111,10806862,53126820,676227984.475300,1299836340.911200,989939092.133900,2966003417.520400,184258,119047,126244,429549
2020-11-04,NASDAQ BX (B),38258624,25848191,26594207,90701022,1611085493.416300,1620512030.098700,1989219144.337100,5220816667.852100,543421,144957,388489,1076867
2020-11-04,NYSE National (C),67909262,42117098,30984773,141011133,1519319667.680800,1593850457.314600,1265984428.043300,4379154553.038700,574148,204764,316470,1095382
2020-11-04,FINRA / Nasdaq TRF Chicago (DB),21879848,8577237,18710259,49167344,1088534400.317500,600880020.324600,1293106938.968100,2982521359.610200,125869,32690,118135,276694
2020-11-04,FINRA / NYSE TRF (DN),342668894,133714932,347152256,823536082,11030654128.210600,5790853389.794600,19368788679.755908,36190296197.761108,1502129,318311,1616450,3436890
2020-11-04,FINRA / Nasdaq TRF Carteret (DQ),1491626407,543092154,1190037101,3224755662,62234907922.528490,34912997899.205588,78401999658.639955,175549905480.374033,6126499,1309226,5091788,12527513
2020-11-04,MIAX Pearl (H),470965,1216797,624967,2312729,55134084.585000,179289755.194400,137855953.761700,372279793.541100,5450,4564,7578,17592
2020-11-04,EDGA Equities (J),76622499,57978203,52794001,187394703,3590198742.726199,2789719630.875699,3572721243.952100,9952639617.553998,965316,318268,684090,1967674
2020-11-04,EDGX Equities (K),319119184,166899535,226701783,712720502,11394934830.600402,10164700936.652003,15108095593.125789,36667731360.378194,2268957,824570,1875385,4968912
2020-11-04,LTSE (L),100,4,3,107,3900.000000,331.360000,8.730000,4240.090000,1,1,1,3
2020-11-04,NYSE Chicago (M),6973097,9604360,6964382,23541839,465985769.346600,1761517564.912999,1417635725.688700,3645139059.948299,10181,1139,10165,21485
2020-11-04,NYSE (N),994640832,82347749,73209597,1150198178,44504981868.913297,4484248885.928199,4822128618.369997,53811359373.211493,4003759,264855,513181,4781795
2020-11-04,NYSE Arca (P),263046364,435364275,316832562,1015243201,11366200802.506201,29137283846.782719,26356880238.739968,66860364888.028888,2293707,1599454,2984796,6877957
2020-11-04,NASDAQ (Q),588485081,297194773,945604794,1831284648,27664355354.889999,22766896600.151208,75764116004.776440,126195367959.817647,6076235,1617843,7849059,15543137
2020-11-04,Members Exchange (U),18094333,4592700,12490589,35177622,369345480.247200,197035063.120000,307494400.398600,873874943.765800,152503,11842,97823,262168
2020-11-04,Investors Exchange (V),179179881,27710773,116364460,323255114,10607319254.623299,2137511640.989700,9612932989.538705,22357763885.151704,1607776,135909,1122794,2866479
2020-11-04,NASDAQ PSX (X),35049719,28058818,25460284,88568821,1033081799.933300,1412172255.981000,1791904543.459400,4237158599.373700,221852,128102,221745,571699
2020-11-04,BYX Equities (Y),81171617,48619497,45113454,174904568,2676908391.969700,2940598116.658001,2941504818.767900,8559011327.395601,905888,257888,568686,1732462
2020-11-04,BZX Equities (Z),248791516,202415369,174315076,625521961,10763802438.899400,16012270159.731986,14855841715.010099,41631914313.641485,2580439,1088160,1933611,5602210
2020-11-03,NYSE American (A),14250289,23103433,8890412,46244134,559638877.500900,1076341542.726601,601098724.842500,2237079145.070001,177188,100978,108667,386833
2020-11-03,NASDAQ BX (B),35941261,20582904,23781692,80305857,1349489714.809000,1269856124.115700,1466738450.291900,4086084289.216600,482343,132965,327957,943265
2020-11-03,NYSE National (C),65207676,36223165,27552329,128983170,1366166510.000000,1345921601.853400,909514974.614800,3621603086.468200,557338,173038,286216,1016592
2020-11-03,FINRA / Nasdaq TRF Chicago (DB),17413867,7491081,14781127,39686075,879451960.365600,539148308.456600,953883205.014100,2372483473.836300,103760,33522,89487,226769
2020-11-03,FINRA / NYSE TRF (DN),308258813,111072948,342814430,762146191,9607047734.751100,4265231943.418698,15007415620.467504,28879695298.637302,1362167,287192,1453036,3102395
2020-11-03,FINRA / Nasdaq TRF Carteret (DQ),1344292362,480725753,1086783799,2911801914,52116727076.438329,29338796223.755702,58892642798.239618,140348166098.433649,5550697,1252151,4445830,11248678
2020-11-03,MIAX Pearl (H),470842,780970,527012,1778824,70188987.240000,86857280.400000,80240771.240400,237287038.880400,5585,3003,6812,15400
2020-11-03,EDGA Equities (J),70155184,43200978,46190657,159546819,3074302603.605700,2072225600.722800,2521278943.697799,7667807148.026299,919896,238047,622987,1780930
2020-11-03,EDGX Equities (K),286263638,119888390,229018089,635170117,9933551718.807102,7030644871.452898,11539700080.334398,28503896670.594398,2051024,576629,1662304,4289957
2020-11-03,LTSE (L),0,0,8,8,0.000000,0.000000,93.600000,93.600000,0,0,2,2
2020-11-03,NYSE Chicago (M),5690482,6890900,10779258,23360640,373721615.866000,1222429459.765000,996313149.210000,2592464224.841000,8120,1379,8359,17858
2020-11-03,NYSE (N),861866074,55870806,58287613,976024493,36798611174.902199,3082694965.571600,3268221665.659401,43149527806.133200,3523106,173132,418799,4115037
2020-11-03,NYSE Arca (P),227994962,312106378,270125067,810226407,10064825787.577603,21555488905.244693,17185785662.920899,48806100355.743195,2015999,1078072,2393601,5487672
2020-11-03,NASDAQ (Q),506859241,214934602,775537733,1497331576,23744799008.908989,15029748079.259697,51744733371.358212,90519280459.526898,5292840,1117678,6255305,12665823
2020-11-03,Members Exchange (U),23500801,4337272,18795914,46633987,445529505.922900,170943702.660000,334511421.407600,950984629.990500,207530,10752,133732,352014
2020-11-03,Investors Exchange (V),154315790,20423518,97874592,272613900,8730542201.433002,1344441252.595100,7204475978.038400,17279459432.066502,1479500,119986,1029142,2628628
2020-11-03,NASDAQ PSX (X),30396609,20221445,20322228,70940282,879858339.053100,990015731.367800,1199819956.682800,3069694027.103700,204454,102030,167928,474412
2020-11-03,BYX Equities (Y),78616687,43095793,41324056,163036536,2404193960.615400,2352085052.129800,1961350372.577400,6717629385.322600,861478,212133,507323,1580934
2020-11-03,BZX Equities (Z),209889961,136620624,143200594,489711179,8618053216.869700,10155624085.370904,9114905233.323095,27888582535.563699,2251052,684524,1548538,4484114
2020-11-02,NYSE American (A),12858783,20759777,8807703,42426263,545253246.821800,839448301.622000,593442051.449300,1978143599.893100,192465,95716,127783,415964
2020-11-02,NASDAQ BX (B),33214332,19544381,21733756,74492469,1281465247.940700,1233531773.298900,1479868309.653100,3994865330.892700,488644,147461,326321,962426
2020-11-02,NYSE National (C),66054479,32910594,28388217,127353290,1429930467.907400,1195849888.752600,1006811765.612200,3632592122.272200,603067,167756,309981,1080804
2020-11-02,FINRA / Nasdaq TRF Chicago (DB),17181086,7983567,14555731,39720384,739853244.719500,599224025.785200,926776390.139900,2265853660.644600,105665,35453,91417,232535
2020-11-02,FINRA / NYSE TRF (DN),327181834,107379433,336355872,770917139,8985943636.455495,4454100306.562500,15473951010.583296,28913994953.601291,1411113,298921,1505076,3215110
2020-11-02,FINRA / Nasdaq TRF Carteret (DQ),1361443393,484961449,1091306649,2937711491,50776692869.297490,28150766100.895414,60457245140.770988,139384704110.963892,5698027,1258685,4445392,11402104
2020-11-02,MIAX Pearl (H),334990,449028,576265,1360283,37754009.620000,57019492.060000,97598262.574800,192371764.254800,4007,1701,7096,12804
2020-11-02,EDGA Equities (J),70156194,38525605,46923546,155605345,3151473053.997000,1912225966.074100,2739766755.089700,7803465775.160800,986887,232037,667206,1886130
2020-11-02,EDGX Equities (K),278693112,110328040,219074360,608095512,8767412690.332197,6545830907.089699,11684064475.362898,26997308072.784794,2123882,577817,1715984,4417683
2020-11-02,LTSE (L),38706,8828,19621,67155,1181248.710000,337930.150000,552615.680000,2071794.540000,473,96,288,857
2020-11-02,NYSE Chicago (M),11633030,6230005,6904802,24767837,577792215.129700,1001315152.855000,944277407.595600,2523384775.580300,9514,909,8475,18898
2020-11-02,NYSE (N),890141992,52741193,57671677,1000554862,38155868423.647893,2747395766.591300,3256998238.664700,44160262428.903893,3695439,179775,435965,4311179
2020-11-02,NYSE Arca (P),233893158,306102899,271179498,811175555,9100475043.197600,19478149768.064106,17952255044.939797,46530879856.201503,2150175,1055263,2447281,5652719
2020-11-02,NASDAQ (Q),513802465,211922300,786320544,1512045309,22064860698.124202,14639486927.315996,54488428742.769595,91192776368.209793,5648456,1202641,6453957,13305054
2020-11-02,Members Exchange (U),27011375,4033561,15213042,46257978,547389112.766000,161807734.130000,358526888.915900,1067723735.811900,255054,11704,141292,408050
2020-11-02,Investors Exchange (V),159917948,17797478,97124628,274840054,8349886932.671297,1227637494.550000,7515165708.158404,17092690135.379701,1492726,103499,1001560,2597785
2020-11-02,NASDAQ PSX (X),28941031,19092811,18081246,66115088,860109069.700400,1040176257.939300,1092148581.251800,2992433908.891500,208890,100722,163017,472629
2020-11-02,BYX Equities (Y),75243153,40279261,40313859,155836273,2492668491.051700,2363902028.960701,2153206484.525600,7009777004.538001,934391,210992,544207,1689590
2020-11-02,BZX Equities (Z),206949840,134786710,148456606,490193156,8293036533.715701,9413839858.114403,9997217809.692999,27704094201.523103,2390739,724194,1563238,4678171
2020-10-30,NYSE American (A),17019635,28158795,10960121,56138551,563686633.891600,1038496459.103500,834059367.477900,2436242460.473000,197942,112999,138053,448994
2020-10-30,NASDAQ BX (B),44857343,24043752,32461405,101362500,1646945523.428400,1540947871.023000,2022922010.599500,5210815405.050900,599762,131419,408752,1139933
2020-10-30,NYSE National (C),76916191,38259539,32394812,147570542,1519795299.160000,1367325563.661000,1082724631.741800,3969845494.562800,632615,182903,322903,1138421
2020-10-30,FINRA / Nasdaq TRF Chicago (DB),20573436,8526594,17684972,46785002,952885021.724300,566668287.262900,1340140732.869100,2859694041.856300,124082,33491,118036,275609
2020-10-30,FINRA / NYSE TRF (DN),313900953,125416088,367902283,807219324,9219187538.654997,4715861769.270497,19476803874.588201,33411853182.513695,1488727,368648,1952719,3810094
2020-10-30,FINRA / Nasdaq TRF Carteret (DQ),1384410675,530098173,1175210837,3089719685,51898448806.782617,33145966669.808797,74354881614.789703,159399297091.381117,5963273,1459278,5430766,12853317
2020-10-30,MIAX Pearl (H),179182,446074,428006,1053262,34414231.380000,67200304.160000,117455431.607200,219069967.147200,3123,1404,7047,11574
2020-10-30,EDGA Equities (J),79157698,46265710,52969714,178393122,3170517210.410499,2269170744.729800,3424349333.520800,8864037288.661099,1020399,265617,712886,1998902
2020-10-30,EDGX Equities (K),299467013,138597771,258795881,696860665,9311577340.405898,8563071054.305299,14961645053.341008,32836293448.052205,2247670,709673,2090153,5047496
2020-10-30,LTSE (L),48406,10905,39380,98691,1246870.180000,441276.590000,768356.170000,2456502.940000,638,120,496,1254
2020-10-30,NYSE Chicago (M),5368828,5661691,4450395,15480914,370004216.635900,587145252.513400,973111104.597000,1930260573.746300,11418,1566,10917,23901
2020-10-30,NYSE (N),1199028283,63687487,72253519,1334969289,49190547203.679792,3458960172.608899,4562569986.362799,57212077362.651490,4110796,208728,514537,4834061
2020-10-30,NYSE Arca (P),250807546,342074566,293871640,886753752,9234992047.306203,22750771148.344794,22737381985.080905,54723145180.731902,2178297,1244303,2803856,6226456
2020-10-30,NASDAQ (Q),578858547,252070646,978157482,1809086675,23570145727.531604,18335099303.300207,72827268079.789430,114732513110.621241,5866731,1416694,7476000,14759425
2020-10-30,Members Exchange (U),27806434,4558396,16133382,48498212,512905758.241900,155806995.860000,358072288.544800,1026785042.646700,234012,10040,140623,384675
2020-10-30,Investors Exchange (V),177843712,20215399,109003321,307062432,9147605321.382000,1449806847.747100,10442020248.903097,21039432418.032197,1624068,117992,1116065,2858125
2020-10-30,NASDAQ PSX (X),21741702,25576842,21930308,69248852,526613752.019600,2835046191.620601,2373690109.539098,5735350053.179299,135360,70421,134949,340730
2020-10-30,BYX Equities (Y),90537160,44160621,49367228,184065009,2710060563.334400,2734968682.777801,2840993296.435300,8286022542.547501,1062196,228384,627483,1918063
2020-10-30,BZX Equities (Z),255409186,165978351,177593887,598981424,9892129498.808402,12403736205.589906,14996172627.083897,37292038331.482205,2719181,880186,2012545,5611912
2020-10-29,NYSE American (A),16355208,25816886,9343726,51515820,550234786.288800,1040059804.543100,660829077.414300,2251123668.246200,208122,117646,128877,454645
2020-10-29,NASDAQ BX (B),39079243,19774876,24013103,82867222,1416459407.564300,1175710673.410800,1659410112.950300,4251580193.925400,556316,116642,356015,1028973
2020-10-29,NYSE National (C),80267946,33762972,27142441,141173359,1552112929.487600,1199125909.510000,944278548.913700,3695517387.911300,636143,163855,292849,1092847
2020-10-29,FINRA / Nasdaq TRF Chicago (DB),20895517,8538646,15061964,44496127,1028874151.630900,468577927.133800,925055681.018800,2422507759.783500,126427,40857,94938,262222
2020-10-29,FINRA / NYSE TRF (DN),364061015,123850888,334309148,822221051,10485026740.886300,5586777906.281097,16497279818.587694,32569084465.755091,1506276,345906,1542512,3394694
2020-10-29,FINRA / Nasdaq TRF Carteret (DQ),1505191367,499590586,1076832300,3081614253,56129878522.886388,28246208183.732705,62774452560.642432,147150539267.261525,6064190,1345367,4670617,12080174
2020-10-29,MIAX Pearl (H),96969,333492,96927,527388,16705416.230000,50234440.839900,32480611.980000,99420469.049900,1467,492,1575,3534
2020-10-29,EDGA Equities (J),77944035,42730164,46381317,167055516,3213984121.762900,1920327141.322500,2922576118.718700,8056887381.804100,1035432,235747,661523,1932702
2020-10-29,EDGX Equities (K),329773550,135225694,213897488,678896732,10095254690.514404,7285866246.228498,11890246666.504900,29271367603.247802,2293226,664140,1764781,4722147
2020-10-29,LTSE (L),13111,1475,7298,21884,244216.080000,49552.500000,233855.560000,527624.140000,218,13,160,391
2020-10-29,NYSE Chicago (M),5908153,8050751,6949593,20908497,540048018.166100,810785659.260000,1143574073.937900,2494407751.364000,9995,1214,8234,19443
2020-10-29,NYSE (N),1001223202,61023846,62240051,1124487099,40215247477.448394,3170391159.139500,3407126068.174501,46792764704.762395,3900072,181019,475096,4556187
2020-10-29,NYSE Arca (P),280117972,329532084,283827049,893477105,10020387877.577298,19252113755.729513,21429853485.473105,50702355118.779916,2279262,1195204,2684037,6158503
2020-10-29,NASDAQ (Q),597323898,230340247,817249899,1644914044,24300561636.488888,14994632725.388807,59334907671.997227,98630102033.874922,5855906,1266347,6624408,13746661
2020-10-29,Members Exchange (U),20309272,2552262,11289677,34151211,450830482.171700,90985040.790000,284846942.724100,826662465.685800,193540,8938,117748,320226
2020-10-29,Investors Exchange (V),188679831,17513584,102580803,308774218,9990210466.074100,1217168117.960700,8273329736.347397,19480708320.382197,1651573,100816,1065007,2817396
2020-10-29,NASDAQ PSX (X),21105249,19420281,15386397,55911927,513103437.957100,2045641567.297999,1684493994.672902,4243238999.928001,150484,53381,115243,319108
2020-10-29,BYX Equities (Y),84966785,41477903,41873433,168318121,2506595564.093900,2237155600.209201,2310708495.984100,7054459660.287201,1007887,199958,576617,1784462
2020-10-29,BZX Equities (Z),278553152,148998674,155709586,583261412,10183014865.729299,10565086712.563103,11555902912.792797,32304004491.085199,2829971,799778,1822741,5452490
2020-10-28,NYSE American (A),18963973,30952616,10534648,60451237,671782666.371600,1458999252.917900,773328702.790400,2904110622.079900,224595,131983,136558,493136
2020-10-28,NASDAQ BX (B),39563671,22975210,24885938,87424819,1456810723.801800,1373928810.326500,1763642008.686900,4594381542.815200,541816,151642,364327,1057785
2020-10-28,NYSE National (C),81062297,41967172,29413271,152442740,1563750927.454300,1513978157.426100,1006637680.198800,4084366765.079200,630721,193470,295567,1119758
2020-10-28,FINRA / Nasdaq TRF Chicago (DB),21227013,9040810,19006812,49274635,969142645.865100,540112006.931200,1055088050.535100,2564342703.331400,125605,42577,112616,280798
2020-10-28,FINRA / NYSE TRF (DN),362120314,140004948,459783075,961908337,9597879983.837499,5138811632.753502,17124190150.412003,31860881767.003004,1696799,447965,1791022,3935786
2020-10-28,FINRA / Nasdaq TRF Carteret (DQ),1570971849,587349118,1299101622,3457422589,57249045985.642483,34697007235.694613,66217299305.826117,158163352527.163213,6569370,1792750,5174365,13536485
2020-10-28,MIAX Pearl (H),97900,766684,152729,1017313,17739273.080000,75623894.800000,42132190.269800,135495358.149800,1548,1183,2419,5150
2020-10-28,EDGA Equities (J),82104724,48487548,55299458,185891730,3240184024.487700,2267087004.718800,3018124788.142200,8525395817.348700,1059844,282310,690975,2033129
2020-10-28,EDGX Equities (K),340766195,159560563,287927788,788254546,9790827685.043001,9497971544.687395,12387474410.981200,31676273640.711596,2454134,811592,1940452,5206178
2020-10-28,LTSE (L),23278,1745,9332,34355,632339.670000,64787.330000,263576.060000,960703.060000,335,24,182,541
2020-10-28,NYSE Chicago (M),8811240,8951504,4692762,22455506,480369146.471000,1080433347.249400,589789492.161000,2150591985.881400,10017,1592,8717,20326
2020-10-28,NYSE (N),1092193730,75449574,71605550,1239248854,44316964509.132402,4148359753.543999,3829844607.078500,52295168869.754901,4038740,228578,497917,4765235
2020-10-28,NYSE Arca (P),308938519,395852397,349101997,1053892913,10854850200.869300,24424412873.790484,17869904039.238999,53149167113.898783,2499983,1452512,2673782,6626277
2020-10-28,NASDAQ (Q),614299245,274623965,943932704,1832855914,24663415006.946199,19327782125.312805,60733507532.809080,104724704665.068084,6092129,1516843,7029103,14638075
2020-10-28,Members Exchange (U),13105479,560264,4671006,18336749,410898858.225000,18884058.990000,236153264.930000,665936182.145000,114388,928,46921,162237
2020-10-28,Investors Exchange (V),193302914,22512484,113259520,329074918,9909223570.743299,1611195513.910901,9112206458.781199,20632625543.435399,1695319,125036,1134220,2954575
2020-10-28,NASDAQ PSX (X),18477712,21630051,18607600,58715363,524231720.459300,2599790898.875500,1990863600.913800,5114886220.248600,141245,68450,125587,335282
2020-10-28,BYX Equities (Y),101515945,59366254,56940574,217822773,2833463782.791100,3118744477.639300,2449227961.203700,8401436221.634100,1139504,300155,614671,2054330
2020-10-28,BZX Equities (Z),272430522,178858892,181765842,633055256,9882398196.042501,13158655246.656403,11275935748.596706,34316989191.295610,2769025,971354,1808090,5548469
2020-10-27,NYSE American (A),13367908,21129157,7742220,42239285,486617012.740600,683606654.349100,503914882.139000,1674138549.228700,165742,89200,98557,353499
2020-10-27,NASDAQ BX (B),31689490,14041380,28517586,74248456,1210000183.267600,793057968.753300,1289707265.540300,3292765417.561200,448263,82971,296212,827446
2020-10-27,NYSE National (C),56755157,22054302,21350789,100160248,1101887728.744000,823551045.211700,764921143.446200,2690359917.401900,467452,106268,234383,808103
2020-10-27,FINRA / Nasdaq TRF Chicago (DB),7564972,1776274,9476969,18818215,282899953.989900,75754740.131300,529367859.593000,888022553.714200,35002,6827,42790,84619
2020-10-27,FINRA / NYSE TRF (DN),289589881,90099324,357667716,737356921,8471560675.504201,3006739572.082099,15820603535.260905,27298903782.847205,1305280,250089,1459383,3014752
2020-10-27,FINRA / Nasdaq TRF Carteret (DQ),1289526730,368331440,1080495303,2738353473,49436438868.340487,22233356752.260013,57149194694.363803,128818990314.964303,5125505,1019279,4200293,10345077
2020-10-27,MIAX Pearl (H),86606,421487,97463,605556,12513019.150000,47314688.867300,23926611.010000,83754319.027300,1073,1611,1295,3979
2020-10-27,EDGA Equities (J),62320476,27968493,42037604,132326573,2719075362.774100,1307002490.175200,2439534340.789800,6465612193.739100,845603,163570,585367,1594540
2020-10-27,EDGX Equities (K),275236077,95249109,237303157,607788343,8375291692.897297,5148164519.736999,10854197801.186604,24377654013.820900,1947189,460285,1630577,4038051
2020-10-27,LTSE (L),53780,880,13766,68426,1538630.190000,30867.690000,461580.970000,2031078.850000,647,12,237,896
2020-10-27,NYSE Chicago (M),4907274,8538855,3864662,17310791,253286521.534400,1012548789.045400,571406028.017000,1837241338.596800,8335,1702,7495,17532
2020-10-27,NYSE (N),795698101,40713395,56827325,893238821,32561431828.042096,2257125567.049400,2637186173.785600,37455743568.877096,3057606,122972,374902,3555480
2020-10-27,NYSE Arca (P),209391841,220077753,245149696,674619290,7805754481.434799,13763065060.063602,14900352261.104201,36469171802.602602,1796099,770877,2124790,4691766
2020-10-27,NASDAQ (Q),464343957,156762174,725115582,1346221713,19598174905.177194,11084365584.814899,44705437480.003852,75387977969.995945,4599961,864702,5451252,10915915
2020-10-27,Members Exchange (U),13621294,316973,5176078,19114345,395917005.285000,17370664.880000,247687087.015000,660974757.180000,104836,853,46472,152161
2020-10-27,Investors Exchange (V),151549807,14032853,95063038,260645698,8249865565.989001,880840216.476000,7552309012.997199,16683014795.462200,1409743,81334,975738,2466815
2020-10-27,NASDAQ PSX (X),12373558,9712617,13124679,35210854,382232717.306600,1050364269.060500,1477466319.182700,2910063305.549800,102073,36548,109083,247704
2020-10-27,BYX Equities (Y),73387244,32455343,40489483,146332070,2250079092.248200,1771093639.600601,1925486114.649000,5946658846.497801,868684,166177,516569,1551430
2020-10-27,BZX Equities (Z),210938260,94067053,135263616,440268929,8082723406.883200,6705712384.996100,8979881943.065001,23768317734.944301,2185147,513842,1415669,4114658
2020-10-26,NYSE American (A),15161316,28664634,8983893,52809843,552905235.395200,1068603601.573100,570396764.600300,2191905601.568600,195090,128117,123111,446318
2020-10-26,NASDAQ BX (B),31854778,18500229,23520911,73875918,1176171465.979300,1069503262.488800,1332671892.864400,3578346621.332500,474748,118791,315969,909508
2020-10-26,NYSE National (C),59984921,30032230,24435812,114452963,1230663991.447200,1119951503.173600,794520701.658100,3145136196.278900,524562,143829,268539,936930
2020-10-26,FINRA / Nasdaq TRF Chicago (DB),7361431,3108425,9922498,20392354,286915068.763100,134188409.584400,698889279.823700,1119992758.171200,36126,11884,57616,105626
2020-10-26,FINRA / NYSE TRF (DN),310496100,136903063,381836508,829235671,9203865380.985999,4543100959.478499,17634559292.075798,31381525632.540296,1453308,419185,1730487,3602980
2020-10-26,FINRA / Nasdaq TRF Carteret (DQ),1266771466,485338718,1114949295,2867059479,48694261184.204303,27564600046.047783,61616665432.260833,137875526662.512919,5299931,1529842,4696639,11526412
2020-10-26,MIAX Pearl (H),85331,738360,96260,919951,12583536.200000,85996710.636000,33547377.620000,132127624.456000,1356,1998,1644,4998
2020-10-26,EDGA Equities (J),63976734,33476737,41349023,138802494,2769502256.000300,1538156476.599700,2520345957.164800,6828004689.764800,880602,198463,599748,1678813
2020-10-26,EDGX Equities (K),283222282,136992700,251366672,671581654,8907700053.584603,6940979147.278201,11840009280.779895,27688688481.642699,2121207,674658,1818915,4614780
2020-10-26,LTSE (L),25972,1864,11954,39790,716243.030000,67921.380000,407279.910000,1191444.320000,384,14,275,673
2020-10-26,NYSE Chicago (M),4376082,4698192,5179406,14253680,335543952.684800,740099856.860000,557667071.527500,1633310881.072300,8467,1156,7320,16943
2020-10-26,NYSE (N),826828256,53823845,59696135,940348236,34912295459.050696,2923486986.410999,3051410933.597300,40887193379.058995,3174007,164674,411355,3750036
2020-10-26,NYSE Arca (P),202989318,273186590,240481586,716657494,7698651657.830201,17274709879.236995,14908610434.786406,39881971971.853602,1849784,1016096,2202658,5068538
2020-10-26,NASDAQ (Q),471538754,218894201,748183655,1438616610,19233202951.082699,14779996191.536699,49648593481.154803,83661792623.774201,4767148,1166824,5886552,11820524
2020-10-26,Members Exchange (U),10924232,422351,4967134,16313717,362621605.785000,18763298.810000,237263040.045000,618647944.640000,96656,986,44807,142449
2020-10-26,Investors Exchange (V),142514715,20414028,89882046,252810789,7538946997.530001,1297696595.291900,7444094545.271201,16280738138.093102,1356196,112132,944469,2412797
2020-10-26,NASDAQ PSX (X),14489175,22555271,17971464,55015910,398000082.000700,2234077628.400701,2120914175.426499,4752991885.827900,123194,77476,134831,335501
2020-10-26,BYX Equities (Y),71966263,37757297,40129515,149853075,2219615106.540000,2223886555.952201,2017275178.575100,6460776841.067301,889259,192547,521876,1603682
2020-10-26,BZX Equities (Z),217645688,129493748,142143043,489282479,8101890486.704899,9185254007.335901,9835998849.551905,27123143343.592705,2254762,689140,1533494,4477396
2020-10-23,NYSE American (A),11561382,19317064,7976824,38855270,394960597.417300,550594954.348000,425645102.765500,1371200654.530800,147991,82250,94211,324452
2020-10-23,NASDAQ BX (B),28009451,12588629,21218602,61816682,1090384336.171300,758886975.427400,1176144429.198100,3025415740.796800,406878,88548,288973,784399
2020-10-23,NYSE National (C),56073013,23081846,24125358,103280217,1159884964.638600,866526138.769800,768745460.903300,2795156564.311700,479875,109756,247370,837001
2020-10-23,FINRA / Nasdaq TRF Chicago (DB),6953785,2249025,9471601,18674411,266047177.222100,72754647.552000,508601180.832000,847403005.606100,30957,9785,49277,90019
2020-10-23,FINRA / NYSE TRF (DN),311038795,81484210,384661537,777184542,9543526721.712601,2713078500.734400,14805366773.847810,27061971996.294811,1349399,233995,1627113,3210507
2020-10-23,FINRA / Nasdaq TRF Carteret (DQ),1181792184,315146980,1092358342,2589297506,44338780433.038699,18361835129.753106,49335449752.671521,112036065315.463326,4518376,889794,4276758,9684928
2020-10-23,MIAX Pearl (H),42661,406986,57472,507119,7166471.120000,37298613.950000,18810135.800000,63275220.870000,704,1963,829,3496
2020-10-23,EDGA Equities (J),55579112,24439174,39444006,119462292,2470464015.978000,1181982681.793600,2153168506.328500,5805615204.100100,760489,147820,523394,1431703
2020-10-23,EDGX Equities (K),244942798,85764779,261425277,592132854,7532827467.674499,4198496301.792499,9733134382.532096,21464458151.999094,1703675,397450,1653545,3754670
2020-10-23,LTSE (L),56448,476,14315,71239,1375391.600000,13477.680000,396475.220000,1785344.500000,662,6,242,910
2020-10-23,NYSE Chicago (M),9462520,6610129,4832595,20905244,550340923.464000,902838645.330000,607117225.010000,2060296793.804000,7063,1160,6381,14604
2020-10-23,NYSE (N),721877619,34034366,53015313,808927298,29067426251.179602,1803769744.225401,2568965594.663999,33440161590.069002,2681389,103115,362278,3146782
2020-10-23,NYSE Arca (P),183209841,186654980,261708223,631573044,6612460105.234301,11282079110.187401,12179904982.938796,30074444198.360498,1521174,642229,2020491,4183894
2020-10-23,NASDAQ (Q),411216862,142567068,701030698,1254814628,16588625956.262400,9420701289.614401,39454210820.956206,65463538066.833007,4086902,749604,5153011,9989517
2020-10-23,Members Exchange (U),10741609,370331,5026170,16138110,320920754.085000,14849880.440000,218313241.890000,554083876.415000,93074,1476,39588,134138
2020-10-23,Investors Exchange (V),133832015,12972734,87826311,234631060,6943489937.857999,819078385.680700,6544758015.862304,14307326339.401003,1224332,70579,845241,2140152
2020-10-23,NASDAQ PSX (X),26725509,14802042,16648617,58176168,669960603.513000,816415072.472900,1104919096.132300,2591294772.118200,164679,69937,144423,379039
2020-10-23,BYX Equities (Y),62567743,27876395,39309478,129753616,1999696478.397200,1503757777.827900,1788658419.355200,5292112675.580300,772735,137656,480938,1391329
2020-10-23,BZX Equities (Z),195925430,84513061,135428992,415867483,7284674483.888800,5801131334.849696,8480625772.435802,21566431591.174298,1989333,445819,1379180,3814332
2020-10-22,NYSE American (A),13743896,21789773,9165439,44699108,474586205.607500,569978520.110100,456994839.419500,1501559565.137100,183329,86507,106282,376118
2020-10-22,NASDAQ BX (B),31272908,15432573,22966163,69671644,1206209892.383500,874179966.905200,1442653520.687799,3523043379.976499,431864,102851,313053,847768
2020-10-22,NYSE National (C),64322972,25125153,26874046,116322171,1384063670.568000,963436071.067700,877775418.026800,3225275159.662500,554510,130575,270825,955910
2020-10-22,FINRA / Nasdaq TRF Chicago (DB),8300229,1962569,10168134,20430932,313337817.206600,85942491.839000,624425480.732700,1023705789.778300,36437,6978,54817,98232
2020-10-22,FINRA / NYSE TRF (DN),327799932,94146204,401188535,823134671,9241694879.210400,3083470204.264601,16660317267.799398,28985482351.274399,1405738,259844,1694611,3360193
2020-10-22,FINRA / Nasdaq TRF Carteret (DQ),1346430933,407453185,1187051721,2940935839,49517729481.344870,22283075866.090511,60410056978.800211,132210862326.235592,5117907,991763,4583022,10692692
2020-10-22,MIAX Pearl (H),83639,219500,123228,426367,15020873.090000,15075890.686300,38617199.887700,68713963.664000,1419,662,1974,4055
2020-10-22,EDGA Equities (J),63599246,27884182,42109536,133592964,2750431715.937500,1344550075.554400,2398104273.742900,6493086065.234800,856696,168213,564298,1589207
2020-10-22,EDGX Equities (K),292597799,95524137,259821672,647943608,8814342346.833102,5131867208.041999,11667585081.534905,25613794636.410006,1972268,439141,1787265,4198674
2020-10-22,LTSE (L),22420,1068,7438,30926,706197.250000,53000.610000,258875.370000,1018073.230000,385,13,139,537
2020-10-22,NYSE Chicago (M),6968725,5376185,18606766,30951676,400879076.242000,512493706.810000,1376865343.985000,2290238127.037000,6917,866,6941,14724
2020-10-22,NYSE (N),844436506,41515411,57606249,943558166,34104374343.888898,2207560954.293200,2839879277.755401,39151814575.937499,3057838,124629,405229,3587696
2020-10-22,NYSE Arca (P),211086325,216066820,282888222,710041367,7620310161.333803,13512527820.985494,15279439709.390696,36412277691.709993,1787864,759014,2297293,4844171
2020-10-22,NASDAQ (Q),472252664,149898537,819681562,1441832763,19212451793.056007,10631483605.144799,49091038873.498997,78934974271.699803,4692422,842429,5946636,11481487
2020-10-22,Members Exchange (U),10922391,451540,3833786,15207717,309363910.015000,25323839.770000,189899389.610000,524587139.395000,93629,1188,36672,131489
2020-10-22,Investors Exchange (V),142684088,13896685,90443492,247024265,7589264420.291398,863237816.268500,7805625101.540199,16258127338.100097,1321525,80610,932363,2334498
2020-10-22,NASDAQ PSX (X),30278296,14983174,16720175,61981645,716043181.976000,856653356.740000,1110794674.032400,2683491212.748400,180059,74369,144588,399016
2020-10-22,BYX Equities (Y),70273221,30528667,39509170,140311058,2242675933.832400,1700871328.727600,2010055519.724600,5953602782.284600,840443,158310,488725,1487478
2020-10-22,BZX Equities (Z),234986294,97395022,145280274,477661590,8640381379.700400,6904157496.898500,9692244238.967602,25236783115.566502,2214081,534416,1531539,4280036
2020-10-21,NYSE American (A),14085892,25157094,8192540,47435526,415245910.062300,681309540.040000,479392476.939100,1575947927.041400,152162,100603,99653,352418
2020-10-21,NASDAQ BX (B),31363908,14856239,20218026,66438173,1203167127.048700,876415737.687600,1426390465.596900,3505973330.333200,447313,101254,306829,855396
2020-10-21,NYSE National (C),60875721,26038698,24722760,111637179,1239645063.725300,977115511.296500,850565680.661800,3067326255.683600,522071,131952,260993,915016
2020-10-21,FINRA / Nasdaq TRF Chicago (DB),7724975,1755005,9392266,18872246,324174267.240900,80844906.455500,658742766.348500,1063761940.044900,37540,7484,54807,99831
2020-10-21,FINRA / NYSE TRF (DN),313957561,108560269,431702135,854219965,9506441278.780499,3276264676.849802,16839953683.512315,29622659639.142616,1424402,289204,1728110,3441716
2020-10-21,FINRA / Nasdaq TRF Carteret (DQ),1330974461,425931724,1215892742,2972798927,50404480245.600584,21488289602.673003,60063380378.612861,131956150226.886448,5045192,1059392,4560762,10665346
2020-10-21,MIAX Pearl (H),83291,72046,102415,257752,13906882.790000,9905761.166000,41092956.448700,64905600.404700,1344,439,1632,3415
2020-10-21,EDGA Equities (J),59407668,30420112,38640043,128467823,2553077029.617800,1388208087.525600,2435340009.846500,6376625126.989900,803555,172928,533161,1509644
2020-10-21,EDGX Equities (K),276797324,106690687,277325791,660813802,8832035938.512300,5256856543.299499,11888823867.784097,25977716349.595896,1925782,475263,1795409,4196454
2020-10-21,LTSE (L),23150,1718,8682,33550,649454.300000,125280.640000,329790.490000,1104525.430000,316,32,129,477
2020-10-21,NYSE Chicago (M),10672333,5834511,4984425,21491269,587500748.375400,800041369.630000,658631131.075000,2046173249.080400,7588,1055,6134,14777
2020-10-21,NYSE (N),849401213,43651960,54701410,947754583,35447538875.880504,2420451657.379900,2995421546.445100,40863412079.705504,3029927,128093,385726,3543746
2020-10-21,NYSE Arca (P),212169272,233803889,269617352,715590513,8134471343.675002,13970380818.454589,15501619443.365701,37606471605.495292,1812790,823099,2212928,4848817
2020-10-21,NASDAQ (Q),463519095,182144843,809293530,1454957468,19177773164.894895,12190927969.420806,50648160322.072160,82016861456.387861,4595251,923228,5905980,11424459
2020-10-21,Members Exchange (U),9604040,453468,3667820,13725328,284914192.275000,23211312.680000,193418800.610000,501544305.565000,81760,1523,34396,117679
2020-10-21,Investors Exchange (V),148968707,14748321,92358860,256075888,7881595298.272402,895973244.695900,8225903941.502801,17003472484.471103,1339964,85055,937343,2362362
2020-10-21,NASDAQ PSX (X),28104643,17548781,16954501,62607925,673396451.023500,988772197.032800,1064682017.922700,2726850665.979000,170926,80729,148125,399780
2020-10-21,BYX Equities (Y),67841413,32677670,43060573,143579656,2204216667.153500,1865587007.297100,1927572975.318900,5997376649.769500,829974,165367,488977,1484318
2020-10-21,BZX Equities (Z),218390543,103708700,146482866,468582109,8252760975.874701,7497506286.400899,9985887463.589695,25736154725.865295,2147697,543974,1512997,4204668
2020-10-20,NYSE American (A),11649483,20360226,9549288,41558997,374812930.815400,634168218.971500,522931610.870900,1531912760.657800,151518,83842,99535,334895
2020-10-20,NASDAQ BX (B),30220684,15787063,20230753,66238500,1047546867.586300,962344713.866400,1309175366.701700,3319066948.154400,414669,94333,316777,825779
2020-10-20,NYSE National (C),61083825,27153876,25795543,114033244,1171195832.161200,1023680780.733000,848300723.408000,3043177336.302200,500956,131385,262563,894904
2020-10-20,FINRA / Nasdaq TRF Chicago (DB),7337106,1795289,12622988,21755383,253492322.031900,88152968.546100,639441963.501700,981087254.079700,32723,6457,55756,94936
2020-10-20,FINRA / NYSE TRF (DN),326468207,93912505,453829983,874210695,8344918308.705404,3613138631.063201,17621175357.166499,29579232296.935104,1355074,253337,1695023,3303434
2020-10-20,FINRA / Nasdaq TRF Carteret (DQ),1258557580,421574828,1229086312,2909218720,43022563851.018497,22462444203.265602,58275795807.623805,123760803861.907904,4883094,975767,4466259,10325120
2020-10-20,MIAX Pearl (H),117900,199696,145474,463070,18587327.810000,27133790.896600,45444291.581300,91165410.287900,1682,1892,2204,5778
2020-10-20,EDGA Equities (J),60464770,30498947,41325601,132289318,2399836552.396600,1449586697.019900,2310325979.710401,6159749229.126901,798904,176799,560197,1535900
2020-10-20,EDGX Equities (K),295428304,100415410,286851596,682695310,8316646271.441901,5630019908.825892,11942056189.355499,25888722369.623292,1895995,445246,1788029,4129270
2020-10-20,LTSE (L),22528,495,9482,32505,692684.570000,23772.270000,202494.420000,918951.260000,305,13,121,439
2020-10-20,NYSE Chicago (M),4941892,7087261,5460495,17489648,232328902.075500,530140841.409000,948514324.416800,1710984067.901300,8849,944,6581,16374
2020-10-20,NYSE (N),755309077,46119700,61180092,862608869,29966508969.908605,2434642607.721100,2899174669.643700,35300326247.273405,2984077,130555,398978,3513610
2020-10-20,NYSE Arca (P),217087762,238523989,281629036,737240787,7078207017.057402,15259573312.010198,14758334073.605894,37096114402.673494,1730330,781108,2199973,4711411
2020-10-20,NASDAQ (Q),458779103,172676750,774312123,1405767976,17929793280.749302,11950842274.057806,45972027856.829178,75852663411.636286,4504827,912233,5791160,11208220
2020-10-20,Members Exchange (U),1508109,364538,1024739,2897386,77426936.900000,28193979.160000,82634333.165200,188255249.225200,12687,1533,11137,25357
2020-10-20,Investors Exchange (V),130824666,14918745,87989496,233732907,6815468530.728999,941927374.857900,7246770050.799700,15004165956.386599,1215882,84261,874287,2174430
2020-10-20,NASDAQ PSX (X),25519029,17057052,16732229,59308310,613513838.702400,913238623.248800,1197425473.749800,2724177935.701000,157076,79836,151816,388728
2020-10-20,BYX Equities (Y),67392782,33449334,47342902,148185018,1952394701.809900,1909219710.820100,1978765100.460600,5840379513.090600,808010,165475,489399,1462884
2020-10-20,BZX Equities (Z),205146880,106793734,154929381,466869995,7371884370.084499,7563361540.673302,9549914673.412299,24485160584.170100,2112210,552021,1513441,4177672
2020-10-19,NYSE American (A),11946826,22616831,8493132,43056789,382747814.441900,772755205.876600,521341936.120500,1676844956.439000,130358,91674,88758,310790
2020-10-19,NASDAQ BX (B),29524095,13426407,20124930,63075432,1064381324.841400,818474553.819900,1400100476.715700,3282956355.377000,435878,89468,317276,842622
2020-10-19,NYSE National (C),56260967,25585518,24589741,106436226,1124331984.838200,926567253.943300,845597760.580100,2896496999.361600,474357,117655,253182,845194
2020-10-19,FINRA / Nasdaq TRF Chicago (DB),8680986,2447591,11469178,22597755,278220269.829500,103412159.602000,653055730.367300,1034688159.798800,37003,9072,62250,108325
2020-10-19,FINRA / NYSE TRF (DN),384856427,104952056,433136321,922944804,8545389119.792599,3401985532.988201,19226325615.840291,31173700268.621091,1584624,295008,1911227,3790859
2020-10-19,FINRA / Nasdaq TRF Carteret (DQ),1301377832,377156099,1221944055,2900477986,43091730227.161802,21483950832.934308,61963020378.674988,126538701438.771098,4890589,1047990,4757731,10696310
2020-10-19,MIAX Pearl (H),113681,236219,99938,449838,18772850.850000,30826507.709600,37191252.290000,86790610.849600,1710,1882,1635,5227
2020-10-19,EDGA Equities (J),59746052,25701377,38700498,124147927,2411515786.097800,1271425146.318800,2206938363.583800,5889879296.000400,796904,152696,552330,1501930
2020-10-19,EDGX Equities (K),316613636,95605651,276595636,688814923,8123872857.326699,5320590609.194797,12760894143.964899,26205357610.486395,1902101,440742,1834024,4176867
2020-10-19,LTSE (L),20390,1040,7649,29079,612550.840000,33420.000000,305103.680000,951074.520000,394,11,115,520
2020-10-19,NYSE Chicago (M),6281782,4670194,4479100,15431076,675703510.746000,547527270.485000,796443990.554300,2019674771.785300,9190,1092,7798,18080
2020-10-19,NYSE (N),833981000,39103685,54165497,927250182,34809109612.666005,2244104537.400500,2947825989.900301,40001040139.966806,3030371,122490,393439,3546300
2020-10-19,NYSE Arca (P),209728003,223636495,274658741,708023239,6592292568.288302,14273357932.141992,14779751086.700993,35645401587.131287,1629777,772683,2198402,4600862
2020-10-19,NASDAQ (Q),444748803,162008961,810191706,1416949470,17221585506.310902,11757659357.563100,51629279391.025404,80608524254.899406,4379605,857157,6161165,11397927
2020-10-19,Members Exchange (U),1334160,460106,1378336,3172602,76232349.420000,48404035.460000,141265248.435700,265901633.315700,13316,2452,15207,30975
2020-10-19,Investors Exchange (V),128092402,13671288,88978509,230742199,6504064805.132400,897919030.412800,7803164839.760300,15205148675.305500,1220359,81842,899718,2201919
2020-10-19,NASDAQ PSX (X),27293293,16607109,17517480,61417882,612362173.748800,898638176.098700,1221197415.204600,2732197765.052100,149176,79335,147900,376411
2020-10-19,BYX Equities (Y),68567197,30466521,42335729,141369447,1936932334.328300,1778629486.416400,1975546109.741800,5691107930.486500,786842,155367,484187,1426396
2020-10-19,BZX Equities (Z),201919550,98604028,148550933,449074511,6998449762.684001,7169597285.309499,9772557582.546100,23940604630.539600,1937142,516273,1531265,3984680
2020-10-16,NYSE American (A),13518223,18880735,9750983,42149941,363471644.303700,538254286.527000,495662174.659700,1397388105.490400,136249,76532,84512,297293
2020-10-16,NASDAQ BX (B),33960840,12953223,18168702,65082765,1077846509.885700,870372240.037500,1315156757.761900,3263375507.685100,409995,79930,263191,753116
2020-10-16,NYSE National (C),58715086,21678173,22381932,102775191,1134049596.178800,824965855.551100,752650326.387000,2711665778.116900,498083,107722,244364,850169
2020-10-16,FINRA / Nasdaq TRF Chicago (DB),10912697,1789015,9539926,22241638,292508566.467900,78062547.934100,594710422.509500,965281536.911500,38764,6702,53945,99411
2020-10-16,FINRA / NYSE TRF (DN),517625857,91187172,376000525,984813554,9928987115.255399,3979981186.134800,18428715758.820606,32337684060.210805,1642040,240575,1646797,3529412
2020-10-16,FINRA / Nasdaq TRF Carteret (DQ),1507669516,377339953,1106986735,2991996204,44972981916.306297,30803296159.500288,61620198470.721148,137396476546.527733,5073215,948938,4160277,10182430
2020-10-16,MIAX Pearl (H),105559,187549,79590,372698,21207357.090000,30054854.600000,29122803.877600,80385015.567600,1547,1211,1187,3945
2020-10-16,EDGA Equities (J),69319439,23291168,34616817,127227424,2473555233.868500,1306940807.656900,2256312777.155199,6036808818.680599,758462,139081,504240,1401783
2020-10-16,EDGX Equities (K),392164681,75492713,223441887,691099281,8306490832.682500,4365589365.355999,11988951073.468603,24661031271.507102,1917037,349496,1550443,3816976
2020-10-16,LTSE (L),22281,501,6102,28884,489394.860000,25605.810000,140000.520000,655001.190000,391,6,110,507
2020-10-16,NYSE Chicago (M),13235040,10516469,11300151,35051660,683915371.020000,967272439.800000,1917836465.973100,3569024276.793100,7139,1138,7457,15734
2020-10-16,NYSE (N),887844292,32107886,50602410,970554588,39352814604.115296,1872892420.412400,3036521288.535401,44262228313.063097,2727661,94529,359462,3181652
2020-10-16,NYSE Arca (P),250463112,187729698,229152908,667345718,6854398377.773799,12464153358.774800,14634053204.140289,33952604940.688888,1606921,614750,1949251,4170922
2020-10-16,NASDAQ (Q),471621007,129493426,799390950,1400505383,17336284870.990406,9563925718.284001,55287667152.244805,82187877741.519212,4209646,676654,5393921,10280221
2020-10-16,Members Exchange (U),1183920,513001,1273495,2970416,66122983.535000,42576845.370000,120504054.900000,229203883.805000,10847,2058,13358,26263
2020-10-16,Investors Exchange (V),127674685,13119500,84429122,225223307,6894640794.005800,872740180.049500,7313217022.006201,15080597996.061501,1173042,76006,828160,2077208
2020-10-16,NASDAQ PSX (X),27135480,14273403,15428919,56837802,580426501.863300,802495991.145800,1378023770.435800,2760946263.444900,141476,71401,129899,342776
2020-10-16,BYX Equities (Y),82397137,27455340,39369189,149221666,1997540204.726100,1631934050.301100,2025543053.030100,5655017308.057300,769927,144278,450620,1364825
2020-10-16,BZX Equities (Z),222467705,80600944,135065397,438134046,7299035165.192400,6213682667.271500,10795758159.399898,24308475991.863798,1882179,426652,1400754,3709585
2020-10-15,NYSE American (A),11900600,23372847,10096672,45370119,339390406.933400,630498076.990000,426261489.442800,1396149973.366200,147795,93791,92643,334229
2020-10-15,NASDAQ BX (B),27566678,13971843,19821660,61360181,1046926523.447700,820672281.542500,1403918375.298900,3271517180.289100,414689,90356,301909,806954
2020-10-15,NYSE National (C),55026751,24771348,25051535,104849634,1189580646.089900,911919699.059700,794541286.403700,2896041631.553300,526784,127662,263917,918363
2020-10-15,FINRA / Nasdaq TRF Chicago (DB),9194360,2335599,10681391,22211350,337028182.171700,91685718.168000,654732019.354300,1083445919.694000,44748,8409,58396,111553
2020-10-15,FINRA / NYSE TRF (DN),302651821,98148347,405486501,806286669,9461392150.511102,3938892341.270603,18207804920.084900,31608089411.866605,1450166,275726,1670992,3396884
2020-10-15,FINRA / Nasdaq TRF Carteret (DQ),1177742562,392642210,1180548191,2750932963,44962313645.887723,21710948893.167705,63177319765.912721,129850582304.968149,4863083,1002750,4366733,10232566
2020-10-15,MIAX Pearl (H),1458,104200,973,106631,80235.520000,16778932.150000,258526.430000,17117694.100000,10,474,10,494
2020-10-15,EDGA Equities (J),54631767,26373129,38852552,119857448,2459925275.795400,1270390692.279600,2313461107.557499,6043777075.632499,777330,163336,567789,1508455
2020-10-15,EDGX Equities (K),279479198,92295369,266851154,638625721,9043264909.011306,5176345712.996099,12117891171.596204,26337501793.603609,1887692,417261,1713413,4018366
2020-10-15,LTSE (L),22295,693,4626,27614,439089.790000,23452.050000,119415.770000,581957.610000,361,9,107,477
2020-10-15,NYSE Chicago (M),7089873,9201726,9150653,25442252,460499422.964600,787149852.860000,1688426515.237200,2936075791.061800,10057,921,9100,20078
2020-10-15,NYSE (N),758438803,39568321,51697878,849705002,31589126973.374196,2315071551.925900,2946674363.853700,36850872889.153796,2985358,121124,367698,3474180
2020-10-15,NYSE Arca (P),202414925,219262891,266204904,687882720,7844309920.272300,14336503778.742105,15652166429.331593,37832980128.345998,1730490,770041,2174374,4674905
2020-10-15,NASDAQ (Q),429334851,155040549,750991528,1335366928,18361431043.750100,11065237174.544298,49003240333.382508,78429908551.676906,4529544,842549,5842112,11214205
2020-10-15,Members Exchange (U),1032096,544236,996522,2572854,50816728.570000,41505084.670000,99796110.529500,192117923.769500,10114,1837,12012,23963
2020-10-15,Investors Exchange (V),134101494,12902001,86159728,233163223,7048555925.156600,829788106.581500,7559030165.933802,15437374197.671902,1231092,74257,877373,2182722
2020-10-15,NASDAQ PSX (X),23499197,17498861,16685053,57683111,546230114.279200,965950451.790900,1131069776.096400,2643250342.166500,139980,80826,136298,357104
2020-10-15,BYX Equities (Y),64688900,28682342,41278905,134650147,2074560603.968000,1704415125.486000,1967291756.543400,5746267485.997400,800847,157264,486558,1444669
2020-10-15,BZX Equities (Z),185737647,99297155,144717070,429751872,7105064874.291496,7184722363.614597,9562656611.074698,23852443848.980791,1887112,515381,1445461,3847954
2020-10-14,NYSE American (A),12189140,23561293,9863711,45614144,339486074.857500,572346440.511100,535470485.315800,1447303000.684400,142130,94175,86718,323023
2020-10-14,NASDAQ BX (B),29535896,13624932,19676581,62837409,1087844829.752500,844849775.051000,1304216117.052700,3236910721.856200,416470,89240,299728,805438
2020-10-14,NYSE National (C),61365938,25158243,22194355,108718536,1206152649.566200,895145978.748600,747446273.126900,2848744901.441700,534830,127769,245878,908477
2020-10-14,FINRA / Nasdaq TRF Chicago (DB),9226502,2142766,10644794,22014062,333237096.636000,94314215.925000,755955473.526100,1183506786.087100,46147,21372,65010,132529
2020-10-14,FINRA / NYSE TRF (DN),315005891,107126540,437513139,859645570,9251149581.740900,4273563798.022200,21303269369.145704,34827982748.908804,1468931,280573,1793843,3543347
2020-10-14,FINRA / Nasdaq TRF Carteret (DQ),1226606396,452979434,1229332576,2908918406,45632500832.605597,23840969314.747505,70106166558.083980,139579636705.437082,4900927,1029436,4654719,10585082
2020-10-14,MIAX Pearl (H),1,132827,3614,136442,634.500000,21161513.900000,989560.720000,22151709.120000,1,860,10,871
2020-10-14,EDGA Equities (J),57064972,27616890,38485597,123167459,2382161332.398800,1347351702.712900,2409047146.104600,6138560181.216300,774007,173286,557733,1505026
2020-10-14,EDGX Equities (K),295270639,92005672,263189002,650465313,9121014716.605993,5031958232.398401,13656725849.319593,27809698798.323987,1905974,428641,1775188,4109803
2020-10-14,LTSE (L),19722,1251,6797,27770,516143.300000,43211.490000,175705.220000,735060.010000,287,15,122,424
2020-10-14,NYSE Chicago (M),7411647,8924602,8484918,24821167,618190698.695800,714025074.180200,1013730138.547000,2345945911.423000,10296,2036,8145,20477
2020-10-14,NYSE (N),764083609,38097064,57123756,859304429,31489775932.236194,2121777639.452800,3231879999.119899,36843433570.808893,2901113,120106,406877,3428096
2020-10-14,NYSE Arca (P),221485119,218029880,267299006,706814005,8348094606.667400,13469264814.562597,15671691375.633599,37489050796.863596,1698479,776389,2192207,4667075
2020-10-14,NASDAQ (Q),436302784,152170145,748013494,1336486423,17683332794.468799,10295412844.458303,51543090229.733721,79521835868.660823,4401251,819231,5987498,11207980
2020-10-14,Members Exchange (U),933048,774331,880848,2588227,41137974.920000,39484351.330000,88235980.158000,168858306.408000,8774,3564,11037,23375
2020-10-14,Investors Exchange (V),129907734,12505584,83889385,226302703,6842901087.802999,804698589.844500,7959050582.187198,15606650259.834697,1224534,75388,873709,2173631
2020-10-14,NASDAQ PSX (X),26853682,16458210,18525629,61837521,612886797.629400,895079015.949300,1371203457.996500,2879169271.575200,141164,78772,149484,369420
2020-10-14,BYX Equities (Y),66633871,30853985,40953868,138441724,2056704202.866900,1823726763.942700,2111179514.117300,5991610480.926900,775695,163433,480843,1419971
2020-10-14,BZX Equities (Z),198618926,96497803,154335480,449452209,7164010841.010301,6443362327.186496,10301336601.412509,23908709769.609306,1941103,511480,1492495,3945078
2020-10-13,NYSE American (A),10881287,26250778,9665373,46797438,357969711.331700,605716284.437100,473620414.726600,1437306410.495400,153955,101111,97988,353054
2020-10-13,NASDAQ BX (B),27427228,14984810,24748104,67160142,1025852881.341500,848779715.397800,1354026207.228600,3228658803.967900,408386,91952,300592,800930
2020-10-13,NYSE National (C),57178980,25689369,24736574,107604923,1139222189.522100,915360309.893600,794351687.186700,2848934186.602400,514469,128426,269743,912638
2020-10-13,FINRA / Nasdaq TRF Chicago (DB),6409333,2464848,10687108,19561289,284554406.778600,83980954.628000,712870554.050700,1081405915.457300,31925,9200,57088,98213
2020-10-13,FINRA / NYSE TRF (DN),269419125,117096210,468778510,855293845,8483043019.972800,3382401030.001303,22064268373.145710,33929712423.119813,1315864,306155,1827345,3449364
2020-10-13,FINRA / Nasdaq TRF Carteret (DQ),1157516924,465534366,1319669112,2942720402,45791184282.810587,27936784020.577892,77237555927.589170,150965524230.977649,4820083,1058721,4812117,10690921
2020-10-13,MIAX Pearl (H),151,67116,30,67297,96460.320000,10902663.620000,6323.400000,11005447.340000,14,695,3,712
2020-10-13,EDGA Equities (J),56810976,27776308,41310469,125897753,2432926594.135900,1318186443.840300,2733040448.814999,6484153486.791199,779677,168600,601013,1549290
2020-10-13,EDGX Equities (K),256030068,111948060,291633563,659611691,8535742232.307402,5296220887.970200,14714700120.640509,28546663240.918111,1835979,470230,1872359,4178568
2020-10-13,LTSE (L),18357,846,6901,26104,427680.490000,23804.890000,151978.820000,603464.200000,296,13,171,480
2020-10-13,NYSE Chicago (M),5745905,5533301,7134607,18413813,336678110.166500,593453868.355000,1242946579.545800,2173078558.067300,10604,1432,7444,19480
2020-10-13,NYSE (N),756619551,41083124,58709242,856411917,32754091098.023300,2225424661.152900,3295578172.966500,38275093932.142700,3003909,127885,421468,3553262
2020-10-13,NYSE Arca (P),194130814,241966926,286648617,722746357,7522572512.294598,14463398741.603403,18229887784.834605,40215859038.732606,1657615,827146,2279227,4763988
2020-10-13,NASDAQ (Q),403310436,164604219,782720368,1350635023,17538203516.964496,10946787434.875701,55059960732.086303,83544951683.926500,4201748,873928,6087737,11163413
2020-10-13,Members Exchange (U),975030,373574,1412603,2761207,46326529.695000,44145155.120000,153417771.679800,243889456.494800,10431,2011,17414,29856
2020-10-13,Investors Exchange (V),137187022,12938310,91830748,241956080,7478758203.005901,809116256.699400,8247750587.280099,16535625046.985400,1255096,75873,883309,2214278
2020-10-13,NASDAQ PSX (X),24056527,16889371,18400636,59346534,564284847.943700,927946136.559100,1550505817.209500,3042736801.712300,145376,79423,151840,376639
2020-10-13,BYX Equities (Y),63976694,31135328,43044749,138156771,2046096535.793100,1793044907.662101,2389883249.654200,6229024693.109401,794180,157765,528392,1480337
2020-10-13,BZX Equities (Z),183407526,101006233,153002207,437415966,7118914220.226298,6939451910.976598,11442290254.729197,25500656385.932093,1854523,519267,1578584,3952374
2020-10-12,NYSE American (A),9895718,20480249,9326196,39702163,315527427.740800,679816821.418300,685523331.802800,1680867580.961900,124204,80259,98507,302970
2020-10-12,NASDAQ BX (B),24836617,14464771,29079671,68381059,921361642.261700,859164814.976100,1524061209.030200,3304587666.268000,345765,88835,298124,732724
2020-10-12,NYSE National (C),50744603,21270144,26383673,98398420,1061526169.412600,807429582.259900,833206265.611400,2702162017.283900,474104,114721,271199,860024
2020-10-12,FINRA / Nasdaq TRF Chicago (DB),7868948,2303650,12220602,22393200,288926577.007700,103538014.025700,844660580.761600,1237125171.795000,36697,8353,71768,116818
2020-10-12,FINRA / NYSE TRF (DN),277602630,107197302,537064968,921864900,8131949749.739200,3504909816.027799,23896152996.814498,35533012562.581497,1352114,310525,2053043,3715682
2020-10-12,FINRA / Nasdaq TRF Carteret (DQ),1117276232,374866854,1354692486,2846835572,43397054950.486096,25092691073.262484,79683128851.336182,148172874875.084762,4476621,1007228,4961755,10445604
2020-10-12,MIAX Pearl (H),1,71055,1001,72057,617.100000,11614439.720000,276029.530000,11891086.350000,1,772,3,776
2020-10-12,EDGA Equities (J),50692234,23289850,43681135,117663219,2362040042.100900,1204247669.349400,2957784260.463200,6524071971.913500,698267,151886,606676,1456829
2020-10-12,EDGX Equities (K),243467871,89055867,308151796,640675534,7805001941.459600,4987914452.982703,16218248056.660097,29011164451.102400,1668293,399053,1917255,3984601
2020-10-12,LTSE (L),14077,727,6540,21344,362910.810000,13493.790000,189917.890000,566322.490000,260,10,155,425
2020-10-12,NYSE Chicago (M),2931266,4992651,7399442,15323359,309839932.022800,896167010.472000,1525931641.595200,2731938584.090000,8083,2070,7036,17189
2020-10-12,NYSE (N),746848910,33489433,65883855,846222198,32964681298.131498,1947887098.625800,4145663406.916601,39058231803.673899,2717781,106726,445596,3270103
2020-10-12,NYSE Arca (P),172419663,207913908,291865867,672199438,6423433548.961901,13754386495.223402,20640357965.598802,40818178009.784105,1454018,730953,2355033,4540004
2020-10-12,NASDAQ (Q),372484240,132896743,884066615,1389447598,16050441156.747397,9542614916.300804,64191752137.793500,89784808210.841701,3828110,713075,6193150,10734335
2020-10-12,Members Exchange (U),127623,18433,3963,150019,7409393.110000,5324651.220000,1379832.330000,14113876.660000,1235,229,58,1522
2020-10-12,Investors Exchange (V),117481516,10765602,91637125,219884243,6645178353.618600,705347216.155300,9845306607.162600,17195832176.936500,1114130,69556,920606,2104292
2020-10-12,NASDAQ PSX (X),20948872,14109892,20279505,55338269,498762939.990500,850095850.914800,1618654421.460000,2967513212.365300,126909,68685,162895,358489
2020-10-12,BYX Equities (Y),58194254,28726174,43552454,130472882,1935367217.514300,1722272659.451400,2756491991.648100,6414131868.613800,698377,158505,498480,1355362
2020-10-12,BZX Equities (Z),161933228,85694244,159739667,407367139,6506164090.135903,6925170936.712103,13843249611.962402,27274584638.810408,1710480,438932,1578533,3727945
2020-10-09,NYSE American (A),11366011,31888819,8205876,51460706,353893490.632300,650675396.868400,511527627.756300,1516096515.257000,137310,107052,88590,332952
2020-10-09,NASDAQ BX (B),30346236,18416463,28795965,77558664,1050118327.463800,872710717.746700,1173118532.345400,3095947577.555900,409025,99117,277780,785922
2020-10-09,NYSE National (C),64009361,27560395,22376002,113945758,1230917232.030700,998916773.003400,762078332.857500,2991912337.891600,550828,138497,266052,955377
2020-10-09,FINRA / Nasdaq TRF Chicago (DB),7419878,2954764,10446397,20821039,244272554.250700,98147137.759000,520441237.019500,862860929.029200,33586,9089,49962,92637
2020-10-09,FINRA / NYSE TRF (DN),323774577,151550717,485811770,961137064,8170655577.534299,3724406340.512500,16884659038.534582,28779720956.581381,1363460,345367,1721234,3430061
2020-10-09,FINRA / Nasdaq TRF Carteret (DQ),1264064449,486991282,1243116136,2994171867,43691638325.600367,24017302969.865104,58612707072.408467,126321648367.873938,4805808,1152927,4402596,10361331
2020-10-09,MIAX Pearl (H),200,53279,1256,54735,211.000000,8674883.140000,331378.030000,9006472.170000,2,560,12,574
2020-10-09,EDGA Equities (J),57146692,28669328,39071907,124887927,2418729319.283600,1318369955.203600,2425711025.868600,6162810300.355800,755821,172993,548586,1477400
2020-10-09,EDGX Equities (K),276887800,133323929,271207501,681419230,7827351818.681602,5549603508.272500,11519439407.457503,24896394734.411605,1783024,511341,1633164,3927529
2020-10-09,NYSE Chicago (M),7004611,9276654,4802775,21084040,327177194.158500,1404065546.202000,978076295.025500,2709319035.386000,8646,2300,7390,18336
2020-10-09,NYSE (N),851343798,43809348,56715642,951868788,33813813102.520999,2185014462.540200,2905615914.044600,38904443479.105799,2924552,127399,386156,3438107
2020-10-09,NYSE Arca (P),206049977,273720749,267947012,747717738,7024590035.752596,14436597588.950896,14601332916.665002,36062520541.368494,1607841,880454,2113591,4601886
2020-10-09,NASDAQ (Q),422359647,185019220,782216954,1389595821,16505658423.331702,11141668108.860501,48644436587.243500,76291763119.435703,4159260,894156,5576789,10630205
2020-10-09,Members Exchange (U),516146,10678,20361,547185,17333554.960000,3047506.470000,3801493.218000,24182554.648000,4200,122,212,4534
2020-10-09,Investors Exchange (V),129486069,16046398,83167305,228699772,6784956910.093499,916615724.403100,7021850619.805097,14723423254.301696,1171127,80887,834067,2086081
2020-10-09,NASDAQ PSX (X),25710763,18441305,16042614,60194682,526672677.028600,929376560.061300,1145132154.862500,2601181391.952400,143301,80031,130393,353725
2020-10-09,BYX Equities (Y),68395771,34435511,37227190,140058472,2034577582.176100,1865593193.043601,1900005461.797200,5800176237.016901,775156,176676,462633,1414465
2020-10-09,BZX Equities (Z),198213800,111463512,147062116,456739428,7090224878.746495,7030516449.794008,10037561674.432004,24158303002.972507,1901995,547481,1427366,3876842
2020-10-08,NYSE American (A),10435820,40576072,7409744,58421636,327641813.003500,599953230.334300,411557351.642100,1339152394.979900,131411,145535,86686,363632
2020-10-08,NASDAQ BX (B),29536262,16328389,25354911,71219562,1055322698.939700,777881170.498000,1130717680.250700,2963921549.688400,406250,91278,274984,772512
2020-10-08,NYSE National (C),64586295,28911922,25813055,119311272,1294146496.018200,1000694348.690100,808385430.031100,3103226274.739400,580688,142517,297832,1021037
2020-10-08,FINRA / Nasdaq TRF Chicago (DB),7691343,4250774,10357929,22300046,282566518.956900,84313676.688800,528197944.333500,895078139.979200,33935,13775,51083,98793
2020-10-08,FINRA / NYSE TRF (DN),307730704,186908306,484641018,979280028,8666050409.458696,3290799679.187799,16832077139.872897,28788927228.519392,1299008,435144,1718636,3452788
2020-10-08,FINRA / Nasdaq TRF Carteret (DQ),1251099207,605844525,1282837868,3139781600,43775207596.277902,23409729031.585908,56436839399.475448,123621776027.339258,4789134,1581736,4361412,10732282
2020-10-08,MIAX Pearl (H),0,0,2,2,0.000000,0.000000,65.700000,65.700000,0,0,2,2
2020-10-08,EDGA Equities (J),58351508,30552027,40220414,129123949,2486935212.392300,1285499108.316300,2303747577.087600,6076181897.796200,776740,170881,552958,1500579
2020-10-08,EDGX Equities (K),276386679,166116846,270936412,713439937,8091045828.840495,4806006030.993199,10561081926.995999,23458133786.829693,1792574,618737,1605184,4016495
2020-10-08,LTSE (L),100,0,0,100,2134.000000,0.000000,0.000000,2134.000000,1,0,0,1
2020-10-08,NYSE Chicago (M),10041621,6737784,5235768,22015173,621250789.668300,809687648.054000,951950451.035800,2382888888.758100,8111,1805,7738,17654
2020-10-08,NYSE (N),798788092,38902717,55818254,893509063,31834987773.522100,1838549020.132701,2616445499.568300,36289982293.223101,2879085,123262,372752,3375099
2020-10-08,NYSE Arca (P),206549381,291237917,265136153,762923451,7602345866.864102,12691891706.656692,13699580349.934208,33993817923.455002,1662889,933540,2077689,4674118
2020-10-08,NASDAQ (Q),424143485,194209563,758451306,1376804354,17016465962.004397,9646847533.167301,42447574075.680807,69110887570.852505,4230912,905921,5529855,10666688
2020-10-08,Members Exchange (U),354759,14466,22961,392186,12718584.120000,4106810.600000,2877236.465200,19702631.185200,3175,175,201,3551
2020-10-08,Investors Exchange (V),131381229,15242715,80606437,227230381,6898564387.514901,812759608.863000,6441950258.279800,14153274254.657701,1169762,86961,799540,2056263
2020-10-08,NASDAQ PSX (X),26082075,17874316,16367466,60323857,533488532.078000,899953525.436000,976533253.164000,2409975310.678000,145895,82805,128703,357403
2020-10-08,BYX Equities (Y),69962693,38200671,38802052,146965416,2024067365.701500,1710066173.119700,1710972494.872500,5445106033.693700,802442,189577,460298,1452317
2020-10-08,BZX Equities (Z),194527721,104595582,139568165,438691468,6870453742.026801,6124981950.623001,8173039965.064798,21168475657.714600,1858755,529444,1362762,3750961
2020-10-07,NYSE American (A),11595802,24067270,7405094,43068166,376172565.055000,619029142.506300,533896515.782300,1529098223.343600,144831,90988,92282,328101
2020-10-07,NASDAQ BX (B),28653205,15321621,22964806,66939632,1034950665.286000,953894210.304600,1245261041.941400,3234105917.532000,418518,88173,311857,818548
2020-10-07,NYSE National (C),65661808,28728561,28006071,122396440,1271067809.301700,1022102606.041800,845971655.582000,3139142070.925500,596375,135228,315063,1046666
2020-10-07,FINRA / Nasdaq TRF Chicago (DB),6370328,1915227,11359302,19644857,286223766.025600,80062066.928900,641973563.889800,1008259396.844300,30346,6985,61156,98487
2020-10-07,FINRA / NYSE TRF (DN),264183219,130740543,507694095,902617857,8014511136.561301,3236852335.601098,18208737178.219096,29460100650.381495,1226584,298364,1885031,3409979
2020-10-07,FINRA / Nasdaq TRF Carteret (DQ),1222580856,500828409,1402247537,3125656802,45711951276.486413,26608603929.642905,64991454368.353081,137312009574.482399,4889593,1112538,5115251,11117382
2020-10-07,MIAX Pearl (H),3,0,1530,1533,1764.000000,0.000000,45962.030000,47726.030000,1,0,24,25
2020-10-07,EDGA Equities (J),56536582,27892037,42950795,127379414,2502846279.414900,1385359586.739000,2403208740.975200,6291414607.129100,805290,167121,609782,1582193
2020-10-07,EDGX Equities (K),243941313,99016130,307512601,650470044,7845755584.780402,4729969336.181598,11424389248.177602,24000114169.139602,1780737,424150,1871680,4076567
2020-10-07,NYSE Chicago (M),8224848,8519263,5300396,22044507,637938886.522800,1148787327.489000,1112450284.685800,2899176498.697600,7861,1695,9763,19319
2020-10-07,NYSE (N),878971575,38907549,59114715,976993839,36018960693.288299,2050577362.054100,2788888888.540900,40858426943.883299,3093604,123736,421528,3638868
2020-10-07,NYSE Arca (P),196419550,242250941,309179950,747850441,7510026725.493104,13783827547.465096,15252280549.843909,36546134822.802109,1707311,832035,2418577,4957923
2020-10-07,NASDAQ (Q),417119650,165631216,894302855,1477053721,17122985400.686097,10134681116.041898,50334419413.060115,77592085929.788110,4526405,838750,6286257,11651412
2020-10-07,Members Exchange (U),267037,10993,11538,289568,11457402.280000,3097591.840000,2644604.610000,17199598.730000,2518,141,106,2765
2020-10-07,Investors Exchange (V),129529079,14099122,82788752,226416953,6852643068.126601,850087931.952700,6747174848.727299,14449905848.806600,1205125,81791,856225,2143141
2020-10-07,NASDAQ PSX (X),24355696,16692291,16525846,57573833,572636870.484200,903150764.579500,947135263.352100,2422922898.415800,149751,78893,137832,366476
2020-10-07,BYX Equities (Y),69771555,35881276,44563504,150216335,2142638927.890800,1853445728.741700,2044179166.867700,6040263823.500200,856964,169539,528295,1554798
2020-10-07,BZX Equities (Z),190570018,105801932,168849681,465221631,7015772275.663900,6344985584.814794,9496433630.117795,22857191490.596489,2028326,510859,1616505,4155690
2020-10-06,NYSE American (A),13666140,28288528,8099233,50053901,386065455.624000,795792136.870900,574755350.506300,1756612943.001200,154784,112223,101901,368908
2020-10-06,NASDAQ BX (B),30886876,21030746,29067508,80985130,1032676012.914300,1473305305.188000,1447016186.682000,3952997504.784300,432617,130364,344325,907306
2020-10-06,NYSE National (C),75840162,38321461,32201418,146363041,1384752290.940100,1415039365.669900,1024664125.582600,3824455782.192600,615229,186617,327314,1129160
2020-10-06,FINRA / Nasdaq TRF Chicago (DB),8181515,2480456,13364628,24026599,365749089.893000,118223757.457400,809117231.646100,1293090078.996500,37437,8397,69685,115519
2020-10-06,FINRA / NYSE TRF (DN),321034139,136769479,566536453,1024340071,9842347177.026098,4234498498.516804,22433889790.819905,36510735466.362807,1441581,350556,2170673,3962810
2020-10-06,FINRA / Nasdaq TRF Carteret (DQ),1368766024,526945795,1542416906,3438128725,51310514053.833690,27914368340.525896,75071428130.831670,154296310525.191256,5246441,1257550,5571779,12075770
2020-10-06,MIAX Pearl (H),581,0,35,616,33355.210000,0.000000,4501.560000,37856.770000,7,0,3,10
2020-10-06,EDGA Equities (J),68031443,39497330,49734360,157263133,2596382281.187600,1907045469.596300,2817598565.616200,7321026316.400100,884768,231578,664456,1780802
2020-10-06,EDGX Equities (K),315922589,140295501,365718742,821936832,9806230163.073995,7325109394.317602,14769248505.216894,31900588062.608491,2152825,628320,2247191,5028336
2020-10-06,LTSE (L),0,0,400,400,0.000000,0.000000,1644.000000,1644.000000,0,0,5,5
2020-10-06,NYSE Chicago (M),5060618,8397142,6275051,19732811,359973746.075000,1023213126.607000,837838361.410600,2221025234.092600,10882,1634,11020,23536
2020-10-06,NYSE (N),991724604,61240445,70343540,1123308589,38130301256.788195,3181892003.688300,3605428424.301901,44917621684.778396,3667460,191236,481914,4340610
2020-10-06,NYSE Arca (P),236462705,346697765,356731465,939891935,8187844951.179999,22575756382.445308,19267944501.869990,50031545835.495297,1960756,1179379,2792893,5933028
2020-10-06,NASDAQ (Q),532344434,238955320,1007316317,1778616071,21479372017.416401,16392936086.830107,59082460823.317454,96954768927.563962,5327177,1229906,7273825,13830908
2020-10-06,Members Exchange (U),277341,11152,5115,293608,9205147.580000,3144357.710000,3234289.120000,15583794.410000,2204,127,108,2439
2020-10-06,Investors Exchange (V),141706575,19303474,89760708,250770757,6963076857.876800,1251422978.407000,6248993780.913499,14463493617.197299,1398971,104358,975638,2478967
2020-10-06,NASDAQ PSX (X),33728993,26216152,22852388,82797533,810856686.458400,1428535368.185200,1513733750.759300,3753125805.402900,193572,123775,190300,507647
2020-10-06,BYX Equities (Y),76220865,46284379,51277766,173783010,2056399339.067900,2516862066.605200,2460478251.788200,7033739657.461300,850542,233944,555857,1640343
2020-10-06,BZX Equities (Z),233542410,153009897,179262313,565814620,8325874504.421298,11403442717.894106,11569425622.685906,31298742845.001310,2320077,774361,1848779,4943217
2020-10-05,NYSE American (A),10368072,20923510,7225861,38517443,337428189.026200,694969364.381500,490086789.689500,1522484343.097200,136262,88229,91115,315606
2020-10-05,NASDAQ BX (B),25785456,14976068,22880616,63642140,943765918.137800,905053004.176400,1174659976.766700,3023478899.080900,377435,88000,294592,760027
2020-10-05,NYSE National (C),63235082,28119213,26257604,117611899,1274251048.806800,1045864507.974500,815370011.835900,3135485568.617200,579441,139241,293262,1011944
2020-10-05,FINRA / Nasdaq TRF Chicago (DB),6205018,1907376,10827503,18939897,221426333.151500,84711691.263700,607730987.584400,913869011.999600,29510,7378,59349,96237
2020-10-05,FINRA / NYSE TRF (DN),265063716,104258084,465466926,834788726,7495409768.802801,3077292322.966001,18857605395.323499,29430307487.092301,1218982,287714,1824820,3331516
2020-10-05,FINRA / Nasdaq TRF Carteret (DQ),1180535058,400130331,1332539284,2913204673,44147057236.502491,20435424190.482300,63524674410.005481,128107155836.990272,4689611,1114983,4942063,10746657
2020-10-05,MIAX Pearl (H),1,0,111,112,54.910000,0.000000,3548.300000,3603.210000,1,0,6,7
2020-10-05,EDGA Equities (J),52959625,24375321,39194089,116529035,2320262124.526800,1218533453.041900,2369249632.170000,5908045209.738700,739328,148353,576585,1464266
2020-10-05,EDGX Equities (K),240631069,96303173,279726960,616661202,7348201830.330003,4633753276.499603,11348254819.357398,23330209926.187004,1725943,420235,1767293,3913471
2020-10-05,LTSE (L),0,3600,0,3600,0.000000,240480.000000,0.000000,240480.000000,0,40,0,40
2020-10-05,NYSE Chicago (M),9635429,5411590,3165929,18212948,449395733.364800,427279495.030000,710182949.305000,1586858177.699800,7611,1544,8220,17375
2020-10-05,NYSE (N),851060844,37460293,52828557,941349694,34729431586.593206,1888934003.985500,2542091869.393300,39160457459.972006,2882379,111879,378119,3372377
2020-10-05,NYSE Arca (P),181904029,234120339,269857529,685881897,6346244229.052399,13927404949.226892,14332807091.805805,34606456270.085096,1586866,770922,2268720,4626508
2020-10-05,NASDAQ (Q),410518871,150475939,829090738,1390085548,17252673959.880294,9499468483.028498,48937211519.668980,75689353962.577772,4351153,775978,5853578,10980709
2020-10-05,Members Exchange (U),327774,14265,22197,364236,12445703.510000,4003197.560000,2151128.332000,18600029.402000,3056,175,170,3401
2020-10-05,Investors Exchange (V),123269742,14565478,90113867,227949087,6529867934.449600,868300117.520400,6861006439.456197,14259174491.426197,1153381,86958,874454,2114793
2020-10-05,NASDAQ PSX (X),23936191,16710590,16697101,57343882,554942738.530900,863556768.772000,1058556007.585900,2477055514.888800,147455,79232,139786,366473
2020-10-05,BYX Equities (Y),66618430,33778841,41912701,142309972,1975582777.771600,1881350121.330400,1985838521.035600,5842771420.137600,766366,168082,484967,1419415
2020-10-05,BZX Equities (Z),180674719,89096503,136122128,405893350,6630058869.099600,5719206263.151402,8209553562.575300,20558818694.826302,1911113,463810,1417242,3792165
2020-10-02,NYSE American (A),12602497,29637184,9547990,51787671,340912848.181900,933308685.234200,661743009.786200,1935964543.202300,168924,123202,119188,411314
2020-10-02,NASDAQ BX (B),28999166,19021968,23285216,71306350,1071685288.602100,1266072026.012100,1619035096.130300,3956792410.744500,424828,114737,325626,865191
2020-10-02,NYSE National (C),67483295,36514046,30648060,134645401,1290711609.203300,1312896122.115200,893591992.014700,3497199723.333200,605620,177153,315553,1098326
2020-10-02,FINRA / Nasdaq TRF Chicago (DB),6505049,2875715,9773309,19154073,279475552.139900,116058295.065800,711704584.187200,1107238431.392900,31377,9498,56627,97502
2020-10-02,FINRA / NYSE TRF (DN),273311557,139132878,459365036,871809471,8390731631.701099,4114281567.406902,23285502481.799398,35790515680.907399,1252154,360113,1826411,3438678
2020-10-02,FINRA / Nasdaq TRF Carteret (DQ),1188015169,482812070,1278645934,2949473173,45037239990.640621,25188594769.370613,71529907456.793404,141755742216.804638,4830922,1436684,4800491,11068097
2020-10-02,MIAX Pearl (H),0,0,303,303,0.000000,0.000000,14790.100000,14790.100000,0,0,4,4
2020-10-02,EDGA Equities (J),58051836,34769528,43463065,136284429,2403771211.401500,1738775075.534400,2739541783.277501,6882088070.213401,770000,201274,600884,1572158
2020-10-02,EDGX Equities (K),274573586,139800339,278685961,693059886,8238693723.779301,6699306340.123501,15903728946.704402,30841729010.607204,1924822,635931,2026744,4587497
2020-10-02,LTSE (L),0,0,200,200,0.000000,0.000000,1045.000000,1045.000000,0,0,2,2
2020-10-02,NYSE Chicago (M),6461893,9180545,7112220,22754658,341712601.816200,1229349432.189800,1199420257.863300,2770482291.869300,6730,6268,11972,24970
2020-10-02,NYSE (N),900683458,55567435,66676276,1022927169,34378579686.684508,2940414810.687900,3511934627.454900,40830929124.827308,3344835,175919,445499,3966253
2020-10-02,NYSE Arca (P),223214914,322829387,293855367,839899668,7866975630.454698,20512363953.792498,20064771618.399183,48444111202.646379,1894779,1126179,2570728,5591686
2020-10-02,NASDAQ (Q),480794325,226235466,894239049,1601268840,19271851393.136007,14869390883.254209,58835954474.065295,92977196750.455511,5036734,1191756,6784922,13013412
2020-10-02,Members Exchange (U),516656,15858,11075,543589,18922068.270000,4385385.420000,2853651.749400,26161105.439400,4384,183,146,4713
2020-10-02,Investors Exchange (V),132661868,17637039,91319042,241617949,6681396384.825700,1167331998.335700,7016876451.305999,14865604834.467399,1205517,99183,881903,2186603
2020-10-02,NASDAQ PSX (X),29956429,24291473,21669254,75917156,705700845.610500,1316696984.748300,1761498419.387700,3783896249.746500,174649,116000,195210,485859
2020-10-02,BYX Equities (Y),72083739,40583854,46480791,159148384,2257466886.394800,2413454901.996000,3018484161.476800,7689405949.867600,872119,212849,577055,1662023
2020-10-02,BZX Equities (Z),219267258,145582930,176734482,541584670,7919912258.097702,9747419743.695206,13157773742.236302,30825105744.029210,2183024,764433,1775565,4723022
2020-10-01,NYSE American (A),12594205,20989098,8944572,42527875,402499675.484000,795095284.645000,554772338.760100,1752367298.889100,201116,90469,126667,418252
2020-10-01,NASDAQ BX (B),31329946,18971298,22808158,73109402,1096235996.509500,1278300935.386800,1387139533.963500,3761676465.859800,450847,106012,339175,896034
2020-10-01,NYSE National (C),69953525,38695467,32977225,141626217,1356219378.540000,1477512985.789700,1090286962.738700,3924019327.068400,620602,180874,343748,1145224
2020-10-01,FINRA / Nasdaq TRF Chicago (DB),6304338,2182979,10935709,19423026,256917567.756400,104998389.369900,597128668.625600,959044625.751900,30337,7537,54443,92317
2020-10-01,FINRA / NYSE TRF (DN),276185524,111580288,492466096,880231908,8474298303.006598,4374828356.070398,20950181404.973804,33799308064.050800,1327530,294062,1796378,3417970
2020-10-01,FINRA / Nasdaq TRF Carteret (DQ),1236620500,516724917,1436384286,3189729703,45845873862.034210,34162853428.933125,72729043745.375541,152737771036.342876,5030470,1277177,5054076,11361723
2020-10-01,MIAX Pearl (H),0,0,300,300,0.000000,0.000000,9340.000000,9340.000000,0,0,3,3
2020-10-01,EDGA Equities (J),63454865,36406921,51247643,151109429,2807368244.880300,1946975812.929300,3043450287.117399,7797794344.926999,891336,201254,714368,1806958
2020-10-01,EDGX Equities (K),272085094,112265602,301386002,685736698,8604078233.080000,6098516346.469100,15097298337.993900,29799892917.543000,2069408,505704,2090906,4666018
2020-10-01,LTSE (L),0,0,2774,2774,0.000000,0.000000,15589.880000,15589.880000,0,0,38,38
2020-10-01,NYSE Chicago (M),9801833,12265615,6664448,28731896,479326044.221800,1223686158.295000,1751072879.842500,3454085082.359300,5958,5091,6710,17759
2020-10-01,NYSE (N),859127785,44120086,66685278,969933149,35049510479.897597,2508848879.934500,3026468506.264600,40584827866.096697,3443355,138184,440452,4021991
2020-10-01,NYSE Arca (P),220048050,287511664,301222662,808782376,7800701142.974502,18710256857.132395,16188561008.894501,42699519009.001398,1994130,943536,2681353,5619019
2020-10-01,NASDAQ (Q),544644858,191501079,929746459,1665892396,23419771043.401902,12939647272.745301,56517966774.690206,92877385090.837409,5672700,1004004,7180840,13857544
2020-10-01,Members Exchange (U),479054,13200,10634,502888,15178956.615000,3673357.310000,2544514.983800,21396828.908800,4426,164,116,4706
2020-10-01,Investors Exchange (V),153936893,19164548,111308060,284409501,8306032423.387899,1141190229.815500,8178452311.847998,17625674965.051397,1373541,104598,1025231,2503370
2020-10-01,NASDAQ PSX (X),27904574,21561736,20446511,69912821,675237498.162300,1215232503.323100,1342048172.852700,3232518174.338100,177410,99738,170788,447936
2020-10-01,BYX Equities (Y),76664573,41230917,44861182,162756672,2342243068.930400,2405761860.429700,2282557429.669800,7030562359.029900,917086,196615,552107,1665808
2020-10-01,BZX Equities (Z),215206467,120329977,167806754,503343198,7984576113.436399,8123200187.868099,10932271500.481093,27040047801.785591,2324515,615991,1714321,4654827
2020-09-30,NYSE American (A),15066690,27677001,9107398,51851089,454025723.058400,1002049931.220500,620466378.649800,2076542032.928700,223591,103590,136356,463537
2020-09-30,NASDAQ BX (B),33131864,18931781,23950031,76013676,1097305967.411400,1207913822.559800,1253304412.531000,3558524202.502200,435037,107501,308988,851526
2020-09-30,NYSE National (C),77915523,35317915,32672843,145906281,1515736796.789100,1378410635.507800,1053231918.611800,3947379350.908700,709005,174033,364853,1247891
2020-09-30,FINRA / Nasdaq TRF Chicago (DB),8472938,2147109,11290132,21910179,330694309.121700,112135841.274400,684922106.730700,1127752257.126800,38749,8061,56295,103105
2020-09-30,FINRA / NYSE TRF (DN),308497470,120187092,532884457,961569019,9553453044.039308,4526516286.608202,21941738979.078001,36021708309.725511,1442161,303474,1886536,3632171
2020-09-30,FINRA / Nasdaq TRF Carteret (DQ),1366795497,498359981,1450164200,3315319678,51999488007.083284,30912031340.063513,72037959724.517766,154949479071.664563,5204305,1170785,4967933,11343023
2020-09-30,MIAX Pearl (H),0,0,152,152,0.000000,0.000000,4741.530000,4741.530000,0,0,3,3
2020-09-30,EDGA Equities (J),69454394,35520304,53431452,158406150,3087189565.919000,1807336241.054800,3059811936.067999,7954337743.041799,933397,200039,701970,1835406
2020-09-30,EDGX Equities (K),295228691,122909638,326242319,744380648,8952810846.332799,6713315721.038099,14262525819.300009,29928652386.670907,2077858,524765,2053652,4656275
2020-09-30,NYSE Chicago (M),5265947,11407006,3378770,20051723,378069330.461000,1823435527.720000,497486865.967500,2698991724.148500,5843,5490,7173,18506
2020-09-30,NYSE (N),1267839243,54050936,59571713,1381461892,50001115523.545995,3065052550.472000,2999337024.589100,56065505098.607095,3532566,154671,421603,4108840
2020-09-30,NYSE Arca (P),227968196,297996178,316515036,842479410,8225827890.883601,19942877303.347891,16165262673.616204,44333967867.847696,2059899,995577,2602476,5657952
2020-09-30,NASDAQ (Q),605196063,209189671,1109254629,1923640363,26181305550.614602,14675299525.383895,69557515679.460818,110414120755.459315,5860580,1014789,7146346,14021715
2020-09-30,Members Exchange (U),501436,20170,12364,533970,13447726.580000,5614887.370000,4176405.562000,23239019.512000,3139,225,129,3493
2020-09-30,Investors Exchange (V),122793068,18549464,74794991,216137523,5765883473.525800,1371150656.082600,4349956499.633800,11486990629.242200,1092938,95723,710549,1899210
2020-09-30,NASDAQ PSX (X),29065206,23602119,22544521,75211846,709122982.413700,1363123234.709500,1463258423.985200,3535504641.108400,192534,108563,187305,488402
2020-09-30,BYX Equities (Y),81908625,40561772,54785750,177256147,2401256412.616500,2302263158.757600,2254483714.610300,6958003285.984400,919822,188590,546723,1655135
2020-09-30,BZX Equities (Z),223542999,134780217,180036492,538359708,8577310202.200700,9454293248.764600,11288642476.755298,29320245927.720598,2357722,658760,1793774,4810256
2020-09-29,NYSE American (A),11357151,30763066,7481572,49601789,350321124.775500,604762172.009000,445671505.780600,1400754802.565100,154951,105590,101135,361676
2020-09-29,NASDAQ BX (B),31569290,13479601,20006271,65055162,1106139952.580000,758798470.441400,1328745850.499900,3193684273.521300,414006,81333,288958,784297
2020-09-29,NYSE National (C),67677622,26897999,25582382,120158003,1162162269.253600,962472953.558600,804023485.835800,2928658708.648000,532050,129646,267984,929680
2020-09-29,FINRA / Nasdaq TRF Chicago (DB),6400810,2452932,9139273,17993015,237191660.603900,89930876.114500,598915169.148600,926037705.867000,27888,8965,49171,86024
2020-09-29,FINRA / NYSE TRF (DN),280481449,151959924,461063059,893504432,7799108080.756504,3682485295.563602,20937157222.731222,32418750599.051328,1231892,364610,1778060,3374562
2020-09-29,FINRA / Nasdaq TRF Carteret (DQ),1150056293,462728679,1202058450,2814843422,40604708285.355409,19936804122.003594,64591162671.334938,125132675078.693941,4558006,1257861,4481822,10297689
2020-09-29,MIAX Pearl (H),0,0,2075,2075,0.000000,0.000000,63766.610000,63766.610000,0,0,28,28
2020-09-29,EDGA Equities (J),60042107,25738775,44346004,130126886,2449708155.160800,1200177525.004600,2640760469.375999,6290646149.541399,803277,150374,627690,1581341
2020-09-29,EDGX Equities (K),251542637,105391888,250246691,607181216,7110413602.020898,4366189069.281497,11702351618.756699,23178954290.059094,1767300,461794,1787844,4016938
2020-09-29,NYSE Chicago (M),7906065,6205433,4605603,18717101,308435225.328300,691902946.465000,856796323.610100,1857134495.403400,4945,2766,6646,14357
2020-09-29,NYSE (N),701047471,36777991,49348033,787173495,27002111830.835194,1775413821.302200,2279018334.721900,31056543986.859294,2843316,107439,363328,3314083
2020-09-29,NYSE Arca (P),190050193,245431927,253913565,689395685,6104596540.383398,13355925649.665393,12743186804.932296,32203708994.981087,1605645,819985,2319261,4744891
2020-09-29,NASDAQ (Q),511455692,164321501,810949196,1486726389,20290041959.511610,9434146414.370802,48525740071.536879,78249928445.419291,5009970,837883,6395821,12243674
2020-09-29,Members Exchange (U),753597,5845,11531,770973,16477899.300000,1604317.930000,2483103.875800,20565321.105800,4384,79,109,4572
2020-09-29,Investors Exchange (V),97637986,12706920,55694246,166039152,4081006388.472300,782792376.739600,3868878939.823700,8732677705.035600,853984,73127,572584,1499695
2020-09-29,NASDAQ PSX (X),26415811,15207121,17053385,58676317,549736211.813400,838228056.076100,986695535.237600,2374659803.127100,151541,76429,141951,369921
2020-09-29,BYX Equities (Y),73423880,30271407,37278705,140973992,2043733846.085200,1534747008.104800,1784484201.442200,5362965055.632200,859653,152973,470042,1482668
2020-09-29,BZX Equities (Z),193772794,97167942,140269483,431210219,6665395998.750301,5822699922.435596,8535173851.282500,21023269772.468397,2026916,500925,1499431,4027272
2020-09-28,NYSE American (A),12956812,22158772,8721581,43837165,353002096.352600,836431742.490900,511430921.331600,1700864760.175100,160409,90558,105837,356804
2020-09-28,NASDAQ BX (B),28525581,14843981,21094165,64463727,828721147.797700,924832872.651200,1153310337.987800,2906864358.436700,344773,85315,281853,711941
2020-09-28,NYSE National (C),71557849,32344115,27187421,131089385,1195081584.997500,1164944067.162000,906418000.123000,3266443652.282500,540477,148839,272462,961778
2020-09-28,FINRA / Nasdaq TRF Chicago (DB),6941327,2044904,10394990,19381221,257075525.380800,89779247.917800,604646818.430900,951501591.729500,29830,7504,58086,95420
2020-09-28,FINRA / NYSE TRF (DN),299062678,117307399,489497365,905867442,8336221722.694202,4219389040.960101,22281198112.247715,34836808875.902018,1298916,289874,1941722,3530512
2020-09-28,FINRA / Nasdaq TRF Carteret (DQ),1175718219,403537736,1211805334,2791061289,41464288923.371187,22986704154.718700,68971276647.175020,133422269725.264907,4594445,1052012,4678194,10324651
2020-09-28,EDGA Equities (J),62114922,29012686,45955122,137082730,2425015927.857600,1360484802.828900,2859460515.729300,6644961246.415800,793623,159386,632268,1585277
2020-09-28,EDGX Equities (K),263166418,89099100,267950403,620215921,6894103930.661799,4632592166.007697,13151729359.484204,24678425456.153700,1798951,405394,1895116,4099461
2020-09-28,NYSE Chicago (M),3130843,3427674,3987132,10545649,240412675.042000,545525895.780000,582600750.836000,1368539321.658000,4513,4448,8271,17232
2020-09-28,NYSE (N),854520382,40641564,55099198,950261144,33083325103.346198,2063844571.955100,2686907106.116900,37834076781.418198,3145191,118906,376303,3640400
2020-09-28,NYSE Arca (P),224092461,230016335,277682890,731791686,6548006680.793504,13728821832.656989,14474295990.627895,34751124504.078388,1725012,765405,2426874,4917291
2020-09-28,NASDAQ (Q),538340965,166715579,898511383,1603567927,21065737427.760390,10416009792.851305,58808594492.244171,90290341712.855866,5130520,844650,6835586,12810756
2020-09-28,Members Exchange (U),338285,0,8460,346745,10346940.700000,0.000000,2696634.442500,13043575.142500,3592,0,88,3680
2020-09-28,Investors Exchange (V),94011802,16328967,58033226,168373995,4082806932.618300,1013020473.201200,3708016615.093500,8803844020.913000,914888,83082,614591,1612561
2020-09-28,NASDAQ PSX (X),28205798,16408798,19604198,64218794,568000886.467400,885833194.705200,1376634395.705800,2830468476.878400,162603,72561,163058,398222
2020-09-28,BYX Equities (Y),77661647,32730681,41177345,151569673,2021477245.997600,1651140124.240000,2068736021.665800,5741353391.903400,854535,153233,501839,1509607
2020-09-28,BZX Equities (Z),210571614,98878298,155039144,464489056,6964493105.259900,5972326583.325598,10060117689.929403,22996937378.514901,2081852,495773,1587909,4165534
2020-09-25,NYSE American (A),11507802,21460273,8953070,41921145,320050999.315400,846392781.606700,581665162.717400,1748108943.639500,152896,86794,108089,347779
2020-09-25,NASDAQ BX (B),24881735,15750570,21557640,62189945,824746003.271300,1040186043.805500,1261091072.869800,3126023119.946600,325025,90301,275337,690663
2020-09-25,NYSE National (C),63174676,30994410,30120361,124289447,1171069620.110400,1114086517.051400,880975980.256400,3166132117.418200,543195,144504,299303,987002
2020-09-25,FINRA / Nasdaq TRF Chicago (DB),5599407,2497180,12251996,20348583,189287086.767000,91202214.006600,678044541.074100,958533841.847700,23688,6925,52383,82996
2020-09-25,FINRA / NYSE TRF (DN),305601055,126750814,529721889,962073758,7212274463.919801,3568863013.210603,23524287155.213994,34305424632.344398,1179125,266221,1840609,3285955
2020-09-25,FINRA / Nasdaq TRF Carteret (DQ),1165680873,406548250,1326018448,2898247571,38930391200.205101,22427622321.665799,72502030163.305889,133860043685.176789,4398151,1149826,4700063,10248040
2020-09-25,EDGA Equities (J),57288341,30440171,46321941,134050453,2353115467.411000,1493278627.666200,2750550629.463599,6596944724.540799,747729,163047,614707,1525483
2020-09-25,EDGX Equities (K),253393965,99536881,284341370,637272216,6397571940.784399,5458106198.848997,11986145965.891792,23841824105.525188,1730583,451696,1839521,4021800
2020-09-25,NYSE Chicago (M),6035429,11998253,6393574,24427256,420041175.460000,1048876840.030000,962776830.106000,2431694845.596000,6833,1790,8589,17212
2020-09-25,NYSE (N),800219539,48015089,57603929,905838557,30233120152.327698,2604930464.906501,2707410921.677500,35545461538.911699,3001031,133767,407880,3542678
2020-09-25,NYSE Arca (P),215308631,245899738,293517774,754726143,6115917107.169703,15272561651.447007,15359617849.389498,36748096608.006208,1661314,814274,2440625,4916213
2020-09-25,NASDAQ (Q),506335474,185203828,889432963,1580972265,19938467972.011597,11797849271.316699,55496320245.931603,87232637489.259899,4981132,917921,6716010,12615063
2020-09-25,Members Exchange (U),235090,0,8374,243464,7614514.460000,0.000000,1012085.311000,8626599.771000,2800,0,81,2881
2020-09-25,Investors Exchange (V),95004215,14230773,59529024,168764012,4402674600.332700,965656328.768100,3750643560.764200,9118974489.865000,943232,76344,647578,1667154
2020-09-25,NASDAQ PSX (X),26919234,20229246,18334875,65483355,572799195.805000,1003539404.261200,1451831757.190401,3028170357.256601,165009,96074,175329,436412
2020-09-25,BYX Equities (Y),66717298,32621616,40798016,140136930,1802271556.656600,1865158718.693900,1895011800.726300,5562442076.076800,772324,156488,479796,1408608
2020-09-25,BZX Equities (Z),199434305,114448717,160371389,474254411,6616855204.717600,7431101597.823600,10167771115.480797,24215727918.021997,2020697,535862,1563273,4119832
2020-09-24,NYSE American (A),14605103,28610355,8724430,51939888,370571585.946200,820652437.905100,514158730.244400,1705382754.095700,162723,114580,112468,389771
2020-09-24,NASDAQ BX (B),54647135,21883156,29801326,106331617,1017536669.416500,1355131288.034100,1487197900.696701,3859865858.147301,408939,129738,334364,873041
2020-09-24,NYSE National (C),72928494,45033467,30923777,148885738,1284985044.456600,1500454466.809700,1054448711.788500,3839888223.054800,588097,203676,314366,1106139
2020-09-24,FINRA / Nasdaq TRF Chicago (DB),8352500,3388885,12331636,24073021,246574343.324700,128327333.194000,963778345.641200,1338680022.159900,31037,9334,70848,111219
2020-09-24,FINRA / NYSE TRF (DN),371214956,157694312,541244449,1070153717,8519722659.446996,4739245203.442901,28180269191.724373,41439237054.614270,1354616,337425,2107252,3799293
2020-09-24,FINRA / Nasdaq TRF Carteret (DQ),1343705428,541621153,1397743914,3283070495,43161778768.124300,26439753149.630199,82991686675.134879,152593218592.889378,5184279,1365399,5287964,11837642
2020-09-24,EDGA Equities (J),71343917,44082710,51958749,167385376,2698340869.004700,1901672866.078900,2977795534.075300,7577809269.158900,894435,237168,713761,1845364
2020-09-24,EDGX Equities (K),325579876,131429080,281857239,738866195,7450994342.740899,6841161448.419403,12695190772.312387,26987346563.472689,2113497,624694,1999514,4737705
2020-09-24,LTSE (L),0,0,200,200,0.000000,0.000000,774.000000,774.000000,0,0,1,1
2020-09-24,NYSE Chicago (M),9117101,6805822,5822472,21745395,517774555.561000,638749091.780000,1130224606.196400,2286748253.537400,8740,1839,10743,21322
2020-09-24,NYSE (N),927745324,63925502,68117911,1059788737,32689044697.988105,3169307111.595700,3179807930.320000,39038159739.903805,3835531,188445,468166,4492142
2020-09-24,NYSE Arca (P),272049113,340057803,333273203,945380119,7296161886.642798,20682253184.950484,19064644628.524303,47043059700.117585,2050486,1185618,2920379,6156483
2020-09-24,NASDAQ (Q),661815586,255576158,1008700387,1926092131,24241296944.215908,15851760432.749702,61948753137.928418,102041810514.894028,6329604,1312247,8384011,16025862
2020-09-24,Members Exchange (U),368847,0,17718,386565,8801169.060000,0.000000,5881303.958700,14682473.018700,3875,0,142,4017
2020-09-24,Investors Exchange (V),102524759,18758404,65052247,186335410,4879789646.127000,1199758263.091600,4303446533.560502,10382994442.779102,953700,101274,663165,1718139
2020-09-24,NASDAQ PSX (X),32228562,28105654,19636349,79970565,677107930.339700,1406663870.880600,1290876554.106800,3374648355.327100,192656,137337,198782,528775
2020-09-24,BYX Equities (Y),80937896,48766869,45793924,175498689,2107484496.569500,2547908702.491200,2188821547.135200,6844214746.195900,933066,226420,550752,1710238
2020-09-24,BZX Equities (Z),252763546,160803483,185366789,598933818,7626522523.153498,9523042814.707799,11281838572.210598,28431403910.071895,2412023,811086,1841269,5064378
2020-09-23,NYSE American (A),14490167,29202345,10221608,53914120,437007266.171300,1145583830.767200,654148270.978800,2236739367.917300,162299,113351,117505,393155
2020-09-23,NASDAQ BX (B),36034194,19462030,30456536,85952760,1097015524.817700,1097098834.982700,1535006039.313800,3729120399.114200,394267,111300,350666,856233
2020-09-23,NYSE National (C),67597107,40356898,31318700,139272705,1327818238.892200,1374967134.235100,1014213544.617900,3716998917.745200,570987,173027,306188,1050202
2020-09-23,FINRA / Nasdaq TRF Chicago (DB),7951131,3321981,11284151,22557263,296802156.983500,114804534.407900,866696175.803500,1278302867.194900,34665,9549,72309,116523
2020-09-23,FINRA / NYSE TRF (DN),319205993,139984221,535164407,994354621,9321893835.048397,4286976748.807001,28453845563.907799,42062716147.763197,1475855,373860,2348949,4198664
2020-09-23,FINRA / Nasdaq TRF Carteret (DQ),1263886416,570978242,1357416425,3192281083,44873665732.900793,33003612360.844300,79337480116.316825,157214758210.061918,5217346,1324244,5651678,12193268
2020-09-23,EDGA Equities (J),68817126,38514747,54806270,162138143,2878531386.424400,1721127567.041400,3167191011.221600,7766849964.687400,891039,211979,709016,1812034
2020-09-23,EDGX Equities (K),300867544,136315332,301481523,738664399,8409136865.311805,7000140992.109202,14174636321.305691,29583914178.726698,2191930,625367,2183984,5001281
2020-09-23,LTSE (L),200,0,0,200,4772.000000,0.000000,0.000000,4772.000000,2,0,0,2
2020-09-23,NYSE Chicago (M),6678376,11535543,5641748,23855667,488413267.055000,1345837449.253000,957660837.184500,2791911553.492500,8332,1619,11217,21168
2020-09-23,NYSE (N),1002648213,56323705,64701879,1123673797,39188534070.168003,2955098066.693199,3207084138.857800,45350716275.719002,3684788,173014,453038,4310840
2020-09-23,NYSE Arca (P),234976831,321576090,327761279,884314200,8012682535.457499,19792320473.876600,19440458777.594694,47245461786.928793,2020002,1142632,2934684,6097318
2020-09-23,NASDAQ (Q),616240923,231926054,1061702164,1909869141,25260062414.354406,15100382927.399306,68534234616.193007,108894679957.946719,5967714,1172063,8183409,15323186
2020-09-23,Members Exchange (U),298272,0,27422,325694,9296103.450000,0.000000,11275202.206500,20571305.656500,3179,0,224,3403
2020-09-23,Investors Exchange (V),99341392,18727623,66394585,184463600,4831856273.481300,1163444934.534700,4258021404.755000,10253322612.771000,954691,97308,675710,1727709
2020-09-23,NASDAQ PSX (X),32432182,25491615,21205423,79129220,709377776.117600,1387183352.405200,1288854236.504200,3385415365.027000,188464,123979,196394,508837
2020-09-23,BYX Equities (Y),78606292,43032635,47522143,169161070,2250959798.057300,2156157126.412801,2294466090.545500,6701583015.015601,923783,202972,547041,1673796
2020-09-23,BZX Equities (Z),228581639,137196325,170216416,535994380,7943557107.487801,8951675880.693096,11451775688.096805,28347008676.277702,2320781,687045,1775858,4783684
2020-09-22,NYSE American (A),13152044,23134209,8049004,44335257,388009453.267600,789862948.172400,564282031.278300,1742154432.718300,163622,92091,112632,368345
2020-09-22,NASDAQ BX (B),33109814,16713763,24972436,74796013,1076025330.945600,1061489928.648700,1343355897.605500,3480871157.199800,379329,94791,294861,768981
2020-09-22,NYSE National (C),60280813,36451143,28377291,125109247,1193081749.465700,1221713881.184700,923323335.950400,3338118966.600800,518775,148151,288521,955447
2020-09-22,FINRA / Nasdaq TRF Chicago (DB),5926885,2410236,9752659,18089780,216250462.797100,92672449.635700,813940357.294000,1122863269.726800,26791,7889,56567,91247
2020-09-22,FINRA / NYSE TRF (DN),280369276,117159394,453804277,851332947,7809056434.211800,3466849885.475600,27444491150.032413,38720397469.719813,1244853,298696,1931040,3474589
2020-09-22,FINRA / Nasdaq TRF Carteret (DQ),1183740471,444276793,1209484595,2837501859,42848894353.449306,24064696485.574706,77743442215.492236,144657033054.516248,4717204,1134683,4790847,10642734
2020-09-22,EDGA Equities (J),59702195,32601798,44908105,137212098,2695211830.537700,1484838768.195700,3016585116.875500,7196635715.608900,820000,173438,639567,1633005
2020-09-22,EDGX Equities (K),247936156,99811401,233900074,581647631,7253956806.910303,5115858851.652998,12888234379.268797,25258050037.832098,1820624,463882,1727834,4012340
2020-09-22,NYSE Chicago (M),7017349,5720929,8275725,21014003,652269746.157600,484238048.846500,1397623901.805300,2534131696.809400,9032,2155,9799,20986
2020-09-22,NYSE (N),947252915,40298434,56236864,1043788213,38424275327.980199,2109916075.618300,3273949940.427001,43808141344.025500,3169461,121477,408446,3699384
2020-09-22,NYSE Arca (P),204083689,237706665,253331315,695121669,7012689289.478500,15002356218.487809,18852987780.788009,40868033288.754318,1751761,837950,2487692,5077403
2020-09-22,NASDAQ (Q),530496770,176949001,903110434,1610556205,22463030094.601705,11404459672.773007,64231271038.021799,98098760805.396511,5292642,907588,7011133,13211363
2020-09-22,Members Exchange (U),160267,0,20792,181059,5219381.385000,0.000000,4530606.649000,9749988.034000,1898,0,183,2081
2020-09-22,Investors Exchange (V),100641448,16101948,62711990,179455386,4901587820.795000,939184066.964900,4743833866.410999,10584605754.170899,972244,80779,659025,1712048
2020-09-22,NASDAQ PSX (X),27932608,18431519,17128281,63492408,637953526.424800,1002446236.476400,1147632594.656500,2788032357.557700,164064,87710,163607,415381
2020-09-22,BYX Equities (Y),68227955,37977402,40621545,146826902,2118951647.333000,1917850841.941500,2107399509.556600,6144201998.831100,851867,165272,502090,1519229
2020-09-22,BZX Equities (Z),204480274,104033791,160756839,469270904,7415999206.404497,6711885128.373399,12181761959.264499,26309646294.042395,2124944,534495,1686181,4345620
2020-09-21,NYSE American (A),15744908,38288698,9173125,63206731,471596227.764900,1340814714.301700,633609563.740900,2446020505.807500,177993,128200,116614,422807
2020-09-21,NASDAQ BX (B),32940543,24109609,27600069,84650221,1078949383.718700,1454713347.777801,1638697902.239400,4172360633.735901,395964,147073,322637,865674
2020-09-21,NYSE National (C),73469301,48107529,30928421,152505251,1435108809.435600,1710041147.790900,1100173084.721200,4245323041.947700,577986,210483,307560,1096029
2020-09-21,FINRA / Nasdaq TRF Chicago (DB),8474879,4028034,10625225,23128138,299713779.428400,158656131.472900,980437720.204700,1438807631.106000,40281,15036,71695,127012
2020-09-21,FINRA / NYSE TRF (DN),327698067,175549647,492116211,995363925,9300616167.574599,5452320896.582998,31484083553.266108,46237020617.423705,1665894,469660,2289338,4424892
2020-09-21,FINRA / Nasdaq TRF Carteret (DQ),1360006257,603691536,1275717045,3239414838,49811349849.201016,32416624665.352588,89983565036.028299,172211539550.581903,6015827,1840187,5534721,13390735
2020-09-21,EDGA Equities (J),74182331,47845864,54745432,176773627,3093185243.134900,2144050195.885500,3714241968.203800,8951477407.224200,946020,261944,750831,1958795
2020-09-21,EDGX Equities (K),309381503,169402189,245601684,724385376,8789468669.805301,8218455984.196495,16189996065.143500,33197920719.145296,2311195,755854,2048088,5115137
2020-09-21,LTSE (L),0,0,100,100,0.000000,0.000000,26.180000,26.180000,0,0,1,1
2020-09-21,NYSE Chicago (M),4242349,9117644,6639151,19999144,358462753.502600,1358105580.005000,955908376.707800,2672476710.215400,5520,1259,6842,13621
2020-09-21,NYSE (N),1221945021,65752594,66595120,1354292735,47747337632.943604,3414339413.705300,3930012895.703600,55091689942.352504,4321535,201898,481178,5004611
2020-09-21,NYSE Arca (P),257587520,390650083,289311619,937549222,8421999787.904299,24233616859.110091,22987158863.723900,55642775510.738290,2116338,1426760,2820990,6364088
2020-09-21,NASDAQ (Q),678837317,280940079,1100571116,2060348512,27990749822.079599,17914851497.675797,77146039510.972909,123051640830.728305,6687538,1472520,9108122,17268180
2020-09-21,Members Exchange (U),54601,26,6330,60957,1725635.880000,1314.560000,4295347.278400,6022297.718400,463,1,123,587
2020-09-21,Investors Exchange (V),104196461,23831048,62379395,190406904,4776407542.586398,1540928460.848100,4915666960.587800,11233002964.022298,942857,118790,621425,1683072
2020-09-21,NASDAQ PSX (X),35599493,28313861,22072291,85985645,793585806.772300,1487776572.996300,1744918353.558201,4026280733.326801,201804,143596,217754,563154
2020-09-21,BYX Equities (Y),85275513,52466296,44314349,182056158,2449165104.926300,2760189290.048200,2781862472.345000,7991216867.319500,1002569,257989,584608,1845166
2020-09-21,BZX Equities (Z),246434679,173500987,162579058,582514724,8534506067.470902,10965440303.459203,12666909062.953504,32166855433.883609,2452113,854138,1772275,5078526
2020-09-18,NYSE American (A),14190334,70677604,8759133,93627071,380359705.607400,1184668917.812200,626280206.512400,2191308829.932000,140540,103270,104816,348626
2020-09-18,NASDAQ BX (B),32820585,18801862,24350912,75973359,1058894404.848800,1145633097.139600,1665996391.700000,3870523893.688400,393306,108850,338643,840799
2020-09-18,NYSE National (C),81831144,36095657,32811023,150737824,1662381523.870800,1335992501.881500,1141667703.931500,4140041729.683800,656268,159237,320429,1135934
2020-09-18,FINRA / Nasdaq TRF Chicago (DB),6546437,3024876,13135155,22706468,222884116.281500,145845751.626000,849228135.406000,1217958003.313500,28206,8499,65052,101757
2020-09-18,FINRA / NYSE TRF (DN),302880028,120787227,511418699,935085954,8001652835.187497,4619625652.995899,27980716746.023308,40601995234.206704,1362631,302931,2170435,3835997
2020-09-18,FINRA / Nasdaq TRF Carteret (DQ),1661602462,444504205,1626355851,3732462518,58060541165.528595,31331475849.693111,102555791958.587882,191947808973.809588,5304894,1077308,5405238,11787440
2020-09-18,EDGA Equities (J),71433512,35062280,54630477,161126269,3013174087.760600,1740107638.201900,3619710748.646200,8372992474.608700,915938,182837,727877,1826652
2020-09-18,EDGX Equities (K),303739531,114296184,281379264,699414979,8166472454.100600,6605116112.122802,15428149432.374998,30199737998.598400,2119612,544935,2126289,4790836
2020-09-18,NYSE Chicago (M),22138121,17436501,8726206,48300828,925787976.973100,2390400088.888900,3059918901.471001,6376106967.333001,7901,1743,11488,21132
2020-09-18,NYSE (N),3203071433,49251083,64670497,3316993013,119170610954.974027,2772288208.703500,3782394049.278301,125725293212.955828,3910577,151699,499756,4562032
2020-09-18,NYSE Arca (P),255298996,261336052,310222599,826857647,8370926341.090902,18016196156.690197,21654701220.323624,48041823718.104723,2022523,976219,2928774,5927516
2020-09-18,NASDAQ (Q),662784048,203745978,2493729692,3360259718,27764268308.901205,14356946542.114793,146851724276.059629,188972939127.075627,6342970,1089387,8891078,16323435
2020-09-18,Investors Exchange (V),100081870,16410403,64073331,180565604,4632975165.243300,1177475012.785200,4732026353.090099,10542476531.118599,888404,85964,620131,1594499
2020-09-18,NASDAQ PSX (X),34549043,22158892,23044075,79752010,783598259.659600,1249653406.347400,2159238571.124500,4192490237.131500,192402,105030,232800,530232
2020-09-18,BYX Equities (Y),81760073,39499607,51428108,172687788,2394776882.489700,2281892828.222901,2763040615.160901,7439710325.873502,945229,187666,601445,1734340
2020-09-18,BZX Equities (Z),241681004,123985323,190354988,556021315,8454000260.721097,8624042436.647599,13828560444.734201,30906603142.102897,2353859,628054,1877785,4859698
2020-09-17,NYSE American (A),13433902,30512234,7276798,51222934,353578401.782700,922555964.690400,510683445.650100,1786817812.123200,135724,103734,96650,336108
2020-09-17,NASDAQ BX (B),30935342,16871472,20771008,68577822,1062026253.427400,1158280511.939600,1389191955.179200,3609498720.546200,385291,107501,307784,800576
2020-09-17,NYSE National (C),72165044,32316399,26451763,130933206,1394531664.842100,1219333847.978400,973716382.456400,3587581895.276900,574803,149574,295413,1019790
2020-09-17,FINRA / Nasdaq TRF Chicago (DB),6590272,3079331,11048863,20718466,243686366.454500,106609806.497300,825557572.718900,1175853745.670700,28187,8781,66566,103534
2020-09-17,FINRA / NYSE TRF (DN),306369194,165146070,474918142,946433406,8133054830.083401,4192285082.456899,27998004160.733495,40323344073.273795,1297556,337068,2114835,3749459
2020-09-17,FINRA / Nasdaq TRF Carteret (DQ),1258556534,534624041,1269570324,3062750899,45998927617.648092,28214927505.209176,84255713520.902512,158469568643.759780,5212390,1164642,5219437,11596469
2020-09-17,EDGA Equities (J),64926149,31352497,48523356,144802002,2865050880.829100,1559627573.252500,3200094726.762501,7624773180.844101,857064,178634,686783,1722481
2020-09-17,EDGX Equities (K),286679942,133617179,238182779,658479900,7765096917.952501,6244925562.656095,13815216572.728008,27825239053.336604,1966110,563701,1961825,4491636
2020-09-17,LTSE (L),183934,9338,186563,379835,34497520.200000,1670157.000000,116024607.490000,152192284.690000,3393,177,3491,7061
2020-09-17,NYSE Chicago (M),13785729,6495558,7026450,27307737,457464876.532000,1168918911.523000,1192977063.762600,2819360851.817600,6410,1099,8483,15992
2020-09-17,NYSE (N),1062358504,49348860,54695007,1166402371,42589141765.038705,2821534869.503898,3413272796.267902,48823949430.810505,3566932,159661,464026,4190619
2020-09-17,NYSE Arca (P),237516639,271981855,278639900,788138394,7957501243.194000,17200820382.651602,20703999466.064211,45862321091.909813,1966081,1011672,2770787,5748540
2020-09-17,NASDAQ (Q),604911800,207254315,1031985833,1844151948,25804630756.964404,14203039290.787901,72936716299.144737,112944386346.897042,5938381,1106041,8299245,15343667
2020-09-17,Investors Exchange (V),96664890,15278080,60730664,172673634,4829360345.695700,1035113166.253500,4680560460.857900,10545033972.807100,877360,86501,599028,1562889
2020-09-17,NASDAQ PSX (X),30910907,21489709,18852707,71253323,699689096.463400,1182492767.530900,1510376228.213000,3392558092.207300,180273,105876,200448,486597
2020-09-17,BYX Equities (Y),73300012,34798947,39528368,147627327,2192023833.954000,2181978749.492300,2331192410.701700,6705194994.148000,872595,174821,520347,1567763
2020-09-17,BZX Equities (Z),220553469,129521899,151731238,501806606,7731351833.671298,8453281336.159199,11705785225.125402,27890418394.955899,2169979,643445,1673634,4487058
2020-09-16,NYSE American (A),13640886,25716836,6705215,46062937,391442218.697400,709517821.858200,462471781.459600,1563431822.015200,149386,105114,91925,346425
2020-09-16,NASDAQ BX (B),33687208,16322507,21345706,71355421,1307754239.257300,1033439249.549500,1299301124.396100,3640494613.202900,413145,105899,287223,806267
2020-09-16,NYSE National (C),77872033,33198660,29158087,140228780,1495557777.119000,1174907160.831800,931857669.964600,3602322607.915400,604035,141138,286134,1031307
2020-09-16,FINRA / Nasdaq TRF Chicago (DB),7790714,2182326,10415881,20388921,285188766.134600,102789248.523900,788353590.579800,1176331605.238300,33989,8285,59955,102229
2020-09-16,FINRA / NYSE TRF (DN),333027148,132471585,472122800,937621533,10025287400.822197,4411060787.029000,25560067502.871399,39996415690.722596,1499932,329970,2071557,3901459
2020-09-16,FINRA / Nasdaq TRF Carteret (DQ),1402359202,425737052,1256235278,3084331532,54257601746.644111,25447489788.120203,74528082362.229568,154233173896.993882,5841836,1194545,5085217,12121598
2020-09-16,EDGA Equities (J),68228439,30150282,46789553,145168274,3146849073.821300,1479070813.715500,2977776584.596100,7603696472.132900,892360,178712,668323,1739395
2020-09-16,EDGX Equities (K),311680460,115975724,229622284,657278468,9247226374.946797,5960569887.177400,11919159177.519598,27126955439.643795,2168038,523295,1782777,4474110
2020-09-16,LTSE (L),195397,6027,270474,471898,33047935.570000,829091.760000,96622742.510000,130499769.840000,3254,107,5006,8367
2020-09-16,NYSE Chicago (M),12341421,10452475,9514733,32308629,465120438.912600,1994382934.357000,1092422344.006300,3551925717.275900,6887,1575,8796,17258
2020-09-16,NYSE (N),1091923595,46645713,53183570,1191752878,45915111224.358509,2591290046.447600,2718328660.040800,51224729930.846909,3750718,138621,421961,4311300
2020-09-16,NYSE Arca (P),260925303,258091099,270187579,789203981,9182577194.926704,15515958492.030611,18104724952.281894,42803260639.239209,2108040,943458,2603492,5654990
2020-09-16,NASDAQ (Q),653710404,196494190,993224406,1843429000,28270608412.461094,13092830838.533596,64839741336.846000,106203180587.840690,6491621,1054228,7940387,15486236
2020-09-16,Investors Exchange (V),103452445,15499734,63130810,182082989,5250800113.103700,1019983995.773000,4498279988.651700,10769064097.528400,902084,82940,590455,1575479
2020-09-16,NASDAQ PSX (X),32057196,21014223,18648674,71720093,742634860.303600,1170447099.705400,1195761898.303600,3108843858.312600,192654,93369,175654,461677
2020-09-16,BYX Equities (Y),77131446,32211995,39088436,148431877,2414263143.378500,1864601088.011399,2039393322.005300,6318257553.395199,930036,166194,522137,1618367
2020-09-16,BZX Equities (Z),238882555,120264474,158380834,517527863,8545118464.335197,7700077381.641098,10358163781.644096,26603359627.620391,2320548,589966,1597801,4508315
2020-09-15,NYSE American (A),13510103,21063970,7307834,41881907,384353063.875300,630793579.383300,462390017.270000,1477536660.528600,148677,88361,95943,332981
2020-09-15,NASDAQ BX (B),31865444,13432901,25654149,70952494,1052023348.648000,830303809.857000,1343452816.724200,3225779975.229200,403950,87530,297301,788781
2020-09-15,NYSE National (C),67699639,26340594,26256788,120297021,1328964007.662100,960360750.987600,861753323.523100,3151078082.172800,546937,121874,269679,938490
2020-09-15,FINRA / Nasdaq TRF Chicago (DB),7237377,1622132,12009112,20868621,250710898.509600,75133099.905100,943430658.139400,1269274656.554100,30332,6652,67235,104219
2020-09-15,FINRA / NYSE TRF (DN),289573450,103396258,534847975,927817683,8799814216.313203,3207478623.320298,29143402281.273200,41150695120.906701,1335310,276630,2221520,3833460
2020-09-15,FINRA / Nasdaq TRF Carteret (DQ),1248216397,368618227,1351809332,2968643956,44983035066.504503,21152323922.266596,80137500888.559811,146272859877.330910,5350658,1061773,5336364,11748795
2020-09-15,EDGA Equities (J),64260013,23527888,49412074,137199975,2841700389.352200,1185946811.608400,3076848632.107100,7104495833.067700,864781,147540,676310,1688631
2020-09-15,EDGX Equities (K),277610142,85172248,270730316,633512706,8244368800.537103,4319752656.779701,12515994985.115600,25080116442.432404,1974710,418193,1873914,4266817
2020-09-15,LTSE (L),177757,11442,399731,588930,26958630.180000,1916937.310000,126774145.750000,155649713.240000,3292,174,7006,10472
2020-09-15,NYSE Chicago (M),8529262,9961192,7954736,26445190,445875320.358200,1561098664.971100,1203862029.494700,3210836014.824000,5716,1347,5729,12792
2020-09-15,NYSE (N),843790388,35789496,50021232,929601116,34029477973.177401,1886798735.371700,2519736542.232401,38436013250.781502,3240521,112939,409050,3762510
2020-09-15,NYSE Arca (P),220399279,213657179,290791604,724848062,7616293420.884003,13148731163.483593,19257597003.134610,40022621587.502206,1840786,770909,2650261,5261956
2020-09-15,NASDAQ (Q),568632208,155467519,888244516,1612344243,24249022574.796099,9884400179.987198,59928505917.245890,94061928672.029187,5697871,842376,7485900,14026147
2020-09-15,Investors Exchange (V),106973092,12091589,60907622,179972303,4948391589.236200,795033280.535000,4319850044.615503,10063274914.386703,892179,73032,589808,1555019
2020-09-15,NASDAQ PSX (X),27876263,15662750,15902900,59441913,651418959.112100,861201870.752700,1050986566.744100,2563607396.608900,170549,74111,157192,401852
2020-09-15,BYX Equities (Y),74716760,28970456,42807314,146494530,2226988949.940500,1642813661.383700,1824362180.683600,5694164792.007800,873413,149275,491276,1513964
2020-09-15,BZX Equities (Z),206122684,86968319,151055134,444146137,7236469749.698400,5553125811.104496,9380443503.055002,22170039063.857898,2072162,462562,1525930,4060654
2020-09-14,NYSE American (A),13149079,23089057,8100115,44338251,433352717.624600,804503625.209400,532326317.858000,1770182660.692000,162812,93932,106159,362903
2020-09-14,NASDAQ BX (B),30271191,14794152,22423838,67489181,1067233707.782200,958697628.804900,1383660150.715800,3409591487.302900,395144,96555,302485,794184
2020-09-14,NYSE National (C),68309021,30377912,27609085,126296018,1356183449.135700,1082596316.752500,857801701.103800,3296581466.992000,569233,139089,285326,993648
2020-09-14,FINRA / Nasdaq TRF Chicago (DB),5981886,2025574,11257203,19264663,215772558.486400,77922520.535400,888182021.202700,1181877100.224500,24772,7074,67549,99395
2020-09-14,FINRA / NYSE TRF (DN),256402358,101697882,502588045,860688285,7445892836.114300,3400225253.131500,27461425665.132592,38307543754.378392,1243121,276824,2162380,3682325
2020-09-14,FINRA / Nasdaq TRF Carteret (DQ),1148615482,380260933,1300663201,2829539616,41598937807.276007,23132512504.536990,78518056095.837777,143249506407.650774,5048672,1047658,5442410,11538740
2020-09-14,EDGA Equities (J),61732682,25534594,48141719,135408995,2795896144.131400,1315582196.650400,3079877919.844100,7191356260.625900,861456,161654,705637,1728747
2020-09-14,EDGX Equities (K),251615602,91163273,256701765,599480640,7255637991.207198,4740406373.228299,12492087443.344897,24488131807.780394,1901449,447892,1978408,4327749
2020-09-14,LTSE (L),186522,11064,323646,521232,33680653.180000,1607395.270000,137112198.620000,172400247.070000,3579,164,6344,10087
2020-09-14,NYSE Chicago (M),9606791,7419235,15303562,32329588,580977468.139700,1091892447.829000,1096650898.407900,2769520814.376600,5741,669,7299,13709
2020-09-14,NYSE (N),859978549,36848671,49828540,946655760,35335862112.303405,2040691075.662200,2742517105.708300,40119070293.673905,3256141,123069,410800,3790010
2020-09-14,NYSE Arca (P),203487365,225827050,300122403,729436818,6870626215.286500,14623820312.829604,19314020115.958096,40808466644.074200,1761119,841027,2718704,5320850
2020-09-14,NASDAQ (Q),547463728,163955749,937563215,1648982692,23642932396.157398,11450910410.010195,63263880083.584203,98357722889.751796,5620107,886272,7770917,14277296
2020-09-14,Investors Exchange (V),90478838,15094506,60972397,166545741,4116047596.182700,905555492.205200,4226884265.396500,9248487353.784400,864031,84490,600414,1548935
2020-09-14,NASDAQ PSX (X),25490733,16621578,15312462,57424773,585423772.181400,955251274.231500,1009041307.043500,2549716353.456400,163947,84724,152915,401586
2020-09-14,BYX Equities (Y),69428846,32347665,39031341,140807852,2144819902.559400,1809980918.977100,1959942233.870400,5914743055.406900,873076,165548,522553,1561177
2020-09-14,BZX Equities (Z),197382184,94493370,141673671,433549225,6959013684.242301,6589717293.650403,9355780376.277400,22904511354.170104,2032542,503474,1546240,4082256
2020-09-11,NYSE American (A),12352154,26356879,8089726,46798759,342190470.456500,919282592.070900,545057711.136800,1806530773.664200,153372,112013,96851,362236
2020-09-11,NASDAQ BX (B),29698910,19478476,23575816,72753202,1033564958.852800,1089364908.310500,1366680881.454500,3489610748.617800,392453,122680,319955,835088
2020-09-11,NYSE National (C),67561369,34737467,27939328,130238164,1298943500.789800,1234621886.533600,912654232.014600,3446219619.338000,569618,157125,283103,1009846
2020-09-11,FINRA / Nasdaq TRF Chicago (DB),5258960,2639401,11055396,18953757,194799869.747000,115465166.105300,849054256.010500,1159319291.862800,24086,7449,63903,95438
2020-09-11,FINRA / NYSE TRF (DN),235194542,111352603,474447190,820994335,6908848045.302598,3795341419.888902,25041366401.216601,35745555866.408101,1113287,284214,1927077,3324578
2020-09-11,FINRA / Nasdaq TRF Carteret (DQ),1061719322,446195181,1254455491,2762369994,38808585799.347415,24142438495.838225,72504439799.681599,135455464094.867239,4798695,1082778,4975571,10857044
2020-09-11,EDGA Equities (J),61673495,38682186,51576412,151932093,2686896725.249500,1823682007.773100,3144538863.410701,7655117596.433301,856965,218162,708411,1783538
2020-09-11,EDGX Equities (K),244307743,117521760,249987229,611816732,6967722188.501302,6369094956.730999,12423700269.616010,25760517414.848311,1862192,576582,1844093,4282867
2020-09-11,LTSE (L),221237,12897,285644,519778,33614692.980000,1986427.640000,91758731.280000,127359851.900000,3534,157,5096,8787
2020-09-11,NYSE Chicago (M),8897673,9196449,9029011,27123133,666065500.137600,1555941126.035200,1649676959.546901,3871683585.719701,7742,1372,9771,18885
2020-09-11,NYSE (N),826689817,59861243,52552903,939103963,32291043261.540702,3303542523.243500,2698769091.563400,38293354876.347602,3396141,192283,427860,4016284
2020-09-11,NYSE Arca (P),205927955,313812118,299397112,819137185,7141717214.755698,18119989391.243495,19504292454.817489,44765999060.816682,1834336,1097794,2698681,5630811
2020-09-11,NASDAQ (Q),571594325,248841842,894617000,1715053167,24209617474.605895,15964879630.308404,58900669487.745588,99075166592.659887,5752267,1267750,7678492,14698509
2020-09-11,Investors Exchange (V),82972494,14696489,54072115,151741098,3932274836.557099,1001055729.093500,3679096657.187800,8612427222.838399,776851,81153,525245,1383249
2020-09-11,NASDAQ PSX (X),24602417,22548421,16245432,63396270,642964754.531500,1255045147.497000,1161746651.437700,3059756553.466200,165506,109454,161982,436942
2020-09-11,BYX Equities (Y),66993154,41382227,41131969,149507350,1979190029.756300,2381195887.482101,2112024711.491000,6472410628.729401,826047,209548,509526,1545121
2020-09-11,BZX Equities (Z),204430596,151989917,161795785,518216298,7288060848.538901,9380068355.301498,11504658043.822501,28172787247.662900,2084975,781304,1655698,4521977
2020-09-10,NYSE American (A),15270103,25845888,8557871,49673862,428433861.649900,851746018.258200,610936837.151300,1891116717.059400,159500,109560,109308,378368
2020-09-10,NASDAQ BX (B),34447899,21721957,26440788,82610644,1229462821.047400,1424370066.461500,1535136733.446900,4188969620.955800,470532,128691,344900,944123
2020-09-10,NYSE National (C),75273519,40460666,31915594,147649779,1422352369.749800,1411029235.245100,1035803525.556400,3869185130.551300,593036,178169,309223,1080428
2020-09-10,FINRA / Nasdaq TRF Chicago (DB),6756901,2680947,11234476,20672324,238352524.328500,115552873.236000,1006932464.634300,1360837862.198800,27913,8152,69211,105276
2020-09-10,FINRA / NYSE TRF (DN),277227296,133451427,489482033,900160756,7963452731.532800,4519207649.596001,28140935957.793593,40623596338.922394,1222049,332971,2124159,3679179
2020-09-10,FINRA / Nasdaq TRF Carteret (DQ),1216098505,477820698,1282009487,2975928690,43671741081.264794,26177713122.362709,78186000664.993066,148035454868.620569,5124307,1210339,5471503,11806149
2020-09-10,EDGA Equities (J),68352364,41504358,52695938,162552660,2908411840.725400,1977383289.473600,3279018333.439500,8164813463.638500,937925,239584,742731,1920240
2020-09-10,EDGX Equities (K),289767346,136188114,271170567,697126027,8242234510.091806,7163994230.616701,14123203896.040298,29529432636.748805,2098805,614840,2058231,4771876
2020-09-10,LTSE (L),287340,19704,498283,805327,51783901.670000,3132914.580000,170446313.100000,225363129.350000,4734,266,8908,13908
2020-09-10,NYSE Chicago (M),9589892,13269531,5179117,28038540,490938703.489000,1886340499.753500,734513316.445800,3111792519.688300,8413,1110,9533,19056
2020-09-10,NYSE (N),911197084,68455834,57412413,1037065331,35272277208.512802,3462423614.169700,3087844205.855500,41822545028.538002,3814461,197424,467331,4479216
2020-09-10,NYSE Arca (P),239248840,332229525,335173619,906651984,8342966882.402201,20727686145.354605,23428866723.525988,52499519751.282794,2045689,1222564,3069926,6338179
2020-09-10,NASDAQ (Q),635847167,266868106,981496119,1884211392,26662523897.879098,18708877161.397704,69287320284.657618,114658721343.934420,6397959,1356526,8871873,16626358
2020-09-10,Investors Exchange (V),99819802,15356720,59400900,174577422,4541440253.811100,1066062205.221400,4102913290.971802,9710415750.004302,874718,87426,579527,1541671
2020-09-10,NASDAQ PSX (X),28673384,24184288,18184074,71041746,744729037.782400,1386736483.598800,1326349811.552200,3457815332.933400,179081,110244,179430,468755
2020-09-10,BYX Equities (Y),74316507,41655176,44177019,160148702,2234074648.932200,2446272486.756400,2438509617.994000,7118856753.682600,905090,211853,562556,1679499
2020-09-10,BZX Equities (Z),226459304,161614762,164986597,553060663,7852010157.589399,10604267531.573003,11285126758.544498,29741404447.706900,2249456,789481,1747533,4786470
2020-09-09,NYSE American (A),13811532,25716638,7909443,47437613,438769143.387400,948222853.657600,636032735.730700,2023024732.775700,159311,104636,107191,371138
2020-09-09,NASDAQ BX (B),31027403,18941636,25827927,75796966,1168813938.915600,1306851792.088700,1728706502.364900,4204372233.369200,416491,112581,350325,879397
2020-09-09,NYSE National (C),70168356,33988029,28915611,133071996,1413561210.037300,1239265674.997600,1075250528.310700,3728077413.345600,594368,159489,316397,1070254
2020-09-09,FINRA / Nasdaq TRF Chicago (DB),5057200,2311814,7467990,14837004,190443512.345800,96162315.132000,760697200.495100,1047303027.972900,23504,8252,60464,92220
2020-09-09,FINRA / NYSE TRF (DN),274866453,136653736,436683290,848203479,8104724634.412001,4998621303.289799,25741521315.019612,38844867252.721412,1206008,336519,1978013,3520540
2020-09-09,FINRA / Nasdaq TRF Carteret (DQ),1183242404,490336261,1205361996,2878940661,44890758412.815200,28201806797.097087,78533057187.652515,151625622397.564802,5198831,1277417,5314270,11790518
2020-09-09,EDGA Equities (J),69295136,39692389,51338838,160326363,3099011735.603800,1981498236.411000,3474135228.497799,8554645200.512599,955063,230002,755530,1940595
2020-09-09,EDGX Equities (K),254339129,126304303,236445397,617088829,7410567364.385602,6696038765.022599,13395789907.549296,27502396036.957497,1889521,578014,1903992,4371527
2020-09-09,LTSE (L),48528,1360,233877,283765,14391688.780000,229161.220000,103127685.590000,117748535.590000,912,19,4450,5381
2020-09-09,NYSE Chicago (M),8487777,9162287,7251300,24901364,453544411.688000,1385361278.990000,1148085698.281300,2986991388.959300,7940,1543,9434,18917
2020-09-09,NYSE (N),867166604,55386351,55943459,978496414,36344633085.138596,3207476544.015900,2860485610.738701,42412595239.893197,3452007,173164,446897,4072068
2020-09-09,NYSE Arca (P),207436502,293841804,290234306,791512612,7556511127.344099,19580195370.655891,19935027911.786993,47071734409.786983,1846972,1073817,2832310,5753099
2020-09-09,NASDAQ (Q),563132724,216414817,928698175,1708245716,24642466921.712888,15253656444.585889,69997042770.681191,109893166136.979968,5831450,1163956,7939199,14934605
2020-09-09,Investors Exchange (V),93522014,15374469,60148313,169044796,4496953257.963000,1001102224.154100,4189046492.484600,9687101974.601700,874443,84776,617713,1576932
2020-09-09,NASDAQ PSX (X),24091514,20867616,15538555,60497685,587342228.545100,1188409008.449000,1049106761.988300,2824857998.982400,155159,99625,161497,416281
2020-09-09,BYX Equities (Y),70079427,39746655,42118256,151944338,2168098088.082800,2433200851.540800,2439570026.646699,7040868966.270299,860363,197203,530595,1588161
2020-09-09,BZX Equities (Z),196748251,127275577,150552520,474576348,7189525093.611498,9193550320.677804,11722506064.450397,28105581478.739699,2087961,673151,1678795,4439907
2020-09-08,NYSE American (A),16343180,29863097,10726264,56932541,505081672.888900,1067246135.754300,808699408.700900,2381027217.344100,186214,129511,134898,450623
2020-09-08,NASDAQ BX (B),38468433,24554418,29413568,92436419,1371448722.567800,1648935458.700600,2253112127.152001,5273496308.420401,476688,139395,429425,1045508
2020-09-08,NYSE National (C),83600424,46903770,33119398,163623592,1652335387.925800,1581622402.032300,1387453772.519800,4621411562.477900,670921,206044,351574,1228539
2020-09-08,FINRA / Nasdaq TRF Chicago (DB),7651989,3515566,11110093,22277648,240556533.282400,123965501.529200,945643492.393199,1310165527.204799,31416,10745,77174,119335
2020-09-08,FINRA / NYSE TRF (DN),319038873,144352763,436987133,900378769,8404544088.260802,5096255931.649400,27978072527.195291,41478872547.105493,1434498,395528,2342491,4172517
2020-09-08,FINRA / Nasdaq TRF Carteret (DQ),1302506292,513199390,1247362709,3063068391,46616210452.122504,30929540963.284402,87013941378.692731,164559692794.099637,6035617,1592108,6126861,13754586
2020-09-08,EDGA Equities (J),81875649,57450460,62025279,201351388,3560876558.000600,2552304954.107802,4305135429.095701,10418316941.204103,1072954,331913,908817,2313684
2020-09-08,EDGX Equities (K),348045432,162232514,259617184,769895130,9420504167.761398,8491475445.163300,17062260323.875196,34974239936.799894,2432314,744562,2374370,5551246
2020-09-08,LTSE (L),272079,733,506994,779806,47415892.030000,64800.480000,180129008.680000,227609701.190000,4384,9,9668,14061
2020-09-08,NYSE Chicago (M),9043411,9721045,8819562,27584018,441087843.118000,1805948567.940999,1164191341.479000,3411227752.537999,9259,1532,8256,19047
2020-09-08,NYSE (N),1017661560,78334040,72754859,1168750459,42444088008.380502,3998635979.329701,4411681699.389399,50854405687.099602,4282601,241190,578423,5102214
2020-09-08,NYSE Arca (P),273823743,378087026,340745096,992655865,9681257127.030497,24436616190.507908,29576919794.017307,63694793111.555712,2379002,1438633,3553466,7371101
2020-09-08,NASDAQ (Q),710648087,296182637,1074802433,2081633157,31046617906.124608,20906219002.591818,86972928910.760579,138925765819.477005,7223359,1549886,9942337,18715582
2020-09-08,Investors Exchange (V),109413753,19186846,68490561,197091160,5073794137.574900,1313757532.969500,5409830279.657801,11797381950.202201,973344,108657,674289,1756290
2020-09-08,NASDAQ PSX (X),28683089,26097096,20290327,75070512,751671943.046800,1522251776.781200,1471618706.953800,3745542426.781800,192194,125077,204522,521793
2020-09-08,BYX Equities (Y),90462283,45237032,49727328,185426643,2658775058.924000,2543104781.560000,2972288581.073300,8174168421.557300,1057548,232283,647074,1936905
2020-09-08,BZX Equities (Z),256794161,187933630,178927443,623655234,9407113553.259602,12304477079.439308,14027915466.847892,35739506099.546802,2626784,959321,2103833,5689938
2020-09-04,NYSE American (A),13068510,38347000,10146765,61562275,445978448.421100,1265832432.913800,965602236.437200,2677413117.772100,161891,169830,135894,467615
2020-09-04,NASDAQ BX (B),34207303,29781223,31205044,95193570,1422970242.082500,2389419541.369500,2619454179.898999,6431843963.350999,451712,188425,410782,1050919
2020-09-04,NYSE National (C),72424320,52334081,33360732,158119133,1596131736.433100,1777889536.453600,1681061557.193700,5055082830.080400,628070,250097,378267,1256434
2020-09-04,FINRA / Nasdaq TRF Chicago (DB),7911318,4501162,13344924,25757404,321499538.697100,168956290.050700,1231967315.622600,1722423144.370400,39069,14164,89788,143021
2020-09-04,FINRA / NYSE TRF (DN),320339051,226890002,524256410,1071485463,9669240062.349301,6766589763.825801,36062565466.791301,52498395292.966403,1483984,580076,2601874,4665934
2020-09-04,FINRA / Nasdaq TRF Carteret (DQ),1238664740,699821663,1375860903,3314347306,49632602529.872696,39381613929.299713,104017910380.816840,193032126839.989249,5895160,1970436,6671479,14537075
2020-09-04,EDGA Equities (J),77821266,70842377,70015526,218679169,3534923874.946902,3154324183.945101,5106460746.263702,11795708805.155705,1020190,392738,948106,2361034
2020-09-04,EDGX Equities (K),317953272,205841748,291466532,815261552,10285927912.306795,10563025739.654899,20543086001.607592,41392039653.569286,2389710,995070,2546962,5931742
2020-09-04,LTSE (L),35537,0,456243,491780,8700836.280000,0.000000,181942822.040000,190643658.320000,592,0,7930,8522
2020-09-04,NYSE Chicago (M),3056363,7578348,5962177,16596888,212027071.495000,1117812860.400000,1960409725.746500,3290249657.641500,7141,1604,11102,19847
2020-09-04,NYSE (N),959731955,92406736,66896068,1119034759,40707883193.094506,4764030733.567299,4536634225.677500,50008548152.339305,4242688,304249,587649,5134586
2020-09-04,NYSE Arca (P),249386239,489199777,378514314,1117100330,9828118682.902902,29407449337.703782,32965169505.745393,72200737526.352077,2197039,1948198,3640484,7785721
2020-09-04,NASDAQ (Q),691049560,379420982,1132772598,2203243140,31215528158.468507,24354832256.375716,98946683090.851208,154517043505.695431,7000981,2069162,10749281,19819424
2020-09-04,Investors Exchange (V),93539237,18272846,65983455,177795538,5049406684.255301,1355120752.462501,5998836436.303198,12403363873.021000,866566,103239,632999,1602804
2020-09-04,NASDAQ PSX (X),29354645,34906891,22094518,86356054,854114156.799100,1870726181.272600,2515288785.892900,5240129123.964600,190445,201344,258934,650723
2020-09-04,BYX Equities (Y),78564599,55553587,55361325,189479511,2606663904.319000,3570719969.226602,4230426632.846800,10407810506.392402,958506,285992,673727,1918225
2020-09-04,BZX Equities (Z),251619108,245826805,206750371,704196284,10242556474.458103,16173099344.860301,19344341989.870806,45759997809.189210,2599924,1311948,2368235,6280107
2020-09-03,NYSE American (A),14702871,38754279,10198164,63655314,471213014.418400,1583239677.106600,850165413.804500,2904618105.329500,163031,160782,123937,447750
2020-09-03,NASDAQ BX (B),37036865,32415855,31673057,101125777,1396143303.729400,2146137493.414301,2355619144.902000,5897899942.045701,466320,202893,388665,1057878
2020-09-03,NYSE National (C),81702266,54107183,38996731,174806180,1632474771.532700,1903726791.440099,1601497959.088700,5137699522.061499,639610,234607,360113,1234330
2020-09-03,FINRA / Nasdaq TRF Chicago (DB),9189974,5498121,13685147,28373242,384248903.273000,174679072.919200,1148743023.678600,1707670999.870800,45902,15889,86431,148222
2020-09-03,FINRA / NYSE TRF (DN),353964104,209827032,529615236,1093406372,10803758738.593796,6689141632.346802,33877067446.406201,51369967817.346799,1573061,519478,2564267,4656806
2020-09-03,FINRA / Nasdaq TRF Carteret (DQ),1404208539,702878319,1450516994,3557603852,54764621921.334602,42299343723.107806,105165909570.826368,202229875215.268776,6394746,1934458,6675119,15004323
2020-09-03,EDGA Equities (J),85111576,65861303,70922489,221895368,3840498223.785200,2976012036.428200,5200524140.327502,12017034400.540902,1085331,375038,929518,2389887
2020-09-03,EDGX Equities (K),362000672,208548139,321143393,891692204,11602560605.767202,10868407215.585504,21250193208.679201,43721161030.031907,2656716,968500,2678177,6303393
2020-09-03,LTSE (L),15318,313,24798,40429,2168275.060000,28865.220000,3107035.440000,5304175.720000,296,9,510,815
2020-09-03,NYSE Chicago (M),4517681,8543920,8801225,21862826,438352027.864000,848742303.295000,2557079459.180000,3844173790.339000,10063,2037,13917,26017
2020-09-03,NYSE (N),993342765,96165351,74083371,1163591487,42759058079.692703,5469950240.503502,5017612622.339402,53246620942.535607,4341627,305445,592637,5239709
2020-09-03,NYSE Arca (P),291112192,507023986,391460448,1189596626,10649040223.815004,32130806143.613979,30276316054.653699,73056162422.082682,2424472,1915004,3583345,7922821
2020-09-03,NASDAQ (Q),762315680,380197631,1160230439,2302743750,33965549735.873696,26528048197.299107,97999233756.400940,158492831689.573743,7553318,2005436,10357858,19916612
2020-09-03,Investors Exchange (V),116531177,21399131,73378810,211309118,6246680348.821899,1780323451.903300,6531633074.604700,14558636875.329899,943453,111529,640018,1695000
2020-09-03,NASDAQ PSX (X),34665158,36337789,23869371,94872318,902316039.732400,2179459345.395500,2152320810.747200,5234096195.875100,211911,205960,230335,648206
2020-09-03,BYX Equities (Y),86264230,60601624,58520446,205386300,2749675054.489000,3846577021.658700,3322262295.304800,9918514371.452500,1019881,303960,647980,1971821
2020-09-03,BZX Equities (Z),275156296,243268449,207893873,726318618,10847050289.238598,16719653642.154893,17943303246.052796,45510007177.446287,2742205,1237766,2228776,6208747
2020-09-02,NYSE American (A),13174519,27447776,8924336,49546631,453409254.193100,838234469.879600,537570880.798700,1829214604.871400,170009,111842,118460,400311
2020-09-02,NASDAQ BX (B),30734122,20508608,27455001,78697731,1209448074.828300,1271400691.206300,1940319239.467600,4421168005.502200,400618,110044,340126,850788
2020-09-02,NYSE National (C),66005775,37549573,29470375,133025723,1406209329.202600,1506937048.638700,1157361059.117700,4070507436.959000,564387,176147,317122,1057656
2020-09-02,FINRA / Nasdaq TRF Chicago (DB),7304453,2665025,13553360,23522838,323364858.310100,103850833.285300,1117153739.854400,1544369431.449800,36331,9755,82800,128886
2020-09-02,FINRA / NYSE TRF (DN),319103068,136181143,515607020,970891231,9519253122.125297,4598311088.645999,30631097974.213708,44748662184.985004,1423305,354956,2418710,4196971
2020-09-02,FINRA / Nasdaq TRF Carteret (DQ),1332855391,521203902,1415992015,3270051308,51734858722.830073,26974371292.402686,90553970078.467565,169263200093.700324,5646323,1415746,5966940,13029009
2020-09-02,EDGA Equities (J),72640676,37972651,57752382,168365709,3504491643.107200,1923071712.196200,4052096801.777798,9479660157.081198,973526,232297,815789,2021612
2020-09-02,EDGX Equities (K),311055678,130761782,272497755,714315215,9758063238.422197,7095737717.510203,17165492718.404492,34019293674.336892,2220449,575529,2185617,4981595
2020-09-02,LTSE (L),18401,188,41741,60330,1565671.370000,17153.650000,2409906.660000,3992731.680000,392,7,722,1121
2020-09-02,NYSE Chicago (M),14209461,6429019,5664113,26302593,698594639.579800,559333915.595000,1850123210.800300,3108051765.975100,8025,2173,11344,21542
2020-09-02,NYSE (N),885493749,56426952,61069636,1002990337,38771492177.884198,3441592926.564102,3913107930.127500,46126193034.575800,3430028,166013,477611,4073652
2020-09-02,NYSE Arca (P),241817799,293940217,308486134,844244150,9349729348.852898,18578990692.066793,23702230673.445292,51630950714.364983,2035616,1053512,2907074,5996202
2020-09-02,NASDAQ (Q),596214042,204826635,966969450,1768010127,27652453575.684899,14527909329.760505,77746461285.028288,119926824190.473692,5899766,1067323,8323219,15290308
2020-09-02,Investors Exchange (V),98773633,18037911,66676824,183488368,5055686250.107201,1202885508.881500,5505973356.110202,11764545115.098903,905239,96134,628833,1630206
2020-09-02,NASDAQ PSX (X),27622395,20993755,19826267,68442417,817909601.643000,1309581902.231500,2039823663.581300,4167315167.455800,194889,102835,194261,491985
2020-09-02,BYX Equities (Y),73759674,42324962,52543294,168627930,2537105849.294400,2596591709.688200,2841700273.317601,7975397832.300201,902956,212367,580575,1695898
2020-09-02,BZX Equities (Z),204862493,124544787,159837875,489245155,8375545361.806200,8924835548.891199,13572036457.460991,30872417368.158390,2167881,637421,1764982,4570284
2020-09-01,NYSE American (A),12627590,25769363,7014931,45411884,393976655.297700,696497482.887400,445743707.580300,1536217845.765400,157193,99450,100136,356779
2020-09-01,NASDAQ BX (B),30485258,16649355,23979735,71114348,1183973256.520800,1042056453.663300,1961130022.436301,4187159732.620401,389081,98001,330294,817376
2020-09-01,NYSE National (C),60411302,32307879,26185617,118904798,1275377036.446900,1263161333.662200,1078500989.788100,3617039359.897200,521669,153026,304664,979359
2020-09-01,FINRA / Nasdaq TRF Chicago (DB),7354617,2311515,9531369,19197501,286226713.385000,92189393.367300,929845537.039200,1308261643.791500,35717,8488,73725,117930
2020-09-01,FINRA / NYSE TRF (DN),335473917,127946635,461610880,925031432,9778525099.630002,4046048738.005100,28709864534.899921,42534438372.535023,1441641,330907,2288316,4060864
2020-09-01,FINRA / Nasdaq TRF Carteret (DQ),1308596296,438681545,1220050603,2967328444,47551835054.254012,25297225414.891585,81004744247.232455,153853804716.378052,5489283,1254508,5850093,12593884
2020-09-01,EDGA Equities (J),64949482,33098879,48782630,146830991,3030484621.558300,1693883313.522600,3489684503.888702,8214052438.969602,873249,202332,722054,1797635
2020-09-01,EDGX Equities (K),294734562,102024196,242735201,639493959,8554866530.701204,5287096690.357001,15461805446.822594,29303768667.880799,1997849,462325,1937393,4397567
2020-09-01,LTSE (L),0,0,300,300,0.000000,0.000000,3587.000000,3587.000000,0,0,4,4
2020-09-01,NYSE Chicago (M),8882728,4628887,11113989,24625604,498063740.031800,609840805.966400,3163248465.092000,4271153011.090200,8839,1824,13613,24276
2020-09-01,NYSE (N),814175270,48833871,54042916,917052057,33565733989.299101,2762175829.360700,3387628673.144501,39715538491.804302,3011482,139072,453575,3604129
2020-09-01,NYSE Arca (P),235925157,269101139,275540978,780567274,8102209663.734102,16872759164.607890,22365030448.971794,47339999277.313786,1869457,908309,2754149,5531915
2020-09-01,NASDAQ (Q),539079334,171597151,863757364,1574433849,23443096349.773497,11384571248.684600,68264132669.273161,103091800267.731258,5163752,886992,7147315,13198059
2020-09-01,Investors Exchange (V),94724673,16574411,65494750,176793834,4689801799.607799,1173749613.606000,5110822684.862100,10974374098.075899,861436,94257,612395,1568088
2020-09-01,NASDAQ PSX (X),30013387,19420608,17159105,66593100,772038012.389400,1245715285.366300,1633389849.630700,3651143147.386400,182702,94370,178098,455170
2020-09-01,BYX Equities (Y),71373532,36026444,46294214,153694190,2261016002.726600,2172380700.029000,2525625112.772300,6959021815.527900,825688,189436,519319,1534443
2020-09-01,BZX Equities (Z),192684506,102145066,137765458,432595030,7498575430.815899,6780404687.424397,11196789254.508499,25475769372.748795,1956619,511230,1550269,4018118
2020-08-31,NYSE American (A),11878492,35851305,7560878,55290675,330264772.925600,627167357.932700,390472317.342900,1347904448.201200,142347,104477,94861,341685
2020-08-31,NASDAQ BX (B),26889212,18299487,20607642,65796341,973678510.583700,1134588039.742400,2117826989.070900,4226093539.397000,328143,99810,281886,709839
2020-08-31,NYSE National (C),65580094,36628865,26437427,128646386,1334588023.243300,1354346674.615800,1060451080.184500,3749385778.043600,539635,158036,296007,993678
2020-08-31,FINRA / Nasdaq TRF Chicago (DB),7932967,2309824,9434923,19677714,250576470.634000,95274862.963900,866598402.568500,1212449736.166400,32697,8107,65911,106715
2020-08-31,FINRA / NYSE TRF (DN),313267383,135746566,434302642,883316591,8322182458.796700,4437973998.983202,26777016486.117485,39537172943.897387,1447906,352011,2534549,4334466
2020-08-31,FINRA / Nasdaq TRF Carteret (DQ),1269485927,503709907,1205765476,2978961310,44932434297.443293,29012239432.807488,79783613013.634822,153728286743.885603,5268660,1241982,6182088,12692730
2020-08-31,EDGA Equities (J),59958274,30940049,46417675,137315998,2897775810.731200,1625494506.131800,3540148855.299799,8063419172.162799,817377,173919,691943,1683239
2020-08-31,EDGX Equities (K),291879927,110374803,267470518,669725248,8011402775.074398,5394381715.898500,17525404522.553001,30931189013.525899,1949171,474339,2099254,4522764
2020-08-31,NYSE Chicago (M),3278078,8047660,6823266,18149004,328683899.232400,1357835096.006700,1543496128.796300,3230015124.035400,7696,1038,9234,17968
2020-08-31,NYSE (N),1132001163,49715701,54850546,1236567410,48136370798.423396,2876625108.910600,3624502782.086300,54637498689.420296,2918218,153871,473087,3545176
2020-08-31,NYSE Arca (P),242013690,269431096,279862539,791307325,8696018125.451401,17315999899.955597,22682746588.467596,48694764613.874594,1956713,903941,2767150,5627804
2020-08-31,NASDAQ (Q),548430120,176308494,995896368,1720634982,23358625625.191092,11603040837.754499,80715633819.883229,115677300282.828820,5128671,896493,7261827,13286991
2020-08-31,Investors Exchange (V),92473282,16697073,56799821,165970176,4007895438.429200,1070758982.958100,4493607732.200901,9572262153.588201,760964,82960,547652,1391576
2020-08-31,NASDAQ PSX (X),26375600,19112108,16690415,62178123,639548960.564200,1188426434.752600,1532428304.068000,3360403699.384800,164357,97358,162152,423867
2020-08-31,BYX Equities (Y),72039266,39106665,42919129,154065060,2134483925.596400,2316921877.486501,2466251296.303001,6917657099.385902,803781,187396,494016,1485193
2020-08-31,BZX Equities (Z),184803432,101015481,140212140,426031053,6869981146.033001,6488141847.134202,11534190533.216999,24892313526.384202,1903181,492931,1527835,3923947
2020-08-28,NYSE American (A),11322616,23804308,5799662,40926586,306556600.026400,449953514.282800,333865816.129900,1090375930.439100,129979,93491,82406,305876
2020-08-28,NASDAQ BX (B),28825119,15883745,19565284,64274148,958122795.379000,988243324.112000,1195657332.699600,3142023452.190600,320772,99944,234575,655291
2020-08-28,NYSE National (C),56023907,31663967,25410409,113098283,1214032095.566300,1126057383.008700,987793309.259000,3327882787.834000,515173,139574,290479,945226
2020-08-28,FINRA / Nasdaq TRF Chicago (DB),6853514,2408942,9275412,18537868,253859867.771900,92079742.373500,803313785.630200,1149253395.775600,31220,8696,50728,90644
2020-08-28,FINRA / NYSE TRF (DN),323694927,127626679,408001829,859323435,9486743434.333403,3595775122.981603,24574915370.292887,37657433927.607893,1252225,303093,1598970,3154288
2020-08-28,FINRA / Nasdaq TRF Carteret (DQ),1230281451,398021110,1045591995,2673894556,43071725237.871500,19453485831.202280,67557109327.518882,130082320396.592662,4877911,1074910,4472766,10425587
2020-08-28,EDGA Equities (J),53330745,23063684,42876194,119270623,2601669672.126200,1237435527.279400,2950551695.565000,6789656894.970600,758655,141174,587346,1487175
2020-08-28,EDGX Equities (K),277021721,96894295,222317221,596233237,7587435926.715100,4317568275.923199,12109851765.463607,24014855968.101906,1768220,405636,1526394,3700250
2020-08-28,LTSE (L),478,0,5985,6463,11316.340000,0.000000,67965.020000,79281.360000,7,0,33,40
2020-08-28,NYSE Chicago (M),4389095,8566371,4635470,17590936,384949826.181900,2196881745.620899,2213666686.883801,4795498258.686600,8138,1332,9491,18961
2020-08-28,NYSE (N),788972534,37904018,45419549,872296101,34934052092.841995,2044261198.075600,2811502901.481899,39789816192.399494,2774593,117266,406384,3298243
2020-08-28,NYSE Arca (P),230952352,222307630,236061039,689321021,7661244758.357499,13101903710.433596,18334278100.895294,39097426569.686389,1711781,777653,2244698,4734132
2020-08-28,NASDAQ (Q),517021940,154500655,733645449,1405168044,22249057270.292699,9556009618.776400,62351295951.623287,94156362840.692386,5085870,795081,6192479,12073430
2020-08-28,Investors Exchange (V),77137731,13413187,47371840,137922758,3999239867.212900,839136163.387600,3525051166.561800,8363427197.162300,690098,73751,460849,1224698
2020-08-28,NASDAQ PSX (X),25638964,14916448,13296636,53852048,636700100.139100,846158221.492700,1395453455.521800,2878311777.153600,149753,76160,131695,357608
2020-08-28,BYX Equities (Y),59536182,30502616,38054239,128093037,1978391201.370400,1686800606.425300,1912886245.927900,5578078053.723600,724464,158787,428953,1312204
2020-08-28,BZX Equities (Z),177511401,82407879,115655601,375574881,6739753491.832100,5221424557.351502,10397652370.133900,22358830419.317502,1817082,420999,1290712,3528793
2020-08-27,NYSE American (A),9897567,33382488,6330732,49610787,323585077.471200,642897903.811400,323232111.195200,1289715092.477800,122954,128967,83053,334974
2020-08-27,NASDAQ BX (B),29116812,19344500,24189914,72651226,1138596440.808900,1097679413.200600,1621777679.187300,3858053533.196800,363806,133307,289845,786958
2020-08-27,NYSE National (C),64539102,42429126,30265418,137233646,1415170869.812700,1441950318.984900,1178985157.289901,4036106346.087501,563630,190217,327563,1081410
2020-08-27,FINRA / Nasdaq TRF Chicago (DB),8141054,3336908,11409416,22887378,370100509.280300,103263881.882800,1006651542.275300,1480015933.438400,43459,11296,64803,119558
2020-08-27,FINRA / NYSE TRF (DN),324105755,177724056,482600336,984430147,11703900321.251104,4921151097.041001,28677673655.730501,45302725074.022606,1398337,396563,1776724,3571624
2020-08-27,FINRA / Nasdaq TRF Carteret (DQ),1198224354,510350277,1238178704,2946753335,49716785019.973485,22501593391.212596,79398680149.757805,151617058560.943886,5412879,1384570,5067320,11864769
2020-08-27,EDGA Equities (J),58499603,31449344,47547192,137496139,3018772318.231900,1455233779.031300,3629575552.096600,8103581649.359800,810660,179739,647324,1637723
2020-08-27,EDGX Equities (K),287373825,138433313,267975637,693782775,9561117742.203799,5771295554.119698,14742351277.419404,30074764573.742901,1983180,570620,1778831,4332631
2020-08-27,NYSE Chicago (M),9746472,4766790,6724292,21237554,716908632.595000,884294687.110000,3074401658.750999,4675604978.455999,7691,930,9919,18540
2020-08-27,NYSE (N),777885589,56385819,55047812,889319220,33030789665.502004,2915221070.617100,3354984315.826700,39300995051.945804,3118228,162898,422496,3703622
2020-08-27,NYSE Arca (P),232822400,311110994,273252361,817185755,9025190363.096104,16904269669.821699,21720090989.193497,47649551022.111300,1927760,1074832,2491204,5493796
2020-08-27,NASDAQ (Q),584187449,223176108,840850624,1648214181,27128214037.697885,12597534970.581506,69706892807.518114,109432641815.797505,5472265,1087919,6885643,13445827
2020-08-27,Investors Exchange (V),87054928,14446370,58050400,159551698,4520950409.233600,998285681.609900,4589158702.421302,10108394793.264802,745949,77489,512717,1336155
2020-08-27,NASDAQ PSX (X),25426765,19619303,17654322,62700390,708167359.269000,969987364.273900,1608689946.421700,3286844669.964600,162231,98451,153178,413860
2020-08-27,BYX Equities (Y),63875358,40345786,46199195,150420339,2204796887.505300,2180867385.468601,2676594384.754799,7062258657.728700,778074,195339,485221,1458634
2020-08-27,BZX Equities (Z),194994319,125092459,141129948,461216726,8158124857.809299,7473361101.805301,12762798059.165697,28394284018.780297,2040065,597003,1497635,4134703
2020-08-26,NYSE American (A),9493815,28619092,6635833,44748740,309471965.865000,526442739.019400,532085602.039200,1368000306.923600,121787,103230,80248,305265
2020-08-26,NASDAQ BX (B),26184734,16013596,19435273,61633603,1040902622.781300,923173720.125400,1427787055.307000,3391863398.213700,364110,88495,258003,710608
2020-08-26,NYSE National (C),55636441,31609469,25251619,112497529,1268454572.693400,1149756218.417000,1059000291.237900,3477211082.348300,533043,147741,295150,975934
2020-08-26,FINRA / Nasdaq TRF Chicago (DB),7881932,3186227,10891124,21959283,343239525.843800,96471449.717000,942500980.796200,1382211956.357000,38562,8856,62899,110317
2020-08-26,FINRA / NYSE TRF (DN),315198202,168492854,488848313,972539369,11619832180.380703,3934115187.706498,27800321346.090184,43354268714.177385,1309305,346916,1756043,3412264
2020-08-26,FINRA / Nasdaq TRF Carteret (DQ),1197944434,447448314,1247481516,2892874264,51201111380.885383,20751537432.380401,81402751829.744127,153355400643.009911,5279083,1142184,4940829,11362096
2020-08-26,EDGA Equities (J),55174425,25451135,42233875,122859435,2808042450.851400,1235963205.753100,3560806500.336700,7604812156.941200,784065,145895,616247,1546207
2020-08-26,EDGX Equities (K),273786054,115461479,263933997,653181530,8992282280.399900,4696587309.677600,13484639943.576704,27173509533.654204,1840409,431860,1657525,3929794
2020-08-26,NYSE Chicago (M),5701165,8237415,14595644,28534224,420067003.225000,1006682549.270000,3536827071.308799,4963576623.803799,9258,1286,10611,21155
2020-08-26,NYSE (N),745400928,40841514,51217973,837460415,32521587459.080402,2091170792.931100,4111921218.692400,38724679470.703902,2802403,116782,414651,3333836
2020-08-26,NYSE Arca (P),211190236,232320352,268602613,712113201,8723301207.620295,13274652292.885695,22075119732.689613,44073073233.195603,1776541,794549,2441661,5012751
2020-08-26,NASDAQ (Q),531375097,156718294,792285922,1480379313,25068419552.847503,9704951340.032002,66123724714.592790,100897095607.472295,5069544,770622,6217210,12057376
2020-08-26,Investors Exchange (V),86695980,13692631,53740485,154129096,4439197607.686801,855482726.359800,4724848454.506902,10019528788.553503,759364,77983,501241,1338588
2020-08-26,NASDAQ PSX (X),21157101,14774914,15277110,51209125,655952022.106700,801791091.649100,1835655537.567100,3293398651.322900,152942,65252,150769,368963
2020-08-26,BYX Equities (Y),59538988,33310229,40024577,132873794,2053927972.584900,1709276819.081900,2336210817.954900,6099415609.621700,745013,153926,455679,1354618
2020-08-26,BZX Equities (Z),178174858,89811431,131070319,399056608,7433485908.311500,5876107929.158705,12034774699.330197,25344368536.800402,1881401,436334,1372342,3690077
2020-08-25,NYSE American (A),9104918,28441350,5628027,43174295,293975107.929500,520060266.862100,326252490.636000,1140287865.427600,126672,107486,80850,315008
2020-08-25,NASDAQ BX (B),27004080,13918193,19418307,60340580,1028583547.427900,763664991.871900,1146405966.753600,2938654506.053400,329920,82423,245016,657359
2020-08-25,NYSE National (C),57889198,33859397,25268299,117016894,1252625176.462000,1175122808.700700,898086193.055800,3325834178.218500,520158,154007,283748,957913
2020-08-25,FINRA / Nasdaq TRF Chicago (DB),7938939,2922190,10715447,21576576,318407933.979300,91802193.025400,646777842.927300,1056987969.932000,35379,8342,50378,94099
2020-08-25,FINRA / NYSE TRF (DN),308788393,135395945,536684194,980868532,10678661416.943293,3252391957.560799,24033732420.540193,37964785795.044285,1200970,299296,1568051,3068317
2020-08-25,FINRA / Nasdaq TRF Carteret (DQ),1160301697,424160783,1246220847,2830683327,46315148731.102287,20413191119.643709,63255994262.621796,129984334113.367792,4952051,1103244,4549756,10605051
2020-08-25,EDGA Equities (J),55104597,24194204,41997227,121296028,2754436596.616700,1154058654.560600,2734564120.637900,6643059371.815200,770243,141777,577768,1489788
2020-08-25,EDGX Equities (K),254659800,100069744,263778420,618507964,8257887849.241099,4246496442.068901,10318380713.507004,22822765004.817004,1752458,419284,1554366,3726108
2020-08-25,NYSE Chicago (M),12357563,5280583,14729234,32367380,1110413199.882000,499494768.930000,4538383881.122999,6148291849.934999,7624,1641,7435,16700
2020-08-25,NYSE (N),713322323,40219415,47431133,800972871,28283855005.438101,2009645746.894600,2351650649.107600,32645151401.440301,2709618,115787,362484,3187889
2020-08-25,NYSE Arca (P),192687959,228336233,269649648,690673840,7795011031.066998,13190761923.816295,16188939460.152501,37174712415.035794,1694704,772792,2201024,4668520
2020-08-25,NASDAQ (Q),494714151,156141570,760190607,1411046328,22173494775.293902,9206560665.606902,50242496554.190588,81622551995.091392,4786963,778618,5721430,11287011
2020-08-25,Investors Exchange (V),83343958,13437383,51033012,147814353,4199297153.646800,878931039.974200,3454073167.459500,8532301361.080500,747301,79006,490820,1317127
2020-08-25,NASDAQ PSX (X),21695855,13786901,13259932,48742688,545638978.811600,781109632.471300,970297079.154200,2297045690.437100,144676,64873,129031,338580
2020-08-25,BYX Equities (Y),58396467,30765120,37555788,126717375,2009776918.824300,1552613508.958100,1885925726.386400,5448316154.168800,729356,146084,441554,1316994
2020-08-25,BZX Equities (Z),170346396,87221039,131723127,389290562,6502893216.847500,5257379263.456503,8954977749.181302,20715250229.485305,1795757,441136,1286072,3522965
2020-08-24,NYSE American (A),9831928,35120887,8911250,53864065,285183144.638900,534888710.188900,377687542.530200,1197759397.358000,121063,116534,87445,325042
2020-08-24,NASDAQ BX (B),25165578,15575300,22644271,63385149,918980933.518900,837101331.589600,1514112857.079800,3270195122.188300,312216,80928,270241,663385
2020-08-24,NYSE National (C),58214899,34283249,29017431,121515579,1208618368.717300,1099122237.194700,913908705.870300,3221649311.782300,514520,146415,310707,971642
2020-08-24,FINRA / Nasdaq TRF Chicago (DB),8028632,3007903,12556935,23593470,305566835.250800,89977658.570600,966256630.823200,1361801124.644600,35774,9323,63903,109000
2020-08-24,FINRA / NYSE TRF (DN),306336173,167730753,576449817,1050516743,9737429834.577001,3790649392.034003,27227514055.299573,40755593281.910577,1267598,341513,1878384,3487495
2020-08-24,FINRA / Nasdaq TRF Carteret (DQ),1200113955,436676351,1375604851,3012395157,45777166537.673194,19803666147.027598,75912478644.601269,141493311329.302061,4936899,1161293,5296545,11394737
2020-08-24,EDGA Equities (J),54114767,25968356,46218964,126302087,2643177303.781900,1174121049.842600,3021836772.058701,6839135125.683201,750021,146360,636151,1532532
2020-08-24,EDGX Equities (K),251473156,115775897,307775919,675024972,7996248357.799997,4342950955.561199,12586236242.090402,24925435555.451598,1769639,434867,1835795,4040301
2020-08-24,NYSE Chicago (M),7735233,8124690,8095385,23955308,492843061.081000,857830838.631300,1225322218.500000,2575996118.212300,7017,1900,9746,18663
2020-08-24,NYSE (N),773317809,38332590,54890576,866540975,32609353594.675198,1954954169.320299,2614837324.946399,37179145088.941896,2884988,110473,407072,3402533
2020-08-24,NYSE Arca (P),201908520,232140564,311688961,745738045,7738219490.985805,13265945794.625402,20295007263.003002,41299172548.614209,1746568,773811,2529320,5049699
2020-08-24,NASDAQ (Q),502784965,153020807,881017970,1536823742,22088999814.250794,8751772998.374601,63803049893.732216,94643822706.357611,4820917,732483,6635841,12189241
2020-08-24,Investors Exchange (V),80447902,13437177,55550638,149435717,3946017782.588200,797449837.106600,4425035402.709800,9168503022.404600,730916,77402,520762,1329080
2020-08-24,NASDAQ PSX (X),21750232,12796825,16251714,50798771,555394388.375600,727214471.421100,1487335713.144100,2769944572.940800,148436,58990,154584,362010
2020-08-24,BYX Equities (Y),58926451,33641168,42176970,134744589,1858793062.815800,1655747430.233100,2315909235.527399,5830449728.576299,705173,150614,478554,1334341
2020-08-24,BZX Equities (Z),183261446,89709455,158461870,431432771,6730761710.034599,5212011993.099299,10899159059.792103,22841932762.926001,1892630,436323,1523579,3852532
2020-08-21,NYSE American (A),9326003,26519364,5327580,41172947,277965861.759200,493377974.269700,321745019.345500,1093088855.374400,114459,95527,72356,282342
2020-08-21,NASDAQ BX (B),25034612,14970046,35947179,75951837,850523683.178000,815911073.630100,1212675405.865900,2879110162.674000,289622,73684,235072,598378
2020-08-21,NYSE National (C),56299257,31631241,28359436,116289934,1183825750.895900,1100872275.162600,834244263.028300,3118942289.086800,510109,143426,278778,932313
2020-08-21,FINRA / Nasdaq TRF Chicago (DB),6358856,1803456,9368717,17531029,248890834.099000,67039342.947300,889458808.488500,1205388985.534800,27134,6596,50128,83858
2020-08-21,FINRA / NYSE TRF (DN),268012900,121112410,571062618,960187928,7964988276.019505,3302008278.479702,26040358585.572800,37307355140.072007,1107990,282601,1667318,3057909
2020-08-21,FINRA / Nasdaq TRF Carteret (DQ),1109967997,402208110,1359465496,2871641603,43112027317.922193,22891285818.616687,77413114673.230829,143416427809.769709,4523073,1062813,4805980,10391866
2020-08-21,EDGA Equities (J),49182144,22537337,51352276,123071757,2446643737.406600,1147725339.869700,3223922556.697601,6818291633.973901,699238,133673,581813,1414724
2020-08-21,EDGX Equities (K),201048402,87077353,284991124,573116879,6324022673.858699,4170345722.314299,12248081596.183302,22742449992.356300,1487321,367292,1530528,3385141
2020-08-21,NYSE Chicago (M),10532023,11488153,12707071,34727247,669033537.045000,1222608511.630000,3019361553.333800,4911003602.008800,7511,2295,7168,16974
2020-08-21,NYSE (N),837327227,36900249,45328532,919556008,35754045475.391506,1922969464.717300,2572606861.938801,40249621802.047607,2592540,110769,372230,3075539
2020-08-21,NYSE Arca (P),173583150,212715306,320916832,707215288,6536697689.517400,12385782603.564507,19169628240.898001,38092108533.979908,1557981,743654,2313414,4615049
2020-08-21,NASDAQ (Q),447032065,146228673,922112553,1515373291,20190155990.481803,9019459212.255506,65717588554.754363,94927203757.491672,4462910,734761,5927709,11125380
2020-08-21,Investors Exchange (V),73884248,13596708,50065141,137546097,3531591784.354800,840904322.725700,3765528891.591699,8138024998.672199,695822,73988,481423,1251233
2020-08-21,NASDAQ PSX (X),19028638,14575746,18247479,51851863,537373126.646400,811744161.339800,1513456314.100700,2862573602.086900,133756,68869,126937,329562
2020-08-21,BYX Equities (Y),55264339,29334424,44270546,128869309,1774538316.988000,1654960964.748200,2097932810.483999,5527432092.220199,668247,146201,436283,1250731
2020-08-21,BZX Equities (Z),163137384,86612487,169767510,419517381,6082956479.521802,5038710826.956803,12330116309.511198,23451783615.989803,1733645,429016,1442885,3605546
2020-08-20,NYSE American (A),9742329,24038298,5694403,39475030,273738776.428800,522813446.699500,325916144.272300,1122468367.400600,124180,97407,80057,301644
2020-08-20,NASDAQ BX (B),25529337,16791824,28568848,70890009,828035254.439900,849421582.223900,1113704543.643900,2791161380.307700,305750,84370,241418,631538
2020-08-20,NYSE National (C),58544885,32512760,28873694,119931339,1176764881.750200,1145629322.129500,839027502.059700,3161421705.939400,522051,147687,298690,968428
2020-08-20,FINRA / Nasdaq TRF Chicago (DB),5846755,2089380,12025255,19961390,231631999.108900,74443310.352400,741264141.579900,1047339451.041200,26667,6685,49795,83147
2020-08-20,FINRA / NYSE TRF (DN),275707642,122655077,657500092,1055862811,8662575651.278902,3251076603.964099,22817578969.049403,34731231224.292404,1110149,286024,1744262,3140435
2020-08-20,FINRA / Nasdaq TRF Carteret (DQ),1077095871,407007705,1464275753,2948379329,39673123126.230186,18653003889.085495,61981192580.462072,120307319595.777753,4631960,1050692,4884108,10566760
2020-08-20,EDGA Equities (J),51974751,24899891,63272542,140147184,2530476180.606400,1226151900.643100,2909758915.822300,6666386997.071800,747885,140816,583793,1472494
2020-08-20,EDGX Equities (K),216685604,96536062,378592311,691813977,6716075454.653199,4457647245.356497,10875405167.306900,22049127867.316596,1568595,398133,1616630,3583358
2020-08-20,NYSE Chicago (M),10397033,7537792,6855129,24789954,608487151.042000,837540389.433400,1840172609.543800,3286200150.019200,6426,978,6462,13866
2020-08-20,NYSE (N),706924362,40916752,52463226,800304340,28495539173.557700,1971819067.789700,2449059103.291800,32916417344.639200,2632327,113395,375666,3121388
2020-08-20,NYSE Arca (P),189959770,246496664,347965746,784422180,6855108186.109500,13725028610.804396,17052041308.586705,37632178105.500601,1648045,781195,2251194,4680434
2020-08-20,NASDAQ (Q),473622027,157242820,872847173,1503712020,20484899218.575500,9478174475.986502,55363222771.664766,85326296466.226768,4597661,762521,5814903,11175085
2020-08-20,Investors Exchange (V),80295740,14915229,55394099,150605068,3770840899.032800,919239834.680900,3573528334.300200,8263609068.013900,719226,76545,484881,1280652
2020-08-20,NASDAQ PSX (X),19803996,16839242,14401564,51044802,517771783.819700,904683279.121700,1178093179.050000,2600548241.991400,137860,71672,132740,342272
2020-08-20,BYX Equities (Y),60787017,31254821,56574514,148616352,1890853553.965800,1684440689.811400,1969549934.246000,5544844178.023200,714649,149449,450917,1315015
2020-08-20,BZX Equities (Z),168127796,92221244,169825655,430174695,6018892565.465100,5434124171.537902,9853026052.904402,21306042789.907404,1753979,448297,1348269,3550545
2020-08-19,NYSE American (A),9405917,32345165,5878725,47629807,265303244.431200,574654444.803200,322362866.398700,1162320555.633100,115295,118151,74977,308423
2020-08-19,NASDAQ BX (B),26789684,16138429,22279878,65207991,925516061.563900,786427976.762200,1276196340.862500,2988140379.188600,301941,88737,229559,620237
2020-08-19,NYSE National (C),57837977,30888298,25456867,114183142,1208946427.980500,1094520982.571900,921535290.071700,3225002700.624100,510967,143987,286164,941118
2020-08-19,FINRA / Nasdaq TRF Chicago (DB),7736765,2222147,8905972,18864884,271097527.247200,88590064.061000,614974254.028900,974661845.337100,29938,7932,46398,84268
2020-08-19,FINRA / NYSE TRF (DN),313469382,140554697,509166804,963190883,9519269797.689301,4164291704.800101,20269971414.005406,33953532916.494808,1123258,341285,1591026,3055569
2020-08-19,FINRA / Nasdaq TRF Carteret (DQ),1171964926,474679270,1240065786,2886709982,44624783966.393879,25660685240.788295,60750449674.636183,131035918881.818357,4757741,1282717,4500725,10541183
2020-08-19,EDGA Equities (J),54838511,26412797,43425380,124676688,2629223155.589400,1313960424.734400,2824896588.939500,6768080169.263300,735998,156025,570008,1462031
2020-08-19,EDGX Equities (K),233109439,118074630,253497136,604681205,7193619616.790097,5122961580.977198,10516507554.924693,22833088752.691988,1619172,486621,1507527,3613320
2020-08-19,NYSE Chicago (M),6641554,9183915,7411898,23237367,435347279.257100,806379272.182200,1772057280.095500,3013783831.534800,6755,1863,6803,15421
2020-08-19,NYSE (N),765748108,48224192,44998308,858970608,31326752782.992694,2417912921.029600,2312026255.028301,36056691959.050595,2804980,137201,384119,3326300
2020-08-19,NYSE Arca (P),202097149,266560207,288083571,756740927,7562216912.871003,14829054956.230704,16780981769.027195,39172253638.128902,1710368,922383,2226405,4859156
2020-08-19,NASDAQ (Q),488680817,187609101,802823834,1479113752,21571548370.426503,11411918873.251907,53817728111.155321,86801195354.833731,4712115,922371,5897684,11532170
2020-08-19,Investors Exchange (V),86365219,14886346,56542584,157794149,4024156501.812900,1031236351.111300,3623275151.195600,8678668004.119800,742800,77289,503579,1323668
2020-08-19,NASDAQ PSX (X),18923033,17819085,14467203,51209321,523500909.298500,956322586.101800,1148182245.990500,2628005741.390800,133310,78086,127981,339377
2020-08-19,BYX Equities (Y),64138406,34115423,40682723,138936552,1985710844.599000,1830040349.790300,1951271612.739600,5767022807.128900,700812,170931,437724,1309467
2020-08-19,BZX Equities (Z),171739646,106924246,132796675,411460567,6554820278.307199,6626862724.400199,9387636535.632498,22569319538.339896,1873721,524252,1460191,3858164
2020-08-18,NYSE American (A),10701242,28092602,6051959,44845803,270438105.639900,471091245.375100,310538248.506900,1052067599.521900,126225,99322,76372,301919
2020-08-18,NASDAQ BX (B),29587124,14539411,20608578,64735113,928276767.708100,696821889.293200,1141773480.360100,2766872137.361400,329843,75511,243058,648412
2020-08-18,NYSE National (C),59435796,27662873,24827356,111926025,1206437941.866600,974167706.924900,876282907.998400,3056888556.789900,518370,133206,290619,942195
2020-08-18,FINRA / Nasdaq TRF Chicago (DB),7035307,2485141,8770711,18291159,263292795.759800,80040946.839600,738858991.055200,1082192733.654600,30059,8276,52349,90684
2020-08-18,FINRA / NYSE TRF (DN),284760927,129633999,434061809,848456735,8528579211.556696,3151924122.049999,18240510770.945316,29921014104.552011,1136527,291074,1527553,2955154
2020-08-18,FINRA / Nasdaq TRF Carteret (DQ),1157721699,429431560,1120989901,2708143160,42235446221.104201,21101638499.981811,56176042513.869419,119513127234.955431,4866048,1091357,4494427,10451832
2020-08-18,EDGA Equities (J),56798255,23720923,39106120,119625298,2642554764.774500,1099751919.212300,2511438105.580101,6253744789.566901,784849,133384,567305,1485538
2020-08-18,EDGX Equities (K),227245319,103301518,247566299,578113136,6890454485.109201,4057045704.319001,10152986705.059703,21100486894.487905,1632087,395590,1520636,3548313
2020-08-18,NYSE Chicago (M),12966065,7551963,5001694,25519722,882994833.965400,1125884474.946400,1425682326.136400,3434561635.048200,6210,2479,8012,16701
2020-08-18,NYSE (N),770522627,39798343,44600571,854921541,30926779484.942498,1857020191.227600,2289160354.510201,35072960030.680299,2830773,109762,381934,3322469
2020-08-18,NYSE Arca (P),208988725,238485975,272852924,720327624,7834315887.643900,13206139792.434999,16191200213.875398,37231655893.954297,1812396,805255,2281879,4899530
2020-08-18,NASDAQ (Q),499281783,156509903,775185544,1430977230,21485740182.290395,8937893779.619297,52638408517.230888,83062042479.140580,4745187,765779,5929715,11440681
2020-08-18,Investors Exchange (V),91186897,13207749,52311256,156705902,4120228061.910700,842032180.905300,3465244223.412001,8427504466.228001,794460,71430,507148,1373038
2020-08-18,NASDAQ PSX (X),19676933,15770959,11644432,47092324,501471988.500800,805056371.295800,889762660.931500,2196291020.728100,132213,68743,114221,315177
2020-08-18,BYX Equities (Y),64290454,28912664,41793267,134996385,1986998840.414900,1410660753.661700,1751709521.703400,5149369115.780000,742830,137212,443790,1323832
2020-08-18,BZX Equities (Z),169358837,87247377,123227066,379833280,6240558819.296603,4896247024.346199,8615640021.788696,19752445865.431498,1833365,431543,1323635,3588543
2020-08-17,NYSE American (A),8779933,34176217,5672907,48629057,259447658.412300,435853056.304000,256663890.970900,951964605.687200,112333,117782,71918,302033
2020-08-17,NASDAQ BX (B),26574090,14701641,24019021,65294752,945252999.508500,747668872.539400,1068303767.301400,2761225639.349300,331548,69158,240318,641024
2020-08-17,NYSE National (C),59449385,27388246,23805274,110642905,1255332874.373500,952777957.589500,771778115.346800,2979888947.309800,519467,127065,284152,930684
2020-08-17,FINRA / Nasdaq TRF Chicago (DB),6299361,4090398,9053231,19442990,234443481.450400,88255889.268200,753573442.064900,1076272812.783500,28653,11137,50388,90178
2020-08-17,FINRA / NYSE TRF (DN),256900724,159114773,434408580,850424077,7853086956.576301,2850231856.043300,18207395374.382702,28910714187.002303,1137592,362011,1524089,3023692
2020-08-17,FINRA / Nasdaq TRF Carteret (DQ),1084335941,477839449,1143385410,2705560800,41716173679.586700,19176443236.942294,59293107349.073019,120185724265.602013,4713455,1243626,4418095,10375176
2020-08-17,EDGA Equities (J),49567402,21387846,37849593,108804841,2425885651.920900,996674057.950000,2512623868.737200,5935183578.608100,708711,121383,533185,1363279
2020-08-17,EDGX Equities (K),217940012,123297814,227860815,569098641,6739154825.327999,3639503119.191700,9508783601.556102,19887441546.075801,1548746,433809,1405374,3387929
2020-08-17,NYSE Chicago (M),16013422,4909148,8588336,29510906,897802417.689100,594077171.735000,1373700507.425500,2865580096.849600,6757,1338,7610,15705
2020-08-17,NYSE (N),744583107,36026078,43578308,824187493,31084946256.401698,1579563467.349300,1987162279.798400,34651672003.549398,2607794,96912,334014,3038720
2020-08-17,NYSE Arca (P),198603173,234318842,260742406,693664421,7652028916.459602,11750260846.313499,15409227540.039997,34811517302.813098,1716513,746123,2154769,4617405
2020-08-17,NASDAQ (Q),469735263,152573613,777919109,1400227985,20409263388.589196,7968825727.916000,51202205681.979401,79580294798.484597,4386515,708194,5635980,10730689
2020-08-17,Investors Exchange (V),79133952,12029034,50405633,141568619,3806755739.750100,677333100.645400,3418390190.108901,7902479030.504401,708600,64983,475638,1249221
2020-08-17,NASDAQ PSX (X),20681369,13476453,11743434,45901256,545021564.547100,718547293.225600,812320820.278400,2075889678.051100,136654,59862,109009,305525
2020-08-17,BYX Equities (Y),55706938,31761773,39316652,126785363,1864448027.364000,1466525513.804700,1633998013.852400,4964971555.021100,672225,141290,406096,1219611
2020-08-17,BZX Equities (Z),166026777,82747669,116528852,365303298,6135831680.482499,4272399055.898198,7590145521.860703,17998376258.241400,1727608,401241,1218723,3347572
2020-08-14,NYSE American (A),9018982,24828626,5603942,39451550,227283136.123300,445155012.959600,237777547.865800,910215696.948700,113370,92451,74564,280385
2020-08-14,NASDAQ BX (B),25937830,13526968,24831329,64296127,817837122.498900,655346412.598600,1023603865.518700,2496787400.616200,297198,73709,236202,607109
2020-08-14,NYSE National (C),53798231,27034167,24562125,105394523,1029447281.670700,919170686.018700,781906476.070300,2730524443.759700,457658,130736,269771,858165
2020-08-14,FINRA / Nasdaq TRF Chicago (DB),5701070,1809695,10037122,17547887,195494656.546800,78264755.183800,560599540.519400,834358952.250000,23453,6154,44191,73798
2020-08-14,FINRA / NYSE TRF (DN),245935678,121033383,526866269,893835330,7231719342.218599,3150751245.245698,18171631737.431193,28554102324.895490,977950,270423,1565705,2814078
2020-08-14,FINRA / Nasdaq TRF Carteret (DQ),982090996,379119301,1235454912,2596665209,34928858139.018511,19624953286.790299,53146893178.847910,107700704604.656720,4165921,989973,4468755,9624649
2020-08-14,EDGA Equities (J),45602124,20076493,42838590,108517207,2065236480.371100,946894046.588400,2292246386.050000,5304376913.009500,634684,116539,522954,1274177
2020-08-14,EDGX Equities (K),194663767,87927114,283304269,565895150,5447985205.031200,3759038268.796402,8619616304.971803,17826639778.799405,1359915,353369,1487791,3201075
2020-08-14,NYSE Chicago (M),6829170,8628837,8203920,23661927,470561502.443700,1276462517.025000,1106230279.515300,2853254298.984000,6263,1741,6568,14572
2020-08-14,NYSE (N),715612990,35914156,42832737,794359883,26825596486.651402,1678594207.840600,1910403637.643400,30414594332.135402,2506609,100261,339956,2946826
2020-08-14,NYSE Arca (P),180947656,215149007,288767595,684864258,5848466135.781200,11815508994.325697,13410060740.190407,31074035870.297304,1549657,721496,2152994,4424147
2020-08-14,NASDAQ (Q),437349107,148094452,789329220,1374772779,17886098241.330297,8413664728.105002,43763393092.352874,70063156061.788173,4179482,706181,5511014,10396677
2020-08-14,Investors Exchange (V),73775390,11282661,50529081,135587132,3165604950.708200,679747100.205900,3062493336.211500,6907845387.125600,705866,68735,488867,1263468
2020-08-14,NASDAQ PSX (X),19644555,11736744,12848841,44230140,494242264.294100,626356022.242400,1046058489.793600,2166656776.330100,128654,57497,122937,309088
2020-08-14,BYX Equities (Y),52089342,24738817,39934388,116762547,1579961066.362500,1261817885.532800,1546107159.960900,4387886111.856200,608605,123414,398572,1130591
2020-08-14,BZX Equities (Z),151063431,82236474,128319399,361619304,5224000035.188200,4536369572.090099,7245660712.724503,17006030320.002802,1634971,397251,1260748,3292970
2020-08-13,NYSE American (A),10502704,44830362,6963623,62296689,280044271.020000,587352767.165900,318756700.375900,1186153738.561800,129627,168032,88685,386344
2020-08-13,NASDAQ BX (B),29028762,19804111,25557257,74390130,937222823.544400,809935467.501000,1294780067.307100,3041938358.352500,344834,104848,272382,722064
2020-08-13,NYSE National (C),59589418,36370233,27001750,122961401,1217433137.929400,1194433841.159700,940094503.690200,3351961482.779300,513720,169294,300276,983290
2020-08-13,FINRA / Nasdaq TRF Chicago (DB),5607718,3516792,9629782,18754292,205993084.335200,100382809.866400,794452908.132900,1100828802.334500,25328,13882,50064,89274
2020-08-13,FINRA / NYSE TRF (DN),256683031,224359819,502841411,983884261,7424097336.022401,4393200860.035299,23404476657.520099,35221774853.577799,1055801,521106,1662210,3239117
2020-08-13,FINRA / Nasdaq TRF Carteret (DQ),1065623791,635415025,1222718701,2923757517,38988221814.686303,23849980246.262602,67575463876.318694,130413665937.267599,4579090,1726436,4757125,11062651
2020-08-13,EDGA Equities (J),51032027,27889630,41882979,120804636,2370731844.501900,1168848938.831200,2706471311.909399,6246052095.242499,705488,166327,578426,1450241
2020-08-13,EDGX Equities (K),207939564,170497597,255196656,633633817,5946296725.561701,4846675128.011205,10880229404.757000,21673201258.329906,1489745,676751,1586360,3752856
2020-08-13,NYSE Chicago (M),7337081,6034080,5386484,18757645,473941126.469700,494982129.670000,751687677.255900,1720610933.395600,6843,1849,6999,15691
2020-08-13,NYSE (N),717918602,44990809,43888955,806798366,27451987030.567904,2114195280.769800,2364285684.076200,31930467995.413904,2836424,133747,371842,3342013
2020-08-13,NYSE Arca (P),200243751,306436704,292119655,798800110,6939510265.981801,15003710773.410095,17689421247.104308,39632642286.496204,1757533,1035978,2459760,5253271
2020-08-13,NASDAQ (Q),495038153,228116759,802402614,1525557526,20607668625.754808,10451462091.034598,51583465690.650175,82642596407.439581,4781003,1118613,6302666,12202282
2020-08-13,Investors Exchange (V),81814108,14837020,55590245,152241373,3610971725.687100,853398081.444500,3622493651.182800,8086863458.314400,750750,87555,542693,1380998
2020-08-13,NASDAQ PSX (X),20205126,15309301,13965609,49480036,540888346.392300,856419672.696000,980410996.867900,2377719015.956200,145094,77111,136222,358427
2020-08-13,BYX Equities (Y),57401944,35633181,42225520,135260645,1783998588.553600,1779764175.169999,1994673669.329000,5558436433.052599,680704,178097,447650,1306451
2020-08-13,BZX Equities (Z),172765785,118784183,133108572,424658540,6245378933.012600,6060140851.031902,9531362016.221197,21836881800.265699,1869834,580645,1440776,3891255
2020-08-12,NYSE American (A),10037165,47960911,6913838,64911914,293057892.197400,652072674.588600,325021822.339200,1270152389.125200,130696,147513,84213,362422
2020-08-12,NASDAQ BX (B),31058704,20989938,26254896,78303538,1103829295.698400,990467334.247100,1280956518.505600,3375253148.451100,384729,105357,300829,790915
2020-08-12,NYSE National (C),66706953,42167596,31710113,140584662,1391293542.482500,1399400085.773500,1018473406.675200,3809167034.931200,582939,184681,332646,1100266
2020-08-12,FINRA / Nasdaq TRF Chicago (DB),6655200,2965894,10319216,19940310,265563993.114800,91427377.523100,774266958.409900,1131258329.047800,28654,9160,54960,92774
2020-08-12,FINRA / NYSE TRF (DN),291769285,201342752,535686462,1028798499,9302835797.332105,4209867440.852702,23197938981.201011,36710642219.385818,1158704,421979,1759762,3340445
2020-08-12,FINRA / Nasdaq TRF Carteret (DQ),1175360994,662942889,1328498423,3166802306,44768567589.770699,30624719751.655605,68631712364.906806,144024999706.333110,4925594,1499479,4976050,11401123
2020-08-12,EDGA Equities (J),57240170,35721375,46569026,139530571,2784722820.985000,1433219434.562600,2907513896.000800,7125456151.548400,812843,190811,647551,1651205
2020-08-12,EDGX Equities (K),225215671,174413433,269098982,668728086,6869254671.623698,5635965477.587203,10918585421.847997,23423805571.058898,1653075,615561,1696379,3965015
2020-08-12,NYSE Chicago (M),7698281,8337336,4394794,20430411,422692234.805100,999476191.598100,1088131391.188500,2510299817.591700,6680,2264,7793,16737
2020-08-12,NYSE (N),770948616,52923459,49692713,873564788,31235277674.028795,2555614000.720600,2622662703.231301,36413554377.980696,3098086,146720,399027,3643833
2020-08-12,NYSE Arca (P),216014916,332351089,303981715,852347720,7858035848.259797,16860453689.875591,18255581859.285288,42974071397.420676,1909614,1076433,2584809,5570856
2020-08-12,NASDAQ (Q),545458341,231219946,868395974,1645074261,23241755778.939003,12216116086.126305,57854276042.378923,93312147907.444231,5205578,1066908,6656409,12928895
2020-08-12,Investors Exchange (V),89851024,18607298,60130089,168588411,4240780197.972900,1090492533.753700,3883937510.375400,9215210242.102000,790594,95590,536730,1422914
2020-08-12,NASDAQ PSX (X),23001981,18459488,15877539,57339008,600943479.920200,1004249250.206700,1052973982.128500,2658166712.255400,159056,87530,143893,390479
2020-08-12,BYX Equities (Y),61741984,44353680,44967066,151062730,1965592443.087600,1999363680.690300,2052801573.898000,6017757697.675900,753807,198258,487350,1439415
2020-08-12,BZX Equities (Z),193499038,125391699,142745925,461636662,7128282704.362700,7213646655.132299,9497954087.797201,23839883447.292200,2084451,603302,1538426,4226179
2020-08-11,NYSE American (A),12655685,39094663,8233722,59984070,431024537.135800,819480125.076700,408591405.491900,1659096067.704400,157806,144304,108754,410864
2020-08-11,NASDAQ BX (B),38049795,24177434,30145254,92372483,1375174355.158000,1405306727.032301,1528967497.106100,4309448579.296401,460134,128669,338849,927652
2020-08-11,NYSE National (C),82704054,49173867,36724909,168602830,1726946772.179200,1669028788.143400,1184161532.741700,4580137093.064300,705636,220983,384925,1311544
2020-08-11,FINRA / Nasdaq TRF Chicago (DB),9678553,3663025,11692963,25034541,375205231.166000,142178644.849600,632902334.027800,1150286210.043400,41644,11614,53902,107160
2020-08-11,FINRA / NYSE TRF (DN),385956810,186187519,609749525,1181893854,12467264227.132498,5213716939.622696,19946503652.758387,37627484819.513581,1506874,464364,1945859,3917097
2020-08-11,FINRA / Nasdaq TRF Carteret (DQ),1507025922,701862885,1502417396,3711306203,59584584844.857720,33863134397.750201,68396419910.199734,161844139152.807655,6236375,1643745,5659117,13539237
2020-08-11,EDGA Equities (J),72028235,38979134,52988884,163996253,3457628927.825300,1842655102.912200,3228133481.559600,8528417512.297100,1010215,222064,738948,1971227
2020-08-11,EDGX Equities (K),312829550,168640949,306268674,787739173,9539404723.364996,7506694406.354998,11418449871.643000,28464549001.362994,2165402,675018,1950089,4790509
2020-08-11,NYSE Chicago (M),7949350,7828538,3403742,19181630,558824925.961200,989659542.847500,823535722.642500,2372020191.451200,7148,2537,7889,17574
2020-08-11,NYSE (N),956032000,69517536,58164349,1083713885,37959174134.278795,3604969427.237500,2737683868.755901,44301827430.272196,3926645,193749,443886,4564280
2020-08-11,NYSE Arca (P),293237505,374528232,369183396,1036949133,11135939006.233003,21531479600.432866,20150945113.213201,52818363719.879070,2541234,1302581,3083673,6927488
2020-08-11,NASDAQ (Q),729178169,274460697,1033416972,2037055838,31138165071.909197,16831135624.159009,60649310744.839021,108618611440.907227,7033361,1354171,8186076,16573608
2020-08-11,Investors Exchange (V),111954274,21474689,69604399,203033362,5512261335.213800,1293101886.955100,4736063271.471699,11541426493.640599,999016,115773,657103,1771892
2020-08-11,NASDAQ PSX (X),27467723,24756812,19448656,71673191,824339675.111200,1354295230.987300,1298544451.090200,3477179357.188700,192746,123971,170095,486812
2020-08-11,BYX Equities (Y),81350513,48563324,51032787,180946624,2618560825.940200,2577263929.370900,2287547765.339900,7483372520.651000,954864,221725,555702,1732291
2020-08-11,BZX Equities (Z),252445095,160834837,169299606,582579538,9616848722.912301,9577787814.311199,10486913761.072199,29681550298.295699,2658844,785826,1850308,5294978
2020-08-10,NYSE American (A),11086492,35272550,7405950,53764992,351280665.383100,539393270.633000,347957379.453700,1238631315.469800,150806,129961,98354,379121
2020-08-10,NASDAQ BX (B),36227601,18230279,33157408,87615288,1297610221.212500,802081797.612000,1344709800.110000,3444401818.934500,428380,90393,311276,830049
2020-08-10,NYSE National (C),72767747,34859845,31233329,138860921,1538545798.360400,1208919894.786500,978932750.873400,3726398444.020300,632575,175049,343331,1150955
2020-08-10,FINRA / Nasdaq TRF Chicago (DB),7945769,2934819,11292912,22173500,302856689.773300,119009013.224100,670437205.422000,1092302908.419400,38312,9863,54532,102707
2020-08-10,FINRA / NYSE TRF (DN),351386662,149818177,590192026,1091396865,10644019077.995997,4063418197.737500,21324940136.471017,36032377412.204514,1496399,381200,2025508,3903107
2020-08-10,FINRA / Nasdaq TRF Carteret (DQ),1385451290,466054706,1423208256,3274714252,52588624224.587003,21295322425.708399,66509040863.126261,140392987513.421663,5781721,1338607,5572655,12692983
2020-08-10,EDGA Equities (J),66610864,26667470,48982904,142261238,3221132797.351200,1279881213.572100,3135791125.254900,7636805136.178200,928900,164484,693664,1787048
2020-08-10,EDGX Equities (K),269020984,119757036,293570386,682348406,7988847308.149396,4836190685.039799,10332403410.481904,23157441403.671099,1877258,485132,1830591,4192981
2020-08-10,NYSE Chicago (M),5166410,4685251,6031674,15883335,290183863.560000,587881076.680000,1042518544.683500,1920583484.923500,6763,2421,7563,16747
2020-08-10,NYSE (N),864062986,45234318,53933574,963230878,34440857602.135197,2292161263.776500,2444822869.142500,39177841735.054197,3324047,132226,426458,3882731
2020-08-10,NYSE Arca (P),250259647,253801806,327890999,831952452,9137931604.580502,13999739001.679194,17257689030.457693,40395359636.717389,2185443,903745,2755016,5844204
2020-08-10,NASDAQ (Q),607323603,181787907,944034039,1733145549,25617987245.374790,10369637700.531902,53206686336.954889,89194311282.861581,5713058,909772,7230632,13853462
2020-08-10,Investors Exchange (V),97500947,14347141,60849538,172697626,4686353262.663800,834799124.434200,3902158204.032500,9423310591.130500,873404,86227,572613,1532244
2020-08-10,NASDAQ PSX (X),25280470,17549002,17800730,60630202,674368288.607200,923126433.276600,1113969262.718700,2711463984.602500,183030,87443,164801,435274
2020-08-10,BYX Equities (Y),69560313,32308717,44196540,146065570,2296320841.395400,1582095229.414200,1961003433.897701,5839419504.707301,836071,158754,502578,1497403
2020-08-10,BZX Equities (Z),208275842,108926133,154641127,471843102,7804895964.025499,6246752062.038502,9322894381.197595,23374542407.261596,2224717,550465,1670682,4445864
2020-08-07,NYSE American (A),10893083,28792524,8035848,47721455,332513064.551500,558022383.315400,325252912.604500,1215788360.471400,150210,109829,96990,357029
2020-08-07,NASDAQ BX (B),34143932,19999142,28909207,83052281,1144909463.931700,1006035808.959300,1365778840.121400,3516724113.012400,387163,100130,293201,780494
2020-08-07,NYSE National (C),73164863,43472645,31297371,147934879,1447700019.421400,1502201365.762100,976680629.834900,3926582015.018400,596065,190896,333922,1120883
2020-08-07,FINRA / Nasdaq TRF Chicago (DB),7385070,2626071,11568567,21579708,328181031.899400,119938800.201000,772329013.740400,1220448845.840800,36026,8841,59143,104010
2020-08-07,FINRA / NYSE TRF (DN),322145064,149840084,647061936,1119047084,10146548588.748599,4240066203.588102,23841175838.348609,38227790630.685310,1363817,363254,1988196,3715267
2020-08-07,FINRA / Nasdaq TRF Carteret (DQ),1265405527,475482139,1515306464,3256194130,48524657298.959893,23092811713.921394,72117521758.943019,143734990771.824306,5406155,1290709,5512919,12209783
2020-08-07,EDGA Equities (J),68011513,31764092,50827637,150603242,3355128836.581100,1629133766.982300,3327208488.845000,8311471092.408400,947292,183056,698937,1829285
2020-08-07,EDGX Equities (K),249631570,127802448,305824914,683258932,7588511917.160599,5771057573.782401,11577653835.181897,24937223326.124897,1782077,481427,1803224,4066728
2020-08-07,NYSE Chicago (M),7495806,9221217,14933999,31651022,592755598.257000,899921202.652000,2484265075.068600,3976941875.977600,5323,2355,5460,13138
2020-08-07,NYSE (N),807880670,52266810,56514064,916661544,32399420511.079702,2611502087.940400,3032192735.683100,38043115334.703202,3259098,144616,464178,3867892
2020-08-07,NYSE Arca (P),244941815,298647196,326062583,869651594,9179870038.741500,17061915430.166394,18786058480.453302,45027843949.361196,2080864,981858,2686357,5749079
2020-08-07,NASDAQ (Q),605609134,205589112,955104234,1766302480,26734640073.382908,12711665849.164499,59207901453.925762,98654207376.473169,5649615,986510,7268222,13904347
2020-08-07,Investors Exchange (V),105953496,15215376,68896331,190065203,5652497566.987401,972201222.015700,4801392557.280801,11426091346.283902,939607,89735,636784,1666126
2020-08-07,NASDAQ PSX (X),26746907,20309756,20718149,67774812,758005186.828500,1155605114.732600,1521338411.322599,3434948712.883699,181940,97590,172397,451927
2020-08-07,BYX Equities (Y),69712891,36812191,56522030,163047112,2234454322.373100,1984248794.021800,2308664672.251900,6527367788.646800,821917,167967,529246,1519130
2020-08-07,BZX Equities (Z),210914561,123939244,166353821,501207626,8400902038.658898,7195324601.353200,11819103610.162304,27415330250.174402,2253232,589651,1760823,4603706
2020-08-06,NYSE American (A),10934787,31887047,7782043,50603877,323315986.165700,483466282.262300,324664625.055800,1131446893.483800,140255,108551,86841,335647
2020-08-06,NASDAQ BX (B),36906436,16024953,25274431,78205820,1201915898.170200,773575680.892900,1184471151.336500,3159962730.399600,422292,85781,283673,791746
2020-08-06,NYSE National (C),71777235,36186775,29621664,137585674,1344776870.501700,1223611203.160000,907971408.837400,3476359482.499100,605122,165482,321258,1091862
2020-08-06,FINRA / Nasdaq TRF Chicago (DB),8336954,2818782,11876694,23032430,297182035.031900,106741585.596000,639102374.765900,1043025995.393800,35486,8588,54051,98125
2020-08-06,FINRA / NYSE TRF (DN),336621053,153087340,617940927,1107649320,10094721886.221898,3829880940.976902,21522785540.427396,35447388367.626196,1385105,345206,1957707,3688018
2020-08-06,FINRA / Nasdaq TRF Carteret (DQ),1383811645,455674077,1461790123,3301275845,50068990202.262817,19614385866.897793,63461748711.678242,133145124780.838852,5678669,1192312,5437431,12308412
2020-08-06,EDGA Equities (J),68725140,24987273,52002351,145714764,3228560488.318500,1242726366.992400,2989568300.255900,7460855155.566800,955627,159214,695246,1810087
2020-08-06,EDGX Equities (K),262793653,121542452,307215281,691551386,7440069462.325502,4830484356.675003,10540146136.166298,22810699955.166803,1771996,441155,1777441,3990592
2020-08-06,NYSE Chicago (M),15049458,6292669,4545888,25888015,566229297.723000,945147673.205000,703377877.530500,2214754848.458500,5363,2102,6033,13498
2020-08-06,NYSE (N),806731613,44276206,51484418,902492237,31114395564.728294,2275911949.440100,2819177181.974200,36209484696.142594,3195448,133087,441112,3769647
2020-08-06,NYSE Arca (P),250899341,266055924,318980810,835936075,8623171211.845103,14952726135.338198,16370146829.765794,39946044176.949095,2056825,857542,2566222,5480589
2020-08-06,NASDAQ (Q),607552226,174553017,936892751,1718997994,25288579225.353298,10506973274.190997,53230722537.745598,89026275037.289893,5620500,857679,6886599,13364778
2020-08-06,Investors Exchange (V),113994382,15147415,70125214,199267011,5483161883.196200,909573008.090400,4789026685.170101,11181761576.456701,932236,76661,609061,1617958
2020-08-06,NASDAQ PSX (X),26894259,17173318,18867431,62935008,723119421.395800,916842110.641100,1183665777.503800,2823627309.540700,188570,81396,157263,427229
2020-08-06,BYX Equities (Y),69256254,34406968,51299890,154963112,2130155642.748400,1634682776.944099,2031200564.505500,5796038984.197999,804170,164776,505251,1474197
2020-08-06,BZX Equities (Z),208650848,104988099,154303234,467942181,7720030604.645398,5924653363.062498,9888489090.927196,23533173058.635092,2201707,522343,1611055,4335105
2020-08-05,NYSE American (A),12067124,34407363,7725805,54200292,323261860.460200,609082857.565600,250926388.179600,1183271106.205400,131332,121156,86774,339262
2020-08-05,NASDAQ BX (B),35671873,17001914,24108804,76782591,1312883336.818800,913414583.153500,1120070476.422000,3346368396.394300,440249,95509,279580,815338
2020-08-05,NYSE National (C),78438724,36983240,28233843,143655807,1459375714.598300,1263623735.793900,842126166.797800,3565125617.190000,623937,174973,299188,1098098
2020-08-05,FINRA / Nasdaq TRF Chicago (DB),8583143,2990298,11090277,22663718,340048990.743100,108607077.534100,524378034.396200,973034102.673400,38848,8772,51180,98800
2020-08-05,FINRA / NYSE TRF (DN),353629264,151496479,619475673,1124601416,11990958277.524701,3940648118.873103,17714003947.781807,33645610344.179611,1424920,363790,1864431,3653141
2020-08-05,FINRA / Nasdaq TRF Carteret (DQ),1445569920,536666671,1504092280,3486328871,55251549897.014507,23717540169.248010,58512353238.744084,137481443305.006601,5788006,1266257,5193452,12247715
2020-08-05,EDGA Equities (J),70929899,28680068,49387292,148997259,3544740010.507200,1433980421.439800,2826098501.850100,7804818933.797100,965379,178878,666777,1811034
2020-08-05,EDGX Equities (K),272032324,126208889,293380002,691621215,7994337333.639199,4770448188.030001,8833905950.694602,21598691472.363802,1763500,448565,1642135,3854200
2020-08-05,NYSE Chicago (M),6396618,7545985,7911376,21853979,578787823.231900,1209637461.450000,2098756808.154400,3887182092.836300,5305,2909,5166,13380
2020-08-05,NYSE (N),900057517,50966796,47217078,998241391,33939291184.066097,2409432688.688400,2186550911.711700,38535274784.466197,3232535,143054,402017,3777606
2020-08-05,NYSE Arca (P),261336124,290597687,321144936,873078747,9737697941.132201,15621038535.713100,15072441437.328298,40431177914.173599,2125373,924236,2497352,5546961
2020-08-05,NASDAQ (Q),637957313,191410112,951487199,1780854624,28305075168.837297,10763007512.658203,49732902750.604290,88800985432.099790,5794258,892823,6662107,13349188
2020-08-05,Investors Exchange (V),118712600,16206828,66910347,201829775,5669931125.651099,963930844.303800,4358997908.025198,10992859877.980097,947566,83284,601830,1632680
2020-08-05,NASDAQ PSX (X),30557683,19588811,18129811,68276305,786021331.375500,1100949950.677900,937271032.420200,2824242314.473600,189988,87879,150038,427905
2020-08-05,BYX Equities (Y),75536895,38746499,49984555,164267949,2351446308.431300,1952190197.379500,1908848111.600200,6212484617.411000,852861,185279,496229,1534369
2020-08-05,BZX Equities (Z),227592949,115319092,160462057,503374098,8656688672.574599,6131807222.587602,8535751005.573099,23324246900.735300,2285733,549929,1616663,4452325
2020-08-04,NYSE American (A),10920324,31403200,6504368,48827892,292046588.548700,541518740.409000,275980844.393600,1109546173.351300,130430,120831,80185,331446
2020-08-04,NASDAQ BX (B),34479236,17104728,23433496,75017460,1103047852.019000,966137883.043300,1234236005.282300,3303421740.344600,396579,96314,288981,781874
2020-08-04,NYSE National (C),80487198,39110630,27413498,147011326,1467150509.501500,1293479125.841000,920107598.150000,3680737233.492500,632840,179483,310514,1122837
2020-08-04,FINRA / Nasdaq TRF Chicago (DB),7659895,2458515,11357305,21475715,239064018.968100,90777615.401400,664362281.835700,994203916.205200,32910,8236,54984,96130
2020-08-04,FINRA / NYSE TRF (DN),341751718,133517330,597486116,1072755164,9251647459.266899,3501558727.475800,21835872748.309190,34589078935.051889,1345701,328267,1952854,3626822
2020-08-04,FINRA / Nasdaq TRF Carteret (DQ),1404890426,478177534,1420725861,3303793821,48542669262.127113,21862871089.793406,65164280842.138326,135569821194.058845,5532831,1279791,5293743,12106365
2020-08-04,EDGA Equities (J),70311647,28088371,49334742,147734760,3244905462.674600,1440351609.131500,3029818250.630201,7715075322.436301,952812,174184,684678,1811674
2020-08-04,EDGX Equities (K),256212873,111736079,289346544,657295496,6979237560.718801,4623575691.365796,9607727762.243602,21210541014.328199,1706346,435820,1692485,3834651
2020-08-04,NYSE Chicago (M),12374664,8403267,6867842,27645773,712833989.817600,1280879774.423000,1804268653.510600,3797982417.751200,4807,1795,5328,11930
2020-08-04,NYSE (N),863278908,45378958,53528073,962185939,32460867540.979600,2319883778.301300,2739557077.986301,37520308397.267201,3232501,134550,421390,3788441
2020-08-04,NYSE Arca (P),258873036,271005322,316016968,845895326,8571061370.581001,14959591947.299308,16470625213.714595,40001278531.594904,2045189,915959,2516673,5477821
2020-08-04,NASDAQ (Q),634456869,174201075,933896276,1742554220,26098416073.307099,10396595447.078200,54988622598.054686,91483634118.439985,5973661,854251,7065584,13893496
2020-08-04,Investors Exchange (V),110597442,14849028,60996917,186443387,4969677099.353800,924455423.451100,3882459201.949401,9776591724.754301,898195,82997,576485,1557677
2020-08-04,NASDAQ PSX (X),31828978,18270525,18879365,68978868,805998231.391700,1096563751.384100,1104048869.858400,3006610852.634200,201801,95440,171134,468375
2020-08-04,BYX Equities (Y),77084306,36895020,43075670,157054996,2237409298.059400,1840802906.615500,1905070449.436400,5983282654.111300,850846,176361,491304,1518511
2020-08-04,BZX Equities (Z),219174402,111567627,157660758,488402787,7732876689.127403,6105247520.770401,9444788632.667202,23282912842.565006,2278843,552449,1659503,4490795
2020-08-03,NYSE American (A),10584924,26081364,5761233,42427521,285437249.903400,420768544.382200,293055439.852900,999261234.138500,128140,96933,87678,312751
2020-08-03,NASDAQ BX (B),33768973,17043226,24340471,75152670,1148352031.483200,1045248123.720000,1439623625.555200,3633223780.758400,416759,94792,304092,815643
2020-08-03,NYSE National (C),74383324,40317252,29455911,144156487,1394732564.252200,1364356443.803400,950341124.590600,3709430132.646200,619936,165735,322661,1108332
2020-08-03,FINRA / Nasdaq TRF Chicago (DB),7950723,2289203,11799910,22039836,281306057.110500,92858214.643400,712213244.998600,1086377516.752500,36248,8981,59784,105013
2020-08-03,FINRA / NYSE TRF (DN),367970314,131395869,637468791,1136834974,9944697632.571696,3702714453.445299,23445512427.425692,37092924513.442687,1555386,344655,2091070,3991111
2020-08-03,FINRA / Nasdaq TRF Carteret (DQ),1409067564,465168673,1483723625,3357959862,48971812277.207593,23487266605.852095,72447115344.921982,144906194227.981670,5946290,1227496,5587441,12761227
2020-08-03,EDGA Equities (J),71719098,25089123,48736721,145544942,3358840744.924300,1337049871.727300,2985042589.359800,7680933206.011400,979514,162605,704826,1846945
2020-08-03,EDGX Equities (K),260653591,100389023,305087181,666129795,7029871561.679799,4425023888.527698,10208294258.371695,21663189708.579192,1767034,409162,1743385,3919581
2020-08-03,NYSE Chicago (M),5064801,6957800,16643142,28665743,425375714.759000,1070607995.140000,921259139.828400,2417242849.727400,5226,1279,6813,13318
2020-08-03,NYSE (N),871512923,40850728,54988319,967351970,34261595122.470200,2208941323.413800,2791422379.912500,39261958825.796500,3349204,126163,447072,3922439
2020-08-03,NYSE Arca (P),266020476,279352686,328695066,874068228,8922811202.942601,16626419282.784601,18537847543.833298,44087078029.560500,2206656,908090,2711957,5826703
2020-08-03,NASDAQ (Q),629147900,170130329,961384582,1760662811,25870563216.462308,10622947260.327396,61402516016.303092,97896026493.092796,6159644,850193,7444443,14454280
2020-08-03,Investors Exchange (V),109766725,15733559,63120173,188620457,4960979781.957700,999536442.131300,4632126921.708200,10592643145.797200,918717,87854,573822,1580393
2020-08-03,NASDAQ PSX (X),27622496,17989348,18232653,63844497,702558715.824400,1005927961.880000,923194275.555100,2631680953.259500,188650,87023,158081,433754
2020-08-03,BYX Equities (Y),73261436,32122796,45327989,150712221,2193177576.593000,1814654198.661000,2087203629.994400,6095035405.248400,848156,153472,522536,1524164
2020-08-03,BZX Equities (Z),220454049,104326718,169130939,493911706,7831127181.436801,5927758437.183298,10755868297.190203,24514753915.810302,2326090,517242,1789025,4632357
2020-07-31,NYSE American (A),13126439,32212426,5879355,51218220,328956260.391400,667952667.615800,347944079.374900,1344853007.382100,131672,112450,79868,323990
2020-07-31,NASDAQ BX (B),37384144,22092291,36257446,95733881,1279027738.225200,1400705835.582600,1686888208.315401,4366621782.123201,417606,127002,321288,865896
2020-07-31,NYSE National (C),88668484,47504484,37700303,173873271,1626799324.203600,1695564586.184199,1135858438.553200,4458222348.940999,691304,216381,374954,1282639
2020-07-31,FINRA / Nasdaq TRF Chicago (DB),8503519,2898774,11958233,23360526,258822481.756300,116589235.094100,860926133.860500,1236337850.710900,33014,8924,57634,99572
2020-07-31,FINRA / NYSE TRF (DN),317592286,148700266,617052401,1083344953,8966709390.430999,4447634153.405301,25113271513.619098,38527615057.455398,1358194,347631,1969025,3674850
2020-07-31,FINRA / Nasdaq TRF Carteret (DQ),1449161512,528180764,1478435837,3455778113,51453822257.633393,28967182891.306102,79317972376.758140,159738977525.697635,5747894,1249034,5418998,12415926
2020-07-31,EDGA Equities (J),79113884,33638799,56712185,169464868,3651015419.073700,1949121814.176201,3745360581.558501,9345497814.808402,1019018,198540,744468,1962026
2020-07-31,EDGX Equities (K),263370409,124985836,293321899,681678144,6868668744.984001,6265020375.508699,12432938995.086507,25566628115.579207,1741807,517352,1739069,3998228
2020-07-31,NYSE Chicago (M),10994531,3564483,5402116,19961130,533324190.063200,604350251.714000,969929719.587000,2107604161.364200,5224,1395,5619,12238
2020-07-31,NYSE (N),1305439508,61503246,63768610,1430711364,50475572987.722397,3611458199.256599,4032476699.364400,58119507886.343396,3536630,197164,535528,4269322
2020-07-31,NYSE Arca (P),274056878,333855273,336289425,944201576,8992722616.932904,20633454946.342600,22983273346.820200,52609450910.095704,2212713,1203345,2870793,6286851
2020-07-31,NASDAQ (Q),686046106,241760255,1169736560,2097542921,27619627861.136708,15119573700.305706,80089874503.463968,122829076064.906382,6179501,1152906,7745646,15078053
2020-07-31,Investors Exchange (V),113033717,18596953,63310871,194941541,5298058481.638000,1315576464.442200,5318134605.724302,11931769551.804502,928788,100850,568459,1598097
2020-07-31,NASDAQ PSX (X),34018363,24705984,20673747,79398094,873995921.508600,1394469896.497000,1558118912.902900,3826584730.908500,214489,116238,186791,517518
2020-07-31,BYX Equities (Y),82785396,44373620,59832193,186991209,2425407718.571800,2419157799.677899,2616453428.445700,7461018946.695399,895902,190263,551538,1637703
2020-07-31,BZX Equities (Z),244241617,149679294,182404670,576325581,8512258886.075800,9105026169.946006,14276241461.721407,31893526517.743213,2410302,736387,1858735,5005424
2020-07-30,NYSE American (A),12015139,28620301,5554242,46189682,321501824.023300,534085557.699700,273917572.648400,1129504954.371400,124338,110397,73150,307885
2020-07-30,NASDAQ BX (B),38656012,18053811,34567696,91277519,1363155341.722700,1029561778.643500,1460245033.440200,3852962153.806400,438495,104344,315105,857944
2020-07-30,NYSE National (C),75482407,42715262,31898520,150096189,1519753910.504600,1422760126.460600,979593168.208900,3922107205.174100,631935,195598,319909,1147442
2020-07-30,FINRA / Nasdaq TRF Chicago (DB),8025606,3369644,11886596,23281846,261945595.676400,129047630.851600,575757647.975400,966750874.503400,30914,10064,52805,93783
2020-07-30,FINRA / NYSE TRF (DN),318525651,148254580,611859956,1078640187,9439217247.380402,4324541348.073198,19372819623.413003,33136578218.866603,1336434,368035,1981593,3686062
2020-07-30,FINRA / Nasdaq TRF Carteret (DQ),1258171659,605788895,1405567491,3269528045,45013209373.367607,27856711303.728907,58081263556.801086,130951184233.897600,5277189,1458817,5021290,11757296
2020-07-30,EDGA Equities (J),76049668,34974727,53659868,164684263,3488047811.263500,1755049291.934901,3110665708.122401,8353762811.320802,980146,210308,686748,1877202
2020-07-30,EDGX Equities (K),268454803,127814979,308311190,704580972,7431324805.644199,5806296173.832203,10989441924.937893,24227062904.414295,1749564,531779,1801054,4082397
2020-07-30,NYSE Chicago (M),8152845,6824631,6829156,21806632,431747211.565000,930329546.010000,884931684.512500,2247008442.087500,4985,1594,5604,12183
2020-07-30,NYSE (N),826221131,55571150,58232045,940024326,30287331570.057302,3049324766.577400,2853337559.425400,36189993896.060102,3299466,183995,455073,3938534
2020-07-30,NYSE Arca (P),262438304,308488268,341337804,912264376,9082662597.471802,17495843168.242603,19936486751.983812,46514992517.698217,2118057,1077400,2743434,5938891
2020-07-30,NASDAQ (Q),635656209,224787499,992016836,1852460544,26587006526.290701,13603853979.559202,54312553593.992923,94503414099.842826,5812004,1094887,7111079,14017970
2020-07-30,Investors Exchange (V),110814736,17821507,63472005,192108248,5201417767.163599,1070981817.096300,4101664246.848100,10374063831.107999,905975,98317,573860,1578152
2020-07-30,NASDAQ PSX (X),31429312,23815230,19946744,75191286,831084937.617100,1280838684.105100,1006013128.636200,3117936750.358400,203762,121456,171610,496828
2020-07-30,BYX Equities (Y),77822948,41919714,58548019,178290681,2265028316.793500,2113936211.836700,2215952910.725200,6594917439.355400,839087,197150,523088,1559325
2020-07-30,BZX Equities (Z),257010115,143618013,182124672,582752800,8782898212.660704,8175817331.239597,10333480460.386400,27292196004.286701,2446202,705889,1787560,4939651
2020-07-29,NYSE American (A),10256386,29359096,5504733,45120215,285636203.848500,412908774.487200,231171650.514200,929716628.849900,111537,102010,68221,281768
2020-07-29,NASDAQ BX (B),38327756,15639949,29565331,83533036,1270038257.505300,875892822.193500,1096201066.241300,3242132145.940100,418356,86349,277353,782058
2020-07-29,NYSE National (C),77059370,37557180,32457371,147073921,1499824819.955100,1245584728.155100,864885007.957300,3610294556.067500,627278,172909,319183,1119370
2020-07-29,FINRA / Nasdaq TRF Chicago (DB),7945482,2757084,11521246,22223812,308255671.378400,106202745.473900,533646002.213000,948104419.065300,36102,8091,45113,89306
2020-07-29,FINRA / NYSE TRF (DN),353683659,148593842,584421963,1086699464,10925311154.834499,3835905084.181698,16233288780.901792,30994505019.917989,1511322,333926,1686897,3532145
2020-07-29,FINRA / Nasdaq TRF Carteret (DQ),1370584716,468145909,1394503268,3233233893,50660868516.223809,20822945933.819311,53360365877.581181,124844180327.624301,5696634,1108324,4675980,11480938
2020-07-29,EDGA Equities (J),75803065,25939730,49478622,151221417,3609453678.290400,1307493633.752000,2709548315.316100,7626495627.358500,985173,161808,640296,1787277
2020-07-29,EDGX Equities (K),273161556,115441540,282573986,671177082,7783176492.035699,4753074280.300599,7631985308.021103,20168236080.357401,1781002,430142,1455213,3666357
2020-07-29,NYSE Chicago (M),7102495,6783924,3311188,17197607,334728790.962500,967614511.174000,394189386.329600,1696532688.466100,5210,1409,5939,12558
2020-07-29,NYSE (N),860689099,45215916,52490839,958395854,34230116015.762497,2339753104.997800,2375091270.283601,38944960391.043898,3191394,134246,380030,3705670
2020-07-29,NYSE Arca (P),280880921,265037631,319185653,865104205,9947774280.453700,15134466454.426804,14337729492.025394,39419970226.905898,2243362,905960,2421073,5570395
2020-07-29,NASDAQ (Q),679164139,192469989,930618328,1802252456,28125958858.393391,10840183063.321198,47702833237.219653,86668975158.934242,6052793,881376,6412213,13346382
2020-07-29,Investors Exchange (V),108300576,15502786,61516886,185320248,5083868562.765700,857799837.210700,4005238888.665600,9946907288.642000,898388,80790,540769,1519947
2020-07-29,NASDAQ PSX (X),29460654,20027510,18181050,67669214,787623993.648500,1085535055.285900,803984696.651800,2677143745.586200,203744,91912,156417,452073
2020-07-29,BYX Equities (Y),75755138,33994081,65562309,175311528,2306560729.150100,1585622757.818600,1854293160.557600,5746476647.526300,821323,155530,481856,1458709
2020-07-29,BZX Equities (Z),230025660,116556408,168750123,515332191,8222640772.689899,6137665171.956701,7785360536.131597,22145666480.778197,2273667,539610,1521552,4334829
2020-07-28,NYSE American (A),9675870,29258297,4299981,43234148,273673176.402900,410572943.839700,218626404.318200,902872524.560800,119534,99004,62734,281272
2020-07-28,NASDAQ BX (B),32225331,15170313,24985447,72381091,1077463096.972300,844858305.744800,1057370324.600100,2979691727.317200,372697,86000,253884,712581
2020-07-28,NYSE National (C),77326691,37709328,29899090,144935109,1483336528.743300,1258193626.794700,813530870.315800,3555061025.853800,645779,173316,303712,1122807
2020-07-28,FINRA / Nasdaq TRF Chicago (DB),7596706,2877144,12482068,22955918,240325822.783300,103032041.626700,579035191.683700,922393056.093700,31676,8494,44661,84831
2020-07-28,FINRA / NYSE TRF (DN),314161051,148800571,627766351,1090727973,8509472912.985401,4288146036.260298,18494335225.982397,31291954175.228096,1321831,337161,1650311,3309303
2020-07-28,FINRA / Nasdaq TRF Carteret (DQ),1275904994,463304337,1354062657,3093271988,45941818115.746091,21727428119.694204,54743929083.479357,122413175318.919652,5263881,1115624,4280634,10660139
2020-07-28,EDGA Equities (J),65788994,23941467,45159172,134889633,3109985599.061600,1198909905.399000,2539922363.423901,6848817867.884501,895623,153580,595845,1645048
2020-07-28,EDGX Equities (K),248633867,111345138,282201107,642180112,6145306868.378399,4477424540.465799,7735032864.187203,18357764273.031401,1616930,414260,1353973,3385163
2020-07-28,NYSE Chicago (M),5148127,5098607,4635740,14882474,317813977.621500,1033745770.735800,597908999.397800,1949468747.755100,5222,1584,5446,12252
2020-07-28,NYSE (N),725072898,45457654,48806171,819336723,26526973600.775898,2310139235.167000,2067196645.380900,30904309481.323798,2929062,133616,346342,3409020
2020-07-28,NYSE Arca (P),276931438,255290846,297615444,829837728,8619746712.862000,14307350445.824188,14431284753.459791,37358381912.145979,2107721,886037,2226258,5220016
2020-07-28,NASDAQ (Q),600438214,182980780,858201213,1641620207,23811682425.865806,10495136148.723700,45974459864.015120,80281278438.604626,5316470,851762,5879211,12047443
2020-07-28,Investors Exchange (V),100174941,12912738,51008840,164096519,4593880901.456701,778896991.338400,3106307276.606000,8479085169.401101,803360,76188,456886,1336434
2020-07-28,NASDAQ PSX (X),29122436,18746711,16594668,64463815,746002548.573100,1038572248.851800,798720038.179900,2583294835.604800,186644,92148,141220,420012
2020-07-28,BYX Equities (Y),67766223,33417280,75673159,176856662,2016443180.662800,1515709568.566800,1762566349.189200,5294719098.418800,742626,153899,446180,1342705
2020-07-28,BZX Equities (Z),217220099,114378507,161272793,492871399,7198704570.835900,5929360750.917700,7703797510.396000,20831862832.149600,2063530,531084,1391414,3986028
2020-07-27,NYSE American (A),9638904,39367332,5333102,54339338,288662831.066500,397578440.058100,249467031.959000,935708303.083600,104819,115741,69558,290118
2020-07-27,NASDAQ BX (B),31034501,15971939,28768962,75775402,1011828726.100100,883113812.530200,1124410528.863800,3019353067.494100,349254,86087,271952,707293
2020-07-27,NYSE National (C),74353041,39866180,30735360,144954581,1425832687.215200,1344267708.531900,876295108.956500,3646395504.703600,611806,181018,313368,1106192
2020-07-27,FINRA / Nasdaq TRF Chicago (DB),6602187,3710234,12250607,22563028,202856322.189000,126188147.705400,580890929.810300,909935399.704700,28314,11314,49510,89138
2020-07-27,FINRA / NYSE TRF (DN),274824631,173933797,664485882,1113244310,8048572035.571299,4106228766.533699,20084759111.364409,32239559913.469407,1256622,403531,1933035,3593188
2020-07-27,FINRA / Nasdaq TRF Carteret (DQ),1258699807,512532464,1476007599,3247239870,45521574519.564393,20388565847.241515,60313259494.246608,126223399861.052516,5027937,1265009,4859641,11152587
2020-07-27,EDGA Equities (J),63251963,27617467,48175267,139044697,2922313021.201500,1463031612.349500,2647667892.431100,7033012525.982100,859845,173993,622083,1655921
2020-07-27,EDGX Equities (K),230177266,132196652,312225935,674599853,6049308612.676399,4529798574.931901,8771451337.787896,19350558525.396196,1542850,463594,1542320,3548764
2020-07-27,NYSE Chicago (M),5904049,8271534,5471626,19647209,367082312.290000,1659998915.984800,573310196.581700,2600391424.856500,5121,1959,5466,12546
2020-07-27,NYSE (N),789959856,47586991,48838827,886385674,30217837120.129895,2264036153.068100,2267445221.732600,34749318494.930595,2808156,135559,364347,3308062
2020-07-27,NYSE Arca (P),237914110,274810030,325472466,838196606,7766562046.894699,14502828211.504400,15721502200.396102,37990892458.795201,1880156,931244,2441387,5252787
2020-07-27,NASDAQ (Q),584335754,192763871,972648850,1749748475,23306927635.789100,10121268047.254899,52385568931.782520,85813764614.826519,5173491,874158,6290764,12338413
2020-07-27,Investors Exchange (V),95071242,16141770,54428763,165641775,4366586148.077700,883447360.428600,3388578077.492201,8638611585.998501,797354,78485,485123,1360962
2020-07-27,NASDAQ PSX (X),28449175,18738067,17031161,64218403,693082734.979700,967550843.710700,912113472.285000,2572747050.975400,177496,87865,146840,412201
2020-07-27,BYX Equities (Y),66402217,38524711,75593253,180520181,1987532125.938500,1628060340.082301,1834843277.298400,5450435743.319201,752547,165028,476074,1393649
2020-07-27,BZX Equities (Z),213700757,116122436,167104640,496927833,7282732271.034198,5808914998.152002,8614148045.511300,21705795314.697500,2086161,552865,1509890,4148916
2020-07-24,NYSE American (A),8658906,32283604,5299863,46242373,275629583.591800,359393021.116000,310472077.449900,945494682.157700,98847,106243,73554,278644
2020-07-24,NASDAQ BX (B),27235004,16281437,31727945,75244386,991263592.141600,939896770.487700,1457550287.340900,3388710649.970200,324039,97863,304646,726548
2020-07-24,NYSE National (C),73612326,45187409,34994091,153793826,1421142144.727600,1449465286.780900,1106413567.221100,3977020998.729600,600159,206317,334846,1141322
2020-07-24,FINRA / Nasdaq TRF Chicago (DB),6886791,2935083,13076134,22898008,218482889.344400,111473961.044700,841132168.447700,1171089018.836800,27523,9159,55694,92376
2020-07-24,FINRA / NYSE TRF (DN),283619053,187054321,643755596,1114428970,7698231241.005001,4428923058.962698,24411164664.336009,36538318964.303708,1168831,397864,1938378,3505073
2020-07-24,FINRA / Nasdaq TRF Carteret (DQ),1126407247,516955147,1445280857,3088643251,40228967680.643899,24694182447.961909,68528734987.380306,133451885115.986114,4480796,1209072,5047794,10737662
2020-07-24,EDGA Equities (J),58527083,31667966,52108775,142303824,2688247349.851500,1518460631.759800,3050066109.303999,7256774090.915299,801138,200988,672737,1674863
2020-07-24,EDGX Equities (K),207120415,133113839,291312740,631546994,5516544923.863301,5120455100.383600,10266648348.438000,20903648372.684901,1378817,515069,1635008,3528894
2020-07-24,NYSE Chicago (M),10966831,4836060,6140628,21943519,793356498.410200,503550966.675000,1211649894.013000,2508557359.098200,5541,1509,6632,13682
2020-07-24,NYSE (N),711326204,55621389,51387193,818334786,27355366004.376797,2754516911.194200,2832382926.762901,32942265842.333898,2780580,175730,412564,3368874
2020-07-24,NYSE Arca (P),232701962,298617635,339437433,870757030,7756681950.400298,16959025254.139000,20038251595.612812,44753958800.152110,1833684,1086270,2676124,5596078
2020-07-24,NASDAQ (Q),552879075,219909175,987540994,1760329244,23102697389.037005,12717653485.064896,60601978101.085617,96422328975.187518,5066876,1030490,7167420,13264786
2020-07-24,Investors Exchange (V),90999593,16088359,63160569,170248521,4219192164.910300,886865178.885700,4343683884.994501,9449741228.790501,742986,80888,532141,1356015
2020-07-24,NASDAQ PSX (X),27164076,21788337,19658985,68611398,735208919.544500,1160353969.927200,1483281389.407300,3378844278.879000,182814,117737,200024,500575
2020-07-24,BYX Equities (Y),62311331,36604782,64234719,163150832,1881643797.958900,1890489115.035799,2597525566.571000,6369658479.565699,703247,174911,529557,1407715
2020-07-24,BZX Equities (Z),209000582,131780158,184276415,525057155,7327797963.404600,7844284672.694101,11691468544.574791,26863551180.673492,1985968,660578,1692952,4339498
2020-07-23,NYSE American (A),9231691,41170499,5873245,56275435,341891014.585400,448862964.579000,330944854.129600,1121698833.294000,99235,123719,72001,294955
2020-07-23,NASDAQ BX (B),32814482,19455306,30760978,83030766,1194964285.907300,1112672379.077400,1489611791.602102,3797248456.586802,367375,107013,298813,773201
2020-07-23,NYSE National (C),84459207,52890018,35002391,172351616,1661645997.545900,1774607119.194000,1069196522.242400,4505449638.982300,655700,235139,334710,1225549
2020-07-23,FINRA / Nasdaq TRF Chicago (DB),8591621,3430372,14315081,26337074,310472446.787600,126804117.514600,986124412.448800,1423400976.751000,36966,10691,74396,122053
2020-07-23,FINRA / NYSE TRF (DN),329425397,226268123,667583244,1223276764,9612918187.204899,4810015941.321403,26191626490.873579,40614560619.399881,1417255,462778,2249993,4130026
2020-07-23,FINRA / Nasdaq TRF Carteret (DQ),1338805369,607082440,1544703823,3490591632,49754183882.038600,26152384266.028903,75035075904.186488,150941644052.253991,5174612,1367523,5429949,11972084
2020-07-23,EDGA Equities (J),66249736,36015154,50093275,152358165,3004780037.444200,1697838791.856600,2932205268.352601,7634824097.653401,887512,220535,649916,1757963
2020-07-23,EDGX Equities (K),248473958,169725378,315281126,733480462,6933048840.799400,6261045276.674598,11724211400.051098,24918305517.525096,1629725,607864,1796597,4034186
2020-07-23,NYSE Chicago (M),8205845,5064285,4037053,17307183,449004167.203800,534039340.247900,913950800.692500,1896994308.144200,5859,1024,7000,13883
2020-07-23,NYSE (N),820602496,62768323,56594429,939965248,31233070339.649099,3131865915.732500,2947392927.855100,37312329183.236699,3178169,186519,429014,3793702
2020-07-23,NYSE Arca (P),264243251,349585799,375215976,989045026,9362711850.187000,19108755785.680619,22215193354.282206,50686660990.149825,2144523,1229881,2943944,6318348
2020-07-23,NASDAQ (Q),640466776,277920213,1067869946,1986256935,26192209375.717503,15253031877.609704,67989891576.118815,109435132829.446022,5679581,1202689,7684085,14566355
2020-07-23,Investors Exchange (V),102079246,16600875,64547037,183227158,4857847845.061701,1127293416.864800,4247914231.537499,10233055493.464000,824892,87389,538327,1450608
2020-07-23,NASDAQ PSX (X),33212818,26538247,19970080,79721145,904444569.861000,1400082352.059900,1359787072.333900,3664313994.254800,219381,132053,187303,538737
2020-07-23,BYX Equities (Y),73395283,44777197,59079391,177251871,2243264575.754700,2201468465.579000,2381626680.123700,6826359721.457400,829875,187004,519052,1535931
2020-07-23,BZX Equities (Z),236509771,163433719,190615198,590558688,8223157635.537898,9182862534.084500,11679811837.034308,29085832006.656706,2260422,755651,1804095,4820168
2020-07-22,NYSE American (A),9247111,52317270,5358056,66922437,290611691.388500,446469448.189400,234892477.168500,971973616.746400,102417,158420,62051,322888
2020-07-22,NASDAQ BX (B),33566669,16697751,26986651,77251071,1065114258.174900,815444424.880700,1089132595.320500,2969691278.376100,364366,90992,246898,702256
2020-07-22,NYSE National (C),77161144,42022942,29111038,148295124,1444256366.586800,1339378661.034600,851070759.096300,3634705786.717700,607383,186946,287717,1082046
2020-07-22,FINRA / Nasdaq TRF Chicago (DB),7162610,2814311,10265444,20242365,246476403.396000,75429250.803900,549262766.928900,871168421.128800,28373,8423,40671,77467
2020-07-22,FINRA / NYSE TRF (DN),337026033,242715186,673213575,1252954794,9446901171.184606,4560698954.399499,19214547913.404499,33222148038.988604,1393467,496138,1889887,3779492
2020-07-22,FINRA / Nasdaq TRF Carteret (DQ),1366499861,681871001,1450331485,3498702347,46554945608.459182,25999864179.394494,56805897194.973163,129360706982.826839,5012884,1395433,4489164,10897481
2020-07-22,EDGA Equities (J),65446913,29027201,45008719,139482833,3060472545.820201,1306818213.730400,2759184271.435799,7126475030.986400,854991,176556,586771,1618318
2020-07-22,EDGX Equities (K),243805056,178086738,298709635,720601429,6463015130.320000,5114029175.411798,9080432451.787000,20657476757.518798,1525113,580629,1457984,3563726
2020-07-22,NYSE Chicago (M),5871902,8720003,5265507,19857412,292018587.643100,858429653.510000,732705774.700400,1883154015.853500,4918,2331,4936,12185
2020-07-22,NYSE (N),829030361,51160289,55212195,935402845,30698939811.042002,2445039374.381800,2289255389.904700,35433234575.328502,2813762,147214,357794,3318770
2020-07-22,NYSE Arca (P),275575057,316956916,321719036,914251009,9121801961.012800,15420011868.074706,16463862938.231295,41005676767.318801,2019661,1071770,2288508,5379939
2020-07-22,NASDAQ (Q),588202408,228620671,906793244,1723616323,23816876037.708500,10927619572.806199,47776449402.039412,82520945012.554111,5203809,983175,5903148,12090132
2020-07-22,Investors Exchange (V),101858610,16170946,54333448,172363004,4588905133.495499,883903860.183000,3349366806.680200,8822175800.358699,785037,87586,471244,1343867
2020-07-22,NASDAQ PSX (X),30524363,20510449,18772336,69807148,759165248.677700,1055533585.456200,867545884.980400,2682244719.114300,190220,96374,151231,437825
2020-07-22,BYX Equities (Y),70634353,45337646,61118633,177090632,2043812903.078700,1628393040.510600,1860380234.747300,5532586178.336600,730633,185453,434673,1350759
2020-07-22,BZX Equities (Z),225548987,131996255,166767838,524313080,7525900904.196497,6505902789.758401,8263136121.747905,22294939815.702803,2064326,626672,1450814,4141812
2020-07-21,NYSE American (A),10205237,48157486,5650225,64012948,333459843.469600,483465804.611900,271182663.684300,1088108311.765800,112694,157107,67771,337572
2020-07-21,NASDAQ BX (B),39610006,20034413,35043271,94687690,1271550816.605500,1012375793.168900,1329527915.559800,3613454525.334200,464529,113001,307549,885079
2020-07-21,NYSE National (C),89011567,50202401,38216165,177430133,1670646348.305100,1638911771.895900,1006730249.447800,4316288369.648800,684333,210261,343677,1238271
2020-07-21,FINRA / Nasdaq TRF Chicago (DB),6821452,2756599,15359576,24937627,273432860.726600,91781145.973600,697275033.268100,1062489039.968300,26855,7759,42348,76962
2020-07-21,FINRA / NYSE TRF (DN),353363997,213307051,925496190,1492167238,10149826563.319294,4351757698.926900,21673433875.802295,36175018138.048489,1467943,490100,2375364,4333407
2020-07-21,FINRA / Nasdaq TRF Carteret (DQ),1394753839,645436910,1876961882,3917152631,46139209960.972289,25368236851.536498,62612855650.875107,134120302463.383894,4994778,1402640,5136261,11533679
2020-07-21,EDGA Equities (J),72204622,32977658,57047328,162229608,3274871743.127600,1699513085.231900,3010322040.947501,7984706869.307001,938700,214516,666897,1820113
2020-07-21,EDGX Equities (K),269135351,182617934,402417827,854171112,7085971756.603899,5654590100.324201,9715787739.852807,22456349596.780907,1689200,615000,1737926,4042126
2020-07-21,NYSE Chicago (M),7176174,5295008,8399256,20870438,376176934.672900,503059319.508200,940556736.491000,1819792990.672100,6098,1429,5885,13412
2020-07-21,NYSE (N),898235462,61136732,62365150,1021737344,32466916381.858701,2954165293.680300,2357253628.170600,37778335303.709601,3173705,172048,408934,3754687
2020-07-21,NYSE Arca (P),299203043,348026791,412469189,1059699023,9855382802.595302,17156406568.903400,17969626165.208107,44981415536.706809,2236053,1133480,2680707,6050240
2020-07-21,NASDAQ (Q),650408456,228137670,1125673526,2004219652,25980698028.549993,11927317602.201596,56918102972.873480,94826118603.625069,5775502,1069862,7071653,13917017
2020-07-21,Investors Exchange (V),101968898,17659791,58918271,178546960,4379126128.911000,966743745.044700,3621533421.209700,8967403295.165400,852624,91756,527106,1471486
2020-07-21,NASDAQ PSX (X),34125196,21821888,20718452,76665536,821087896.219100,1091009270.691400,1131184175.083600,3043281341.994100,207024,107631,169674,484329
2020-07-21,BYX Equities (Y),78016431,49152060,93894855,221063346,2190557755.679600,1920531296.676900,2285818033.726500,6396907086.083000,824604,204074,546729,1575407
2020-07-21,BZX Equities (Z),252379578,138051651,212124302,602555531,8419352396.878298,7332532399.637404,9985655776.008500,25737540572.524202,2378208,662216,1762333,4802757
2020-07-20,NYSE American (A),8053771,46419159,5279310,59752240,274586791.465200,328536603.151500,316807511.138600,919930905.755300,89423,155895,63813,309131
2020-07-20,NASDAQ BX (B),34997617,16622854,30683148,82303619,934021777.084900,838948049.612200,1280430367.332400,3053400194.029500,326606,100474,268382,695462
2020-07-20,NYSE National (C),71951433,35687195,35814122,143452750,1377198733.342400,1178953969.776700,1030282753.574600,3586435456.693700,602331,161072,323286,1086689
2020-07-20,FINRA / Nasdaq TRF Chicago (DB),8476772,3778096,14083107,26337975,266477538.512200,93843586.296100,791129509.801600,1151450634.609900,35305,15223,64039,114567
2020-07-20,FINRA / NYSE TRF (DN),335033047,228068637,677178849,1240280533,8765922231.086600,3888592678.027900,21903258473.846297,34557773382.960797,1457120,568043,2315712,4340875
2020-07-20,FINRA / Nasdaq TRF Carteret (DQ),1207980133,588294305,1459092218,3255366656,41282224730.505798,20778771132.861398,62108658658.093509,124169654521.460705,4756419,1467952,4840577,11064948
2020-07-20,EDGA Equities (J),64145960,26231732,55471204,145848896,3011018472.576500,1239097228.448700,3196162165.174901,7446277866.200101,833638,176516,654157,1664311
2020-07-20,EDGX Equities (K),251633440,153186899,314209272,719029611,6045398813.005298,4378694493.487301,10138090844.918199,20562184151.410798,1463148,590840,1580588,3634576
2020-07-20,NYSE Chicago (M),6213664,8026751,6368632,20609047,295149115.767000,1162948058.200000,1068747957.654000,2526845131.621000,5227,1439,6231,12897
2020-07-20,NYSE (N),786061589,49616232,57857199,893535020,30205781012.890403,2335321615.377900,2691696887.360500,35232799515.628803,2821845,155047,378494,3355386
2020-07-20,NYSE Arca (P),255500215,283151150,337007616,875658981,8390614312.668603,14468399203.872297,18372866641.608601,41231880158.149501,1913860,1014581,2518411,5446852
2020-07-20,NASDAQ (Q),549946799,195726479,991498344,1737171622,23257756234.585603,10203142822.575405,59062863159.278915,92523762216.439923,5006844,953341,6631645,12591830
2020-07-20,Investors Exchange (V),89401963,13875448,62225071,165502482,4523560328.672900,811548332.823200,4054010807.038499,9389119468.534599,779351,84319,521543,1385213
2020-07-20,NASDAQ PSX (X),26534933,17271379,19196403,63002715,688782871.868000,944914365.135500,1139927530.496900,2773624767.500400,177736,88915,162236,428887
2020-07-20,BYX Equities (Y),69826607,38611970,64530991,172969568,2040579534.741100,1541566224.612100,2358126968.309300,5940272727.662500,719006,173288,482816,1375110
2020-07-20,BZX Equities (Z),213586624,113942466,184143802,511672892,7447337955.466501,5657650341.745701,10550575852.513208,23655564149.725410,2056324,592870,1622429,4271623
2020-07-17,NYSE American (A),8693829,25407924,5185373,39287126,274863337.827600,281161021.666200,249371182.967700,805395542.461500,100716,94495,65199,260410
2020-07-17,NASDAQ BX (B),30983076,15465430,36748839,83197345,1095365757.740900,823105208.388400,1076797892.023300,2995268858.152600,337109,86795,252572,676476
2020-07-17,NYSE National (C),73428749,33740967,30528025,137697741,1445521168.392800,1224116003.011600,871181648.557800,3540818819.962200,612138,166796,309648,1088582
2020-07-17,FINRA / Nasdaq TRF Chicago (DB),7136581,2581000,12750767,22468348,211691087.300200,78922296.074800,578983874.182800,869597257.557800,27733,7275,49311,84319
2020-07-17,FINRA / NYSE TRF (DN),315519127,145525635,694001379,1155046141,8262106821.140401,3410302924.454000,18827912746.720491,30500322492.314892,1355826,356538,2174745,3887109
2020-07-17,FINRA / Nasdaq TRF Carteret (DQ),1232767976,459545954,1517414707,3209728637,41663679560.024897,22746353579.667405,59778243057.381151,124188276197.073453,4461780,1029269,4523994,10015043
2020-07-17,EDGA Equities (J),67471808,30368775,50469866,148310449,2978514014.677000,1583846710.483600,2629235709.452800,7191596434.613400,851927,177062,629731,1658720
2020-07-17,EDGX Equities (K),229049120,99026210,315525704,643601034,5833312124.786002,4221242843.921203,8087526037.998901,18142081006.706106,1424372,406967,1523724,3355063
2020-07-17,NYSE Chicago (M),7113070,11383692,8157473,26654235,694984503.129500,1248623315.366000,1508594346.907800,3452202165.403300,4630,1357,6251,12238
2020-07-17,NYSE (N),868884990,45378493,51825187,966088670,36642597632.556803,2244107993.180000,2096400665.598499,40983106291.335302,2730640,130192,361315,3222147
2020-07-17,NYSE Arca (P),245784166,235156824,326336890,807277880,7807458130.451799,13638617995.075309,15015254577.593799,36461330703.120907,1834899,845287,2348630,5028816
2020-07-17,NASDAQ (Q),535011005,164451866,1003469338,1702932209,21694273372.495709,9918160835.772696,54697238570.133897,86309672778.402302,4794743,788270,6308760,11891773
2020-07-17,Investors Exchange (V),85123724,13013715,52173816,150311255,3761175710.830800,823159107.807400,3520757631.782099,8105092450.420299,718890,71983,454792,1245665
2020-07-17,NASDAQ PSX (X),27896946,17359277,17760505,63016728,742749502.844400,914865302.887100,1232996575.063200,2890611380.794700,183150,83669,149027,415846
2020-07-17,BYX Equities (Y),70572420,36361132,69943900,176877452,2111039678.609200,1822840975.294799,1885054148.786000,5818934802.689999,721668,167261,461918,1350847
2020-07-17,BZX Equities (Z),207416906,103810662,169190658,480418226,7334496458.765599,6028604306.914701,9081949909.043797,22445050674.724097,1958389,506831,1518447,3983667
2020-07-16,NYSE American (A),8603797,25933635,4862053,39399485,306497232.602400,267875139.389700,346956203.936600,921328575.928700,98856,90672,61458,250986
2020-07-16,NASDAQ BX (B),32742895,16584117,28806155,78133167,1086896345.414200,886007107.863300,1176600132.346700,3149503585.624200,353068,98135,257139,708342
2020-07-16,NYSE National (C),82309240,38397717,34963902,155670859,1545695755.278300,1299573461.300600,990273061.311200,3835542277.890100,641215,178605,330285,1150105
2020-07-16,FINRA / Nasdaq TRF Chicago (DB),7255562,2882634,11308904,21447100,245898059.002100,95402172.761500,656186579.602500,997486811.366100,29941,8032,47514,85487
2020-07-16,FINRA / NYSE TRF (DN),320562155,157656878,699815861,1178034894,9218504658.801006,4029461008.168598,20715597347.660393,33963563014.629997,1353351,388122,2039662,3781135
2020-07-16,FINRA / Nasdaq TRF Carteret (DQ),1216123324,465617715,1446181893,3127922932,42101974256.054311,20435451698.091515,59937801996.728861,122475227950.874687,4761128,1141959,4584425,10487512
2020-07-16,EDGA Equities (J),71061747,32567265,54960645,158589657,3118213525.455500,1508574053.840400,2978478633.372801,7605266212.668701,894285,198958,627284,1720527
2020-07-16,EDGX Equities (K),227879365,106751555,342244954,676875874,6238123785.990502,4538225542.425099,9189148229.200298,19965497557.615899,1479924,450816,1581278,3512018
2020-07-16,NYSE Chicago (M),8770178,7971033,4974207,21715418,700896916.149700,720644788.638000,1038067735.182000,2459609439.969700,5313,1679,6058,13050
2020-07-16,NYSE (N),776902615,50348946,51652248,878903809,29676089641.495402,2565994619.363900,2413202399.025200,34655286659.884502,2971907,155731,369812,3497450
2020-07-16,NYSE Arca (P),245705649,271464159,337749501,854919309,8699350593.400903,15692951991.530098,17926228205.464404,42318530790.395405,2020882,983322,2500649,5504853
2020-07-16,NASDAQ (Q),568845539,181413584,940040653,1690299776,23662852604.717596,10757429025.208398,52519451170.895414,86939732800.821408,5230899,911342,6482374,12624615
2020-07-16,Investors Exchange (V),93448738,14297065,58466216,166212019,4196281857.113500,890490122.996600,3812199480.023200,8898971460.133300,752720,80747,495274,1328741
2020-07-16,NASDAQ PSX (X),25410139,18416084,19010544,62836767,656362040.603500,916600372.953100,1338914826.683800,2911877240.240400,175392,89986,157747,423125
2020-07-16,BYX Equities (Y),77352460,37831397,72940722,188124579,2128094547.356500,1779782421.827500,2242298540.002800,6150175509.186800,756108,172551,500126,1428785
2020-07-16,BZX Equities (Z),209888186,119474601,169782089,499144876,7479524496.585001,6801307673.667098,9790902334.531402,24071734504.783501,2056819,588049,1519207,4164075
2020-07-15,NYSE American (A),8849989,30787166,5429374,45066529,273769611.774300,363619234.198100,272210840.040300,909599686.012700,107044,108299,69109,284452
2020-07-15,NASDAQ BX (B),35002208,20704944,30641021,86348173,1217212535.797500,1276125536.661200,1360928939.147800,3854267011.606500,406396,125489,300481,832366
2020-07-15,NYSE National (C),100943680,48600933,44028159,193572772,1810788598.918600,1591328611.227100,1105900055.339400,4508017265.485100,780089,209515,402478,1392082
2020-07-15,FINRA / Nasdaq TRF Chicago (DB),8329208,3548224,12120913,23998345,340669550.740200,127925735.149100,725167909.412600,1193763195.301900,37394,9251,58020,104665
2020-07-15,FINRA / NYSE TRF (DN),363053481,186379971,680069481,1229502933,11074457402.774602,5385619746.478496,23217218933.451190,39677296082.704288,1635677,440712,2364731,4441120
2020-07-15,FINRA / Nasdaq TRF Carteret (DQ),1369417595,556268872,1549274118,3474960585,49565415454.594812,26336575173.462299,67421847194.958881,143323837823.015992,5376545,1248319,5149895,11774759
2020-07-15,EDGA Equities (J),82516681,40136014,62638939,185291634,3698954049.329800,1981460292.636800,3178017175.860299,8858431517.826899,1047327,236870,751576,2035773
2020-07-15,EDGX Equities (K),268753542,138975627,331423117,739152286,7618854955.217199,6559415486.845601,10706637019.995299,24884907462.058099,1790647,586816,1773502,4150965
2020-07-15,NYSE Chicago (M),5688190,6897140,7376022,19961352,314462518.222000,997208424.220000,1059053084.051800,2370724026.493800,6457,1561,7685,15703
2020-07-15,NYSE (N),950842985,63666763,62489948,1076999696,37322760170.643004,3455080759.009800,2700138762.837400,43477979692.490204,3642031,207570,457122,4306723
2020-07-15,NYSE Arca (P),294511150,339656557,386113022,1020280729,10473401606.380897,20782588745.156705,20312616599.867800,51568606951.405402,2447799,1297951,2958150,6703900
2020-07-15,NASDAQ (Q),700797165,242776534,1124502401,2068076100,29765366641.001397,15161820952.884204,62787381834.233418,107714569428.119019,6501244,1186958,7917901,15606103
2020-07-15,Investors Exchange (V),114649007,17607018,62564344,194820369,5014122125.711501,1101741685.230900,4057684767.898001,10173548578.840402,888676,86308,521301,1496285
2020-07-15,NASDAQ PSX (X),32541857,24723357,20408345,77673559,864997511.512700,1432052747.525600,1053611415.074800,3350661674.113100,217397,129048,176631,523076
2020-07-15,BYX Equities (Y),86896520,43637972,63861251,194395743,2483509880.146000,2236488396.246900,2391419684.199600,7111417960.592500,937630,199177,554150,1690957
2020-07-15,BZX Equities (Z),264046163,160956582,204132717,629135462,9510252003.194800,9684412376.031001,11846026061.110502,31040690440.336303,2633333,782592,2018666,5434591
2020-07-14,NYSE American (A),9110104,23316798,5928092,38354994,284993176.832500,349395449.471800,303442097.738500,937830724.042800,114125,94404,77229,285758
2020-07-14,NASDAQ BX (B),37076599,23380792,36762840,97220231,1282909929.426900,1397328874.593300,1765136672.868500,4445375476.888700,422907,143134,350659,916700
2020-07-14,NYSE National (C),94755358,55370236,43066098,193191692,1777698389.681500,1785145111.498900,1277049025.525800,4839892526.706200,738047,241476,385979,1365502
2020-07-14,FINRA / Nasdaq TRF Chicago (DB),6867168,2649021,9754504,19270693,269217468.330700,90872952.202000,762071983.151800,1122162403.684500,32090,7930,53224,93244
2020-07-14,FINRA / NYSE TRF (DN),319054602,169539101,630460803,1119054506,9820464164.080599,5032499062.366902,24766072778.856502,39619036005.304003,1419039,387856,2316264,4123159
2020-07-14,FINRA / Nasdaq TRF Carteret (DQ),1357809043,540442050,1469715291,3367966384,50570428483.232805,27228926941.527308,75965423600.523663,153764779025.283776,5041320,1201825,5126447,11369592
2020-07-14,EDGA Equities (J),80988026,49233815,63164906,193386747,3563251669.399900,2221145974.341100,3589997495.333799,9374395139.074799,1011478,279954,771269,2062701
2020-07-14,EDGX Equities (K),251473681,152540817,312917639,716932137,7224186123.028901,7109778410.625202,12334575016.921710,26668539550.575813,1698053,653905,1879383,4231341
2020-07-14,NYSE Chicago (M),8013528,4604822,5116207,17734557,949850565.547500,508056436.910000,1121805573.216600,2579712575.674100,7455,1056,8826,17337
2020-07-14,NYSE (N),908562086,82695345,63428977,1054686408,35179231253.727703,4266152539.816999,3254788707.978501,42700172501.523203,3508396,249593,487406,4245395
2020-07-14,NYSE Arca (P),287107250,401308755,390385100,1078801105,10286402236.056403,24860579342.309304,24688315424.744706,59835297003.110413,2381652,1498363,3151492,7031507
2020-07-14,NASDAQ (Q),675261839,285406204,1073725142,2034393185,27694139444.014914,17872783334.246005,71645704089.229969,117212626867.490888,6446968,1458595,8420531,16326094
2020-07-14,Investors Exchange (V),100305896,18585164,63299788,182190848,4461894850.265200,1210969058.801200,4197075215.301798,9869939124.368198,821688,91216,526259,1439163
2020-07-14,NASDAQ PSX (X),34616771,28235523,23070913,85923207,921033143.146000,1484430696.438100,1730276412.155200,4135740251.739300,232856,152342,224590,609788
2020-07-14,BYX Equities (Y),83752982,47466712,64991930,196211624,2433090262.801800,2441380247.480799,2659227264.790700,7533697775.073299,875169,227928,571657,1674754
2020-07-14,BZX Equities (Z),252385135,199296765,205983170,657665070,9115624773.679001,10916617388.535503,14610037479.352400,34642279641.566904,2517660,937795,2045792,5501247
2020-07-13,NYSE American (A),9769251,35657874,5780462,51207587,294388061.683800,366919647.899500,391329319.852000,1052637029.435300,117599,112065,77111,306775
2020-07-13,NASDAQ BX (B),39549687,24704598,37957306,102211591,1370734656.914400,1595390132.743100,2414312865.090700,5380437654.748200,451300,142691,358859,952850
2020-07-13,NYSE National (C),95282669,54723138,44557083,194562890,1753658710.341700,1777155654.155700,1336115107.511600,4866929472.009000,767568,240445,407224,1415237
2020-07-13,FINRA / Nasdaq TRF Chicago (DB),9982668,4049851,15001281,29033800,389179604.803000,149465300.109100,1360588862.540899,1899233767.452999,48884,13076,86351,148311
2020-07-13,FINRA / NYSE TRF (DN),386062125,207383172,707114952,1300560249,11620701688.355798,5189452172.610700,33066918671.392012,49877072532.358510,1862609,499906,2861229,5223744
2020-07-13,FINRA / Nasdaq TRF Carteret (DQ),1430630234,651342014,1612553492,3694525740,51055209584.970893,32240227494.583712,90709305140.066739,174004742219.621344,5562339,1451487,5781129,12794955
2020-07-13,EDGA Equities (J),83934461,44210133,65658832,193803426,3745963714.634600,2232050408.118800,4099865283.005901,10077879405.759301,1078398,265001,837519,2180918
2020-07-13,EDGX Equities (K),293198181,161519748,358914180,813632109,8019767968.496795,7090729020.661796,14625185323.435908,29735682312.594499,1914249,647189,2006492,4567930
2020-07-13,NYSE Chicago (M),4619670,9557799,6295052,20472521,456676354.346600,1797927175.998600,1124305007.491500,3378908537.836700,7309,2427,10021,19757
2020-07-13,NYSE (N),1008033431,74361452,64137274,1146532157,37582005243.736201,3755989704.335900,3779378183.913300,45117373131.985401,3803138,219940,509361,4532439
2020-07-13,NYSE Arca (P),293093667,390533625,390156328,1073783620,9965918825.687904,22860436502.529308,27813883502.160402,60640238830.377614,2417262,1374888,3155324,6947474
2020-07-13,NASDAQ (Q),733519441,262911605,1158539998,2154971044,29948777780.314799,16526370899.905613,85768067518.038052,132243216198.258464,6921490,1266656,9145408,17333554
2020-07-13,Investors Exchange (V),110978430,20471691,64631422,196081543,4991936686.452200,1296480877.115700,5393327356.815401,11681744920.383301,937969,108678,592374,1639021
2020-07-13,NASDAQ PSX (X),35611516,27443235,22774639,85829390,927778088.497700,1532561638.782600,2171851007.849699,4632190735.129999,234557,136511,225872,596940
2020-07-13,BYX Equities (Y),91099442,50540352,77353096,218992890,2516180450.452800,2757842997.532700,3018546712.130200,8292570160.115700,942418,231891,627839,1802148
2020-07-13,BZX Equities (Z),277076257,180391814,220461400,677929471,9852954182.861901,10560199674.158997,16231607519.231501,36644761376.252399,2759212,841860,2156628,5757700
2020-07-10,NYSE American (A),8495413,23896172,4405213,36796798,265289515.557000,258152140.885900,315806983.127900,839248639.570800,102130,81545,60946,244621
2020-07-10,NASDAQ BX (B),38548378,18734882,33546171,90829431,1175365948.145300,1021380989.941600,1366980582.821400,3563727520.908300,413991,99414,288903,802308
2020-07-10,NYSE National (C),84846567,37938281,31973481,154758329,1518368351.715700,1226598233.985000,948276453.921300,3693243039.622000,689643,158826,311584,1160053
2020-07-10,FINRA / Nasdaq TRF Chicago (DB),9507958,2755952,9261278,21525188,296642505.627300,102212833.197200,778255672.378000,1177111011.202500,36358,8005,47174,91537
2020-07-10,FINRA / NYSE TRF (DN),400650172,160926865,520403696,1081980733,10109852707.136602,3977959876.358400,21819260435.945618,35907073019.440620,1625292,383414,1907812,3916518
2020-07-10,FINRA / Nasdaq TRF Carteret (DQ),1354252491,492076348,1199128744,3045457583,43719419683.289016,20548501970.653407,61393460401.589707,125661382055.532130,5146606,1109534,4204752,10460892
2020-07-10,EDGA Equities (J),72985029,33285387,47627198,153897614,3085190008.082100,1549113812.030500,3198996945.803501,7833300765.916101,937547,182662,651324,1771533
2020-07-10,EDGX Equities (K),288674794,116112791,234877793,639665378,6980398635.045597,4917435067.035000,9662667127.243403,21560500829.324000,1708760,454269,1379677,3542706
2020-07-10,NYSE Chicago (M),11071382,4696494,4537522,20305398,1575145278.032400,486739787.214500,794206018.670000,2856091083.916900,5468,1822,7280,14570
2020-07-10,NYSE (N),875773656,53130954,51708987,980613597,30184557469.064402,2565990057.994200,3012368902.270101,35762916429.328703,3173918,150181,397012,3721111
2020-07-10,NYSE Arca (P),287756359,278283064,283696959,849736382,8238295104.296200,15768136916.667508,17688121024.525305,41694553045.489013,2058200,978517,2280154,5316871
2020-07-10,NASDAQ (Q),637729553,189241786,840923643,1667894982,23731263890.439902,11347983537.374601,56876700107.592252,91955947535.406755,5689491,904356,6389381,12983228
2020-07-10,Investors Exchange (V),90851933,16893159,50680215,158425307,3961375768.142900,932722425.518900,3717406427.166100,8611504620.827900,973389,91606,573659,1638654
2020-07-10,NASDAQ PSX (X),28174558,19135366,16914062,64223986,685460289.721100,942532171.888800,1444842463.230000,3072834924.839900,187547,92221,163275,443043
2020-07-10,BYX Equities (Y),83842349,40062782,51524589,175429720,2163622662.841500,1893021878.602300,2227128375.828000,6283772917.271800,865463,160578,480034,1506075
2020-07-10,BZX Equities (Z),251029523,129447215,156306858,536783596,7890630315.776100,6968293448.412900,11506524642.581500,26365448406.770500,2303614,606927,1552469,4463010
2020-07-09,NYSE American (A),9427704,29180119,5342849,43950672,284899222.474100,353620084.121500,271375906.500400,909895213.096000,105517,107005,70375,282897
2020-07-09,NASDAQ BX (B),44177833,22790204,37895076,104863113,1385319465.645000,1233465365.817199,1538068966.236500,4156853797.698699,497548,130084,348579,976211
2020-07-09,NYSE National (C),97162199,48678675,40286561,186127435,1687540902.599800,1608971495.039000,1083727689.981100,4380240087.619900,760503,226869,382086,1369458
2020-07-09,FINRA / Nasdaq TRF Chicago (DB),10417979,3189541,10412822,24020342,381906939.569700,145011289.932000,695118535.148100,1222036764.649800,41589,10787,49507,101883
2020-07-09,FINRA / NYSE TRF (DN),385461999,186183257,562634414,1134279670,11476211105.838697,5187830345.812499,21299554612.968597,37963596064.619793,1737150,471379,2025904,4234433
2020-07-09,FINRA / Nasdaq TRF Carteret (DQ),1406691074,559110422,1348633198,3314434694,49438802531.104698,26064898614.479692,62144261906.822209,137647963052.406599,5532397,1415449,4677927,11625773
2020-07-09,EDGA Equities (J),84043153,42250015,58641299,184934467,3627907331.768001,2043116294.100400,3520199955.738700,9191223581.607101,1079657,248887,750039,2078583
2020-07-09,EDGX Equities (K),302359300,147632946,269376490,719368736,7986926639.581597,6489561287.590895,9716646558.596003,24193134485.768495,1925691,610298,1578314,4114303
2020-07-09,NYSE Chicago (M),7913002,7785425,4174195,19872622,373493553.102600,947468628.246000,651670143.053300,1972632324.401900,7043,2306,8015,17364
2020-07-09,NYSE (N),972036831,68677629,57434115,1098148575,35474608783.888896,3506592234.664802,3211151247.896900,42192352266.450598,3784957,213190,453323,4451470
2020-07-09,NYSE Arca (P),299076914,357679494,328370152,985126560,9587925923.963096,19627903916.808492,19013388185.497193,48229218026.268781,2347053,1312416,2665848,6325317
2020-07-09,NASDAQ (Q),720570798,252659723,962989992,1936220513,28760192074.272604,14575288649.289698,57422604159.932391,100758084883.494693,6623936,1223715,7440318,15287969
2020-07-09,Investors Exchange (V),114674470,19904484,63256917,197835871,4800336786.383000,1159744520.909900,4179814244.316099,10139895551.608999,1159599,117690,672034,1949323
2020-07-09,NASDAQ PSX (X),35887187,25920231,20217183,82024601,860283626.096300,1380747870.558100,1012475044.207600,3253506540.862000,214821,130180,182941,527942
2020-07-09,BYX Equities (Y),90769103,48635976,60052569,199457648,2377647599.037900,2474469024.664600,2455237160.657901,7307353784.360401,967598,225344,552791,1745733
2020-07-09,BZX Equities (Z),262981698,166449364,183466160,612897222,8904945173.101595,9604489407.387497,11793056878.338796,30302491458.827888,2583392,799696,1861309,5244397
2020-07-08,NYSE American (A),9491694,27467366,4952656,41911716,288778878.223000,314029285.803100,233418328.178400,836226492.204500,107381,88952,64450,260783
2020-07-08,NASDAQ BX (B),39891406,18516368,34471322,92879096,1241361969.738700,880084461.126100,1215203674.604500,3336650105.469300,424730,94031,274394,793155
2020-07-08,NYSE National (C),91964549,37726747,37499301,167190597,1622523766.827000,1322224062.163600,908342957.806200,3853090786.796800,764793,180436,362195,1307424
2020-07-08,FINRA / Nasdaq TRF Chicago (DB),10822253,2766127,9982152,23570532,365613594.332300,108198969.733300,657472537.998200,1131285102.063800,45261,8814,49731,103806
2020-07-08,FINRA / NYSE TRF (DN),412545231,160988882,585164036,1158698149,11772477576.352406,4332518538.568600,19345572107.815297,35450568222.736303,1656451,400159,1971509,4028119
2020-07-08,FINRA / Nasdaq TRF Carteret (DQ),1480748553,519203993,1400517001,3400469547,51831000883.985201,22276426057.325502,57597764010.536707,131705190951.847410,5454224,1227457,4473967,11155648
2020-07-08,EDGA Equities (J),81484194,32903497,54086986,168474677,3599534372.332701,1613799478.408600,3440518293.690500,8653852144.431801,1026487,206934,705541,1938962
2020-07-08,EDGX Equities (K),296675505,115986791,255588996,668251292,7651755788.794203,5056439121.704898,8061723538.017401,20769918448.516502,1765402,488431,1389826,3643659
2020-07-08,NYSE Chicago (M),7603384,7155828,6481952,21241164,560389608.423500,782452557.452700,918706336.031100,2261548501.907300,6827,1375,7428,15630
2020-07-08,NYSE (N),1017021314,53639111,55429052,1126089477,36974486955.671595,2631139373.354399,2574001261.982000,42179627591.007994,3487667,164947,421207,4073821
2020-07-08,NYSE Arca (P),299121210,295903968,322507287,917532465,9560331689.207900,16279849147.104297,16209028602.574195,42049209438.886392,2154263,1046267,2406388,5606918
2020-07-08,NASDAQ (Q),710364911,193318035,959906722,1863589668,27763921597.729591,10760913776.625796,53968564792.967509,92493400167.322896,6034258,943757,6509553,13487568
2020-07-08,Investors Exchange (V),108290448,18043365,61955161,188288974,4783245064.553800,1023302217.309200,3697357965.117600,9503905246.980600,1116495,104494,644920,1865909
2020-07-08,NASDAQ PSX (X),34712689,19052460,19143561,72908710,820199575.831800,945563354.168400,793146221.948400,2558909151.948600,208525,97902,154389,460816
2020-07-08,BYX Equities (Y),86355375,39118504,61005782,186479661,2290644843.176200,1858985166.324200,2079326027.006100,6228956036.506500,895148,184453,512640,1592241
2020-07-08,BZX Equities (Z),250224384,123099677,161525257,534849318,8718578949.605200,6789661514.038000,9814649326.446604,25322889790.089804,2325478,599585,1559285,4484348
2020-07-07,NYSE American (A),8786105,31395519,5021474,45203098,255827633.797800,332992112.639000,248606128.081200,837425874.518000,99059,98495,65937,263491
2020-07-07,NASDAQ BX (B),38067071,19930172,50592328,108589571,1198889905.090600,904059912.203700,1415227384.184800,3518177201.479100,397131,95309,294762,787202
2020-07-07,NYSE National (C),86566676,34469792,38181005,159217473,1541036607.749700,1208810413.474600,1025728160.383400,3775575181.607700,722121,168625,364002,1254748
2020-07-07,FINRA / Nasdaq TRF Chicago (DB),9048140,2720256,9895668,21664064,303609999.056100,110779843.646300,685044859.431600,1099434702.134000,35766,8466,48527,92759
2020-07-07,FINRA / NYSE TRF (DN),322217945,183418045,574015059,1079651049,8884967134.897501,4203030993.712399,18219429242.676498,31307427371.286398,1505721,429125,2059749,3994595
2020-07-07,FINRA / Nasdaq TRF Carteret (DQ),1417669746,547570162,1548484188,3513724096,48961346124.844615,25040469908.060686,64079669422.022059,138081485454.927360,5317760,1280601,4802750,11401111
2020-07-07,EDGA Equities (J),74059762,30846828,58949000,163855590,3345273429.630100,1545326989.688400,3344330731.281000,8234931150.599500,961650,201898,724125,1887673
2020-07-07,EDGX Equities (K),267105602,134639567,300190627,701935796,6923288023.128300,5735869772.572801,9623303739.501002,22282461535.202103,1681126,522532,1544972,3748630
2020-07-07,NYSE Chicago (M),6916991,7679117,5000728,19596836,537356635.071500,1166203429.950000,882763460.805700,2586323525.827200,7303,1801,8203,17307
2020-07-07,NYSE (N),961223995,46595082,56225428,1064044505,34968629432.884306,2430107053.950600,2943841506.504299,40342577993.339205,3274158,154628,449624,3878410
2020-07-07,NYSE Arca (P),280219814,288550521,346564145,915334480,8805888014.877201,16181914220.505604,17406223494.935905,42394025730.318710,2096101,1022612,2553815,5672528
2020-07-07,NASDAQ (Q),649046458,190097334,1009165408,1848309200,24889078129.166510,11472316791.674798,57544686991.300602,93906081912.141910,5738472,933661,6874640,13546773
2020-07-07,Investors Exchange (V),97872983,17620034,60923144,176416161,4412385264.407500,1181770430.340300,3940602703.392100,9534758398.139900,1012939,100255,604555,1717749
2020-07-07,NASDAQ PSX (X),34896544,16697217,21820562,73414323,780805768.082100,921843063.366000,1477753472.825200,3180402304.273300,187850,82470,179345,449665
2020-07-07,BYX Equities (Y),78030076,41754105,66346499,186130680,2124994061.285800,1916527425.000500,2183713516.252400,6225235002.538700,790709,191176,507169,1489054
2020-07-07,BZX Equities (Z),239611321,128956225,185760001,554327547,7883582759.105501,7610337496.158697,10275561940.291400,25769482195.555598,2280534,624394,1671910,4576838
2020-07-06,NYSE American (A),9263754,30040881,5099078,44403713,280871731.949600,307855369.527600,292550789.139100,881277890.616300,110342,90921,74257,275520
2020-07-06,NASDAQ BX (B),37395015,19966663,29805769,87167447,1203170255.828800,919022685.905800,1405660095.978800,3527853037.713400,398101,114335,294816,807252
2020-07-06,NYSE National (C),83401447,41635133,35591595,160628175,1474804884.678900,1496310002.464900,984824764.021800,3955939651.165600,704829,181941,350793,1237563
2020-07-06,FINRA / Nasdaq TRF Chicago (DB),10846742,2942444,13688227,27477413,426651315.387100,121877177.116900,911291246.583000,1459819739.087000,51301,10326,72292,133919
2020-07-06,FINRA / NYSE TRF (DN),367780336,192306481,666688372,1226775189,11399043076.461099,4656648411.903700,20490335445.177399,36546026933.542198,1687788,424620,2450598,4563006
2020-07-06,FINRA / Nasdaq TRF Carteret (DQ),1417286506,550803745,1531240773,3499331024,51392052517.561998,24787426894.676497,64818782836.953412,140998262249.191907,5392988,1303779,5242739,11939506
2020-07-06,EDGA Equities (J),76590505,31892145,59251747,167734397,3502546265.622000,1501580099.854600,3918444203.119101,8922570568.595701,967731,191568,764104,1923403
2020-07-06,EDGX Equities (K),276509545,129633654,340281974,746425173,7403309428.687198,5391161723.218803,9729599436.738500,22524070588.644501,1747056,488806,1810765,4046627
2020-07-06,NYSE Chicago (M),5418716,7549254,2708397,15676367,761951599.363600,853862715.772800,497825639.069200,2113639954.205600,7803,2450,6369,16622
2020-07-06,NYSE (N),1056112253,51038272,60639297,1167789822,37637672980.553596,2494300417.160300,3656390697.644600,43788364095.358496,3357574,151690,494389,4003653
2020-07-06,NYSE Arca (P),290063669,312265739,387222375,989551783,9510922684.649300,17080712444.789297,18456474317.737998,45048109447.176595,2154917,996411,2813002,5964330
2020-07-06,NASDAQ (Q),669363648,207565610,1105174572,1982103830,26556293797.268896,11348927342.403799,63175163749.217423,101080384888.890118,5761548,915309,7345825,14022682
2020-07-06,Investors Exchange (V),106209798,18486774,61891818,186588390,4687313830.260301,1019344826.199400,3891863277.669700,9598521934.129401,988663,98900,617367,1704930
2020-07-06,NASDAQ PSX (X),30007260,20474753,18976599,69458612,713187494.192100,1067107377.106100,1162000625.070500,2942295496.368700,198301,93743,166563,458607
2020-07-06,BYX Equities (Y),81369284,50477431,65910835,197757550,2211781644.251200,1985043666.038000,2433038051.129700,6629863361.418900,854219,197296,546106,1597621
2020-07-06,BZX Equities (Z),241542586,128180224,186092287,555815097,8252846794.696598,7176991858.644699,11034261716.666198,26464100370.007495,2334636,597720,1796985,4729341
2020-07-02,NYSE American (A),8897971,33251800,5169052,47318823,237024173.247700,286747953.342600,266851345.187300,790623471.777600,110009,98582,74493,283084
2020-07-02,NASDAQ BX (B),34073582,17281745,26021794,77377121,1080821771.091900,935024332.824800,1280786612.702300,3296632716.619000,376063,119133,279054,774250
2020-07-02,NYSE National (C),83611344,39185603,36512993,159309940,1424500913.847200,1358220568.924800,1014593558.149200,3797315040.921200,709232,190950,361591,1261773
2020-07-02,FINRA / Nasdaq TRF Chicago (DB),7676319,2934861,9809367,20420547,294482622.227300,134242966.486000,693092790.421900,1121818379.135200,33581,8916,49798,92295
2020-07-02,FINRA / NYSE TRF (DN),328557911,192933432,617680951,1139172294,9495279026.979398,4606035297.530300,18350128252.158713,32451442576.668411,1381932,406851,2073216,3861999
2020-07-02,FINRA / Nasdaq TRF Carteret (DQ),1207033078,555905333,1334642973,3097581384,41321915294.568093,22449601462.650910,57092076489.267407,120863593246.486410,4835781,1356811,4597888,10790480
2020-07-02,EDGA Equities (J),69329492,34314269,56272526,159916287,2996946887.372500,1570519992.262700,3304568795.953200,7872035675.588400,898028,196237,706656,1800921
2020-07-02,EDGX Equities (K),230991312,147317185,282345247,660653744,6105990390.773798,5358559952.067102,9302693567.125494,20767243909.966394,1528260,525967,1532645,3586872
2020-07-02,NYSE Chicago (M),9437330,6603249,5049815,21090394,515221299.830100,569971977.020000,1086196192.173300,2171389469.023400,8010,1901,7478,17389
2020-07-02,NYSE (N),897158894,49193611,55478075,1001830580,33417100064.948102,2438293478.580300,3011691852.143701,38867085395.672103,3242235,157299,433562,3833096
2020-07-02,NYSE Arca (P),271546658,317554281,338202746,927303685,8679255352.696501,16971141160.355200,17249387903.003100,42899784416.054801,2101200,1075364,2572522,5749086
2020-07-02,NASDAQ (Q),615714780,239761553,951491839,1806968172,24369001056.589902,12099669431.065802,57069612991.503286,93538283479.158990,5563362,1012513,6846545,13422420
2020-07-02,Investors Exchange (V),100435986,19779049,62523050,182738085,4320502852.732300,1150644174.385600,4046150181.081101,9517297208.199001,1259644,118441,807877,2185962
2020-07-02,NASDAQ PSX (X),28646212,17875610,18178911,64700733,756491259.829200,968545148.977700,1306143205.219200,3031179614.026100,196435,98045,163727,458207
2020-07-02,BYX Equities (Y),74493111,57837787,63412719,195743617,1960920901.567100,1965806656.929699,2163235266.596700,6089962825.093499,786376,197596,509755,1493727
2020-07-02,BZX Equities (Z),230124198,142119142,176128084,548371424,7850565838.769500,7786519952.996000,11102574793.235404,26739660585.000904,2275456,654682,1695296,4625434
2020-07-01,NYSE American (A),8309283,23455508,6474492,38239283,262481798.401400,278039164.036200,341545857.352600,882066819.790200,133061,77635,91106,301802
2020-07-01,NASDAQ BX (B),36838378,19000336,33090173,88928887,1190289428.672500,1057638897.554300,1461562049.208600,3709490375.435400,418570,128385,328533,875488
2020-07-01,NYSE National (C),83605189,45444278,41190544,170240011,1579349924.052500,1579513956.610100,1115607434.397500,4274471315.060100,770843,212410,422798,1406051
2020-07-01,FINRA / Nasdaq TRF Chicago (DB),7729690,2635322,9823213,20188225,313514687.378800,122906290.124500,676655948.794100,1113076926.297400,33929,9397,48905,92231
2020-07-01,FINRA / NYSE TRF (DN),375405484,171915048,663514622,1210835154,10608734624.147096,4888355681.433399,19447998505.137916,34945088810.718411,1399614,387519,2143731,3930864
2020-07-01,FINRA / Nasdaq TRF Carteret (DQ),1318196787,548810381,1576141120,3443148288,46561367140.658888,25913499650.604708,60450335691.815188,132925202483.078784,4902266,1317575,4987007,11206848
2020-07-01,EDGA Equities (J),75547564,33653537,61667845,170868946,3339629085.561100,1664681506.438200,4025394379.187103,9029704971.186403,1000020,204805,774869,1979694
2020-07-01,EDGX Equities (K),218048226,141870811,360806357,720725394,5913204283.255596,5759166614.444400,9414092150.449796,21086463048.149792,1607493,517279,1758416,3883188
2020-07-01,NYSE Chicago (M),5971769,14178453,14220692,34370914,384717129.095200,1717411445.123000,882222579.294000,2984351153.512200,9331,1606,7885,18822
2020-07-01,NYSE (N),928702778,55236548,64128207,1048067533,32917051776.610700,2826841752.626801,3715797013.628100,39459690542.865601,3504971,174675,513012,4192658
2020-07-01,NYSE Arca (P),281410881,326619565,385352003,993382449,9630471613.016202,18674674671.061394,17594726321.408205,45899872605.485801,2327792,1119879,2843889,6291560
2020-07-01,NASDAQ (Q),657497881,217893540,1050302966,1925694387,26479827237.102500,12908206768.930700,56634407559.139124,96022441565.172324,6045403,1030480,7307329,14383212
2020-07-01,Investors Exchange (V),112938579,21584528,75332855,209855962,4984809768.656700,1244537382.832200,4607676489.878001,10837023641.366901,1498465,132665,1011090,2642220
2020-07-01,NASDAQ PSX (X),28012221,21261335,19725898,68999454,736235111.115100,1259291434.631400,958265347.125500,2953791892.872000,191293,104019,174263,469575
2020-07-01,BYX Equities (Y),74456503,39963209,63672222,178091934,2179187071.664300,1855318274.012399,2640023736.809600,6674529082.486299,849396,183634,577081,1610111
2020-07-01,BZX Equities (Z),236562018,139176999,198993345,574732362,8225914070.199600,8209604571.931002,11470923656.337906,27906442298.468508,2483143,666799,1875350,5025292
2020-06-30,NYSE American (A),10006022,29920002,5722092,45648116,278642855.721700,336464690.205400,273139240.095700,888246786.022800,133934,87446,84550,305930
2020-06-30,NASDAQ BX (B),41072572,20534290,32202706,93809568,1227754981.989700,1197658047.419700,1266847352.547100,3692260381.956500,448694,122731,322596,894021
2020-06-30,NYSE National (C),102263521,47341827,39789383,189394731,1798127468.182400,1608419843.219100,1100239669.014800,4506786980.416300,872341,208240,414737,1495318
2020-06-30,FINRA / Nasdaq TRF Chicago (DB),6992522,2585762,10055389,19633673,312822387.014800,126998538.992500,650622594.478600,1090443520.485900,30169,8945,50126,89240
2020-06-30,FINRA / NYSE TRF (DN),314360404,178974970,639513948,1132849322,10208916871.961002,5083350885.201501,19109128810.041797,34401396567.204300,1349740,395631,2173493,3918864
2020-06-30,FINRA / Nasdaq TRF Carteret (DQ),1297673141,578865584,1449258636,3325797361,47046341260.112899,32435796717.259788,58016124874.360512,137498262851.733199,4795638,1223309,4702603,10721550
2020-06-30,EDGA Equities (J),80424382,36762165,56214094,173400641,3435719850.342800,1941871463.328200,3161951836.093500,8539543149.764500,1022681,205551,734125,1962357
2020-06-30,EDGX Equities (K),214034961,132369307,313134303,659538571,5712488405.473300,6861808837.025899,8030325088.978704,20604622331.477903,1510270,521175,1598874,3630319
2020-06-30,NYSE Chicago (M),6784607,7949099,4003833,18737539,380119255.900100,979841976.012600,509193948.643200,1869155180.555900,6649,1667,6197,14513
2020-06-30,NYSE (N),1217907110,57483022,61302027,1336692159,46638073760.368591,3287027099.125900,3017335680.361400,52942436539.855891,3715426,184029,524601,4424056
2020-06-30,NYSE Arca (P),281965579,342209183,370734233,994908995,9373385276.319298,21791887707.151301,16137197244.762207,47302470228.232806,2220005,1130812,2720227,6071044
2020-06-30,NASDAQ (Q),661364169,240269849,1186379608,2088013626,26384607150.127909,15286017919.165410,64613388195.042907,106284013264.336226,6082811,1070915,7425564,14579290
2020-06-30,Investors Exchange (V),114318120,24958882,64876315,204153317,4586811697.355300,1458888669.490300,4036144118.750399,10081844485.595999,1183955,128312,747768,2060035
2020-06-30,NASDAQ PSX (X),27892996,23896249,19822686,71611931,729415573.877900,1537328905.838200,1098337195.657000,3365081675.373100,184256,116405,164419,465080
2020-06-30,BYX Equities (Y),83838817,48028285,57056079,188923181,2277026098.583900,2323541715.418500,2357948700.405300,6958516514.407700,903515,207540,553813,1664868
2020-06-30,BZX Equities (Z),244960248,157761972,200129465,602851685,8298530581.575700,10389917686.244100,10423576970.204505,29112025238.024305,2405462,721964,1870788,4998214
2020-06-29,NYSE American (A),8347200,29379589,5641115,43367904,244217353.884600,269781992.366200,250127297.529000,764126643.779800,121021,96893,83880,301794
2020-06-29,NASDAQ BX (B),38914482,20076500,31082967,90073949,1216964837.308200,1151972278.002200,1277540731.285400,3646477846.595800,466068,134876,334953,935897
2020-06-29,NYSE National (C),87691736,49898493,38186147,175776376,1530905882.680100,1701611615.623400,953756958.240100,4186274456.543600,794859,232383,401306,1428548
2020-06-29,FINRA / Nasdaq TRF Chicago (DB),7959607,2981352,10906143,21847102,341170536.874900,137856837.946000,608224059.903400,1087251434.724300,36820,8696,54273,99789
2020-06-29,FINRA / NYSE TRF (DN),371331564,213671715,656355593,1241358872,11750436150.188394,4604739409.392802,17718570882.743401,34073746442.324597,1629295,433958,2154919,4218172
2020-06-29,FINRA / Nasdaq TRF Carteret (DQ),1305747085,734520392,1420138371,3460405848,46111608196.958583,32854877350.565101,54131990935.487176,133098476483.010860,5216474,1553024,4801721,11571219
2020-06-29,EDGA Equities (J),76167612,37350257,56625094,170142963,3240102994.089999,1777204268.764700,3128045899.086201,8145353161.940900,1020518,221469,746270,1988257
2020-06-29,EDGX Equities (K),220508489,139215235,309044605,668768329,5971865680.076499,6128136319.728599,7829377183.342601,19929379183.147699,1632262,556676,1622401,3811339
2020-06-29,NYSE Chicago (M),5431520,6616783,4081772,16130075,284932597.891000,681987403.780800,569660361.243600,1536580362.915400,8938,1432,6979,17349
2020-06-29,NYSE (N),965245150,53053945,56198514,1074497609,34390910823.536199,2690532997.040800,2772836874.293000,39854280694.869999,3483528,173616,460207,4117351
2020-06-29,NYSE Arca (P),289222856,319994588,355240202,964457646,9740203423.795102,18329750928.421507,15980938798.662600,44050893150.879209,2412173,1134686,2745650,6292509
2020-06-29,NASDAQ (Q),635327117,234859892,1043722332,1913909341,24844970364.036206,13326078870.821600,51270345325.299909,89441394560.157715,5965133,1095843,7297095,14358071
2020-06-29,Investors Exchange (V),120784994,28108727,76575983,225469704,4861298382.632000,1607469995.457300,4228269508.688201,10697037886.777501,1488510,174073,977354,2639937
2020-06-29,NASDAQ PSX (X),26581167,20821823,19620787,67023777,688029783.828500,1165691348.106200,829553377.238200,2683274509.172900,195020,105743,164985,465748
2020-06-29,BYX Equities (Y),77759489,44055147,58316998,180131634,2155245074.770200,2185089347.933600,2170068772.955200,6510403195.659000,902577,224187,559887,1686651
2020-06-29,BZX Equities (Z),236959494,157980506,194563370,589503370,7753299261.533897,8795128126.045301,9695050006.311596,26243477393.890794,2439832,757362,1831893,5029087
2020-06-26,NYSE American (A),11838611,159155483,7784402,178778496,369110258.200800,768092408.064200,354945704.914500,1492148371.179500,157574,130324,107695,395593
2020-06-26,NASDAQ BX (B),49557608,22459743,41674477,113691828,1502939996.926400,1294665624.034700,1601126668.847600,4398732289.808700,530519,173739,386203,1090461
2020-06-26,NYSE National (C),117454658,59842632,50048006,227345296,2050414677.632600,2000306837.571300,1229305694.983500,5280027210.187400,1043098,268253,523398,1834749
2020-06-26,FINRA / Nasdaq TRF Chicago (DB),9500569,3383954,11891614,24776137,328844320.662100,128164244.739900,576472887.816800,1033481453.218800,35099,10345,50862,96306
2020-06-26,FINRA / NYSE TRF (DN),387126275,271508711,757984105,1416619091,10757872951.222205,6119005675.646800,19783761406.705305,36660640033.574310,1773627,539003,2317316,4629946
2020-06-26,FINRA / Nasdaq TRF Carteret (DQ),2226733773,704575485,2230951836,5162261094,81387466302.842599,32653517392.892202,89477043652.711156,203518027348.445957,6051558,1564625,5326208,12942391
2020-06-26,EDGA Equities (J),96910240,42752693,75980099,215643032,4019125293.248700,2181272713.640900,3798102360.028600,9998500366.918200,1227282,248093,911956,2387331
2020-06-26,EDGX Equities (K),269955469,186410575,384690368,841056412,6889735270.027704,7803291879.278095,10105464406.667899,24798491555.973698,1985333,745694,1927649,4658676
2020-06-26,NYSE Chicago (M),4885096,8793208,3710281,17388585,244007407.681200,1096812230.267800,838065522.299200,2178885160.248200,9223,2344,8159,19726
2020-06-26,NYSE (N),3161317778,66733979,74553200,3302604957,97419879336.525101,3626106891.900700,4357975051.422600,105403961279.848401,4227154,226821,584098,5038073
2020-06-26,NYSE Arca (P),364753802,399356580,457282562,1221392944,11815268211.021302,23327030384.090795,21913789646.274095,57056088241.386192,2916956,1514964,3366116,7798036
2020-06-26,NASDAQ (Q),811233345,307683190,2752836983,3871753518,32156219767.180812,18012595990.642594,113499983048.538120,163668798806.361526,7354435,1478749,9008333,17841517
2020-06-26,Investors Exchange (V),159060334,31522729,92841550,283424613,6459111075.126900,1739748396.682200,5753392795.001000,13952252266.810100,1271765,174306,810017,2256088
2020-06-26,NASDAQ PSX (X),31873562,25186198,23656532,80716292,876514580.289300,1387936589.855900,1392529906.465600,3656981076.610800,227790,129153,210206,567149
2020-06-26,BYX Equities (Y),104422437,51675221,75830700,231928358,2836872793.124200,2625841967.634700,2812568192.767500,8275282953.526400,1121535,240681,730726,2092942
2020-06-26,BZX Equities (Z),301234153,199615342,267673200,768522695,10145530478.169900,12049553487.386803,14374616504.479799,36569700470.036502,3027270,985864,2382558,6395692
2020-06-25,NYSE American (A),9531245,27711811,6542500,43785556,289804079.475100,296584231.203700,276701273.908600,863089584.587400,139315,92174,88143,319632
2020-06-25,NASDAQ BX (B),39865004,21370980,36053624,97289608,1244893951.750200,1109952188.801000,1254535416.288300,3609381556.839500,451296,143097,328307,922700
2020-06-25,NYSE National (C),102757066,50950654,44123304,197831024,1813220473.379700,1736802298.064400,1058664483.893700,4608687255.337800,908120,224995,447780,1580895
2020-06-25,FINRA / Nasdaq TRF Chicago (DB),8544228,2867028,9689679,21100935,303775339.622800,134390461.895400,457376655.297800,895542456.816000,31768,8035,42051,81854
2020-06-25,FINRA / NYSE TRF (DN),406661756,233418256,727844441,1367924453,11190018632.780898,5530759857.948498,17704988481.966498,34425766972.695894,1487842,439307,2105459,4032608
2020-06-25,FINRA / Nasdaq TRF Carteret (DQ),1425475458,665101182,1525557007,3616133647,47705905175.505503,28879539063.550711,51194431798.266504,127779876037.322718,5309292,1262765,4824760,11396817
2020-06-25,EDGA Equities (J),86038457,42169185,65585625,193793267,3656767316.054600,1865148357.358900,3115736558.016700,8637652231.430200,1133927,227975,802731,2164633
2020-06-25,EDGX Equities (K),255528212,146954899,368528809,771011920,6211102193.114201,6384648687.202500,8373357207.365496,20969108087.682197,1758100,585914,1701428,4045442
2020-06-25,NYSE Chicago (M),3353566,10333028,4451053,18137647,240118096.027200,935298099.960200,651908867.503600,1827325063.491000,8163,1260,7176,16599
2020-06-25,NYSE (N),966832197,60400503,65301154,1092533854,35172745857.196502,3156260228.965200,2644505481.253500,40973511567.415202,3801483,209538,484729,4495750
2020-06-25,NYSE Arca (P),328441063,349127389,422580650,1100149102,10622366638.329301,20219522849.309611,15540310103.409802,46382199591.048714,2678496,1279337,2910910,6868743
2020-06-25,NASDAQ (Q),710543471,263830990,1127499775,2101874236,28172882916.015494,14543171904.288990,52926879663.300794,95642934483.605278,6672282,1214696,7583430,15470408
2020-06-25,Investors Exchange (V),127937373,22830455,72220001,222987829,5023667653.917300,1254275348.322900,3505224174.146002,9783167176.386202,1010779,115244,631948,1757971
2020-06-25,NASDAQ PSX (X),27232176,21994342,19702088,68928606,670861145.612700,1164948173.377200,838992788.100300,2674802107.090200,192360,108817,175801,476978
2020-06-25,BYX Equities (Y),87421179,48520674,65809974,201751827,2325699304.630400,2406714736.764599,2209555836.787500,6941969878.182499,988853,216396,647258,1852507
2020-06-25,BZX Equities (Z),261529326,166845576,218151418,646526320,8642088384.602299,9857601022.188899,10095157562.970606,28594846969.761804,2694336,795570,1961955,5451861
2020-06-24,NYSE American (A),10391803,31095631,7910297,49397731,315482421.475100,399815853.621300,323721655.868700,1039019930.965100,143896,110195,97688,351779
2020-06-24,NASDAQ BX (B),47581227,25161058,47273571,120015856,1484139481.622700,1631980351.088800,1515247375.501000,4631367208.212500,535116,199805,375613,1110534
2020-06-24,NYSE National (C),106452595,59885701,49227146,215565442,1875176806.052600,2060082591.528399,1204905843.785500,5140165241.366499,924455,277568,476280,1678303
2020-06-24,FINRA / Nasdaq TRF Chicago (DB),12169092,4310040,13928817,30407949,372578551.328500,188846553.776100,603334546.879300,1164759651.983900,41563,12673,53409,107645
2020-06-24,FINRA / NYSE TRF (DN),523285382,230012046,855539313,1608836741,12858470574.466896,7481928596.251500,21810587733.248018,42150986903.966414,2047804,597530,2417230,5062564
2020-06-24,FINRA / Nasdaq TRF Carteret (DQ),1628879146,718083498,1746053825,4093016469,52728781864.547998,36351069607.703069,59989117992.172606,149068969464.423673,6238317,1583466,5339261,13161044
2020-06-24,EDGA Equities (J),92512378,43203562,73376361,209092301,3863710462.661999,2182834426.473000,3275936208.656399,9322481097.791398,1206363,257839,854981,2319183
2020-06-24,EDGX Equities (K),306334720,167358268,442405114,916098102,7255599044.511804,8574484547.522103,9608394032.025600,25438477624.059507,2038673,748392,1897695,4684760
2020-06-24,NYSE Chicago (M),7062729,12268429,4378377,23709535,303242302.533600,1574254651.595000,729744235.149000,2607241189.277600,10758,2248,8163,21169
2020-06-24,NYSE (N),1104332479,70592506,74943268,1249868253,40678486764.019994,3794695756.032201,3068372943.618800,47541555463.670995,4200837,239613,537245,4977695
2020-06-24,NYSE Arca (P),381985596,412034364,476567534,1270587494,12107162438.710503,24637183479.704285,18996299814.798704,55740645733.213492,3043729,1653671,3283488,7980888
2020-06-24,NASDAQ (Q),808476180,304751762,1357100880,2470328822,31595703388.707598,20394922297.735714,62060578886.101074,114051204572.544386,7343920,1598699,8337994,17280613
2020-06-24,Investors Exchange (V),138548184,25199358,79106769,242854311,5507148323.907801,1550798406.957000,4274465071.277799,11332411802.142600,1183210,132966,755531,2071707
2020-06-24,NASDAQ PSX (X),28857709,23647892,20592260,73097861,744255245.675700,1337792352.264100,1045082147.470200,3127129745.410000,202479,129413,178862,510754
2020-06-24,BYX Equities (Y),97829767,54082445,74949412,226861624,2590530639.226900,2956622659.385598,2621780470.362602,8168933768.975100,1086853,255249,709579,2051681
2020-06-24,BZX Equities (Z),302989132,210614367,265777920,779381419,10188917381.044001,13750001241.129198,12166301350.890692,36105219973.063891,3072293,1063836,2268781,6404910
2020-06-23,NYSE American (A),9183058,34659620,5807771,49650449,265439337.643300,272858121.513200,272914487.543100,811211946.699600,135861,95731,91860,323452
2020-06-23,NASDAQ BX (B),40234545,15812261,35365637,91412443,1271848261.282400,876223768.005400,1337919068.831000,3485991098.118800,462336,112880,335360,910576
2020-06-23,NYSE National (C),91622274,36976004,40270053,168868331,1681597177.526200,1295588492.155900,1026592901.143500,4003778570.825600,808981,184888,432530,1426399
2020-06-23,FINRA / Nasdaq TRF Chicago (DB),8317787,2540363,14825726,25683876,309307651.064200,128658464.058800,546780227.210400,984746342.333400,33397,8125,49611,91133
2020-06-23,FINRA / NYSE TRF (DN),384929345,216834991,1009705554,1611469890,11266062504.260206,4718814390.671400,19836385898.596407,35821262793.528013,1599401,463468,2377061,4439930
2020-06-23,FINRA / Nasdaq TRF Carteret (DQ),1423123746,628348673,1918955012,3970427431,50184176358.230908,26384990354.156009,58196019600.478627,134765186312.865544,5221631,1203387,5071394,11496412
2020-06-23,EDGA Equities (J),76638343,29387606,67139712,173165661,3340730327.183800,1446790814.489800,3046008065.849399,7833529207.522999,1014181,184165,770772,1969118
2020-06-23,EDGX Equities (K),254571375,134959917,441804490,831335782,6493372180.340700,5089420274.377795,8729461253.368599,20312253708.087094,1702854,501309,1707284,3911447
2020-06-23,NYSE Chicago (M),8029142,7047579,6332800,21409521,550364815.340000,539347451.980200,991703111.390200,2081415378.710400,7822,1859,5875,15556
2020-06-23,NYSE (N),1016090020,39995367,67905312,1123990699,37396021722.201594,2087623526.070100,2640490696.812500,42124135945.084194,3300997,138434,463631,3903062
2020-06-23,NYSE Arca (P),305322829,275067770,456636854,1037027453,10265569441.444997,15522546305.041893,16641869323.926209,42429985070.413099,2520563,1037409,2892927,6450899
2020-06-23,NASDAQ (Q),626052063,193440837,1240708774,2060201674,25372000587.570702,11018168344.225798,54644465129.547722,91034634061.344222,5720155,954797,6967089,13642041
2020-06-23,Investors Exchange (V),122097182,19370058,75850371,217317611,4870709773.434300,1059952062.615800,4211530240.554400,10142192076.604500,979911,100080,637628,1717619
2020-06-23,NASDAQ PSX (X),23249151,14118786,17962814,55330751,611975014.227900,762024475.642100,760225368.783900,2134224858.653900,168516,70737,143403,382656
2020-06-23,BYX Equities (Y),78958306,47480078,132428305,258866689,2109994190.669100,1783993612.709099,2025372131.876800,5919359935.254999,845629,186811,660694,1693134
2020-06-23,BZX Equities (Z),243430863,124904756,223475086,591810705,8401259590.154398,7169366349.083901,10035718960.234699,25606344899.472998,2445311,627921,1832686,4905918
2020-06-22,NYSE American (A),10378432,31893799,6013428,48285659,261385156.515700,328957284.885800,251425437.768600,841767879.170100,147249,94143,89467,330859
2020-06-22,NASDAQ BX (B),40618198,16528325,27307011,84453534,1170465987.068900,906600628.174000,1125009994.732400,3202076609.975300,442063,123942,304234,870239
2020-06-22,NYSE National (C),88598874,38211981,37385845,164196700,1531370293.029300,1336239060.039100,962860284.703200,3830469637.771600,809243,187499,420719,1417461
2020-06-22,FINRA / Nasdaq TRF Chicago (DB),9239338,2550572,11242011,23031921,298496955.384600,135675552.358500,518797652.889900,952970160.633000,34866,8679,51729,95274
2020-06-22,FINRA / NYSE TRF (DN),394893328,164654065,675731475,1235278868,11108260095.620705,4934724517.047696,16214789970.396508,32257774583.064909,1659694,439900,2206692,4306286
2020-06-22,FINRA / Nasdaq TRF Carteret (DQ),1355006340,565070932,1451361673,3371438945,47013042382.741123,25886721152.026686,50073284177.481851,122973047712.249660,5157043,1214789,4883282,11255114
2020-06-22,EDGA Equities (J),74735224,28828871,56170803,159734898,3047062458.205000,1478970523.319400,2794605811.832300,7320638793.356700,998873,186274,765699,1950846
2020-06-22,EDGX Equities (K),258742114,114367925,338563791,711673830,6119168655.736002,5521159029.990205,7679647338.923496,19319975024.649703,1721188,515491,1680399,3917078
2020-06-22,NYSE Chicago (M),7677793,11348195,4535720,23561708,420864153.775400,1945028370.359400,848789160.763300,3214681684.898100,9610,1508,6589,17707
2020-06-22,NYSE (N),1073813640,39864460,57169088,1170847188,39105183389.098395,2153596728.888000,2349986583.267899,43608766701.254294,3444406,145219,438734,4028359
2020-06-22,NYSE Arca (P),287385066,283365023,374378484,945128573,8940268079.941898,17219054887.112006,14349351249.652294,40508674216.706198,2380125,1090864,2753274,6224263
2020-06-22,NASDAQ (Q),637675477,190445174,1112795360,1940916011,24451130579.402195,11924360332.702406,52589838867.128317,88965329779.232918,5888154,1038464,6975049,13901667
2020-06-22,Investors Exchange (V),104151292,19853808,65927047,189932147,4326462537.475000,1066284515.393900,3561494779.641002,8954241832.509902,967494,94359,648090,1709943
2020-06-22,NASDAQ PSX (X),24732171,14932115,15422651,55086937,608501491.559300,794629212.076600,642734939.423500,2045865643.059400,177060,84015,140460,401535
2020-06-22,BYX Equities (Y),80750015,38562749,76019945,195332709,1992781877.611300,1796544247.034500,1969817815.734600,5759143940.380400,851011,181301,647475,1679787
2020-06-22,BZX Equities (Z),238295194,126117418,196939993,561352605,8002607200.451300,7693241147.070101,9154374692.430198,24850223039.951599,2455912,674595,1878111,5008618
2020-06-19,NYSE American (A),11418993,112235500,6739187,130393680,353307884.884400,624403257.398700,375069541.507300,1352780683.790400,151599,107099,94690,353388
2020-06-19,NASDAQ BX (B),48433331,22735497,34635015,105803843,1474589983.044700,1302939542.755800,1437823911.715800,4215353437.516300,509389,171939,337163,1018491
2020-06-19,NYSE National (C),126339665,54519640,46784622,227643927,2262737266.988900,1952812663.009200,1144270147.409600,5359820077.407700,1044293,264854,482453,1791600
2020-06-19,FINRA / Nasdaq TRF Chicago (DB),9489671,3149892,11058144,23697707,402313549.872100,171052546.502100,570045528.029400,1143411624.403600,35760,9524,48210,93494
2020-06-19,FINRA / NYSE TRF (DN),424184779,183433514,608813630,1216431923,12738731461.365898,6092729607.884099,18111494756.744598,36942955825.994595,1705538,474571,2038399,4218508
2020-06-19,FINRA / Nasdaq TRF Carteret (DQ),1979063499,613684896,1644383469,4237131864,72111247914.092755,35864004062.743589,70871645058.343217,178846897035.179561,5871903,1305971,4999884,12177758
2020-06-19,EDGA Equities (J),99226531,41366500,63421982,204015013,4138922974.878200,2083996091.765700,3454641480.759800,9677560547.403700,1301246,239080,834822,2375148
2020-06-19,EDGX Equities (K),304452641,151830293,319672854,775955788,7813488021.915699,8205055429.201899,9248150708.767402,25266694159.885000,2055176,657488,1784893,4497557
2020-06-19,NYSE Chicago (M),10758661,19617973,7434723,37811357,726602630.282400,2502782004.450001,1299962553.952600,4529347188.685001,8686,1883,7382,17951
2020-06-19,NYSE (N),3518193104,57919424,67860614,3643973142,131837688819.609589,3394948757.777100,3085472357.886800,138318109935.273489,4626546,205193,557444,5389183
2020-06-19,NYSE Arca (P),372514958,373718906,412875427,1159109291,12571991356.664203,23855959875.257104,19144991497.367195,55572942729.288502,2997265,1385013,3243968,7626246
2020-06-19,NASDAQ (Q),856653282,266889193,2465841118,3589383593,34497872087.371510,17952646678.290107,125688309891.952112,178138828657.613729,7736559,1404190,8614696,17755445
2020-06-19,Investors Exchange (V),141174343,33643595,82585332,257403270,5518243540.899700,1982360950.707700,4299645189.914700,11800249681.522100,1079932,163985,667602,1911519
2020-06-19,NASDAQ PSX (X),31521163,20818885,18569665,70909713,849457135.134300,1222416459.083800,1132645223.361600,3204518817.579700,217220,107939,164967,490126
2020-06-19,BYX Equities (Y),103219082,51734921,74823626,229777629,2638834757.775800,2491540531.825500,2462139708.119900,7592514997.721200,1094737,233146,654358,1982241
2020-06-19,BZX Equities (Z),310009008,180180479,228333102,718522589,11275055645.246699,11936036090.736195,13892400793.579505,37103492529.562399,3109386,896030,2259123,6264539
2020-06-18,NYSE American (A),8476052,29177560,5624321,43277933,236118815.782400,263834015.506700,215387073.403800,715339904.692900,118298,84422,77728,280448
2020-06-18,NASDAQ BX (B),40230220,14865904,32971333,88067457,1262848751.356900,863893486.598700,1307077585.617400,3433819823.573000,451222,110594,306762,868578
2020-06-18,NYSE National (C),85967467,33690568,34873347,154531382,1532262936.875400,1209481317.452000,849227397.519000,3590971651.846400,752222,164695,368927,1285844
2020-06-18,FINRA / Nasdaq TRF Chicago (DB),7219496,2272396,10374395,19866287,316741366.124800,113292484.243000,425182881.422400,855216731.790200,29466,7542,42869,79877
2020-06-18,FINRA / NYSE TRF (DN),361057200,170600698,652467325,1184125223,11215258080.511903,4721499327.798596,14825754295.145110,30762511703.455609,1394498,385020,1918663,3698181
2020-06-18,FINRA / Nasdaq TRF Carteret (DQ),1284232133,497290591,1357861990,3139384714,44952156182.518016,23801586193.769917,47480194089.214431,116233936465.502364,4786674,1026994,4368116,10181784
2020-06-18,EDGA Equities (J),72599884,26730746,56663840,155994470,3167034974.113800,1287024460.088800,2835457324.806000,7289516759.008600,996739,157784,712149,1866672
2020-06-18,EDGX Equities (K),235435889,107668394,330804835,673909118,5960722210.831200,5315576799.509301,6999390299.338204,18275689309.678705,1562410,437016,1500952,3500378
2020-06-18,NYSE Chicago (M),4917851,14797824,4769559,24485234,255756961.909100,1888476800.250000,795979989.762900,2940213751.922000,7526,1381,5104,14011
2020-06-18,NYSE (N),1009090486,35359565,55083240,1099533291,36617579693.633600,2000210063.757000,2264348604.550000,40882138361.940600,3438680,135503,415396,3989579
2020-06-18,NYSE Arca (P),281467604,253829948,372695111,907992663,9177771819.867403,15218783756.244809,13336797795.687495,37733353371.799707,2237958,949629,2555197,5742784
2020-06-18,NASDAQ (Q),627704042,175304117,1080739691,1883747850,24312992942.535500,11094615761.592310,48682935804.143375,84090544508.271185,5643700,918668,6602425,13164793
2020-06-18,Investors Exchange (V),105368934,18508339,65401432,189278705,4180127521.037500,952262304.309700,3578646570.757100,8711036396.104300,878271,86314,555243,1519828
2020-06-18,NASDAQ PSX (X),23370538,12824440,13609135,49804113,579065430.088800,759155977.614400,691402920.046900,2029624327.750100,165423,68398,132045,365866
2020-06-18,BYX Equities (Y),74754026,36345844,80154405,191254275,2008844659.873700,1706116146.284300,1992193831.232699,5707154637.390699,823445,162177,525583,1511205
2020-06-18,BZX Equities (Z),226803632,113759961,181232185,521795778,7868383353.447400,7357889185.323698,8462090689.664503,23688363228.435601,2301406,580296,1630593,4512295
2020-06-17,NYSE American (A),8788668,34195852,5373176,48357696,270780537.674700,340413855.680300,251529938.736800,862724332.091800,129043,89337,87172,305552
2020-06-17,NASDAQ BX (B),39282680,18405913,33183766,90872359,1139380748.208600,951650281.593900,1170019218.014500,3261050247.817000,438079,132944,303687,874710
2020-06-17,NYSE National (C),87747882,38221396,35808726,161778004,1548023661.336400,1348795148.437400,933392052.713500,3830210862.487300,745504,184890,382585,1312979
2020-06-17,FINRA / Nasdaq TRF Chicago (DB),7379832,2163353,10240009,19783194,273421340.442700,101293050.643100,483804939.531800,858519330.617600,27266,6693,43678,77637
2020-06-17,FINRA / NYSE TRF (DN),380563129,179714863,634887581,1195165573,10408286832.428605,5060604844.107600,17092031430.178808,32560923106.715013,1492892,416829,2041622,3951343
2020-06-17,FINRA / Nasdaq TRF Carteret (DQ),1328665035,536615586,1341435062,3206715683,45550231397.611500,26755011702.531800,51915652700.829983,124220895800.973283,4889733,1121274,4598514,10609521
2020-06-17,EDGA Equities (J),76759343,32625298,60544284,169928925,3222485435.489500,1639814293.891200,3012268540.503899,7874568269.884599,1049316,190191,763928,2003435
2020-06-17,EDGX Equities (K),249715307,130149277,327386620,707251204,6380393072.803299,5868606113.333399,7958542152.893398,20207541339.030096,1639831,523630,1663669,3827130
2020-06-17,NYSE Chicago (M),5185364,12401381,3658565,21245310,399998473.683200,1685505873.725600,592481359.151500,2677985706.560300,7611,1350,5289,14250
2020-06-17,NYSE (N),1012361286,44394209,55000444,1111755939,35935723871.811101,2366767113.789100,2394544222.290500,40697035207.890701,3527932,152539,422469,4102940
2020-06-17,NYSE Arca (P),274507165,285069696,354506349,914083210,8494340537.566101,16723325538.641096,14114764992.250995,39332431068.458192,2266930,1076633,2645752,5989315
2020-06-17,NASDAQ (Q),648367092,205444484,1075486238,1929297814,25055270821.589807,12570980486.927296,50520127372.031814,88146378680.548917,5929054,1068817,6952859,13950730
2020-06-17,Investors Exchange (V),109690524,20652339,64656685,194999548,4681031093.641200,1185402896.661600,3741730842.898000,9608164833.200800,860652,102202,533460,1496314
2020-06-17,NASDAQ PSX (X),23741067,15192497,14419999,53353563,613119302.356400,816657644.186500,685299835.871400,2115076782.414300,168540,76144,127296,371980
2020-06-17,BYX Equities (Y),74874163,41244272,68962878,185081313,1865061134.683800,1969797564.089800,1812623350.225500,5647482048.999100,823225,191118,526713,1541056
2020-06-17,BZX Equities (Z),232821719,137866913,194159514,564848146,8089766122.796199,8363330515.627401,9853389471.079299,26306486109.502899,2459592,689013,1847638,4996243
2020-06-16,NYSE American (A),11295398,31690541,6022741,49008680,370519160.589600,401503089.550000,321205698.576900,1093227948.716500,162663,112544,97001,372208
2020-06-16,NASDAQ BX (B),51941428,26264110,39653744,117859282,1658391350.699200,1649647269.134501,1494020002.107800,4802058621.941501,557056,229549,357508,1144113
2020-06-16,NYSE National (C),104964582,54032377,39824006,198820965,1883486688.174600,1857430303.812800,1077324480.045000,4818241472.032400,863545,262561,402841,1528947
2020-06-16,FINRA / Nasdaq TRF Chicago (DB),10654942,3295590,9788666,23739198,415779488.171300,221932510.332200,563129493.188200,1200841491.691700,38367,10100,44094,92561
2020-06-16,FINRA / NYSE TRF (DN),501692426,219756904,659190428,1380639758,13722771360.579406,6975856173.838799,19107580717.134001,39806208251.552206,1787263,512017,2119167,4418447
2020-06-16,FINRA / Nasdaq TRF Carteret (DQ),1571752945,666666029,1448655441,3687074415,53967327095.733711,33412000862.658584,57089872047.559914,144469200005.952209,5760037,1501653,4848525,12110215
2020-06-16,EDGA Equities (J),97668161,50847090,62366873,210882124,4069471715.831600,2515781038.501500,3396335985.206200,9981588739.539300,1292543,275599,811365,2379507
2020-06-16,EDGX Equities (K),343060442,200686091,347829988,891576521,8946614295.176398,10485028338.574004,9993624137.562404,29425266771.312806,2144188,826656,1842674,4813518
2020-06-16,NYSE Chicago (M),7810470,7686860,3582063,19079393,477464546.968000,606657437.757300,542140267.646700,1626262252.372000,12137,1970,8155,22262
2020-06-16,NYSE (N),1268497591,76044037,63016459,1407558087,45608766492.761100,3959921837.162199,3035427869.472299,52604116199.395598,4987510,248457,484840,5720807
2020-06-16,NYSE Arca (P),389829033,486063716,409514846,1285407595,12373257352.897900,29899806437.902410,19418939816.700891,61692003607.501201,3157887,1766474,3142338,8066699
2020-06-16,NASDAQ (Q),899667532,341466746,1187770568,2428904846,35310950271.669303,23691923677.257093,62484770471.000606,121487644419.927002,8257145,1832564,8497251,18586960
2020-06-16,Investors Exchange (V),126376586,29938182,69892680,226207448,5242080011.523600,1993295586.268300,3800685316.986800,11036060914.778700,999448,131947,573005,1704400
2020-06-16,NASDAQ PSX (X),32090493,27552798,18815050,78458341,843962721.179500,1601250603.330700,1044369071.639700,3489582396.149900,232219,148403,185068,565690
2020-06-16,BYX Equities (Y),101949821,60622305,75646237,238218363,2646779507.577700,2891239003.687201,2455953898.394899,7993972409.659800,1099196,268945,621310,1989451
2020-06-16,BZX Equities (Z),326566507,233249218,227758826,787574551,11222744644.272002,15378003700.483904,13320149614.422895,39920897959.178801,3384646,1194815,2271039,6850500
2020-06-15,NYSE American (A),11989820,31323948,6479588,49793356,384802313.997200,427268733.186500,294634552.628000,1106705599.811700,166802,104622,101741,373165
2020-06-15,NASDAQ BX (B),50120114,23295434,37271440,110686988,1450196243.965100,1359097672.785800,1443310502.662900,4252604419.413800,511914,150088,359248,1021250
2020-06-15,NYSE National (C),111749402,55032443,45463607,212245452,1945952006.804500,1823764156.484500,1060569578.338900,4830285741.627900,926088,256093,444821,1627002
2020-06-15,FINRA / Nasdaq TRF Chicago (DB),11390176,3927494,10903528,26221198,467397611.217300,164511546.353500,621344869.058000,1253254026.628800,42998,11266,46822,101086
2020-06-15,FINRA / NYSE TRF (DN),504760161,207421386,641659502,1353841049,13379593199.712703,6725100121.093697,19464717832.273601,39569411153.080001,1900989,521836,2039570,4462395
2020-06-15,FINRA / Nasdaq TRF Carteret (DQ),1558660820,608485825,1349481458,3516628103,53848565034.528894,33794093831.359094,52551662346.702697,140194321212.590685,6054813,1494042,4681929,12230784
2020-06-15,EDGA Equities (J),99466146,45958880,62294449,207719475,3909107264.702600,2270665422.143700,3064446254.712000,9244218941.558300,1314909,262946,830322,2408177
2020-06-15,EDGX Equities (K),337907682,172126437,321994386,832028505,8345400962.730603,9573860914.630699,8930244783.112095,26849506660.473397,2206497,801517,1768449,4776463
2020-06-15,NYSE Chicago (M),11845300,17940313,4696664,34482277,1079146158.685000,2190300430.497400,619964625.037300,3889411214.219700,11760,1474,8768,22002
2020-06-15,NYSE (N),1222193886,66848981,65278090,1354320957,44123319233.315900,3672256906.727799,2860149525.954699,50655725665.998398,4958739,251830,513268,5723837
2020-06-15,NYSE Arca (P),367276244,429319919,386314741,1182910904,11215927366.537401,26329291271.022516,17264688259.235105,54809906896.795022,3068124,1673895,3158021,7900040
2020-06-15,NASDAQ (Q),871351449,316529577,1158127829,2346008855,32790931437.017592,20884986023.764203,58138269088.289194,111814186549.070989,7998462,1728915,8230833,17958210
2020-06-15,Investors Exchange (V),135711396,26180364,69830566,231722326,5028054373.048400,1592276363.042100,3311232688.694400,9931563424.784900,1028376,127583,562625,1718584
2020-06-15,NASDAQ PSX (X),28106423,24301016,18495727,70903166,724036717.058600,1536988843.824500,955068580.761900,3216094141.645000,206988,135114,182204,524306
2020-06-15,BYX Equities (Y),100983723,52625789,79960600,233570112,2440261857.828900,2506452103.519400,2126317668.570299,7073031629.918599,1075262,249818,606838,1931918
2020-06-15,BZX Equities (Z),333970130,223075789,217767473,774813392,11358458625.773398,14786913412.522598,11915190496.690706,38060562534.986702,3546045,1146131,2257263,6949439
2020-06-12,NYSE American (A),11781466,32653166,6725220,51159852,381815117.421600,528790216.396600,391585576.775000,1302190910.593200,167997,122868,99932,390797
2020-06-12,NASDAQ BX (B),55956585,30186087,31664182,117806854,1708699534.717100,2052103307.676899,1621839389.654600,5382642232.048599,616255,207975,382050,1206280
2020-06-12,NYSE National (C),97787140,60369974,43977966,202135080,1739938355.163100,1944992996.903900,1192025650.923000,4876957002.990000,839969,290629,418797,1549395
2020-06-12,FINRA / Nasdaq TRF Chicago (DB),10094854,3950804,10146397,24192055,333812743.882000,160703624.125500,600654626.950600,1095170994.958100,39697,11628,44651,95976
2020-06-12,FINRA / NYSE TRF (DN),546424405,248590455,609087906,1404102766,13159507662.636204,8834936107.185505,22157585413.190803,44152029183.012512,1885486,583017,2052378,4520881
2020-06-12,FINRA / Nasdaq TRF Carteret (DQ),1620805749,849691818,1347692344,3818189911,52502304725.941298,44319324484.236305,63012241912.719014,159833871122.896617,6089461,1659072,4735499,12484032
2020-06-12,EDGA Equities (J),109406539,64007787,64095696,237510022,4022470322.438700,3328498187.212699,3419358053.955500,10770326563.606899,1399171,384787,842721,2626679
2020-06-12,EDGX Equities (K),362559229,219183474,309802853,891545556,9014821563.271103,12449474034.836001,10672494654.093099,32136790252.200203,2306590,1023154,1806330,5136074
2020-06-12,NYSE Chicago (M),11323622,22876844,7138363,41338829,395212122.860800,2418986038.337000,989351136.780200,3803549297.978000,11262,2482,8749,22493
2020-06-12,NYSE (N),1163918093,78526415,62005405,1304449913,42918241772.866198,4276201768.361800,3040558467.000800,50235002008.228798,4954728,286543,500094,5741365
2020-06-12,NYSE Arca (P),377266617,553488667,368942486,1299697770,11643803255.933899,33506212454.380066,19998929450.926901,65148945161.240866,3139353,2084693,3124257,8348303
2020-06-12,NASDAQ (Q),856462599,406090169,1146123237,2408676005,33046783756.668906,28205201492.925970,65068558124.358379,126320543373.953255,8174292,2261191,8684364,19119847
2020-06-12,Investors Exchange (V),140721131,32414803,70456577,243592511,4994361737.462597,1963961143.491600,3900382624.093400,10858705505.047597,1097018,161783,583366,1842167
2020-06-12,NASDAQ PSX (X),28831021,30424033,18823869,78078923,775321102.477000,1876536659.938300,1469606794.613200,4121464557.028500,215184,178145,215287,608616
2020-06-12,BYX Equities (Y),104805213,64346033,62357044,231508290,2644211046.878800,3575219560.446799,2786534769.080199,9005965376.405798,1117704,320430,620640,2058774
2020-06-12,BZX Equities (Z),347193653,295699361,229959862,872852876,12610790994.385500,20326316500.111300,15348492695.350798,48285600189.847598,3813260,1521527,2571314,7906101
2020-06-11,NYSE American (A),13940063,37666977,8406138,60013178,458021388.709500,622529402.054100,438385370.548200,1518936161.311800,183320,136101,116384,435805
2020-06-11,NASDAQ BX (B),60809341,33195449,39247069,133251859,1971205244.080700,2183574528.992999,1744191346.711200,5898971119.784899,680012,274316,425112,1379440
2020-06-11,NYSE National (C),113083740,72729346,46924292,232737378,2117792407.168400,2514484942.028300,1286724496.741900,5919001845.938600,981551,345569,450552,1777672
2020-06-11,FINRA / Nasdaq TRF Chicago (DB),13993968,5419926,12929649,32343543,460571160.885700,272525068.867200,770130941.867000,1503227171.619900,54701,16658,57446,128805
2020-06-11,FINRA / NYSE TRF (DN),634850927,275591994,729276535,1639719456,15630711300.758691,10123171055.572394,23477357891.340088,49231240247.671173,2623452,780532,2608113,6012097
2020-06-11,FINRA / Nasdaq TRF Carteret (DQ),2068663753,1057159623,1637885640,4763709016,65853720885.665875,58810792169.946318,68739092674.090194,193403605729.702387,8037895,2240676,5869961,16148532
2020-06-11,EDGA Equities (J),126044654,61899048,78589695,266533397,5016028151.531700,3288115670.367800,4013390346.540701,12317534168.440201,1627078,394453,988369,3009900
2020-06-11,EDGX Equities (K),436225469,250521949,413445462,1100192880,11220649380.536607,13971617097.447086,12039721452.621099,37231987930.604792,2777006,1146649,2155169,6078824
2020-06-11,NYSE Chicago (M),8312190,14563908,6386673,29262771,383298188.199400,1400722240.046000,1064929058.261300,2848949486.506700,10342,2165,7598,20105
2020-06-11,NYSE (N),1327685741,82894813,68587353,1479167907,49812563769.525098,4367323197.440298,3059705284.483799,57239592251.449195,5347007,284022,513831,6144860
2020-06-11,NYSE Arca (P),471906571,593717743,446759437,1512383751,15521187661.225796,37697577798.439233,21661956728.482397,74880722188.147426,3770454,2231656,3473062,9475172
2020-06-11,NASDAQ (Q),1009047510,424552330,1355392003,2788991843,40747915096.087599,31065305933.990185,75759287124.939561,147572508155.017345,9149745,2279453,9500382,20929580
2020-06-11,Investors Exchange (V),181261713,38792670,87670828,307725211,6527471710.661499,2708944894.625701,4563128615.917400,13799545221.204600,1294115,188317,672035,2154467
2020-06-11,NASDAQ PSX (X),36631026,35608753,23887760,96127539,929587337.472000,2156734649.035100,1519080221.204100,4605402207.711200,246531,195751,229429,671711
2020-06-11,BYX Equities (Y),125822610,78077194,78918888,282818692,3253411868.062600,4145736676.964097,2938923173.830400,10338071718.857097,1311251,367287,709620,2388158
2020-06-11,BZX Equities (Z),409047194,303311117,266552132,978910443,15283286695.787597,20446157500.028101,16927045416.787202,52656489612.602900,4213905,1533375,2814897,8562177
2020-06-10,NYSE American (A),12462891,48705193,6316315,67484399,396404407.243900,405763511.257700,351809940.048500,1153977858.550100,170031,138970,97204,406205
2020-06-10,NASDAQ BX (B),57198682,29328310,32244057,118771049,1650149581.721500,1566452623.914900,1465524798.678900,4682127004.315300,589129,154828,341562,1085519
2020-06-10,NYSE National (C),102744691,54340972,39822611,196908274,1888546984.842900,1958441107.472001,1119291721.202800,4966279813.517701,864224,253254,419513,1536991
2020-06-10,FINRA / Nasdaq TRF Chicago (DB),13017673,3631418,11279905,27928996,418809029.094000,162232218.601100,636502165.599900,1217543413.295000,44166,10143,51235,105544
2020-06-10,FINRA / NYSE TRF (DN),692644825,297501190,842073495,1832219510,16504643520.452604,6854742213.241702,21489874901.291105,44849260634.985411,2396969,657191,2609415,5663575
2020-06-10,FINRA / Nasdaq TRF Carteret (DQ),1977592384,781762906,1661731820,4421087110,61264183312.333528,35245189761.129506,62162168838.259512,158671541911.722546,6477534,1641043,5203490,13322067
2020-06-10,EDGA Equities (J),102214494,51298249,61711940,215224683,3932763579.989400,2385197205.835800,3328754930.378200,9646715716.203400,1270268,299144,796084,2365496
2020-06-10,EDGX Equities (K),420764829,219635655,396372142,1036772626,10013551182.015296,8447629787.180804,10877209053.626396,29338390022.822496,2434706,832196,1920197,5187099
2020-06-10,NYSE Chicago (M),21640737,12567059,10062966,44270762,689771335.271100,1426029174.157600,1206947950.523200,3322748459.951900,11376,1565,7155,20096
2020-06-10,NYSE (N),1188406627,62300743,64184240,1314891610,41781815136.543804,3367014736.284999,2751506247.342700,47900336120.171503,4560352,213558,465827,5239737
2020-06-10,NYSE Arca (P),430026209,433721539,440094687,1303842435,12301517482.253697,23538544427.465502,19394855325.837089,55234917235.556288,3142974,1561369,3070754,7775097
2020-06-10,NASDAQ (Q),915824952,320272231,1197066863,2433164046,33397450554.024203,18349684400.759499,62323209785.945823,114070344740.729525,7890963,1568204,8045864,17505031
2020-06-10,Investors Exchange (V),159655777,28620571,82666579,270942927,6404299704.214201,1521142584.605300,4659255723.089003,12584698011.908504,1157615,127341,630953,1915909
2020-06-10,NASDAQ PSX (X),33441739,24069630,20342212,77853581,809412414.915400,1393482481.462300,1050934076.873600,3253828973.251300,223464,116086,181247,520797
2020-06-10,BYX Equities (Y),108934030,66444420,70639956,246018406,2559259046.778700,2839550312.969399,2373747938.792000,7772557298.540099,1086526,268789,606063,1961378
2020-06-10,BZX Equities (Z),362307278,210707611,234252662,807267551,12072807766.917196,11883457242.195701,14163705241.226404,38119970250.339301,3486515,1036902,2203849,6727266
2020-06-09,NYSE American (A),11649310,43428579,6513339,61591228,341173923.744000,342862220.859300,306812594.374600,990848738.977900,147881,113593,86766,348240
2020-06-09,NASDAQ BX (B),55304132,20111320,47185860,122601312,1544490764.349500,1215362460.461400,1392658613.618300,4152511838.429200,583302,117512,338461,1039275
2020-06-09,NYSE National (C),94628063,45324827,38308129,178261019,1803259784.840200,1703850506.428100,1012458544.027200,4519568835.295500,832385,215882,396055,1444322
2020-06-09,FINRA / Nasdaq TRF Chicago (DB),11656590,2902910,10384070,24943570,334797061.148800,113890068.800400,533014569.128500,981701699.077700,39589,8189,45702,93480
2020-06-09,FINRA / NYSE TRF (DN),679138438,258350474,876426656,1813915568,13921165136.092295,5668762657.843503,19230961237.512795,38820889031.448593,2482815,590632,2625259,5698706
2020-06-09,FINRA / Nasdaq TRF Carteret (DQ),1993377038,812038892,1779123736,4584539666,58829729663.611236,37982356145.050513,58881495317.849919,155693581126.511668,6575616,1427314,5245624,13248554
2020-06-09,EDGA Equities (J),100790622,43775589,62750675,207316886,4115363147.373000,2331165362.134000,3342095562.365000,9788624071.872000,1381998,249639,875797,2507434
2020-06-09,EDGX Equities (K),412453950,167903192,393598014,973955156,8854286646.666509,6734873801.804096,9197263238.022507,24786423686.493112,2310999,608441,1797627,4717067
2020-06-09,NYSE Chicago (M),8540939,10126188,5248891,23916018,463286394.722500,1064221770.950000,805557075.637000,2333065241.309500,12325,1597,5998,19920
2020-06-09,NYSE (N),1152476653,49364167,60232965,1262073785,41385497674.803100,2902935543.451900,2170248148.632500,46458681366.887500,4065752,157549,416803,4640104
2020-06-09,NYSE Arca (P),438186747,354570405,440916569,1233673721,11846877230.662699,20178443902.657088,16688847644.074905,48714168777.394692,3140029,1184160,2965435,7289624
2020-06-09,NASDAQ (Q),840168720,247934397,1197591111,2285694228,29443880144.667193,14250375270.878299,56079008617.526585,99773264033.072077,7343602,1133435,7737667,16214704
2020-06-09,Investors Exchange (V),143250236,26160156,82336857,251747249,5512229358.702100,1436250118.189000,4188812566.993001,11137292043.884101,1067675,118780,621989,1808444
2020-06-09,NASDAQ PSX (X),31241869,20706011,19572452,71520332,739387064.664900,1348268813.808500,1006718690.422400,3094374568.895800,203469,107105,165731,476305
2020-06-09,BYX Equities (Y),109994810,63019749,72045602,245060161,2487298421.715700,2477296117.689401,2222064686.160500,7186659225.565601,1102381,236030,595975,1934386
2020-06-09,BZX Equities (Z),328071911,165834571,227224245,721130727,10529319446.440598,9527055021.170701,11784341593.419998,31840716061.031297,3183445,789045,2094087,6066577
2020-06-08,NYSE American (A),15239184,38021411,8107889,61368484,477320636.846300,346452790.448900,292370008.855600,1116143436.150800,193451,113784,102123,409358
2020-06-08,NASDAQ BX (B),64578729,20555620,50340782,135475131,1694105996.895400,1307877222.537800,1325079283.387000,4327062502.820200,638977,118149,355915,1113041
2020-06-08,NYSE National (C),113446769,42055107,41846934,197348810,2169218819.342900,1616765042.864500,1034478196.012000,4820462058.219400,940730,213501,425184,1579415
2020-06-08,FINRA / Nasdaq TRF Chicago (DB),18596614,3044647,14331694,35972955,475130955.771900,126943173.012100,551819008.216500,1153893137.000500,59224,10138,52021,121383
2020-06-08,FINRA / NYSE TRF (DN),1012341907,230963851,975906164,2219211922,17352733211.989798,5593977292.624502,17435496111.859381,40382206616.473681,3206579,582554,2643352,6432485
2020-06-08,FINRA / Nasdaq TRF Carteret (DQ),2658092102,783333072,2064962635,5506387809,71403879298.322209,36268040997.442504,58301643813.492897,165973564109.257610,8157171,1510505,5544492,15212168
2020-06-08,EDGA Equities (J),114413785,37113877,75130609,226658271,4439512275.263000,2004357330.114900,3149508795.814700,9593378401.192600,1461916,249598,865489,2577003
2020-06-08,EDGX Equities (K),596293785,162455234,468656913,1227405932,11245292859.109697,6814308662.480805,9308806369.698702,27368407891.289204,2918602,625994,1909978,5454574
2020-06-08,NYSE Chicago (M),10211026,15891754,4062724,30165504,427706304.516800,1605252847.100000,573894260.479400,2606853412.096200,10337,1865,6111,18313
2020-06-08,NYSE (N),1428125559,47840660,67434882,1543401101,47703551883.379700,2815028769.816000,2292690149.446900,52811270802.642600,4657274,158186,440141,5255601
2020-06-08,NYSE Arca (P),584358408,338596086,483657871,1406612365,14017212283.552699,19267740125.331907,16124302535.890710,49409254944.775316,3629702,1212658,3017189,7859549
2020-06-08,NASDAQ (Q),1053165690,233003017,1411590550,2697759257,34913425662.353012,13695141839.606395,56641974321.706982,105250541823.666389,8441362,1164728,8023482,17629572
2020-06-08,Investors Exchange (V),208852377,27423027,99450279,335725683,7073430754.172502,1435428379.347900,4642084769.192701,13150943902.713103,1308469,119527,691608,2119604
2020-06-08,NASDAQ PSX (X),38853182,20681071,24375084,83909337,904914859.169300,1306331344.787000,898211276.775000,3109457480.731300,258127,105970,188998,553095
2020-06-08,BYX Equities (Y),136880392,56893898,123178262,316952552,2997675762.897400,2664218585.814701,2249218531.549900,7911112880.262001,1310608,239124,671776,2221508
2020-06-08,BZX Equities (Z),444855739,161743007,284302400,890901146,12880778323.899803,9379356534.307400,11249075182.215705,33509210040.422908,3844203,815258,2258249,6917710
2020-06-05,NYSE American (A),17092757,36613773,9441908,63148438,532239183.082900,540610050.493100,417510551.797900,1490359785.373900,224997,117334,131427,473758
2020-06-05,NASDAQ BX (B),75279199,30252074,94264094,199795367,2129666883.432700,1636154142.696700,1665978315.945400,5431799342.074800,746337,138343,422834,1307514
2020-06-05,NYSE National (C),122925092,57533735,45485391,225944218,2319897074.538500,2112413303.169701,1185310217.591300,5617620595.299501,1000485,255999,452396,1708880
2020-06-05,FINRA / Nasdaq TRF Chicago (DB),19929151,3758894,12827658,36515703,576075400.641300,155701143.946600,516944616.582300,1248721161.170200,58567,11400,46870,116837
2020-06-05,FINRA / NYSE TRF (DN),944117500,239661373,1064297538,2248076411,20951608905.059202,7441780631.212300,17921605010.460991,46314994546.732493,3101280,593602,2712662,6407544
2020-06-05,FINRA / Nasdaq TRF Carteret (DQ),2708388909,826473685,2147803331,5682665925,83251684615.492314,47089262715.692405,63684381788.118124,194025329119.302843,8514171,1707364,5871983,16093518
2020-06-05,EDGA Equities (J),129900722,47537903,77286988,254725613,5555902154.881001,2677460861.356201,3875545141.789500,12108908158.026702,1633116,304576,956243,2893935
2020-06-05,EDGX Equities (K),529260364,185330011,453018366,1167608741,12607434109.563699,9632249553.470801,10499672995.246900,32739356658.281400,2906775,762480,1995998,5665253
2020-06-05,NYSE Chicago (M),11281821,15020811,6094483,32397115,608271021.321200,2099867284.830000,940977071.714000,3649115377.865200,12050,1951,6609,20610
2020-06-05,NYSE (N),1466412148,69463750,76202879,1612078777,53319917006.595988,4521599525.298202,2878383828.139200,60719900360.033390,5348302,222201,534025,6104528
2020-06-05,NYSE Arca (P),565839279,438462240,525253760,1529555279,16229466897.465302,27122349893.402806,18268350709.841792,61620167500.709900,3936794,1527478,3345518,8809790
2020-06-05,NASDAQ (Q),1143778667,300743241,1520190082,2964711990,43257153461.183903,20625617279.924300,66143349886.485546,130026120627.593749,9541094,1485578,9073425,20100097
2020-06-05,Investors Exchange (V),208815344,31847521,99848753,340511618,8450164024.615401,1939310382.437600,5259882563.201900,15649356970.254901,1392792,142578,747038,2282408
2020-06-05,NASDAQ PSX (X),40683253,28251008,25191336,94125597,1103884796.633600,1991822594.226200,1347208597.571400,4442915988.431200,277518,144725,209286,631529
2020-06-05,BYX Equities (Y),147194309,65134556,88737657,301066522,3600278125.795100,3525730277.328000,2873680021.244100,9999688424.367200,1412640,281330,737946,2431916
2020-06-05,BZX Equities (Z),508405568,225489176,361789412,1095684156,17108168039.700999,14222929798.362801,15296273938.688000,46627371776.751800,4597569,1109952,2763040,8470561
2020-06-04,NYSE American (A),11584304,32022423,6655615,50262342,334859988.067500,344161849.242200,288500687.211300,967522524.521000,161596,97310,99167,358073
2020-06-04,NASDAQ BX (B),60362028,22965322,52954126,136281476,1677000439.331500,1153141806.844600,1369132594.035300,4199274840.211400,632598,113841,396586,1143025
2020-06-04,NYSE National (C),108259007,43364172,41808259,193431438,1959109712.737700,1663356531.868900,973530789.511800,4595997034.118400,890471,221326,409837,1521634
2020-06-04,FINRA / Nasdaq TRF Chicago (DB),13048779,3175631,14724803,30949213,374173784.581400,135874730.408700,557531091.451200,1067579606.441300,43810,8200,50580,102590
2020-06-04,FINRA / NYSE TRF (DN),666432740,205492508,1030208369,1902133617,14917031732.915997,5525147221.219104,18595066455.513297,39037245409.648398,2271781,466150,2823055,5560986
2020-06-04,FINRA / Nasdaq TRF Carteret (DQ),2023158177,710865491,2029690169,4763713837,62914893216.313373,33266678353.591197,57195904362.763981,153377475932.668551,6470713,1352282,5651798,13474793
2020-06-04,EDGA Equities (J),100898573,37571704,67995293,206465570,4276314093.348700,1948177944.756400,3205663689.643500,9430155727.748600,1343249,244147,879580,2466976
2020-06-04,EDGX Equities (K),397462716,153000735,501306515,1051769966,9511216117.196901,6746671495.297798,9269169656.742904,25527057269.237603,2284443,594294,2064337,4943074
2020-06-04,NYSE Chicago (M),18039401,9499864,4072991,31612256,1030193026.314000,1221456784.079999,654264989.033800,2905914799.427799,8091,1618,5693,15402
2020-06-04,NYSE (N),1155475515,50106802,66199725,1271782042,40667631815.365797,2758785341.597500,2297188005.694400,45723605162.657697,4218169,157859,477923,4853951
2020-06-04,NYSE Arca (P),405116379,341487591,511012493,1257616463,12192587583.700204,19075610985.382188,15913960930.951198,47182159500.033590,3104460,1151773,3193285,7449518
2020-06-04,NASDAQ (Q),843298988,231228741,1360743638,2435271367,31274270739.046900,13799726842.736207,53851825813.664161,98925823395.447268,7310948,1123767,8226891,16661606
2020-06-04,Investors Exchange (V),154108055,21971652,89594406,265674113,6257401509.666002,1300603566.848200,4430829327.003700,11988834403.517902,1128882,102846,647880,1879608
2020-06-04,NASDAQ PSX (X),32431091,20543383,22103557,75078031,774557308.157300,1290623704.858700,940237255.225600,3005418268.241600,209295,103631,182038,494964
2020-06-04,BYX Equities (Y),107074660,55181104,78767204,241022968,2559196214.951400,2569105668.877200,2289994800.781499,7418296684.610099,1076493,227444,648034,1951971
2020-06-04,BZX Equities (Z),354548190,173546311,263489692,791584193,11502469590.618101,10031791245.884697,11351063658.641798,32885324495.144596,3400406,812496,2284538,6497440
2020-06-03,NYSE American (A),13512363,28391225,6740578,48644166,379833438.716300,399083228.588700,277615728.187100,1056532395.492100,169619,101407,97712,368738
2020-06-03,NASDAQ BX (B),60398387,28595394,41475563,130469344,1635836197.049400,1277895574.921000,1380626969.922300,4294358741.892700,548936,130541,340727,1020204
2020-06-03,NYSE National (C),101489160,46282242,37903846,185675248,1911619667.183300,1772245249.877900,981591626.855900,4665456543.917100,872790,237898,390800,1501488
2020-06-03,FINRA / Nasdaq TRF Chicago (DB),11567001,2977262,10525401,25069664,335977566.000900,140235129.191500,500304673.801300,976517368.993700,43944,10102,47665,101711
2020-06-03,FINRA / NYSE TRF (DN),569009565,179318032,692110554,1440438151,14896770597.934399,6062935620.982498,16651058326.333596,37610764545.250493,2059451,474235,2296103,4829789
2020-06-03,FINRA / Nasdaq TRF Carteret (DQ),1905076603,695878271,1563752007,4164706881,61452270958.808818,36552530463.511112,56394392654.325994,154399194076.645924,6555918,1419333,5161746,13136997
2020-06-03,EDGA Equities (J),103550383,40235444,62639313,206425140,4509285100.906300,2038818710.686000,3197313982.367500,9745417793.959800,1321128,256378,825788,2403294
2020-06-03,EDGX Equities (K),375091819,152805017,354109390,882006226,9215661326.461099,7683533486.562199,9172993024.196603,26072187837.219901,2177357,631122,1808381,4616860
2020-06-03,NYSE Chicago (M),22910003,18119231,6415239,47444473,3082346003.206100,2786709639.307500,686692411.564000,6555748054.077600,10303,2303,5789,18395
2020-06-03,NYSE (N),1088762998,55241590,58403068,1202407656,39364152031.830801,3378699529.822499,2127540651.989700,44870392213.643000,3786355,170592,408918,4365865
2020-06-03,NYSE Arca (P),378602504,356749181,385787912,1121139597,11628529080.547403,20700217615.823692,14938832924.122800,47267579620.493895,2810221,1228649,2779329,6818199
2020-06-03,NASDAQ (Q),762826510,242302185,1086542945,2091671640,28681523319.044795,14620732576.442002,50444363402.210570,93746619297.697367,6494893,1157641,7078883,14731417
2020-06-03,Investors Exchange (V),148298399,26412081,78273450,252983930,6283760172.108900,1479376950.978100,4275395367.460200,12038532490.547200,1097302,113399,606197,1816898
2020-06-03,NASDAQ PSX (X),31150953,22562177,19782310,73495440,754828995.911700,1471768594.213000,882872552.367800,3109470142.492500,206559,114844,157647,479050
2020-06-03,BYX Equities (Y),101440541,52299551,64411119,218151211,2633579646.925400,2520695450.874600,1995984848.895400,7150259946.695400,1018650,236854,552357,1807861
2020-06-03,BZX Equities (Z),331877100,170204495,210161688,712243283,10887774563.769998,10634112535.394400,10352123298.451002,31874010397.615400,3138266,816484,2038710,5993460
2020-06-02,NYSE American (A),11425204,22621075,6004006,40050285,323544027.299600,318009291.900100,265003892.972900,906557212.172600,148777,82238,86381,317396
2020-06-02,NASDAQ BX (B),51951710,19929585,29621225,101502520,1531591808.097100,1112928507.589400,1316173637.929400,3960693953.615900,531923,104720,291975,928618
2020-06-02,NYSE National (C),93954701,43411047,33941948,171307696,1663777000.716500,1639723660.600100,928298217.976700,4231798879.293300,807538,222732,357999,1388269
2020-06-02,FINRA / Nasdaq TRF Chicago (DB),8542325,2607510,8858418,20008253,255439111.978300,133278997.657400,465723293.079700,854441402.715400,33468,8233,40481,82182
2020-06-02,FINRA / NYSE TRF (DN),470259192,153441499,552532253,1176232944,11954375234.665903,4891952184.661098,15616813241.393694,32463140660.720695,1591387,383578,1834207,3809172
2020-06-02,FINRA / Nasdaq TRF Carteret (DQ),1644449955,581835513,1334892757,3561178225,55753525098.829889,28614763761.658309,53501473947.124417,137869762807.612615,5606222,1297860,4450202,11354284
2020-06-02,EDGA Equities (J),89553696,35901853,52281578,177737127,3908126858.184000,1775488985.149300,3080086169.586200,8763702012.919500,1213422,231818,743720,2188960
2020-06-02,EDGX Equities (K),287663188,134076221,290512523,712251932,7038679949.438800,6423812376.829000,8368199585.180698,21830691911.448498,1854514,556689,1575475,3986678
2020-06-02,NYSE Chicago (M),21806297,8267870,4900252,34974419,3188047425.072701,1363335965.380000,492934137.968600,5044317528.421301,12625,1930,5374,19929
2020-06-02,NYSE (N),1003901132,44752322,49355148,1098008602,37665990635.116896,2541324992.735900,1956620242.628600,42163935870.481396,3500697,139922,370086,4010705
2020-06-02,NYSE Arca (P),309745091,313382155,335683158,958810404,9779552360.059500,17645266245.492896,14971982066.960395,42396800672.512791,2488442,1034621,2544624,6067687
2020-06-02,NASDAQ (Q),670694800,204308506,966910305,1841913611,25860860623.039496,12313621971.948400,50270590734.176952,88445073329.164848,6141314,1031893,6618790,13791997
2020-06-02,Investors Exchange (V),131488005,23926512,66228897,221643414,5488579487.273899,1415072080.068900,3894782950.925799,10798434518.268598,983145,112644,542684,1638473
2020-06-02,NASDAQ PSX (X),26969830,18045092,16346206,61361128,708867708.295300,1120445165.792100,839521876.197900,2668834750.285300,190175,93840,142805,426820
2020-06-02,BYX Equities (Y),90172971,48226390,58247237,196646598,2305931066.915000,2116986065.859600,2043772528.857800,6466689661.632400,952845,208033,512908,1673786
2020-06-02,BZX Equities (Z),284581298,152558536,183771795,620911629,9528357556.648498,9165236653.691497,9853766445.697105,28547360656.037100,2843349,756532,1820387,5420268
2020-06-01,NYSE American (A),11381960,24228360,6559916,42170236,348529300.971900,326653319.314500,280875079.447200,956057699.733600,160003,84499,96953,341455
2020-06-01,NASDAQ BX (B),41631959,17612244,26124745,85368948,1254485414.149200,958147179.096500,1089852708.561700,3302485301.807400,449155,97947,267929,815031
2020-06-01,NYSE National (C),87758841,42445314,35898306,166102461,1584320743.032900,1549889746.554900,925809893.876200,4060020383.464000,763497,214425,372324,1350246
2020-06-01,FINRA / Nasdaq TRF Chicago (DB),7858965,2525077,8599017,18983059,233018755.238100,116584929.035300,527585598.703500,877189282.976900,33722,7720,44758,86200
2020-06-01,FINRA / NYSE TRF (DN),403364981,138913840,516455820,1058734641,9365853988.703899,4554140224.327699,15055341810.076701,28975336023.108299,1565414,378524,1771834,3715772
2020-06-01,FINRA / Nasdaq TRF Carteret (DQ),1446532545,543608017,1287019804,3277160366,44529916650.309688,27713258726.789287,49441201356.552715,121684376733.651690,5523857,1231615,4491460,11246932
2020-06-01,EDGA Equities (J),84950914,32382367,54296159,171629440,3632893112.757600,1524156510.093200,2964004314.848200,8121053937.699000,1156539,211086,758044,2125669
2020-06-01,EDGX Equities (K),264399286,115410638,299757204,679567128,6352231083.272003,5264526769.626998,8209596936.137000,19826354789.036001,1785626,502103,1586439,3874168
2020-06-01,NYSE Chicago (M),21717266,5383608,2920336,30021210,3266863743.825000,859257656.420000,514857608.628300,4640979008.873300,8541,1610,5759,15910
2020-06-01,NYSE (N),903941855,39828647,48012635,991783137,30864005434.780800,2176749125.733400,1859847308.716100,34900601869.230300,3402463,133005,374176,3909644
2020-06-01,NYSE Arca (P),285252426,281588290,303382245,870222961,8522612743.081800,16447907993.338506,12114219098.910598,37084739835.330904,2362260,952855,2386314,5701429
2020-06-01,NASDAQ (Q),637546473,183677088,930399374,1751622935,23731114910.037093,10588500866.947898,44776271745.295321,79095887522.280312,5898559,958872,6292666,13150097
2020-06-01,Investors Exchange (V),114633654,22226657,62553933,199414244,4600947472.969801,1187705753.443100,3575347694.588000,9364000921.000901,875061,101610,519022,1495693
2020-06-01,NASDAQ PSX (X),24478261,16375650,16756399,57610310,590388422.538500,1030205075.203300,773649106.329700,2394242604.071500,173177,81316,135379,389872
2020-06-01,BYX Equities (Y),80649904,44997509,58281093,183928506,2140566114.013400,1967214737.830600,1897630874.465400,6005411726.309400,856709,197423,510233,1564365
2020-06-01,BZX Equities (Z),268072748,132411729,190754764,591239241,8491317796.035898,7151593622.820996,9257909563.098400,24900820981.955294,2817347,668289,1839859,5325495
2020-05-29,NYSE American (A),15969930,32146614,8239308,56355852,469253759.750400,497372760.177800,362766078.482700,1329392598.410900,273009,99505,142543,515057
2020-05-29,NASDAQ BX (B),59720389,24296373,38709574,122726336,1757724247.588000,1484988594.693200,1530705643.605100,4773418485.886300,626304,149078,371778,1147160
2020-05-29,NYSE National (C),122849768,54787466,43075990,220713224,2089947161.262700,2060178706.381400,1156350998.731400,5306476866.375500,1001469,267912,438066,1707447
2020-05-29,FINRA / Nasdaq TRF Chicago (DB),8188538,2823559,8780991,19793088,264816570.619800,144295640.760700,464037094.941800,873149306.322300,31019,8064,36516,75599
2020-05-29,FINRA / NYSE TRF (DN),421121803,164752204,514470307,1100344314,10495661085.817500,5844833724.573601,15697392455.593906,32037887265.985007,1516955,417108,1646419,3580482
2020-05-29,FINRA / Nasdaq TRF Carteret (DQ),1908161603,609015838,1412465144,3929642585,65291497864.158973,33362968375.495188,61362826798.303085,160017293037.957246,6067886,1373366,4460926,11902178
2020-05-29,EDGA Equities (J),113010019,46721879,63170135,222902033,4571797205.784400,2407814014.978300,3600146943.696300,10579758164.459000,1475456,277556,837916,2590928
2020-05-29,EDGX Equities (K),305639028,161719182,268437404,735795614,7466205214.694999,8956587311.597495,9013586225.657099,25436378751.949593,2170490,744543,1634934,4549967
2020-05-29,NYSE Chicago (M),15007523,9162111,3109198,27278832,1570719774.085000,1719957724.270001,379544411.946200,3670221910.301201,13922,1808,6567,22297
2020-05-29,NYSE (N),2408015516,63987613,63165801,2535168930,88517544386.743498,3766371518.412399,2677349867.691000,94961265772.846897,4412919,205847,469362,5088128
2020-05-29,NYSE Arca (P),398187751,408831058,353978485,1160997294,12499147521.793400,25743569066.461900,16970119825.434300,55212836413.689600,3216696,1449073,2831034,7496803
2020-05-29,NASDAQ (Q),763432435,289526426,1528379735,2581338596,28485867428.901689,18261793979.036308,85398858325.387768,132146519733.325765,7157996,1525247,7272818,15956061
2020-05-29,Investors Exchange (V),145285432,26634063,70114190,242033685,5792909505.470302,1596134611.793900,4013486765.581599,11402530882.845801,1080624,119598,569668,1769890
2020-05-29,NASDAQ PSX (X),36277900,25067981,21244617,82590498,915050417.205000,1576267167.774900,1315265318.938900,3806582903.918800,246881,124843,190686,562410
2020-05-29,BYX Equities (Y),115634480,58380016,64016964,238031460,2855400349.053700,2965371679.300800,2470987304.359200,8291759332.713700,1157294,257529,619513,2034336
2020-05-29,BZX Equities (Z),461053096,213290465,280932847,955276408,18071982419.070000,13895626074.508392,17999668686.250401,49967277179.828793,4355346,1053314,2686528,8095188
2020-05-28,NYSE American (A),12895725,22803645,6793288,42492658,392976677.650000,425375846.141900,356672939.369500,1175025463.161400,188310,86073,112380,386763
2020-05-28,NASDAQ BX (B),51499586,21236577,32527569,105263732,1638760401.604500,1248643207.952400,1385211385.183600,4272614994.740500,572253,121778,327423,1021454
2020-05-28,NYSE National (C),99518901,49734330,41092271,190345502,1867234954.755000,1781090389.626500,1105666649.747900,4753991994.129400,844813,234198,403523,1482534
2020-05-28,FINRA / Nasdaq TRF Chicago (DB),8967215,2941749,8102214,20011178,285621714.577600,157113127.462200,491182229.853500,933917071.893300,36002,8351,39170,83523
2020-05-28,FINRA / NYSE TRF (DN),480083247,168326380,567996210,1216405837,11158965995.529295,5779147298.629605,15803510959.800298,32741624253.959198,1770682,421067,1821118,4012867
2020-05-28,FINRA / Nasdaq TRF Carteret (DQ),1643513182,587105572,1333622344,3564241098,54587088287.241885,30732797598.978389,53592429198.967619,138912315085.187893,5950063,1301119,4478247,11729429
2020-05-28,EDGA Equities (J),100277274,38204453,60270753,198752480,4226883657.407900,1869898622.104200,3277918467.050600,9374700746.562700,1287009,233874,777315,2298198
2020-05-28,EDGX Equities (K),296928459,140733926,295443020,733105405,7327241606.030097,7471017769.233703,8217109113.994297,23015368489.258097,1972315,613517,1573822,4159654
2020-05-28,NYSE Chicago (M),12608873,11434810,5401696,29445379,1243720032.792800,1388966629.414400,561611877.811300,3194298540.018500,7363,2308,6252,15923
2020-05-28,NYSE (N),1035666421,51340328,54279382,1141286131,38912024274.447590,2911592496.226200,2384690166.036400,44208306936.710190,3913841,159552,388198,4461591
2020-05-28,NYSE Arca (P),369051504,328793621,349425880,1047271005,11781304909.329801,19829434808.529893,15295360509.120201,46906100226.979895,2889467,1173674,2592155,6655296
2020-05-28,NASDAQ (Q),665322498,241093019,940852050,1847267567,25023342200.988589,14698657454.705700,50896664561.741902,90618664217.436191,6253704,1207386,6741421,14202511
2020-05-28,Investors Exchange (V),140264739,25684021,72344935,238293695,5962053006.595100,1457007583.791500,4267450538.639199,11686511129.025799,1020109,116004,569970,1706083
2020-05-28,NASDAQ PSX (X),29721279,21399153,18429587,69550019,721823510.129400,1270958586.661100,959034523.864700,2951816620.655200,202671,101992,157381,462044
2020-05-28,BYX Equities (Y),99276205,54645244,72967309,226888758,2562431823.037500,2390432486.461200,2281761612.839900,7234625922.338600,1011422,212263,580020,1803705
2020-05-28,BZX Equities (Z),401428799,175544419,254115749,831088967,15594079871.166296,10898714470.875500,15466053030.239699,41958847372.281495,3767839,833579,2409964,7011382
2020-05-27,NYSE American (A),14677040,29231988,7489803,51398831,500492844.907100,402489371.344400,425926245.747200,1328908461.998700,305616,101324,151898,558838
2020-05-27,NASDAQ BX (B),60148434,25465107,35967592,121581133,1801419249.416700,1461378172.818700,1617599785.475700,4880397207.711100,627393,147558,374101,1149052
2020-05-27,NYSE National (C),113546762,51317128,40953245,205817135,2108287616.485500,1844096457.480100,1192171072.769200,5144555146.734800,1067234,246479,447068,1760781
2020-05-27,FINRA / Nasdaq TRF Chicago (DB),11324196,2703336,9220773,23248305,325203624.510000,106908911.776600,568965279.587000,1001077815.873600,43016,8651,48066,99733
2020-05-27,FINRA / NYSE TRF (DN),586767144,186478000,607431273,1380676417,12237999300.967199,6194047152.410509,18748003873.232284,37180050326.609992,2025598,452861,2058550,4537009
2020-05-27,FINRA / Nasdaq TRF Carteret (DQ),1957248599,680714572,1460405254,4098368425,62807224863.035520,34383249556.985017,63020823765.688505,160211298185.709042,6779991,1394897,5044805,13219693
2020-05-27,EDGA Equities (J),110416188,43257070,64824614,218497872,4661013054.960800,2020853664.157200,3692890138.041999,10374756857.159999,1411740,254626,866183,2532549
2020-05-27,EDGX Equities (K),351759767,191937959,312927404,856625130,8198830597.823601,8579554180.763302,10229003084.320400,27007387862.907303,2223414,747706,1800826,4771946
2020-05-27,NYSE Chicago (M),14406411,10389934,6961005,31757350,1266926596.581100,1329285451.600000,1251311462.286501,3847523510.467601,5470,2175,5126,12771
2020-05-27,NYSE (N),1134875312,61352458,61899978,1258127748,40959145435.754996,3476376686.693300,2618071207.984900,47053593330.433196,4399549,187983,436335,5023867
2020-05-27,NYSE Arca (P),459360591,418734140,390436023,1268530754,14227550115.031196,21910714982.565700,19101907354.307493,55240172451.904389,3544231,1371711,3066083,7982025
2020-05-27,NASDAQ (Q),784490564,298941840,1019720708,2103153112,28168186376.396301,16410096762.438101,55419674299.127724,99997957437.962126,7066580,1382873,7659882,16109335
2020-05-27,Investors Exchange (V),166943004,24445780,84182330,275571114,7196426926.890899,1495519850.634500,5544966171.448299,14236912948.973698,1158185,107947,629163,1895295
2020-05-27,NASDAQ PSX (X),35308621,25307028,20597812,81213461,813697204.411200,1449670617.494400,1127312102.631800,3390679924.537400,231811,130842,189942,552595
2020-05-27,BYX Equities (Y),113889733,50788908,63941265,228619906,2910328777.644300,2619727924.214600,2675045905.137700,8205102606.996600,1160247,237778,638723,2036748
2020-05-27,BZX Equities (Z),482841193,208432392,302151734,993425319,18456459156.263102,12422987092.352899,18930218302.289805,49809664550.905806,4423139,981539,2866914,8271592
2020-05-26,NYSE American (A),13126255,25205863,8042250,46374368,384680759.764100,374431098.319500,343005040.959300,1102116899.042900,192307,92396,125062,409765
2020-05-26,NASDAQ BX (B),55290724,23337866,30526409,109154999,1564605763.845000,1349158636.616200,1289745939.047200,4203510339.508400,555995,126991,301045,984031
2020-05-26,NYSE National (C),112350509,55757273,42423467,210531249,2039128574.621300,2047588454.853100,1062877077.051600,5149594106.526000,924184,251968,419082,1595234
2020-05-26,FINRA / Nasdaq TRF Chicago (DB),10444181,2773471,10578668,23796320,339962456.127500,135526289.468000,543518198.942400,1019006944.537900,43181,9718,49337,102236
2020-05-26,FINRA / NYSE TRF (DN),490459452,146085769,626655792,1263201013,11764401636.566301,5280805573.227498,16427596601.569600,33472803811.363399,1998816,449073,2091186,4539075
2020-05-26,FINRA / Nasdaq TRF Carteret (DQ),1805721454,611983730,1435592965,3853298149,58772629539.829401,37340076105.076697,54607235927.112517,150719941572.018615,6456052,1361496,4827674,12645222
2020-05-26,EDGA Equities (J),97832837,35735181,61838036,195406054,4273577982.584700,1871176676.839900,3293324665.614000,9438079325.038600,1285697,226107,816908,2328712
2020-05-26,EDGX Equities (K),322712633,138441762,334610154,795764549,8235951835.115003,6769220923.090495,8998070064.416900,24003242822.622398,2124613,593404,1706933,4424950
2020-05-26,NYSE Chicago (M),10603592,11430820,3128096,25162508,748440257.243800,1576726715.245000,418542816.429300,2743709788.918100,7159,2559,6370,16088
2020-05-26,NYSE (N),1142480815,55188055,63321724,1260990594,43518753536.160500,2955911663.003200,3316860647.007699,49791525846.171399,3838232,154159,477048,4469439
2020-05-26,NYSE Arca (P),417113892,365920054,380803711,1163837657,12960030139.071692,20891756866.919704,16256205021.767300,50107992027.758696,3041514,1192712,2744688,6978914
2020-05-26,NASDAQ (Q),696625614,235462093,1024145675,1956233382,25366673386.077209,13981535753.864397,52932120776.443580,92280329916.385186,6244903,1136456,6744322,14125681
2020-05-26,Investors Exchange (V),147733665,25838257,77381412,250953334,6321320316.442399,1410291273.414500,4531111454.430198,12262723044.287097,1087051,112889,608691,1808631
2020-05-26,NASDAQ PSX (X),32130853,24011136,19678742,75820731,784975205.319800,1477780605.554600,912690582.517800,3175446393.392200,209538,114315,165627,489480
2020-05-26,BYX Equities (Y),97437157,50085868,67070076,214593101,2493045739.580600,2496610474.628301,2259273216.619900,7248929430.828801,999810,218774,573551,1792135
2020-05-26,BZX Equities (Z),396444692,158563492,263153008,818161192,15375082723.524393,9609414218.352998,15041291554.785004,40025788496.662395,3683713,766744,2396753,6847210
2020-05-22,NYSE American (A),8647304,22170036,5874382,36691722,259898713.200000,279726835.763600,225152518.045700,764778067.009300,135533,82191,87301,305025
2020-05-22,NASDAQ BX (B),36323453,14915316,26702166,77940935,1170795878.806700,843794002.235000,1087257454.618400,3101847335.660100,415190,95141,242199,752530
2020-05-22,NYSE National (C),74449015,35015619,30444630,139909264,1287694806.498000,1302574962.390600,798806610.162500,3389076379.051100,661937,189500,313872,1165309
2020-05-22,FINRA / Nasdaq TRF Chicago (DB),7229948,1954464,8658810,17843222,249389771.039500,95289356.133900,470401177.936600,815080305.110000,31877,6130,38025,76032
2020-05-22,FINRA / NYSE TRF (DN),353846664,136376389,583441839,1073664892,8718144038.565500,4160099404.801599,14847427042.165002,27725670485.532101,1395422,369929,1628203,3393554
2020-05-22,FINRA / Nasdaq TRF Carteret (DQ),1241927451,419304784,1196809716,2858041951,40897415135.520917,21753657359.578692,43732132138.260001,106383204633.359610,4698460,1086242,3752399,9537101
2020-05-22,EDGA Equities (J),69087652,25929499,47748061,142765212,3083281959.990900,1292560809.452400,2482735862.956700,6858578632.400000,925142,178664,614318,1718124
2020-05-22,EDGX Equities (K),212492471,114557917,287931803,614982191,5270993321.636599,4788017734.547401,6973351121.494502,17032362177.678502,1504545,485083,1311496,3301124
2020-05-22,NYSE Chicago (M),7096851,8057534,3649801,18804186,275012771.013100,1082864861.154000,437814685.920000,1795692318.087100,5607,1603,4722,11932
2020-05-22,NYSE (N),719693248,39184450,46609320,805487018,26110927361.875698,2002997975.604800,1845007396.243900,29958932733.724398,2837646,118751,316647,3273044
2020-05-22,NYSE Arca (P),274126384,253935348,307954831,836016563,9147361810.477800,13694594482.898396,11965215714.476096,34807172007.852292,2194948,889065,2129027,5213040
2020-05-22,NASDAQ (Q),492000636,173538844,791672973,1457212453,18708843120.469894,9569778950.573494,36694681502.841005,64973303573.884393,4676021,889605,5120465,10686091
2020-05-22,Investors Exchange (V),99124360,15010443,55644546,169779349,4242464197.129600,855860484.909700,3074605387.825099,8172930069.864399,780529,78189,446161,1304879
2020-05-22,NASDAQ PSX (X),20690555,16131874,15016120,51838549,507766990.871200,987718347.363700,822753255.958900,2318238594.193800,147948,88525,127416,363889
2020-05-22,BYX Equities (Y),67458724,32713190,49877807,150049721,1761752154.734800,1640281144.716800,1638346833.055500,5040380132.507100,724258,160845,429805,1314908
2020-05-22,BZX Equities (Z),286665365,120025326,210033468,616724159,10953497024.046805,6802342135.233501,11670306408.835997,29426145568.116303,2715314,602225,1795256,5112795
2020-05-21,NYSE American (A),10829545,25709287,6871075,43409907,323513647.428700,486395767.578200,324767550.220000,1134676965.226900,172409,93840,116429,382678
2020-05-21,NASDAQ BX (B),45098741,19632565,28315898,93047204,1400357724.597300,1097883795.376400,1336658516.391400,3834900036.365100,513299,119624,287336,920259
2020-05-21,NYSE National (C),95145648,44396229,34744947,174286824,1613785342.130500,1599470680.470900,922127326.112300,4135383348.713700,787523,227813,355253,1370589
2020-05-21,FINRA / Nasdaq TRF Chicago (DB),8969480,2854232,8059950,19883662,323573518.585000,138765723.158600,515569792.273600,977909034.017200,36684,8524,39092,84300
2020-05-21,FINRA / NYSE TRF (DN),427185711,155689393,539022089,1121897193,10972807455.010993,5470200506.145799,17220252579.350996,33663260540.507788,1636189,421501,1743045,3800735
2020-05-21,FINRA / Nasdaq TRF Carteret (DQ),1588793071,506733390,1238201674,3333728135,54106415541.306602,24956827168.000993,51922614151.627324,130985856860.934919,5494096,1226025,4152673,10872794
2020-05-21,EDGA Equities (J),83491087,34652997,49338913,167482997,3463802221.160200,1671303499.599600,2799937012.024300,7935042732.784100,1093442,226875,665580,1985897
2020-05-21,EDGX Equities (K),251568323,135644770,268706949,655920042,6292321740.552899,6401768396.685901,8611849819.832697,21305939957.071497,1738593,579137,1430314,3748044
2020-05-21,NYSE Chicago (M),8671942,11577978,6684126,26934046,658269872.207100,1220510209.463500,1034930027.415000,2913710109.085600,6503,3436,6341,16280
2020-05-21,NYSE (N),975905779,50561800,49022410,1075489989,34833899740.475202,2584280929.678700,2106829927.762800,39525010597.916702,3343532,152193,346477,3842202
2020-05-21,NYSE Arca (P),325247520,322592353,310483509,958323382,10282871691.641896,17592060176.029600,14626671921.472605,42501603789.144101,2517155,1133469,2299225,5949849
2020-05-21,NASDAQ (Q),573696025,223372316,842384727,1639453068,20424765411.775693,12342973619.347797,44874461603.986676,77642200635.110166,5396468,1161676,5720675,12278819
2020-05-21,Investors Exchange (V),125714902,16906621,64327998,206949521,5124233981.970101,1061127225.357300,3608865456.061001,9794226663.388402,914654,86802,504639,1506095
2020-05-21,NASDAQ PSX (X),26229494,20014605,17512042,63756141,612854398.524400,1199038769.401200,1006279402.973500,2818172570.899100,181610,106171,146482,434263
2020-05-21,BYX Equities (Y),84481335,40276088,56345755,181103178,2096056578.244700,2130482539.421000,2016014742.384600,6242553860.050300,862887,203210,474700,1540797
2020-05-21,BZX Equities (Z),345596749,156473743,225255659,727326151,13110099505.998101,8731820560.293095,14444809385.340400,36286729451.631596,3176218,771534,2017790,5965542
2020-05-20,NYSE American (A),11069547,24363280,7885715,43318542,345357362.081200,345426501.995800,392548321.509500,1083332185.586500,202014,85862,138708,426584
2020-05-20,NASDAQ BX (B),48021007,19814147,36295714,104130868,1561673018.528900,1075910542.147800,1307112245.871300,3944695806.548000,558367,120991,329075,1008433
2020-05-20,NYSE National (C),96447890,46722164,39531593,182701647,1655386064.415800,1670263897.468900,968847208.579900,4294497170.464600,843348,237400,401341,1482089
2020-05-20,FINRA / Nasdaq TRF Chicago (DB),8584151,2850072,8485545,19919768,300718280.217500,136735688.377700,508304734.366400,945758702.961600,36329,8551,42818,87698
2020-05-20,FINRA / NYSE TRF (DN),435462313,151188341,603161655,1189812309,10952025606.061802,5402195487.808101,17199628399.063000,33553849492.932903,1618955,419073,1880327,3918355
2020-05-20,FINRA / Nasdaq TRF Carteret (DQ),1615355975,547027696,1398423526,3560807197,54703219240.119981,30525968404.956691,55623543501.613828,140852731146.690500,5585842,1207315,4590140,11383297
2020-05-20,EDGA Equities (J),83281504,34207427,58094149,175583080,3522601566.948700,1678479254.628500,2922517742.338000,8123598563.915200,1095713,233682,740863,2070258
2020-05-20,EDGX Equities (K),260817807,128611688,324323607,713753102,6266784597.754400,6351138482.096898,8348400767.544797,20966323847.396095,1742360,550906,1626166,3919432
2020-05-20,NYSE Chicago (M),10306120,11125643,7048499,28480262,657822581.976500,1351513041.448600,887053293.774100,2896388917.199200,5805,1839,5965,13609
2020-05-20,NYSE (N),921029155,45563185,55563040,1022155380,32505103934.804198,2322202119.950300,2208156544.976400,37035462599.730898,3372565,141631,389610,3903806
2020-05-20,NYSE Arca (P),337468180,301746305,378022795,1017237280,10727678500.249297,17273640617.894295,14605945290.887188,42607264409.030780,2637237,1091951,2575504,6304692
2020-05-20,NASDAQ (Q),587064342,201124425,990594032,1778782799,21344638509.280400,11673984006.730503,46428860992.699014,79447483508.709917,5533932,1083932,6364673,12982537
2020-05-20,Investors Exchange (V),128398984,19289817,74321965,222010766,5435177211.731600,1129957951.867900,4170589308.995200,10735724472.594700,1001580,91597,611456,1704633
2020-05-20,NASDAQ PSX (X),26252694,17539175,18143862,61935731,625673877.819500,999390403.885600,933962395.756100,2559026677.461200,186096,93135,159809,439040
2020-05-20,BYX Equities (Y),80521300,40293684,60925969,181740953,2073985063.517600,1907477871.322000,1923980494.004500,5905443428.844100,862873,188970,514253,1566096
2020-05-20,BZX Equities (Z),355304176,143411445,254681557,753397178,13278049738.934801,8570925584.340297,14074843935.745296,35923819259.020394,3244762,732589,2257625,6234976
2020-05-19,NYSE American (A),12057291,26034907,7261361,45353559,378111943.558300,321518048.019300,331960585.727400,1031590577.305000,209782,91949,135112,436843
2020-05-19,NASDAQ BX (B),47098229,21968054,30922203,99988486,1484841058.053900,1262164408.653900,1253421822.466500,4000427289.174300,557650,132667,309351,999668
2020-05-19,NYSE National (C),101713110,43365880,40193271,185272261,1690002073.162700,1574314259.881100,973625265.372700,4237941598.416500,859867,229755,397402,1487024
2020-05-19,FINRA / Nasdaq TRF Chicago (DB),8855073,2564754,8289011,19708838,298341029.312000,112873970.352600,482709953.523800,893924953.188400,33655,8085,39169,80909
2020-05-19,FINRA / NYSE TRF (DN),444204460,154085774,594290489,1192580723,11059265121.878299,5204815485.453204,16700382727.396500,32964463334.728003,1707613,453177,1853375,4014165
2020-05-19,FINRA / Nasdaq TRF Carteret (DQ),1550118512,515249427,1405692731,3471060670,48845735151.193397,28436001184.610402,52351477416.583418,129633213752.387217,5599467,1241318,4485140,11325925
2020-05-19,EDGA Equities (J),87350734,38804805,58031594,184187133,3629918477.118300,1804145638.027600,3114761069.764600,8548825184.910500,1174818,254302,765944,2195064
2020-05-19,EDGX Equities (K),268062100,141260889,311090990,720413979,6407288193.126502,6889923374.778899,8402396826.724895,21699608394.630296,1835766,598122,1585191,4019079
2020-05-19,NYSE Chicago (M),11972506,8395696,6646983,27015185,866383431.986000,986195958.593000,876823366.304400,2729402756.883400,6136,2475,5315,13926
2020-05-19,NYSE (N),875117640,46865961,52148990,974132591,30232445488.885506,2546970903.070700,2098465756.725700,34877882148.681906,3689271,147829,379102,4216202
2020-05-19,NYSE Arca (P),332543884,310782708,347198267,990524859,10690129952.423900,18140160252.428514,14474990608.835510,43305280813.687924,2704167,1123255,2507501,6334923
2020-05-19,NASDAQ (Q),615854436,210448604,922251368,1748554408,21571136582.233299,12399144297.253798,44228727418.717418,78199008298.204515,5865654,1141634,6455170,13462458
2020-05-19,Investors Exchange (V),129325331,19618669,70444833,219388833,5245725568.071400,1201667650.373900,3965168348.064400,10412561566.509700,959012,97975,559499,1616486
2020-05-19,NASDAQ PSX (X),26687721,18224529,17619348,62531598,665970054.533900,1048017135.568100,870078397.058100,2584065587.160100,192258,96521,157067,445846
2020-05-19,BYX Equities (Y),90877126,43355849,62552312,196785287,2322329673.466600,2270668427.954300,2114490033.245900,6707488134.666800,969215,215365,539764,1724344
2020-05-19,BZX Equities (Z),382493579,155680386,258925931,797099896,14369695990.864497,9700088813.889302,14368340407.898202,38438125212.652001,3510132,785641,2300959,6596732
2020-05-18,NYSE American (A),14354533,32180353,7537688,54072574,429544994.182900,427354378.108300,354865021.936100,1211764394.227300,213336,111545,126745,451626
2020-05-18,NASDAQ BX (B),59407283,26578441,32925738,118911462,1714381718.197600,1450265259.086600,1361211976.023800,4525858953.308000,603891,142240,318050,1064181
2020-05-18,NYSE National (C),107309582,53059262,41258983,201627827,1835017269.709500,1936762192.642200,1034904607.698200,4806684070.049900,906194,264613,421132,1591939
2020-05-18,FINRA / Nasdaq TRF Chicago (DB),11444056,3854644,8676627,23975327,319775209.264700,161246860.130700,529181498.863500,1010203568.258900,46869,13156,48574,108599
2020-05-18,FINRA / NYSE TRF (DN),579940100,201152684,588086762,1369179546,12224958584.111698,6382696634.180800,17808282788.567599,36415938006.860097,2268600,637347,2065794,4971741
2020-05-18,FINRA / Nasdaq TRF Carteret (DQ),2016689144,679723319,1432843303,4129255766,61599578514.052782,37098501648.457706,57940715474.853273,156638795637.363761,6790829,1541100,4886936,13218865
2020-05-18,EDGA Equities (J),101141405,42129533,60713856,203984794,4177448891.763400,2168060486.040600,3382845987.478100,9728355365.282100,1293250,279208,827229,2399687
2020-05-18,EDGX Equities (K),357040908,168033836,300064995,825139739,7849602323.223700,8415618401.199994,9481068771.385203,25746289495.808897,2192618,730746,1707233,4630597
2020-05-18,NYSE Chicago (M),9987755,10291339,5066607,25345701,590663446.819300,1433946874.419600,823537776.818600,2848148098.057500,6922,3832,6125,16879
2020-05-18,NYSE (N),1198530156,53232606,55162824,1306925586,42644018439.455097,2941603741.658100,2191764093.771700,47777386274.884897,4098628,165184,399362,4663174
2020-05-18,NYSE Arca (P),427550944,381352166,348531187,1157434297,12555523794.651797,22704123309.383901,16242470373.657805,51502117477.693503,3074825,1358908,2674705,7108438
2020-05-18,NASDAQ (Q),743912254,254377518,1026002259,2024292031,25017028018.680413,15336816741.843801,53025896238.986889,93379740999.511103,6633137,1338679,7078244,15050060
2020-05-18,Investors Exchange (V),156819556,23973108,77716466,258509130,6334443058.955402,1364636090.444000,4550780103.260699,12249859252.660101,1122696,118203,608202,1849101
2020-05-18,NASDAQ PSX (X),35624090,22314445,19545087,77483622,755576472.556000,1476169323.842900,961761730.939900,3193507527.338800,232846,117615,164549,515010
2020-05-18,BYX Equities (Y),110211299,53306684,63619349,227137332,2712730679.433100,2574101966.192500,2333287627.803500,7620120273.429100,1084061,235005,577373,1896439
2020-05-18,BZX Equities (Z),443707859,174051843,274070139,891829841,15929227472.440802,10917407764.009401,15622819911.070698,42469455147.520901,3957238,869112,2614481,7440831
2020-05-15,NYSE American (A),11177193,28214089,7536291,46927573,325431498.062300,415590390.317100,322440767.199800,1063462655.579200,175759,98241,110863,384863
2020-05-15,NASDAQ BX (B),47620815,23336863,32149788,103107466,1467331314.525900,1239857757.004000,1246399207.401500,3953588278.931400,514219,161461,305032,980712
2020-05-15,NYSE National (C),88829407,49582535,36165964,174577906,1382967103.829500,1796997598.284700,883964756.270000,4063929458.384200,765303,234809,365423,1365535
2020-05-15,FINRA / Nasdaq TRF Chicago (DB),7754711,2986566,8061635,18802912,221315365.096600,140676673.885900,489096226.726700,851088265.709200,29890,12228,38735,80853
2020-05-15,FINRA / NYSE TRF (DN),447531666,170207273,553263440,1171002379,8423667795.325600,6310866768.878906,16842056708.315688,31576591272.520194,1473237,461677,1690504,3625418
2020-05-15,FINRA / Nasdaq TRF Carteret (DQ),1577905415,572099230,1331250675,3481255320,49579464607.266882,31224716666.743805,53373710907.568807,134177892181.579494,5381810,1266340,4395546,11043696
2020-05-15,EDGA Equities (J),89812323,33551969,58271009,181635301,3886733785.116800,1672558069.546100,3411219106.629100,8970510961.292000,1175075,200976,740506,2116557
2020-05-15,EDGX Equities (K),281121511,153102305,302989199,737213015,6034400139.164002,7918891065.034099,8936595493.816005,22889886698.014106,1766994,688022,1549742,4004758
2020-05-15,NYSE Chicago (M),7800068,19231725,6991743,34023536,333318706.781200,2759195443.471199,957908639.822000,4050422790.074399,5674,2501,4893,13068
2020-05-15,NYSE (N),1378487999,53873590,52962192,1485323781,60968282869.561792,2823376761.765800,2118244071.362100,65909903702.689692,3583748,170615,401585,4155948
2020-05-15,NYSE Arca (P),333117790,340525046,332974236,1006617072,10193092614.818496,19374455709.664800,15249589301.862794,44817137626.346090,2551322,1232470,2453273,6237065
2020-05-15,NASDAQ (Q),623889550,237467336,1085588729,1946945615,23045105782.367900,13692764544.072303,56023666907.095607,92761537233.535810,6031412,1276015,6272108,13579535
2020-05-15,Investors Exchange (V),136093091,21511413,69937179,227541683,5567465687.709401,1413839539.942500,4076388622.633501,11057693850.285402,963275,107935,544495,1615705
2020-05-15,NASDAQ PSX (X),28024672,22305680,19744484,70074836,678429572.321200,1360371625.839500,1139697168.162300,3178498366.323000,207279,117738,172179,497196
2020-05-15,BYX Equities (Y),86850756,49479951,62412541,198743248,2353834523.579800,2280341672.825700,2233902846.875800,6868079043.281300,943866,228185,537054,1709105
2020-05-15,BZX Equities (Z),361685478,167907298,280392687,809985463,14400794707.333301,10622091564.791296,15942364948.383803,40965251220.508400,3324666,844789,2306463,6475918
2020-05-14,NYSE American (A),13346812,32845359,7840704,54032875,358438066.239500,434326390.322400,287685951.765800,1080450408.327700,206082,124650,121440,452172
2020-05-14,NASDAQ BX (B),54627027,29058034,31057038,114742099,1596349917.058800,1542627287.893400,1294704624.451700,4433681829.403900,593010,196518,335499,1125027
2020-05-14,NYSE National (C),104514501,56014132,42485578,203014211,1527205136.285600,1921789833.753300,945509230.434500,4394504200.473400,855704,254226,384467,1494397
2020-05-14,FINRA / Nasdaq TRF Chicago (DB),10765278,4762441,9445075,24972794,322806556.661300,240150818.503100,533420073.452000,1096377448.616400,40605,18094,42165,100864
2020-05-14,FINRA / NYSE TRF (DN),452154321,217445741,514907819,1184507881,9720094503.736297,7403851762.092203,17109756206.068695,34233702471.897195,1677020,605478,1653669,3936167
2020-05-14,FINRA / Nasdaq TRF Carteret (DQ),1654964297,704446830,1223638468,3583049595,51511034803.466410,33133495871.106506,51759133199.354919,136403663873.927835,6177279,1583751,4442635,12203665
2020-05-14,EDGA Equities (J),107385696,40894908,60638584,208919188,4154700996.796000,1933348061.003000,3378426781.928599,9466475839.727599,1368723,236027,809660,2414410
2020-05-14,EDGX Equities (K),301264259,196758328,304052569,802075156,6660121525.400004,10013724394.466402,8415401339.932100,25089247259.798506,2092906,880977,1607632,4581515
2020-05-14,NYSE Chicago (M),9265138,9737703,7910971,26913812,523252484.663800,1025627380.993700,633329749.200400,2182209614.857900,6377,3903,5269,15549
2020-05-14,NYSE (N),1063996872,66466281,58065714,1188528867,35719528693.699592,3545225334.719399,2226565313.218500,41491319341.637491,4474294,205622,419441,5099357
2020-05-14,NYSE Arca (P),391444048,424566187,331017143,1147027378,11706084781.638898,24716068009.205306,14630968328.068489,51053121118.912693,3124452,1580930,2607185,7312567
2020-05-14,NASDAQ (Q),754449468,298573215,956478998,2009501681,25369813683.527910,17667282848.707797,49378573165.693200,92415669697.928907,7151427,1638137,7141349,15930913
2020-05-14,Investors Exchange (V),159151651,26482697,76830365,262464713,5777675854.351400,1502222212.483000,3760603758.053799,11040501824.888199,1091657,119065,588094,1798816
2020-05-14,NASDAQ PSX (X),32116972,26293367,19854841,78265180,687302676.186200,1490773159.839800,1057758499.841800,3235834335.867800,218017,141107,171237,530361
2020-05-14,BYX Equities (Y),103511106,60103677,57591803,221206586,2528541471.798100,2960533709.201300,2176682843.121400,7665758024.120800,1094219,281854,568791,1944864
2020-05-14,BZX Equities (Z),438173468,212655555,264157542,914986565,16031953521.844398,13438294609.541200,15865081095.316607,45335329226.702205,4077564,1094667,2568701,7740932
2020-05-13,NYSE American (A),13448803,31603273,8311244,53363320,403996902.004300,528394875.958500,351494997.304800,1283886775.267600,213323,120022,133049,466394
2020-05-13,NASDAQ BX (B),57156702,25855213,37714951,120726866,1532731725.921100,1396771603.041400,1485958450.477600,4415461779.440100,550863,173913,334177,1058953
2020-05-13,NYSE National (C),110255598,53780839,42406948,206443385,1657564041.683500,1924829056.848100,1068963983.981700,4651357082.513300,924508,251991,416807,1593306
2020-05-13,FINRA / Nasdaq TRF Chicago (DB),10431697,3721351,9829816,23982864,320112005.605700,216072254.774200,720495524.559900,1256679784.939800,41915,16658,51271,109844
2020-05-13,FINRA / NYSE TRF (DN),509841931,204412876,547562715,1261817522,10028880128.671602,7292257225.878003,20933351238.597210,38254488593.146815,2053630,570057,1969344,4593031
2020-05-13,FINRA / Nasdaq TRF Carteret (DQ),1844808960,693851610,1341982294,3880642864,54203160414.979579,38247048549.724806,61315198707.261005,153765407671.965390,6880759,1638408,5065736,13584903
2020-05-13,EDGA Equities (J),114598407,38666348,66623708,219888463,4465087509.949000,2053429524.379300,4089085543.736900,10607602578.065200,1480805,238518,904507,2623830
2020-05-13,EDGX Equities (K),361237870,184460811,313348520,859047201,7358689429.027603,9517012930.349397,10322638953.557899,27198341312.934899,2330664,859652,1774510,4964826
2020-05-13,NYSE Chicago (M),11486673,8982825,5137386,25606884,490536405.782000,724820956.234700,607496031.371800,1822853393.388500,8511,3064,6287,17862
2020-05-13,NYSE (N),1123812256,66533001,63514551,1253859808,38513984783.353990,3714025563.364099,2738173076.260600,44966183422.978689,4558843,209616,456053,5224512
2020-05-13,NYSE Arca (P),432502607,402344018,352469617,1187316242,12576652566.191702,24258854817.254795,17553072795.085300,54388580178.531797,3259733,1570030,2889117,7718880
2020-05-13,NASDAQ (Q),789285142,294712775,1034565318,2118563235,26412329915.592106,18060542950.915205,55410642139.196309,99883515005.703620,7279558,1613218,7824881,16717657
2020-05-13,Investors Exchange (V),177925731,24735137,79976939,282637807,6177284873.067701,1667143157.610900,4269538750.917602,12113966781.596203,1195414,124012,624009,1943435
2020-05-13,NASDAQ PSX (X),34351906,25507795,24006509,83866210,791680784.928500,1556271657.407799,1379519824.966400,3727472267.302699,246658,131165,210178,588001
2020-05-13,BYX Equities (Y),107773617,53105231,61356565,222235413,2598960619.411200,2843499966.730800,2436790901.239499,7879251487.381499,1139307,264759,601407,2005473
2020-05-13,BZX Equities (Z),452742085,206769528,284411006,943922619,16753565306.027201,13402189815.798497,18368534238.773402,48524289360.599100,4085505,1072427,2672991,7830923
2020-05-12,NYSE American (A),10843515,28861870,6777227,46482612,311014375.880100,365915220.914700,294330468.597800,971260065.392600,184009,101772,110789,396570
2020-05-12,NASDAQ BX (B),50263586,22351124,37734141,110348851,1445846941.005000,1172253437.778701,1304120703.932900,3922221082.716601,484235,118445,311635,914315
2020-05-12,NYSE National (C),91400547,40979814,38310677,170691038,1437856200.084100,1557284513.569300,933412684.654200,3928553398.307600,780691,201078,376206,1357975
2020-05-12,FINRA / Nasdaq TRF Chicago (DB),8620909,3099528,9619611,21340048,297033043.097100,158652469.887300,603197252.639800,1058882765.624200,38206,14430,50924,103560
2020-05-12,FINRA / NYSE TRF (DN),419041981,182050073,602756567,1203848621,9499539742.182506,5622433427.720501,17238840853.874807,32360814023.777814,1642585,471848,1942298,4056731
2020-05-12,FINRA / Nasdaq TRF Carteret (DQ),1688863308,745413774,1429343112,3863620194,51247921503.288469,38096195197.177698,55751807482.002586,145095924182.468753,5821789,1288565,4741226,11851580
2020-05-12,EDGA Equities (J),89435635,29837326,63677737,182950698,3696320962.826400,1629596783.257800,3322500567.254101,8648418313.338301,1200366,184143,811282,2195791
2020-05-12,EDGX Equities (K),276699839,148925326,331673454,757298619,6461067436.584298,7352607071.940502,8820788031.414299,22634462539.939099,1906276,640119,1663126,4209521
2020-05-12,NYSE Chicago (M),10288523,23697072,3988857,37974452,507290395.500400,1919307273.084100,383917959.108000,2810515627.692500,6733,1996,5450,14179
2020-05-12,NYSE (N),939508509,49232888,57824345,1046565742,33390318057.810902,2868883116.006600,2208845488.524800,38468046662.342302,3823565,153519,414360,4391444
2020-05-12,NYSE Arca (P),322292433,330827506,347156148,1000276087,10110440557.346898,19241340303.900894,14442127911.761704,43793908773.009496,2551132,1175815,2584577,6311524
2020-05-12,NASDAQ (Q),608408799,230044397,982422750,1820875946,21520431370.142398,14472086672.772500,47177156404.218094,83169674447.132992,5852990,1154452,6862603,13870045
2020-05-12,Investors Exchange (V),146506478,20439500,77512711,244458689,5525075077.458401,1219335331.746900,4115585997.115801,10859996406.321102,1041892,98236,593356,1733484
2020-05-12,NASDAQ PSX (X),24699169,19417923,18845777,62962869,578036469.898000,1295472438.095400,976464138.498400,2849973046.491800,187145,91740,161032,439917
2020-05-12,BYX Equities (Y),91187872,48488625,64443262,204119759,2336869371.342200,2330845625.213600,2115290941.086800,6783005937.642600,963707,210481,573868,1748056
2020-05-12,BZX Equities (Z),341573385,146475232,264431760,752480377,12836486767.873504,9387747434.327300,14249114998.220508,36473349200.421312,3193270,715601,2366337,6275208
2020-05-11,NYSE American (A),10889940,28767975,7395610,47053525,311917709.809900,336558836.357900,299147353.414100,947623899.581900,189116,96446,127669,413231
2020-05-11,NASDAQ BX (B),42802467,19841742,29324053,91968262,1171130630.358500,1116060591.800500,1118582240.295900,3405773462.454900,421453,112914,257745,792112
2020-05-11,NYSE National (C),77213465,33005802,33924931,144144198,1238956502.742200,1277869123.562200,868971878.388300,3385797504.692700,721805,171081,367130,1260016
2020-05-11,FINRA / Nasdaq TRF Chicago (DB),7555622,2896147,7906594,18358363,0.0,0.0,545044263.364400,545044263.364400,1,1,45629,45631
2020-05-11,FINRA / NYSE TRF (DN),389797716,163795236,532418811,1086011763,8588355219.092702,4891293345.711104,16390603135.943705,29870251700.747511,1534428,459189,1679023,3672640
2020-05-11,FINRA / Nasdaq TRF Carteret (DQ),1533290828,554103520,1284583962,3371978310,50427669095.103088,28736055828.261900,57041781339.029299,136205506262.394287,5630465,1215689,4428275,11274429
2020-05-11,EDGA Equities (J),85691199,26389031,59205240,171285470,3516698362.751800,1467669809.508700,3279953504.400800,8264321676.661300,1172996,172058,805858,2150912
2020-05-11,EDGX Equities (K),261450126,124928704,296935365,683314195,5925365255.481699,6032616360.564999,8311298407.115194,20269280023.161892,1787533,557828,1520084,3865445
2020-05-11,NYSE Chicago (M),5542849,5418360,3334074,14295283,488764113.367700,544908994.230000,386383871.040700,1420056978.638400,6744,2596,5565,14905
2020-05-11,NYSE (N),1004342895,38821709,49188226,1092352830,36517052845.938200,2093500721.248500,2072067016.046900,40682620583.233600,3461078,129716,376639,3967433
2020-05-11,NYSE Arca (P),299070741,263451967,316192707,878715415,9143418522.856402,15475755809.415394,13605036111.037212,38224210443.309008,2325396,962238,2369840,5657474
2020-05-11,NASDAQ (Q),547641098,181856601,932363676,1661861375,19231343079.666800,10782498431.845108,48524647881.772368,78538489393.284276,5386240,961098,6120153,12467491
2020-05-11,Investors Exchange (V),124958973,18360189,64380929,207700091,4948587614.055200,1086437540.657100,3779530335.560499,9814555490.272799,922979,86995,515981,1525955
2020-05-11,NASDAQ PSX (X),23787989,15760532,16904069,56452590,542073559.128700,936543919.281800,865068435.405300,2343685913.815800,179222,80019,142776,402017
2020-05-11,BYX Equities (Y),79064604,38329892,61345363,178739859,2066198023.013600,1887137034.844699,2050714581.753400,6004049639.611699,867513,180459,516069,1564041
2020-05-11,BZX Equities (Z),326631580,123703081,230055775,680390436,11781195022.615603,8027343862.892903,12761782734.896499,32570321620.405005,3055758,619532,2178292,5853582
2020-05-08,NYSE American (A),11738661,26715227,6371129,44825017,324140499.435000,358904023.135600,300077970.713400,983122493.284000,186701,90276,108190,385167
2020-05-08,NASDAQ BX (B),47987753,20015267,29470965,97473985,1335149930.331200,982293675.341100,1074241124.327100,3391684729.999400,450843,111642,261503,823988
2020-05-08,NYSE National (C),85450662,35499379,31224701,152174742,1390340821.261700,1305869798.966100,821333671.869800,3517544292.097600,778928,174239,330672,1283839
2020-05-08,FINRA / Nasdaq TRF Chicago (DB),8682855,2570711,8227407,19480973,0.0,0.0,559296182.878500,559296182.878500,1,1,40393,40395
2020-05-08,FINRA / NYSE TRF (DN),408267758,171154153,535985786,1115407697,9380460130.185199,4937955021.929495,15088282716.780215,29406697868.894909,1531007,461483,1600304,3592794
2020-05-08,FINRA / Nasdaq TRF Carteret (DQ),1588801177,538046740,1241777028,3368624945,50711999496.868411,27005461320.134993,49933325251.598223,127650786068.601627,5849525,1198741,4345306,11393572
2020-05-08,EDGA Equities (J),89232527,25495146,54829510,169557183,3699439635.971300,1319519727.782600,2987562042.956999,8006521406.710899,1211082,155619,746362,2113063
2020-05-08,EDGX Equities (K),268439191,134754848,292761451,695955490,6255666283.664900,6030644470.031003,7654654030.525698,19940964784.221601,1802003,559740,1414746,3776489
2020-05-08,NYSE Chicago (M),8482736,28319133,3783144,40585013,350660884.399600,1688597821.004400,532649290.851000,2571907996.255000,5904,1955,5903,13762
2020-05-08,NYSE (N),908743261,40067833,46225340,995036434,31623194678.199307,2051032496.934200,1844225983.164000,35518453158.297507,3551963,123693,352564,4028220
2020-05-08,NYSE Arca (P),311511870,280326690,303822501,895661061,10223699794.469603,15556605302.774503,12442325128.601997,38222630225.846103,2472051,970909,2295320,5738280
2020-05-08,NASDAQ (Q),560337243,188506238,880568880,1629412361,20154902242.599807,10733197911.120606,43498769089.580561,74386869243.300974,5449202,923131,6099925,12472258
2020-05-08,Investors Exchange (V),138707381,19015456,68716872,226439709,5198419182.349799,1093271609.205500,3679104811.157800,9970795602.713099,995112,95442,544486,1635040
2020-05-08,NASDAQ PSX (X),25948364,17396076,16799186,60143626,604629517.914800,993483730.349000,799616526.884400,2397729775.148200,183092,82071,135358,400521
2020-05-08,BYX Equities (Y),82693169,46618254,61209978,190521401,2141634544.918100,1882352561.200400,1739051883.416000,5763038989.534500,885989,192524,479324,1557837
2020-05-08,BZX Equities (Z),331011669,124123691,231862683,686998043,11888982082.494001,7285052533.620999,12526132626.541702,31700167242.656702,3061360,608042,2075062,5744464
2020-05-07,NYSE American (A),13382948,27672023,6853433,47908404,408807736.621500,335737696.217000,311700287.306100,1056245720.144600,194436,95679,103312,393427
2020-05-07,NASDAQ BX (B),52925961,20984834,35160395,109071190,1510315128.898700,959147229.384900,1211169911.720300,3680632270.003900,513398,122269,299749,935416
2020-05-07,NYSE National (C),90115060,38763424,32845134,161723618,1479975185.860700,1365120436.080100,865177386.820200,3710273008.761000,802857,186474,349666,1338997
2020-05-07,FINRA / Nasdaq TRF Chicago (DB),8156176,2610229,6949125,17715530,270601534.404600,138618167.407700,443119869.437600,852339571.249900,32703,8065,34791,75559
2020-05-07,FINRA / NYSE TRF (DN),411446111,188998954,490701356,1091146421,10060731709.835606,5262430174.532499,14675406703.180597,29998568587.548702,1589869,482092,1537312,3609273
2020-05-07,FINRA / Nasdaq TRF Carteret (DQ),1671154396,576859133,1222691329,3470704858,53720444528.948003,26125990885.410494,50222895136.169403,130069330550.527900,6019158,1184861,4250993,11455012
2020-05-07,EDGA Equities (J),97280581,27731273,57234340,182246194,3826289577.153300,1427940606.661000,3218715382.398100,8472945566.212400,1293541,183308,791035,2267884
2020-05-07,EDGX Equities (K),285820920,153132809,282804743,721758472,7032417515.373003,6471153447.520496,8410776351.907801,21914347314.801300,2022781,619828,1507947,4150556
2020-05-07,NYSE Chicago (M),7502639,12358024,7868146,27728809,314270769.712900,1382065936.854901,529843781.958700,2226180488.526501,6135,2026,5944,14105
2020-05-07,NYSE (N),955307767,43398190,47935218,1046641175,33388885727.565096,2248914299.455001,2084417505.771900,37722217532.791997,3946032,140114,385066,4471212
2020-05-07,NYSE Arca (P),345675027,303940682,341453349,991069058,10897659055.428599,15867278204.714598,13344356864.553897,40109294124.697094,2763376,1059568,2475312,6298256
2020-05-07,NASDAQ (Q),622366736,211837624,886189966,1720394326,22157044712.702498,11334557522.118698,44342872561.160204,77834474795.981400,6111783,1084468,6490269,13686520
2020-05-07,Investors Exchange (V),140364272,18376350,70852476,229593098,5733845814.890201,1046426296.929500,3938614264.689900,10718886376.509601,1008936,93483,540987,1643406
2020-05-07,NASDAQ PSX (X),26810647,19358266,17066166,63235079,569677624.279700,1127701814.110000,814906734.381100,2512286172.770800,182209,100295,144623,427127
2020-05-07,BYX Equities (Y),91747309,50424899,51839005,194011213,2274062277.739400,1918859445.288300,2022345041.238300,6215266764.266000,968576,199752,517759,1686087
2020-05-07,BZX Equities (Z),358737111,142513926,228776139,730027176,12925670615.220798,8162017051.234504,12678934242.783900,33766621909.239202,3401866,713174,2231993,6347033
2020-05-06,NYSE American (A),11121779,21310718,5652487,38084984,308647230.560600,299260271.842100,261835820.917200,869743323.319900,149788,76125,71699,297612
2020-05-06,NASDAQ BX (B),46210959,18390144,32575383,97176486,1267565401.112900,897050631.418700,1118703253.460500,3283319285.992100,448923,104395,260905,814223
2020-05-06,NYSE National (C),79159974,36794824,29751963,145706761,1258355288.633400,1304267144.842900,734630984.575400,3297253418.051700,706452,177086,304201,1187739
2020-05-06,FINRA / Nasdaq TRF Chicago (DB),8582485,2192091,6902392,17676968,275655110.742500,132532082.859800,469796981.357900,877984174.960200,33009,7939,33738,74686
2020-05-06,FINRA / NYSE TRF (DN),410450573,148366976,493901450,1052718999,9606503227.995599,5127820264.751300,15429789561.562212,30164113054.309111,1654581,405208,1537757,3597546
2020-05-06,FINRA / Nasdaq TRF Carteret (DQ),1590831282,461596505,1201053947,3253481734,50486042202.514091,22760623568.391186,48873593706.459210,122120259477.364487,5747756,1132189,4043202,10923147
2020-05-06,EDGA Equities (J),87069854,26226139,53208500,166504493,3491983247.079000,1382956211.421600,2958688254.359900,7833627712.860500,1137075,169717,684589,1991381
2020-05-06,EDGX Equities (K),263509334,113258628,277255637,654023599,6191059020.627101,5916180013.561503,7598507520.329702,19705746554.518306,1814312,565078,1369618,3749008
2020-05-06,NYSE Chicago (M),6576340,5928379,4238521,16743240,336861322.460000,718250506.710400,543420660.431400,1598532489.601800,6226,1874,4274,12374
2020-05-06,NYSE (N),904468317,38533442,43754636,986756395,30346013911.781993,2011025451.887300,1794723330.340300,34151762694.009593,3587610,127736,329230,4044576
2020-05-06,NYSE Arca (P),326802590,268064630,297062527,891929747,9938110430.096801,15016464286.094604,12143341799.476398,37097916515.667803,2519493,993726,2176939,5690158
2020-05-06,NASDAQ (Q),582829086,183277286,839924400,1606030772,20302721928.603991,11129788983.475106,40715444850.353104,72147955762.432201,5561760,1025687,5918794,12506241
2020-05-06,Investors Exchange (V),125143926,15964860,62846248,203955034,4801690698.681599,892579262.411700,3363964234.618501,9058234195.711800,888150,80897,482941,1451988
2020-05-06,NASDAQ PSX (X),23525121,15449538,16973790,55948449,538535056.025300,996558570.186200,839471415.581500,2374565041.793000,175881,90271,147499,413651
2020-05-06,BYX Equities (Y),82353370,37938570,63515323,183807263,1978968190.637500,1777390642.468700,1771213405.539200,5527572238.645400,837801,182981,460195,1480977
2020-05-06,BZX Equities (Z),343937984,125674297,228138626,697750907,12303402689.726500,7995286346.343898,12654600897.084606,32953289933.155004,3186327,669358,2080706,5936391
2020-05-05,NYSE American (A),11047846,24515646,6181952,41745444,322200598.377300,353493483.718200,266023428.414600,941717510.510100,144064,89739,72852,306655
2020-05-05,NASDAQ BX (B),49290520,19686812,35158105,104135437,1397582634.259400,1014843982.184700,1084971511.750900,3497398128.195000,459717,108666,264366,832749
2020-05-05,NYSE National (C),82372349,35506561,30099010,147977920,1360331230.559100,1274508808.028500,772102027.310100,3406942065.897700,743816,180171,313518,1237505
2020-05-05,FINRA / Nasdaq TRF Chicago (DB),9159223,2123635,6569661,17852519,273815795.048000,113479398.052000,494312592.851000,881607785.951000,34541,7965,32503,75009
2020-05-05,FINRA / NYSE TRF (DN),462530913,165250418,532087812,1159869143,9875219698.405999,5255175525.481600,15214804808.050706,30345200031.938305,1710223,488552,1599782,3798557
2020-05-05,FINRA / Nasdaq TRF Carteret (DQ),1648353619,555357665,1308660830,3512372114,50152398369.511413,27029038763.586396,49605174246.665804,126786611379.763613,6148283,1281546,4374641,11804470
2020-05-05,EDGA Equities (J),92433841,25430677,60023204,177887722,3775361327.114600,1460010879.441600,3051919116.724599,8287291323.280799,1234767,169296,751041,2155104
2020-05-05,EDGX Equities (K),282098413,129120374,313067972,724286759,6661931798.964099,6276076582.741798,7735558672.000097,20673567053.705994,1909904,602913,1446384,3959201
2020-05-05,NYSE Chicago (M),6016100,13194889,3804447,23015436,338410417.871700,1058713128.965200,359505345.191100,1756628892.028000,5967,2101,4617,12685
2020-05-05,NYSE (N),927057068,43947808,47650926,1018655802,30729677450.093498,2364338216.685100,1850583070.946900,34944598737.725498,3816052,147247,347493,4310792
2020-05-05,NYSE Arca (P),340000546,300131850,324801134,964933530,10663873578.989301,17040658246.261313,12483862483.336298,40188394308.586912,2603055,1054572,2260050,5917677
2020-05-05,NASDAQ (Q),627670170,200541115,889757053,1717968338,21972158939.182395,11538070146.641800,41793461625.497907,75303690711.322102,6041026,1060420,6264686,13366132
2020-05-05,Investors Exchange (V),133197155,19432881,71217467,223847503,5403852045.487400,1167737516.082100,3541140885.998900,10112730447.568400,966890,96071,521550,1584511
2020-05-05,NASDAQ PSX (X),26216314,18708078,19102175,64026567,622013998.383400,1164644963.227900,842326736.849000,2628985698.460300,200461,104836,145060,450357
2020-05-05,BYX Equities (Y),89119369,41443721,62028346,192591436,2168353004.411600,1908851685.876400,1914313006.534900,5991517696.822900,888758,186252,475181,1550191
2020-05-05,BZX Equities (Z),353732290,134808295,223343564,711884149,12503138421.308301,8359882988.992504,11656260902.976405,32519282313.277210,3367613,687157,2080467,6135237
2020-05-04,NYSE American (A),9370368,26191608,5307390,40869366,259837504.586700,351315958.287100,240157602.116900,851311064.990700,120829,90108,66601,277538
2020-05-04,NASDAQ BX (B),46944980,18154262,40077676,105176918,1238137455.569100,795782927.168000,1144623862.920000,3178544245.657100,436475,106486,272292,815253
2020-05-04,NYSE National (C),73410542,34001171,27030947,134442660,1163649637.812400,1235133466.723600,733467443.996800,3132250548.532800,667722,180734,288686,1137142
2020-05-04,FINRA / Nasdaq TRF Chicago (DB),7459342,2423957,6014419,15897718,225045465.638200,126984563.220100,473718931.381200,825748960.239500,31402,8591,31138,71131
2020-05-04,FINRA / NYSE TRF (DN),376785542,163924016,435490837,976200395,8087799479.389902,5171323623.577802,14403137914.591212,27662261017.558916,1645733,618403,1463959,3728095
2020-05-04,FINRA / Nasdaq TRF Carteret (DQ),1493348122,558228619,1123472925,3175049666,46181841159.345289,26997587113.499875,46744378140.037096,119923806412.882260,5737938,1285552,3967146,10990636
2020-05-04,EDGA Equities (J),87392579,25204476,55454595,168051650,3387681066.391300,1250209392.264000,2788311605.699900,7426202064.355200,1152208,173231,705863,2031302
2020-05-04,EDGX Equities (K),246395359,136195271,249950516,632541146,5742509224.225899,6433413344.861995,7302314195.613697,19478236764.701591,1772186,655164,1350721,3778071
2020-05-04,NYSE Chicago (M),11459311,7442759,4400993,23303063,460493096.055800,496735387.422800,934144814.277300,1891373297.755900,6152,1532,4226,11910
2020-05-04,NYSE (N),968604617,43220405,40169726,1051994748,32613112016.311096,2217511274.289400,1658948528.601700,36489571819.202196,3764139,140114,304637,4208890
2020-05-04,NYSE Arca (P),287740073,284911886,273190646,845842605,8346682574.737100,15529352380.456000,11186806760.948503,35062841716.141603,2294743,1055530,1990155,5340428
2020-05-04,NASDAQ (Q),581052437,202266375,855979049,1639297861,19636289276.183891,11697329358.045394,42199931726.364475,73533550360.593760,5707810,1105913,6052955,12866678
2020-05-04,Investors Exchange (V),123382241,19550624,62959659,205892524,4671649368.465400,1065670197.193700,3279009973.702400,9016329539.361500,919740,105157,491938,1516835
2020-05-04,NASDAQ PSX (X),23227611,18008142,16111965,57347718,511607091.688600,1106119402.716000,837840560.787000,2455567055.191600,172385,105170,141338,418893
2020-05-04,BYX Equities (Y),82805245,41649449,55522616,179977310,2016151518.327900,1694680609.712800,1830841649.417599,5541673777.458299,844019,193229,469000,1506248
2020-05-04,BZX Equities (Z),316557327,137214947,192009855,645782129,11043556543.207900,8205743905.439496,10730888039.723197,29980188488.370593,3057642,749915,1870940,5678497
2020-05-01,NYSE American (A),9939563,25305790,6145651,41391004,288290394.374000,342189611.941100,298219694.952900,928699701.268000,139705,97826,79682,317213
2020-05-01,NASDAQ BX (B),52670099,21904149,45373177,119947425,1374659279.272200,1250046884.242299,1619183029.663500,4243889193.177999,444928,136145,316072,897145
2020-05-01,NYSE National (C),73087405,34762550,31144008,138993963,1243607787.283100,1319846374.076400,992017974.396000,3555472135.755500,714816,185458,337578,1237852
2020-05-01,FINRA / Nasdaq TRF Chicago (DB),8999179,2538364,7862462,19400005,268818282.930900,157036912.927800,864112913.875800,1289968109.734500,31463,9515,42746,83724
2020-05-01,FINRA / NYSE TRF (DN),418568484,165409124,483762094,1067739702,8701128797.894100,6116578913.276002,20451064679.561600,35268772390.731702,1691322,587025,1712925,3991272
2020-05-01,FINRA / Nasdaq TRF Carteret (DQ),1490992990,615375992,1207157520,3313526502,44955707004.554588,35345815914.897315,61837332561.375927,142138855480.827830,6057824,1490894,4676203,12224921
2020-05-01,EDGA Equities (J),89470186,29781321,60152606,179404113,3613253303.596300,1741382233.120600,3652212831.795200,9006848368.512100,1184103,191268,792948,2168319
2020-05-01,EDGX Equities (K),255844518,135413665,257357527,648615710,6030966988.699600,7267642011.707298,9849984257.199392,23148593257.606290,1801928,690317,1529498,4021743
2020-05-01,NYSE Chicago (M),5616715,9534985,3974881,19126581,272342792.479500,1659304735.946800,512121410.782800,2443768939.209100,7452,1635,5355,14442
2020-05-01,NYSE (N),923320573,48613430,47835755,1019769758,32149805633.057000,2751898820.292000,2247668644.104099,37149373097.453099,3944931,166144,365790,4476865
2020-05-01,NYSE Arca (P),298623470,338083320,289162123,925868913,8902076250.878297,20097314246.830905,15168652720.857610,44168043218.566812,2412296,1243948,2316210,5972454
2020-05-01,NASDAQ (Q),574429423,227293343,933441909,1735164675,20573168978.469502,14761386326.650997,54363900854.180859,89698456159.301358,5930039,1286650,6982873,14199562
2020-05-01,Investors Exchange (V),123248419,21988783,63572432,208809634,4928719822.849900,1311167981.671400,4311568837.252798,10551456641.774098,935660,111640,512978,1560278
2020-05-01,NASDAQ PSX (X),23332256,21244760,20031964,64608980,570449550.045500,1514300934.079500,1411468462.733600,3496218946.858600,180263,132315,183873,496451
2020-05-01,BYX Equities (Y),80265241,40527897,57080621,177873759,2190114103.182100,2218028374.484300,2371046793.968100,6779189271.634500,858004,202146,518795,1578945
2020-05-01,BZX Equities (Z),331409468,152345250,227250588,711005306,12127358021.608002,9968587943.987304,15714666563.313404,37810612528.908710,3310562,841128,2310441,6462131
2020-04-30,NYSE American (A),10432254,48422470,6451744,65306468,304039870.377400,501568361.856300,333758557.641400,1139366789.875100,110874,140661,66793,318328
2020-04-30,NASDAQ BX (B),71581321,31631861,50584938,153798120,1669502237.059900,1410005180.259600,1639580644.431600,4719088061.751100,530012,155921,312046,997979
2020-04-30,NYSE National (C),96712175,46954401,33210093,176876669,1540065635.872100,1767598874.532400,1055765412.512500,4363429922.917000,834266,228892,344693,1407851
2020-04-30,FINRA / Nasdaq TRF Chicago (DB),10615751,2745383,7059915,20421049,268120797.157700,145724294.280300,657381789.929600,1071226881.367600,30608,8809,35500,74917
2020-04-30,FINRA / NYSE TRF (DN),551691653,212587571,559962590,1324241814,9809397096.712703,6374471891.031602,19350543395.891078,35534412383.635383,1838040,640030,1682734,4160804
2020-04-30,FINRA / Nasdaq TRF Carteret (DQ),1996033734,718979564,1361328093,4076341391,57595718791.948291,36651294237.310999,65568727730.649488,159815740759.908778,6593236,1640005,4498830,12732071
2020-04-30,EDGA Equities (J),110423328,38599968,66337918,215361214,4373650137.523700,2143959295.016900,3907668922.901500,10425278355.442100,1392292,229047,830651,2451990
2020-04-30,EDGX Equities (K),327967121,195020870,304648731,827636722,6803353792.437800,9115218419.992905,10624064721.094201,26542636933.524906,2031209,894123,1525039,4450371
2020-04-30,NYSE Chicago (M),7565192,11218027,4875142,23658361,340911106.612200,1377618850.229500,510184451.049500,2228714407.891200,7831,1783,5248,14862
2020-04-30,NYSE (N),1523545558,60629053,50339059,1634513670,54597497677.980693,3613778941.311300,2347889852.859800,60559166472.151793,4602606,203042,390565,5196213
2020-04-30,NYSE Arca (P),388752112,421516731,322760735,1133029578,11086852119.496301,25261288323.598890,18354915443.100806,54703055886.195997,2897776,1483645,2555787,6937208
2020-04-30,NASDAQ (Q),840830866,292860165,1199922229,2333613260,29397457909.418389,17262889307.277698,71270346275.631152,117930693492.327239,7695273,1526360,7606434,16828067
2020-04-30,Investors Exchange (V),159377547,25149744,79102869,263630160,6102525689.855801,1415475555.902800,4633870134.181900,12151871379.940501,1104829,122815,586348,1813992
2020-04-30,NASDAQ PSX (X),31770400,24181719,21401971,77354090,708299942.087000,1490174999.209699,1381739677.664900,3580214618.961599,230986,136137,196518,563641
2020-04-30,BYX Equities (Y),100331494,51561913,57489941,209383348,2522000231.486300,2755783191.145400,2602636159.704800,7880419582.336500,990519,248586,533678,1772783
2020-04-30,BZX Equities (Z),317355008,194988342,210190901,722534251,10053439478.143101,12237543493.823203,11715890534.652097,34006873506.618401,2992843,936920,1854174,5783937
2020-04-29,NYSE American (A),11729311,35126733,7784150,54640194,339758558.536600,460626660.586600,362982532.375200,1163367751.498400,155543,114897,99349,369789
2020-04-29,NASDAQ BX (B),69892046,29924546,55773993,155590585,1794255559.883000,1172831589.208401,1733971776.795200,4701058925.886601,559235,133366,345194,1037795
2020-04-29,NYSE National (C),99613442,38028793,35915956,173558191,1591278934.567500,1404431717.674800,1024983613.611600,4020694265.853900,882768,190888,386479,1460135
2020-04-29,FINRA / Nasdaq TRF Chicago (DB),12945666,2885449,8237769,24068884,344681922.016600,154844002.330700,581459377.188700,1080985301.536000,44784,9895,40595,95274
2020-04-29,FINRA / NYSE TRF (DN),589460442,200368550,553514125,1343343117,12096273270.268108,6521364268.083101,17714585234.150796,36332222772.502005,2095721,571592,1829439,4496752
2020-04-29,FINRA / Nasdaq TRF Carteret (DQ),2179748773,647952365,1445627013,4273328151,62850109370.729601,31671332007.770104,62187583879.041699,156709025257.541404,7338130,1549248,5049028,13936406
2020-04-29,EDGA Equities (J),115397685,31610775,67470094,214478554,4706642525.072100,1759916471.875600,3880052433.409700,10346611430.357400,1485939,202426,884944,2573309
2020-04-29,EDGX Equities (K),359227945,169637369,298035216,826900530,7994120908.565402,8362822683.134899,10693609317.411103,27050552909.111404,2229890,776777,1688406,4695073
2020-04-29,NYSE Chicago (M),8466141,10667944,6169546,25303631,286287013.661700,1808424592.794400,825382051.465100,2920093657.921200,7991,1438,5762,15191
2020-04-29,NYSE (N),1219394135,51616995,55750953,1326762083,40403053625.810098,3003212966.771300,2463972064.204200,45870238656.785598,4609935,179546,419944,5209425
2020-04-29,NYSE Arca (P),435768552,349365891,361014137,1146148580,13070580672.762004,21102075888.423308,18644419168.237206,52817075729.422518,3172747,1298122,2805293,7276162
2020-04-29,NASDAQ (Q),810077261,262815715,1098424078,2171317054,27019121972.791293,16402394319.237888,60102967123.174921,103524483415.204102,7148776,1352986,7441053,15942815
2020-04-29,Investors Exchange (V),171296939,23094585,77973126,272364650,6474695124.827500,1408562090.088600,4754093030.242799,12637350245.158899,1101148,110162,580766,1792076
2020-04-29,NASDAQ PSX (X),35039159,23983916,20726559,79749634,811307616.619700,1588827897.388400,1143690464.122300,3543825978.130400,239234,134073,186780,560087
2020-04-29,BYX Equities (Y),104464747,44697539,55491143,204653429,2719961729.092800,2320130873.370799,2482937295.600600,7523029898.064199,1056463,212563,575524,1844550
2020-04-29,BZX Equities (Z),423121608,170702953,259233321,853057882,14966291589.304300,11830792267.273396,15000422410.410005,41797506266.987701,3940360,858881,2571095,7370336
2020-04-28,NYSE American (A),10309503,32815252,6615794,49740549,309903000.141600,397494327.553400,288940880.746000,996338208.441000,134117,101693,74392,310202
2020-04-28,NASDAQ BX (B),55315099,20369766,31487103,107171968,1573378588.760800,1113656654.794200,1369636545.401400,4056671788.956400,502027,123047,287512,912586
2020-04-28,NYSE National (C),89124600,35060066,32831902,157016568,1403937336.591700,1241001983.648900,931438896.259600,3576378216.500200,784550,178154,331827,1294531
2020-04-28,FINRA / Nasdaq TRF Chicago (DB),11081504,3492486,7499324,22073314,304452652.372900,148849287.252200,611744404.486200,1065046344.111300,39743,9852,36843,86438
2020-04-28,FINRA / NYSE TRF (DN),475986624,242819541,461324381,1180130546,10170436927.125201,6380402559.863602,15608867379.024892,32159706866.013695,1716529,520849,1533863,3771241
2020-04-28,FINRA / Nasdaq TRF Carteret (DQ),1856221429,719165324,1242408715,3817795468,55779215329.417906,31017956842.277696,55716667315.006286,142513839486.701888,6596765,1424110,4298012,12318887
2020-04-28,EDGA Equities (J),102667354,31163228,58767374,192597956,4025204696.480900,1489732827.685000,3373106430.499299,8888043954.665199,1325968,184879,754600,2265447
2020-04-28,EDGX Equities (K),292761200,177501725,263126398,733389323,6755279910.046797,6959966924.335401,8393781619.094397,22109028453.476595,1946188,718956,1415446,4080590
2020-04-28,NYSE Chicago (M),11497614,14572135,4599761,30669510,341136406.905500,2076517172.660900,672479352.479500,3090132932.045900,7659,1905,4675,14239
2020-04-28,NYSE (N),1032556030,48995345,47033366,1128584741,33809681139.078906,2727678491.267401,2004848523.043900,38542208153.390207,4367119,183163,353580,4903862
2020-04-28,NYSE Arca (P),369027731,351167538,293188595,1013383864,10820997317.845599,19139713080.804197,14293728856.589294,44254439255.239090,2790264,1218128,2329156,6337548
2020-04-28,NASDAQ (Q),727392932,250258487,909674339,1887325758,24107438120.444598,14560406361.244212,46160447201.574075,84828291683.262885,6641729,1272257,6587692,14501678
2020-04-28,Investors Exchange (V),150552698,21012999,72756245,244321942,5719684453.769899,1316878172.730400,3969693668.012200,11006256294.512499,1045900,100996,526116,1673012
2020-04-28,NASDAQ PSX (X),29208072,22570812,19647626,71426510,672259503.673700,1492977607.125500,1055697552.758100,3220934663.557300,206925,113654,170715,491294
2020-04-28,BYX Equities (Y),97402203,46866232,57317137,201585572,2419534520.140500,2048021624.976701,2115210282.624700,6582766427.741901,988413,209696,515115,1713224
2020-04-28,BZX Equities (Z),380065208,176394703,222072228,778532139,13400768332.830501,10407924903.400399,12558890755.201898,36367583991.432798,3527516,849471,2060283,6437270
2020-04-27,NYSE American (A),9782431,28909430,6298894,44990755,291177063.816200,308919275.060400,274669601.178000,874765940.054600,123780,93777,83348,300905
2020-04-27,NASDAQ BX (B),49241870,20741690,28899568,98883128,1432617060.266900,892967459.563800,1236999409.882000,3562583929.712700,437051,107510,263657,808218
2020-04-27,NYSE National (C),76128769,33777974,31233790,141140533,1225241898.452300,1070386982.253500,785830706.220600,3081459586.926400,677268,154243,311144,1142655
2020-04-27,FINRA / Nasdaq TRF Chicago (DB),9632405,3441402,7432745,20506552,247323913.990400,135438923.936500,609324623.767400,992087461.694300,33540,9055,38852,81447
2020-04-27,FINRA / NYSE TRF (DN),427430917,205408923,492993871,1125833711,8506700235.149302,5454837404.057300,16255965822.768581,30217503461.975183,1665538,596560,1646666,3908764
2020-04-27,FINRA / Nasdaq TRF Carteret (DQ),1779791629,729137249,1271615118,3780543996,52292512371.252183,30764615612.965910,55243990383.520925,138301118367.739018,6270471,1412760,4414392,12097623
2020-04-27,EDGA Equities (J),92432930,30345168,47070437,169848535,3459546023.436900,1133252303.246000,2499733311.968800,7092531638.651700,1158890,164684,602234,1925808
2020-04-27,EDGX Equities (K),263778976,151843492,251072969,666695437,5942829470.226399,6139049721.846501,7636619912.522003,19718499104.594903,1717259,616997,1329618,3663874
2020-04-27,NYSE Chicago (M),6418365,14509182,3908686,24836233,277254635.668500,1131615766.898800,685825729.094701,2094696131.662001,6517,1114,4573,12204
2020-04-27,NYSE (N),969586484,40765887,44853295,1055205666,32476327112.640796,2040195600.180200,1732946626.007600,36249469338.828596,3734080,140437,324941,4199458
2020-04-27,NYSE Arca (P),325148133,367180554,296273241,988601928,9139912102.445102,16574354613.445697,12923774951.398400,38638041667.289199,2358605,1077977,2199045,5635627
2020-04-27,NASDAQ (Q),608929281,209297533,860887133,1679113947,20156344351.098702,11346958904.454504,43614454795.685305,75117758051.238511,5459614,1058232,5941223,12459069
2020-04-27,Investors Exchange (V),142321288,23121038,63777524,229219850,5388413089.819799,1043406459.803400,3764660853.607001,10196480403.230200,1007383,101835,496436,1605654
2020-04-27,NASDAQ PSX (X),26173543,19931287,16898673,63003503,563122519.716500,1132026867.796700,880621924.852000,2575771312.365200,185909,98248,141813,425970
2020-04-27,BYX Equities (Y),90821883,51372171,58580529,200774583,2299707347.623600,1767685217.420900,1894700066.287300,5962092631.331800,909953,209873,501039,1620865
2020-04-27,BZX Equities (Z),326320899,135770854,213186632,675278385,11028699130.710197,7566343042.326903,11460274322.863800,30055316495.900900,2975498,662178,1931541,5569217
2020-04-24,NYSE American (A),12225837,36378667,7356750,55961254,280495689.765600,338789617.125600,292119731.197200,911405038.088400,146329,98892,85836,331057
2020-04-24,NASDAQ BX (B),46435669,20697755,25895043,93028467,1149606653.665000,882738664.917200,1053084704.932000,3085430023.514200,408331,120090,223435,751856
2020-04-24,NYSE National (C),80701860,34003823,28724785,143430468,1149543229.515600,1085065527.519200,703228012.482700,2937836769.517500,720999,170757,302493,1194249
2020-04-24,FINRA / Nasdaq TRF Chicago (DB),9389017,3329743,7808309,20527069,216759908.679500,160918699.272800,535856456.174400,913535064.126700,26530,8135,35214,69879
2020-04-24,FINRA / NYSE TRF (DN),401546363,206065603,463439622,1071051588,7172446014.981903,5211036252.192095,14007868415.624602,26391350682.798600,1416873,488119,1361366,3266358
2020-04-24,FINRA / Nasdaq TRF Carteret (DQ),1851584107,680121902,1306023077,3837729086,49934545289.589513,28981191278.454909,51409724121.023084,130325460689.067506,5798112,1347506,4034608,11180226
2020-04-24,EDGA Equities (J),92582644,27914121,51174651,171671416,3314321862.745800,1177096172.322400,2789421580.576400,7280839615.644600,1150226,169159,656308,1975693
2020-04-24,EDGX Equities (K),264761328,156279882,283710873,704752083,5175110200.050300,5669973709.307002,7581807583.090401,18426891492.447703,1653625,593434,1251166,3498225
2020-04-24,NYSE Chicago (M),5202913,22798814,2715172,30716899,173453236.277600,2209403807.687000,268223291.260500,2651080335.225100,6055,1721,4254,12030
2020-04-24,NYSE (N),1058921969,42234580,41718052,1142874601,31759299106.694001,2121637282.481500,1757383662.106700,35638320051.282201,3566761,144128,308565,4019454
2020-04-24,NYSE Arca (P),331514208,308499565,287343780,927357553,8831625468.022898,14797055274.280303,11665444142.761298,35294124885.064499,2385406,1086915,1998144,5470465
2020-04-24,NASDAQ (Q),654454538,226472507,851498780,1732425825,19519976095.441207,11643633288.125897,42365130976.827792,73528740360.394896,5581167,1164521,5512810,12258498
2020-04-24,Investors Exchange (V),132687468,25444557,61172425,219304450,4463755859.374400,1013128114.818300,3134679536.573900,8611563510.766600,963385,109570,460723,1533678
2020-04-24,NASDAQ PSX (X),26626360,19796144,17670930,64093434,545125951.979800,1069700495.492500,957122609.696200,2571949057.168500,174964,112816,143638,431418
2020-04-24,BYX Equities (Y),85136733,49882233,57247411,192266377,1989566318.458700,1692091735.159300,1690364309.497600,5372022363.115600,835279,209527,421860,1466666
2020-04-24,BZX Equities (Z),329043700,133785403,202530126,665359229,10364079904.465300,7001182320.094399,10928549132.131500,28293811356.691199,2933323,657474,1763042,5353839
2020-04-23,NYSE American (A),14179235,31252637,8281472,53713344,361057392.187800,296308820.135100,297341545.630900,954707757.953800,170731,112345,93108,376184
2020-04-23,NASDAQ BX (B),54388819,27867401,26347486,108603706,1353784759.083600,1092628214.685600,1125207789.846400,3571620763.615600,466741,158268,244180,869189
2020-04-23,NYSE National (C),84052724,39050670,28064714,151168108,1249652400.800300,1320439495.670100,727326383.187200,3297418279.657600,750415,194164,293651,1238230
2020-04-23,FINRA / Nasdaq TRF Chicago (DB),11503633,5310429,8558823,25372885,255756863.064600,215248445.351300,615865535.419600,1086870843.835500,30399,10453,34478,75330
2020-04-23,FINRA / NYSE TRF (DN),591834979,266019966,535828708,1393683653,9501223202.924396,7075998053.962399,17346647225.364512,33923868482.251307,1839601,659212,1466127,3964940
2020-04-23,FINRA / Nasdaq TRF Carteret (DQ),1821792104,751915370,1211742146,3785449620,47606668016.482696,29125230733.103809,49779612047.879220,126511510797.465725,5885210,1493758,3843736,11222704
2020-04-23,EDGA Equities (J),101041954,37862750,54190447,193095151,3603922181.665600,1499986781.065600,2842506499.213100,7946415461.944300,1226588,201445,685247,2113280
2020-04-23,EDGX Equities (K),312020529,187114285,274190042,773324856,5773887762.358701,7846305686.168797,7902818537.660702,21523011986.188200,1788932,761131,1235909,3785972
2020-04-23,NYSE Chicago (M),6750402,7229764,5450505,19430671,321357467.369500,618965361.512700,461098903.586000,1401421732.468200,7388,1402,5079,13869
2020-04-23,NYSE (N),1057219814,61357078,45254068,1163830960,32910116857.323603,3108829484.671500,1825303088.789000,37844249430.784103,4245780,211067,330917,4787764
2020-04-23,NYSE Arca (P),377883530,423373861,298997012,1100254403,9273141520.107797,21383920897.884493,12815979965.419098,43473042383.411388,2593499,1485408,2102007,6180914
2020-04-23,NASDAQ (Q),703313970,274933212,914957574,1893204756,21460409280.598998,15492849781.378092,45488008726.005334,82441267787.982424,6186763,1418927,6314541,13920231
2020-04-23,Investors Exchange (V),137879154,34475886,58787779,231142819,4935401016.223599,1349614730.492000,2993799067.108000,9278814813.823599,904811,123341,425796,1453948
2020-04-23,NASDAQ PSX (X),25045790,24952451,18157646,68155887,520320038.469300,1276802533.961300,967153463.439000,2764276035.869600,167884,132189,151760,451833
2020-04-23,BYX Equities (Y),90979988,59940244,55046782,205967014,2113440602.305500,2050937940.625500,1903789207.718100,6068167750.649100,876438,237699,458555,1572692
2020-04-23,BZX Equities (Z),383651200,176924884,216035121,776611205,12638140571.854405,10421957263.276202,12361074343.687807,35421172178.818414,3369938,864454,1991367,6225759
2020-04-22,NYSE American (A),13971835,31222571,7732925,52927331,338932043.805300,291223372.018500,285075758.176600,915231174.000400,166061,94912,92558,353531
2020-04-22,NASDAQ BX (B),47545440,28807958,23677191,100030589,1258918912.239700,1016989685.849600,1062029447.913800,3337938046.003100,437056,126608,225027,788691
2020-04-22,NYSE National (C),76729026,46570756,26530506,149830288,1171578163.944000,1257705569.985000,701666251.745800,3130949985.674800,707815,190926,295651,1194392
2020-04-22,FINRA / Nasdaq TRF Chicago (DB),7690752,5116368,6003292,18810412,184504557.393200,144834049.004300,506899493.102000,836238099.499500,24535,9042,30391,63968
2020-04-22,FINRA / NYSE TRF (DN),392565540,220388998,318416142,931370680,7178460131.635102,4969113509.619801,12523225196.980793,24670798838.235696,1495393,467808,1185414,3148615
2020-04-22,FINRA / Nasdaq TRF Carteret (DQ),1670034656,775774457,1032970709,3478779822,46946950029.061817,26603560496.483179,49097498292.508583,122648008818.053579,5627100,1507395,3616571,10751066
2020-04-22,EDGA Equities (J),102550509,50102473,52118537,204771519,3684583148.782700,1800128084.878800,2928054478.364500,8412765712.026000,1310184,242213,700654,2253051
2020-04-22,EDGX Equities (K),243510908,183754955,199974036,627239899,5307356275.673202,6550209766.017299,7175593997.909097,19033160039.599598,1652940,673787,1135994,3462721
2020-04-22,NYSE Chicago (M),8894672,15834298,3098556,27827526,289575186.001500,2556823768.130001,416714692.413200,3263113646.544701,6921,917,4666,12504
2020-04-22,NYSE (N),1022051168,50124486,40258410,1112434064,33067833846.894095,2423898759.885000,1725748877.310700,37217481484.089795,3788814,164456,304704,4257974
2020-04-22,NYSE Arca (P),323524725,395744553,249323201,968592479,8729721987.955999,17425316941.622213,12541364469.391602,38696403398.969814,2403668,1199912,1973305,5576885
2020-04-22,NASDAQ (Q),607907587,253389920,788256440,1649553947,19549778681.313402,12540650460.563707,44257633455.550489,76348062597.427598,5510609,1173134,5480654,12164397
2020-04-22,Investors Exchange (V),129515064,33844525,54754577,218114166,4544075803.820700,1132775130.354100,3034991872.310501,8711842806.485301,896428,141142,424648,1462218
2020-04-22,NASDAQ PSX (X),24229929,27273725,14900031,66403685,524932956.114100,1108535021.894800,885022961.800900,2518490939.809800,173056,116068,129108,418232
2020-04-22,BYX Equities (Y),82103208,73473727,47240509,202817444,1965010477.642800,1954178774.089100,1875797752.807000,5794987004.538900,809904,248751,407775,1466430
2020-04-22,BZX Equities (Z),332095474,152951949,176266662,661314085,11108571607.897001,7706757594.269101,10937786940.366301,29753116142.532403,3070110,715214,1664923,5450247
2020-04-21,NYSE American (A),12471686,26227752,8782555,47481993,322349338.045500,342543505.488200,312796991.775300,977689835.309000,166392,99572,104721,370685
2020-04-21,NASDAQ BX (B),50779028,47858985,29559247,128197260,1407144107.516600,1607129865.333100,1426227570.486300,4440501543.336000,476958,253529,333795,1064282
2020-04-21,NYSE National (C),85092344,63314619,29442032,177848995,1314531036.691500,1494436055.337200,813457775.491600,3622424867.520300,767591,251413,318831,1337835
2020-04-21,FINRA / Nasdaq TRF Chicago (DB),8276030,8584117,8320028,25180175,294962428.239600,211069549.482200,778150137.969800,1284182115.691600,29478,14833,42563,86874
2020-04-21,FINRA / NYSE TRF (DN),361253731,324204604,479404860,1164863195,8780701346.938301,7336102111.794999,19773247850.848892,35890051309.582192,1654372,778692,1604618,4037682
2020-04-21,FINRA / Nasdaq TRF Carteret (DQ),1599602905,1017727099,1187720595,3805050599,51371134551.388706,35010192927.217905,61320547143.827691,147701874622.434302,5983677,2073520,4273490,12330687
2020-04-21,EDGA Equities (J),95095475,67097546,55689928,217882949,3587345769.010500,1709172658.992400,3279335075.000601,8575853503.003501,1213402,264562,732195,2210159
2020-04-21,EDGX Equities (K),252238112,273124067,269595208,794957387,6259026420.611801,9136571516.386300,9886908362.891503,25282506299.889604,1885225,1022175,1524608,4432008
2020-04-21,NYSE Chicago (M),11523990,10848672,4148738,26521400,590350521.009700,979047866.330000,656667663.920100,2226066051.259800,7804,1822,7456,17082
2020-04-21,NYSE (N),1032574569,75794248,50878435,1159247252,35616570747.124600,3033878095.347800,2393162351.211900,41043611193.684300,4387574,243392,388661,5019627
2020-04-21,NYSE Arca (P),314540518,637100835,308274119,1259915472,9921174028.778099,22769504284.228522,15756717583.889296,48447395896.895917,2671977,1761029,2384938,6817944
2020-04-21,NASDAQ (Q),655455101,383608694,960844920,1999908715,22218790890.891591,17396660884.963096,55319071634.554503,94934523410.409190,6210386,1815291,7014729,15040406
2020-04-21,Investors Exchange (V),139757008,48700205,63245447,251702660,5088644484.566202,1435617231.120000,3642800331.634100,10167062047.320302,969654,199899,473162,1642715
2020-04-21,NASDAQ PSX (X),25789407,36640844,20086481,82516732,654835879.852000,1465472735.736300,1314111746.980900,3434420362.569200,190580,208056,257263,655899
2020-04-21,BYX Equities (Y),99383120,118469906,77085308,294938334,2452907381.512600,2622321993.793801,2430836252.398400,7506065627.704801,978789,371472,535213,1885474
2020-04-21,BZX Equities (Z),377177912,232987454,235103155,845268521,13722980987.722301,11136102821.208601,15747663429.288601,40606747238.219503,3710540,1091234,2302267,7104041
2020-04-20,NYSE American (A),11993240,33121061,7771242,52885543,342118106.837200,309745452.631800,248943415.831700,900806975.300700,163139,100258,101080,364477
2020-04-20,NASDAQ BX (B),46298233,36813342,28857565,111969140,1323368550.818600,1222831210.122400,1237919520.454800,3784119281.395800,426021,167920,259026,852967
2020-04-20,NYSE National (C),82161344,63444436,29449277,175055057,1246855786.499700,1367614291.984500,718977121.391800,3333447199.876000,748739,216933,318344,1284016
2020-04-20,FINRA / Nasdaq TRF Chicago (DB),9566651,9396212,7352919,26315782,286833893.100400,203058582.078800,569318693.390600,1059211168.569800,31951,13021,35769,80741
2020-04-20,FINRA / NYSE TRF (DN),410125551,361963352,500668915,1272757818,9319618127.319299,7005867763.837098,16038889981.671494,32364375872.827891,1760474,775552,1572896,4108922
2020-04-20,FINRA / Nasdaq TRF Carteret (DQ),1676846540,1281766949,1239951806,4198565295,51949085663.785299,35495508578.909591,53699405664.092524,141143999906.787414,6235813,1958585,4160490,12354888
2020-04-20,EDGA Equities (J),91259462,53430115,54138779,198828356,3510225776.191600,1418341900.831400,2822169475.237400,7750737152.260400,1157610,203466,671251,2032327
2020-04-20,EDGX Equities (K),252355591,305618717,289239960,847214268,5886409379.440201,8178161042.898103,7716276900.969004,21780847323.307308,1803245,864943,1330710,3998898
2020-04-20,NYSE Chicago (M),5798395,14536420,4007583,24342398,335678398.486900,915825935.835000,268089409.092000,1519593743.413900,8294,1631,5271,15196
2020-04-20,NYSE (N),1087749878,64818290,44664649,1197232817,36130277737.457597,2618502594.672800,1705957324.494801,40454737656.625198,4121082,180334,345263,4646679
2020-04-20,NYSE Arca (P),314508480,636349820,295958580,1246816880,9013025623.079197,19848550173.355705,12028935228.151702,40890511024.586604,2473947,1482164,2109548,6065659
2020-04-20,NASDAQ (Q),612451603,347293525,948910228,1908655356,19722167533.736097,13849315018.402303,45612710405.634165,79184192957.772565,5705881,1423469,6098185,13227535
2020-04-20,Investors Exchange (V),140330134,55180441,61520054,257030629,5272677876.281401,1458602403.084400,3375092108.019199,10106372387.385000,958002,169486,455891,1583379
2020-04-20,NASDAQ PSX (X),25553318,32634223,17666626,75854167,590322089.440800,1277383160.501300,933077926.592900,2800783176.535000,186482,142733,171193,500408
2020-04-20,BYX Equities (Y),90628243,95375869,77330639,263334751,2233872447.571700,2175260066.724200,1832787128.712100,6241919643.008000,894380,272193,462414,1628987
2020-04-20,BZX Equities (Z),371011561,228944215,219882891,819838667,13023919904.278995,9153208002.067797,11947848746.927100,34124976653.273892,3533710,896214,1990852,6420776
2020-04-17,NYSE American (A),9792152,91743497,5253039,106788688,305395428.457300,496978089.381900,252865087.029400,1055238604.868600,143015,97201,77593,317809
2020-04-17,NASDAQ BX (B),50726696,28187146,30939583,109853425,1483697904.437500,1367851240.475300,1350947169.091800,4202496314.004600,474469,178635,278752,931856
2020-04-17,NYSE National (C),111625955,62549783,39649809,213825547,1700226678.693900,1570129133.642600,1013766892.427400,4284122704.763900,968019,249310,399972,1617301
2020-04-17,FINRA / Nasdaq TRF Chicago (DB),8184917,4779791,8350471,21315179,291244670.975600,209032048.009300,582751765.461700,1083028484.446600,30065,9973,35554,75592
2020-04-17,FINRA / NYSE TRF (DN),427553550,259834237,584875813,1272263600,9941062739.725498,6702287920.713502,16795672854.504309,33439023514.943309,1608480,549789,1524850,3683119
2020-04-17,FINRA / Nasdaq TRF Carteret (DQ),1726651540,869014606,1294033772,3889699918,56303406083.493898,42337835100.629821,59992125775.285921,158633366959.409640,6407324,1612911,4344458,12364693
2020-04-17,EDGA Equities (J),104319746,37658484,70453656,212431886,4334584402.134001,1876189037.040000,3911772466.038700,10122545905.212701,1424816,254877,851787,2531480
2020-04-17,EDGX Equities (K),274403510,189220706,308272048,771896264,6860629847.043601,8207453261.350603,9580854709.338799,24648937817.733003,2031268,709437,1450290,4190995
2020-04-17,NYSE Chicago (M),9857193,24880831,5350392,40088416,662049487.261600,3261222005.729400,598569129.015200,4521840622.006200,14041,1669,7202,22912
2020-04-17,NYSE (N),1389209977,58707915,49824001,1497741893,49086767246.403889,2825200996.588400,2432981956.011600,54344950199.003889,4685475,186380,385724,5257579
2020-04-17,NYSE Arca (P),337852348,459573823,345442711,1142868882,10259562461.678501,21801903774.290702,15015783232.873896,47077249468.843099,2745417,1342354,2385808,6473579
2020-04-17,NASDAQ (Q),670199359,295559954,1164585917,2130345230,22478969800.310394,15735360942.643001,60586222878.468953,98800553621.422348,6249789,1349649,6676261,14275699
2020-04-17,Investors Exchange (V),156951332,29087194,72373250,258411776,5654755019.176200,1547951178.374400,4439182417.119500,11641888614.670100,1031368,128413,537913,1697694
2020-04-17,NASDAQ PSX (X),24841607,28232248,18780299,71854154,621036816.444800,1540932602.882900,1267327904.844900,3429297324.172600,185338,141828,181939,509105
2020-04-17,BYX Equities (Y),98807365,71529039,103009645,273346049,2548263446.745200,2419281596.118900,2287885082.351799,7255430125.215899,1029611,265330,553114,1848055
2020-04-17,BZX Equities (Z),403837908,177265641,247119388,828222937,15157876270.985398,10148827131.165998,15758954064.194199,41065657466.345595,4009413,855423,2236594,7101430
2020-04-16,NYSE American (A),9325485,25949681,5336056,40611222,312577338.372400,317860065.206400,264013413.436900,894450817.015700,130700,91824,77059,299583
2020-04-16,NASDAQ BX (B),51567788,25494689,27289654,104352131,1451609690.739400,1255007219.422900,1294917520.255600,4001534430.417900,488502,155753,268306,912561
2020-04-16,NYSE National (C),98627998,57946173,37522786,194096957,1473432969.517400,1590581027.416800,889537082.830700,3953551079.764900,827524,245283,380182,1452989
2020-04-16,FINRA / Nasdaq TRF Chicago (DB),8253012,5738863,8657250,22649125,244508300.558000,189174539.316200,757342273.807900,1191025113.682100,29626,9743,38790,78159
2020-04-16,FINRA / NYSE TRF (DN),367124344,238062307,552478746,1157665397,8829163136.698402,6650781791.561304,20957000584.402602,36436945512.662308,1597831,523912,1533328,3655071
2020-04-16,FINRA / Nasdaq TRF Carteret (DQ),1627899120,873251293,1273333961,3774484374,54492432241.767930,37027990438.050809,66719215059.636341,158239637739.455080,6204621,1553182,4334592,12092395
2020-04-16,EDGA Equities (J),101949397,40771606,68286939,211007942,3970068903.898401,1874628453.303399,3770179614.686800,9614876971.888600,1364647,255711,826966,2447324
2020-04-16,EDGX Equities (K),252428093,195297561,283722959,731448613,6473924067.140700,8654935524.272796,10901337643.416694,26030197234.830190,1940609,768557,1555623,4264789
2020-04-16,NYSE Chicago (M),8973220,20035657,5358713,34367590,602908964.583200,2875294377.937800,1046644148.327500,4524847490.848500,12634,1211,8726,22571
2020-04-16,NYSE (N),1112620996,58006766,48941979,1219569741,38787979719.893302,2762284094.725500,2379140016.792900,43929403831.411702,4509215,185762,390086,5085063
2020-04-16,NYSE Arca (P),318030504,440075605,321816663,1079922772,10005291315.441999,21056869416.102493,16487575412.111691,47549736143.656183,2647732,1369348,2467136,6484216
2020-04-16,NASDAQ (Q),619738191,276357387,1002088777,1898184355,21429309366.019601,15305787685.404890,55619960567.528508,92355057618.952999,5885709,1338162,6679008,13902879
2020-04-16,Investors Exchange (V),148847980,27220642,67147929,243216551,5476355624.495000,1394649382.434100,4111158309.233800,10982163316.162900,983764,115022,484112,1582898
2020-04-16,NASDAQ PSX (X),23474458,27521861,17684889,68681208,562729654.572300,1341437441.606500,1262218457.339700,3166385553.518500,182345,137774,187995,508114
2020-04-16,BYX Equities (Y),95238440,59994310,90091016,245323766,2430353629.371300,2104232247.756000,2213846824.253200,6748432701.380500,1008905,233329,526255,1768489
2020-04-16,BZX Equities (Z),384718909,183542159,248048383,816309451,14878330608.979798,10577832560.219696,17254954965.728893,42711118134.928387,4007519,906614,2579818,7493951
2020-04-15,NYSE American (A),9706285,28923732,5732092,44362109,328801562.020800,331648750.102200,240652625.951700,901102938.074700,147188,96047,81255,324490
2020-04-15,NASDAQ BX (B),49326396,29471968,25687160,104485524,1392287536.436900,1301426984.975099,1153174346.857800,3846888868.269799,480845,157639,260111,898595
2020-04-15,NYSE National (C),94891985,55298980,35889536,186080501,1469503291.976100,1313736801.248100,844119329.750000,3627359422.974200,827853,224559,393416,1445828
2020-04-15,FINRA / Nasdaq TRF Chicago (DB),9291233,5586196,6678553,21555982,263811847.341500,188230830.962800,606056146.169500,1058098824.473800,31967,11110,32810,75887
2020-04-15,FINRA / NYSE TRF (DN),372350372,229225336,365755017,967330725,8509169196.329002,6482538165.386896,16094689343.653778,31086396705.369676,1632307,525006,1324162,3481475
2020-04-15,FINRA / Nasdaq TRF Carteret (DQ),1651814874,823117488,1107953377,3582885739,51055257864.020375,34130984316.431408,53517978093.838614,138704220274.290397,6305284,1710659,3995888,12011831
2020-04-15,EDGA Equities (J),99918366,43400651,57193266,200512283,3834870838.368100,1712940661.498100,3203599722.213700,8751411222.079900,1341567,247002,774993,2363562
2020-04-15,EDGX Equities (K),241493875,193981990,213563598,649039463,5761727369.585400,8165895253.298103,8191064280.256003,22118686903.139506,1871900,750603,1323178,3945681
2020-04-15,NYSE Chicago (M),7868186,33907627,13951024,55726837,291940402.525800,3237412728.915400,1033336200.726000,4562689332.167200,13026,1690,9500,24216
2020-04-15,NYSE (N),1119046488,53631111,46288249,1218965848,36649564311.712195,2594046500.177700,1990621866.053200,41234232677.943095,4570307,188744,374605,5133656
2020-04-15,NYSE Arca (P),301122229,410588743,259162402,970873374,8847343287.311803,19037850809.223994,12451238047.134095,40336432143.669892,2538944,1314279,2188451,6041674
2020-04-15,NASDAQ (Q),621413333,271974522,866463336,1759851191,20451516076.842803,14233508418.741801,46174871070.328833,80859895565.913437,6055262,1338164,6174693,13568119
2020-04-15,Investors Exchange (V),144757529,27376014,60007927,232141470,5071187859.836300,1392860097.657900,3183366199.655200,9647414157.149400,971912,123732,457719,1553363
2020-04-15,NASDAQ PSX (X),22671867,28704223,15760807,67136897,568958370.557300,1520216326.652400,996247312.278100,3085422009.487800,178704,146245,156939,481888
2020-04-15,BYX Equities (Y),98638261,69593263,68222796,236454320,2416155505.864300,2347451990.632800,1937367320.515600,6700974817.012700,1047642,264623,498390,1810655
2020-04-15,BZX Equities (Z),363691579,171086482,199619556,734397617,13112096998.035002,9554498108.954798,13618427724.413598,36285022831.403398,3791188,854420,2140011,6785619
2020-04-14,NYSE American (A),10113997,30054150,5692300,45860447,293000958.844100,406929011.160500,268109245.318100,968039215.322700,122097,102292,71193,295582
2020-04-14,NASDAQ BX (B),61493557,34883321,30219883,126596761,1535282479.341700,1678401810.065000,1398706051.947100,4612390341.353800,503268,169482,287628,960378
2020-04-14,NYSE National (C),109458502,62928737,35374845,207762084,1634792712.120600,1595273112.533300,904232238.429200,4134298063.083100,878368,245555,352246,1476169
2020-04-14,FINRA / Nasdaq TRF Chicago (DB),9635106,6551907,7118223,23305236,259339392.519400,215033248.025800,706803820.187300,1181176460.732500,31619,12308,38507,82434
2020-04-14,FINRA / NYSE TRF (DN),446988761,259666660,438279094,1144934515,9420717555.705102,7110858818.482496,18399326911.411510,34930903285.599108,1626261,541258,1465781,3633300
2020-04-14,FINRA / Nasdaq TRF Carteret (DQ),1789175404,996067192,1296421234,4081663830,55381249428.790420,45095578904.287396,64616014509.769495,165092842842.847311,6496156,1829483,4470055,12795694
2020-04-14,EDGA Equities (J),106335786,46533431,58338433,211207650,4147437493.176500,2101792190.920600,3658628539.815901,9907858223.913001,1356862,280058,768602,2405522
2020-04-14,EDGX Equities (K),273565233,197224005,243003008,713792246,6360262234.931998,8961339073.851803,9927626320.576201,25249227629.360002,1906576,783659,1429877,4120112
2020-04-14,NYSE Chicago (M),9911918,29891863,5994263,45798044,723562344.385500,2590469664.117699,762258423.497500,4076290432.000699,19297,1518,10804,31619
2020-04-14,NYSE (N),1159393370,60748381,50296548,1270438299,39145313184.549098,2946125173.346399,2572499100.545600,44663937458.441097,4599572,192604,398003,5190179
2020-04-14,NYSE Arca (P),339695644,441819101,298474083,1079988828,10160669802.117601,21538504582.956098,15940930012.103612,47640104397.177311,2640336,1433330,2372986,6446652
2020-04-14,NASDAQ (Q),648855811,291178861,925361461,1865396133,21352121989.119707,15765937529.647009,53823168042.892880,90941227561.659596,5954169,1429062,6228020,13611251
2020-04-14,Investors Exchange (V),143322069,31540033,69206403,244068505,5446354699.780700,1750865493.180400,4375186266.058000,11572406459.019100,992592,134395,519211,1646198
2020-04-14,NASDAQ PSX (X),25471820,28864142,18009965,72345927,640348282.576200,1559717941.890300,1282064793.638700,3482131018.105200,191238,141679,186337,519254
2020-04-14,BYX Equities (Y),102874305,74763437,66984647,244622389,2604682513.091800,2658436619.507200,2182886950.312500,7446006082.911500,1054457,276382,523070,1853909
2020-04-14,BZX Equities (Z),379442986,189326735,218644723,787414444,13751001470.740000,10909709148.189203,15771499355.028613,40432209973.957816,3644533,914913,2098971,6658417
2020-04-13,NYSE American (A),8875976,26111631,4866010,39853617,238845247.356000,330832902.766900,205269578.798800,774947728.921700,116810,94684,61469,272963
2020-04-13,NASDAQ BX (B),50321213,25643819,29165683,105130715,1203088052.336700,1498862440.723100,1138025582.203200,3839976075.263000,445767,175287,266415,887469
2020-04-13,NYSE National (C),93717412,44933687,31654120,170305219,1300140122.853400,1245463084.974800,720424438.094500,3266027645.922700,780001,208033,326903,1314937
2020-04-13,FINRA / Nasdaq TRF Chicago (DB),10319897,3903814,6315079,20538790,240612222.477900,150299974.309700,569713852.478600,960626049.266200,32173,9924,32355,74452
2020-04-13,FINRA / NYSE TRF (DN),448109679,241899009,352363978,1042372666,8305047503.144204,7835198858.807296,14829394628.636702,30969640990.588202,1778915,689129,1325195,3793239
2020-04-13,FINRA / Nasdaq TRF Carteret (DQ),1651657074,936317654,1047738555,3635713283,46221005651.777290,41391982803.780823,48477109449.439603,136090097904.997716,6227308,1839250,3931378,11997936
2020-04-13,EDGA Equities (J),89473079,35337078,50785883,175596040,3293487392.964500,1854369172.225300,2840724458.052598,7988581023.242398,1201526,253796,672344,2127666
2020-04-13,EDGX Equities (K),266022862,188984018,209045116,664051996,5345255486.393300,8647226316.397302,7354257337.719800,21346739140.510402,1831175,820877,1261626,3913678
2020-04-13,NYSE Chicago (M),6773755,11524343,3859418,22157516,306562443.444000,1498357849.832000,477366084.444700,2282286377.720700,14559,1422,10135,26116
2020-04-13,NYSE (N),1162457820,57163944,44003077,1263624841,36690568201.668693,2838609934.783800,1838004922.568700,41367183059.021193,4552393,198637,355773,5106803
2020-04-13,NYSE Arca (P),305462235,433992207,253899696,993354138,7821071392.263302,21137020492.412490,11525800041.484103,40483891926.159895,2407556,1431663,2087326,5926545
2020-04-13,NASDAQ (Q),623976420,284409624,836590715,1744976759,19084022263.127800,15126495010.829403,42992919338.317596,77203436612.274799,5887887,1489576,5920288,13297751
2020-04-13,Investors Exchange (V),125114071,25706282,56410666,207231019,4302055549.348500,1338844692.149500,2946037044.305100,8586937285.803100,925160,114557,465541,1505258
2020-04-13,NASDAQ PSX (X),23519919,28615668,15437204,67572791,512837820.048900,1496408879.784900,946887188.544300,2956133888.378100,167686,167313,153578,488577
2020-04-13,BYX Equities (Y),89818748,60577464,53476235,203872447,2121534037.875100,2199830395.662899,1984042992.641401,6305407426.179400,948465,260981,476457,1685903
2020-04-13,BZX Equities (Z),363917855,176712489,189055715,729686059,12051557548.561300,9756886247.342801,11348130246.324698,33156574042.228799,3536588,913028,1848460,6298076
2020-04-09,NYSE American (A),12637771,30849553,6173802,49661126,366779360.774100,479630763.568200,258845708.129700,1105255832.472000,181571,123687,91742,397000
2020-04-09,NASDAQ BX (B),81367611,47062603,34786916,163217130,1842140984.638800,2290490247.158599,1500239149.086000,5632870380.883399,633546,310229,351893,1295668
2020-04-09,NYSE National (C),138893292,73032675,43928317,255854284,1914689414.530100,1802786123.997100,990744292.946200,4708219831.473400,1142592,311639,456718,1910949
2020-04-09,FINRA / Nasdaq TRF Chicago (DB),15777117,6547360,7404741,29729218,348920575.081800,261690353.550600,415774052.769400,1026384981.401800,45274,14421,31665,91360
2020-04-09,FINRA / NYSE TRF (DN),691418335,317916534,415879382,1425214251,11919348348.497100,9810508696.041595,13626292305.995098,35356149350.533793,2092048,670266,1325707,4088021
2020-04-09,FINRA / Nasdaq TRF Carteret (DQ),2492827638,1437742669,1422978357,5353548664,69071154336.264989,69712182337.910589,62776402753.598076,201559739427.773654,8462914,2371798,4650762,15485474
2020-04-09,EDGA Equities (J),132440664,63148312,66979078,262568054,4817460424.608400,3072760621.907599,3707313799.474200,11597534845.990199,1750711,406345,920034,3077090
2020-04-09,EDGX Equities (K),383983943,290537269,249055922,923577134,7962462695.546499,13708262508.944000,8592452984.073698,30263178188.564197,2611289,1203680,1553120,5368089
2020-04-09,NYSE Chicago (M),8676141,19245281,4771427,32692849,354562348.509200,2823091409.391200,828299890.829600,4005953648.730000,19749,2075,10537,32361
2020-04-09,NYSE (N),1506629403,95126908,62372244,1664128555,46804866520.358898,4387683896.650198,2514958141.759900,53707508558.768996,6897509,330254,494524,7722287
2020-04-09,NYSE Arca (P),506426076,651975682,335551248,1493953006,13254489675.744502,32267412450.361798,15099340467.504496,60621242593.610796,4033578,2188562,2860545,9082685
2020-04-09,NASDAQ (Q),987881679,472281583,1037348594,2497511856,30494874464.336506,24728629958.220687,51174704455.385501,106398208877.942694,9229328,2338128,7665017,19232473
2020-04-09,Investors Exchange (V),188133289,45615070,74687706,308436065,6540479923.264199,2555166424.904100,3872791029.634901,12968437377.803200,1235123,176228,577819,1989170
2020-04-09,NASDAQ PSX (X),33923937,41187941,21013400,96125278,807579567.731100,1969050019.948500,1274391328.340600,4051020916.020200,229405,223589,203377,656371
2020-04-09,BYX Equities (Y),137813323,97642384,78768393,314224100,3259556794.878000,3591475958.315501,2551472233.934600,9402504987.128101,1418969,396618,650887,2466474
2020-04-09,BZX Equities (Z),580724332,302220355,283760865,1166705552,19894696268.416911,16982670224.017202,16046542138.363796,52923908630.797909,5664834,1486495,2744490,9895819
2020-04-08,NYSE American (A),10592652,22505975,5398413,38497040,329266452.749700,322508354.898200,209975139.843200,861749947.491100,141341,89856,76217,307414
2020-04-08,NASDAQ BX (B),60507950,30681637,28346082,119535669,1580968634.307000,1532822490.871300,1161726804.465700,4275517929.644000,568052,214483,301966,1084501
2020-04-08,NYSE National (C),117599698,58692792,39658803,215951293,1627938830.766000,1421263410.171900,835778736.482000,3884980977.419900,971437,243993,405592,1621022
2020-04-08,FINRA / Nasdaq TRF Chicago (DB),10846431,3379718,6833792,21059941,270923271.901300,183149581.401100,404329843.657400,858402696.959800,34398,9135,27478,71011
2020-04-08,FINRA / NYSE TRF (DN),458773106,215369836,364939924,1039082866,9133173097.765200,7697862877.680400,12634667634.524600,29465703609.970200,1507208,485799,1152001,3145008
2020-04-08,FINRA / Nasdaq TRF Carteret (DQ),1825330802,850760146,1132801488,3808892436,52135546859.257002,42175374393.819482,47635557605.560387,141946478858.636871,6577903,1662380,4016189,12256472
2020-04-08,EDGA Equities (J),108575840,42191182,60529434,211296456,3989351789.485400,1987162414.779900,3081347697.647900,9057861901.913200,1459382,288877,803352,2551611
2020-04-08,EDGX Equities (K),271774695,184180853,215732675,671688223,6149282235.494596,9461221713.680198,7128859608.312500,22739363557.487294,2049641,806767,1345506,4201914
2020-04-08,NYSE Chicago (M),7604075,10177298,7069703,24851076,254383278.739300,1435086309.692300,705078025.049800,2394547613.481400,18090,1914,8635,28639
2020-04-08,NYSE (N),1211847749,67361552,50674121,1329883422,39658891075.232201,3181516631.879100,2002151161.026900,44842558868.138201,5501717,229978,419845,6151540
2020-04-08,NYSE Arca (P),361017104,438889710,278550921,1078457735,10146884995.407301,23285454045.651099,11932347254.532402,45364686295.590802,3138386,1557022,2423766,7119174
2020-04-08,NASDAQ (Q),727505725,307878087,914484240,1949868052,24002922755.549995,17238386240.194302,46174942191.246915,87416251186.991212,7271743,1599383,6792065,15663191
2020-04-08,Investors Exchange (V),157881648,26849509,70573714,255304871,5234614712.058900,1559456548.006799,3399706327.049600,10193777587.115299,984340,114311,504322,1602973
2020-04-08,NASDAQ PSX (X),24000111,29089423,17023219,70112753,625602292.927600,1437084159.931900,1070605494.934400,3133291947.793900,179579,163905,164945,508429
2020-04-08,BYX Equities (Y),99987164,67172015,74293410,241452589,2519090437.714800,2292388103.497000,2015703084.064100,6827181625.275900,1101056,263292,569346,1933694
2020-04-08,BZX Equities (Z),421867244,187441983,220534945,829844172,15134438171.091301,11364330874.624101,12710428328.880305,39209197374.595707,4383453,962161,2304335,7649949
2020-04-07,NYSE American (A),13418146,27569997,7546333,48534476,399547631.496600,467617077.621500,345674755.781900,1212839464.900000,187248,120421,98270,405939
2020-04-07,NASDAQ BX (B),68807863,36789420,35025989,140623272,1749111746.367700,1816438068.404701,1487080753.464900,5052630568.237301,616699,257743,347181,1221623
2020-04-07,NYSE National (C),128902750,58839758,45466002,233208510,1789804160.985900,1594037518.946300,1065365348.928100,4449207028.860300,1083539,303808,451306,1838653
2020-04-07,FINRA / Nasdaq TRF Chicago (DB),13922011,4131525,8732369,26785905,387704420.139300,238620611.621400,618589154.024300,1244914185.785000,47265,11690,39571,98526
2020-04-07,FINRA / NYSE TRF (DN),515208539,246528303,374427003,1136163845,10666307964.527698,8509906166.519500,15286451557.988209,34462665689.035407,1738412,585398,1289491,3613301
2020-04-07,FINRA / Nasdaq TRF Carteret (DQ),2150900247,1023279909,1351449678,4525629834,62316800296.308224,50668092068.451604,63354783787.465250,176339676152.225078,7774722,2067798,4751570,14594090
2020-04-07,EDGA Equities (J),123525649,52438600,69580329,245544578,4353131013.774001,2663734648.719500,3817624662.101200,10834490324.594701,1664111,376758,915171,2956040
2020-04-07,EDGX Equities (K),324781894,234034031,240107870,798923795,7167440190.182497,12308547867.830798,8993419092.527993,28469407150.541288,2454200,1049967,1559639,5063806
2020-04-07,NYSE Chicago (M),10384756,9018340,4065785,23468881,339549126.635700,1447822689.400900,425496377.654800,2212868193.691400,18766,2123,10985,31874
2020-04-07,NYSE (N),1480501383,79726327,62384765,1622612475,44444553501.837001,3644276104.688101,2696313749.672000,50785143356.197102,6719934,276128,495407,7491469
2020-04-07,NYSE Arca (P),442516586,549867123,333732568,1326116277,11826168634.407192,29490660186.908199,15487011019.596207,56803839840.911598,3738732,1912449,2760861,8412042
2020-04-07,NASDAQ (Q),890097392,379359905,1100180161,2369637458,27079629382.185697,22067301764.718092,55584641485.236822,104731572632.140611,8664426,2109273,8002664,18776363
2020-04-07,Investors Exchange (V),182695428,34829012,82741392,300265832,6589152416.832401,1975400832.499101,4266359717.421600,12830912966.753102,1160349,148865,571014,1880228
2020-04-07,NASDAQ PSX (X),29840103,32941035,21866714,84647852,809431115.921100,1612296674.958900,1420103082.748500,3841830873.628500,220762,172709,193765,587236
2020-04-07,BYX Equities (Y),126440375,82808655,79513247,288762277,2975331082.490500,2880721023.180300,2608516771.333801,8464568877.004601,1367037,333175,661181,2361393
2020-04-07,BZX Equities (Z),548470102,250650216,269141797,1068262115,18807819192.413997,15739310373.743592,16585702810.991997,51132832377.149586,5536883,1352722,2757161,9646766
2020-04-06,NYSE American (A),11013856,22634225,5943979,39592060,338473830.037700,433855944.691700,269075462.924300,1041405237.653700,153701,103280,82360,339341
2020-04-06,NASDAQ BX (B),63211467,32694084,41513088,137418639,1675730685.941800,1663693449.012899,1433996924.689200,4773421059.643899,582122,221007,347776,1150905
2020-04-06,NYSE National (C),120476689,65469853,42159244,228105786,1638837075.035700,1683287537.529000,912169860.893600,4234294473.458300,992321,255234,411137,1658692
2020-04-06,FINRA / Nasdaq TRF Chicago (DB),10620662,3308749,6726089,20655500,257976850.226800,184591559.031600,417441091.680000,860009500.938400,34119,9613,30866,74598
2020-04-06,FINRA / NYSE TRF (DN),447937359,214813881,372759552,1035510792,9252306664.253395,7266700754.103595,13181034496.167997,29700041914.524987,1685980,561362,1324269,3571611
2020-04-06,FINRA / Nasdaq TRF Carteret (DQ),1982602453,846609774,1206165265,4035377492,57962169796.286386,43251286107.643832,55668704961.886687,156882160865.816905,7246985,1783313,4478351,13508649
2020-04-06,EDGA Equities (J),119044186,46254604,66713455,232012245,4418184575.121700,2554633820.113401,3548808592.863899,10521626988.099000,1557074,327225,865273,2749572
2020-04-06,EDGX Equities (K),277321555,206811663,239610662,723743880,6386416241.871601,10843589653.480905,8549984782.174593,25779990677.527099,2160631,913145,1517817,4591593
2020-04-06,NYSE Chicago (M),7117732,12430008,5960936,25508676,316451746.997500,1585043007.220000,926854115.399300,2828348869.616800,16160,1265,10888,28313
2020-04-06,NYSE (N),1430537323,63320573,56118244,1549976140,48672020674.537605,3176627390.303101,2455527070.372800,54304175135.213506,5888682,220424,466162,6575268
2020-04-06,NYSE Arca (P),395760291,518495211,333156986,1247412488,11080731582.302303,26907199359.423379,14175310029.107492,52163240970.833174,3348293,1668221,2643772,7660286
2020-04-06,NASDAQ (Q),774378400,332766716,1068599004,2175744120,24415761309.645802,19164943674.801102,58295890991.733563,101876595976.180467,7527668,1711419,7349193,16588280
2020-04-06,Investors Exchange (V),171837294,29850455,73843973,275531722,6175308755.695700,1753829996.113300,3739249995.494000,11668388747.303000,1112367,136753,550186,1799306
2020-04-06,NASDAQ PSX (X),26894035,28068181,18935544,73897760,735504098.145100,1417177620.397200,1312693708.385800,3465375426.928100,204383,148720,181467,534570
2020-04-06,BYX Equities (Y),114851882,72509111,71132981,258493974,2748148944.795700,2953433298.941600,2375992536.269800,8077574780.007100,1174199,312291,593835,2080325
2020-04-06,BZX Equities (Z),450236375,220785208,239792585,910814168,16355929952.657201,13444527518.654696,14870296147.057301,44670753618.369198,4655732,1119566,2486130,8261428
2020-04-03,NYSE American (A),12667170,26949052,5336003,44952225,349394089.924400,352148390.338700,226433115.526900,927975595.790000,159687,109504,72936,342127
2020-04-03,NASDAQ BX (B),65191221,33111110,35812166,134114497,1389967380.544300,1414813442.282799,1109143121.827700,3913923944.654799,571800,281836,303354,1156990
2020-04-03,NYSE National (C),114697848,60734504,36746633,212178985,1389944448.678300,1385585814.906600,719723931.906700,3495254195.491600,965356,256372,367963,1589691
2020-04-03,FINRA / Nasdaq TRF Chicago (DB),9284355,3480985,6257441,19022781,204304469.255500,178956717.219400,417040412.291700,800301598.766600,27746,9540,27816,65102
2020-04-03,FINRA / NYSE TRF (DN),393533649,215328793,322931562,931794004,6930725644.223505,6509773172.237799,11258608190.459607,24699107006.920911,1393079,485964,1070820,2949863
2020-04-03,FINRA / Nasdaq TRF Carteret (DQ),1873511501,831400530,1060855654,3765767685,46537125999.719179,33295572853.875618,44226194977.109795,124058893830.704592,6629986,1724833,3845845,12200664
2020-04-03,EDGA Equities (J),112929281,46539831,56950365,216419477,3366694687.490300,1970982991.549500,2661923906.683700,7999601585.723500,1463730,310325,754181,2528236
2020-04-03,EDGX Equities (K),281374856,194651860,208378786,684405502,5290009896.780399,7761109485.676300,6625648922.215099,19676768304.671798,2137783,872546,1336615,4346944
2020-04-03,NYSE Chicago (M),8467221,12834941,6235721,27537883,480147009.770200,1491398585.690800,707258863.785300,2678804459.246300,15069,1021,9101,25191
2020-04-03,NYSE (N),1434466549,60063771,46133671,1540663991,37637813964.609495,2511347093.966200,1659800262.150400,41808961320.726095,5356107,216404,403980,5976491
2020-04-03,NYSE Arca (P),347125838,454304217,244926283,1046356338,8480368554.680603,20975031131.394593,10286549676.204896,39741949362.280092,3129028,1580846,2271894,6981768
2020-04-03,NASDAQ (Q),720272382,330560106,915448045,1966280533,19933007961.890598,16978039087.919899,42086004478.965590,78997051528.776087,7046270,1736210,6451516,15233996
2020-04-03,Investors Exchange (V),170438987,29651300,69265622,269355909,5237096140.887400,1389861268.871400,3275197162.471000,9902154572.229800,1064279,125824,500620,1690723
2020-04-03,NASDAQ PSX (X),27054653,26313636,16507085,69875374,584093616.538600,1089883569.482600,937919035.679500,2611896221.700700,199118,157380,165240,521738
2020-04-03,BYX Equities (Y),116099396,66292736,57900025,240292157,2357375449.116200,2212425923.644799,1724709464.291700,6294510837.052699,1174530,289225,523444,1987199
2020-04-03,BZX Equities (Z),409861050,198103271,204576492,812540813,12626615994.712401,10632634018.837298,11334728125.603805,34593978139.153504,4255562,1059414,2125807,7440783
2020-04-02,NYSE American (A),12920682,25580089,5754959,44255730,391384252.561700,340836863.543200,233795268.913800,966016385.018700,169792,109770,78030,357592
2020-04-02,NASDAQ BX (B),75074016,44278761,33555403,152908180,1615283941.974700,1691443305.283200,1229781519.572100,4536508766.830000,618287,309959,345413,1273659
2020-04-02,NYSE National (C),110491293,84133078,35329857,229954228,1458101130.508200,1543305632.346000,797996308.386800,3799403071.241000,907757,288362,349023,1545142
2020-04-02,FINRA / Nasdaq TRF Chicago (DB),10732781,6899529,7201209,24833519,230903228.526700,237768220.928000,407514498.807200,876185948.261900,34866,14473,32182,81521
2020-04-02,FINRA / NYSE TRF (DN),422353729,292289831,342862128,1057505688,7505412255.851300,7397057657.053198,12227906750.033493,27130376662.937991,1380443,452922,1115689,2949054
2020-04-02,FINRA / Nasdaq TRF Carteret (DQ),2014487061,1021841718,1158387500,4194716279,53294023165.788502,39269089309.575888,49271533932.028684,141834646407.393074,7114846,2072569,4173634,13361049
2020-04-02,EDGA Equities (J),129497930,64985297,65137633,259620860,3846441711.660300,2476761210.553000,3032595606.515499,9355798528.728799,1503972,397978,835864,2737814
2020-04-02,EDGX Equities (K),310529329,255896402,238599651,805025382,6291293652.850999,9316636271.113201,8293140995.834504,23901070919.798704,2205137,1038990,1511895,4756022
2020-04-02,NYSE Chicago (M),9134500,12306932,5009784,26451216,428232885.612700,1058810346.990000,542311807.602500,2029355040.205200,19386,1378,13803,34567
2020-04-02,NYSE (N),1344689523,75980521,49207078,1469877122,38807603523.847103,3020551156.614200,1926369461.323100,43754524141.784403,5878106,272841,431568,6582515
2020-04-02,NYSE Arca (P),394300959,589966656,276061052,1260328667,9977963219.458598,25541405147.298603,12107875570.131797,47627243936.888998,3235122,1814392,2395237,7444751
2020-04-02,NASDAQ (Q),807388410,419380587,1004138394,2230907391,23723675950.443398,20609574840.841695,46324600085.418705,90657850876.703798,7487529,2100268,7279303,16867100
2020-04-02,Investors Exchange (V),191408527,36526853,80285423,308220803,5627398465.997201,1726822816.818400,3486911891.780200,10841133174.595801,1201909,154694,569808,1926411
2020-04-02,NASDAQ PSX (X),28380190,30661302,16171386,75212878,705160184.750800,1366323004.036200,893310676.737300,2964793865.524300,204495,199983,165083,569561
2020-04-02,BYX Equities (Y),131129390,101185017,68205363,300519770,2798571471.879300,2792023834.166201,2071263482.533500,7661858788.579001,1246277,347643,582986,2176906
2020-04-02,BZX Equities (Z),471681402,249271006,236272679,957225087,15579946942.086098,13552508505.998598,13048515147.467201,42180970595.551897,4684937,1266332,2530044,8481313
2020-04-01,NYSE American (A),11747760,26506678,5917742,44172180,336962606.753700,394984326.248900,257868201.763300,989815134.765900,156776,112832,82803,352411
2020-04-01,NASDAQ BX (B),72570148,30459732,41988795,145018675,1605088202.846900,1644678970.979899,1314759786.744700,4564526960.571499,611368,220415,353020,1184803
2020-04-01,NYSE National (C),104456619,51448749,33403322,189308690,1425795515.370500,1389294077.876400,816428503.345700,3631518096.592600,849108,241404,345716,1436228
2020-04-01,FINRA / Nasdaq TRF Chicago (DB),8635837,3513667,6761123,18910627,233105754.614900,195765462.207600,405982115.879400,834853332.701900,36706,12098,31292,80096
2020-04-01,FINRA / NYSE TRF (DN),369765461,210833793,355185357,935784611,7540499457.340899,6845220513.228298,11975932992.910397,26361652963.479594,1456463,465629,1168516,3090608
2020-04-01,FINRA / Nasdaq TRF Carteret (DQ),1784205763,915925023,1160222599,3860353385,49826900015.052696,51124158544.377707,48080461344.040304,149031519903.470707,7262590,1940168,4429348,13632106
2020-04-01,EDGA Equities (J),129835713,47083707,68394504,245313924,4140720138.714500,2314548790.207799,3301841627.093000,9757110556.015299,1612309,337407,898458,2848174
2020-04-01,EDGX Equities (K),287710733,208437056,255197020,751344809,6403550903.831802,9245414780.805498,8016477208.971599,23665442893.608899,2339524,927642,1560778,4827944
2020-04-01,NYSE Chicago (M),8094961,9259556,4168930,21523447,497591349.705000,820644486.107900,497001686.314100,1815237522.127000,15772,1878,10601,28251
2020-04-01,NYSE (N),1299523492,61359403,49458420,1410341315,39686694246.209297,3000889713.448200,2164606555.602001,44852190515.259498,6013835,245692,454476,6714003
2020-04-01,NYSE Arca (P),350472577,484788654,286908282,1122169513,9765907573.113800,24989370054.164906,12321866786.858003,47077144414.136709,3283196,1680618,2531145,7494959
2020-04-01,NASDAQ (Q),742364414,330158173,1009170734,2081693321,23330212875.384502,19323087622.295184,47690117034.297547,90343417531.977233,7591577,1787706,7524091,16903374
2020-04-01,Investors Exchange (V),180871867,32065893,83189750,296127510,5923756728.371899,1582797446.616100,3875881768.627402,11382435943.615401,1179696,139674,603254,1922624
2020-04-01,NASDAQ PSX (X),26618155,27025923,18564345,72208423,673842331.590600,1284667821.288400,1033051175.097800,2991561327.976800,202355,170394,196166,568915
2020-04-01,BYX Equities (Y),125995252,74915437,77137392,278048081,2823782159.689000,2663942358.059900,2065161478.482000,7552885996.230900,1265523,312627,622050,2200200
2020-04-01,BZX Equities (Z),461138581,219890086,244374590,925403257,16612696046.126403,12833495145.606601,13839087663.067897,43285278854.800901,5004861,1106201,2710817,8821879
2020-03-31,NYSE American (A),14507765,29109974,6418686,50036425,409019477.872100,444822391.074300,271013368.994700,1124855237.941100,180018,102109,91296,373423
2020-03-31,NASDAQ BX (B),77877199,34631006,39415818,151924023,2082980380.070400,2088644847.976000,1543534789.752400,5715160017.798800,741053,286621,403802,1431476
2020-03-31,NYSE National (C),124164293,56199979,34576396,214940668,1626656903.190000,1513373858.216000,929575351.815400,4069606113.221400,939127,255764,372192,1567083
2020-03-31,FINRA / Nasdaq TRF Chicago (DB),8054743,3003942,5955192,17013877,218948314.180700,171588374.099900,493480712.050700,884017400.331300,29106,9463,30198,68767
2020-03-31,FINRA / NYSE TRF (DN),375356058,239347795,374001661,988705514,8217145109.770598,7512183503.522598,14429030460.440801,30158359073.733997,1326194,446480,1158450,2931124
2020-03-31,FINRA / Nasdaq TRF Carteret (DQ),1828955148,950541060,1237066261,4016562469,54217056956.560404,50312434889.446229,56018041003.378489,160547532849.385122,7128839,1870499,4325413,13324751
2020-03-31,EDGA Equities (J),126379886,50075068,75106144,251561098,4290014582.542200,2576634027.575001,3588503369.368100,10455151979.485301,1690033,358373,961710,3010116
2020-03-31,EDGX Equities (K),284767877,202597002,277365061,764729940,6668193883.007200,9619082571.527803,8452371927.650400,24739648382.185403,2302738,905101,1595319,4803158
2020-03-31,NYSE Chicago (M),9281936,15379877,6313235,30975048,456914909.268100,1578159922.929800,534454508.313400,2569529340.511300,18140,1585,9535,29260
2020-03-31,NYSE (N),1747939221,63871283,55386080,1867196584,59208560907.174997,3132046569.642500,2365630402.704000,64706237879.521497,6006074,254370,503194,6763638
2020-03-31,NYSE Arca (P),371836427,497828460,313096978,1182761865,10832228226.627799,27589343148.496917,14151020217.304098,52572591592.428814,3491050,1695660,2735630,7922340
2020-03-31,NASDAQ (Q),770360711,333627328,1188712163,2292700202,25723631483.873405,18877686801.705796,61920830716.471909,106522149002.051110,7960026,1785424,7535670,17281120
2020-03-31,Investors Exchange (V),190415111,33133265,84972289,308520665,6817334830.939001,1792563041.100200,4599564290.020601,13209462162.059802,1267805,138798,634166,2040769
2020-03-31,NASDAQ PSX (X),28877740,28243160,20004918,77125818,744698534.356100,1464850969.971000,1278461339.360200,3488010843.687300,214359,176906,205759,597024
2020-03-31,BYX Equities (Y),125951881,72126392,90868668,288946941,2897098409.792000,2713691338.187499,2271546264.204900,7882336012.184399,1296210,313938,630995,2241143
2020-03-31,BZX Equities (Z),491493526,227372581,269707420,988573527,18547354863.616201,13648698017.989603,15835316882.139598,48031369763.745402,5286702,1185182,2859373,9331257
2020-03-30,NYSE American (A),12963803,31570665,6369168,50903636,355924809.123500,517908006.627800,281694986.090600,1155527801.841900,186282,124488,95384,406154
2020-03-30,NASDAQ BX (B),64286987,31820972,34669779,130777738,1700703264.540700,1677650249.806099,1473752455.028100,4852105969.374899,603344,301065,344340,1248749
2020-03-30,NYSE National (C),96454402,57664034,32594236,186712672,1320805455.818200,1466791382.478000,771990981.282800,3559587819.579000,796862,265675,338271,1400808
2020-03-30,FINRA / Nasdaq TRF Chicago (DB),7981857,4365865,5754294,18102016,225422099.904700,171768305.882500,406265187.411900,803455593.199100,33408,11129,29423,73960
2020-03-30,FINRA / NYSE TRF (DN),384303569,277042648,401962124,1063308341,9060911155.970904,8439680750.841102,13172955324.591495,30673547231.403501,1445600,491878,1180591,3118069
2020-03-30,FINRA / Nasdaq TRF Carteret (DQ),1797050908,1010747626,1223671205,4031469739,54759847618.375784,47002926260.765890,51063689429.568985,152826463308.710659,7093419,2000218,4238607,13332244
2020-03-30,EDGA Equities (J),115163921,51374862,71379845,237918628,3932024226.412900,2450505720.988700,3256736181.284801,9639266128.686401,1493831,382953,863830,2740614
2020-03-30,EDGX Equities (K),272464878,208502685,281109916,762077479,6441336193.477999,8571295778.233195,7480591538.756800,22493223510.467994,2176761,908570,1447692,4533023
2020-03-30,NYSE Chicago (M),7187387,19668382,5433658,32289427,298457544.377500,3214052538.367000,594972797.344900,4107482880.089400,17293,1600,10518,29411
2020-03-30,NYSE (N),1242736937,57463705,47325568,1347526210,40227838616.049902,2840822546.173900,2096279731.866500,45164940894.090302,5869011,253617,452512,6575140
2020-03-30,NYSE Arca (P),333223707,498650894,300365733,1132240334,10134204683.095703,24165021045.040015,12100203548.625594,46399429276.761312,3302886,1712248,2472134,7487268
2020-03-30,NASDAQ (Q),679897079,367788516,1018671272,2066356867,23052882172.237503,19485478358.149907,49070671010.030812,91609031540.418222,7223509,1967279,6979027,16169815
2020-03-30,Investors Exchange (V),185533407,32931822,84887182,303352411,6352540481.833801,1758135371.631500,4220623664.513900,12331299517.979201,1241216,145391,628191,2014798
2020-03-30,NASDAQ PSX (X),22926039,26165445,16732027,65823511,676893513.696300,1421740664.472200,1007839510.319500,3106473688.488000,176886,186148,164293,527327
2020-03-30,BYX Equities (Y),106371008,76357081,91518173,274246262,2308172935.846900,2469655303.045900,1750764647.272900,6528592886.165700,1087702,312301,530598,1930601
2020-03-30,BZX Equities (Z),422577040,218227045,248327579,889131664,15566595275.530601,12198753260.425595,13284217863.714304,41049566399.670500,4580296,1187957,2393241,8161494
2020-03-27,NYSE American (A),13983635,27403455,7671412,49058502,441232386.770600,399782745.540900,334986474.323300,1176001606.634800,193560,108118,109725,411403
2020-03-27,NASDAQ BX (B),76231457,40031776,42317735,158580968,1931695460.450300,2540749840.854500,1751232231.131000,6223677532.435800,669835,321165,410876,1401876
2020-03-27,NYSE National (C),103921275,57613260,34766343,196300878,1448784066.039100,1543588247.374100,850120882.457200,3842493195.870400,900054,295586,364297,1559937
2020-03-27,FINRA / Nasdaq TRF Chicago (DB),8451464,3963213,7081966,19496643,226434146.802400,180054735.699800,419236366.478400,825725248.980600,31034,11665,30064,72763
2020-03-27,FINRA / NYSE TRF (DN),413279796,283791483,381911691,1078982970,8894995561.340594,8859215582.656201,13151947061.356697,30906158205.353492,1533713,533791,1207850,3275354
2020-03-27,FINRA / Nasdaq TRF Carteret (DQ),1881099336,1169344124,1249471127,4299914587,56983791131.297109,57488778007.735215,53659562708.451289,168132131847.483613,7316212,2369625,4535219,14221056
2020-03-27,EDGA Equities (J),120139381,64165945,74124504,258429830,4018686440.224100,3240669996.490500,3416306571.155400,10675663007.870000,1431410,444786,846187,2722383
2020-03-27,EDGX Equities (K),300310845,255893860,262485366,818690071,6847470566.836401,11407386488.897904,8252305513.499898,26507162569.234203,2171608,1150339,1475790,4797737
2020-03-27,NYSE Chicago (M),7971715,19369973,5529262,32870950,300539764.235000,1908552431.081800,627545680.955300,2836637876.272100,18183,1547,10064,29794
2020-03-27,NYSE (N),1356608995,69096835,51796225,1477502055,44496870574.861800,3170465929.612200,2110516604.545100,49777853109.019100,5885118,283029,445333,6613480
2020-03-27,NYSE Arca (P),373209369,637135909,298031319,1308376597,10781219217.116797,31727997152.189110,13528163891.708296,56037380261.014203,3282454,2043086,2517516,7843056
2020-03-27,NASDAQ (Q),755731172,424376856,1102599512,2282707540,24684750295.687790,23216175842.027892,52040506805.422686,99941432943.138368,7322330,2247019,7202272,16771621
2020-03-27,Investors Exchange (V),193705708,41356546,88316024,323378278,6661108062.659399,2316728081.311500,4485714723.830801,13463550867.801700,1287374,183568,658824,2129766
2020-03-27,NASDAQ PSX (X),25941125,31938336,18227976,76107437,705854197.221200,1746632436.328700,1080982219.612200,3533468853.162100,210459,198451,181803,590713
2020-03-27,BYX Equities (Y),117003088,92864200,103540579,313407867,2316109799.408200,3211887525.823698,1949368229.371800,7477365554.603698,1031797,381360,542031,1955188
2020-03-27,BZX Equities (Z),454084173,276925890,261255373,992265436,15929389081.074601,16490248786.524102,14821130541.728997,47240768409.327700,4593452,1491471,2628009,8712932
2020-03-26,NYSE American (A),16226041,26767186,7439548,50432775,463952230.682300,416710593.010400,334149396.988800,1214812220.681500,210983,112429,110886,434298
2020-03-26,NASDAQ BX (B),88605729,40251000,40829175,169685904,2315341267.369100,2610793317.317400,1967209754.009700,6893344338.696200,771749,340483,478043,1590275
2020-03-26,NYSE National (C),127737125,69993974,38968938,236700037,1755788291.900700,1746032268.536600,1065002464.809200,4566823025.246500,1058503,319659,425524,1803686
2020-03-26,FINRA / Nasdaq TRF Chicago (DB),12511281,4312768,7400435,24224484,314260854.105500,291941010.067600,459791753.323200,1065993617.496300,44459,13976,34770,93205
2020-03-26,FINRA / NYSE TRF (DN),573909138,292569201,369432050,1235910389,11775660918.307800,9804751758.871691,15338391877.757097,36918804554.936588,1987059,597849,1377802,3962710
2020-03-26,FINRA / Nasdaq TRF Carteret (DQ),2342037564,1117535944,1281554316,4741127824,71006924496.464969,57899259168.381789,61614014364.707800,190520198029.554558,8530885,2375488,4836215,15742588
2020-03-26,EDGA Equities (J),135214239,63606833,69661983,268483055,4668890767.054100,3473526962.825200,4002879839.685703,12145297569.565003,1624441,494781,901164,3020386
2020-03-26,EDGX Equities (K),390144684,271115736,243062738,904323158,8482728868.194599,13395768261.365000,10006113097.772902,31884610227.332501,2640927,1306191,1636240,5583358
2020-03-26,NYSE Chicago (M),10079761,19373014,6072502,35525277,343104978.151800,2814496451.039000,817745831.387500,3975347260.578300,20645,1549,11611,33805
2020-03-26,NYSE (N),1624433678,82033918,57895677,1764363273,54085148749.271304,3820948357.736500,2548163432.835700,60454260539.843504,7415669,351851,524275,8291795
2020-03-26,NYSE Arca (P),479908872,636034666,302098960,1418042498,13516365132.880301,34462693370.723120,15647576834.171102,63626635337.774523,3983785,2310754,2824515,9119054
2020-03-26,NASDAQ (Q),983614392,488154217,1124776971,2596545580,30801283421.703598,26287298692.658800,62052517910.368990,119141100024.731388,9230952,2599236,8606250,20436438
2020-03-26,Investors Exchange (V),209265023,43008704,91138497,343412224,7793211039.986199,2501213918.294299,5000975841.579797,15295400799.860295,1338974,196179,672394,2207547
2020-03-26,NASDAQ PSX (X),36373712,35356251,22143011,93872974,1016573560.592800,1806649444.103800,1342361067.749700,4165584072.446300,266113,200815,236553,703481
2020-03-26,BYX Equities (Y),135217122,94004319,62287266,291508707,2753047701.018600,3664588159.424200,2341839962.814600,8759475823.257400,1229240,434872,574157,2238269
2020-03-26,BZX Equities (Z),601719444,297081784,289916529,1188717757,20384608530.830995,18608724147.152493,18095290430.082992,57088623108.066480,5785870,1692769,3010582,10489221
2020-03-25,NYSE American (A),18450992,29788194,9028581,57267767,565012651.692500,589978327.336900,381486963.795200,1536477942.824600,236022,139026,124802,499850
2020-03-25,NASDAQ BX (B),103730461,49366505,55385786,208482752,2613976027.632500,3091007321.657499,2258445549.370100,7963428898.660099,905628,347460,556536,1809624
2020-03-25,NYSE National (C),144100629,75911794,44407093,264419516,2036672108.080400,1856336573.019900,1167423355.667700,5060432036.768000,1168959,348591,455626,1973176
2020-03-25,FINRA / Nasdaq TRF Chicago (DB),12585283,5162272,7895885,25643440,362184753.716100,333937478.147000,525458975.242800,1221581207.105900,45156,15421,37873,98450
2020-03-25,FINRA / NYSE TRF (DN),567854740,327536738,428590896,1323982374,12865647195.605501,10952266204.798801,17599259179.698995,41417172580.103297,2037207,636181,1527436,4200824
2020-03-25,FINRA / Nasdaq TRF Carteret (DQ),2438139565,1269154910,1440574298,5147868773,73999483640.158304,65007818004.404871,66276476370.194462,205283778014.757637,9087488,2563687,5447026,17098201
2020-03-25,EDGA Equities (J),143968994,67983765,73838331,285791090,4659520036.660800,3748459381.517099,3988718141.112901,12396697559.290800,1640987,502251,931898,3075136
2020-03-25,EDGX Equities (K),392342637,281553289,294922762,968818688,9296176862.493796,13795131011.425805,11140793745.406204,34232101619.325805,2834257,1461710,1884388,6180355
2020-03-25,NYSE Chicago (M),16991570,26415758,5875165,49282493,661873728.558200,3414176253.086000,625347607.385000,4701397589.029200,25408,2278,13331,41017
2020-03-25,NYSE (N),1813006197,93040527,67888423,1973935147,57644851102.856802,3970659962.397402,2884227614.694100,64499738679.948304,8343351,402773,623241,9369365
2020-03-25,NYSE Arca (P),521635080,709917772,362531704,1594084556,15105509652.036802,37492537531.321794,17628534377.341899,70226581560.700495,4389009,2693514,3237658,10320181
2020-03-25,NASDAQ (Q),1029985881,515772555,1330148451,2875906887,32821193589.468999,28619411805.444101,69371628296.166636,130812233691.079736,10061103,2810419,10119216,22990738
2020-03-25,Investors Exchange (V),229015594,44485008,102889605,376390207,8602723262.873901,2656803138.958500,6257365747.351499,17516892149.183900,1505851,195088,750194,2451133
2020-03-25,NASDAQ PSX (X),34556218,33216254,21409754,89182226,1108154475.739300,1572373142.511800,1308886696.232400,3989414314.483500,267447,174577,258229,700253
2020-03-25,BYX Equities (Y),150023781,99658443,78073247,327755471,3488723569.882700,4173718406.301199,3103906255.466400,10766348231.650299,1405784,499476,719503,2624763
2020-03-25,BZX Equities (Z),683623732,347239305,360178464,1391041501,23293152004.978897,21186232848.838492,20779039942.267790,65258424796.085179,6596249,2011147,3589082,12196478
2020-03-24,NYSE American (A),16532346,30979859,7925509,55437714,477892310.949000,517922940.416100,411758101.816400,1407573353.181500,210873,129776,117837,458486
2020-03-24,NASDAQ BX (B),93272882,47502027,45012079,185786988,2367371601.396500,2511506689.338498,2085436661.424600,6964314952.159598,815659,364217,515022,1694898
2020-03-24,NYSE National (C),117327889,73869317,43645440,234842646,1684650511.228500,1820692485.420800,1102867405.109600,4608210401.758900,1032855,349448,455500,1837803
2020-03-24,FINRA / Nasdaq TRF Chicago (DB),11788668,4401122,7957284,24147074,287615576.812900,252522952.899200,530914144.633200,1071052674.345300,39487,14466,39251,93204
2020-03-24,FINRA / NYSE TRF (DN),481000891,287971833,392456509,1161429233,10242774130.141301,8793947665.517802,17942255882.136402,36978977677.795505,1729117,575591,1483427,3788135
2020-03-24,FINRA / Nasdaq TRF Carteret (DQ),2264898717,1112756534,1372571240,4750226491,65036739232.354110,52236987185.855767,67625173344.455103,184898899762.664980,8755225,2425393,5421943,16602561
2020-03-24,EDGA Equities (J),136584957,69546695,74289367,280421019,4333160965.315200,3219382471.436001,4028112512.462700,11580655949.213901,1566413,490292,921082,2977787
2020-03-24,EDGX Equities (K),350444553,270606510,264571830,885622893,8136125305.548502,12226689549.871600,10425876707.157000,30788691562.577102,2631696,1361420,1816497,5809613
2020-03-24,NYSE Chicago (M),12132749,31650143,11276692,55059584,509401595.070500,2525582956.388000,1101294499.964300,4136279051.422800,18981,1785,11602,32368
2020-03-24,NYSE (N),1697645803,85789205,61846210,1845281218,52167486431.988799,3835618462.272100,2668490876.751800,58671595771.012699,7370323,411097,558305,8339725
2020-03-24,NYSE Arca (P),464032188,720916726,341164607,1526113521,12787189766.648101,35873131609.230006,17756894380.432095,66417215756.310202,3979510,2536746,3227807,9744063
2020-03-24,NASDAQ (Q),939241089,506203062,1282662860,2728107011,29802479740.284499,25359717169.452290,71507496827.391098,126669693737.127887,9193149,2673910,9761809,21628868
2020-03-24,Investors Exchange (V),228213594,48465824,110229313,386908731,7930661952.569799,2417250988.864799,6052668884.932499,16400581826.367097,1498974,199042,786361,2484377
2020-03-24,NASDAQ PSX (X),29175432,28798047,21716753,79690232,828696003.829400,1227925328.302400,1212245786.676900,3268867118.808700,230753,154210,238650,623613
2020-03-24,BYX Equities (Y),138241246,101035007,72845705,312121958,3319634567.588200,3684246795.766000,2852584709.481601,9856466072.835801,1340772,471371,660530,2472673
2020-03-24,BZX Equities (Z),582622642,316359671,330910138,1229892451,20185524965.981007,19363176222.077796,20226879122.289103,59775580310.347906,5772593,1745764,3397507,10915864
2020-03-23,NYSE American (A),17194360,29947567,8417717,55559644,514551012.680600,415284368.068300,407613506.073800,1337448886.822700,255999,129337,138484,523820
2020-03-23,NASDAQ BX (B),88651075,52332122,42939630,183922827,2038094595.907500,3404772352.945401,1893487742.503000,7336354691.355901,798770,431871,484407,1715048
2020-03-23,NYSE National (C),122272263,60056233,42266436,224594932,1505983269.575800,1455679030.450700,995422433.682500,3957084733.709000,1006544,315938,430568,1753050
2020-03-23,FINRA / Nasdaq TRF Chicago (DB),10963601,5431122,8801738,25196461,271654782.099900,299029652.912300,613047580.650100,1183732015.662300,40403,16222,42995,99620
2020-03-23,FINRA / NYSE TRF (DN),395300344,336349562,364021310,1095671216,8821496122.539696,9675476566.056799,16997713285.820998,35494685974.417493,1505979,627447,1332350,3465776
2020-03-23,FINRA / Nasdaq TRF Carteret (DQ),2200057096,1350951769,1334471243,4885480108,64006695419.722116,64529248622.214194,66167786651.586999,194703730693.523309,8952329,2689269,5392071,17033669
2020-03-23,EDGA Equities (J),146956165,77644930,80772325,305373420,4125786741.985900,3986987245.153898,4088437247.115200,12201211234.254998,1665189,570510,998878,3234577
2020-03-23,EDGX Equities (K),340463314,312814050,256185680,909463044,7837331157.656500,14897840132.435005,10926008487.700404,33661179777.791909,2700215,1575025,1844925,6120165
2020-03-23,NYSE Chicago (M),11008978,18470865,5484765,34964608,350485830.876700,1895769392.162000,501048898.554300,2747304121.593000,21989,1584,14254,37827
2020-03-23,NYSE (N),1584584680,93120601,59975633,1737680914,45455999781.987604,3831760769.149299,2383546405.470500,51671306956.607403,8155454,420720,559191,9135365
2020-03-23,NYSE Arca (P),469169288,751762349,350083491,1571015128,12705063498.801298,36062972812.126822,18506646472.562400,67274682783.490520,4225238,2775345,3394841,10395424
2020-03-23,NASDAQ (Q),985153810,590134935,1243741225,2819029970,28991640688.615804,31293086212.739298,66366566125.947422,126651293027.302524,9830825,3370963,10396587,23598375
2020-03-23,Investors Exchange (V),239770295,56219888,112715660,408705843,8330915833.181499,2651941699.909599,5998154983.749301,16981012516.840399,1563324,242867,820708,2626899
2020-03-23,NASDAQ PSX (X),31580386,32776379,18705301,83062066,896751062.205700,1477208935.829400,1256639926.309000,3630599924.344100,257570,182664,177535,617769
2020-03-23,BYX Equities (Y),139343789,107529098,77506745,324379632,3149296245.106900,4391166849.497701,2915750063.427200,10456213158.031801,1395462,543920,744339,2683721
2020-03-23,BZX Equities (Z),628911314,366577565,342322893,1337811772,19763767877.302094,21973660553.720395,19888044275.198296,61625472706.220785,6281812,2170226,3638646,12090684
2020-03-20,NYSE American (A),25174462,71483171,11121402,107779035,721704697.569200,744870219.708200,527485135.614700,1994060052.892100,453503,144969,202111,800583
2020-03-20,NASDAQ BX (B),102734015,53361663,53196625,209292303,2488112591.866800,2862980185.632499,2307083253.878400,7658176031.377699,929001,367139,574856,1870996
2020-03-20,NYSE National (C),144164152,69644468,52911993,266720613,2272559021.276700,1726866501.573200,1586108432.052300,5585533954.902200,1396619,297889,575236,2269744
2020-03-20,FINRA / Nasdaq TRF Chicago (DB),12983792,5523779,9321021,27828592,300064866.537900,239879280.905500,651061677.027500,1191005824.470900,44375,14612,45548,104535
2020-03-20,FINRA / NYSE TRF (DN),409617003,316186117,369005192,1094808312,8441133297.536896,9927882719.429104,16198032823.651697,34567048840.617697,1471259,555230,1306605,3333094
2020-03-20,FINRA / Nasdaq TRF Carteret (DQ),2352449559,1431029273,1515380440,5298859272,65099473203.048091,71135821112.031105,71234552441.336696,207469846756.415892,9385679,2622853,5828977,17837509
2020-03-20,EDGA Equities (J),143681302,68054347,77780355,289516004,3937338492.590700,3581108461.291001,3691623238.469000,11210070192.350701,1557504,413970,925621,2897095
2020-03-20,EDGX Equities (K),365018261,317856628,269926259,952801148,8245048288.027802,14538883454.812406,11280033834.008097,34063965576.848305,2831634,1538007,1983404,6353045
2020-03-20,NYSE Chicago (M),11564592,28022679,6973939,46561210,394689272.880800,3537519537.561000,1035983291.562600,4968192102.004400,25431,1532,12144,39107
2020-03-20,NYSE (N),2701795719,99499948,78667570,2879963237,77480942639.158288,4297445962.095401,3034819451.050300,84813208052.303989,8334513,420557,724384,9479454
2020-03-20,NYSE Arca (P),530382835,773752419,394384723,1698519977,13861816210.305601,36090232902.314400,19702605648.426993,69654654761.046994,4852602,2798039,3741438,11392079
2020-03-20,NASDAQ (Q),1071986843,590890315,1797919526,3460796684,30458707072.471892,30682459196.563025,91701567271.315949,152842733540.350866,10192418,3126359,10693554,24012331
2020-03-20,Investors Exchange (V),271161656,63868405,130280949,465311010,8815892305.842798,3289793641.265800,7030013393.645799,19135699340.754397,1766560,252092,889789,2908441
2020-03-20,NASDAQ PSX (X),37128486,36255793,21178671,94562950,1030637788.837700,1750188286.180900,1443324642.029100,4224150717.047700,290644,206123,209529,706296
2020-03-20,BYX Equities (Y),149848590,123218050,75036646,348103286,3458168183.869400,4598060411.154300,3144279776.549200,11200508371.572900,1490258,537071,782197,2809526
2020-03-20,BZX Equities (Z),724263970,368434643,397218938,1489917551,21593489546.336800,22650323705.759600,23263360173.062793,67507173425.159193,6919262,2159820,4043649,13122731
2020-03-19,NYSE American (A),20888286,38281291,9687702,68857279,572822658.483500,430525197.410500,485993665.720500,1489341521.614500,236282,139127,123411,498820
2020-03-19,NASDAQ BX (B),112986559,55022607,57059701,225068867,2685549933.121600,2985559380.078500,2407111928.133800,8078221241.333900,996842,381882,594490,1973214
2020-03-19,NYSE National (C),109170894,62622916,45482929,217276739,1770485465.167600,1469845451.761000,1393116666.249900,4633447583.178500,972642,229481,468920,1671043
2020-03-19,FINRA / Nasdaq TRF Chicago (DB),12406769,6050698,9732234,28189701,234467558.767800,268234310.954100,542239656.224600,1044941525.946500,37453,15789,41019,94261
2020-03-19,FINRA / NYSE TRF (DN),445431481,397172177,390807503,1233411161,9101290288.961298,9393266783.804797,18466687584.684597,36961244657.450692,1447179,589912,1389680,3426771
2020-03-19,FINRA / Nasdaq TRF Carteret (DQ),2471313397,1474351509,1519067309,5464732215,66535726249.496905,59007266420.312411,72233503599.482394,197776496269.291710,9166939,2612678,5705525,17485142
2020-03-19,EDGA Equities (J),152138253,74399024,79451070,305988347,4079784638.086000,3760875041.205700,3764725318.688799,11605384997.980499,1556803,461511,915894,2934208
2020-03-19,EDGX Equities (K),350927678,328055288,270736867,949719833,8053748277.954800,16090051161.052586,12097678970.233803,36241478409.241189,2611184,1575299,1975274,6161757
2020-03-19,NYSE Chicago (M),20957161,18072892,12453059,51483112,881018805.229000,1558674979.682600,1225559378.040300,3665253162.951900,16397,1170,8904,26471
2020-03-19,NYSE (N),1712804120,81356969,68304280,1862465369,50978546464.772296,3564835406.734501,2938340324.944800,57481722196.451597,7585089,370197,615397,8570683
2020-03-19,NYSE Arca (P),483956438,829153881,379957052,1693067371,13369724176.710005,38821683049.194878,20659890592.108105,72851297818.012988,4020104,2669148,3451474,10140726
2020-03-19,NASDAQ (Q),971687336,617167715,1354338174,2943193225,29990954430.044101,29666257280.550880,74615274411.553395,134272486122.148376,9143173,2895097,10530787,22569057
2020-03-19,Investors Exchange (V),316601562,60558078,145152624,522312264,9735335606.491200,3128451097.148400,7147613770.684999,20011400474.324599,1929191,246460,979921,3155572
2020-03-19,NASDAQ PSX (X),32729459,30911104,17626995,81267558,938254568.354600,1361450842.192400,1222761448.881800,3522466859.428800,274554,184791,177287,636632
2020-03-19,BYX Equities (Y),154406454,128585477,81566636,364558567,3501520885.725500,4657516679.499100,3364080926.244101,11523118491.468701,1450009,580714,834165,2864888
2020-03-19,BZX Equities (Z),587700177,375239394,337066606,1300006177,18695856531.819003,24465965650.926810,21257467307.955791,64419289490.701604,5615946,2176639,3537627,11330212
2020-03-18,NYSE American (A),27288709,39498333,11177967,77965009,822867303.962900,541229474.423000,519796038.835700,1883892817.221600,326226,141576,151269,619071
2020-03-18,NASDAQ BX (B),110505566,58990846,55620477,225116889,2811644714.086700,3194805939.764400,2729953610.862301,8736404264.713401,935209,396702,618686,1950597
2020-03-18,NYSE National (C),129240628,80619492,50429178,260289298,2187078902.629700,1623701467.631200,1529847215.395800,5340627585.656700,1100035,268202,500463,1868700
2020-03-18,FINRA / Nasdaq TRF Chicago (DB),12643262,7193612,9444466,29281340,301034601.658000,306513204.605800,692069965.057400,1299617771.321200,45319,20755,47061,113135
2020-03-18,FINRA / NYSE TRF (DN),470122648,363437658,371183894,1204744200,9596534698.019600,9742753563.390009,16964661990.552499,36303950251.962108,1561818,635231,1309647,3506696
2020-03-18,FINRA / Nasdaq TRF Carteret (DQ),2614582303,1549318572,1518915037,5682815912,71592966988.684695,61656729441.133822,72181862019.040306,205431558448.858823,9932862,2930912,5977942,18841716
2020-03-18,EDGA Equities (J),172800464,83067590,89135257,345003311,4691671718.201600,4029231097.637900,4507388989.417500,13228291805.257000,1749864,462502,1038189,3250555
2020-03-18,EDGX Equities (K),390375038,340136738,269929980,1000441756,8999590818.348701,17006557922.988096,11822540148.178301,37828688889.515098,2850609,1534281,2018099,6402989
2020-03-18,NYSE Chicago (M),22118883,29852956,9265499,61237338,733404892.410100,2967392307.012000,1191990682.026900,4892787881.449000,21845,2039,12124,36008
2020-03-18,NYSE (N),1930751710,92316624,70563232,2093631566,58507734733.146302,4082119582.654398,3139879057.678900,65729733373.479600,8332786,379452,641434,9353672
2020-03-18,NYSE Arca (P),554959463,1025426391,412797583,1993183437,15440273207.426396,46498197351.091440,22182556652.688996,84121027211.206832,4670134,3218108,3786425,11674667
2020-03-18,NASDAQ (Q),1119721729,640249897,1430817213,3190788839,35221481229.946408,36221970111.388411,77725227705.059194,149168679046.394013,10266697,3353639,11218144,24838480
2020-03-18,Investors Exchange (V),354821017,67304580,163023958,585149555,11190345867.383103,3484711043.072700,8251687239.633501,22926744150.089304,2138856,263015,1060128,3461999
2020-03-18,NASDAQ PSX (X),36358294,37254420,20482278,94094992,1099970946.842000,1799515178.633900,1505018973.091100,4404505098.567000,295462,185218,202394,683074
2020-03-18,BYX Equities (Y),173344320,123537710,85450065,382332095,4088943939.891000,4743268917.037700,3648984187.454200,12481197044.382900,1593161,559892,868779,3021832
2020-03-18,BZX Equities (Z),679666235,361136700,366766746,1407569681,22416303610.243999,21725150812.246903,21479194110.782992,65620648533.273894,6467408,1952170,3861948,12281526
2020-03-17,NYSE American (A),23711598,34243387,10850523,68805508,726208540.547600,534570363.513400,522332849.181800,1783111753.242800,318773,145013,163827,627613
2020-03-17,NASDAQ BX (B),110764328,47589248,56299515,214653091,3003781953.180099,3070820189.122100,2702692474.484999,8777294616.787198,997476,285228,619313,1902017
2020-03-17,NYSE National (C),126745305,55371250,51120671,233237226,2117500170.743000,1623364040.601200,1656400493.525200,5397264704.869400,1156335,228527,569684,1954546
2020-03-17,FINRA / Nasdaq TRF Chicago (DB),9747502,5030741,9396941,24175184,256927305.062600,227874253.374300,689306089.817700,1174107648.254600,34931,15444,44527,94902
2020-03-17,FINRA / NYSE TRF (DN),410699886,275313490,367152480,1053165856,8982499114.813903,8457051572.419704,17438708807.423502,34878259494.657109,1360109,552667,1287688,3200464
2020-03-17,FINRA / Nasdaq TRF Carteret (DQ),2486211212,1218718597,1525140050,5230069859,71746062838.694249,58424218907.283776,72560013960.549111,202730295706.527136,9123619,2571079,5615937,17310635
2020-03-17,EDGA Equities (J),170393699,70003506,94307732,334704937,4901067731.373900,4365657537.473199,4486521678.938599,13753246947.785698,1814512,444928,1123480,3382920
2020-03-17,EDGX Equities (K),371375394,276912753,283451251,931739398,9202869906.554097,14722004048.375794,13499908601.453499,37424782556.383390,2877097,1330027,2146314,6353438
2020-03-17,NYSE Chicago (M),11224843,23528384,10406422,45159649,527891765.587900,2682807043.678601,1785986813.717700,4996685622.984201,14188,2226,9307,25721
2020-03-17,NYSE (N),1960935865,87280212,70666762,2118882839,65823603536.206310,4481937050.559800,3096488856.888900,73402029443.655010,8973984,371239,666922,10012145
2020-03-17,NYSE Arca (P),489408374,764967618,385751721,1640127713,14901855005.628899,41158401784.987178,20834123035.795503,76894379826.411580,4423583,2609353,3711765,10744701
2020-03-17,NASDAQ (Q),1040544238,479373233,1443137616,2963055087,36665443629.001696,28926668329.939907,81388511513.727724,146980623472.669327,10433276,2648663,11810148,24892087
2020-03-17,Investors Exchange (V),330423155,56953033,159044639,546420827,11288604136.627498,3575895547.884098,7950880325.943203,22815380010.454799,2056540,263185,1082269,3401994
2020-03-17,NASDAQ PSX (X),33470588,28131241,17956423,79558252,1024246437.180900,1443257682.307400,1362258754.031300,3829762873.519600,285091,145333,168868,599292
2020-03-17,BYX Equities (Y),173405489,104326008,87866429,365597926,4167189172.418900,5215473077.358100,3700501985.036300,13083164234.813300,1634733,536304,905100,3076137
2020-03-17,BZX Equities (Z),621195168,321994912,347665799,1290855879,22260352427.371698,21079440520.734803,21709961582.385093,65049754530.491594,6226472,1770315,3798050,11794837
2020-03-16,NYSE American (A),20945879,41061567,10191192,72198638,686857002.282500,580582036.468300,497192663.571800,1764631702.322600,289838,145567,144580,579985
2020-03-16,NASDAQ BX (B),97725755,53810567,50038458,201574780,2831813771.911300,3208906457.462101,2465028599.950300,8505748829.323701,886087,397331,582785,1866203
2020-03-16,NYSE National (C),115799672,48473363,46579955,210852990,2080719929.390900,1581535714.706900,1481204424.852600,5143460068.950400,1098743,226480,515511,1840734
2020-03-16,FINRA / Nasdaq TRF Chicago (DB),11866356,5974126,10014758,27855240,244342061.592500,223880430.555600,625220883.316600,1093443375.464700,38859,18269,44147,101275
2020-03-16,FINRA / NYSE TRF (DN),382977330,262106914,343023782,988108026,7692126838.894702,7762937971.394498,14438777193.839586,29893842004.128786,1457485,603115,1372999,3433599
2020-03-16,FINRA / Nasdaq TRF Carteret (DQ),2279189153,1262781731,1397908480,4939879364,65672239919.518488,61199390902.360978,66697193564.459410,193568824386.338876,8852661,2773689,5484236,17110586
2020-03-16,EDGA Equities (J),181576980,72472389,94016689,348066058,5330708640.842399,4369103604.254501,4125329022.413100,13825141267.510000,1885948,468680,1099781,3454409
2020-03-16,EDGX Equities (K),357845365,284456001,277394671,919696037,8829541078.419302,14495393462.561603,13317834551.963397,36642769092.944302,2723825,1319433,2105004,6148262
2020-03-16,NYSE Chicago (M),11613019,16710670,7995807,36319496,581148787.394900,2010128672.810400,976559011.831799,3567836472.037099,19958,3019,13101,36078
2020-03-16,NYSE (N),1886064110,81130581,65594160,2032788851,63629427360.911806,4653551980.016499,3015128842.732000,71298108183.660305,8145043,399976,592219,9137238
2020-03-16,NYSE Arca (P),429919536,930720073,331241083,1691880692,12819751563.767900,47312667037.926133,18048370803.645913,78180789405.339946,3893995,2672612,3194943,9761550
2020-03-16,NASDAQ (Q),946958270,486101288,1413004797,2846064355,32972213095.427104,29014845584.522597,79443609323.407626,141430668003.357327,9361056,2578269,10692078,22631403
2020-03-16,Investors Exchange (V),315594601,70092300,169483798,555170699,11435075040.462599,4354904559.312601,8877499510.104999,24667479109.880199,1951659,315297,1091917,3358873
2020-03-16,NASDAQ PSX (X),31103908,28882253,17996705,77982866,996449067.991100,1605709675.149800,1449366344.374600,4051525087.515500,271056,161794,160787,593637
2020-03-16,BYX Equities (Y),161144854,101851978,77498411,340495243,3921278545.530300,5165783783.510500,3499835568.576199,12586897897.616999,1534974,562864,851812,2949650
2020-03-16,BZX Equities (Z),575132521,300109433,306140736,1181382690,20209272414.976202,19213618672.209988,18632572668.920401,58055463756.106591,5691859,1554566,3294670,10541095
2020-03-13,NYSE American (A),22360872,40922984,9829779,73113635,753284363.036800,543625171.313200,490106608.198000,1787016142.548000,342952,143681,168261,654894
2020-03-13,NASDAQ BX (B),103307562,52455849,49782261,205545672,2900018773.465800,3143677971.544300,2452425527.849100,8496122272.859200,877113,394169,545104,1816386
2020-03-13,NYSE National (C),139146263,59578633,52174657,250899553,2500502738.364600,1842774107.437200,1590355471.341100,5933632317.142900,1272632,253278,589065,2114975
2020-03-13,FINRA / Nasdaq TRF Chicago (DB),7438120,5040139,6176739,18654998,174828503.226500,274538515.771000,481353422.519100,930720441.516600,28293,15382,34780,78455
2020-03-13,FINRA / NYSE TRF (DN),374047814,285925376,351878725,1011851915,8098176969.967299,9592016672.996497,15866269809.378004,33556463452.341800,1336232,587093,1308412,3231737
2020-03-13,FINRA / Nasdaq TRF Carteret (DQ),2395919173,1377153066,1429270732,5202342971,71979158205.695425,71850965676.970756,71126365548.627973,214956489431.294154,8957665,2767378,5371083,17096126
2020-03-13,EDGA Equities (J),211441781,67580809,108216855,387239445,6458033474.997799,4107239706.644000,5518557658.158601,16083830839.800400,2075131,442324,1192475,3709930
2020-03-13,EDGX Equities (K),350447993,285102886,253822777,889373656,9523654589.397301,16877143429.480003,13867682813.284294,40268480832.161598,2644612,1365496,1989348,5999456
2020-03-13,NYSE Chicago (M),18138288,28678002,8519470,55335760,529335420.705900,1485775299.709200,1081318641.131800,3096429361.546900,18331,2113,8455,28899
2020-03-13,NYSE (N),2059799247,85590234,66146330,2211535811,69466589071.010606,4777706431.515498,3451910022.585300,77696205525.111404,7787884,375856,600009,8763749
2020-03-13,NYSE Arca (P),465232355,894784001,356703772,1716720128,14786575151.434504,50765160099.797930,22180065610.016407,87731800861.248841,4122300,2870879,3472332,10465511
2020-03-13,NASDAQ (Q),976750169,558221674,1396325224,2931297067,35016363090.546008,36925883028.801424,83752774394.080523,155695020513.427955,9438412,2999558,10555564,22993534
2020-03-13,Investors Exchange (V),319483005,78198810,149926029,547607844,11156053166.544400,4196525803.288001,7403708975.756297,22756287945.588698,1924107,323316,1019367,3266790
2020-03-13,NASDAQ PSX (X),30496116,42345194,18151229,90992539,985384105.455800,2240171341.869099,1291549609.203200,4517105056.528099,255184,187572,178630,621386
2020-03-13,BYX Equities (Y),171619191,115864300,86865532,374349023,4455908678.723201,5780880276.253601,3895038886.200300,14131827841.177102,1533019,585777,866151,2984947
2020-03-13,BZX Equities (Z),653449891,357837469,357281380,1368568740,25154177628.120597,25795450191.643685,26309807372.177891,77259435191.942173,6181552,1900270,3754493,11836315
2020-03-12,NYSE American (A),22139571,52303572,10742493,85185636,699685852.482800,739395770.033000,653950734.973400,2093032357.489200,286773,153102,158998,598873
2020-03-12,NASDAQ BX (B),117663794,61894686,62619509,242177989,4109960475.324400,3914930948.035299,3369837633.412700,11394729056.772399,1119868,537320,655592,2312780
2020-03-12,NYSE National (C),127129175,64891802,48163335,240184312,2253182739.230000,1915957276.997400,1530363072.528400,5699503088.755800,1107975,252479,513251,1873705
2020-03-12,FINRA / Nasdaq TRF Chicago (DB),15095322,6670924,11425952,33192198,323520113.512000,345025135.046300,745143650.224600,1413688898.782900,47183,21292,52944,121419
2020-03-12,FINRA / NYSE TRF (DN),425760437,291849813,363670011,1081280261,9180273477.221803,10633735496.202101,16739047042.426592,36553056015.850496,1380393,659925,1393741,3434059
2020-03-12,FINRA / Nasdaq TRF Carteret (DQ),2560769574,1695537068,1562396099,5818702741,76522226029.857523,88299121628.025787,79431307308.835655,244252654966.718965,9268136,3195921,5752657,18216714
2020-03-12,EDGA Equities (J),225890527,76995373,108854106,411740006,7017825970.193701,4231877473.425499,5144885466.569197,16394588910.188397,2161055,505099,1223364,3889518
2020-03-12,EDGX Equities (K),370069770,315491414,281911011,967472195,10231096661.204500,19608053098.529486,14982420942.881496,44821570702.615482,2651129,1689720,2124350,6465199
2020-03-12,NYSE Chicago (M),22255327,26639965,7954693,56849985,1082475122.694200,1361469927.080000,1005367365.110900,3449312414.885100,26802,2961,21873,51636
2020-03-12,NYSE (N),2158752880,100129244,75538325,2334420449,73489586712.268094,5442760668.064699,4171453269.061700,83103800649.394493,8623590,448412,639429,9711431
2020-03-12,NYSE Arca (P),511294766,1038890593,389851727,1940037086,16278379203.543008,56031865887.323542,24910193355.563384,97220438446.429934,4228404,3223508,3695321,11147233
2020-03-12,NASDAQ (Q),1041419985,629324853,1511053089,3181797927,38578264919.379298,41740474834.771573,91007638569.269066,171326378323.419937,9756545,3256654,11596770,24609969
2020-03-12,Investors Exchange (V),342273200,76063219,160097257,578433676,11900762520.848800,4267079261.289700,8198660180.846499,24366501962.984999,1975202,303468,1046326,3324996
2020-03-12,NASDAQ PSX (X),39171902,53191198,22860528,115223628,1403395560.626600,3005594417.559398,1881100888.694800,6290090866.880798,319845,265098,209542,794485
2020-03-12,BYX Equities (Y),175377972,129360923,86845817,391584712,4611323187.533200,6229265908.044496,3993246779.381699,14833835874.959395,1518454,691753,865765,3075972
2020-03-12,BZX Equities (Z),695755229,391921528,395366802,1483043559,27558408065.621197,32577697679.512690,28178242530.146505,88314348275.280392,6341467,2262123,4048612,12652202
2020-03-11,NYSE American (A),20061056,39096484,8328449,67485989,633369448.643900,734242630.703500,412770334.404700,1780382413.752100,294037,148050,141021,583108
2020-03-11,NASDAQ BX (B),93455712,50373414,49092859,192921985,2457735337.660000,2863627097.426599,1998354984.932800,7319717420.019399,795479,412074,458451,1666004
2020-03-11,NYSE National (C),176086337,81645811,61122435,318854583,2995828083.439000,2559804994.784100,1634203203.172900,7189836281.396000,1477055,352727,649415,2479197
2020-03-11,FINRA / Nasdaq TRF Chicago (DB),8939163,4618570,8198261,21755994,240979280.970300,269810701.198100,574623298.392400,1085413280.560800,31676,13930,36076,81682
2020-03-11,FINRA / NYSE TRF (DN),328307467,210970921,353749891,893028279,7665773548.833102,7527207716.660301,13515410270.943709,28708391536.437112,1032666,464913,1122131,2619710
2020-03-11,FINRA / Nasdaq TRF Carteret (DQ),2020137868,1086438359,1283284481,4389860708,64460569978.049496,61884712305.256416,59737799439.066695,186083081722.372607,7582749,2189060,4597984,14369793
2020-03-11,EDGA Equities (J),206947881,56918879,92827246,356694006,6178499534.623200,3107049633.114099,4036775129.583700,13322324297.320999,2022677,344608,1062720,3430005
2020-03-11,EDGX Equities (K),302530665,235246098,234612470,772389233,8267302978.258401,13592903377.360405,10487955117.136398,32348161472.755204,2409076,1281822,1701391,5392289
2020-03-11,NYSE Chicago (M),25525801,22305979,19492714,67324494,1240738477.765199,2397596495.096200,1150117437.068600,4788452409.929999,37870,2571,21718,62159
2020-03-11,NYSE (N),1761708003,101593192,80213096,1943514291,62581422341.175098,5335677732.058798,3889533057.573200,71806633130.807096,7595545,404148,660041,8659734
2020-03-11,NYSE Arca (P),450043776,752553851,368667875,1571265502,14452866179.577891,41783344063.519370,19911057702.619700,76147267945.716961,4025147,2485233,3354583,9864963
2020-03-11,NASDAQ (Q),931413790,526741258,1181031480,2639186528,32940932128.449197,32876972736.351722,64792823226.316714,130610728091.117633,9118636,2682523,9247043,21048202
2020-03-11,Investors Exchange (V),262960195,57751436,124720270,445431901,9562045547.553199,2865623509.498400,5956279747.212898,18383948804.264497,1682122,224134,887677,2793933
2020-03-11,NASDAQ PSX (X),37678681,47917110,23926791,109522582,1354761037.241200,2395547634.099400,1591887388.125100,5342196059.465700,311395,206475,218219,736089
2020-03-11,BYX Equities (Y),159122179,101979311,79333000,340434490,3693110260.815700,4716153780.064500,2891494370.623700,11300758411.503900,1444353,507175,748591,2700119
2020-03-11,BZX Equities (Z),646287961,300124394,334011121,1280423476,25081310643.586898,24060858228.841198,21206907729.342804,70349076601.770900,5991366,1643429,3340157,10974952
2020-03-10,NYSE American (A),20425229,38568289,8123036,67116554,656903940.252300,636314005.689400,487509360.424300,1780727306.366000,279221,137147,135057,551425
2020-03-10,NASDAQ BX (B),100528514,53280809,48522609,202331932,2948633464.885500,3116522428.671998,2327985684.771800,8393141578.329298,873526,454101,464445,1792072
2020-03-10,NYSE National (C),138048853,82726904,48795113,269570870,2683307836.648000,2484307665.623400,1606543838.102500,6774159340.373900,1218764,309339,553087,2081190
2020-03-10,FINRA / Nasdaq TRF Chicago (DB),9496672,5414286,8157064,23068022,222779114.466300,290960133.035500,566847982.229500,1080587229.731300,30808,13344,35737,79889
2020-03-10,FINRA / NYSE TRF (DN),399935870,281178990,400913475,1082028335,8545357066.397497,9525450985.536201,16192656460.556201,34263464512.489899,1171900,521773,1211744,2905417
2020-03-10,FINRA / Nasdaq TRF Carteret (DQ),2222135913,1241466522,1352359199,4815961634,67756532130.405213,63277138900.065326,64100274187.793302,195133945218.263841,7786596,2267927,4533649,14588172
2020-03-10,EDGA Equities (J),174069851,59328400,83181062,316579313,5756030733.361599,3522098864.195801,3937320447.532300,13215450045.089700,1784169,347285,954514,3085968
2020-03-10,EDGX Equities (K),299901110,283212332,243841516,826954958,8272738778.967500,16542635449.220407,10955976927.906503,35771351156.094410,2327380,1368918,1691049,5387347
2020-03-10,NYSE Chicago (M),28482593,19944388,11285371,59712352,1148018668.805700,2235531544.014800,1847184480.731500,5230734693.552000,34812,2836,25172,62820
2020-03-10,NYSE (N),1816315142,107799746,70505214,1994620102,65349421551.605001,5928796243.519203,3763862666.926900,75042080462.051104,7420653,409088,601436,8431177
2020-03-10,NYSE Arca (P),457397903,791872668,364984824,1614255395,15057127731.769006,46066358469.803874,20630506181.284300,81753992382.857180,3945280,2551049,3293678,9790007
2020-03-10,NASDAQ (Q),914685712,566619506,1253022957,2734328175,34146789723.087598,36620000408.990811,72974116575.065813,143740906707.144222,8739810,2867236,9492213,21099259
2020-03-10,Investors Exchange (V),284238161,65712687,121609515,471560363,10018192163.233499,3375045737.242100,6059892929.993399,19453130830.468998,1750229,243269,899997,2893495
2020-03-10,NASDAQ PSX (X),37463016,46902437,21133934,105499387,1283765604.580800,2373819809.187900,1434319126.595900,5091904540.364600,303492,193324,185752,682568
2020-03-10,BYX Equities (Y),162466260,113618615,86869882,362954757,3975113907.704600,5321194205.060301,3234196380.051400,12530504492.816301,1401698,506705,723575,2631978
2020-03-10,BZX Equities (Z),576449576,350124984,323958989,1250533549,23545642682.539997,26844010325.669188,22369842337.799999,72759495346.009184,5448546,1912405,3224619,10585570
2020-03-09,NYSE American (A),24760247,53412968,10995502,89168717,737024604.148000,766134630.333000,583619503.881900,2086778738.362900,302144,163432,157995,623571
2020-03-09,NASDAQ BX (B),103339622,61779916,53250153,218369691,2987565489.762500,3274545152.559200,2780754636.000000,9042865278.321700,852808,531531,556939,1941278
2020-03-09,NYSE National (C),141544928,89853658,48975069,280373655,2624556364.948700,2572640199.623001,1621577468.863300,6818774033.435001,1162444,309050,522183,1993677
2020-03-09,FINRA / Nasdaq TRF Chicago (DB),13989750,5428923,10356666,29775339,289371716.594900,230455956.234400,707046981.432100,1226874654.261400,40207,16525,45697,102429
2020-03-09,FINRA / NYSE TRF (DN),365030553,268025678,322009028,955065259,7466424149.043598,8486343477.132403,13436746692.773922,29389514318.949923,1156133,598937,1252086,3007156
2020-03-09,FINRA / Nasdaq TRF Carteret (DQ),2442884991,1517453104,1362257715,5322595810,69709895107.713096,75439278462.713588,66999413491.857281,212148587062.283965,8348007,2974691,4952640,16275338
2020-03-09,EDGA Equities (J),222946935,78775874,99220852,400943661,6716172104.597300,4099661243.614702,4829968755.312699,15645802103.524701,2034366,420976,1071210,3526552
2020-03-09,EDGX Equities (K),316292303,305512730,262053471,883858504,8524954317.004995,16976734392.006790,13595669300.824101,39097358009.835886,2241386,1516056,1887227,5644669
2020-03-09,NYSE Chicago (M),27290814,17701592,6810852,51803258,1548980643.135499,1450888610.823500,713700071.008200,3713569324.967199,40012,2663,19945,62620
2020-03-09,NYSE (N),2096986587,99422428,74316230,2270725245,71296008044.145909,5508570063.681600,4192580523.001500,80997158630.829009,7994418,408791,613708,9016917
2020-03-09,NYSE Arca (P),528183689,954460482,385946403,1868590574,16300546352.523402,50023715220.351411,22447710722.716792,88771972295.591605,4055072,2901048,3285420,10241540
2020-03-09,NASDAQ (Q),1006833723,561232425,1343658647,2911724795,37294367246.415892,37031470670.498588,81455717229.152606,155781555146.067086,8880806,2926677,9932440,21739923
2020-03-09,Investors Exchange (V),313191293,81420230,126713615,521325138,10970862383.634703,3900505623.135900,6809293556.866400,21680661563.637003,1788579,268178,837844,2894601
2020-03-09,NASDAQ PSX (X),39453931,49193573,24746965,113394469,1432849219.795600,2475004636.642900,1958496353.154800,5866350209.593300,318297,235531,246544,800372
2020-03-09,BYX Equities (Y),167720807,130201411,73985034,371907252,3999940563.974800,6006592016.940399,3621613416.557501,13628145997.472700,1362078,572337,711987,2646402
2020-03-09,BZX Equities (Z),630846379,345008394,348814197,1324668970,26353943789.112003,27360014169.902312,25077884384.560592,78791842343.574907,5663545,1799186,3430788,10893519
2020-03-06,NYSE American (A),20185334,33204234,9513714,62903282,687803857.602800,726562344.801100,505652523.844500,1920018726.248400,279973,136392,143102,559467
2020-03-06,NASDAQ BX (B),75840406,49305501,50898618,176044525,2497982797.314300,2636598000.590199,2449690002.266600,7584270800.171099,682263,497836,496702,1676801
2020-03-06,NYSE National (C),148802167,74571348,51455648,274829163,2766412060.831400,2365224452.881700,1433314242.184100,6564950755.897200,1208014,311563,540450,2060027
2020-03-06,FINRA / Nasdaq TRF Chicago (DB),8258326,4526945,7923311,20708582,225854987.226500,231405147.621800,575620539.207200,1032880674.055500,27471,13932,36251,77654
2020-03-06,FINRA / NYSE TRF (DN),312880715,208263299,401941514,923085528,8353218973.381901,8034106801.346401,15910686165.140100,32298011939.868402,982470,463712,1360122,2806304
2020-03-06,FINRA / Nasdaq TRF Carteret (DQ),1827528652,899748039,1289785686,4017062377,64108446953.544400,53080504484.997347,62842347333.935131,180031298772.476878,6885413,2069529,4696736,13651678
2020-03-06,EDGA Equities (J),154517879,56084824,77929408,288532111,5496095369.470400,3117852885.150700,4054404826.638500,12668353081.259600,1617703,352194,909597,2879494
2020-03-06,EDGX Equities (K),261370048,249883635,240299278,751552961,8203777252.617901,14705535175.831009,11911384646.612298,34820697075.061208,2105502,1296879,1689210,5091591
2020-03-06,NYSE Chicago (M),18373093,25686784,7465961,51525838,1156648498.755200,1891124473.918800,806378696.784200,3854151669.458200,37338,2324,20454,60116
2020-03-06,NYSE (N),1608441736,112826359,74998976,1796267071,63262037514.070499,5880904024.332398,3828399895.859700,72971341434.262597,6614049,361785,564143,7539977
2020-03-06,NYSE Arca (P),372374434,688743042,365138391,1426255867,13741332846.751998,40380378357.142306,21569574974.951620,75691286178.845924,3329833,2283087,3192817,8805737
2020-03-06,NASDAQ (Q),807162685,535810602,1177723912,2520697199,31753471153.016488,32459222756.051898,70875475368.616975,135088169277.685361,7707952,2487643,8885869,19081464
2020-03-06,Investors Exchange (V),209856925,52886618,104203519,366947062,8353655782.135600,2914658731.906300,5492214918.532900,16760529432.574800,1372852,206117,765512,2344481
2020-03-06,NASDAQ PSX (X),33873604,48630849,24463755,106968208,1194554928.424000,2455562153.230901,1819736890.450700,5469853972.105601,276377,230962,225890,733229
2020-03-06,BYX Equities (Y),140931200,105810308,72241156,318982664,3880851155.925800,5110179797.859200,3400590452.125200,12391621405.910200,1304723,516428,724361,2545512
2020-03-06,BZX Equities (Z),554847974,326928419,336756673,1218533066,24539115498.575299,26712451911.182803,23308239309.451409,74559806719.209511,5219846,1738032,3225135,10183013
2020-03-05,NYSE American (A),18752768,32268961,7788083,58809812,656671882.374400,619467323.702900,401897734.830400,1678036940.907700,259007,124782,126127,509916
2020-03-05,NASDAQ BX (B),70874931,41400468,42902006,155177405,2438815412.557800,2219985782.451900,1805959902.445700,6464761097.455400,689736,310819,419073,1419628
2020-03-05,NYSE National (C),119903525,56570887,42247686,218722098,2375155713.042600,2070133679.825200,1171299288.514700,5616588681.382500,1033753,256256,450910,1740919
2020-03-05,FINRA / Nasdaq TRF Chicago (DB),7459990,3321776,7709375,18491141,233938220.238900,223226162.998300,601294100.650900,1058458483.888100,24326,10514,33941,68781
2020-03-05,FINRA / NYSE TRF (DN),255697698,176131106,388876739,820705543,6990439394.011301,6761349367.580298,14830028492.736394,28581817254.327993,840063,391717,1113904,2345684
2020-03-05,FINRA / Nasdaq TRF Carteret (DQ),1586391913,676163066,1191343995,3453898974,58139236091.777093,44516203041.770263,54590744062.457663,157246183196.005019,5962886,1623919,4023636,11610441
2020-03-05,EDGA Equities (J),170343191,45967485,81086456,297397132,5474068393.679400,2574709039.610000,3656546798.487400,11705324231.776800,1637922,285193,894718,2817833
2020-03-05,EDGX Equities (K),223265775,193790074,218399678,635455527,7416912472.693102,11660515991.711097,9665480138.387496,28742908602.791695,1850691,978468,1428747,4257906
2020-03-05,NYSE Chicago (M),15839147,14534742,7203341,37577230,1013302493.276800,1838145221.493200,764659999.906600,3616107714.676600,17446,2493,13958,33897
2020-03-05,NYSE (N),1403964356,84214795,60784898,1548964049,57915104648.625204,4726046856.142301,3184729642.497800,65825881147.265305,5684221,290483,482484,6457188
2020-03-05,NYSE Arca (P),321335750,536116122,305047622,1162499494,12425398449.286598,33609062527.784828,18184219594.095391,64218680571.166817,2894061,1756939,2674590,7325590
2020-03-05,NASDAQ (Q),677088078,395573373,988455745,2061117196,27824810829.274994,24238170477.693392,59728284925.952095,111791266232.920481,6689522,1785162,7366166,15840850
2020-03-05,Investors Exchange (V),176030447,35579001,90065406,301674854,7880639488.236598,2349789328.907400,4759535757.599600,14989964574.743598,1226075,161845,681157,2069077
2020-03-05,NASDAQ PSX (X),28672020,35424858,19402905,83499783,1128353042.836200,1898981139.911100,1364323657.252200,4391657839.999500,240995,157510,181266,579771
2020-03-05,BYX Equities (Y),118663447,90259955,72526276,281449678,3460867296.083400,4614574783.496500,2745192478.350400,10820634557.930300,1130217,426567,629008,2185792
2020-03-05,BZX Equities (Z),385011530,220321053,240029115,845361698,16845075855.484101,17699140064.323397,16711899739.817500,51256115659.624998,3796711,1137011,2339504,7273226
2020-03-04,NYSE American (A),16905694,32158486,6799119,55863299,607572412.119100,660924242.736200,353908728.341200,1622405383.196500,220013,121262,104991,446266
2020-03-04,NASDAQ BX (B),63928703,37735213,41561380,143225296,2332002315.374400,2365577319.363600,1794863016.263300,6492442651.001300,663213,337746,447915,1448874
2020-03-04,NYSE National (C),106534275,50321167,40253009,197108451,2224347366.699100,1844404669.128800,1197898677.714000,5266650713.541900,901112,226285,405703,1533100
2020-03-04,FINRA / Nasdaq TRF Chicago (DB),5645607,2770644,6806529,15222780,191024408.453400,132529515.165200,552338691.697600,875892615.316200,20465,8663,30595,59723
2020-03-04,FINRA / NYSE TRF (DN),235372308,167487763,375099802,777959873,6744702268.221803,6078686021.908202,14757549821.185386,27580938111.315391,742962,355581,1083420,2181963
2020-03-04,FINRA / Nasdaq TRF Carteret (DQ),1507480279,706180520,1167239252,3380900051,60858257666.310996,44394308914.306801,55914699319.681708,161167265900.299505,5432174,1454401,3864127,10750702
2020-03-04,EDGA Equities (J),165386738,45020471,76602057,287009266,5301046161.590000,2662712748.290800,3380063504.062202,11343822413.943002,1588088,269295,877022,2734405
2020-03-04,EDGX Equities (K),196926549,172534563,200548462,570009574,6713999993.506101,10363666211.124708,9604539167.999602,26682205372.630411,1598051,893810,1331703,3823564
2020-03-04,NYSE Chicago (M),18532924,13957716,11485365,43976005,858129935.089400,1350329255.940000,1440480027.852900,3648939218.882300,31781,1556,14909,48246
2020-03-04,NYSE (N),1228697961,86491626,57830461,1373020048,54750554241.992299,4986653268.270499,3035476655.882601,62772684166.145399,5041084,291090,443114,5775288
2020-03-04,NYSE Arca (P),288346767,508718067,288992752,1086057586,11914162257.432895,32731530741.286211,16847774506.608291,61493467505.327397,2587881,1666131,2472325,6726337
2020-03-04,NASDAQ (Q),608417405,396389175,968830507,1973637087,26454084026.896199,24910654262.657778,60284817277.824384,111649555567.378361,6022574,1809149,6987153,14818876
2020-03-04,Investors Exchange (V),163770866,36984103,88683942,289438911,7731685270.939499,2389171107.012701,5036336204.596201,15157192582.548401,1154697,154940,664967,1974604
2020-03-04,NASDAQ PSX (X),26087386,36460726,18968138,81516250,1024658820.628200,2108451584.579599,1472522166.186200,4605632571.393999,219979,163254,178656,561889
2020-03-04,BYX Equities (Y),107019999,78833089,67524619,253377707,3226795145.375900,4255961303.049100,2610427714.787799,10093184163.212799,1033709,374780,604777,2013266
2020-03-04,BZX Equities (Z),333973445,210391212,217539277,761903934,15198861479.341302,17524612930.404308,15315458133.652603,48038932543.398213,3264888,1141137,2105952,6511977
2020-03-03,NYSE American (A),21688186,42350573,9457270,73496029,752690658.654500,889166246.719400,522753652.465100,2164610557.839000,315058,166827,146798,628683
2020-03-03,NASDAQ BX (B),79978656,61521708,49134049,190634413,2706740926.404500,4409238394.661298,2661223621.696102,9777202942.761900,821436,658566,572355,2052357
2020-03-03,NYSE National (C),153535450,74295302,53464250,281295002,2918058266.038800,3198266188.142600,1690436121.454800,7806760575.636200,1267301,341051,534503,2142855
2020-03-03,FINRA / Nasdaq TRF Chicago (DB),6880915,4381129,9079663,20341707,234442545.932200,195931696.093000,856273285.519100,1286647527.544300,27403,13545,42466,83414
2020-03-03,FINRA / NYSE TRF (DN),256447146,214252870,407673169,878373185,7254817906.304599,8563974179.590894,19687282494.883300,35506074580.778793,816161,454151,1199926,2470238
2020-03-03,FINRA / Nasdaq TRF Carteret (DQ),1557381201,913155198,1204769891,3675306290,60850302461.345102,56835268156.891023,66351986204.089683,184037556822.325808,6034571,2043922,4312898,12391391
2020-03-03,EDGA Equities (J),221087758,77932598,96279331,395299687,6473824386.253102,5178527479.146198,4768831125.257700,16421182990.657000,2038046,539248,1089936,3667230
2020-03-03,EDGX Equities (K),272879629,320235635,263500203,856615467,9047815491.602997,20886401616.696017,14357725254.459395,44291942362.758409,2272386,1758471,1831602,5862459
2020-03-03,NYSE Chicago (M),19185389,15577065,11466394,46228848,1123500308.997300,1911363806.430000,1119856572.538200,4154720687.965500,38027,2279,20939,61245
2020-03-03,NYSE (N),1652230359,171720454,85759118,1909709931,70195762977.562100,9376883316.489504,5023590506.989901,84596236801.041505,7418033,599022,667257,8684312
2020-03-03,NYSE Arca (P),406110697,872339777,388326182,1666776656,15617056868.978602,54655289611.558025,26134252362.174094,96406598842.710721,3622253,3092443,3347187,10061883
2020-03-03,NASDAQ (Q),887675393,754274372,1241283154,2883232919,36255837393.898203,48283985566.096798,83548062063.709257,168087885023.704258,8612196,3571488,9507031,21690715
2020-03-03,Investors Exchange (V),181878370,57902752,99044171,338825293,8179786217.253801,4184878735.761900,6568842920.454299,18933507873.470000,1298116,263522,752518,2314156
2020-03-03,NASDAQ PSX (X),39607664,80682540,30789978,151080182,1753059767.494700,4539666839.937401,2689363574.412800,8982090181.844901,337029,368324,309346,1014699
2020-03-03,BYX Equities (Y),137369677,117344102,83628762,338342541,3972076706.322800,6845908376.880800,3661990207.101198,14479975290.304798,1325484,640090,760304,2725878
2020-03-03,BZX Equities (Z),482579800,409436930,303052590,1195069320,20525279826.986298,31807678364.445289,22875685006.064603,75208643197.496190,4597579,2282157,2987548,9867284
2020-03-02,NYSE American (A),21201445,43231985,9561823,73995253,725829738.840500,827263012.077300,529917985.408300,2083010736.326100,290574,149781,146464,586819
2020-03-02,NASDAQ BX (B),74717113,44093664,38144745,156955522,2609195670.832600,3116786916.496001,2220015925.885000,7945998513.213601,717202,486574,475354,1679130
2020-03-02,NYSE National (C),128763216,70279253,45362906,244405375,2599568238.797700,2800941341.167600,1428395892.613900,6828905472.579200,1035480,314676,445299,1795455
2020-03-02,FINRA / Nasdaq TRF Chicago (DB),6779029,3547189,8494588,18820806,248997705.573800,198533262.849200,776761728.998900,1224292697.421900,29962,12144,43339,85445
2020-03-02,FINRA / NYSE TRF (DN),268257626,203135389,343607047,815000062,7765744709.769200,8876393551.931897,19345732123.764297,35987870385.465394,741294,384319,904654,2030267
2020-03-02,FINRA / Nasdaq TRF Carteret (DQ),1794692527,979792962,1325834502,4100319991,69692475399.425920,61742823710.629899,74150623904.370164,205585923014.425983,6750509,2170438,4673074,13594021
2020-03-02,EDGA Equities (J),205084828,70009532,90565282,365659642,6298404812.566701,4170053469.813301,4164996769.309101,14633455051.689103,1952974,435843,1021092,3409909
2020-03-02,EDGX Equities (K),250871260,253839033,246166583,750876876,8444953638.551705,14925772804.696486,12885624398.821296,36256350842.069487,2051328,1327412,1665906,5044646
2020-03-02,NYSE Chicago (M),14372584,19750216,10283248,44406048,1160104959.042700,2658787811.740900,1085261511.616600,4904154282.400200,28394,2120,24964,55478
2020-03-02,NYSE (N),1714891696,112649657,71557275,1899098628,70337165993.126799,6292803455.771499,4431632564.694999,81061602013.593297,6568118,386352,564523,7518993
2020-03-02,NYSE Arca (P),351739615,722850352,348243293,1422833260,14276613593.003600,46085498473.447290,22110740058.747202,82472852125.198092,3193880,2343200,3038232,8575312
2020-03-02,NASDAQ (Q),765651465,503799509,1217430877,2486881851,33124186415.869296,32526613700.222896,79807765523.772383,145458565639.864575,7604589,2362738,8875338,18842665
2020-03-02,Investors Exchange (V),178506394,48040163,104975500,331522057,8027490169.918399,3312927503.959400,6230347433.349599,17570765107.227398,1276396,211494,770993,2258883
2020-03-02,NASDAQ PSX (X),35793831,46412706,22020294,104226831,1421185610.191500,2527032843.387199,1455909635.994600,5404128089.573299,293376,204365,219033,716774
2020-03-02,BYX Equities (Y),132708562,101685338,89146541,323540441,3877275793.875000,5962872500.304699,3489193119.922201,13329341414.101900,1305199,517096,724146,2546441
2020-03-02,BZX Equities (Z),437299657,309621609,277634561,1024555827,19694097886.568799,22936123806.310499,20742273276.337505,63372494969.216803,4260669,1660938,2720109,8641716
2020-02-28,NYSE American (A),28095666,73512136,12296252,113904054,978783656.556500,1249034366.716100,728830163.288800,2956648186.561400,337986,220080,157932,715998
2020-02-28,NASDAQ BX (B),96050656,64877226,55449804,216377686,3366860938.709399,4342698597.995198,3077380433.016700,10786939969.721297,928304,558268,597629,2084201
2020-02-28,NYSE National (C),188840157,96390602,64435845,349666604,3535218836.399900,3774335630.973399,2109475313.961100,9419029781.334399,1430508,447694,592021,2470223
2020-02-28,FINRA / Nasdaq TRF Chicago (DB),10754847,5866912,10682151,27303910,355664883.325200,290529205.262700,975572989.211000,1621767077.798900,38521,19142,52776,110439
2020-02-28,FINRA / NYSE TRF (DN),354777910,316881696,434398317,1106057923,9870492565.394999,13134405560.744991,19787656177.392501,42792554303.532491,1199607,715766,1494271,3409644
2020-02-28,FINRA / Nasdaq TRF Carteret (DQ),2121987877,1482872900,1521045889,5125906666,81381462502.971101,97725801544.650186,82854184665.812088,261961448713.433375,8191703,3040440,5548500,16780643
2020-02-28,EDGA Equities (J),293943206,74913221,117250960,486107387,8498596225.547101,5085514840.312100,5851642886.399001,19435753952.258202,2448301,525650,1206704,4180655
2020-02-28,EDGX Equities (K),348572384,417710810,304983752,1071266946,11376852407.282606,23401166810.186195,16586800271.462098,51364819488.930899,2773180,1940088,2201579,6914847
2020-02-28,NYSE Chicago (M),25896708,15174732,13299560,54371000,1486732134.959900,1711477968.199999,1696788887.793300,4894998990.953199,36432,5043,30944,72419
2020-02-28,NYSE (N),2458671173,174426101,96991248,2730088522,102534918825.657998,10084501332.570799,6071751809.040000,118691171967.268797,9135072,596111,766946,10498129
2020-02-28,NYSE Arca (P),475122906,1131133571,432768637,2039025114,18856836179.204905,68482260800.716891,27786230228.255902,115125327208.177698,4165298,3641065,3771822,11578185
2020-02-28,NASDAQ (Q),1058111897,817946302,1620303529,3496361728,44870266665.969289,54341387465.880688,107086786689.730056,206298440821.580033,10297565,3950180,11757624,26005369
2020-02-28,Investors Exchange (V),240581640,73851432,130578264,445011336,10782292574.165102,4943057456.989099,8102654414.433302,23828004445.587503,1658212,325095,949765,2933072
2020-02-28,NASDAQ PSX (X),51962796,86532589,35378657,173874042,2276186221.389100,5139787450.061801,3041707136.642099,10457680808.093000,437956,415461,356447,1209864
2020-02-28,BYX Equities (Y),169082679,138841216,100166333,408090228,5354569694.770300,7842363271.134499,4573581634.875498,17770514600.780297,1647721,754122,913274,3315117
2020-02-28,BZX Equities (Z),647120048,496615665,369992590,1513728303,27288237187.519702,37906039166.821870,26737046262.185293,91931322616.526865,5983943,2400261,3617927,12002131
2020-02-27,NYSE American (A),24479638,59835526,10484817,94799981,892875720.953700,1103717651.979400,680429129.595100,2677022502.528200,282695,195725,137271,615691
2020-02-27,NASDAQ BX (B),83085172,57477978,46755130,187318280,2971505521.877000,3442175814.639900,2610237042.951000,9023918379.467900,778577,616887,552591,1948055
2020-02-27,NYSE National (C),158411204,89658884,55215899,303285987,2954738893.380500,3282392520.847899,1785537808.262400,8022669222.490799,1201654,392011,529766,2123431
2020-02-27,FINRA / Nasdaq TRF Chicago (DB),10492943,4729626,9576746,24799315,336904465.304900,346971551.571800,869317579.034200,1553193595.910900,36446,15346,48346,100138
2020-02-27,FINRA / NYSE TRF (DN),361646097,269207762,406369373,1037223232,9283112126.387405,9243985330.550500,21380388205.842299,39907485662.780204,1095246,556922,1460805,3112973
2020-02-27,FINRA / Nasdaq TRF Carteret (DQ),2033584333,1057903346,1407145668,4498633347,73449002406.679820,62323788130.421013,78156358896.955236,213929149434.056069,7125283,2476891,5112938,14715112
2020-02-27,EDGA Equities (J),207034419,69496843,88709041,365240303,6515084662.947799,4307175342.895802,4456962537.828300,15279222543.671901,1855766,445924,967762,3269452
2020-02-27,EDGX Equities (K),295950251,321986433,265426801,883363485,9425699003.925100,17733623057.437606,14526996394.777316,41686318456.140022,2222044,1433627,1868031,5523702
2020-02-27,NYSE Chicago (M),18715154,22872595,9729537,51317286,1056900220.557700,3859945553.905100,1175837409.096300,6092683183.559100,23862,3963,20847,48672
2020-02-27,NYSE (N),1761983594,142101346,84791891,1988876831,71617299599.205403,8108238168.518999,4698277476.800703,84423815244.525105,6925433,468039,596593,7990065
2020-02-27,NYSE Arca (P),395774502,871638583,360546100,1627959185,15383155501.159898,54882476690.536878,23206294814.192394,93471927005.889170,3349806,2754410,3104728,9208944
2020-02-27,NASDAQ (Q),824182814,639255221,1285012998,2748451033,34604426642.092800,41405146857.650198,85245715409.280810,161255288909.023808,7701868,2811215,9510130,20023213
2020-02-27,Investors Exchange (V),207019772,51306749,118673021,376999542,8981273175.717500,3469508569.092399,7357385119.801597,19808166864.611496,1390823,220106,842845,2453774
2020-02-27,NASDAQ PSX (X),51516937,73919778,29828236,155264951,1641969930.445000,4474348485.016400,2181368638.122000,8297687053.583400,306827,340483,257787,905097
2020-02-27,BYX Equities (Y),146139937,125240940,86595029,357975906,4428333511.354499,6797064255.730801,4301533834.998200,15526931602.083500,1359328,640459,804918,2804705
2020-02-27,BZX Equities (Z),484695096,340360764,295047850,1120103710,21124651957.517406,27056571807.493283,22122144200.501703,70303367965.512392,4497783,1656554,2875766,9030103
2020-02-26,NYSE American (A),19055000,35701701,8107837,62864538,669297992.545500,835680915.249000,443139310.986000,1948118218.780500,232891,130397,113066,476354
2020-02-26,NASDAQ BX (B),68468799,46698332,37351302,152518433,2335709669.752400,2677637150.005399,2069430205.968800,7082777025.726599,656049,451344,465960,1573353
2020-02-26,NYSE National (C),124567040,65878448,43158296,233603784,2372625446.203900,2543088526.151500,1374051177.603900,6289765149.959300,951584,289083,427276,1667943
2020-02-26,FINRA / Nasdaq TRF Chicago (DB),7405840,3262287,7706637,18374764,217218158.404600,249183783.009000,626497963.844700,1092899905.258300,27136,11433,37634,76203
2020-02-26,FINRA / NYSE TRF (DN),309419093,164897432,339889129,814205654,7235764031.848201,6538268301.831604,16753673252.995302,30527705586.675107,875940,350456,1133166,2359562
2020-02-26,FINRA / Nasdaq TRF Carteret (DQ),1603869973,759303850,1115462578,3478636401,59386281335.053317,47288268524.069120,58112089427.374714,164786639286.497151,6018199,1757718,4171700,11947617
2020-02-26,EDGA Equities (J),166439991,46800965,78762538,292003494,5567389131.703499,2890348480.849101,3855464938.721300,12313202551.273900,1568755,297528,848033,2714316
2020-02-26,EDGX Equities (K),236667723,203073063,210798286,650539072,7365948253.935999,12422420348.819603,10515183750.231504,30303552352.987106,1777951,938533,1466674,4183158
2020-02-26,NYSE Chicago (M),23254394,13284534,10125117,46664045,1232134668.522000,2166927008.250001,1818702428.876400,5217764105.648401,17018,2120,17911,37049
2020-02-26,NYSE (N),1316479737,113780267,62763668,1493023672,55271912067.741385,6440728711.266401,3661170270.911400,65373811049.919186,5112086,321754,469366,5903206
2020-02-26,NYSE Arca (P),298682202,597232569,288717627,1184632398,11685642778.964403,39389002500.240879,17222696537.088401,68297341816.293683,2613770,1793412,2479019,6886201
2020-02-26,NASDAQ (Q),648429562,458595421,975436096,2082461079,27595920150.271805,31158480643.270593,62129311546.967292,120883712340.509690,6176995,1926749,7274316,15378060
2020-02-26,Investors Exchange (V),157361194,45491507,94550205,297402906,6722329186.340200,3096383726.931900,5546990687.875200,15365703601.147300,1115074,174578,689123,1978775
2020-02-26,NASDAQ PSX (X),34283895,53157746,22683994,110125635,1084577157.675800,3334522011.006600,1770059718.609800,6189158887.292200,229184,243423,198606,671213
2020-02-26,BYX Equities (Y),120201231,88964236,66851119,276016586,3644314883.591800,4937793367.558500,2943619854.982500,11525728106.132800,1166870,461755,646581,2275206
2020-02-26,BZX Equities (Z),350064337,245906878,225592448,821563663,15547426815.332003,19891228723.947292,15872098996.017398,51310754535.296693,3304264,1062919,2170638,6537821
2020-02-25,NYSE American (A),18792944,36398241,8605673,63796858,656402030.092100,917181678.679700,518710377.043700,2092294085.815500,220818,132413,114568,467799
2020-02-25,NASDAQ BX (B),65600144,48841612,34529821,148971577,2493186090.391600,2927988569.935399,2079936980.743600,7501111641.070599,620242,450749,449288,1520279
2020-02-25,NYSE National (C),115068583,67271010,42318927,224658520,2352114097.255000,2550580449.168000,1451134075.265200,6353828621.688200,905459,297316,431555,1634330
2020-02-25,FINRA / Nasdaq TRF Chicago (DB),9809696,4095152,8127320,22032168,304459979.583600,263728859.848600,733235958.230000,1301424797.662200,34459,12481,40891,87831
2020-02-25,FINRA / NYSE TRF (DN),326259772,184100065,323427302,833787139,8478503086.755405,7471137956.595501,18861980302.437006,34811621345.787912,1024091,422672,1180786,2627549
2020-02-25,FINRA / Nasdaq TRF Carteret (DQ),1645253457,809029668,1122654880,3576938005,62160502813.759603,52627016585.493397,66029737720.700509,180817257119.953509,6066425,1952672,4258441,12277538
2020-02-25,EDGA Equities (J),162301217,47596100,75935354,285832671,5872940661.217400,2956606858.489100,4028245143.225901,12857792662.932401,1619275,282433,886710,2788418
2020-02-25,EDGX Equities (K),252635512,221945672,208705081,683286265,8477301868.208598,14327165056.222294,11817739695.822802,34622206620.253694,1902937,954808,1593874,4451619
2020-02-25,NYSE Chicago (M),19845339,10143832,9684405,39673576,941721246.336000,1095888900.820000,1527499673.286500,3565109820.442500,21650,1888,17916,41454
2020-02-25,NYSE (N),1354355108,124190279,65653765,1544199152,58602806624.714200,7362038156.374704,3836556312.456500,69801401093.545404,5420461,337039,488321,6245821
2020-02-25,NYSE Arca (P),311228528,653152072,287808752,1252189352,12723200522.670899,44602465289.461606,19335972891.772903,76661638703.905408,2715638,1966766,2619283,7301687
2020-02-25,NASDAQ (Q),644108340,481852682,982378076,2108339098,29370046746.219003,34058777219.837099,68624808759.579595,132053632725.635697,6351519,2028132,7862337,16241988
2020-02-25,Investors Exchange (V),154005107,38003211,89751896,281760214,7044318913.878701,2877255141.911699,5450894997.490401,15372469053.280801,1103396,163031,683784,1950211
2020-02-25,NASDAQ PSX (X),29404602,58027778,22927418,110359798,1154242851.491900,3649461744.643000,1853675319.442500,6657379915.577400,221716,233665,199551,654932
2020-02-25,BYX Equities (Y),121985617,103502914,77783920,303272451,3880501381.677500,5544276727.135398,3789424025.901500,13214202134.714398,1246906,464618,749703,2461227
2020-02-25,BZX Equities (Z),366108096,253097618,235229630,854435344,17432985330.596697,20084160781.495704,18622195165.142998,56139341277.235399,3550206,1112262,2391289,7053757
2020-02-24,NYSE American (A),15776376,33296333,7339338,56412047,597167368.294200,688049004.585500,509903513.426400,1795119886.306100,218351,114535,117760,450646
2020-02-24,NASDAQ BX (B),55384107,39957346,32058935,127400388,2207794617.744500,2213311020.568700,2104286922.007700,6525392560.320900,537175,281753,390133,1209061
2020-02-24,NYSE National (C),104368880,59144327,38899480,202412687,2152487624.934700,2167598638.980799,1325748191.418800,5645834455.334299,812503,236556,393102,1442161
2020-02-24,FINRA / Nasdaq TRF Chicago (DB),7040921,3378675,6988848,17408444,223268231.736100,154446063.956500,590908144.785400,968622440.478000,28085,11582,39301,78968
2020-02-24,FINRA / NYSE TRF (DN),277741400,172026587,291588569,741356556,7683386325.233999,6381017472.345898,16758909450.429002,30823313248.008899,941803,420990,1153159,2515952
2020-02-24,FINRA / Nasdaq TRF Carteret (DQ),1466613320,697315894,1009379430,3173308644,57001838411.224479,44038313155.651688,62461942152.987179,163502093719.863346,5652934,1872094,4073387,11598415
2020-02-24,EDGA Equities (J),130706057,37945447,61888667,230540171,4897215160.404900,2252341905.258400,3630522128.864500,10780079194.527800,1369137,214929,761196,2345262
2020-02-24,EDGX Equities (K),208014232,176306216,182476874,566797322,7096019499.207700,10897858377.610299,10916201821.258199,28910079698.076198,1613842,731838,1396182,3741862
2020-02-24,NYSE Chicago (M),11495846,9442762,8799097,29737705,700709708.137600,1319781249.995000,1122245810.885000,3142736769.017600,17839,3261,14778,35878
2020-02-24,NYSE (N),1187191989,88848465,56538184,1332578638,52508782458.347509,5565006484.778202,3439786507.601299,61513575450.727010,4229129,220729,401759,4851617
2020-02-24,NYSE Arca (P),272981631,530515691,250336132,1053833454,11446925695.840099,34819454401.202122,17640283077.402594,63906663174.444815,2334599,1467773,2266749,6069121
2020-02-24,NASDAQ (Q),538966141,372240576,885888168,1797094885,24744073600.174999,24996887196.197122,65867782404.478228,115608743200.850349,5147874,1502829,6627081,13277784
2020-02-24,Investors Exchange (V),144920206,37875956,85344750,268140912,6806526329.774799,2330482478.736600,5413778553.282702,14550787361.794101,1046228,158651,637435,1842314
2020-02-24,NASDAQ PSX (X),25844615,43421946,19310516,88577077,989691529.369900,2990662667.658100,1680530025.734800,5660884222.762800,191799,168959,165125,525883
2020-02-24,BYX Equities (Y),107490385,93174848,63531044,264196277,3475887951.433800,4866456786.610300,3142227179.704800,11484571917.748900,1107661,393752,648034,2149447
2020-02-24,BZX Equities (Z),296626788,182923306,188229688,667779782,13780443719.581398,14009621613.942393,15215257532.756000,43005322866.279791,2848909,790942,1963223,5603074
2020-02-21,NYSE American (A),11569819,26932976,5688237,44191032,403750186.442300,492723590.038800,368648650.699100,1265122427.180200,150550,79109,81979,311638
2020-02-21,NASDAQ BX (B),45238206,25583749,24434445,95256400,1699950950.783100,1389384448.650600,1518205658.526700,4607541057.960400,454436,177912,299236,931584
2020-02-21,NYSE National (C),75707159,39373442,30557197,145637798,1643504530.201400,1499830351.798500,973136145.221600,4116471027.221500,650733,170112,322813,1143658
2020-02-21,FINRA / Nasdaq TRF Chicago (DB),6005479,2343668,6189788,14538935,196035765.371000,113920072.726800,586837989.348300,896793827.446100,21664,7001,31418,60083
2020-02-21,FINRA / NYSE TRF (DN),216233107,123756079,271016382,611005568,5853697212.677001,4222665021.336099,14681188018.723397,24757550252.736497,684410,263035,924785,1872230
2020-02-21,FINRA / Nasdaq TRF Carteret (DQ),1172351096,495078717,900486333,2567916146,44488879720.102096,33986934689.254275,52638934996.176209,131114749405.532580,4302847,1100906,3300008,8703761
2020-02-21,EDGA Equities (J),99723757,25142120,50111104,174976981,3725456321.302000,1578335745.401800,2815473244.286500,8119265310.990300,1077336,143184,630567,1851087
2020-02-21,EDGX Equities (K),152064809,108762652,145534383,406361844,5157914753.198399,6216477642.509197,7782687193.059501,19157079588.767097,1204179,417187,1044246,2665612
2020-02-21,NYSE Chicago (M),16232204,17166957,11474039,44873200,1001359690.733200,1744971937.008500,1831105191.488400,4577436819.230100,12945,2292,11963,27200
2020-02-21,NYSE (N),1055772302,53623775,43888079,1153284156,49182950585.295089,3440731970.395698,2837906184.247599,55461588739.938386,3243476,131759,298339,3673574
2020-02-21,NYSE Arca (P),201045771,327731946,206105669,734883386,7975703596.729998,20550638554.684305,14268722175.352397,42795064326.766700,1707646,871183,1782134,4360963
2020-02-21,NASDAQ (Q),405677431,232365273,753299677,1391342381,18116949655.286903,14535937283.928907,52014814587.318482,84667701526.534292,3886988,885289,5139134,9911411
2020-02-21,Investors Exchange (V),111578629,21474069,70540307,203593005,5189770757.167700,1576453959.674000,4116617566.734001,10882842283.575701,852192,96303,545172,1493667
2020-02-21,NASDAQ PSX (X),20984055,24657542,15740561,61382158,765566444.911200,1500057171.365200,1363012634.803700,3628636251.080100,155302,86863,131452,373617
2020-02-21,BYX Equities (Y),86451753,64900018,56712645,208064416,2966565109.302700,3104628880.180499,2486075901.693599,8557269891.176798,899806,269643,523103,1692552
2020-02-21,BZX Equities (Z),232149748,112708288,158383625,503241661,10485228538.131899,8278573136.820504,12409904532.926998,31173706207.879401,2207250,486463,1571502,4265215
2020-02-20,NYSE American (A),11264854,27103865,6324402,44693121,363095093.498900,423234723.742600,299205135.166600,1085534952.408100,141059,80544,78971,300574
2020-02-20,NASDAQ BX (B),47671994,25478739,26376701,99527434,1873874097.571100,1276602727.413799,1470637511.247900,4621114336.232799,492081,174898,327776,994755
2020-02-20,NYSE National (C),83114277,37511120,32176440,152801837,1766904298.324000,1353507193.379000,972130594.189900,4092542085.892900,689624,154187,336143,1179954
2020-02-20,FINRA / Nasdaq TRF Chicago (DB),6692386,2389628,6866156,15948170,219184056.974500,121853013.054800,643750906.175000,984787976.204300,24641,6709,33108,64458
2020-02-20,FINRA / NYSE TRF (DN),249694043,129291585,279301916,658287544,6697333879.788399,3722832249.987501,15083581820.789404,25503747950.565304,797868,255810,987248,2040926
2020-02-20,FINRA / Nasdaq TRF Carteret (DQ),1247895269,487501773,910235057,2645632099,47973155721.295593,26364015603.799608,51128167612.131020,125465338937.226221,4577506,985058,3342691,8905255
2020-02-20,EDGA Equities (J),109908979,25187119,54491820,189587918,4099838499.085300,1384210543.928600,2864091747.955000,8348140790.968900,1175839,146444,681016,2003299
2020-02-20,EDGX Equities (K),171824214,108079754,150612582,430516550,5668668644.022797,5959009805.427501,7822694368.703599,19450372818.153897,1309325,406853,1101759,2817937
2020-02-20,NYSE Chicago (M),14936337,13560782,11349635,39846754,737184930.490600,1081513713.585000,745264097.073400,2563962741.149000,10343,1834,9641,21818
2020-02-20,NYSE (N),926395985,56481478,44913924,1027791387,39621091688.783193,3387231127.321300,2494544930.916300,45502867747.020793,3600465,129822,312628,4042915
2020-02-20,NYSE Arca (P),227453297,338800920,220203043,786457260,8693255596.111501,20326839253.527300,13326932996.149100,42347027845.787901,1859069,838965,1846654,4544688
2020-02-20,NASDAQ (Q),442968390,229204143,695873618,1368046151,19555996054.916102,14063827696.794504,45221189418.810672,78841013170.521278,4353223,888063,5356430,10597716
2020-02-20,Investors Exchange (V),125643952,28055389,75185959,228885300,5793758449.225000,1577392002.349600,4390080243.441500,11761230695.016100,898977,97945,567942,1564864
2020-02-20,NASDAQ PSX (X),19922871,25091343,15581707,60595921,830618721.782300,1511603835.069500,1288387529.405000,3630610086.256800,159814,86793,136151,382758
2020-02-20,BYX Equities (Y),90987285,65218439,54383835,210589559,2979477099.892700,2795326795.659699,2386028780.105200,8160832675.657599,909615,238797,541488,1689900
2020-02-20,BZX Equities (Z),242813918,112145361,161861550,516820829,10843506152.902301,7822053720.332998,11959462114.431698,30625021987.666997,2326276,468840,1623363,4418479
2020-02-19,NYSE American (A),9259368,23166285,4168195,36593848,303853198.485000,271021377.206900,200789485.435700,775664061.127600,96543,69246,44560,210349
2020-02-19,NASDAQ BX (B),38443248,15456410,21415241,75314899,1429474774.995200,806115179.490000,1109002173.592500,3344592128.077700,388355,92448,247894,728697
2020-02-19,NYSE National (C),71463719,27153880,29393977,128011576,1423135607.118900,963876976.279900,769577300.182400,3156589883.581200,591992,118114,290781,1000887
2020-02-19,FINRA / Nasdaq TRF Chicago (DB),5368857,1902589,5623072,12894518,160302605.525800,71404216.533800,616582837.173900,848289659.233500,18989,5588,31359,55936
2020-02-19,FINRA / NYSE TRF (DN),221482237,108602064,249596962,579681263,5761835349.265201,2804675803.133701,13548660399.536406,22115171551.935308,740894,235569,931134,1907597
2020-02-19,FINRA / Nasdaq TRF Carteret (DQ),1200855095,400697423,873880328,2475432846,45441138024.775896,22876515444.623393,45751978685.308704,114069632154.707993,4368262,930115,3174324,8472701
2020-02-19,EDGA Equities (J),91628924,17492610,44518456,153639990,3529711039.060800,910766501.249900,2388459466.650300,6828937006.961000,988319,98606,569804,1656729
2020-02-19,EDGX Equities (K),149435987,76206652,129104201,354746840,4799730655.629800,3407535524.257599,6605998750.774806,14813264930.662205,1150326,277724,948789,2376839
2020-02-19,NYSE Chicago (M),8139090,5971997,10601640,24712727,765118530.365500,490999957.373000,1722618714.243300,2978737201.981800,10341,1479,8730,20550
2020-02-19,NYSE (N),829117184,34328754,37952031,901397969,35485449456.001398,1830555525.058700,1888970815.010000,39204975796.070098,2960057,78391,266760,3305208
2020-02-19,NYSE Arca (P),198775649,227243510,183915320,609934479,7963521575.032401,12690215506.537704,11488943952.811004,32142681034.381109,1662762,553477,1569377,3785616
2020-02-19,NASDAQ (Q),368249736,144302785,609110591,1121663112,16055962765.352197,8149794595.486799,41108528323.089012,65314285683.928008,3638051,559132,4476236,8673419
2020-02-19,Investors Exchange (V),118289759,16785476,75873375,210948610,5411796448.851200,1001072568.576400,3874288889.441200,10287157906.868800,876331,77364,532538,1486233
2020-02-19,NASDAQ PSX (X),17995584,15316208,14010270,47322062,635127950.409400,886078154.592500,985101887.691100,2506307992.693000,131083,58217,104338,293638
2020-02-19,BYX Equities (Y),80533536,45286244,46889003,172708783,2639307252.637000,1719171685.148800,1984093255.397799,6342572193.183599,811942,167282,469479,1448703
2020-02-19,BZX Equities (Z),205167536,68997584,134812695,408977815,9037069025.231998,4111554784.875200,9586219106.623304,22734842916.730502,1956779,277229,1342730,3576738
2020-02-18,NYSE American (A),8748649,20494100,4156617,33399366,310467361.701800,317807965.876200,197143945.194000,825419272.772000,94388,64219,45680,204287
2020-02-18,NASDAQ BX (B),38619283,19204112,21127090,78950485,1453940646.342600,945129890.088100,1224202786.462400,3623273322.893100,373350,119183,243785,736318
2020-02-18,NYSE National (C),70008893,30963281,26630107,127602281,1455902195.690000,1069841405.692900,773613462.977100,3299357064.360000,589901,134630,293092,1017623
2020-02-18,FINRA / Nasdaq TRF Chicago (DB),5635668,2031553,5749948,13417169,171258291.850600,96222220.180300,517905972.565800,785386484.596700,21661,5972,29502,57135
2020-02-18,FINRA / NYSE TRF (DN),234433796,96289839,221525066,552248701,5958443372.216300,3049444319.743499,12651511573.378701,21659399265.338500,802316,236741,892448,1931505
2020-02-18,FINRA / Nasdaq TRF Carteret (DQ),1225628288,390849188,776527434,2393004910,48896983175.077706,22821909325.369788,45470116706.383391,117189009206.830885,4360214,962085,3009232,8331531
2020-02-18,EDGA Equities (J),93307302,19546535,44443996,157297833,3659344824.926700,1070909406.184900,2532888569.789700,7263142800.901300,1011150,116180,565113,1692443
2020-02-18,EDGX Equities (K),149471913,79966137,122332612,351770662,4808048908.202799,4370535544.326100,6758002267.249294,15936586719.778193,1160679,326333,937166,2424178
2020-02-18,NYSE Chicago (M),16199636,3845586,7829657,27874879,1261410050.870900,405623128.255000,1183936486.127100,2850969665.253000,10875,1909,9364,22148
2020-02-18,NYSE (N),916399673,40028415,37057891,993485979,40322919945.296506,2426417697.064699,1973413305.986500,44722750948.347705,3042472,101760,261630,3405862
2020-02-18,NYSE Arca (P),201884349,276787787,174634970,653307106,7893271189.613804,16505149924.279791,11317679001.525598,35716100115.419193,1668193,637928,1524195,3830316
2020-02-18,NASDAQ (Q),378527231,165617782,591915967,1136060980,16181574477.161798,9972789533.964503,39772952733.355629,65927316744.481930,3683901,646971,4475694,8806566
2020-02-18,Investors Exchange (V),103623968,18595544,61757612,183977124,4830710816.088401,1104532983.068100,3651067164.194901,9586310963.351402,770740,83961,477141,1331842
2020-02-18,NASDAQ PSX (X),18256672,19283742,13261431,50801845,686355182.069800,1181844547.589300,880564672.051900,2748764401.711000,137444,69441,107968,314853
2020-02-18,BYX Equities (Y),80640820,47178667,41884950,169704437,2617882305.136200,2119407484.082900,2024359956.233100,6761649745.452200,786184,194639,445216,1426039
2020-02-18,BZX Equities (Z),209014515,79442837,128587964,417045316,9224119792.194399,5195382203.384603,9414087150.466297,23833589146.045299,1985210,331567,1307238,3624015
2020-02-14,NYSE American (A),9126097,19192115,4025061,32343273,299958191.022000,262330242.536600,182705264.326900,744993697.885500,82206,54727,37186,174119
2020-02-14,NASDAQ BX (B),35313990,16355519,19573452,71242961,1321230610.636500,875918442.966200,1089829320.616000,3286978374.218700,350129,110835,230752,691716
2020-02-14,NYSE National (C),66779060,25185843,25837954,117802857,1367375971.254700,932813148.860100,722284529.442800,3022473649.557600,572809,112255,290299,975363
2020-02-14,FINRA / Nasdaq TRF Chicago (DB),5434760,1339955,4879692,11654407,159336276.056500,56607455.993900,487571208.231500,703514940.281900,18142,4314,26524,48980
2020-02-14,FINRA / NYSE TRF (DN),254613246,91718045,253784421,600115712,5887288451.288202,2701341298.171100,14575256469.865402,23163886219.324704,725230,204762,917712,1847704
2020-02-14,FINRA / Nasdaq TRF Carteret (DQ),1047117705,326590996,736136823,2109845524,40652116750.856590,22622578535.084902,39268710682.475108,102543405968.416600,3808262,746623,2782847,7337732
2020-02-14,EDGA Equities (J),85783843,16870758,42118044,144772645,3388972668.170600,997817059.415400,2348707806.975900,6735497534.561900,972256,98162,571826,1642244
2020-02-14,EDGX Equities (K),144942410,62469471,120851349,328263230,4410299895.171800,3598293153.366300,6175994011.823898,14184587060.361998,1061264,243298,909243,2213805
2020-02-14,NYSE Chicago (M),15691137,8215854,6715316,30622307,839627126.443800,998325802.192500,1028698556.654100,2866651485.290400,9195,1114,9670,19979
2020-02-14,NYSE (N),844235559,32709267,35453820,912398646,35885335262.963500,2095252083.705700,1886195357.176100,39866782703.845300,2800922,78667,255404,3134993
2020-02-14,NYSE Arca (P),188567313,196799864,174039556,559406733,7126756780.510699,12822538532.317103,10723240467.759089,30672535780.586891,1502591,523832,1521219,3547642
2020-02-14,NASDAQ (Q),340380013,135136286,566156580,1041672879,14757480925.687702,8788596235.108797,37341577596.940490,60887654757.736989,3407113,531960,4248830,8187903
2020-02-14,Investors Exchange (V),102827745,15262491,61447761,179537997,4685196516.773300,1016536359.309100,3362794991.172599,9064527867.254999,768846,72057,474974,1315877
2020-02-14,NASDAQ PSX (X),15703093,15115469,12070850,42889412,595020769.821700,981952688.097300,914600332.167500,2491573790.086500,121680,53748,98763,274191
2020-02-14,BYX Equities (Y),74331686,37516073,40276437,152124196,2414932601.345300,1789662885.863900,1885783743.562700,6090379230.771900,738001,160465,449283,1347749
2020-02-14,BZX Equities (Z),188855169,64771926,123360899,376987994,8274164308.302401,4681905365.428700,9249637638.568497,22205707312.299598,1795968,270725,1270683,3337376
2020-02-13,NYSE American (A),9638015,23683670,4660766,37982451,317977836.905300,367529886.181800,202922849.515400,888430572.602500,88059,69855,43622,201536
2020-02-13,NASDAQ BX (B),35912690,18608013,19350827,73871530,1468283972.215100,897130917.451600,1186388843.980100,3551803733.646800,359395,122916,240334,722645
2020-02-13,NYSE National (C),67511630,29774360,26421084,123707074,1479282109.254700,1062021916.100700,827108609.820900,3368412635.176300,590021,125493,297562,1013076
2020-02-13,FINRA / Nasdaq TRF Chicago (DB),4385513,1373861,5087902,10847276,177383399.986400,66064451.860100,563716826.720400,807164678.566900,18111,4647,28121,50879
2020-02-13,FINRA / NYSE TRF (DN),206729286,92416808,222399065,521545159,5949434426.191899,3005182835.094300,13996972693.112390,22951589954.398589,638015,200743,841157,1679915
2020-02-13,FINRA / Nasdaq TRF Carteret (DQ),1180682520,396506025,760797574,2337986119,47455624892.662696,22174056615.231710,44396212245.866281,114025893753.760687,3858142,813510,2885714,7557366
2020-02-13,EDGA Equities (J),86677776,18590299,42368203,147636278,3576419233.868400,1069649835.394300,2396884045.595300,7042953114.858000,962620,103755,546545,1612920
2020-02-13,EDGX Equities (K),138325514,73976752,121107830,333410096,4811338073.625801,4054323729.749200,6831951959.948298,15697613763.323299,1074620,288694,934487,2297801
2020-02-13,NYSE Chicago (M),12918509,6265584,6648633,25832726,1224950312.361400,1060298736.103200,904068784.397500,3189317832.862100,10868,1386,10514,22768
2020-02-13,NYSE (N),816646981,39986683,37234111,893867775,36628928257.912401,2353431913.232300,1986873699.180800,40969233870.325501,2846028,88673,251107,3185808
2020-02-13,NYSE Arca (P),184061382,241020701,176576063,601658146,7728479369.696900,15053613848.568192,12150042977.300802,34932136195.565894,1520657,609243,1557019,3686919
2020-02-13,NASDAQ (Q),360406167,156898880,585667133,1102972180,16799211664.223595,9736057944.594700,40632169459.397830,67167439068.216125,3640757,612035,4522707,8775499
2020-02-13,Investors Exchange (V),107069748,15008351,60628258,182706357,5152158421.136600,941098446.405800,3472271382.065799,9565528249.608199,786539,71376,480811,1338726
2020-02-13,NASDAQ PSX (X),17195171,17180422,12376646,46752239,643431643.587200,1061503427.897000,878811131.612100,2583746203.096300,126485,57994,100636,285115
2020-02-13,BYX Equities (Y),72002939,41979139,40365646,154347724,2528850006.855200,1998518927.640800,2033012897.436100,6560381831.932100,726315,174530,451951,1352796
2020-02-13,BZX Equities (Z),200733707,76100367,133181076,410015150,9275244221.159103,5177771122.880099,9800865909.341100,24253881253.380302,1876886,310559,1323390,3510835
2020-02-12,NYSE American (A),11243100,24266018,4912299,40421417,361674975.964800,334910436.490300,239525260.358900,936110672.814000,93268,72018,49846,215132
2020-02-12,NASDAQ BX (B),42018230,18186026,22057517,82261773,1656031656.701200,889730450.818200,1342242009.268700,3888004116.788100,410152,119443,253404,782999
2020-02-12,NYSE National (C),74421056,29505471,26982051,130908578,1531218457.772900,1048706443.299800,825620299.535900,3405545200.608600,616827,124919,293010,1034756
2020-02-12,FINRA / Nasdaq TRF Chicago (DB),5708217,1914215,5318361,12940793,218501765.381800,79358330.743000,434102497.653700,731962593.778500,21430,5427,25032,51889
2020-02-12,FINRA / NYSE TRF (DN),309696536,118095143,284737110,712528789,8391519736.445401,3372114871.712401,15401897280.815906,27165531888.973708,840871,269912,954519,2065302
2020-02-12,FINRA / Nasdaq TRF Carteret (DQ),1209913856,388110647,728623318,2326647821,46195313915.562900,21218125284.641104,39550635204.807807,106964074405.011811,4257012,831757,2820801,7909570
2020-02-12,EDGA Equities (J),98872873,18218593,45548601,162640067,3823872596.124700,1056484110.443500,2390726553.245800,7271083259.814000,1063147,110407,583584,1757138
2020-02-12,EDGX Equities (K),161536899,80334959,129170932,371042790,5361583370.174101,3632571960.912599,6559557388.819304,15553712719.906004,1185831,295255,953864,2434950
2020-02-12,NYSE Chicago (M),13336664,6370004,11414012,31120680,844044491.209900,834213542.253000,1455483445.547100,3133741479.010000,9565,1711,10667,21943
2020-02-12,NYSE (N),929176798,35378631,37664588,1002220017,39449941275.066998,1976058935.604900,1922033931.940100,43348034142.611998,2993010,85758,261743,3340511
2020-02-12,NYSE Arca (P),203426871,226017223,179499859,608943953,7995699217.532699,13057309075.534402,10682809670.998496,31735817964.065597,1581901,576848,1504606,3663355
2020-02-12,NASDAQ (Q),414241864,144949553,621847778,1181039195,18488239150.782701,8455115658.418100,40273374609.620995,67216729418.821796,3838456,582076,4459281,8879813
2020-02-12,Investors Exchange (V),125404512,17976809,72203172,215584493,6070718784.918201,997372402.262000,4144347941.249499,11212439128.429700,884651,82745,541252,1508648
2020-02-12,NASDAQ PSX (X),20922970,16106855,13171416,50201241,745121159.631900,899259888.435300,987586979.560200,2631968027.627400,142028,57271,107443,306742
2020-02-12,BYX Equities (Y),83676882,41900451,42595443,168172776,2876798519.351999,2053288493.910300,2131083026.356400,7061170039.618699,853672,189761,476984,1520417
2020-02-12,BZX Equities (Z),227321454,71446733,140771222,439539409,10165654936.471700,4498334790.150301,9789976223.853999,24453965950.476000,2062282,296387,1372873,3731542
2020-02-11,NYSE American (A),11201346,20191878,5006639,36399863,336097298.422900,379420082.121600,244104635.118600,959622015.663100,94955,66651,44120,205726
2020-02-11,NASDAQ BX (B),43532213,21221705,23155855,87909773,1581138782.247100,1113736363.660400,1395231000.758100,4090106146.665600,413888,141273,264842,820003
2020-02-11,NYSE National (C),75573590,30036712,28160631,133770933,1512035081.435900,1109789509.865200,875265083.354600,3497089674.655700,617937,129537,303561,1051035
2020-02-11,FINRA / Nasdaq TRF Chicago (DB),5130602,1800165,5866795,12797562,173113461.134400,102499373.637400,543344283.187100,818957117.958900,18747,5062,28201,52010
2020-02-11,FINRA / NYSE TRF (DN),280303574,106940821,303624465,690868860,7099131625.050503,3495724349.317299,17766743027.165696,28361599001.533498,805788,253550,1029174,2088512
2020-02-11,FINRA / Nasdaq TRF Carteret (DQ),1151414005,380067472,753925568,2285407045,42273532696.130709,22504324584.390602,42699716646.653100,107477573927.174411,4247677,814265,2935851,7997793
2020-02-11,EDGA Equities (J),99683318,19808279,47243044,166734641,3804297659.996700,1204186699.913000,2664267563.054600,7672751922.964300,1079924,111768,612642,1804334
2020-02-11,EDGX Equities (K),169091024,72764836,142183780,384039640,5189395910.675000,4071343765.653301,7688652179.476296,16949391855.804597,1189238,284721,999976,2473935
2020-02-11,NYSE Chicago (M),11049086,6460957,19037410,36547453,651865369.496300,875394825.605400,1235710696.068201,2762970891.169901,10337,1500,9454,21291
2020-02-11,NYSE (N),835348832,37405225,39989495,912743552,34756737168.830208,2399650126.409700,2361874883.283100,39518262178.523008,3004105,90258,269371,3363734
2020-02-11,NYSE Arca (P),211245555,230679692,195011109,636936356,7391215562.025400,14500226084.506292,12444630646.409698,34336072292.941390,1553668,593997,1561392,3709057
2020-02-11,NASDAQ (Q),416735066,152816329,607821926,1177373321,17371428644.259100,9670311574.849798,39546628428.643308,66588368647.752206,3787887,612966,4720207,9121060
2020-02-11,Investors Exchange (V),123512619,17932285,72380311,213825215,5419276632.721000,1083497601.249500,4198635608.499301,10701409842.469801,866397,79667,536417,1482481
2020-02-11,NASDAQ PSX (X),21661190,17841102,15574041,55076333,726359031.248000,1131106798.610000,1181365443.380100,3038831273.238100,141701,62496,119044,323241
2020-02-11,BYX Equities (Y),84969404,44031867,42275358,171276629,2787281950.928300,2202324705.172800,2429852862.291200,7419459518.392300,843625,184091,480686,1508402
2020-02-11,BZX Equities (Z),222497882,74949128,148819909,446266919,9573170383.840998,5051050993.266000,11244815075.633901,25869036452.740899,2033146,306040,1433264,3772450
2020-02-10,NYSE American (A),8989449,19082971,4203717,32276137,317377004.537900,287551071.665100,181121084.704200,786049160.907200,81109,60005,38383,179497
2020-02-10,NASDAQ BX (B),38571907,15957012,20322956,74851875,1400190494.802100,776267772.602000,1218975789.092500,3395434056.496600,364868,109518,224223,698609
2020-02-10,NYSE National (C),65416574,25152359,24953466,115522399,1373931144.905500,895683982.169700,713247745.346100,2982862872.421300,556571,109431,266838,932840
2020-02-10,FINRA / Nasdaq TRF Chicago (DB),5250734,1709820,5025254,11985808,162634920.397700,77786263.004000,555618136.583200,796039319.984900,19573,5142,28186,52901
2020-02-10,FINRA / NYSE TRF (DN),275308247,101780346,286318514,663407107,6711898899.689301,3147125210.662000,17680494962.590701,27539519072.942002,826872,257243,1006255,2090370
2020-02-10,FINRA / Nasdaq TRF Carteret (DQ),1043235512,326308262,684003704,2053547478,41320651907.655695,17940925826.166997,41042221909.825989,100303799643.648681,3859462,831388,2606849,7297699
2020-02-10,EDGA Equities (J),84222105,15358751,39902878,139483734,3469791536.868900,903872400.256700,2243174864.689600,6616838801.815200,945902,90825,514132,1550859
2020-02-10,EDGX Equities (K),155740987,63534754,126164539,345440280,4934998258.720800,3229825617.269903,6866949030.958400,15031772906.949103,1090315,258176,869627,2218118
2020-02-10,NYSE Chicago (M),11613064,7738597,7475958,26827619,942338294.521000,888660812.990000,834064350.137800,2665063457.648800,9118,1774,8502,19394
2020-02-10,NYSE (N),846624826,28365408,32733272,907723506,36752906434.658201,1681193814.964600,1683506707.923000,40117606957.545801,2676403,73675,220141,2970219
2020-02-10,NYSE Arca (P),182872413,215661039,151196879,549730331,7123599639.755799,13176715617.260202,10220792830.482501,30521108087.498502,1459895,519701,1336922,3316518
2020-02-10,NASDAQ (Q),354433311,127096833,577120546,1058650690,15679285738.500093,7700479169.868203,40383999290.086106,63763764198.454402,3342871,519137,3988129,7850137
2020-02-10,Investors Exchange (V),103666330,14475728,57024827,175166885,4905798178.809900,850453802.535300,3499008063.862400,9255260045.207600,766581,66937,452045,1285563
2020-02-10,NASDAQ PSX (X),19566392,14030939,12581036,46178367,697310117.824000,824809781.137300,870357503.307300,2392477402.268600,134340,54911,102662,291913
2020-02-10,BYX Equities (Y),72782445,36713542,38078984,147574971,2485104102.628900,1751993416.135000,1856170809.423900,6093268328.187800,731778,167924,413977,1313679
2020-02-10,BZX Equities (Z),194442548,64951797,120422374,379816719,8877348140.211799,4130241572.913600,8976821523.374002,21984411236.499401,1795099,270234,1175116,3240449
2020-02-07,NYSE American (A),8869820,18105473,4623529,31598822,287083143.796200,321732498.909600,221000975.454800,829816618.160600,76702,54688,41562,172952
2020-02-07,NASDAQ BX (B),40090966,23598831,23774596,87464393,1524886120.764100,1133063231.875100,1319623690.669200,3977573043.308400,399167,171809,263057,834033
2020-02-07,NYSE National (C),73172994,30959003,28734340,132866337,1543187603.043800,1106750774.799700,906528033.188200,3556466411.031700,595198,132645,301994,1029837
2020-02-07,FINRA / Nasdaq TRF Chicago (DB),5574269,1605546,5014147,12193962,158457889.352700,77929418.073500,509218588.523300,745605895.949500,19454,4737,24951,49142
2020-02-07,FINRA / NYSE TRF (DN),286261197,104840135,242362877,633464209,7026463345.200599,3819659399.120201,15453024020.912791,26299146765.233591,826340,250061,888366,1964767
2020-02-07,FINRA / Nasdaq TRF Carteret (DQ),1159670487,335053725,710888571,2205612783,43348576783.956294,21576822262.463004,39861139078.849521,104786538125.268819,4015991,855483,2705333,7576807
2020-02-07,EDGA Equities (J),96074975,19506543,46984149,162565667,3672357202.877300,1158738959.973500,2529237347.942800,7360333510.793600,1058357,115148,597256,1770761
2020-02-07,EDGX Equities (K),165457925,74683262,125393762,365534949,5152931536.617200,4281885575.509602,6652853296.917198,16087670409.044000,1183726,306702,938565,2428993
2020-02-07,NYSE Chicago (M),11091371,13085650,6187247,30364268,459910757.118400,1925872758.456000,670185743.665700,3055969259.240100,9287,1380,8671,19338
2020-02-07,NYSE (N),859879031,39142131,36597463,935618625,36752006438.599808,2384939150.351902,1916923751.087600,41053869340.039310,3001900,101423,249090,3352413
2020-02-07,NYSE Arca (P),196618239,231551853,163769565,591939657,7255511634.812799,14553981905.521605,10313757014.896597,32123250555.231001,1574294,658613,1452053,3684960
2020-02-07,NASDAQ (Q),398046132,165236701,589532823,1152815656,16933934477.320196,10673960709.937505,38063661765.083803,65671556952.341504,3687214,696926,4413818,8797958
2020-02-07,Investors Exchange (V),114065678,17091567,68779369,199936614,5341461642.349599,1047973416.162600,4001120848.110200,10390555906.622399,793067,77090,501762,1371919
2020-02-07,NASDAQ PSX (X),20624732,18430690,14983512,54038934,674312863.654000,1170306499.190000,1188507723.345400,3033127086.189400,144496,74395,115529,334420
2020-02-07,BYX Equities (Y),79014000,45772818,42782799,167569617,2653934985.397600,2302008846.779400,2043784432.632900,6999728264.809900,824024,204486,479579,1508089
2020-02-07,BZX Equities (Z),219415981,81315836,133311606,434043423,9842579348.871899,5454348680.654701,10285165939.305203,25582093968.831803,1904775,338046,1270465,3513286
2020-02-06,NYSE American (A),9289054,19582327,5035940,33907321,338194863.078500,381379306.906500,239937681.682100,959511851.667100,79370,55601,44479,179450
2020-02-06,NASDAQ BX (B),43951686,23220393,24219229,91391308,1734732257.377300,1102948459.010400,1468273899.009800,4305954615.397500,429325,154021,268355,851701
2020-02-06,NYSE National (C),74184325,31448012,28867745,134500082,1572123618.069700,1224318152.256800,868672758.295000,3665114528.621500,605295,137401,300504,1043200
2020-02-06,FINRA / Nasdaq TRF Chicago (DB),5901096,1657877,4952185,12511158,197537250.754200,74047847.764100,557310908.713300,828896007.231600,21044,4807,27474,53325
2020-02-06,FINRA / NYSE TRF (DN),268323515,102666252,249209514,620199281,7659312564.793701,3637233210.552901,17380479098.554993,28677024873.901595,812467,237577,944714,1994758
2020-02-06,FINRA / Nasdaq TRF Carteret (DQ),1140908417,365837807,715596000,2222342224,45991678949.032696,21640291639.901996,40323990092.046584,107955960680.981276,4169988,835983,2742738,7748709
2020-02-06,EDGA Equities (J),100499731,21518584,47194014,169212329,3895330681.928799,1178880321.275500,2497725941.247100,7571936944.451399,1106894,117194,608287,1832375
2020-02-06,EDGX Equities (K),178307482,75035256,128618353,381961091,5999146820.142699,3924709927.903702,6904669664.847800,16828526412.894201,1294244,288521,974771,2557536
2020-02-06,NYSE Chicago (M),10005927,9335116,9725821,29066864,525595709.511500,1379204430.813600,1378126801.057700,3282926941.382800,8595,1198,9193,18986
2020-02-06,NYSE (N),949915477,37656894,37059083,1024631454,41705861550.257101,2145255053.360100,1854882573.210000,45705999176.827201,3139837,92827,247421,3480085
2020-02-06,NYSE Arca (P),219923325,237069593,169441692,626434610,8417784569.626999,14358891615.333595,11389463130.259701,34166139315.220295,1700898,613902,1504488,3819288
2020-02-06,NASDAQ (Q),438191842,159969061,634386209,1232547112,19168759251.877397,9668780955.913501,45204099665.237984,74041639873.028882,4028899,631043,4640739,9300681
2020-02-06,Investors Exchange (V),115213125,17937691,66867566,200018382,5700374805.944603,1045232569.283100,3984516038.661499,10730123413.889202,829534,82839,492775,1405148
2020-02-06,NASDAQ PSX (X),22413640,19491375,14607371,56512386,790547451.269300,1128758637.618500,1057676040.972700,2976982129.860500,150405,69978,117185,337568
2020-02-06,BYX Equities (Y),82121021,48854678,42761315,173737014,2857745254.508200,2374243062.626600,2073281022.318200,7305269339.453000,841124,202563,478363,1522050
2020-02-06,BZX Equities (Z),228108776,74863766,135319671,438292213,10337002759.816697,4790949032.360198,10227741704.258201,25355693496.435096,1968869,310521,1300226,3579616
2020-02-05,NYSE American (A),8757630,20256578,4885471,33899679,350743604.405200,374659791.199000,264809658.603400,990213054.207600,82767,65243,44700,192710
2020-02-05,NASDAQ BX (B),52830901,30315675,30239859,113386435,1921312904.639800,1445871419.897400,1909055260.019500,5276239584.556700,473393,200977,312319,986689
2020-02-05,NYSE National (C),87468621,45231728,34044657,166745006,1882379366.882400,1647318450.376500,1172163628.580800,4701861445.839700,717466,179372,352103,1248941
2020-02-05,FINRA / Nasdaq TRF Chicago (DB),6208229,2481005,6047681,14736915,231413890.923500,111750287.723700,797617598.647100,1140781777.294300,22500,6138,35731,64369
2020-02-05,FINRA / NYSE TRF (DN),288649438,119137196,259078596,666865230,7627335811.807001,3980676029.260000,18939463919.910105,30547475760.977106,863012,268641,1020909,2152562
2020-02-05,FINRA / Nasdaq TRF Carteret (DQ),1184563330,418463204,740696136,2343722670,49116780888.590608,25869605874.702500,47160756484.263596,122147143247.556704,4356914,894279,2861448,8112641
2020-02-05,EDGA Equities (J),113954180,28992678,53134134,196080992,4538809300.574800,1657330896.303300,3297505209.721599,9493645406.599699,1225152,157259,672206,2054617
2020-02-05,EDGX Equities (K),179963041,95592643,141594768,417150452,6241529904.870999,5047153488.056902,8922473230.556396,20211156623.484297,1399629,372456,1119489,2891574
2020-02-05,NYSE Chicago (M),11516806,9803024,7058433,28378263,642053979.754300,1202133166.079800,1191193198.472800,3035380344.306900,12119,1355,11997,25471
2020-02-05,NYSE (N),994261936,52413098,43725747,1090400781,44329933951.197501,3095032815.884502,2640649135.552101,50065615902.634104,3555539,134659,296150,3986348
2020-02-05,NYSE Arca (P),220336406,328693868,189561079,738591353,9191197457.209701,19890524489.793895,15313522088.788892,44395244035.792488,1923455,843205,1834048,4600708
2020-02-05,NASDAQ (Q),460206853,210734459,672078331,1343019643,21142585735.803792,12913753292.421700,54577153192.867630,88633492221.093122,4435893,831191,5305124,10572208
2020-02-05,Investors Exchange (V),145518442,24433130,74251239,244202811,7038915839.041599,1527639959.636000,5493274101.387100,14059829900.064699,1034915,108849,591501,1735265
2020-02-05,NASDAQ PSX (X),23268584,23383198,15849255,62501037,836423912.106600,1453884717.128200,1387899227.787100,3678207857.021900,167370,84582,138802,390754
2020-02-05,BYX Equities (Y),94979824,63917123,48640637,207537584,3305444461.879000,3171965297.230501,2800468852.005299,9277878611.114800,966495,263594,548648,1778737
2020-02-05,BZX Equities (Z),249002035,103962945,149354077,502319057,11487199090.795803,6791150020.430200,12575849262.985497,30854198374.211500,2191534,414111,1484120,4089765
2020-02-04,NYSE American (A),7485750,28400348,4440712,40326810,318208886.721200,406544545.696400,304194997.555700,1028948429.973300,76083,76427,42513,195023
2020-02-04,NASDAQ BX (B),49690873,29826684,27335566,106853123,1884524882.575500,1368250581.896200,2022319017.945900,5275094482.417600,488616,170314,293438,952368
2020-02-04,NYSE National (C),84817327,46633549,31262017,162712893,1767968305.963800,1654621559.696400,1072006117.404500,4494595983.064700,703313,173858,330988,1208159
2020-02-04,FINRA / Nasdaq TRF Chicago (DB),6249240,2121613,6643016,15013869,193320012.227400,98135866.873000,1077150208.832800,1368606087.933200,20974,6156,40183,67313
2020-02-04,FINRA / NYSE TRF (DN),272969865,144133318,253932048,671035231,7164163136.961399,4128006020.662302,21263064229.507004,32555233387.130705,847752,315835,1122750,2286337
2020-02-04,FINRA / Nasdaq TRF Carteret (DQ),1227799528,487513979,773396635,2488710142,50543717848.908500,27102414323.899705,57497060770.130801,135143192942.939006,4527448,1146834,3194348,8868630
2020-02-04,EDGA Equities (J),106090819,27277643,50517902,183886364,4201649041.400200,1422618729.841200,3160416535.390000,8784684306.631400,1204868,143037,656090,2003995
2020-02-04,EDGX Equities (K),182346536,109609532,136141705,428097773,6111163886.912099,5090620011.803399,10622639675.682496,21824423574.397994,1374557,380989,1096443,2851989
2020-02-04,NYSE Chicago (M),10260649,9647651,6632950,26541250,510762599.791800,1104447555.271100,1175975785.747300,2791185940.810200,9147,1969,9625,20741
2020-02-04,NYSE (N),933565868,51075147,41281159,1025922174,41552620045.036999,2804026380.251900,2829932721.448600,47186579146.737499,3361920,118848,285390,3766158
2020-02-04,NYSE Arca (P),205643821,339270337,185543405,730457563,8422940184.487099,18790930261.020104,17388594991.567903,44602465437.075106,1809129,782050,1757137,4348316
2020-02-04,NASDAQ (Q),444796816,212817285,653215755,1310829856,20527318452.547000,12002383305.078001,59366786116.137320,91896487873.762321,4388774,780695,5241445,10410914
2020-02-04,Investors Exchange (V),120836424,24623279,67948945,213408648,5815935798.481701,1407575335.456200,5419481595.558901,12642992729.496802,885175,109480,540990,1535645
2020-02-04,NASDAQ PSX (X),21949109,25794146,16469255,64212510,810711628.155800,1384339427.666800,2006816070.992399,4201867126.814999,163562,91697,143098,398357
2020-02-04,BYX Equities (Y),91439444,74914672,50602745,216956861,3147065231.437000,3290814880.013100,2932248241.661500,9370128353.111600,960427,278405,562040,1800872
2020-02-04,BZX Equities (Z),230959516,100673357,141981515,473614388,10956096829.914900,6196724405.536199,13535138611.479796,30687959846.930895,2089739,394436,1422332,3906507
2020-02-03,NYSE American (A),5940941,22564183,3289168,31794292,285177475.065600,285182249.884900,195501040.727100,765860765.677600,70445,72805,37988,181238
2020-02-03,NASDAQ BX (B),45366334,26885121,24773338,97024793,1775704456.651500,1305761047.581400,1642685104.987800,4724150609.220700,465111,185863,277610,928584
2020-02-03,NYSE National (C),82967518,42756188,32637254,158360960,1730995838.284400,1605246638.468600,992633687.191500,4328876163.944500,697714,174040,343008,1214762
2020-02-03,FINRA / Nasdaq TRF Chicago (DB),5819552,2588454,6388310,14796316,164269456.716400,129932743.235200,906831993.728000,1201034193.679600,20625,7198,36680,64503
2020-02-03,FINRA / NYSE TRF (DN),243585298,137230751,259883752,640699801,6334223767.800300,4567791443.635900,20286776701.293183,31188791912.729383,755802,300807,1075171,2131780
2020-02-03,FINRA / Nasdaq TRF Carteret (DQ),1108059365,498008499,743685096,2349752960,47768907979.767988,27955808772.638901,49983200316.780687,125707917069.187576,4434417,1149464,3106042,8689923
2020-02-03,EDGA Equities (J),104265915,27217289,49660326,181143530,4093176731.425300,1520353896.522000,2853062006.292201,8466592634.239501,1179358,146321,647190,1972869
2020-02-03,EDGX Equities (K),152590792,110615362,136881551,400087705,5221978473.506099,5249648067.648099,9104034795.602398,19575661336.756596,1216296,382626,1060312,2659234
2020-02-03,NYSE Chicago (M),6260466,8807646,4564353,19632465,288959981.195200,678366309.209700,631447941.473600,1598774231.878500,7590,1378,7301,16269
2020-02-03,NYSE (N),973845947,46517738,38985576,1059349261,45393175437.937106,2807114255.741799,2211484974.562000,50411774668.240905,3316501,121052,272073,3709626
2020-02-03,NYSE Arca (P),184185863,326294854,179573197,690053914,7635399632.027401,19717326358.614296,14124621526.404995,41477347517.046692,1690990,822534,1698486,4212010
2020-02-03,NASDAQ (Q),410841470,194930392,670352128,1276123990,19725251436.046005,12066011433.362895,52699443706.163589,84490706575.572489,4263458,808216,5088919,10160593
2020-02-03,Investors Exchange (V),109749958,22604156,65877551,198231665,5337593874.594999,1319626967.665100,4532260571.565399,11189481413.825498,813236,98982,516451,1428669
2020-02-03,NASDAQ PSX (X),20499886,21900165,14703350,57103401,775552303.927100,1388338428.665600,1408924402.132999,3572815134.725699,161588,85161,129724,376473
2020-02-03,BYX Equities (Y),88431385,64063605,53154318,205649308,3025951362.985700,3217830632.705800,2585340905.500501,8829122901.192001,947610,266399,552708,1766717
2020-02-03,BZX Equities (Z),218051418,99454047,142911484,460416949,10492334903.483901,6835552551.955601,12620091347.330699,29947978802.770201,2023569,405408,1403226,3832203
2020-01-31,NYSE American (A),6682705,20891472,3525696,31099873,328358902.561000,311198773.139600,249819278.396800,889376954.097400,71168,71648,43052,185868
2020-01-31,NASDAQ BX (B),50691143,33934271,28291286,112916700,1995663784.293700,1697668238.201800,2006524070.266400,5699856092.761900,499409,268713,310673,1078795
2020-01-31,NYSE National (C),97868772,51770546,38059208,187698526,2053278537.743100,1898327598.698600,1200222218.866900,5151828355.308600,769125,213608,376994,1359727
2020-01-31,FINRA / Nasdaq TRF Chicago (DB),5862746,2956080,6001826,14820652,183727391.447200,154771757.098100,605979908.204700,944479056.750000,20445,8901,29832,59178
2020-01-31,FINRA / NYSE TRF (DN),259829600,145895694,276935412,682660706,6877534908.948000,5454486921.176801,18812950054.333806,31144971884.458607,758802,354786,998317,2111905
2020-01-31,FINRA / Nasdaq TRF Carteret (DQ),1284060708,533185993,798715855,2615962556,54429297024.208312,33651118822.217392,54179659876.089017,142260075722.514721,4807147,1201931,3215362,9224440
2020-01-31,EDGA Equities (J),126243755,34180645,55871957,216296357,4725899414.348500,2012557046.045700,3206289427.486099,9944745887.880299,1319575,191945,670445,2181965
2020-01-31,EDGX Equities (K),194622264,137645331,169446926,501714521,7041046933.298001,8638219374.809200,10666509519.741103,26345775827.848304,1549632,567489,1272272,3389393
2020-01-31,NYSE Chicago (M),7874290,5775895,7599378,21249563,432195015.279800,532048783.929200,1182910051.695200,2147153850.904200,10526,1991,9347,21864
2020-01-31,NYSE (N),1319058413,73413936,44797304,1437269653,59185566133.084995,4772124703.847102,2898774966.947300,66856465803.879397,3814634,188353,295277,4298264
2020-01-31,NYSE Arca (P),194193573,403215235,182140106,779548914,8363532187.593998,26188575978.134486,14440145053.079487,48992253218.807971,1863361,1113021,1694465,4670847
2020-01-31,NASDAQ (Q),481821426,290874613,772317794,1545013833,23235500671.541299,18907569784.221793,59166829915.087708,101309900370.850800,5104938,1199904,5662535,11967377
2020-01-31,Investors Exchange (V),129241396,29204525,74281469,232727390,6105851084.424601,2055056954.753500,5559445370.665699,13720353409.843800,952589,127667,569081,1649337
2020-01-31,NASDAQ PSX (X),22664446,32866400,17047573,72578419,906896885.797800,2209408313.468600,1551190735.745500,4667495935.011900,174256,125071,147669,446996
2020-01-31,BYX Equities (Y),96434057,87411216,56105016,239950289,3247526092.275200,4453064458.424601,2970686408.568300,10671276959.268101,992574,373060,576232,1941866
2020-01-31,BZX Equities (Z),252555930,142955505,164963109,560474544,12658276122.475900,10977810203.810392,15453512815.955203,39089599142.241495,2367271,588153,1628482,4583906
2020-01-30,NYSE American (A),6046117,21371595,2867634,30285346,313495779.689100,238664733.087600,200851665.226700,753012178.003400,64808,62028,32334,159170
2020-01-30,NASDAQ BX (B),54054095,30652692,27031563,111738350,2162205434.534800,1478319786.389100,1755560830.636800,5396086051.560700,520291,236648,305088,1062027
2020-01-30,NYSE National (C),86093211,46285780,30889099,163268090,1876619603.981200,1563056929.708500,1029093981.431900,4468770515.121600,704171,186699,318996,1209866
2020-01-30,FINRA / Nasdaq TRF Chicago (DB),5985816,2484015,6226773,14696604,187618310.312700,111800799.326100,587864126.757700,887283236.396500,19899,7085,29905,56889
2020-01-30,FINRA / NYSE TRF (DN),248944216,141353654,260444096,650741966,6409037745.523799,4542920983.713400,16677976807.732899,27629935536.970098,682043,277533,894693,1854269
2020-01-30,FINRA / Nasdaq TRF Carteret (DQ),1101863949,425943752,707870329,2235678030,45856703238.047213,22985869952.408387,45094901654.225705,113937474844.681305,4259809,1044530,2835254,8139593
2020-01-30,EDGA Equities (J),118649177,28064094,48828282,195541553,4526774339.000600,1567082966.878900,2833494172.898802,8927351478.778302,1246877,158579,618662,2024118
2020-01-30,EDGX Equities (K),185662367,119298906,152619546,457580819,6398434369.066601,6273461447.548901,9874871807.226703,22546767623.842205,1352976,459640,1132942,2945558
2020-01-30,NYSE Chicago (M),12592961,9049767,8215883,29858611,694213830.068800,1058805037.020400,1134378323.509500,2887397190.598700,11502,1599,8885,21986
2020-01-30,NYSE (N),879871772,61717480,39976989,981566241,38246043004.085493,3860806141.318300,2535656333.652600,44642505479.056393,3273516,143574,265547,3682637
2020-01-30,NYSE Arca (P),181188579,341434314,162225612,684848505,7530780827.540899,20852367024.634204,13614538545.711798,41997686397.886901,1621985,917624,1544869,4084478
2020-01-30,NASDAQ (Q),436726516,241787386,621669490,1300183392,20589400685.654190,14964963775.627193,46280272124.831909,81834636586.113292,4393385,983190,4934473,10311048
2020-01-30,Investors Exchange (V),123300969,22032008,67516138,212849115,6027252497.150700,1446393294.896300,4655854021.345400,12129499813.392400,917396,96527,521298,1535221
2020-01-30,NASDAQ PSX (X),22876232,26630630,14928378,64435240,862879768.150900,1670044978.661800,1247246549.508400,3780171296.321100,163809,96015,127658,387482
2020-01-30,BYX Equities (Y),90222707,65446615,48924023,204593345,3083147346.045900,3083858353.740600,2596585069.307700,8763590769.094200,941823,281769,545676,1769268
2020-01-30,BZX Equities (Z),236272447,118456761,145142966,499872174,11376522780.060499,8186564724.494700,11999459522.158801,31562547026.714000,2077878,486234,1388796,3952908
2020-01-29,NYSE American (A),5196287,14743770,2850310,22790367,247216489.486300,173131165.354000,175910100.148600,596257754.988900,55487,54325,31524,141336
2020-01-29,NASDAQ BX (B),44878801,19696401,23635641,88210843,1649872749.130300,931599973.339400,1387080907.902100,3968553630.371800,413518,147479,251119,812116
2020-01-29,NYSE National (C),75450755,29282436,25956270,130689461,1440136378.667200,1016784461.320500,807538932.390400,3264459772.378100,581018,128178,270974,980170
2020-01-29,FINRA / Nasdaq TRF Chicago (DB),5060790,1664569,5087243,11812602,167588349.040200,75294550.802000,437019715.533000,679902615.375200,17185,4928,24201,46314
2020-01-29,FINRA / NYSE TRF (DN),264913058,99989460,261864342,626766860,6131555049.853498,3555144269.172999,15203451141.911295,24890150460.937792,646387,233438,863732,1743557
2020-01-29,FINRA / Nasdaq TRF Carteret (DQ),1102302382,334094999,698296864,2134694245,42579478916.789593,20252814532.471601,39126103448.379596,101958396897.640790,3956817,801645,2672467,7430929
2020-01-29,EDGA Equities (J),101565664,19657339,43400341,164623344,3611749921.298000,1101834455.418900,2365278831.628000,7078863208.344900,1042554,115239,556683,1714476
2020-01-29,EDGX Equities (K),180942503,74805051,150839774,406587328,5560034022.390700,3944910086.483300,8837970386.698004,18342914495.572004,1196575,302474,1041543,2540592
2020-01-29,NYSE Chicago (M),12261293,6031542,7617044,25909879,680717507.238200,647342888.737500,1005690849.124900,2333751245.100600,8520,1134,7723,17377
2020-01-29,NYSE (N),826225366,36910699,34097527,897233592,35331797058.489003,2159253302.040900,1797004988.700000,39288055349.229903,2871266,91579,230880,3193725
2020-01-29,NYSE Arca (P),170244733,228025721,148589018,546859472,6711130934.753802,13650278628.613396,10719885548.506600,31081295111.873798,1434397,606323,1368027,3408747
2020-01-29,NASDAQ (Q),398995722,150780090,582988447,1132764259,17719861595.273301,9292071695.908403,39190294296.474689,66202227587.656393,3815116,656900,4442040,8914056
2020-01-29,Investors Exchange (V),110917815,15256949,62564811,188739575,5045443397.232800,945639770.839800,3877721789.748401,9868804957.821001,821117,73417,489374,1383908
2020-01-29,NASDAQ PSX (X),19123521,15062500,13869277,48055298,661776363.460900,895049026.503900,881087705.191200,2437913095.156000,132926,56963,111199,301088
2020-01-29,BYX Equities (Y),78491804,41578452,42222118,162292374,2533065624.082500,2055933129.838400,1943858461.668500,6532857215.589400,793137,194117,465171,1452425
2020-01-29,BZX Equities (Z),203681057,73930140,130745225,408356422,9289894284.908698,5067192980.066700,9998578696.723398,24355665961.698796,1769483,326992,1239379,3335854
2020-01-28,NYSE American (A),5187243,16906269,2600416,24693928,237151806.734200,243047960.408100,164180122.407100,644379889.549400,55679,59151,29073,143903
2020-01-28,NASDAQ BX (B),44444651,24146709,21948130,90539490,1587598179.808400,1195965054.869900,1259111698.901700,4042674933.580000,414736,165852,259881,840469
2020-01-28,NYSE National (C),75811331,36873645,27253167,139938143,1504142007.009700,1340857446.232600,799213097.658800,3644212550.901100,595672,140022,269890,1005584
2020-01-28,FINRA / Nasdaq TRF Chicago (DB),5358312,1831216,4617442,11806970,165379805.956900,84728564.755500,329857847.016300,579966217.728700,19031,5520,21544,46095
2020-01-28,FINRA / NYSE TRF (DN),234135150,120223657,250055791,604414598,6301562304.697201,4067603307.836496,12812916286.299396,23182081898.833093,654089,265888,797483,1717460
2020-01-28,FINRA / Nasdaq TRF Carteret (DQ),1100243103,398601941,683681673,2182526717,46453757338.840091,22889345272.859794,38849803787.392076,108192906399.091961,3937712,977581,2504750,7420043
2020-01-28,EDGA Equities (J),97609283,24956674,41969629,164535586,3719437021.101600,1403813899.285500,2245508433.941400,7368759354.328500,1032734,134880,525951,1693565
2020-01-28,EDGX Equities (K),166104855,93774096,146372017,406250968,5394167724.749501,5043660215.580503,7346189894.808301,17784017835.138305,1235996,370050,992770,2598816
2020-01-28,NYSE Chicago (M),11040420,11434620,6779455,29254495,624340279.539400,1512720111.570000,963839221.416600,3100899612.526000,7464,1668,7653,16785
2020-01-28,NYSE (N),832641526,45359680,35084311,913085517,36453055030.514503,2684070821.743000,1833640497.423100,40970766349.680603,2871876,108052,229600,3209528
2020-01-28,NYSE Arca (P),160330733,295787086,144164406,600282225,6436772002.569700,18146890850.873096,8861173064.431703,33444835917.874499,1463757,717544,1289290,3470591
2020-01-28,NASDAQ (Q),382155522,184710930,570315671,1137182123,17269819296.977195,11495066188.290393,35714626966.962802,64479512452.230390,3788661,735791,4092500,8616952
2020-01-28,Investors Exchange (V),108354963,20799687,57639521,186794171,5041943601.049200,1287137640.054400,3441036632.071100,9770117873.174700,812266,90515,459138,1361919
2020-01-28,NASDAQ PSX (X),19877662,20085397,12782650,52745709,681493990.796300,1205007292.209500,892767598.386000,2779268881.391800,144297,72129,100560,316986
2020-01-28,BYX Equities (Y),82731985,55329608,43938853,182000446,2680207530.423800,2612621529.678600,1902661165.510300,7195490225.612700,829212,234158,446585,1509955
2020-01-28,BZX Equities (Z),205545274,89095275,119821827,414462376,9526290373.550701,6141786529.098302,8050220379.121698,23718297281.770701,1864088,368797,1144908,3377793
2020-01-27,NYSE American (A),6108306,26243978,3698323,36050607,297646560.963500,375043519.200800,208725840.436200,881415920.600500,66408,87812,37490,191710
2020-01-27,NASDAQ BX (B),43076158,29503362,25969418,98548938,1689850741.462400,1434149675.294900,1472640929.395500,4596641346.152800,420365,208678,301976,931019
2020-01-27,NYSE National (C),80829504,40500450,31951941,153281895,1632049388.103600,1453799664.364100,886708971.265500,3972558023.733200,640657,178877,314128,1133662
2020-01-27,FINRA / Nasdaq TRF Chicago (DB),5915398,2376306,5957365,14249069,199462390.482100,107483871.309200,464681361.202400,771627622.993700,20703,8360,28211,57274
2020-01-27,FINRA / NYSE TRF (DN),255326589,146753799,268389525,670469913,6922963112.832300,5448802745.063603,14690627199.432304,27062393057.328207,727924,367188,940648,2035760
2020-01-27,FINRA / Nasdaq TRF Carteret (DQ),1131070434,501080823,794411708,2426562965,46983374719.100910,28627365692.973495,41536219450.802976,117146959862.877381,4228078,1360919,2905997,8494994
2020-01-27,EDGA Equities (J),108711122,30478449,50838098,190027669,3966962277.315400,1686654743.463200,2583755205.671000,8237372226.449600,1094006,178276,597409,1869691
2020-01-27,EDGX Equities (K),178079789,122468502,162599588,463147879,6067152911.366298,6706392370.336796,8026917501.527097,20800462783.230191,1339973,535519,1149144,3024636
2020-01-27,NYSE Chicago (M),10276928,16325799,5318242,31920969,549540321.889100,1178216498.576200,678223977.560000,2405980798.025300,8798,3198,9610,21606
2020-01-27,NYSE (N),977556471,62160242,42576382,1082293095,43882669240.004499,3834072524.012299,2200580304.461400,49917322068.478198,3175938,150155,275844,3601937
2020-01-27,NYSE Arca (P),177268864,383901481,177261957,738432302,7334962930.632497,23828576008.929195,11013235410.672295,42176774350.233987,1590912,1026744,1531194,4148850
2020-01-27,NASDAQ (Q),409078316,246416496,739877794,1395372606,19314655909.200303,15086036704.992599,45209686829.951094,79610379444.143996,4174334,1029483,4927079,10130896
2020-01-27,Investors Exchange (V),112639869,24926449,70374389,207940707,5380907508.808700,1630012833.052200,3905683976.377499,10916604318.238399,867331,114647,529940,1511918
2020-01-27,NASDAQ PSX (X),19596982,26235201,15687145,61519328,778509291.624200,1639939548.090700,1115326186.652300,3533775026.367200,153384,104020,127474,384878
2020-01-27,BYX Equities (Y),87728863,67178672,50920836,205828371,2988355530.735301,3281528462.340200,2392057472.308400,8661941465.383901,909890,308473,539462,1757825
2020-01-27,BZX Equities (Z),227786417,121728022,148083882,497598321,10787090843.628700,8450026710.094599,10219717578.376294,29456835132.099593,2049926,529098,1380903,3959927
2020-01-24,NYSE American (A),6330862,23956784,3838409,34126055,300707509.583100,324167552.844400,230753849.778700,855628912.206200,70424,78449,41907,190780
2020-01-24,NASDAQ BX (B),43471905,30151903,26402593,100026401,1652821821.763100,1307278612.551500,1518331917.931500,4478432352.246100,413470,233738,323917,971125
2020-01-24,NYSE National (C),86007867,39682474,31546720,157237061,1655532532.708900,1420156420.877900,895521728.278500,3971210681.865300,646771,159861,313125,1119757
2020-01-24,FINRA / Nasdaq TRF Chicago (DB),5347195,2710205,6066626,14124026,188969273.528200,129199857.840000,471372166.560400,789541297.928600,19033,7651,27474,54158
2020-01-24,FINRA / NYSE TRF (DN),278538728,159361687,314046676,751947091,7622273835.555802,5435316992.553302,17306787669.611598,30364378497.720702,743294,350315,965737,2059346
2020-01-24,FINRA / Nasdaq TRF Carteret (DQ),1103867196,485620990,817683098,2407171284,45606579281.654092,29977856719.954098,44601616906.704118,120186052908.312308,4179454,1048260,3013853,8241567
2020-01-24,EDGA Equities (J),103058827,25730797,50346380,179136004,3905102838.556900,1489625823.120300,2671870492.252200,8066599153.929400,1069397,151773,611220,1832390
2020-01-24,EDGX Equities (K),181845874,116170771,169383557,467400202,6284932840.321001,6310107148.010703,8572559695.395102,21167599683.726806,1342538,443633,1181353,2967524
2020-01-24,NYSE Chicago (M),9404502,11680445,9518972,30603919,441557085.777800,1135759928.495900,1007762744.814700,2585079759.088400,10150,3192,8830,22172
2020-01-24,NYSE (N),870970131,59565849,45434208,975970188,38678955406.446499,3785462394.263001,2652064242.764200,45116482043.473700,3088988,133636,294822,3517446
2020-01-24,NYSE Arca (P),169357747,322287942,172259062,663904751,6984475346.825402,19689046329.589098,10838210988.793301,37511732665.207801,1559265,886370,1547322,3992957
2020-01-24,NASDAQ (Q),409174472,225329360,674075207,1308579039,18763504631.763406,14044864088.549794,42262009168.130315,75070377888.443515,4049933,905416,4986130,9941479
2020-01-24,Investors Exchange (V),108655466,24705462,71848394,205209322,5337199077.507400,1563301812.200500,4263558980.251100,11164059869.959000,830897,103804,523562,1458263
2020-01-24,NASDAQ PSX (X),19021825,26835971,16966803,62824599,721547462.449500,1715634634.189100,1304958655.192400,3742140751.831000,142479,88691,136103,367273
2020-01-24,BYX Equities (Y),88033021,61826525,51284231,201143777,2960347791.904100,3263433302.476900,2408864653.170900,8632645747.551900,913995,265590,560498,1740083
2020-01-24,BZX Equities (Z),225694691,113178355,162272937,501145983,10946832615.685299,8165050332.026598,11994355102.980005,31106238050.691902,2001993,475118,1496065,3973176
2020-01-23,NYSE American (A),6608571,20277835,3447227,30333633,308130590.602900,243618075.812800,197238942.751900,748987609.167600,68028,60098,37465,165591
2020-01-23,NASDAQ BX (B),43139835,27658734,23487277,94285846,1663957598.656900,1297101636.883400,1346812468.361800,4307871703.902100,406026,167763,266534,840323
2020-01-23,NYSE National (C),76930726,31927030,28937905,137795661,1525910275.915000,1210421060.978900,840414280.703300,3576745617.597200,572555,126318,282558,981431
2020-01-23,FINRA / Nasdaq TRF Chicago (DB),5754409,2013564,5454673,13222646,171209179.606000,89007299.470500,443702369.722300,703918848.798800,17472,5471,24954,47897
2020-01-23,FINRA / NYSE TRF (DN),254963662,124753522,279836324,659553508,6394392383.619000,3810787838.200000,13008713237.357413,23213893459.176413,665806,263643,833165,1762614
2020-01-23,FINRA / Nasdaq TRF Carteret (DQ),1140817432,448807701,798641345,2388266478,48742268155.031711,25282897339.008603,42451501487.137818,116476666981.178132,4056416,964186,2758134,7778736
2020-01-23,EDGA Equities (J),98329464,24227043,46707664,169264171,3746783547.068700,1346083097.781100,2433904735.933700,7526771380.783500,1028917,124928,569392,1723237
2020-01-23,EDGX Equities (K),176893964,90511036,160121494,427526494,5725397305.352800,4685907266.804903,7237486766.460599,17648791338.618302,1250072,315210,1065220,2630502
2020-01-23,NYSE Chicago (M),10942430,9071624,9139592,29153646,574462864.812800,945822195.658000,1553925215.859201,3074210276.330001,8033,2604,8435,19072
2020-01-23,NYSE (N),948487424,45775874,39123337,1033386635,41714173942.450607,2710569484.653300,2009633508.177900,46434376935.281807,2862989,102950,253601,3219540
2020-01-23,NYSE Arca (P),174120042,267883162,159642135,601645339,6876482214.794001,15714976375.255299,9337330689.357801,31928789279.407101,1500811,663900,1437907,3602618
2020-01-23,NASDAQ (Q),396913773,179853546,645571907,1222339226,17560571128.953496,10816417061.591997,39445224449.005316,67822212639.550809,3853875,695436,4467314,9016625
2020-01-23,Investors Exchange (V),110350271,23359747,67715332,201425350,5133303502.450400,1401107059.504000,3667020270.550100,10201430832.504500,840995,92816,511231,1445042
2020-01-23,NASDAQ PSX (X),17982655,20389683,13631096,52003434,655990605.079200,1182765664.029000,874699618.499300,2713455887.607500,131327,63787,108391,303505
2020-01-23,BYX Equities (Y),86069532,56880908,47536924,190487364,2844978586.941500,2591492018.446901,2129537611.606400,7566008216.994801,877555,219397,522245,1619197
2020-01-23,BZX Equities (Z),218406644,87772609,136857298,443036551,9886372009.101600,5757837543.335701,9219685061.071800,24863894613.509101,1894058,345786,1289492,3529336
2020-01-22,NYSE American (A),6348446,16870501,3570616,26789563,299011777.453600,235069688.949300,206852193.680400,740933660.083300,67366,55111,38590,161067
2020-01-22,NASDAQ BX (B),43441530,20653809,22983010,87078349,1657541708.984800,976960966.679100,1366577053.256100,4001079728.920000,420535,135009,268099,823643
2020-01-22,NYSE National (C),70708632,28643954,27496571,126849157,1446579956.205200,1103150923.745100,827213488.446400,3376944368.396700,575101,123057,285071,983229
2020-01-22,FINRA / Nasdaq TRF Chicago (DB),6314259,1494471,5620921,13429651,194334934.048900,59965472.094300,552295653.935300,806596060.078500,20516,4439,28989,53944
2020-01-22,FINRA / NYSE TRF (DN),272551559,112924483,303199001,688675043,6987578989.643302,3808725311.778299,15732840017.151697,26529144318.573298,725298,247667,956170,1929135
2020-01-22,FINRA / Nasdaq TRF Carteret (DQ),1121768124,416031966,818980930,2356781020,45158454878.266085,25178930085.204107,42173298609.413107,112510683572.883299,4076172,864766,2839006,7779944
2020-01-22,EDGA Equities (J),91223008,18801593,44465920,154490521,3626800742.531900,1086830350.262300,2474738687.207800,7188369780.002000,1022761,111853,570152,1704766
2020-01-22,EDGX Equities (K),178033674,71858721,166338845,416231240,5697448189.073198,3396981063.729599,7777609586.839699,16872038839.642496,1277385,254255,1101788,2633428
2020-01-22,NYSE Chicago (M),13289364,11865648,7258699,32413711,618558176.346000,1462275011.930800,943890248.809000,3024723437.085800,7058,2475,9879,19412
2020-01-22,NYSE (N),864044371,36078814,37881708,938004893,39653177954.591299,2026322008.278700,2024141147.455700,43703641110.325699,2761468,80017,237595,3079080
2020-01-22,NYSE Arca (P),167410050,210826330,147539694,525776074,6543597229.993400,12568472307.364601,9497865656.924296,28609935194.282297,1470180,534580,1365816,3370576
2020-01-22,NASDAQ (Q),369500647,137264126,608066701,1114831474,16547696485.716200,7979510920.319401,40185101683.210490,64712309089.246091,3616111,534989,4379894,8530994
2020-01-22,Investors Exchange (V),111481969,16760600,64490438,192733007,5348347223.473100,971743419.853300,4073427899.994500,10393518543.320900,847418,82964,511699,1442081
2020-01-22,NASDAQ PSX (X),16834625,15525321,12878876,45238822,631563427.866400,890891021.671600,904652121.726000,2427106571.264000,128206,53760,103012,284978
2020-01-22,BYX Equities (Y),83254716,40888820,50902536,175046072,2748270899.836601,1852694257.365400,2202231490.836900,6803196648.038901,864008,178045,517343,1559396
2020-01-22,BZX Equities (Z),207579096,67797604,132914685,408291385,9453576797.879700,4304258139.406798,10120661791.135098,23878496728.421596,1826379,276195,1269284,3371858
2020-01-21,NYSE American (A),6679445,21672071,3273899,31625415,277096068.337000,209683241.279800,206672555.594500,693451865.211300,69591,64335,35013,168939
2020-01-21,NASDAQ BX (B),47818293,26869416,24579120,99266829,1773946812.178000,1202216803.230800,1318892993.442800,4295056608.851600,452846,178783,281303,912932
2020-01-21,NYSE National (C),79414663,35339813,31512726,146267202,1621732572.981700,1300670792.837300,885835785.027200,3808239150.846200,629077,146456,313923,1089456
2020-01-21,FINRA / Nasdaq TRF Chicago (DB),6527758,2185152,5969800,14682710,221438955.129900,90728397.801600,423193285.806400,735360638.737900,22553,6411,27439,56403
2020-01-21,FINRA / NYSE TRF (DN),303027762,127193473,329714964,759936199,7800975584.137499,4151486921.824101,13725124874.055002,25677587380.016602,822173,286778,998672,2107623
2020-01-21,FINRA / Nasdaq TRF Carteret (DQ),1273827616,475325635,855454821,2604608072,54854914124.124905,33416670148.873196,45337622955.491384,133609207228.489485,4268876,1001009,2917720,8187605
2020-01-21,EDGA Equities (J),101443628,23391165,48976969,173811762,3946202785.942000,1299295922.680900,2413111615.485500,7658610324.108400,1082943,131554,589177,1803674
2020-01-21,EDGX Equities (K),195817688,81324838,177552883,454695409,6319463265.917296,4373321546.091700,7637621771.430298,18330406583.439294,1367360,306043,1172527,2845930
2020-01-21,NYSE Chicago (M),10267635,10921273,6902641,28091549,825505740.365800,1554364619.249200,827229108.132800,3207099467.747800,9204,3052,9666,21922
2020-01-21,NYSE (N),1045974330,41560981,39029078,1126564389,47777969627.858395,2503214141.112600,1923452603.622600,52204636372.593595,2923336,95482,262451,3281269
2020-01-21,NYSE Arca (P),178466650,285121945,163688383,627276978,7064422179.551600,17875774653.914603,9485208158.815603,34425404992.281806,1538195,643623,1469930,3651748
2020-01-21,NASDAQ (Q),403347631,174662428,725475150,1303485209,18026774279.443499,10806628760.723402,45274985936.713888,74108388976.880789,3874599,659341,4631134,9165074
2020-01-21,Investors Exchange (V),115377288,20848220,65790328,202015836,5477938795.163501,1235467865.829200,3875178260.212299,10588584921.205000,854368,88444,524085,1466897
2020-01-21,NASDAQ PSX (X),19422274,18514294,13853899,51790467,726768724.247600,1122923600.839800,856101973.383500,2705794298.470900,154960,62464,109495,326919
2020-01-21,BYX Equities (Y),91587570,51045532,51508585,194141687,2951459952.355900,2469730274.417000,2003641760.349200,7424831987.122100,911270,213232,520341,1644843
2020-01-21,BZX Equities (Z),225849431,84033617,143334339,453217387,10540668215.874597,5734631421.289901,9413804603.600899,25689104240.765397,1948269,330078,1337663,3616010
2020-01-17,NYSE American (A),5693439,14245190,3136688,23075317,258441886.934200,198782573.322500,186497635.692100,643722095.948800,60849,48212,34290,143351
2020-01-17,NASDAQ BX (B),51075554,20105813,25800592,96981959,2146037075.008700,1009421912.891100,1471647136.233700,4627106124.133500,495397,119015,292393,906805
2020-01-17,NYSE National (C),80994622,30219887,29653296,140867805,1916260873.291600,1154085750.856800,990655455.790400,4061002079.938800,640107,123560,299994,1063661
2020-01-17,FINRA / Nasdaq TRF Chicago (DB),6958261,1472721,5787156,14218138,231427953.440500,63559951.863600,379725602.522000,674713507.826100,17987,5319,23270,46576
2020-01-17,FINRA / NYSE TRF (DN),262727503,109199181,308401440,680328124,6610220198.609901,5731017706.821697,12277700947.467907,24618938852.899505,707721,234484,881793,1823998
2020-01-17,FINRA / Nasdaq TRF Carteret (DQ),1122322237,430628265,805724006,2358674508,49164189299.484012,34378988391.770284,43868550746.141607,127411728437.395903,3823532,843944,2664248,7331724
2020-01-17,EDGA Equities (J),99884887,20259493,47834634,167979014,4140971702.787100,1218199338.445000,2504563449.355500,7863734490.587600,1066391,118381,581097,1765869
2020-01-17,EDGX Equities (K),171587565,65163631,170871128,407622324,5667063189.643199,3866838946.264902,6602327685.837205,16136229821.745306,1219440,256053,1068065,2543558
2020-01-17,NYSE Chicago (M),10574773,12880021,9049439,32504233,716319305.168600,1537496748.030000,1671444805.256900,3925260858.455500,8355,3106,7247,18708
2020-01-17,NYSE (N),988409836,33540087,35588801,1057538724,50545217507.212099,2049031096.105800,1953221953.816000,54547470557.133899,2668201,83244,241687,2993132
2020-01-17,NYSE Arca (P),162552196,227045797,147941498,537539491,6575375282.100401,17621373432.986803,8261604933.688400,32458353648.775604,1434543,561744,1390018,3386305
2020-01-17,NASDAQ (Q),352902146,143264899,692264353,1188431398,15934003893.041503,9504383362.515102,44879418143.132494,70317805398.689099,3490717,554338,4255469,8300524
2020-01-17,Investors Exchange (V),105348398,19131891,62725764,187206053,4876037942.155801,1176481484.610100,3585744276.604100,9638263703.370001,803364,82318,498410,1384092
2020-01-17,NASDAQ PSX (X),17057497,15625509,12633952,45316958,681919545.698800,1024705387.776000,970285484.970900,2676910418.445700,131498,56611,103364,291473
2020-01-17,BYX Equities (Y),86634525,42729829,46601525,175965879,2975055159.320000,2147226453.420699,2089207570.398900,7211489183.139599,865010,182447,517287,1564744
2020-01-17,BZX Equities (Z),201503792,70291086,138531629,410326507,9605269844.138402,5053555899.256098,9592246202.123203,24251071945.517703,1781804,283895,1309132,3374831
2020-01-16,NYSE American (A),5402566,16621562,3101647,25125775,225750888.339300,205836387.300200,177697923.264900,609285198.904400,57685,54383,35582,147650
2020-01-16,NASDAQ BX (B),42714830,19880868,23165745,85761443,1563608630.044100,977817692.299300,1192223145.335500,3733649467.678900,416310,125523,274839,816672
2020-01-16,NYSE National (C),70364367,27445336,28836823,126646526,1462172755.635500,1015761638.227100,821342476.289500,3299276870.152100,579847,118262,299340,997449
2020-01-16,FINRA / Nasdaq TRF Chicago (DB),5593909,1297925,5010363,11902197,156149456.590100,52724562.383800,386492681.681700,595366700.655600,18762,4531,23441,46734
2020-01-16,FINRA / NYSE TRF (DN),281577802,103167238,285305986,670051026,6647066222.805499,3549683115.939599,12705160391.215293,22901909729.960391,730813,251906,881497,1864216
2020-01-16,FINRA / Nasdaq TRF Carteret (DQ),1066605840,391209421,742757111,2200572372,43661952401.134405,24991381564.749699,38314815965.665600,106968149931.549704,3795782,851788,2619466,7267036
2020-01-16,EDGA Equities (J),92601790,20110632,45161611,157874033,3566478066.901400,1152063275.982200,2185619184.363800,6904160527.247400,1013288,116935,564109,1694332
2020-01-16,EDGX Equities (K),178579482,64560495,151669663,394809640,5572498564.627400,3704331064.315101,6364516621.200098,15641346250.142599,1261805,243720,1047098,2552623
2020-01-16,NYSE Chicago (M),10501478,12556757,8277815,31336050,560489535.019500,1383643330.000400,1125668687.592500,3069801552.612400,7850,2553,8647,19050
2020-01-16,NYSE (N),846201583,31387318,35968199,913557100,38340019465.839800,1979550436.545700,1750726413.792700,42070296316.178200,2692470,84986,248803,3026259
2020-01-16,NYSE Arca (P),168337142,201148626,138681802,508167570,6587680941.090598,13492828090.440997,7903124281.590201,27983633313.121796,1451850,541188,1338401,3331439
2020-01-16,NASDAQ (Q),362032080,143404486,595412370,1100848936,15750910478.667404,8895124138.803502,35287281156.633589,59933315774.104495,3525523,555907,4193140,8274570
2020-01-16,Investors Exchange (V),107484366,15715149,60939257,184138772,4853897233.850502,1050535483.915400,3506845272.556400,9411277990.322302,826892,80771,506328,1413991
2020-01-16,NASDAQ PSX (X),16860941,14974056,13387284,45222281,643613257.573600,968144735.672500,895938926.726200,2507696919.972300,135288,50800,107424,293512
2020-01-16,BYX Equities (Y),82330645,38696129,45112270,166139044,2746256387.387500,1956274038.266200,1997911549.966800,6700441975.620500,849354,176506,522719,1548579
2020-01-16,BZX Equities (Z),203401036,67476264,129331296,400208596,9267591277.513599,4757464249.197200,8599911477.914401,22624967004.625200,1796838,276160,1253881,3326879
2020-01-15,NYSE American (A),5808839,14143258,2723121,22675218,248708172.002400,207240520.491400,150057013.074000,606005705.567800,55256,51707,29900,136863
2020-01-15,NASDAQ BX (B),41314728,20570274,22990682,84875684,1519660483.059600,1010471654.368800,1235580204.264200,3765712341.692600,392412,144498,278305,815215
2020-01-15,NYSE National (C),74720798,32073332,29583296,136377426,1525634381.919700,1194416243.034700,774429118.906600,3494479743.861000,605019,127126,305476,1037621
2020-01-15,FINRA / Nasdaq TRF Chicago (DB),6648722,1298938,5533929,13481589,177586789.027400,57657002.897000,359783596.365300,595027388.289700,19044,4639,23523,47206
2020-01-15,FINRA / NYSE TRF (DN),300614831,103889106,295816685,700320622,7177322732.390206,4452946951.257200,12535064998.415399,24165334682.062805,750704,237376,861490,1849570
2020-01-15,FINRA / Nasdaq TRF Carteret (DQ),1095764284,448776234,802979596,2347520114,43793643169.315498,31220482961.286185,39061737418.029906,114075863548.631589,3941436,841465,2683463,7466364
2020-01-15,EDGA Equities (J),93364672,20199600,44618400,158182672,3666190296.529600,1222437832.267000,2173085879.136900,7061714007.933500,1001979,117305,543841,1663125
2020-01-15,EDGX Equities (K),196348651,67979657,164750607,429078915,5875913603.639699,4302922971.502299,6735158058.686101,16913994633.828099,1337989,273583,1093083,2704655
2020-01-15,NYSE Chicago (M),10840921,8641481,7256834,26739236,476222264.306900,994279853.958100,1012549902.024800,2483052020.289800,8964,3724,7807,20495
2020-01-15,NYSE (N),871774067,37817603,38565944,948157614,38150341743.534608,2366437237.894601,1937491957.348400,42454270938.777609,2892658,94910,294560,3282128
2020-01-15,NYSE Arca (P),175359609,228504822,147672683,551537114,6885250761.653801,14831709660.349707,8170163474.714103,29887123896.717611,1590713,607252,1460472,3658437
2020-01-15,NASDAQ (Q),397218703,157318238,616949558,1171486499,17423705654.484702,10070098542.427299,35105828813.659201,62599633010.571202,3934134,622560,4522771,9079465
2020-01-15,Investors Exchange (V),118577330,21339055,65608372,205524757,5347397619.691700,1344342662.831600,3740310509.229501,10432050791.752801,902276,93948,530673,1526897
2020-01-15,NASDAQ PSX (X),18401647,16701914,13516053,48619614,636220341.963200,1049993497.010400,939894510.869300,2626108349.842900,137745,59868,109249,306862
2020-01-15,BYX Equities (Y),94183240,44341119,48333433,186857792,3045497363.766800,2154618866.375300,2129136523.630400,7329252753.772500,918235,197457,554782,1670474
2020-01-15,BZX Equities (Z),220556099,77204939,136324557,434085595,9896929673.113199,5603021507.969602,8706658545.659899,24206609726.742700,1927897,321036,1330976,3579909
2020-01-14,NYSE American (A),5014068,25310243,3268795,33593106,238193403.069200,205420364.435100,208850303.057900,652464070.562200,55144,52503,37044,144691
2020-01-14,NASDAQ BX (B),41155292,24583612,24053141,89792045,1579817320.814000,1330839092.339200,1399914749.300100,4310571162.453300,410218,160525,303301,874044
2020-01-14,NYSE National (C),75181685,34605705,29850319,139637709,1571115977.633400,1288851988.445500,882128921.970300,3742096888.049200,619920,146585,306784,1073289
2020-01-14,FINRA / Nasdaq TRF Chicago (DB),7280921,1498819,6703933,15483673,290790200.390800,71385395.192000,571922360.418200,934097956.001000,18146,4800,29994,52940
2020-01-14,FINRA / NYSE TRF (DN),257006821,106969419,303972582,667948822,7155699142.974602,3448609849.248700,16148354360.649997,26752663352.873299,694511,257617,954860,1906988
2020-01-14,FINRA / Nasdaq TRF Carteret (DQ),1128376101,490485729,838038117,2456899947,49550256464.964681,29568471360.911601,47630513044.844905,126749240870.721187,3955342,888913,2823948,7668203
2020-01-14,EDGA Equities (J),95955239,25005365,46763936,167724540,3666901978.581400,1483751927.291900,2400914102.260600,7551568008.133900,1048801,141846,589197,1779844
2020-01-14,EDGX Equities (K),175293870,78716477,165106539,419116886,5906203311.334198,4545441213.686202,8029452921.538703,18481097446.559103,1341223,325269,1173657,2840149
2020-01-14,NYSE Chicago (M),12027167,25527673,7178686,44733526,723510695.028700,2218069732.471700,781100056.636500,3722680484.136900,9172,2901,9700,21773
2020-01-14,NYSE (N),915884265,42466475,37649251,995999991,42152848079.651296,2805892800.893001,2031628464.855099,46990369345.399396,2895739,113246,264527,3273512
2020-01-14,NYSE Arca (P),166799457,253742619,152893532,573435608,6813648957.731100,16044017970.011501,9789901490.721097,32647568418.463698,1495453,665650,1501584,3662687
2020-01-14,NASDAQ (Q),380151670,175153393,661112768,1216417831,17744089974.640700,10753248789.264198,42142811609.892222,70640150373.797120,3891829,685657,4793864,9371350
2020-01-14,Investors Exchange (V),109837232,21696426,69384714,200918372,5250682041.773801,1322157093.088100,4223216669.637501,10796055804.499402,874260,93918,555753,1523931
2020-01-14,NASDAQ PSX (X),17462642,18054947,14578986,50096575,668615227.287400,1097497348.553800,1072204616.649900,2838317192.491100,138339,64136,122909,325384
2020-01-14,BYX Equities (Y),87202112,49177266,51072489,187451867,3017460721.676500,2489796071.926800,2312967890.851600,7820224684.454900,941942,219996,576732,1738670
2020-01-14,BZX Equities (Z),212996671,82589069,141536105,437121845,10141746909.282100,5792539056.148503,10142988426.936698,26077274392.367301,1915289,338180,1372862,3626331
2020-01-13,NYSE American (A),5132931,18099374,3338945,26571250,221345150.543900,199221266.988300,189558611.429600,610125028.961800,53935,49660,36651,140246
2020-01-13,NASDAQ BX (B),47405906,19783634,28228485,95418025,1973236141.406400,1080492242.120400,1556878713.575100,4610607097.101900,489290,123481,342148,954919
2020-01-13,NYSE National (C),69046738,27724807,26951167,123722712,1454652847.329900,985556004.007700,812864702.976500,3253073554.314100,587670,110965,293262,991897
2020-01-13,FINRA / Nasdaq TRF Chicago (DB),5061062,1268491,5998051,12327604,161017184.804100,49751035.714400,508347946.830300,719116167.348800,16768,4075,28886,49729
2020-01-13,FINRA / NYSE TRF (DN),254493437,102464244,332939325,689897006,6097400396.986901,3252106792.193400,15334595131.595914,24684102320.776215,693413,247408,1032745,1973566
2020-01-13,FINRA / Nasdaq TRF Carteret (DQ),1093100690,368632028,815984669,2277717387,48295994417.351497,20945059354.405494,41695050141.854788,110936103913.611779,3947854,854871,2918419,7721144
2020-01-13,EDGA Equities (J),80092141,18348602,41512632,139953375,2891013897.872800,980900494.524200,1963546593.680600,5835460986.077600,861643,104850,502461,1468954
2020-01-13,EDGX Equities (K),162454082,64457080,172205733,399116895,5158742366.013598,3484432740.156099,7424454567.049203,16067629673.218900,1207470,254727,1148104,2610301
2020-01-13,NYSE Chicago (M),8080685,14602158,9846572,32529415,505996559.188300,1928382912.170000,1196130535.119400,3630510006.477700,7844,3003,8740,19587
2020-01-13,NYSE (N),834400947,33272241,38135120,905808308,36996647061.088401,2046362554.190500,1851794905.383200,40894804520.662101,2588994,87353,256738,2933085
2020-01-13,NYSE Arca (P),154256036,233239732,151895570,539391338,6071051469.942799,15065579315.836908,8393556974.955303,29530187760.735010,1355818,552968,1377638,3286424
2020-01-13,NASDAQ (Q),347761334,143679778,637044861,1128485973,15353891319.642305,8463173813.307697,38074022083.484784,61891087216.434786,3447472,565435,4476267,8489174
2020-01-13,Investors Exchange (V),107293167,20654291,69573840,197521298,5112801754.147300,1195807749.726100,4081406085.222099,10390015589.095499,871262,85557,567967,1524786
2020-01-13,NASDAQ PSX (X),16644665,15313518,13249925,45208108,599601253.656500,920815951.190600,866727445.481800,2387144650.328900,132704,55487,108644,296835
2020-01-13,BYX Equities (Y),81313263,43847631,48751411,173912305,2730513036.711000,2051745496.361000,2060935452.838000,6843193985.910000,865591,187570,548849,1602010
2020-01-13,BZX Equities (Z),192861036,68529030,141167570,402557636,8802613897.781801,4450228412.421799,9560155255.956802,22812997566.160402,1739114,282759,1335669,3357542
2020-01-10,NYSE American (A),4878619,18103531,3203030,26185180,236001810.751700,184397531.999900,174119272.532200,594518615.283800,53051,47849,34211,135111
2020-01-10,NASDAQ BX (B),43889985,21994788,25722446,91607219,1777267710.826400,1103208499.124400,1359746237.604300,4240222447.555100,443822,151559,316047,911428
2020-01-10,NYSE National (C),71577323,26420893,28399297,126397513,1473178091.004200,1037972961.611500,774088232.780700,3285239285.396400,586736,113733,291366,991835
2020-01-10,FINRA / Nasdaq TRF Chicago (DB),3970352,1209118,4860856,10040326,133606793.874400,58584646.446500,357934161.546600,550125601.867500,14122,4515,22357,40994
2020-01-10,FINRA / NYSE TRF (DN),226200606,105714023,299168126,631082755,5658554954.598001,3689088822.811301,12878910951.939001,22226554729.348303,608582,238817,890129,1737528
2020-01-10,FINRA / Nasdaq TRF Carteret (DQ),970639627,374710287,749616417,2094966331,39484806323.619603,23212429727.211109,35556171203.940824,98253407254.771536,3560832,811045,2641317,7013194
2020-01-10,EDGA Equities (J),77209854,17808559,38451008,133469421,2646916713.055700,999469702.394300,1776669531.260000,5423055946.710000,815266,99028,463378,1377672
2020-01-10,EDGX Equities (K),153541670,66435558,160408812,380386040,5056303108.212397,3562674257.268500,6596224076.802001,15215201442.282898,1178856,252347,1068209,2499412
2020-01-10,NYSE Chicago (M),19431179,15771050,5862549,41064778,913088339.782000,2653299898.471000,1000814449.732700,4567202687.985700,7258,2334,7933,17525
2020-01-10,NYSE (N),778590220,35069851,34403474,848063545,34423003935.208791,2131585134.057600,1784675870.227900,38339264939.494291,2527755,88877,233970,2850602
2020-01-10,NYSE Arca (P),143642204,218944928,151617824,514204956,5753824038.333701,13364134744.259603,7875023208.352003,26992981990.945307,1325563,552068,1322742,3200373
2020-01-10,NASDAQ (Q),337080534,153800854,616257304,1107138692,14831250044.111400,9123435333.427903,34171570313.998180,58126255691.537483,3382943,576278,4174294,8133515
2020-01-10,Investors Exchange (V),101954025,18990040,64753589,185697654,4625273004.080600,1122252774.071800,3570148284.883600,9317674063.036000,816448,88932,531165,1436545
2020-01-10,NASDAQ PSX (X),16821768,15188104,14374419,46384291,592608202.610100,889661545.003100,915980167.639200,2398249915.252400,133590,55117,111901,300608
2020-01-10,BYX Equities (Y),78530430,43506215,50487613,172524258,2623759832.766200,2218963092.434800,2034928125.977100,6877651051.178100,824745,191622,537654,1554021
2020-01-10,BZX Equities (Z),186626417,69716402,135317157,391659976,8690252285.504402,4685874256.674500,9215060123.817901,22591186665.996803,1705869,285931,1263054,3254854
2020-01-09,NYSE American (A),5426744,15844847,3081211,24352802,232352741.700000,186626244.676100,175762086.584500,594741072.960600,57784,48978,33600,140362
2020-01-09,NASDAQ BX (B),51068263,20755757,27542577,99366597,1984239541.438300,1029845764.333300,1497833965.069800,4511919270.841400,511010,149359,340969,1001338
2020-01-09,NYSE National (C),75462943,28197490,27213394,130873827,1531532175.649500,1007218284.591200,776126535.027600,3314876995.268300,627390,130149,289277,1046816
2020-01-09,FINRA / Nasdaq TRF Chicago (DB),6635831,1495518,6299669,14431018,260526033.746900,58769298.122600,504593241.695800,823888573.565300,16187,4624,27427,48238
2020-01-09,FINRA / NYSE TRF (DN),259977639,108324545,339954122,708256306,6642431170.686399,3661166692.200401,15364942836.474803,25668540699.361603,673771,241371,970877,1886019
2020-01-09,FINRA / Nasdaq TRF Carteret (DQ),1141659047,377705773,821504343,2340869163,46707054642.485806,20970366537.230994,41708833390.023281,109386254569.740081,3913452,833445,2760280,7507177
2020-01-09,EDGA Equities (J),89604255,17121284,40981144,147706683,3130179974.296400,887814764.178700,1955713522.779900,5973708261.255000,959392,102449,498827,1560668
2020-01-09,EDGX Equities (K),174857131,68106161,175194835,418158127,5599972693.757799,3582031588.575200,7764340580.281803,16946344862.614802,1282249,265329,1141265,2688843
2020-01-09,NYSE Chicago (M),11134939,15411120,4544656,31090715,566372867.927000,1747576526.928000,636574692.384100,2950524087.239100,7520,2666,7421,17607
2020-01-09,NYSE (N),875867327,34858185,35395448,946120960,36954564288.325398,2101999061.854900,1951726842.618800,41008290192.799098,2666324,87274,250372,3003970
2020-01-09,NYSE Arca (P),159978211,225849855,152985266,538813332,6388317568.615401,13405785870.717503,9185260573.409202,28979364012.742106,1401717,537300,1378494,3317511
2020-01-09,NASDAQ (Q),370810072,148984879,635909048,1155703999,16054434027.316605,8849639785.155298,37228519048.495372,62132592860.967275,3664000,573577,4422961,8660538
2020-01-09,Investors Exchange (V),106511481,17923498,61332681,185767660,4943693330.326500,1071365942.423900,3709437489.397600,9724496762.148000,872806,90184,521027,1484017
2020-01-09,NASDAQ PSX (X),16273713,14474447,12368866,43117026,599632058.566400,872347497.608000,943967887.870400,2415947444.044800,134343,53042,107159,294544
2020-01-09,BYX Equities (Y),88083508,41547403,53968944,183599855,2811759416.595600,2111922427.880300,2129706052.044400,7053387896.520300,934907,196696,556077,1687680
2020-01-09,BZX Equities (Z),207880479,71711803,142686367,422278649,9274236420.614102,4726562536.149399,10254924021.972603,24255722978.736104,1847750,294305,1340259,3482314
2020-01-08,NYSE American (A),5867849,21330043,3196530,30394422,264059710.265400,227358452.705100,199353637.872200,690771800.842700,66157,59552,37568,163277
2020-01-08,NASDAQ BX (B),53163126,29304062,29511205,111978393,2088318690.498900,1355881860.119200,1696499901.669400,5140700452.287500,555511,201795,356954,1114260
2020-01-08,NYSE National (C),79553890,41074212,29085057,149713159,1605568514.181400,1342959064.123600,868781952.652400,3817309530.957400,642784,156806,301980,1101570
2020-01-08,FINRA / Nasdaq TRF Chicago (DB),7974186,2234144,6480262,16688592,298759000.946500,80775448.650000,629326177.074100,1008860626.670600,18660,6282,26130,51072
2020-01-08,FINRA / NYSE TRF (DN),278684236,149354618,307672917,735711771,6856094779.849802,4378823180.633002,15479330562.066118,26714248522.548922,704949,303907,919914,1928770
2020-01-08,FINRA / Nasdaq TRF Carteret (DQ),1110596914,470595808,771781938,2352974660,45203997094.048500,26053115617.264790,39757922350.240202,111015035061.553492,4001552,993684,2702815,7698051
2020-01-08,EDGA Equities (J),92929113,25712765,42141773,160783651,3200171405.797900,1319603056.209600,2049360646.273400,6569135108.280900,975375,129195,517784,1622354
2020-01-08,EDGX Equities (K),186628805,111793714,168594356,467016875,6079012082.660200,5442665925.885900,7888459195.931200,19410137204.477300,1378245,369310,1124443,2871998
2020-01-08,NYSE Chicago (M),6374423,9752360,6565431,22692214,500338623.019500,978953520.810000,893681067.556600,2372973211.386100,7728,2865,7625,18218
2020-01-08,NYSE (N),895957642,58261074,38706667,992925383,39384694332.995201,3230952801.811999,2005087904.302700,44620735039.109900,2949884,124514,260148,3334546
2020-01-08,NYSE Arca (P),171695670,336882447,158571777,667149894,6884296500.335800,18739642275.174901,9403426437.152188,35027365212.662889,1536777,777219,1427064,3741060
2020-01-08,NASDAQ (Q),398179713,230823828,639009394,1268012935,17631940389.742095,12677350922.445698,39569889977.670820,69879181289.858613,4021221,804779,4470003,9296003
2020-01-08,Investors Exchange (V),111144376,22777356,64076794,197998526,5178467897.322800,1329015661.741700,3867507328.707100,10374990887.771600,899401,101975,545173,1546549
2020-01-08,NASDAQ PSX (X),17250185,24414075,15400935,57065195,640018352.995600,1346579757.997300,857340233.187000,2843938344.179900,142676,77305,106364,326345
2020-01-08,BYX Equities (Y),89653813,64940003,53201187,207795003,2882294749.856300,2974472165.799600,2146066237.433200,8002833153.089100,946897,274649,566889,1788435
2020-01-08,BZX Equities (Z),221186121,112053384,138624671,471864176,10157214119.109503,7159662598.852102,10097077645.761797,27413954363.723402,2021790,409841,1333308,3764939
2020-01-07,NYSE American (A),5308681,22121662,2983219,30413562,240132902.099000,187327841.642100,172188902.060600,599649645.801700,57158,56392,32055,145605
2020-01-07,NASDAQ BX (B),40775398,18719341,24387068,83881807,1470567273.443100,916674661.695600,1232505062.436300,3619746997.575000,389608,142577,265575,797760
2020-01-07,NYSE National (C),74394794,26526168,28932387,129853349,1536739435.706400,968204381.131300,838758293.219700,3343702110.057400,615129,120614,295865,1031608
2020-01-07,FINRA / Nasdaq TRF Chicago (DB),3760102,1279805,4273955,9313862,122958087.810000,50269425.388400,328709838.744800,501937351.943200,13642,3826,19973,37441
2020-01-07,FINRA / NYSE TRF (DN),257294388,117918242,315959529,691172159,6271489163.382500,3335707985.022901,12976717048.835598,22583914197.240999,658338,248380,859574,1766292
2020-01-07,FINRA / Nasdaq TRF Carteret (DQ),1067077796,392149946,762799019,2222026761,44860123688.417087,21073492603.459206,39432404052.099999,105366020343.976292,3811865,841166,2635013,7288044
2020-01-07,EDGA Equities (J),93561384,18310755,44565287,156437426,3406101210.908100,916291806.887600,2169048923.187500,6491441940.983200,996251,103070,544020,1643341
2020-01-07,EDGX Equities (K),174990873,83721337,169449978,428162188,5531178302.425000,3772466686.560001,7429962410.067598,16733607399.052599,1255756,269783,1070173,2595712
2020-01-07,NYSE Chicago (M),8797633,13676351,5678779,28152763,490223302.557800,1245951837.953100,645551049.061500,2381726189.572400,7247,1772,7050,16069
2020-01-07,NYSE (N),792166861,33082471,36587441,861836773,35298903129.531901,1889947018.045200,1932810174.445801,39121660322.022902,2611299,81357,259657,2952313
2020-01-07,NYSE Arca (P),153588973,222611822,146383925,522584720,6183027341.666399,12998109065.821706,8253148288.131201,27434284695.619306,1432013,551759,1362558,3346330
2020-01-07,NASDAQ (Q),359382764,152761866,586048320,1098192950,16059219038.531699,8600591717.000999,33631268219.793580,58291078975.326278,3916842,564469,4247858,8729169
2020-01-07,Investors Exchange (V),108695102,17169596,61704000,187568698,4854702033.207501,1005108073.341000,3425992731.085200,9285802837.633701,862965,80469,546514,1489948
2020-01-07,NASDAQ PSX (X),16185183,15156738,12176217,43518138,561001055.086800,879820932.092900,802736296.959500,2243558284.139200,125727,54917,100132,280776
2020-01-07,BYX Equities (Y),81791220,45438252,48324514,175553986,2757737962.573200,2077639446.237800,1982118609.742700,6817496018.553700,867684,190253,528903,1586840
2020-01-07,BZX Equities (Z),198147527,70062444,131488048,399698019,8826683877.732099,4388812026.192601,8739239490.604896,21954735394.529596,1794620,280793,1217160,3292573
2020-01-06,NYSE American (A),5218813,22262176,3017799,30498788,207371750.819000,209699448.350100,154699225.159500,571770424.328600,57738,67302,34709,159749
2020-01-06,NASDAQ BX (B),39679836,21065763,26707697,87453296,1402827444.452400,1082457029.705200,1183213225.101300,3668497699.258900,379726,144407,252922,777055
2020-01-06,NYSE National (C),79282834,29460785,31505288,140248907,1543833821.339100,1049678975.804400,764809445.540300,3358322242.683800,650877,126404,307497,1084778
2020-01-06,FINRA / Nasdaq TRF Chicago (DB),3943633,1424644,4311546,9679823,117703537.445200,72511683.621900,302663362.695200,492878583.762300,14224,4678,19916,38818
2020-01-06,FINRA / NYSE TRF (DN),272548592,134979935,437170432,844698959,6055513053.601397,4294175507.820298,12025574538.743705,22375263100.165400,743768,277183,926442,1947393
2020-01-06,FINRA / Nasdaq TRF Carteret (DQ),1109753846,436993297,839747823,2386494966,45743919217.386007,27431962713.186593,37385215507.879499,110561097438.452099,3966228,951782,2651192,7569202
2020-01-06,EDGA Equities (J),92719395,19250464,51223178,163193037,3200594910.589900,1047429727.192200,1975215575.905400,6223240213.687500,1001777,111765,549093,1662635
2020-01-06,EDGX Equities (K),181070201,79541740,208507242,469119183,5215011290.624202,3933677957.643099,6453567423.946603,15602256672.213904,1283763,283199,1086558,2653520
2020-01-06,NYSE Chicago (M),11007966,16480287,6480406,33968659,599914112.969900,1142580736.900000,832755895.515300,2575250745.385200,9498,3620,7461,20579
2020-01-06,NYSE (N),978427422,33458565,33669288,1045555275,42504473188.451998,2135362080.679200,1660366316.155800,46300201585.286998,2735235,94402,238820,3068457
2020-01-06,NYSE Arca (P),159109540,244170178,162522595,565802313,5841605337.200098,15239593919.567208,7444060695.847400,28525259952.614706,1406199,606366,1309824,3322389
2020-01-06,NASDAQ (Q),364707859,165293057,725997613,1255998529,15452069214.908897,9743079702.286298,35860557938.624217,61055706855.819412,3666934,645041,4250509,8562484
2020-01-06,Investors Exchange (V),99690920,16802091,57691548,174184559,4594512689.876400,1071695065.790800,3125230819.330600,8791438574.997800,868464,87072,534196,1489732
2020-01-06,NASDAQ PSX (X),18035935,16807258,12303355,47146548,564377798.628500,1025388724.692900,716454463.562600,2306220986.884000,131702,63958,98511,294171
2020-01-06,BYX Equities (Y),88832264,48071632,72050352,208954248,2752160236.127200,2242429006.923300,1871691544.462800,6866280787.513300,911622,214791,544494,1670907
2020-01-06,BZX Equities (Z),198431272,73957140,137553229,409941641,8542296420.657998,4981902567.785001,8011398303.248998,21535597291.691997,1781072,305723,1217258,3304053
2020-01-03,NYSE American (A),5464079,22423315,2718304,30605698,206851609.060000,248911190.500100,147785149.702300,603547949.262400,54847,67111,30494,152452
2020-01-03,NASDAQ BX (B),39852446,29366557,25176593,94395596,1387697971.804500,1421274367.654100,1204304979.178500,4013277318.637100,379290,185796,269557,834643
2020-01-03,NYSE National (C),78301808,36717731,31008728,146028267,1475261919.563000,1289119084.172000,725431205.428200,3489812209.163200,627928,150627,287694,1066249
2020-01-03,FINRA / Nasdaq TRF Chicago (DB),3425619,1570367,3653702,8649688,120533600.424900,77558552.245000,308300337.850300,506392490.520200,13160,5166,18756,37082
2020-01-03,FINRA / NYSE TRF (DN),264305987,130781729,403906876,798994592,5650642408.404202,4471404929.766698,12040398759.105992,22162446097.276892,665564,303949,836532,1806045
2020-01-03,FINRA / Nasdaq TRF Carteret (DQ),959221334,430044939,729826343,2119092616,35807727782.145202,27551305522.522100,33333095787.614408,96692129092.281710,3773181,1067429,2482335,7322945
2020-01-03,EDGA Equities (J),95673407,26702192,51173152,173548751,3139075092.402900,1340123941.232000,1968468912.614100,6447667946.249000,993021,147699,517980,1658700
2020-01-03,EDGX Equities (K),174524448,93194416,201235788,468954652,5031380156.919000,5171265327.113001,6510194556.565999,16712840040.598000,1239451,369686,1012884,2622021
2020-01-03,NYSE Chicago (M),6375555,10809350,5955002,23139907,277173670.660000,1475740711.805799,717887441.802800,2470801824.268599,8193,3451,5466,17110
2020-01-03,NYSE (N),932139588,46564661,34743328,1013447577,36829499661.384798,3013052530.441100,1936647690.251800,41779199882.077698,2837770,118448,247046,3203264
2020-01-03,NYSE Arca (P),164346712,307131686,166459931,637938329,5801446286.833601,19681121097.048803,8326416171.436398,33808983555.318802,1396090,714070,1288257,3398417
2020-01-03,NASDAQ (Q),361377100,204133116,659340663,1224850879,14941450249.494399,12099138514.707604,34471145646.091000,61511734410.293003,3665178,791536,4155907,8612621
2020-01-03,Investors Exchange (V),93805677,22157644,54359059,170322380,3834462510.485500,1352996085.151600,2861350024.071100,8048808619.708200,796070,111171,500619,1407860
2020-01-03,NASDAQ PSX (X),18434942,18795631,11829441,49060014,557498569.939000,1177712813.912400,798500585.730800,2533711969.582200,130736,68136,96723,295595
2020-01-03,BYX Equities (Y),87121041,61509826,70092546,218723413,2579117356.827700,3003369079.163901,1901090926.441100,7483577362.432701,873127,265257,511760,1650144
2020-01-03,BZX Equities (Z),200340015,93018061,135041260,428399336,8251766497.478401,6413427295.351198,8641307019.193101,23306500812.022700,1770851,399309,1194774,3364934
2020-01-02,NYSE American (A),5257875,17304395,3051287,25613557,229816309.398200,345603989.314500,173641974.268600,749062272.981300,58512,60708,35697,154917
2020-01-02,NASDAQ BX (B),41205824,26206050,24393164,91805038,1510756517.365100,1396921807.191100,1173227241.021500,4080905565.577700,400814,173363,264398,838575
2020-01-02,NYSE National (C),80386821,31311591,31427429,143125841,1605366724.692300,1239793379.650700,818624326.385900,3663784430.728900,621948,137432,300921,1060301
2020-01-02,FINRA / Nasdaq TRF Chicago (DB),4013149,1561466,4578176,10152791,134411210.490300,74405059.510000,307482361.822700,516298631.823000,15207,4995,20526,40728
2020-01-02,FINRA / NYSE TRF (DN),269426322,110947468,476593880,856967670,6226205579.870201,4313856351.149501,11892130883.300689,22432192814.320391,727413,278465,938066,1943944
2020-01-02,FINRA / Nasdaq TRF Carteret (DQ),1014546400,478736233,830294191,2323576824,40131163682.335599,29502033246.537694,36309692607.926499,105942889536.799792,3886331,994430,2673786,7554547
2020-01-02,EDGA Equities (J),90708173,24364940,61046815,176119928,3441141133.627300,1391185612.864500,2106949212.256900,6939275958.748700,1017742,136669,574776,1729187
2020-01-02,EDGX Equities (K),173369143,78777774,224754530,476901447,5314526095.451201,4753677816.499101,6603551161.152195,16671755073.102497,1335748,311308,1139922,2786978
2020-01-02,NYSE Chicago (M),6842343,6038662,8494416,21375421,813970385.319799,754096562.420400,875690154.917400,2443757102.657599,8493,3069,6386,17948
2020-01-02,NYSE (N),863199294,40198386,37519003,940916683,37566937190.795395,2742372365.134401,1905285105.427200,42214594661.356996,2934032,106223,276421,3316676
2020-01-02,NYSE Arca (P),159987201,264844501,172491419,597323121,6252279771.723797,17149001537.516903,7976553098.515003,31377834407.755703,1490256,638032,1384189,3512477
2020-01-02,NASDAQ (Q),353135847,160627261,692741284,1206504392,15494703750.564101,10558981306.353104,35401123724.174718,61454808781.091923,3702416,671902,4406817,8781135
2020-01-02,Investors Exchange (V),97200726,21158683,55810787,174170196,4284712011.712600,1317298154.220600,3048231232.927900,8650241398.861100,784776,98979,491691,1375446
2020-01-02,NASDAQ PSX (X),17268988,17584939,12466026,47319953,576756469.776500,1168942640.463100,822755232.294400,2568454342.534000,132826,69898,103689,306413
2020-01-02,BYX Equities (Y),92088252,54085832,76739741,222913825,2858129532.248200,2879394192.609600,2046782008.041500,7784305732.899300,915316,244721,563924,1723961
2020-01-02,BZX Equities (Z),191298380,78148285,150299031,419745696,8746544003.151300,5436489639.885899,8576692592.714206,22759726235.751405,1780549,321687,1270468,3372704
